,sent_index,sentence_length,root_word,root_index,entity_1_index,entity_2_index,entity_distance,no_words_before_entity_1,no_words_after_entity_2,entity_1_root_distance,entity_2_root_distance,entity 1 name,entity 2 name,entity_type_1,entity_type_2,entity_pos_1,entity_pos_2,entity_dep_1,entity_dep_2,entity_tag_1,entity_tag_2,shortest_distance,label
0,0.0,37,attended,6,17,26,9,16,10,-11,20,Isle of Wight,Ryde School with Upper Chine,--,org-org-org-org-org,PROPN-ADP-PROPN,PROPN-PROPN-ADP-PROPN-PROPN,pobj-prep-pobj,compound-oprd-prep-compound-pobj,NNP-IN-NNP,NNP-NNP-IN-NNP-NNP,4,1
1,1.0,26,Supported,0,7,24,17,6,1,-7,24,Mars,Maryland,org,,PROPN,PROPN,nsubj,compound,NNP,NNP,5,1
2,2.0,24,is,11,2,19,17,1,4,9,8,California,substance abuse,,org-org,PROPN,NOUN-NOUN,compound,compound-compound,NNP,NN-NN,7,1
3,3.0,15,are,5,3,8,5,2,6,2,3,Aetna,Connecticut,org,,PROPN,PROPN,poss,pobj,NNP,NNP,4,1
4,2554.0,38,Wallis,1,20,29,9,19,8,-19,28,Aetna,Connecticut,org,,PROPN,PROPN,compound,pobj,NNP,NNP,-1,1
5,4.0,27,said,5,1,4,3,0,22,4,-1,Singapore Airlines,SIA,org-org,,PROPN-PROPN,PROPN,compound-nsubj,appos,NNP-NNP,NNP,2,1
6,20.0,27,said,5,1,4,3,0,22,4,-1,Singapore Airlines,SIA,org-org,,PROPN-PROPN,PROPN,compound-nsubj,appos,NNP-NNP,NNP,2,1
7,5.0,12,attended,1,3,11,8,2,0,-2,10,St. Benet Biscop Catholic High School,Northumberland,org-org-org-org-org-org,,PROPN-PROPN-PROPN-PROPN-PROPN-PROPN,PROPN,compound-compound-compound-compound-compound-dobj,pobj,NNP-NNP-NNP-NNP-NNP-NNP,NNP,3,1
8,6.0,17,is,3,2,16,14,1,0,1,13,Sacramento Heatwave,California,org-org,,PROPN-PROPN,PROPN,compound-nsubj,pobj,NNP-NNP,NNP,2,1
9,7.0,34,ranked,9,3,21,18,2,12,6,12,Oklahoma,QuikTrip,,org,PROPN,PROPN,nmod,dobj,NNP,NNP,9,1
10,8.0,13,is,4,1,12,11,0,0,3,8,DigiPen Institute of Technology,Washington,org-org-org-org,,PROPN-PROPN-ADP-PROPN,PROPN,compound-nsubj-prep-pobj,pobj,NNP-NNP-IN-NNP,NNP,6,1
11,9.0,31,is,1,1,8,7,0,22,0,7,Viva,York Region,org,-,PROPN,PROPN-PROPN,nsubj,compound-compound,NNP,NNP-NNP,4,1
12,10.0,50,is,3,13,29,16,12,20,-10,26,Georgia,Army National Guard,,org-org-org,PROPN,PROPN-PROPN-PROPN,pobj,compound-compound-poss,NNP,NNP-NNP-NNP,9,1
13,11.0,47,used,3,1,5,4,0,41,2,2,THF Realty,Missouri,org-org,,PROPN-PROPN,PROPN,compound-compound,poss,NNP-NNP,NNP,5,1
14,12.0,58,is,8,18,20,2,17,37,-10,12,University of Georgia College of Agricultural and Environmental Sciences,Georgia,org-org-org-org-org-org-org-org-org,,PROPN-ADP-PROPN-PROPN-ADP-PROPN-CCONJ-PROPN-PROPN,PROPN,pobj-prep-compound-pobj-prep-amod-cc-conj-pobj,compound,NNP-IN-NNP-NNP-IN-NNP-CC-NNP-NNPS,NNP,2,1
15,13.0,36,banned,4,16,26,10,15,9,-12,22,Moscow,Olga Knipper,,per-per,PROPN,PROPN-PROPN,compound,compound-conj,NNP,NNP-NNP,6,1
16,14.0,43,is,12,1,11,10,0,31,11,-1,Sydenham Institute of Management Studies,SIMSREE,----,org,PROPN-PROPN-ADP-PROPN-PROPN,PROPN,compound-nsubj-prep-pobj-nmod,appos,NNP-NNP-IN-NNP-NNPS,NNP,5,1
17,15.0,29,governed,2,1,22,21,0,6,1,20,Ottawa,Jim Watson,,per-per,PROPN,PROPN-PROPN,compound,compound-appos,NNP,NNP-NNP,4,1
18,16.0,42,was,1,15,18,3,14,23,-14,17,Durham Light Infantry,British Army,org-org-org,-,PROPN-PROPN-PROPN,PROPN-PROPN,compound-compound-compound,compound-nsubj,NNP-NNP-NNP,NNP-NNP,2,1
19,17.0,31,made,9,8,9,1,7,21,1,0,Salvador,Raul,,per,PROPN,PROPN,compound,pobj,NNP,NNP,4,1
20,18.0,28,went,2,2,12,10,1,15,0,10,BCC,BCC-500,,org,PROPN,NOUN,nsubj,nsubjpass,NNP,NN,2,1
21,19.0,16,originated,9,1,9,8,0,6,8,0,His,Shady,org,,DET,PROPN,poss,nsubj,PRP$,NNP,4,1
22,21.0,35,established,4,11,15,4,10,19,-7,11,Universiti Pertanian Malaysia,UPM,--,org,PROPN-PROPN-PROPN,PROPN,compound-compound-attr,appos,NNP-NNP-NNP,NNP,2,1
23,22.0,59,headed,33,18,40,22,17,18,15,7,Patiala,Amarinder Singh,,per-per,PROPN,PROPN-PROPN,pobj,compound-compound,NNP,NNP-NNP,-1,1
24,23.0,48,Site,3,19,24,5,18,23,-16,21,V,where Ho Ch,,per-per-per,PROPN,ADV-PROPN-PROPN,compound,advmod-compound-nmod,NNP,WRB-NNP-NNP,6,1
25,24.0,15,involved,5,1,3,2,0,11,4,-2,University,Turku,org,,PROPN,PROPN,nsubjpass,pobj,NNP,NNP,3,1
26,25.0,20,began,9,15,18,3,14,1,-6,9,EAC,Arusha,org,,PROPN,PROPN,compound,compound,NNP,NNP,2,1
27,26.0,19,represented,6,3,3,0,2,15,3,-3,Bryant Bulldogs,Bryant University,-,org-org,PROPN-PROPN,PROPN-PROPN,compound-compound,compound-dobj,NNP-NNPS,NNP-NNP,0,1
28,2513.0,22,represents,8,4,4,0,3,17,4,-4,Bryant Bulldogs,Bryant University,-,org-org,PROPN-PROPN,PROPN-PROPN,compound-compound,compound-dobj,NNP-NNPS,NNP-NNP,0,1
29,27.0,24,founded,6,9,6,-3,8,17,-3,0,Nashville,Lipscomb University,,org-org,PROPN,PROPN-PROPN,compound,compound-pobj,NNP,NNP-NNP,2,1
30,28.0,26,attended,6,18,25,7,17,0,-12,19,Golden Gate University,California,org-org-org,,PROPN-PROPN-PROPN,PROPN,compound-compound-pobj,pobj,NNP-NNP-NNP,NNP,5,1
31,29.0,26,won,7,3,10,7,2,15,4,3,North Carolina State University,NCAA,---,org,PROPN-PROPN-PROPN-PROPN,PROPN,compound-compound-compound-compound,nmod,NNP-NNP-NNP-NNP,NNP,6,1
32,30.0,30,merged,8,12,5,-7,11,24,-4,-3,Tunnel Authority,Triborough Bridge and Tunnel Authority,-,org-org-org-org-org,PROPN-PROPN,PROPN-PROPN-CCONJ-PROPN-PROPN,compound-pobj,nmod-nmod-cc-conj-nsubj,NNP-NNP,NNP-NNP-CC-NNP-NNP,4,1
33,31.0,23,show,3,1,6,5,0,16,2,3,Aberdeen,Cobain,,per,ADJ,PROPN,compound,nsubjpass,JJ,NNP,4,1
34,32.0,68,was,7,18,19,1,17,48,-11,12,Liz Anderson,Anderson,-,per,PROPN-PROPN,PROPN,compound-appos,poss,NNP-NNP,NNP,1,1
35,33.0,19,represented,6,3,3,0,2,15,3,-3,Indiana Hoosiers,Indiana University,org-org,-,PROPN-PROPN,PROPN-PROPN,compound-compound,compound-compound,NNP-NNPS,NNP-NNP,0,1
36,34.0,40,has,14,11,14,3,10,25,3,0,Grand Forks Herald,WDAZ,--,org,PROPN-PROPN-PROPN,PROPN,compound-compound-compound,dobj,NNP-NNP-NNP,NNP,7,1
37,35.0,39,are,2,18,24,6,17,14,-16,22,Ibn Rushd,Averroes,-,per,PROPN-PROPN,PROPN,compound-ROOT,appos,NNP-NNP,NNP,-1,1
38,36.0,45,listed,5,24,34,10,23,10,-19,29,Gilmer,his,,per,PROPN,DET,poss,poss,NNP,PRP$,-1,1
39,37.0,43,celebrated,5,8,12,4,7,30,-3,7,Finlandia University,Michigan,org-org,,PROPN-PROPN,PROPN,compound-pobj,pobj,NNP-NNP,NNP,2,1
40,38.0,31,founded,3,2,16,14,1,14,1,13,university,Friends Pacific Academy,org,--,NOUN,PROPN-PROPN-PROPN,nsubjpass,compound-compound-pobj,NN,NNP-NNP-NNP,7,1
41,39.0,38,represented,6,16,36,20,15,1,-10,30,National Union of General Workers,Zenrokyo,----,org,PROPN-PROPN-ADP-PROPN-PROPN,PROPN,compound-pobj-prep-compound-pobj,ROOT,NNP-NNP-IN-NNP-NNPS,NNP,4,1
42,40.0,22,hosted,2,15,18,3,14,3,-13,16,Ben Affleck,Jennifer Garner,per-per,-,PROPN-PROPN,PROPN-PROPN,compound-conj,compound-conj,NNP-NNP,NNP-NNP,1,1
43,41.0,59,left,0,17,21,4,16,37,-17,21,Normal,Alabama University,,org-org,PROPN,PROPN-PROPN,compound,compound-appos,NNP,NNP-NNP,1,1
44,42.0,19,attended,1,3,8,5,2,10,-2,7,Denison University,Ohio,org-org,,PROPN-PROPN,PROPN,compound-dobj,pobj,NNP-NNP,NNP,2,1
45,43.0,43,represented,7,3,10,7,2,32,4,3,Army Black Knights,United States Military Academy,--,org-org-org-org,PROPN-PROPN-PROPN,PROPN-PROPN-PROPN-PROPN,compound-compound-compound,compound-compound-compound-dobj,NNP-NNP-NNPS,NNP-NNP-NNP-NNP,5,1
46,44.0,31,Chrysalis,1,2,5,3,1,25,-1,4,Chrysalis,Ten Years After,org,--,PROPN,NUM-NOUN-ADP,ROOT,nummod-nsubj-aux,NNP,CD-NNS-IN,-1,1
47,45.0,30,acquired,4,3,7,4,2,22,1,3,LucasVarity,TRW,,org,PROPN,PROPN,nsubjpass,pobj,NNP,NNP,2,1
48,46.0,16,is,6,1,5,4,0,10,5,-1,The Science Academy of South Texas,South Texas Independent School District,-----,org-org-org-org-org,DET-PROPN-PROPN-ADP-PROPN-PROPN,PROPN-PROPN-PROPN-PROPN-PROPN,det-compound-nsubj-prep-compound-pobj,compound-compound-compound-compound-pobj,DT-NNP-NNP-IN-NNP-NNP,NNP-NNP-NNP-NNP-NNP,3,1
49,47.0,13,was,1,5,11,6,4,1,-4,10,Merzbow,ZSF Produkt,,org-org,PROPN,PROPN-PROPN,compound,compound-dobj,NNP,NNP-NNP,3,1
50,48.0,31,announced,7,10,18,8,9,12,-3,11,PLC,Pymble,org,,PROPN,PROPN,compound,amod,NNP,NNP,3,1
51,49.0,27,undergo,5,12,18,6,11,8,-7,13,National Aeronautics,NASA,-,org,PROPN-PROPN,PROPN,nmod-nmod,appos,NNP-NNP,NNP,3,1
52,2094.0,27,is,12,19,25,6,18,1,-7,13,National Aeronautics,NASA,-,per,PROPN-PROPN,PROPN,nmod-nmod,appos,NNP-NNP,NNP,5,1
53,50.0,62,travelled,8,12,29,17,11,32,-4,21,United States,Brian McKnight,-,per-per,PROPN-PROPN,PROPN-PROPN,compound-pobj,compound-appos,NNP-NNP,NNP-NNP,11,1
54,51.0,27,sued,14,1,13,12,0,13,13,-1,Viacom,Comedy Central,org,-,PROPN,PROPN-PROPN,nsubj,compound-dobj,NNP,NNP-NNP,4,1
55,1283.0,62,On,0,20,43,23,19,18,-20,43,Viacom,Comedy Central,,per-per,PROPN,PROPN-PROPN,poss,compound-conj,NNP,NNP-NNP,13,1
56,52.0,11,takes,5,1,4,3,0,6,4,-1,China,Jiang Zemin,,per-per,PROPN,PROPN-PROPN,poss,compound-nsubj,NNP,NNP-NNP,4,1
57,53.0,32,is,8,2,15,13,1,16,6,7,2nd Tank Battalion,United States,--,org-org,ADJ-PROPN-PROPN,PROPN-PROPN,compound-compound-nsubj,compound-compound,JJ-NNP-NNP,NNP-NNP,6,1
58,54.0,36,became,31,19,2,-17,18,33,12,-29,Derbyshire,Eckington Junior School,,org-org-org,PROPN,PROPN-PROPN-PROPN,poss,compound-compound-attr,NNP,NNP-NNP-NNP,5,1
59,55.0,16,broadcast,6,10,14,4,9,1,-4,8,TVE1,TVE,org,,PROPN,PROPN,pobj,compound,NNP,NNP,3,1
60,56.0,37,area,3,17,19,2,16,17,-14,16,Universiti Malaysia Kelantan,Kelantan,org-org-org,,PROPN-PROPN-PROPN,PROPN,pobj-compound-nsubj,pobj,NNP-NNP-NNP,NNP,2,1
61,57.0,34,holding,9,1,8,7,0,25,8,-1,NBC Universal,msnbc.com,org-org,,PROPN-PROPN,X,compound-nsubj,pobj,NNP-NNP,ADD,2,1
62,58.0,14,played,2,2,13,11,1,0,0,11,Spartans,Michigan,per,,PROPN,PROPN,nsubj,pobj,NNPS,NNP,1,1
63,59.0,32,received,1,11,11,0,10,20,-10,10,Florida,Florida Gators,,org-org,PROPN,PROPN-PROPN,appos,compound-compound,NNP,NNP-NNPS,0,1
64,60.0,38,held,8,20,22,2,19,15,-12,14,Times,India,,org,PROPN,PROPN,ROOT,compound,NNP,NNP,4,1
65,61.0,60,sold,5,44,50,6,43,9,-39,45,Emera,Nova Scotia,org,-,PROPN,PROPN-PROPN,pobj,compound-compound,NNP,NNP-NNP,4,1
66,62.0,18,is,8,1,12,11,0,5,7,4,Ph?m,ed Vietn,per,-,PROPN,NOUN-PROPN,intj,attr-nsubj,NNP,NN-NNP,3,1
67,63.0,33,signed,4,4,7,3,3,25,0,3,Fitzgerald,Reprise,per,,PROPN,PROPN,nsubj,compound,NNP,NNP,2,1
68,64.0,60,Mamet,3,45,50,5,44,9,-42,47,Charles,Catherine of Braganza,,per-per-per,PROPN,PROPN-ADP-PROPN,compound,appos-prep-compound,NNP,NNP-IN-NNP,7,1
69,65.0,24,led,1,6,17,11,5,6,-5,16,North Dakota Fighting Sioux,Division I,---,org-org,PROPN-PROPN-PROPN-PROPN,PROPN-PRON,compound-pobj-xcomp-compound,pobj-nsubj,NNP-NNP-NNP-NNP,NNP-PRP,5,1
70,66.0,33,warns,11,1,6,5,0,26,10,-5,Shahzada,Afghanistan,per,,PROPN,PROPN,compound,compound,NNP,NNP,4,1
71,67.0,31,is,17,1,25,24,0,5,16,8,Anneke van Giersbergen,The Gathering,per-per-per,-,PROPN-PROPN-PROPN,DET-PROPN,compound-compound-nsubj,det-compound,NNP-NNP-NNP,DT-NNP,6,1
72,68.0,24,starting,3,8,13,5,7,10,-5,10,Los Angeles Xtreme,XFL,--,org,PROPN-PROPN-PROPN,PROPN,compound-compound-pobj,pobj,NNP-NNP-NNP,NNP,7,1
73,69.0,40,was,10,25,28,3,24,11,-15,18,Eduard Shevardnadze,Georgia,per-per,,PROPN-PROPN,PROPN,compound-pobj,pobj,NNP-NNP,NNP,2,1
74,1379.0,39,clouded,4,11,16,5,10,22,-7,12,Eduard Shevardnadze,Georgia,org-org,,PROPN-PROPN,PROPN,compound-pobj,pobj,NNP-NNP,NNP,7,1
75,70.0,30,performed,6,5,18,13,4,11,1,12,Boston,Mike Stern,,per-per,PROPN,PROPN-PROPN,pobj,compound-dobj,NNP,NNP-NNP,4,1
76,71.0,18,became,2,1,11,10,0,6,1,9,Plumer,New Hampshire,per,-,NOUN,PROPN-PROPN,nsubj,compound-pobj,NN,NNP-NNP,5,1
77,72.0,66,was,26,19,25,6,18,40,7,-1,Philippa of Hainault,Edward,per-per-per,,PROPN-ADP-PROPN,PROPN,nsubj-prep-pobj,compound,NNP-IN-NNP,NNP,4,1
78,73.0,31,were,2,21,26,5,20,4,-19,24,Francis Duke of Teck,Princess Mary Adelaide of Cambridge,---,per-per-per-per-per,PROPN-PROPN-ADP-PROPN,PROPN-PROPN-PROPN-ADP-PROPN,compound-pobj-prep-pobj,compound-compound-conj-prep-pobj,NNP-NNP-IN-NNP,NNP-NNP-NNP-IN-NNP,2,1
79,74.0,39,was,2,2,10,8,1,28,0,8,University,China,org,,PROPN,PROPN,nsubj,pobj,NNP,NNP,2,1
80,75.0,38,co-hosted,4,16,14,-2,15,23,-12,10,Jean Charest,Quebec,per-per,,PROPN-PROPN,PROPN,compound-conj,pobj,NNP-NNP,NNP,3,1
81,76.0,39,been,2,1,32,31,0,6,1,30,Berlusconi,Veronica Lario,per,-,PROPN,PROPN-PROPN,nsubj,compound-appos,NNP,NNP-NNP,15,1
82,77.0,18,acquired,3,8,15,7,7,2,-5,12,Ameritech,Wisconsin Bell,org,-,PROPN,PROPN-PROPN,pobj,compound-compound,NNP,NNP-NNP,4,1
83,78.0,27,became,2,1,8,7,0,18,1,6,Rich,LaFace Records,per,-,PROPN,PROPN-PROPN,nsubj,compound-pobj,NNP,NNP-NNPS,3,1
84,79.0,25,selected,4,8,20,12,7,4,-4,16,Greece,George Dalaras,,per-per,PROPN,PROPN-PROPN,dobj,compound-pobj,NNP,NNP-NNP,4,1
85,80.0,28,doing,4,8,16,8,7,11,-4,12,Sun Cellular,Digital Telecommunications Philippines,-,org-org-org,PROPN-PROPN,PROPN-PROPN-PROPN,compound-nsubj,compound-compound-pobj,NNP-NNP,NNP-NNP-NNPS,5,1
86,81.0,17,is,2,11,15,4,10,1,-9,13,Sweden,Jonas Hellborg,,per-per,PROPN,PROPN-PROPN,pobj,compound-pobj,NNP,NNP-NNP,3,1
87,82.0,30,be,2,1,5,4,0,24,1,3,England,Darren,,per,PROPN,PROPN,nsubj,compound,NNP,NNP,3,1
88,83.0,13,married,1,1,3,2,0,9,0,2,Sonia,Selvaraghavan,per,,PROPN,PROPN,nsubj,dobj,NNP,NNP,2,1
89,84.0,32,accused,6,8,15,7,7,16,-2,9,Azem Vllasi,League,per-per,,PROPN-PROPN,PROPN,compound-dative,pobj,NNP-NNP,NNP,5,1
90,85.0,17,is,3,1,8,7,0,8,2,5,Enterprise High School,Shasta Union High School District,--,org-org-org-org-org,NOUN-PROPN-PROPN,PROPN-PROPN-PROPN-PROPN-PROPN,compound-compound-nsubj,compound-compound-compound-compound-pobj,NN-NNP-NNP,NNP-NNP-NNP-NNP-NNP,6,1
91,86.0,17,was,2,14,16,2,13,0,-12,14,French,Faure,,per,ADJ,PROPN,amod,pobj,JJ,NNP,2,1
92,87.0,20,was,10,1,19,18,0,0,9,9,David Henshaw,Navy,per-per,,PROPN-PROPN,PROPN,compound-nsubj,pobj,NNP-NNP,NNP,2,1
93,88.0,34,were,7,14,21,7,13,12,-7,14,London,him,,per,PROPN,PRON,compound,dobj,NNP,PRP,4,1
94,89.0,27,hung,11,7,8,1,6,18,4,-3,his,Sydney,per,,DET,PROPN,poss,compound,PRP$,NNP,2,1
95,90.0,45,held,8,29,33,4,28,11,-21,25,ONGC,India,org,,PROPN,PROPN,nsubj,pobj,NNP,NNP,2,1
96,91.0,33,became,12,3,17,14,2,15,9,5,Australia,Teale,,per,PROPN,PROPN,poss,nsubj,NNP,NNP,5,1
97,92.0,29,is,4,11,28,17,10,0,-7,24,Gilles Duceppe,Bloc,per-per,,PROPN-PROPN,PROPN,compound-conj,pobj,NNP-NNP,NNP,3,1
98,93.0,29,affors,2,18,24,6,17,4,-16,22,De La Salle,Philippines,org-org-org,,PROPN-PROPN-PROPN,PROPN,compound-compound-compound,nmod,NNP-NNP-NNP,NNP,5,1
99,94.0,30,backs,25,1,5,4,0,24,24,-20,Blix,United Nations Monitoring Verification and Inspection Commission,per,------,PROPN,PROPN-PROPN-PROPN-PROPN-CCONJ-PROPN-PROPN,nsubj,compound-nmod-nmod-nmod-cc-conj-dobj,NNP,NNP-NNP-NNP-NNP-CC-NNP-NNP,3,1
100,95.0,40,follows,7,21,27,6,20,12,-14,20,United Liberation Front of Asom,ULFA,org-org-org-org-org,,PROPN-PROPN-PROPN-ADP-PROPN,PROPN,compound-compound-pobj-prep-pobj,appos,NNP-NNP-NNP-IN-NNP,NNP,3,1
101,2465.0,16,is,5,8,14,6,7,1,-3,9,United Liberation Front of Asom,ULFA,----,org,PROPN-PROPN-PROPN-ADP-PROPN,PROPN,compound-compound-attr-prep-pobj,appos,NNP-NNP-NNP-IN-NNP,NNP,3,1
102,96.0,41,is,4,11,11,0,10,29,-7,7,Gul Ahmed Group,Gul Ahmed Textile Mills Limited,org-org-org,----,PROPN-PROPN-PROPN,PROPN-PROPN-PROPN-PROPN-PROPN,compound-compound-pobj,compound-compound-compound-dobj-nmod,NNP-NNP-NNP,NNP-NNP-NNP-NNPS-NNP,0,1
103,97.0,21,was,3,10,19,9,9,1,-7,16,United States,Thomas Jefferson,-,per-per,PROPN-PROPN,PROPN-PROPN,compound-pobj,compound-pobj,NNP-NNP,NNP-NNP,7,1
104,98.0,20,is,1,15,19,4,14,0,-14,18,Wilfrid Laurier University,Canada,org-org-org,,PROPN-PROPN-PROPN,PROPN,compound-compound-pobj,pobj,NNP-NNP-NNP,NNP,5,1
105,99.0,24,attended,1,3,6,3,2,17,-2,5,Huntingdon College,Montgomery,org-org,,PROPN-PROPN,PROPN,compound-dobj,pobj,NNP-NNP,NNP,4,1
106,114.0,33,served,2,27,30,3,26,2,-25,28,Huntingdon College,Montgomery,org-org,,PROPN-PROPN,PROPN,compound-ROOT,compound,NNP-NNP,NNP,2,1
107,100.0,33,became,1,8,12,4,7,20,-7,11,1997,Alchemy Partners,,org-org,NUM,PROPN-PROPN,nummod,compound-pobj,CD,NNP-NNPS,3,1
108,101.0,20,formed,6,4,19,15,3,0,2,13,Luigi Einaudi,Italy,per-per,,PROPN-PROPN,PROPN,compound-nsubjpass,pobj,NNP-NNP,NNP,2,1
109,1628.0,26,was,4,3,8,5,2,17,1,4,Luigi Einaudi,Italy,org-org,,PROPN-PROPN,PROPN,compound-appos,pobj,NNP-NNP,NNP,4,1
110,102.0,24,became,12,3,12,9,2,11,9,0,New York City,Patrick,--,per,PROPN-PROPN-PROPN,PROPN,compound-compound-pobj,pobj,NNP-NNP-NNP,NNP,4,1
111,103.0,16,was,1,1,9,8,0,6,0,8,Timeless,Citadel Broadcasting,,org-org,PROPN,PROPN-PROPN,nsubj,compound-pobj,NNP,NNP-NNP,2,1
112,104.0,16,is,2,1,15,14,0,0,1,13,Pathway Communications,Ontario,org-org,,PROPN-PROPN,PROPN,compound-nsubj,pobj,NNP-NNP,NNP,2,1
113,105.0,24,has,1,1,22,21,0,1,0,21,UHD,Houston,org,,PROPN,PROPN,nsubj,compound,NNP,NNP,9,1
114,106.0,19,plays,1,10,11,1,9,7,-9,10,Indianapolis,North Central High School,,org-org-org-org,PROPN,PROPN-PROPN-PROPN-PROPN,compound,compound-compound-compound-compound,NNP,NNP-NNP-NNP-NNP,2,1
115,107.0,34,placed,7,20,6,-14,19,27,-13,-1,Marina Militare,Italian Navy,org-org,-,PROPN-PROPN,PROPN-PROPN,compound-pobj,amod-appos,NNP-NNP,NNP-NNP,7,1
116,108.0,19,held,5,13,18,5,12,0,-8,13,West Virginia Wesleyan College,Buckhannon,org-org-org-org,,PROPN-PROPN-PROPN-PROPN,PROPN,compound-compound-compound-pobj,pobj,NNP-NNP-NNP-NNP,NNP,4,1
117,109.0,13,married,3,5,9,4,4,3,-2,6,Collette McArdle,he,-,per,PROPN-PROPN,PRON,compound-dobj,nsubj,NNP-NNP,PRP,1,1
118,110.0,29,said,16,16,26,10,15,2,0,10,Juncker,Luxembourg,per,,PROPN,PROPN,nsubj,poss,NNP,NNP,4,1
119,111.0,35,Information,1,5,25,20,4,9,-4,24,University of Adelaide,Group of Eight,--,org-org-org,PROPN-ADP-PROPN,PROPN-ADP-NUM,nsubj-prep-pobj,pobj-prep-pobj,NNP-IN-NNP,NNP-IN-CD,6,1
120,112.0,24,is,2,1,22,21,0,1,1,20,Exeter School,Devon,org-org,,PROPN-PROPN,PROPN,compound-nsubj,compound,NNP-NNP,NNP,12,1
121,113.0,17,sponsor,3,5,13,8,4,3,-2,10,Nazareth Academy,La Grange Park,org-org,--,PROPN-PROPN,PROPN-PROPN-PROPN,compound-dative,compound-compound-compound,NNP-NNP,NNP-NNP-NNP,2,1
122,115.0,29,owned,3,19,21,2,18,7,-16,18,Sliema,Michael,,per,PROPN,PROPN,pobj,nsubj,NNP,NNP,2,1
123,116.0,47,elected,10,9,16,7,8,30,1,6,VMI,Division I,,org-org,PROPN,PROPN-PRON,nsubj,compound-compound,NNP,NNP-PRP,6,1
124,117.0,23,attended,1,3,3,0,2,19,-2,2,Columbia High School,Columbia,org-org-org,,PROPN-PROPN-PROPN,PROPN,compound-compound-dobj,compound,NNP-NNP-NNP,NNP,0,1
125,118.0,31,announced,4,3,7,4,2,23,1,3,Guy Verhofstadt,Belgium,per-per,,PROPN-PROPN,PROPN,compound-nsubj,poss,NNP-NNP,NNP,5,1
126,119.0,44,attended,8,24,34,10,23,9,-16,26,Chailey School,East Sussex,org-org,-,PROPN-PROPN,PROPN-PROPN,compound-conj,compound-pobj,NNP-NNP,NNP-NNP,11,1
127,120.0,50,In,0,19,28,9,18,21,-19,28,James J. Couzens,Michigan,per-per-per,,PROPN-PROPN-PROPN,PROPN,compound-compound-pobj,compound,NNP-NNP-NNP,NNP,5,1
128,121.0,26,is,3,1,25,24,0,0,2,22,Naresuan,Thailand,org,,PROPN,PROPN,compound,pobj,NNP,NNP,3,1
129,937.0,14,is,4,1,13,12,0,0,3,9,Naresuan,Thailand,per,,PROPN,PROPN,compound,pobj,NNP,NNP,1,1
130,122.0,17,came,3,8,10,2,7,6,-5,7,42 Commando,Royal Marines,-,org-org,NUM-PROPN,PROPN-PROPN,nummod-compound,compound-pobj,CD-NNP,NNP-NNPS,1,1
131,123.0,22,Following,0,8,16,8,7,5,-8,16,Butthole Surfers,Texas,per-per,,PROPN-PROPN,PROPN,compound-compound,pobj,NNP-NNPS,NNP,3,1
132,124.0,11,led,3,2,10,8,1,0,1,7,union,Vietnam,per,,NOUN,PROPN,nsubjpass,pobj,NN,NNP,2,1
133,125.0,22,teaches,2,9,21,12,8,0,-7,19,University of the Arts,Philadelphia,org-org-org-org,,PROPN-ADP-DET-PROPN,PROPN,pobj-prep-det-nmod,pobj,NNP-IN-DT-NNPS,NNP,4,1
134,126.0,23,Inc.,0,5,19,14,4,3,-5,19,Radio Mindanao Network,Philippines,org-org-org,,PROPN-PROPN-PROPN,PROPN,compound-compound-nsubj,pobj,NNP-NNP-NNP,NNPS,5,1
135,127.0,24,is,11,1,18,17,0,5,10,7,Duncan of Jordanstone College of Art and Design,University of Dundee,-------,org-org-org,PROPN-ADP-PROPN-PROPN-ADP-PROPN-CCONJ-PROPN,PROPN-ADP-PROPN,nsubj-prep-compound-pobj-prep-pobj-cc-conj,pobj-prep-pobj,NNP-IN-NNP-NNP-IN-NNP-CC-NNP,NNP-IN-NNP,7,1
136,128.0,48,escalated,5,2,19,17,1,28,3,14,Canada,Bret,,per,PROPN,PROPN,nsubj,compound,NNP,NNP,10,1
137,129.0,65,said,2,11,39,28,10,25,-9,37,Tupac Shakur,Digital Underground,per-per,-,PROPN-PROPN,PROPN-PROPN,compound-poss,compound-pobj,NNP-NNP,NNP-NNP,12,1
138,130.0,22,shot,3,7,13,6,6,8,-4,10,Bill Gwatney,Arkansas Democratic Party,per-per,--,PROPN-PROPN,PROPN-PROPN-PROPN,compound-dobj,compound-compound-pobj,NNP-NNP,NNP-NNP-NNP,5,1
139,131.0,48,ambushed,38,6,13,7,5,34,32,-25,Henry Gurney,Malaya,per-per,,PROPN-PROPN,PROPN,compound-pobj,pobj,NNP-NNP,NNP,2,1
140,132.0,25,are,3,2,14,12,1,10,1,11,Seattle SeaDogs,Continental Indoor Soccer League,-,org-org-org-org,PROPN-PROPN,PROPN-PROPN-PROPN-PROPN,compound-nsubj,compound-compound-compound-pobj,NNP-NNP,NNP-NNP-NNP-NNP,6,1
141,133.0,28,nominated,2,1,10,9,0,17,1,8,She,Pakistan,per,,PRON,PROPN,nsubjpass,compound,PRP,NNP,5,1
142,134.0,33,chosen,2,18,25,7,17,7,-16,23,Claude Pompidou,Georges Pompidou,-,per-per,PROPN-PROPN,PROPN-PROPN,compound-compound,compound-pobj,NNP-NNP,NNP-NNP,4,1
143,135.0,27,signed,1,15,26,11,14,0,-14,25,Catherine of Valois,France,per-per-per,,PROPN-ADP-PROPN,PROPN,appos-prep-pobj,pobj,NNP-IN-NNP,NNP,9,1
144,136.0,20,departed,6,2,3,1,1,16,4,-3,Yemenia,Yemen,org,,PROPN,PROPN,compound,compound,NNP,NNP,1,1
145,137.0,13,is,1,9,12,3,8,0,-8,11,University of Minnesota,USA,org-org-org,,PROPN-ADP-PROPN,PROPN,nmod-prep-pobj,pobj,NNP-IN-NNP,NNP,5,1
146,138.0,30,sentenced,14,1,7,6,0,22,13,-7,Bung Mokhtar Radin,Parliament,per-per-per,,PROPN-PROPN-PROPN,PROPN,compound-compound-nsubjpass,pobj,NNP-NNP-NNP,NNP,3,1
147,139.0,16,released,1,1,14,13,0,1,0,13,Haunts,Black Records,,org-org,NOUN,PROPN-PROPN,nsubj,compound-appos,NNS,NNP-NNPS,3,1
148,140.0,39,took,4,8,27,19,7,11,-4,23,England,he,,per,PROPN,PRON,pobj,nsubj,NNP,PRP,2,1
149,2572.0,32,show,2,8,4,-4,7,27,-6,2,England,he,per,,PROPN,PRON,pobj,nsubj,NNP,PRP,2,1
150,2610.0,17,born,2,7,9,2,6,7,-5,7,England,he,org,,PROPN,PRON,pobj,nsubj,NNP,PRP,1,1
151,141.0,22,became,3,3,11,8,2,10,0,8,he,Virginia,per,,PRON,PROPN,nsubj,pobj,PRP,NNP,3,1
152,142.0,18,is,3,1,11,10,0,6,2,8,Woodlands Community College,Southampton,org-org-org,,PROPN-PROPN-PROPN,PROPN,compound-compound-nsubj,compound,NNP-NNP-NNP,NNP,5,1
153,143.0,18,upgraded,8,2,11,9,1,6,6,3,his,Japan,per,,DET,PROPN,poss,compound,PRP$,NNP,5,1
154,144.0,44,helped,13,3,12,9,2,31,10,-1,De Gasperi,Council,per-per,,PROPN-PROPN,PROPN,compound-poss,compound,NNP-NNP,NNP,3,1
155,145.0,21,chaperones,9,1,6,5,0,14,8,-3,His,Aishwarya Rai,per,-,DET,PROPN-PROPN,poss,compound-appos,PRP$,NNP-NNP,4,1
156,146.0,24,became,11,11,20,9,10,3,0,9,Hawkes,Texas,per,,PROPN,PROPN,pobj,compound,NNP,NNP,5,1
157,147.0,13,was,1,6,12,6,5,0,-5,11,Thomas A. Stewart Secondary School,Peterborough,org-org-org-org-org,,PROPN-PROPN-PROPN-PROPN-PROPN,PROPN,compound-compound-compound-compound-pobj,pobj,NNP-NNP-NNP-NNP-NNP,NNP,5,1
158,148.0,32,was,20,3,10,7,2,21,17,-10,Fischer,Dirty Dirk,per,-,PROPN,PROPN-PROPN,nsubj,compound-compound,NNP,NNP-NNP,5,1
159,149.0,39,told,9,7,27,20,6,11,2,18,Polish National Bank,Poland,org-org-org,,PROPN-PROPN-PROPN,PROPN,compound-compound-pobj,poss,NNP-NNP-NNP,NNP,14,1
160,150.0,35,given,26,2,8,6,1,26,24,-18,Fiji Times,the Australian,org-org,-,PROPN-PROPN,DET-ADJ,compound-nsubj,det-amod,NNP-NNP,DT-JJ,4,1
161,151.0,36,History,2,25,34,9,24,1,-23,32,Fairfield Preparatory School,Leicestershire,--,org,PROPN-PROPN-PROPN,PROPN,compound-compound-appos,compound,NNP-NNP-NNP,NNP,4,1
162,152.0,19,said,7,9,14,5,8,4,-2,7,Petros Christodoulou,Greece,org-org,,PROPN-PROPN,PROPN,compound-nsubj,poss,NNP-NNP,NNP,5,1
163,153.0,27,served,4,12,14,2,11,12,-8,10,Boston University,Terriers,per-per,,PROPN-PROPN,PROPN,compound-compound,pobj,NNP-NNP,NNPS,6,1
164,154.0,36,went,6,10,18,8,9,17,-4,12,Stowe School,Buckinghamshire,org-org,,PROPN-PROPN,PROPN,compound-pobj,pobj,NNP-NNP,NNP,4,1
165,155.0,19,was,12,14,17,3,13,1,-2,5,Centre College,Danville,org-org,,PROPN-PROPN,PROPN,compound-attr,compound,NNP-NNP,NNP,1,1
166,156.0,30,After,0,18,26,8,17,3,-18,26,Ben,ATO,org,,PROPN,PROPN,nsubj,compound,NNP,NNP,3,1
167,157.0,14,met,3,1,13,12,0,0,2,10,Johnny O'Keefe,Australia,per-per,,PROPN-PROPN,PROPN,compound-nsubj,pobj,NNP-NNP,NNP,2,1
168,158.0,17,was,2,8,13,5,7,3,-6,11,White Zombie,Silent Explosion,per-per,-,PROPN-PROPN,PROPN-PROPN,compound-pobj,compound-appos,NNP-NNP,NNP-NNP,5,1
169,159.0,38,told,8,6,8,2,5,29,2,0,Bank of Mexico,Mexico,per-per-per,,PROPN-ADP-PROPN,PROPN,pobj-prep-pobj,poss,NNP-IN-NNP,NNP,4,1
170,160.0,35,wait,4,1,33,32,0,1,3,29,Tori Spelling,Dean McDermott,org-org,-,PROPN-PROPN,PROPN-PROPN,compound-nsubj,compound-appos,NNP-NNP,NNP-NNP,5,1
171,161.0,62,selected,23,19,37,18,18,24,4,14,University of Missouri,NBA Draft,per-per-per,-,PROPN-ADP-PROPN,PROPN-PROPN,pobj-prep-compound,compound-pobj,NNP-IN-NNP,NNP-NNP,10,1
172,162.0,67,Pld,0,40,49,9,39,17,-40,49,Public Bank,Malaysia,-,org,PROPN-PROPN,PROPN,compound-compound,npadvmod,NNP-NNP,NNP,4,1
173,163.0,17,signed,5,3,15,12,2,1,2,10,Black Sabbath,Warner Bros,org-org,-,PROPN-PROPN,PROPN-PROPN,compound-appos,compound-appos,NNP-NNP,NNP-NNP,4,1
174,164.0,41,is,1,32,38,6,31,2,-31,37,Command and General Staff College,Fort Leavenworth,----,org-org,PROPN-CCONJ-PROPN-PROPN-PROPN,PROPN-PROPN,nmod-cc-conj-compound-conj,compound-compound,NNP-CC-NNP-NNP-NNP,NNP-NNP,4,1
175,165.0,54,said,52,4,8,4,3,45,48,-44,Ministry of Justice,Bureau of Investigation,org-org-org,--,PROPN-ADP-PROPN,PROPN-ADP-PROPN,poss-prep-pobj,pobj-prep-pobj,NNP-IN-NNP,NNP-IN-NNP,4,1
176,166.0,32,told,6,3,5,2,2,26,3,-1,Defence,Henk Kamp,org,-,PROPN,PROPN-PROPN,compound,compound-nsubj,NNP,NNP-NNP,1,1
177,167.0,18,returned,5,2,9,7,1,8,3,4,O'Rourke,California,,per,PROPN,PROPN,nsubj,pobj,NNP,NNP,2,1
178,168.0,112,include,7,10,24,14,9,87,-3,17,Affiliated Computer Services,Dallas,per-per-per,,PROPN-PROPN-PROPN,PROPN,amod-compound-dobj,compound,NNP-NNP-NNPS,NNP,4,1
179,169.0,53,nominated,6,15,12,-3,14,40,-9,6,Judge,United States,org,-,PROPN,PROPN-PROPN,attr,compound-compound,NNP,NNP-NNP,2,1
180,170.0,30,made,1,9,12,3,8,17,-8,11,Marshall Islands,Litokwa Tomeing,per-per,-,PROPN-PROPN,PROPN-PROPN,compound-compound,compound-nsubj,NNP-NNP,NNP-NNP,2,1
181,171.0,16,was,6,6,14,8,5,1,0,8,Dru,In Essence,,per-per,PROPN,ADP-PROPN,attr,prep-pobj,NNP,IN-NNP,5,1
182,172.0,45,Puyet,0,1,16,15,0,28,-1,16,Puyet,Spanish,per,,PROPN,ADJ,ROOT,amod,NNP,JJ,5,1
183,173.0,15,was,0,7,10,3,6,4,-7,10,Cameroon,Ahmadou Ahidjo,per,-,PROPN,PROPN-PROPN,poss,compound-appos,NNP,NNP-NNP,5,1
184,174.0,29,reported,2,8,28,20,7,0,-6,26,Giuliano Amato,Italy,-,per,PROPN-PROPN,PROPN,compound-nsubj,pobj,NNP-NNP,NNP,3,1
185,1522.0,30,said,4,3,10,7,2,19,1,6,Giuliano Amato,Italy,org-org,,PROPN-PROPN,PROPN,compound-nsubj,nsubj,NNP-NNP,NNP,4,1
186,175.0,16,is,4,12,14,2,11,1,-8,10,Cashis,Shady,per,,PROPN,PROPN,pobj,compound,NNP,NNP,1,1
187,176.0,43,asked,19,13,16,3,12,26,6,-3,Greenhills School,Ann Arbor,per-per,-,PROPN-PROPN,PROPN-PROPN,compound-pobj,compound-compound,NNP-NNP,NNP-NNP,2,1
188,177.0,48,Italy,1,27,31,4,26,16,-26,30,Unicredit,Creditanstalt,org,,PROPN,PROPN,poss,pobj,NNP,NNP,5,1
189,178.0,22,is,5,5,5,0,4,16,0,0,Illinois,Illinois Army National Guard,,org-org-org-org,PROPN,PROPN-PROPN-PROPN-PROPN,pobj,compound-compound-compound-pobj,NNP,NNP-NNP-NNP-NNP,0,1
190,179.0,34,called,5,1,23,22,0,10,4,18,Israel,Yitzhak Rabin,,org-org,PROPN,PROPN-PROPN,poss,compound-pobj,NNP,NNP-NNP,10,1
191,180.0,14,was,1,8,13,5,7,0,-7,12,CTVglobemedia,Canada,,per,NOUN,PROPN,pobj,dobj,NNS,NNP,5,1
192,181.0,27,said,4,17,18,1,16,8,-13,14,Air China,China,org-org,,PROPN-PROPN,PROPN,compound-appos,compound,NNP-NNP,NNP,2,1
193,182.0,62,said,42,53,60,7,52,1,-11,18,Benjamin N. Cardozo School of Law,New York,-----,org-org,PROPN-PROPN-PROPN-PROPN-ADP-PROPN,PROPN-PROPN,compound-compound-compound-pobj-prep-pobj,compound-pobj,NNP-NNP-NNP-NNP-IN-NNP,NNP-NNP,4,1
194,183.0,26,replace,4,9,13,4,8,12,-5,9,York Region Transit,Viva,org-org-org,,PROPN-PROPN-PROPN,PROPN,compound-compound-poss,nmod,NNP-NNP-NNP,NNP,3,1
195,184.0,19,is,1,1,11,10,0,7,0,10,CNBC-e,Turkey,org,,NOUN,PROPN,nsubj,pobj,NN,NNP,3,1
196,185.0,20,recorded,2,10,16,6,9,3,-8,14,Wisconsin,DeYarmond Edison,org,-,PROPN,PROPN-PROPN,pobj,compound-appos,NNP,NNP-NNP,4,1
197,186.0,26,released,7,5,6,1,4,19,2,-1,artist,Lara Fabian,,org-org,NOUN,PROPN-PROPN,compound,compound-nsubj,NN,NNP-NNP,1,1
198,187.0,21,represents,7,10,19,9,9,1,-3,12,University of the Incarnate Word,United States,----,per-per,PROPN-ADP-DET-PROPN-PROPN,PROPN-PROPN,dobj-prep-det-compound-pobj,compound-pobj,NNP-IN-DT-NNP-NNP,NNP-NNP,5,1
199,188.0,14,is,2,1,5,4,0,8,1,3,Hombres G,Spanish,org-org,,NOUN-PROPN,ADJ,compound-nsubj,amod,NNS-NNP,JJ,3,1
200,189.0,20,suggested,3,2,14,12,1,5,1,11,Abdelaziz Bouteflika,Morocco,per-per,,PROPN-PROPN,PROPN,compound-nsubj,pobj,NNP-NNP,NNP,3,1
201,190.0,40,lived,12,5,8,3,4,31,7,-4,Jack Cassidy,Shirley Jones,per-per,-,PROPN-PROPN,PROPN-PROPN,compound-appos,compound-conj,NNP-NNP,NNP-NNP,1,1
202,191.0,22,were,4,1,20,19,0,1,3,16,Super Extra Bonus Party,Kildare,---,per,PROPN-PROPN-PROPN-PROPN,PROPN,compound-compound-compound-nsubj,compound,NNP-NNP-NNP-NNP,NNP,8,1
203,192.0,41,Kingdom,1,21,21,0,20,19,-20,20,Henri Christophe,Henri,org-org,,PROPN-PROPN,PROPN,compound-pobj,pobj,NNP-NNP,NNP,0,1
204,193.0,41,known,5,8,28,20,7,12,-3,23,Australia,Ruth Cracknell,per,-,PROPN,PROPN-PROPN,pobj,compound-pobj,NNP,NNP-NNP,7,1
205,194.0,16,Departments,0,9,15,6,8,0,-9,15,Royal Free Hospital,UK,--,per,PROPN-PROPN-PROPN,PROPN,compound-compound-conj,ROOT,NNP-NNP-NNP,NNP,6,1
206,195.0,28,extradited,7,4,10,6,3,17,3,3,Alberto Fujimori,Peru,org-org,,PROPN-PROPN,PROPN,compound-nsubjpass,pobj,NNP-NNP,NNP,2,1
207,196.0,18,underwent,5,11,12,1,10,5,-6,7,Sentara Norfolk General Hospital,Norfolk,per-per-per-per,,PROPN-PROPN-PROPN-PROPN,PROPN,compound-compound-compound-pobj,pobj,NNP-NNP-NNP-NNP,NNP,2,1
208,197.0,15,April,1,9,11,2,8,3,-8,10,Yale University,New Haven,org-org,-,PROPN-PROPN,PROPN-PROPN,compound-compound,compound-compound,NNP-NNP,NNP-NNP,2,1
209,198.0,28,forced,3,14,21,7,13,6,-11,18,James K. Polk,Tennessee,org-org-org,,PROPN-PROPN-PROPN,PROPN,compound-compound-pobj,compound,NNP-NNP-NNP,NNP,9,1
210,199.0,18,been,3,8,17,9,7,0,-5,14,Institute for Studies in Theoretical Physics and Mathematics,Tehran,per-per-per-per-per-per-per-per,,PROPN-ADP-PROPN-ADP-PROPN-PROPN-CCONJ-PROPN,PROPN,pobj-prep-pobj-prep-compound-pobj-cc-conj,pobj,NNP-IN-NNPS-IN-NNP-NNP-CC-NNP,NNP,5,1
211,200.0,33,bought,2,1,5,4,0,27,1,3,RedOctane,Activision,org,,PROPN,PROPN,nsubjpass,pobj,NNP,NNP,2,1
212,201.0,34,re-released,4,9,10,1,8,23,-5,6,his,Swami Records,,org-org,DET,PROPN-PROPN,poss,compound-compound,PRP$,NNP-NNPS,2,1
213,202.0,52,helped,3,41,50,9,40,1,-38,47,Mexico,Francisco Madero,,org-org,PROPN,PROPN-PROPN,pobj,compound-dobj,NNP,NNP-NNP,6,1
214,203.0,94,appointed,7,54,61,7,53,32,-47,54,Canadian Forces,Maritime Command,-,per-per,PROPN-PROPN,PROPN-PROPN,compound-pobj,compound-pobj,NNP-NNPS,NNP-NNP,10,1
215,204.0,22,written,8,2,19,17,1,2,6,11,Chiang Kai-shek,Republic,org-org,,PROPN-PROPN,PROPN,compound-compound,pobj,NNP-NNP,NNP,6,1
216,205.0,14,born,2,1,4,3,0,9,1,2,She,Margaret Yvonne Middleton,per,--,PRON,PROPN-PROPN-PROPN,nsubjpass,compound-compound-oprd,PRP,NNP-NNP-NNP,3,1
217,206.0,22,is,7,2,15,13,1,6,5,8,Advanced Technology College,Daytona Beach Florida,per-per-per,--,PROPN-PROPN-PROPN,PROPN-PROPN-PROPN,compound-nmod-nsubj,compound-compound-pobj,NNP-NNP-NNP,NNP-NNP-NNP,5,1
218,207.0,34,Elected,0,8,28,20,7,5,-8,28,Parti,Pauline Marois,org,-,PROPN,PROPN-PROPN,pobj,compound-appos,NNP,NNP-NNP,6,1
219,208.0,24,reached,1,12,15,3,11,8,-11,14,United States,Ciara,-,per,PROPN-PROPN,PROPN,compound-pobj,poss,NNP-NNP,NNP,6,1
220,209.0,78,created,7,6,6,0,5,71,1,-1,Lyon,Lyon,,per,PROPN,PROPN,pobj,pobj,NNP,NNP,0,1
221,210.0,14,founded,2,1,13,12,0,0,1,11,It,Larnaca,org,,PRON,PROPN,nsubjpass,pobj,PRP,NNP,3,1
222,211.0,9,outshines,1,3,5,2,2,3,-2,4,DoCoMo,Japan,org,,PROPN,PROPN,dobj,poss,NNP,NNP,3,1
223,212.0,27,stood,4,7,10,3,6,16,-3,6,Milton Obote,Uganda,org-org,,PROPN-PROPN,PROPN,compound-poss,appos,NNP-NNP,NNP,2,1
224,213.0,17,is,4,1,14,13,0,2,3,10,Briercrest College and Seminary,Caronport,per-per-per-per,,PROPN-PROPN-CCONJ-PROPN,PROPN,compound-nsubj-cc-conj,compound,NNP-NNP-CC-NNP,NNP,4,1
225,214.0,49,left,3,10,19,9,9,29,-7,16,Barak,Israel,org,,PROPN,PROPN,nsubj,compound,NNP,NNP,4,1
226,215.0,34,born,3,1,21,20,0,12,2,18,Anthony Minghella,England,per-per,,PROPN-PROPN,PROPN,compound-nsubjpass,pobj,NNP-NNP,NNP,6,1
227,216.0,46,suggested,3,15,32,17,14,13,-12,29,Royal Air Force,RAF,per-per-per,,PROPN-PROPN-PROPN,PROPN,compound-compound-pobj,nsubj,NNP-NNP-NNP,NNP,6,1
228,217.0,39,dumped,21,11,37,26,10,1,10,16,UDF,Bakili Muluzi,,org-org,PROPN,PROPN-PROPN,compound,compound-appos,NNP,NNP-NNP,11,1
229,218.0,21,won,3,3,11,8,2,9,0,8,Bowles,North Carolina,,per-per,PROPN,PROPN-PROPN,nsubj,compound-pobj,NNP,NNP-NNP,5,1
230,219.0,61,agreed,2,40,44,4,39,16,-38,42,New York,Hunter College,per-per,-,PROPN-PROPN,PROPN-PROPN,compound-pobj,compound-nsubj,NNP-NNP,NNP-NNP,6,1
231,220.0,25,has,2,1,16,15,0,8,1,14,Bishopbriggs,Turnbull High School,org,--,PROPN,PROPN-PROPN-PROPN,nsubj,compound-compound-pobj,NNP,NNP-NNP-NNP,5,1
232,221.0,26,|,1,2,14,12,1,11,-1,13,| Jap,an Ryutaro Hashimo,org-org,--,PROPN-PROPN,DET-PROPN-PROPN,ROOT-ROOT,det-compound-appos,NNP-NNP,DT-NNP-NNP,-1,1
233,222.0,41,refers,3,1,1,0,0,39,2,-2,Victoria,Victoria of the United Kingdom,,per-per-per-per-per,PROPN,PROPN-ADP-DET-PROPN-PROPN,nsubj,pobj-prep-det-compound-pobj,NNP,NNP-IN-DT-NNP-NNP,0,1
234,223.0,39,explained,2,1,13,12,0,25,1,11,Hugo Chavez,Venezuela,-,per,PROPN-PROPN,PROPN,compound-nsubj,poss,NNP-NNP,NNP,8,1
235,224.0,21,guest,2,9,19,10,8,1,-7,17,his,Melanie Griffith,per,-,DET,PROPN-PROPN,poss,compound-pobj,PRP$,NNP-NNP,7,1
236,225.0,26,formed,2,5,17,12,4,8,-3,15,Des Moines,Paul Gray,per-per,-,PROPN-PROPN,PROPN-PROPN,compound-compound,compound-conj,NNP-NNP,NNP-NNP,6,1
237,226.0,25,produced,5,14,20,6,13,4,-9,15,Beeb Birtles,Zoot,-,per,PROPN-PROPN,PROPN,compound-pobj,pobj,NNP-NNPS,NNP,8,1
238,227.0,34,was,2,15,31,16,14,2,-13,29,Japan,n Kyot,per,-,PROPN,CCONJ-PROPN,pobj,subtok-compound,NNP,CC-NNP,7,1
239,228.0,42,holds,1,13,24,11,12,17,-12,23,Pontifical University of St. Thomas Aquinas,Italy,-----,per,PROPN-PROPN-ADP-PROPN-PROPN-PROPN,PROPN,compound-pobj-prep-compound-compound-pobj,pobj,NNP-NNP-IN-NNP-NNP-NNP,NNP,5,1
240,229.0,32,is,2,1,9,8,0,22,1,7,Hybrid Ice,Pennsylvania,org-org,,PROPN-PROPN,PROPN,compound-nsubj,pobj,NNP-NNP,NNP,4,1
241,230.0,15,played,1,12,13,1,11,1,-11,12,AHL,Chicago Wolves,per,-,PROPN,PROPN-NOUN,compound,compound-pobj,NNP,NNP-NNS,1,1
242,231.0,19,retired,5,13,18,5,12,0,-8,13,Walsh University,Ohio,org-org,,PROPN-PROPN,PROPN,compound-pobj,pobj,NNP-NNP,NNP,5,1
243,232.0,56,is,2,33,44,11,32,11,-31,42,Pedro Winter,Ed Banger Records,org-org,--,PROPN-PROPN,PROPN-PROPN-PROPN,compound-conj,nmod-nmod-nmod,NNP-NNP,NNP-NNP-NNPS,7,1
244,233.0,20,attended,5,7,9,2,6,10,-2,4,Cameron University,Oklahoma,per-per,,PROPN-PROPN,PROPN,compound-compound,compound,NNP-NNP,NNP,2,1
245,234.0,19,founded,2,2,8,6,1,10,0,6,Redford,California,,org,PROPN,PROPN,nsubj,pobj,NNP,NNP,2,1
246,235.0,24,is,6,12,23,11,11,0,-6,17,Sheryl Crow,Records,per-per,,PROPN-PROPN,PROPN,compound-pobj,pobj,NNP-NNP,NNPS,4,1
247,236.0,33,review,7,13,15,2,12,17,-6,8,Rembrandt,Dutch,per,,PROPN,PROPN,pobj,compound,NNP,NNP,2,1
248,237.0,28,is,9,1,26,25,0,1,8,17,Adele Khoury Graham,Bob Graham,per-per-per,-,PROPN-PROPN-PROPN,PROPN-PROPN,compound-compound-nsubj,compound-conj,NNP-NNP-NNP,NNP-NNP,5,1
249,238.0,20,served,11,1,5,4,0,14,10,-6,Bridges House,Concord,per-per,,PROPN-PROPN,PROPN,compound-nsubj,pobj,NNP-NNP,NNP,3,1
250,239.0,30,dominates,9,1,18,17,0,11,8,9,Liga Veneta,The People of Freedom,org-org,---,PROPN-PROPN,DET-PROPN-ADP-PROPN,compound-nsubj,det-appos-prep-pobj,NNP-NNP,DT-NNPS-IN-NNP,5,1
251,240.0,18,shot,3,6,16,10,5,1,-3,13,Seventeen,Ann Shoket,org,-,PROPN,PROPN-PROPN,compound,compound-dobj,NNP,NNP-NNP,5,1
252,241.0,39,features,1,35,38,3,34,0,-34,37,Jarvis Cocker,Pulp,org-org,,PROPN-PROPN,PROPN,compound-appos,pobj,NNP-NNP,NNP,2,1
253,242.0,19,decides,10,1,4,3,0,14,9,-6,Sandy Brozinsky,Bette Midler,per-per,-,PROPN-PROPN,PROPN-PROPN,compound-nsubj,compound-appos,NNP-NNP,NNP-NNP,1,1
254,243.0,29,?,0,4,9,5,3,19,-4,9,; Punja,r Amarinder Sing,-,per-per-per,PUNCT-PROPN,NOUN-PROPN-PROPN,punct-nsubj,nummod-compound-appos,:-NNP,NN-NNP-NNP,4,1
255,244.0,41,is,20,1,40,39,0,0,19,20,Philippine Science High School System,Philippines,----,per,PROPN-PROPN-PROPN-PROPN-PROPN,PROPN,compound-compound-compound-compound-pobj,pobj,NNP-NNP-NNP-NNP-NNP,NNP,-1,1
256,245.0,35,received,4,9,13,4,8,21,-5,9,Albania,Enver Hoxha,org,-,PROPN,PROPN-PROPN,poss,compound-appos,NNP,NNP-NNP,3,1
257,246.0,40,announced,8,5,7,2,4,32,3,-1,Odex,Stephen Sing,,per-per,PROPN,PROPN-PROPN,compound,compound-nsubj,NNP,NNP-NNP,1,1
258,247.0,37,was,1,6,19,13,5,17,-5,18,Benjamin Harrison,American,org-org,,PROPN-PROPN,PROPN,compound-compound,compound,NNP-NNP,NNP,6,1
259,248.0,40,In,0,2,9,7,1,30,-2,9,her,United Democrats,per,-,DET,PROPN-PROPN,poss,compound-pobj,PRP$,NNP-NNPS,4,1
260,249.0,33,Corp.,3,1,11,10,0,21,2,8,Las Vegas Sands,Sheldon Adelson,per-per-per,-,PROPN-PROPN-PROPN,PROPN-PROPN,compound-compound-compound,compound-pobj,NNP-NNP-NNPS,NNP-NNP,-1,1
261,250.0,43,was,1,32,36,4,31,6,-31,35,David Levy Yulee,Florida,org-org-org,,PROPN-PROPN-PROPN,PROPN,compound-compound-conj,pobj,NNP-NNP-NNP,NNP,3,1
262,251.0,67,Aman,10,10,20,10,9,46,0,10,Musa Aman,Sabah,per-per,,PROPN-PROPN,PROPN,compound-ROOT,pobj,NNP-NNP,NNP,1,1
263,252.0,26,appointed,2,8,24,16,7,1,-6,22,Conservative,John Major,per,-,PROPN,PROPN-PROPN,compound,compound-pobj,NNP,NNP-NNP,7,1
264,253.0,32,was,5,17,25,8,16,6,-12,20,he,Paris.Newton MacDonald,,per-per,PRON,PROPN-PROPN,nsubj,compound-pobj,PRP,NNP-NNP,5,1
265,254.0,18,were,6,1,13,12,0,4,5,7,Ilaiyaraaja,Indian,per,,PROPN,ADJ,poss,amod,NNP,JJ,7,1
266,255.0,29,include,17,1,17,16,0,11,16,0,Bus,Ulsterbus,per,,PROPN,PROPN,poss,pobj,NNP,NNP,3,1
267,256.0,24,was,18,2,3,1,1,20,16,-15,Emperor,Michael VIII Palaiologos,,org-org-org,PROPN,PROPN-PROPN-PROPN,compound,compound-compound-nsubj,NNP,NNP-NNP-NNP,2,1
268,257.0,22,selected,5,4,17,13,3,4,1,12,Brown,Veterans Affairs,,per-per,PROPN,PROPN-PROPN,nsubjpass,pobj-pobj,NNP,NNP-NNP,5,1
269,258.0,28,retained,7,1,3,2,0,24,6,-4,PAS,Abdul Hadi Awang,per,--,PROPN,PROPN-PROPN-PROPN,compound,compound-compound-nsubj,NNP,NNP-NNP-NNP,2,1
270,259.0,30,During,0,5,11,6,4,18,-5,11,Democratic Kampuchea,Samphan,-,per,ADJ-PROPN,PROPN,compound-pobj,nsubj,JJ-NNP,NNP,-1,1
271,260.0,25,led,1,18,20,2,17,4,-17,19,Rollins College,Tars,-,per,PROPN-PROPN,VERB,compound-compound,pobj,NNP-NNP,VBZ,4,1
272,261.0,31,went,2,1,12,11,0,18,1,10,He,King,org,,PRON,PROPN,nsubj,compound,PRP,NNP,5,1
273,262.0,44,Center,3,2,16,14,1,27,1,13,Tahirih Justice Center,NGO,per-per-per,,PROPN-PROPN-PROPN,PROPN,compound-compound-ROOT,appos,NNP-NNP-NNP,NNP,4,1
274,263.0,31,replaced,24,20,29,9,19,1,4,5,JetBlue,David Neeleman,org,-,PROPN,PROPN-PROPN,poss,compound-dobj,NNP,NNP-NNP,4,1
275,264.0,31,reassigned,8,10,20,10,9,10,-2,12,John G. Rice,he,org-org-org,,PROPN-PROPN-PROPN,PRON,compound-compound-dobj,nsubj,NNP-NNP-NNP,PRP,4,1
276,265.0,27,became,21,8,12,4,7,14,13,-9,1966,University of Bradford,,per-per-per,NUM,PROPN-ADP-PROPN,pobj,dobj-prep-pobj,CD,NNP-IN-NNP,3,1
277,266.0,61,took,11,28,42,14,27,18,-17,31,Syria,Hashim al-Atassi,,org-org,PROPN,PROPN-CCONJ,pobj,compound-pobj,NNP,NNP-CC,6,1
278,2354.0,33,reached,7,19,28,9,18,4,-12,21,Syria,Hashim al-Atassi,per,-,PROPN,PROPN-CCONJ,pobj,compound-pobj,NNP,NNP-CC,7,1
279,267.0,16,consists,2,5,5,0,4,10,-3,3,Landkreditt Bank,Landkreditt,-,per,PROPN-PROPN,PROPN,compound-compound,compound,NNP-NNP,NNP,0,1
280,268.0,17,was,4,1,15,14,0,1,3,11,Bishop Borgess High School,Redford,---,org,PROPN-PROPN-PROPN-PROPN,PROPN,compound-compound-compound-nsubj,compound,NNP-NNP-NNP-NNP,NNP,7,1
281,269.0,18,met,7,10,17,7,9,0,-3,10,Chelsea College of Art and Design,London,org-org-org-org-org-org,,PROPN-PROPN-ADP-PROPN-CCONJ-PROPN,PROPN,compound-pobj-prep-pobj-cc-conj,pobj,NNP-NNP-IN-NNP-CC-NNP,NNP,3,1
282,270.0,40,said,4,1,3,2,0,36,3,-1,Google,Sergey Brin,org,-,PROPN,PROPN-PROPN,compound,compound-appos,NNP,NNP-NNP,1,1
283,271.0,31,include,3,5,7,2,4,23,-2,4,John Curtin,Australia,org-org,,PROPN-PROPN,PROPN,compound-compound,poss,NNP-NNP,NNP,2,1
284,272.0,28,say,1,5,6,1,4,21,-4,5,Southern,California high school,per,--,PROPN,PROPN-ADJ-NOUN,nmod,nmod-amod-compound,NNP,NNP-JJ-NN,3,1
285,273.0,31,Department,1,2,26,24,1,4,-1,25,Department of Building and Housing,e New Zealan,----,org-org-org,PROPN-ADP-PROPN-CCONJ-PROPN,PROPN-PROPN-PROPN,ROOT-prep-pobj-cc-conj,det-nmod-nmod,NNP-IN-NNP-CC-NNP,NNP-NNP-NNP,8,1
286,274.0,44,says,3,37,42,5,36,1,-34,39,Moore,Bruce Willis,org,-,PROPN,PROPN-PROPN,poss,compound-pobj,NNP,NNP-NNP,4,1
287,275.0,23,ran,4,7,12,5,6,10,-3,8,Charles L. McNary,Republican,per-per-per,,PROPN-PROPN-PROPN,ADJ,compound-compound-pobj,amod,NNP-NNP-NNP,JJ,5,1
288,276.0,27,competed,14,14,26,12,13,0,0,12,Outlaws,2001,per,,PROPN,NUM,nsubj,pobj,NNPS,CD,7,1
289,277.0,26,served,5,11,24,13,10,1,-6,19,England,James Callaghan,org,-,PROPN,PROPN-PROPN,pobj,compound-conj,NNP,NNP-NNP,8,1
290,278.0,22,visited,4,2,3,1,1,18,2,-1,President,Kalkot Mataskelekele,,per-per,PROPN,PROPN-PROPN,compound,compound-nsubj,NNP,NNP-NNP,2,1
291,279.0,35,said,20,28,33,5,27,1,-8,13,Japan,Yasuhiro Nakasone,,per-per,PROPN,PROPN-PROPN,poss,compound-pobj,NNP,NNP-NNP,5,1
292,280.0,26,is,11,1,23,22,0,2,10,12,Ryde School with Upper Chine,Isle of Wight,----,per-per-per,PROPN-PROPN-ADP-PROPN-PROPN,PROPN-ADP-PROPN,compound-nsubj-prep-compound-pobj,pobj-prep-pobj,NNP-NNP-IN-NNP-NNP,NNP-IN-NNP,6,1
293,281.0,15,worked,2,9,14,5,8,0,-7,12,TG4,Ireland,org,,PROPN,PROPN,compound,conj,NNP,NNP,6,1
294,282.0,21,served,2,1,12,11,0,8,1,10,Koivisto,Turku,org,,PROPN,PROPN,nsubj,compound,NNP,NNP,3,1
295,283.0,103,located,10,83,85,2,82,17,-73,75,University of Stuttgart,Stuttgart,per-per-per,,PROPN-ADP-PROPN,PROPN,dobj-prep-pobj,compound,NNP-IN-NNP,NNP,1,1
296,2704.0,16,is,8,2,4,2,1,11,6,-4,University of Stuttgart,Stuttgart,per-per-per,,PROPN-ADP-PROPN,PROPN,nsubj-prep-pobj,compound,NNP-IN-NNP,NNP,3,1
297,284.0,33,Savangwongse,4,26,32,6,25,0,-22,28,Mongkut,Debsirindra,org,,PROPN,PROPN,pobj,pobj,NNP,NNP,5,1
298,285.0,21,is,3,1,20,19,0,0,2,17,Hasland Junior School,Derbyshire,per-per-per,,PROPN-PROPN-PROPN,PROPN,compound-compound-nsubj,pobj,NNP-NNP-NNP,NNP,11,1
299,286.0,36,formed,3,7,12,5,6,23,-4,9,Nova Scotia,Joel Plaskett,org-org,-,PROPN-PROPN,PROPN-PROPN,compound-pobj,compound-pobj,NNP-NNP,NNP-NNP,4,1
300,287.0,38,offer,5,22,31,9,21,6,-17,26,Fujio Mitarai,Canon,-,per,PROPN-PROPN,PROPN,compound-nsubj,compound,NNP-NNP,NNP,6,1
301,288.0,22,represented,8,3,17,14,2,4,5,9,Florida Atlantic University,Division I,--,org-org,PROPN-PROPN-PROPN,PROPN-PRON,compound-compound-nmod,compound-compound,NNP-NNP-NNP,NNP-PRP,6,1
302,289.0,49,revealed,9,1,6,5,0,42,8,-3,Anatoly Perminov,Russian Federal Space Agency,-,org-org-org-org,PROPN-PROPN,ADJ-PROPN-PROPN-PROPN,compound-nsubj,compound-compound-compound-pobj,NNP-NNP,JJ-NNP-NNP-NNP,4,1
303,290.0,23,hired,3,6,20,14,5,2,-3,17,Cecil Rhodes,De Beers,-,org-org,PROPN-PROPN,PROPN-PROPN,compound-pobj,compound-compound,NNP-NNP,NNP-NNP,7,1
304,906.0,46,born,3,16,21,5,15,24,-13,18,Cecil Rhodes,De Beers,per-per,-,PROPN-VERB,PROPN-PROPN,compound-nsubj,compound-compound,NNP-VBZ,NNP-NNP,4,1
305,291.0,31,announced,9,6,18,12,5,12,3,9,VimpelCom,Beeline,per,,PROPN,PROPN,appos,amod,NNP,NNP,5,1
306,292.0,28,developed,8,20,26,6,19,1,-12,18,Massachusetts,Sinclair Weeks,,org-org,PROPN,PROPN-PROPN,pobj,compound-conj,NNP,NNP-NNPS,3,1
307,293.0,23,represented,8,3,3,0,2,19,5,-5,Georgia Tech Yellow Jackets,Georgia Institute of Technology,org-org-org-org,---,PROPN-PROPN-PROPN-PROPN,PROPN-PROPN-ADP-PROPN,compound-compound-compound-compound,compound-dobj-prep-pobj,NNP-NNP-NNP-NNPS,NNP-NNP-IN-NNP,0,1
308,294.0,50,presented,6,16,25,9,15,24,-10,19,Singapore,J C Sum,,per-per-per,PROPN,NOUN-PROPN-PROPN,nsubj,compound-compound-dobj,NNP,NN-NNP-NNP,8,1
309,295.0,19,teaches,2,5,9,4,4,9,-3,7,Las Positas College,Livermore,--,org,PROPN-PROPN-PROPN,PROPN,compound-compound-pobj,compound,NNP-NNP-NNP,NNP,3,1
310,296.0,49,is,17,25,32,7,24,16,-8,15,Czech Republic,Paroube,-,per,PROPN-PROPN,PROPN,compound-pobj,pobj,NNP-NNP,NNP,3,1
311,297.0,23,scheduled,17,13,14,1,12,8,4,-3,President,Ismail Omar Guelleh,org,--,PROPN,PROPN-PROPN-PROPN,compound,compound-compound-conj,NNP,NNP-NNP-NNP,2,1
312,298.0,16,named,1,5,14,9,4,1,-4,13,Nebraska,Mike Johanns,,per-per,PROPN,PROPN-PROPN,compound,compound-conj,NNP,NNP-NNP,3,1
313,299.0,20,is,2,10,16,6,9,3,-8,14,Gerald Simpson,A Guy Called Gerald,-,per-per-per-per,PROPN-PROPN,DET-PROPN-PROPN-PROPN,compound-compound,det-nsubj-ROOT-oprd,NNP-NNP,DT-NNP-NNP-NNP,4,1
314,300.0,22,Rtd,2,5,19,14,4,2,-3,17,Khan Sahib HABIBULLAH Khan Marwat,Senate,----,per,PROPN-PROPN-PROPN-PROPN-PROPN,PROPN,compound-compound-compound-compound-nsubjpass,pobj,NNP-NNP-NNP-NNP-NNP,NNP,6,1
315,301.0,30,celebrated,2,6,29,23,5,0,-4,27,Slovakia,Ivan,,per,PROPN,PROPN,dobj,conj,NNP,NNP,7,1
316,302.0,36,visit,4,29,34,5,28,1,-25,30,Taco Bell,California,per-per,,PROPN-PROPN,PROPN,compound-compound,pobj,NNP-NNP,NNP,4,1
317,303.0,21,removed,1,1,15,14,0,5,0,14,Ollivier,France,,per,PROPN,PROPN,nsubj,pobj,NNP,NNP,2,1
318,304.0,24,worked,2,11,18,7,10,5,-9,16,Sweden,Nanne,org,,PROPN,PROPN,pobj,compound,NNP,NNP,2,1
319,305.0,46,were,2,12,41,29,11,4,-10,39,in Singapore,and Sinn,per-per,-,ADP-PROPN,CCONJ-PROPN,prep-pobj,cc-compound,IN-NNP,CC-NNP,-1,1
320,306.0,38,set,4,1,14,13,0,23,3,10,GE Aviation,Engine Alliance,-,per-per,PROPN-PROPN,PROPN-PROPN,compound-nsubj,compound-oprd,NNP-NNP,NNP-NNP,6,1
321,307.0,46,sits,1,34,24,-10,33,21,-33,23,India,Indian Institute of Technology Delhi,per,----,PROPN,PROPN-PROPN-ADP-PROPN-PROPN,pobj,compound-pobj-prep-pobj-appos,NNP,NNP-NNP-IN-NNP-NNP,9,1
322,308.0,19,had,5,1,4,3,0,14,4,-1,Cecil Day-Lewis,Jill Balcon,org-org,-,PROPN-PROPN,PROPN-PROPN,compound-nsubj,compound-conj,NNP-NNP,NNP-NNP,2,1
323,309.0,19,written,7,6,10,4,5,8,1,3,Carpenters,Richard Carpenter,,org-org,PROPN,PROPN-PROPN,pobj,compound-compound,NNPS,NNP-NNP,4,1
324,310.0,23,Whitesides,2,1,21,20,0,1,1,19,George M. Whitesides,Harvard University,--,per-per,PROPN-PROPN-PROPN,PROPN-PROPN,compound-compound-ROOT,compound-pobj,NNP-NNP-NNP,NNP-NNP,5,1
325,311.0,21,was,2,12,15,3,11,5,-10,13,8th Army,Soviet Union,-,per-per,ADJ-PROPN,PROPN-PROPN,amod-pobj,compound-appos,JJ-NNP,NNP-NNP,1,1
326,312.0,42,signed,16,28,34,6,27,7,-12,18,Bow Wow,Columbia,per-per,,PROPN-INTJ,PROPN,compound-intj,compound,NNP-UH,NNP,4,1
327,313.0,23,plans,4,3,15,12,2,7,1,11,Chuck Hagel,Republican,org-org,,PROPN-PROPN,PROPN,compound-nsubj,compound,NNP-NNP,NNP,7,1
328,314.0,35,written,6,28,30,2,27,4,-22,24,Arista,Willie Nile,per,-,PROPN,PROPN-PROPN,compound,compound-pobj,NNP,NNP-NNP,3,1
329,315.0,37,has,2,23,34,11,22,2,-21,32,New Brunswick,University of Moncton,per-per,--,PROPN-PROPN,PROPN-ADP-PROPN,compound-compound,pobj-prep-pobj,NNP-NNP,NNP-IN-NNP,7,1
330,316.0,31,created,2,2,10,8,1,20,0,8,church,Thomas Chalmers,,per-per,NOUN,PROPN-PROPN,nsubj,compound-pobj,NN,NNP-NNP,3,1
331,317.0,25,Italy,0,1,3,2,0,21,-1,3,Italy,Elisa,,org,PROPN,PROPN,ROOT,compound,NNP,NNP,1,1
332,318.0,37,neveru,2,1,13,12,0,23,1,11,Michael Jackson,Motown,org-org,,PROPN-PROPN,PROPN,compound-nsubj,compound,NNP-NNP,NNP,4,1
333,1499.0,36,is,7,4,13,9,3,22,3,6,Michael Jackson,Motown,org-org,,PROPN-PROPN,PROPN,compound-poss,compound,NNP-NNP,NNP,7,1
334,319.0,22,born,2,11,18,7,10,3,-9,16,Prince Leopold of Bavaria,Archduchess Gisela of Austria,---,per-per-per-per,PROPN-PROPN-ADP-PROPN,PROPN-PROPN-ADP-PROPN,compound-pobj-prep-pobj,compound-appos-prep-pobj,NNP-NNP-IN-NNP,NNP-NNP-IN-NNP,2,1
335,320.0,26,created,5,2,11,9,1,14,3,6,1996,Heritage High School,per,--,NUM,PROPN-PROPN-PROPN,pobj,compound-compound-pobj,CD,NNP-NNP-NNP,6,1
336,321.0,24,was,8,1,14,13,0,9,7,6,Humaira Begum,Mohammed Zahir Shah,-,per-per-per,PROPN-PROPN,PROPN-PROPN-PROPN,compound-nsubj,compound-compound-pobj,NNP-NNP,NNP-NNP-NNP,5,1
337,322.0,49,rover,1,11,17,6,10,31,-10,16,Taylor,East Fremantle,,org-org,PROPN,PROPN-PROPN,nsubj,compound-pobj,NNP,NNP-NNP,3,1
338,323.0,67,Because,0,8,9,1,7,57,-8,9,Taipei,Chen Shui-bian,,per-per,PROPN,PROPN-PROPN,compound,compound-pobj,NNP,NNP-NNP,2,1
339,324.0,29,channel,1,12,25,13,11,3,-11,24,Nicktoons,2005,per,,PROPN,NUM,compound,pobj,NNPS,CD,3,1
340,325.0,23,was,5,14,15,1,13,7,-9,10,Israel,Chaim Weizmann,,per-per,PROPN,PROPN-PROPN,compound,compound-pobj,NNP,NNP-NNP,1,1
341,326.0,23,is,10,1,19,18,0,3,9,9,Kuo Chuan Presbyterian Secondary School,Bishan,org-org-org-org-org,,PROPN-PROPN-PROPN-PROPN-PROPN,PROPN,compound-compound-compound-compound-nsubj,compound,NNP-NNP-NNP-NNP-NNP,NNP,3,1
342,327.0,15,is,1,7,12,5,6,2,-6,11,Santiago de Cuba,Cuban National Series,--,per-per-per,PROPN-PROPN-PROPN,PROPN-PROPN-PROPN,compound-compound-pobj,compound-compound-pobj,NNP-NNP-NNP,NNP-NNP-NNP,4,1
343,328.0,115,released,5,19,46,27,18,68,-14,41,Auckland,New Zealand,org,-,PROPN,PROPN-PROPN,pobj,compound-conj,NNP,NNP-NNP,-1,1
344,329.0,29,born,2,5,13,8,4,15,-3,11,London,Winston Churchill,,org-org,PROPN,PROPN-PROPN,pobj,compound-pobj,NNP,NNP-NNP,4,1
345,1332.0,40,said,4,16,28,12,15,11,-12,24,London,Winston Churchill,,org-org,PROPN,PROPN-PROPN,pobj,compound-pobj,NNP,NNP-NNP,5,1
346,330.0,19,served,7,15,17,2,14,1,-8,10,Agriculture,James Wilson,org,-,PROPN,PROPN-PROPN,compound,compound-pobj,NNP,NNP-NNP,1,1
347,331.0,26,elected,6,12,24,12,11,1,-6,18,John Michael McConnell,National Intelligence,--,per-per,PROPN-PROPN-PROPN,PROPN-PROPN,compound-compound-dobj,compound-pobj,NNP-NNP-NNP,NNP-NNP,7,1
348,332.0,8,information,1,4,6,2,3,1,-3,5,Pfizer,Ian Read,,per-per,PROPN,PROPN-PROPN,compound,compound-pobj,NNP,NNP-NNP,3,1
349,333.0,16,located,11,5,14,9,4,1,6,3,Leonard M. Miller School of Medicine,Miami,per-per-per-per-per-per,,PROPN-PROPN-PROPN-PROPN-ADP-PROPN,PROPN,compound-compound-compound-pobj-prep-pobj,compound,NNP-NNP-NNP-NNP-IN-NNP,NNP,5,1
350,334.0,38,is,9,1,26,25,0,11,8,17,University of National and World Economy,Bulgaria,org-org-org-org-org-org,,PROPN-ADP-PROPN-CCONJ-PROPN-PROPN,PROPN,nmod-prep-pobj-cc-conj-nsubj,pobj,NNP-IN-NNP-CC-NNP-NNP,NNP,8,1
351,335.0,29,sent,9,8,15,7,7,13,1,6,Russel,Brooklyn,org,,PROPN,PROPN,pobj,pobj,NNP,NNP,5,1
352,336.0,29,was,10,15,8,-7,14,20,-5,-2,Hideki Tj,of Jap,org-org,-,PROPN-PROPN,ADP-PROPN,compound-pobj,prep-pobj,NNP-NNP,IN-NNP,-1,1
353,337.0,22,The,0,3,21,18,2,0,-3,21,Serie A,Italy,per-per,,PROPN-DET,PROPN,compound-det,pobj,NNP-DT,NNP,6,1
354,338.0,22,played,1,5,7,2,4,14,-4,6,Indiana,IUP,per,,PROPN,PROPN,pobj,appos,NNP,NNP,3,1
355,339.0,44,was,2,9,22,13,8,21,-7,20,Rompetrol,Netherlands,org,,PROPN,PROPN,nmod,pobj,NNP,NNP,-1,1
356,340.0,48,continued,5,32,41,9,31,6,-27,36,Nigerian,Prince Nico Mbarga,,org-org-org,ADJ,PROPN-PROPN-PROPN,amod,compound-compound-pobj,JJ,NNP-NNP-NNP,8,1
357,341.0,31,used,4,8,8,0,7,22,-4,4,Cardiff,Cardiff,org,,PROPN,PROPN,compound,pobj,NNP,NNP,0,1
358,342.0,33,received,12,1,12,11,0,20,11,0,Joy Smith,Manitoba,-,per,PROPN-PROPN,PROPN,compound-nsubj,pobj,NNP-NNP,NNP,1,1
359,343.0,17,been,2,14,15,1,13,1,-12,13,President,Alfredo Palacio,,org-org,PROPN,PROPN-PROPN,compound,compound-pobj,NNP,NNP-NNP,2,1
360,344.0,26,worked,1,18,25,7,17,0,-17,24,Institute of Education,London,per-per-per,,PROPN-ADP-PROPN,PROPN,pobj-prep-pobj,pobj,NNP-IN-NNP,NNP,6,1
361,345.0,18,represented,7,3,3,0,2,14,4,-4,East Carolina Pirates,East Carolina University,--,per-per-per,PROPN-PROPN-PROPN,PROPN-PROPN-PROPN,compound-compound-compound,compound-compound-dobj,NNP-NNP-NNP,NNP-NNP-NNP,0,1
362,346.0,39,politicians,1,9,13,4,8,25,-8,12,Samuel Leonard Tilley,New Brunswick,org-org-org,-,PROPN-PROPN-PROPN,PROPN-PROPN,compound-compound-pobj,compound-poss,NNP-NNP-NNP,NNP-NNP,3,1
363,347.0,28,known,6,2,24,22,1,3,4,18,Victoria University of Manchester,1851,---,org,PROPN-PROPN-ADP-PROPN,NUM,compound-nsubj-prep-pobj,pobj,NNP-NNP-IN-NNP,CD,5,1
364,348.0,25,said,23,19,20,1,18,4,4,-3,Australia,RBA,per,,PROPN,PROPN,compound,compound,NNP,NNP,1,1
365,349.0,46,had,3,27,36,9,26,9,-24,33,United Kingdom,Andrew Bonar Law,org-org,--,PROPN-PROPN,PROPN-PROPN-PROPN,compound-compound,compound-compound-nsubj,NNP-NNP,NNP-NNP-NNP,5,1
366,350.0,15,is,4,6,14,8,5,0,-2,10,T T Supermarket,Richmond,--,org,NOUN-NOUN-NOUN,PROPN,compound-compound-attr,pobj,NN-NN-NN,NNP,6,1
367,351.0,27,Knox,0,1,26,25,0,0,-1,26,Knox,Boston,,per,PROPN,PROPN,ROOT,pobj,NNP,NNP,8,1
368,352.0,12,acquired,4,3,10,7,2,1,1,6,Procter Gamble,Wella,org-org,,PROPN-PROPN,PROPN,compound-nsubj,compound,NNP-NNP,NNP,4,1
369,353.0,32,says,21,16,19,3,15,12,5,-2,Rollins College,Winter Park,per-per,-,PROPN-PROPN,PROPN-PROPN,compound-pobj,compound-compound,NNP-NNP,NNP-NNP,3,1
370,354.0,28,put,3,11,24,13,10,3,-8,21,Luke Kelly,Dublin,org-org,,PROPN-PROPN,PROPN,compound-dobj,pobj,NNP-NNP,NNP,5,1
371,355.0,23,is,10,10,16,6,9,6,0,6,Burns,Montana,org,,PROPN,PROPN,nsubj,nsubj,NNP,NNP,2,1
372,356.0,15,is,3,10,14,4,9,0,-7,11,John Radcliffe Hospital,England,per-per-per,,PROPN-PROPN-PROPN,PROPN,compound-compound-compound,pobj,NNP-NNP-NNP,NNP,5,1
373,357.0,11,is,4,1,4,3,0,6,3,0,Spain,Telecinco,per,,PROPN,PROPN,poss,nsubj,NNP,NNP,3,1
374,358.0,20,located,7,17,19,2,16,0,-10,12,GPTC,17,org,,PROPN,NUM,compound,nummod,NNP,CD,4,1
375,359.0,26,said,22,5,17,12,4,8,17,-5,Popescu-Tariceanu,National Liberal Party,,org-org-org,PROPN,PROPN-PROPN-PROPN,nsubj,compound-compound-pobj,NNP,NNP-NNP-NNP,8,1
376,360.0,12,was,1,7,11,4,6,0,-6,10,Brazilian Communist Party,1922,org-org-org,,PROPN-PROPN-PROPN,NUM,compound-compound-pobj,pobj,NNP-NNP-NNP,CD,5,1
377,361.0,20,posted,4,1,3,2,0,16,3,-1,Horde,Jayson Sherlock,,org-org,NOUN,PROPN-PROPN,compound,compound-nsubj,NN,NNP-NNP,1,1
378,362.0,34,attempted,18,1,6,5,0,27,17,-12,Gaston Flosse,President,org-org,,PROPN-PROPN,PROPN,compound-nsubj,oprd,NNP-NNP,NNP,3,1
379,363.0,18,elected,4,3,13,10,2,4,1,9,Robinson,London,,per,PROPN,PROPN,nsubjpass,pobj,NNP,NNP,5,1
380,364.0,32,hailed,13,1,4,3,0,27,12,-9,Italian,Roberto Maroni,per,-,ADJ,PROPN-PROPN,amod,compound-nsubj,JJ,NNP-NNP,2,1
381,365.0,19,was,10,1,18,17,0,0,9,8,Jean Gascon,administrator,per-per,,PROPN-PROPN,NOUN,compound-nsubj,conj,NNP-NNP,NN,2,1
382,366.0,36,launched,13,29,32,3,28,3,-16,19,National Children,Tallaght,-,per,PROPN-PROPN,PROPN,compound-compound,dobj,NNP-NNP,NNP,3,1
383,367.0,39,said,30,25,7,-18,24,31,5,-23,Martin,Puerto Rico,per,-,PROPN,PROPN-PROPN,appos,compound-pobj,NNP,NNP-NNP,8,1
384,368.0,32,directed,13,3,9,6,2,22,10,-4,Uxbridge,Keith Park,org,-,PROPN,PROPN-PROPN,nmod,compound-nsubj,NNP,NNP-NNP,4,1
385,369.0,19,said,3,2,14,12,1,4,1,11,Toots Hibbert,Jamaica,per-per,,PROPN-PROPN,PROPN,compound-nsubj,pobj,NNPS-NNP,NNP,7,1
386,370.0,28,confirmed,1,17,20,3,16,7,-16,19,National Bolshevik Party,Eduard Limonov,org-org-org,-,PROPN-PROPN-PROPN,PROPN-PROPN,compound-compound-compound,compound-pobj,NNP-NNP-NNP,NNP-NNP,3,1
387,371.0,44,were,4,7,10,3,6,33,-3,6,George Abela,Malta,per-per,,PROPN-PROPN,PROPN,compound-attr,pobj,NNP-NNP,NNP,1,1
388,372.0,19,played,1,13,13,0,12,5,-12,12,Pulaski High School,Pulaski,org-org-org,,PROPN-PROPN-PROPN,PROPN,compound-compound-pobj,compound,NNP-NNP-NNP,NNP,0,1
389,373.0,29,named,1,4,13,9,3,15,-3,12,William H. Seward,New York,per-per-per,-,PROPN-PROPN-PROPN,PROPN-PROPN,compound-compound-pobj,compound-pobj,NNP-NNP-NNP,NNP-NNP,-1,1
390,374.0,28,established,4,22,26,4,21,1,-18,22,GCap Media,Global Radio,org-org,-,PROPN-PROPN,PROPN-PROPN,compound-pobj,compound-conj,NNP-NNP,NNP-NNP,1,1
391,375.0,35,said,5,4,18,14,3,16,1,13,Albert Ho,Hong Kong,per-per,-,PROPN-PROPN,PROPN-PROPN,compound-nsubj,compound-poss,NNP-NNP,NNP-NNP,6,1
392,376.0,28,endorse,24,6,9,3,5,18,18,-15,Franklin Foer,The New Republic,-,org-org-org,PROPN-PROPN,DET-PROPN-PROPN,compound-attr,det-compound-pobj,NNP-NNP,DT-NNP-NNP,3,1
393,377.0,21,was,2,10,18,8,9,2,-8,16,Venezuela,Antonio,per,,PROPN,PROPN,compound,pobj,NNP,NNP,4,1
394,378.0,25,lawyer,4,13,22,9,12,2,-9,18,he,Ontario,,org,PRON,PROPN,nsubj,pobj,PRP,NNP,6,1
395,379.0,17,welcomed,7,1,15,14,0,1,6,8,Sonthi,Democrat Party,,per-per,PROPN,PROPN-PROPN,poss,compound-pobj,NNP,NNP-NNP,8,1
396,380.0,25,is,9,8,16,8,7,8,1,7,PICS,University of Central Punjab,per,---,PROPN,PROPN-ADP-PROPN-PROPN,appos,pobj-prep-compound-pobj,NNP,NNP-IN-NNP-NNP,6,1
397,381.0,70,wrote,3,39,55,16,38,14,-36,52,Shakespears Sister,London,per-per,,PROPN-PROPN,PROPN,compound-conj,pobj,NNPS-NNP,NNP,15,1
398,382.0,19,is,4,1,9,8,0,9,3,5,Boca Juniors,Club Boca Juniors,-,org-org-org,PROPN-PROPN,PROPN-PROPN-PROPN,compound-compound,compound-compound-compound,NNP-NNP,NNP-NNP-NNP,7,1
399,383.0,28,obtained,2,2,7,5,1,20,0,5,EastLink,Canada,per,,PROPN,PROPN,nsubj,pobj,NNP,NNP,6,1
400,384.0,26,is,1,1,4,3,0,21,0,3,Teemu,guitarist,,org,PROPN,NOUN,nsubj,attr,NNP,NN,2,1
401,385.0,57,born,3,40,7,-33,39,49,-37,4,Massey University,Palmerston North,org-org,-,PROPN-PROPN,PROPN-PROPN,compound-compound,compound-pobj,NNP-NNP,NNP-NNP,7,1
402,386.0,21,held,1,1,11,10,0,9,0,10,He,Governor,per,,PRON,PROPN,nsubj,poss,PRP,NNP,5,1
403,387.0,14,based,3,1,9,8,0,4,2,6,Quantel,Newbury,org,,PROPN,PROPN,nsubjpass,compound,NNP,NNP,4,1
404,388.0,22,born,2,12,15,3,11,6,-10,13,Gena Rowlands,Greek-American,per-per,,PROPN-PROPN,ADJ,compound-pobj,amod,NNP-NNP,JJ,2,1
405,389.0,28,is,1,1,21,20,0,6,0,20,Grae,New York,org,-,PROPN,PROPN-PROPN,nsubj,compound-poss,NNP,NNP-NNP,5,1
406,390.0,49,appeared,4,24,28,4,23,20,-20,24,Special Action Force,SAF,per-per-per,,PROPN-PROPN-PROPN,PROPN,compound-compound-appos,conj,NNP-NNP-NNP,NNP,3,1
407,391.0,67,joined,3,55,62,7,54,4,-52,59,Tyrone Guthrie,Ireland,per-per,,PROPN-PROPN,PROPN,compound-pobj,poss,NNP-NNP,NNP,4,1
408,392.0,31,created,7,15,26,11,14,4,-8,19,Coors,Molson Coors Brewing Company,org,---,PROPN,PROPN-PROPN-PROPN-PROPN,compound,compound-compound-compound-pobj,NNP,NNP-NNP-NNP-NNP,6,1
409,393.0,60,awarded,5,40,44,4,39,15,-35,39,Medgar Evers College,Brooklyn,per-per-per,,PROPN-PROPN-PROPN,PROPN,compound-compound-pobj,pobj,NNP-NNPS-NNP,NNP,2,1
410,394.0,60,despatched,1,38,58,20,37,1,-37,57,13th Airborne Division,Army,--,org,ADJ-PROPN-PROPN,PROPN,compound-compound-pobj,compound,JJ-NNP-NNP,NNP,7,1
411,395.0,12,won,3,3,6,3,2,5,0,3,he,Sydney,org,,PRON,PROPN,nsubj,compound,PRP,NNP,1,1
412,396.0,45,was,26,14,37,23,13,7,12,11,Cash,Columbia,,org,PROPN,PROPN,poss,pobj,NNP,NNP,12,1
413,397.0,32,In,0,6,16,10,5,15,-6,16,Blue Network,ABC,per-per,,PROPN-PROPN,PROPN,compound-nsubjpass,attr,NNP-NNP,NNP,5,1
414,398.0,32,felt,8,18,22,4,17,9,-10,14,People's Justice Party,PKR,per-per-per,,PROPN-PROPN-PROPN,PROPN,compound-compound-nsubj,appos,NNP-NNP-NNP,NNP,3,1
415,399.0,25,say,3,1,8,7,0,16,2,5,Chrysler,Robert Nardelli,,org-org,PROPN,PROPN-PROPN,nsubj,compound-appos,NNP,NNP-NNP,4,1
416,400.0,39,indicated,4,26,6,-20,25,32,-22,2,California,he,,org,PROPN,PRON,pobj,nsubj,NNP,PRP,6,1
417,401.0,37,needs,8,10,36,26,9,0,-2,28,BULGARI,1884,org,,PROPN,NUM,dobj,pobj,NNP,CD,9,1
418,402.0,14,served,1,1,7,6,0,6,0,6,He,Afghanistan,,per,PRON,PROPN,nsubj,pobj,PRP,NNP,3,1
419,403.0,15,is,5,1,14,13,0,0,4,9,Booker T. Washington High School,Virginia,org-org-org-org-org,,PROPN-PROPN-PROPN-PROPN-PROPN,PROPN,compound-compound-compound-compound-nsubj,appos,NNP-NNP-NNP-NNP-NNP,NNP,3,1
420,404.0,22,called,1,1,9,8,0,12,0,8,He,Arizona State Sun Devils baseball,per,----,PRON,PROPN-PROPN-PROPN-PROPN-NOUN,nsubj,compound-compound-compound-compound-dobj,PRP,NNP-NNP-NNP-NNP-NN,3,1
421,405.0,49,include,3,8,20,12,7,28,-5,17,Japan,n which famous,org,--,PROPN,CCONJ-DET-ADJ,poss,amod-det-amod,NNP,CC-WDT-JJ,10,1
422,406.0,23,studied,4,4,9,5,3,13,0,5,Edinburgh,Allan Ramsay,,org-org,PROPN,PROPN-PROPN,pobj,compound-pobj,NNP,NNP-NNP,2,1
423,407.0,36,voted,1,7,21,14,6,14,-6,20,Philippe,France,,per,PROPN,PROPN,pobj,pobj,NNP,NNP,9,1
424,695.0,39,be,4,6,17,11,5,21,-2,13,Philippe,France,,per,PROPN,PROPN,attr,compound,NNP,NNP,6,1
425,408.0,30,made,1,6,20,14,5,9,-5,19,actor,William Thomas,,per-per,NOUN,PROPN-PROPN,nsubj,compound-poss,NN,NNP-NNP,8,1
426,409.0,19,said,7,4,6,2,3,12,3,-1,AFSCME,Gerald McEntee,per,-,PROPN,PROPN-PROPN,compound,compound-pobj,NNP,NNP-NNP,1,1
427,410.0,30,suffered,5,1,22,21,0,7,4,17,Burma,Soe Win,,per-per,PROPN,PROPN-PROPN,nsubj,compound-pobj,NNP,NNP-NNP,6,1
428,411.0,23,named,3,6,13,7,5,9,-3,10,Walter S. Gurnee,Chicago,org-org-org,,PROPN-PROPN-PROPN,PROPN,compound-compound-pobj,pobj,NNP-NNP-NNP,NNP,3,1
429,1474.0,31,served,18,1,23,22,0,7,17,5,Walter S. Gurnee,Chicago,org-org-org,,PROPN-PROPN-PROPN,PROPN,compound-compound-nsubj,pobj,NNP-NNP-NNP,NNP,5,1
430,412.0,25,served,11,1,18,17,0,6,10,7,William Emmett Dever,Chicago,--,per,PROPN-PROPN-PROPN,PROPN,compound-compound-nsubj,compound,NNP-NNP-NNP,NNP,7,1
431,413.0,22,born,2,5,8,3,4,13,-3,6,Venezuela,Mendoza,per,,PROPN,PROPN,pobj,appos,NNP,NNP,3,1
432,414.0,24,born,2,1,12,11,0,11,1,10,Wolf,London,per,,PROPN,PROPN,nsubjpass,pobj,NNP,NNP,4,1
433,415.0,76,was,22,54,59,5,53,16,-32,37,team,Universal Music,,per-per,NOUN,PROPN-PROPN,pobj,compound-compound,NN,NNP-NNP,3,1
434,416.0,20,joined,3,8,11,3,7,8,-5,8,Georgia,William DuVall,per,-,PROPN,PROPN-PROPN,pobj,compound-compound,NNP,NNP-NNP,2,1
435,417.0,19,received,15,5,8,3,4,10,10,-7,Korn,Reginald Arvizu,per,-,PROPN,PROPN-PROPN,poss,compound-dobj,NNP,NNP-NNP,3,1
436,418.0,70,became,9,44,60,16,43,9,-35,51,England,Terry Hollands,,per-per,PROPN,PROPN-PROPN,poss,compound-pobj,NNP,NNP-NNP,4,1
437,419.0,38,was,3,6,24,18,5,13,-3,21,Hua,Chinese,,per,PROPN,PROPN,poss,pobj,NNP,NNPS,9,1
438,420.0,22,has,1,1,8,7,0,13,0,7,Rotherham,Thomas Rotherham,,per-per,PROPN,PROPN-PROPN,nsubj,compound-compound,NNP,NNP-NNP,3,1
439,421.0,29,is,8,18,24,6,17,4,-10,16,r FK Zemu,e Serbian League Belgrad,per-per-per,---,NOUN-PROPN-PROPN,PROPN-PROPN-PROPN-PROPN,pobj-compound-compound,det-compound-compound-compound,NN-NNP-NNP,NNP-NNP-NNP-NNP,7,1
440,422.0,18,born,2,1,10,9,0,7,1,8,Makatsch,German,,org,PROPN,ADJ,nsubjpass,amod,NNP,JJ,7,1
441,423.0,25,co-founded,7,4,9,5,3,15,3,2,Madden,MADMUSE,,org,PROPN,PROPN,poss,dobj,NNP,NNP,6,1
442,424.0,20,born,3,1,1,0,0,18,2,-2,Florence Stanley,Florence Schwartz,per-per,-,PROPN-PROPN,PROPN-PROPN,compound-nsubjpass,compound-pobj,NNP-NNP,NNP-NNP,0,1
443,425.0,32,saying,7,5,30,25,4,1,2,23,Hudson,Chicago,per,,PROPN,PROPN,compound,compound,NNP,NNP,12,1
444,426.0,46,said,1,27,39,12,26,6,-26,38,e Pakista,d Nawa,per-per,-,PROPN-PROPN,ADJ-PROPN,nmod-nmod,det-compound,NNP-NNP,JJ-NNP,-1,1
445,427.0,34,was,10,1,23,22,0,10,9,13,Paolo Boselli,Italy,per-per,,PROPN-PROPN,PROPN,compound-nsubj,pobj,NNP-NNP,NNP,6,1
446,428.0,20,is,6,5,11,6,4,8,1,5,SHU,South Yorkshire,,per-per,PROPN,PROPN-PROPN,appos,compound-compound,NNP,NNP-NNP,6,1
447,429.0,22,was,12,1,11,10,0,10,11,-1,Manuel Ramil,Spain,per-per,,PROPN-PROPN,PROPN,compound-nsubj,pobj,NNP-NNP,NNP,1,1
448,430.0,48,are,5,42,46,4,41,1,-37,41,Northern Rock,Ron Sandler,org-org,-,PROPN-PROPN,PROPN-PROPN,compound-compound,compound-nsubj,NNP-NNP,NNP-NNP,2,1
449,431.0,16,moved,4,1,3,2,0,12,3,-1,Texas,Otis Williams,per,-,PROPN,PROPN-PROPN,compound,compound-nsubj,NNP,NNP-NNP,1,1
450,432.0,23,is,2,2,14,12,1,8,0,12,he,Sabah,org,,PRON,PROPN,nsubj,pobj,PRP,NNP,1,1
451,433.0,21,was,2,7,20,13,6,0,-5,18,Sarah Siddons,London,-,per,PROPN-PROPN,PROPN,compound-appos,pobj,NNP-NNPS,NNP,4,1
452,434.0,15,is,1,1,14,13,0,0,0,13,BuzzTracker,Yahoo,per,,PROPN,PROPN,nsubj,pobj,NNP,NNP,1,1
453,435.0,14,called,2,5,7,2,4,6,-3,5,Singapore,Wee Kim Wee,per,--,PROPN,PROPN-PROPN-PROPN,compound,compound-compound-pobj,NNP,NNP-NNP-NNP,2,1
454,436.0,23,made,10,5,8,3,4,14,5,-2,Pakistani,Haider,,org,ADJ,PROPN,amod,nsubj,JJ,NNP,6,1
455,437.0,23,rely,7,3,5,2,2,17,4,-2,Japan,Nippon Steel,,per-per,PROPN,PROPN-PROPN,pobj,compound-compound,NNP,NNP-NNP,2,1
456,438.0,50,had,7,27,33,6,26,16,-20,26,Honduras,Morazan,org,,PROPN,PROPN,nsubj,nsubj,NNP,NNP,-1,1
457,439.0,32,is,0,8,25,17,7,6,-8,25,Hungary,his,,per,PROPN,DET,pobj,poss,NNP,PRP$,6,1
458,440.0,46,provided,2,1,1,0,0,44,1,-1,Reno Air,Reno,-,org,PROPN-PROPN,PROPN,compound-nsubj,compound,NNP-NNP,NNP,0,1
459,441.0,25,was,3,1,18,17,0,6,2,15,John Singleton Copley,Boston,--,per,PROPN-PROPN-PROPN,PROPN,compound-compound-nsubj,pobj,NNP-NNP-NNP,NNP,5,1
460,442.0,26,is,6,12,18,6,11,7,-6,12,J. Reuben Clark Law School,Brigham Young University,----,per-per-per,PROPN-PROPN-PROPN-PROPN-PROPN,PROPN-PROPN-PROPN,compound-compound-compound-compound-pobj,compound-compound-pobj,NNP-NNP-NNP-NNP-NNP,NNP-NNP-NNP,4,1
461,443.0,14,is,1,7,11,4,6,2,-6,10,Essex Senior League,Bowers Pitsea F.C,org-org-org,--,PROPN-PROPN-PROPN,PROPN-PROPN-PROPN,compound-compound-compound,compound-compound-pobj,NNP-NNP-NNP,NNP-NNP-NNP,4,1
462,444.0,23,said,10,13,17,4,12,5,-3,7,Richard Branson,Virgin Galactic,per-per,-,PROPN-PROPN,PROPN-PROPN,compound-nsubj,compound-appos,NNP-NNP,NNP-NNP,3,1
463,445.0,38,born,13,9,11,2,8,26,4,-2,Soviet Union,Mikhail Gorbachev,-,org-org,PROPN-PROPN,PROPN-PROPN,compound-compound,compound-pobj,NNP-NNP,NNP-NNP,1,1
464,1942.0,27,says,3,17,20,3,16,6,-14,17,Soviet Union,Mikhail Gorbachev,per-per,-,PROPN-PROPN,PROPN-PROPN,compound-pobj,compound-nsubj,NNP-NNP,NNP-NNP,7,1
465,446.0,20,is,2,1,16,15,0,3,1,14,Imberhorne School,West Sussex,org-org,-,PROPN-PROPN,PROPN-PROPN,compound-nsubj,compound-pobj,NNP-NNP,NNP-NNP,7,1
466,447.0,19,is,7,13,18,5,12,0,-6,11,Biola University,CA,-,org,PROPN-PROPN,PROPN,compound-pobj,pobj,NNP-NNP,NNP,4,1
467,448.0,35,lost,4,4,13,9,3,21,0,9,university,Wales,,per,NOUN,PROPN,nsubj,pobj,NN,NNP,2,1
468,449.0,20,continue,10,3,9,6,2,10,7,-1,Tokio,Japan,org,,PROPN,PROPN,compound,pobj,NNP,NNP,2,1
469,450.0,32,negotiated,6,3,15,12,2,16,3,9,Cisco Systems,Linksys,org-org,,PROPN-PROPN,PROPN,compound-nsubj,compound,NNP-NNPS,NNP,7,1
470,451.0,28,opened,5,3,12,9,2,15,2,7,Five Guys,Virginia,org-org,,NUM-PROPN,PROPN,compound-compound,pobj,CD-NNP,NNP,3,1
471,452.0,36,died,25,1,17,16,0,18,24,-8,Abdurrahman Wahid,Indonesia,-,per,PROPN-PROPN,PROPN,compound-nsubj,poss,NNP-NNP,NNP,6,1
472,453.0,46,called,10,2,6,4,1,39,8,-4,NBER,Martin Feldstein,org,-,PROPN,PROPN-PROPN,compound,compound-pobj,NNP,NNP-NNP,3,1
473,454.0,46,studied,1,12,23,11,11,22,-11,22,Austria,Danube University Krems,,org-org-org,PROPN,PROPN-PROPN-PROPN,appos,compound-compound-pobj,NNP,NNP-NNP-NNPS,8,1
474,455.0,24,is,3,13,22,9,12,1,-10,19,Kenny Burrell,Prestige,org-org,,PROPN-PROPN,PROPN,compound-conj,compound,NNP-NNP,NNP,4,1
475,456.0,29,released,7,4,9,5,3,19,3,2,Interscope Records,Bush,per-per,,PROPN-PROPN,PROPN,compound-pobj,poss,NNP-NNPS,NNP,4,1
476,457.0,35,is,1,14,18,4,13,16,-13,17,Western Carolina University,Cullowhee,--,per,PROPN-PROPN-PROPN,PROPN,compound-compound-pobj,pobj,NNP-NNP-NNP,NNP,3,1
477,458.0,12,escort,3,5,10,5,4,1,-2,7,Barbara Stanwyck,Robert Taylor,-,org-org,PROPN-PROPN,PROPN-PROPN,compound-dobj,compound-pobj,NNP-NNP,NNP-NNP,4,1
478,459.0,70,United,23,15,18,3,14,51,8,-5,USA,American Friends Service Committee,per,---,PROPN,PROPN-PROPN-PROPN-PROPN,pobj,compound-compound-compound-compound,NNP,NNP-NNP-NNP-NNP,4,1
479,460.0,22,is,4,2,9,7,1,12,2,5,center,Baghdad,,per,NOUN,PROPN,poss,nsubj,NN,NNP,5,1
480,461.0,34,band,3,9,29,20,8,4,-6,26,Newcastle,Ben Gillies,org,-,PROPN,PROPN-PROPN,compound,compound-conj,NNP,NNP-NNP,-1,1
481,462.0,49,is,15,13,25,12,12,23,2,10,Mexico City,National Autonomous University of Mexico,per-per,----,PROPN-PROPN,PROPN-PROPN-PROPN-ADP-PROPN,compound-pobj,compound-compound-pobj-prep-pobj,NNP-NNP,NNP-NNP-NNP-IN-NNP,11,1
482,463.0,30,thumb,0,3,8,5,2,21,-3,8,John Howard,Encinitas,-,org,PROPN-PROPN,PROPN,compound-nsubj,compound,NNP-NNP,NNP,3,1
483,464.0,32,reported,10,5,9,4,4,22,5,-1,Interior,Mario Scelba,org,-,PROPN,PROPN-PROPN,pobj,compound-appos,NNP,NNP-NNP,2,1
484,465.0,35,stated,2,1,5,4,0,29,1,3,Wen,China,,per,PROPN,PROPN,nsubj,nsubj,NNP,NNP,3,1
485,466.0,41,is,9,1,24,23,0,16,8,15,Arizona Federal Credit Union,Phoenix,---,org,PROPN-PROPN-PROPN-PROPN,PROPN,compound-compound-compound-nsubj,compound,NNP-NNP-NNP-NNP,NNP,6,1
486,467.0,19,born,13,3,9,6,2,9,10,-4,Sido,Aggro Berlin,per,-,PROPN,PROPN-PROPN,nsubjpass,compound-compound,NNP,NNP-NNP,5,1
487,468.0,29,gave,4,2,11,9,1,17,2,7,Stephen A. Douglas,Illinois,--,per,PROPN-PROPN-PROPN,PROPN,compound-compound-nsubj,compound,NNP-NNP-NNP,NNP,6,1
488,1634.0,41,use,2,22,34,12,21,6,-20,32,Stephen A. Douglas,Illinois,org-org-org,,PROPN-PROPN-PROPN,PROPN,compound-compound-conj,poss,NNP-NNP-NNP,NNP,11,1
489,469.0,27,founded,2,1,7,6,0,19,1,5,AIG,1919,per,,PROPN,NUM,nsubjpass,pobj,NNP,CD,2,1
490,470.0,22,led,1,9,13,4,8,8,-8,12,he,Algeria,org,,PRON,PROPN,nsubjpass,poss,PRP,NNP,5,1
491,471.0,23,scored,2,10,20,10,9,2,-8,18,United States,Diamond,per-per,,PROPN-PROPN,PROPN,compound-nsubj,compound,NNP-NNP,NNP,4,1
492,472.0,25,is,3,12,12,0,11,12,-9,9,Portland State University,Portland,per-per-per,,PROPN-PROPN-PROPN,PROPN,compound-compound-pobj,compound,NNP-NNP-NNP,NNP,0,1
493,473.0,32,report,1,18,15,-3,17,16,-17,14,Stockwell Day,Canadian,org-org,,PROPN-PROPN,ADJ,compound-pobj,amod,NNP-NNP,JJ,2,1
494,474.0,50,For,0,30,49,19,29,0,-30,49,Pedro Aguirre Cerda,Chile,per-per-per,,PROPN-PROPN-PROPN,PROPN,compound-compound-dobj,pobj,NNP-NNP-NNP,NNP,6,1
495,475.0,26,bildenden,13,7,11,4,6,14,6,-2,Josef Mikl,Vienna,-,org,PROPN-PROPN,PROPN,compound-conj,compound,NNP-NNP,NNP,6,1
496,476.0,51,emerged,1,38,42,4,37,8,-37,41,Los Angeles,Michael D. Antonovich,org-org,--,PROPN-PROPN,PROPN-PROPN-PROPN,compound-compound,compound-compound-conj,NNP-NNP,NNP-NNP-NNP,5,1
497,477.0,20,is,2,1,4,3,0,15,1,2,Ittiam Systems,India,per-per,,PROPN-PROPN,PROPN,compound-nsubj,poss,NNP-NNP,NNP,4,1
498,478.0,20,Title,0,6,14,8,5,5,-6,14,Pensacola Junior College,United States,per-per-per,-,PROPN-PROPN-PROPN,PROPN-PROPN,compound-compound-ROOT,compound-nsubj,NNP-NNP-NNP,NNP-NNP,6,1
499,479.0,47,founded,4,2,7,5,1,39,2,3,Adventist Review,James,per-per,,PROPN-PROPN,PROPN,compound-nsubjpass,pobj,NNP-NNP,NNP,4,1
500,480.0,27,is,1,12,16,4,11,10,-11,15,United States,James Buchanan,-,per-per,PROPN-PROPN,PROPN-PROPN,compound-pobj,compound-pobj,NNP-NNP,NNP-NNP,7,1
501,481.0,36,represents,7,2,18,16,1,17,5,11,Denmark national football team,Danish Football Association,org-org-org-org,--,PROPN-ADJ-NOUN-NOUN,PROPN-PROPN-PROPN,nmod-amod-compound-nsubj,compound-compound-pobj,NNP-JJ-NN-NN,NNP-NNP-NNP,6,1
502,482.0,24,gained,20,8,14,6,7,9,12,-6,Oakland,Richie Rich,org,-,PROPN,PROPN-PROPN,compound,nmod-appos,NNP,NNP-NNP,7,1
503,483.0,40,told,26,10,7,-3,9,32,16,-19,Scranton,my,org,,PROPN,DET,pobj,poss,NNP,PRP$,5,1
504,484.0,26,continued,2,1,24,23,0,1,1,22,Shelley Martel,Sudbury,-,per,PROPN-PROPN,PROPN,compound-nsubj,compound,NNP-NNP,NNP,8,1
505,485.0,72,University-College,1,13,32,19,12,39,-12,31,Nanaimo,Vancouver Island University,,org-org-org,PROPN,PROPN-PROPN-PROPN,compound,compound-compound-pobj,NNP,NNP-NNP-NNP,7,1
506,486.0,27,replaced,3,1,2,1,0,24,2,-1,Actress,Tilda Swinton,,per-per,PROPN,PROPN-PROPN,compound,compound-nsubj,NNP,NNP-NNP,1,1
507,487.0,42,heard,7,22,26,4,21,15,-15,19,Sheila Kelley,Richard Schiff,-,per-per,PROPN-PROPN,PROPN-PROPN,compound-compound,compound-pobj,NNP-NNP,NNP-NNP,3,1
508,488.0,40,is,9,24,25,1,23,14,-15,16,Socialist Party,Party of European Socialists,per-per,---,PROPN-PROPN,PROPN-ADP-PROPN-PROPN,compound-pobj,pobj-prep-compound-pobj,NNP-NNP,NNP-IN-NNP-NNPS,1,1
509,489.0,50,recommended,9,14,24,10,13,25,-5,15,142d Fighter Wing,Oregon,--,org,NUM-PROPN-PROPN,PROPN,dobj-compound-appos,pobj,CD-NNP-NNP,NNP,4,1
510,490.0,29,disputed,4,20,27,7,19,1,-16,23,Hun Sen,CPP,-,per,PROPN-PROPN,PROPN,compound-poss,appos,NNP-NNP,NNP,3,1
511,491.0,13,owns,4,4,7,3,3,5,0,3,Stagecoach,Coach USA,per,-,PROPN,PROPN-PROPN,nsubj,nmod-nmod,NNP,NNP-NNP,1,1
512,492.0,14,credited,3,7,9,2,6,4,-4,6,Samsung Electronics,Co.,-,org,PROPN-PROPN,PROPN,compound-compound,dobj,NNP-NNPS,NNP,3,1
513,493.0,24,was,5,9,15,6,8,8,-4,10,Alexander Ramsey,Minnesota,org-org,,PROPN-PROPN,PROPN,nmod-nmod,pobj,NNP-NNP,NNP,4,1
514,494.0,40,said,30,11,32,21,10,7,19,2,Digicel,Denis O'Brien,per,-,PROPN,PROPN-PROPN,dobj,compound-nsubj,NNP,NNP-NNP,6,1
515,495.0,39,mounted,8,32,38,6,31,0,-24,30,Sani Abacha,Nigeria,org-org,,PROPN-PROPN,PROPN,compound-compound,pobj,NNP-NNP,NNP,4,1
516,2166.0,34,defeated,10,24,29,5,23,4,-14,19,Sani Abacha,Nigeria,per-per,,PROPN-PROPN,PROPN,compound-compound,poss,NNP-NNP,NNP,5,1
517,2640.0,23,was,2,11,14,3,10,8,-9,12,Sani Abacha,Nigeria,org-org,,PROPN-PROPN,PROPN,compound-pobj,pobj,NNP-NNP,NNP,5,1
518,496.0,42,faced,26,12,15,3,11,26,14,-11,David Broderick,California,-,org,PROPN-PROPN,PROPN,compound-nsubj,compound,NNP-NNP,NNP,1,1
519,497.0,22,was,6,1,10,9,0,11,5,4,Peter Kane,England,per-per,,PROPN-PROPN,PROPN,compound-nsubj,poss,NNP-NNP,NNP,6,1
520,498.0,35,encompasses,4,3,13,10,2,21,1,9,Evergreen Group,EVA Air,per-per,-,PROPN-PROPN,PROPN-PROPN,compound-nsubj,compound-compound,NNP-NNP,NNP-NNP,7,1
521,499.0,26,used,20,10,16,6,9,9,10,-4,Rhode Island,Salve Regina University,per-per,--,PROPN-PROPN,PROPN-PROPN-PROPN,compound-pobj,compound-compound-compound,NNP-NNP,NNP-NNP-NNP,7,1
522,500.0,43,closed,11,15,21,6,14,21,-4,10,MG Rover,Longbridge,per-per,,PROPN-PROPN,PROPN,compound-poss,pobj,NNP-NNP,NNP,7,1
523,501.0,30,was,1,7,19,12,6,10,-6,18,Zambians,Atlanta Chiefs,per,-,PROPN,PROPN-PROPN,pobj,compound-pobj,NNPS,NNP-NNPS,4,1
524,2244.0,37,Rated,0,22,33,11,21,3,-22,33,Zambians,Atlanta Chiefs,,org-org,PROPN,PROPN-PROPN,pobj,compound-dobj,NNPS,NNP-NNPS,3,1
525,502.0,25,clashed,3,6,21,15,5,3,-3,18,Hun Sen,Cambodia,org-org,,PROPN-PROPN,PROPN,compound-pobj,poss,NNP-NNP,NNP,9,1
526,541.0,32,overthrown,6,8,26,18,7,5,-2,20,Hun Sen,Cambodia,per-per,,PROPN-PROPN,PROPN,compound-nsubjpass,pobj,NNP-NNP,NNP,8,1
527,503.0,39,warned,22,14,19,5,13,19,8,-3,Scott Trust,Guardian Media Group,-,org-org-org,PROPN-PROPN,PROPN-PROPN-PROPN,compound-pobj,compound-compound-dobj,NNP-NNP,NNP-NNP-NNP,3,1
528,504.0,12,is,2,1,6,5,0,5,1,4,Mr. Dinizulu,percussionist,org-org,,PROPN-PROPN,NOUN,compound-nsubj,attr,NNP-NNP,NN,3,1
529,505.0,31,faced,2,15,29,14,14,1,-13,27,Jewish,New Voices,,org-org,ADJ,PROPN-PROPN,compound,compound-oprd,JJ,NNP-NNPS,8,1
530,506.0,34,trust,3,1,30,29,0,3,2,27,Coldwell,Liberal Party of Canada,per,---,PROPN,PROPN-PROPN-ADP-PROPN,nsubj,compound-pobj-prep-pobj,NNP,NNP-NNP-IN-NNP,6,1
531,507.0,27,was,9,17,25,8,16,1,-8,16,Spain,Enrique Bunbury,org,-,PROPN,PROPN-PROPN,pobj,compound-conj,NNP,NNP-NNP,3,1
532,508.0,28,was,1,9,26,17,8,1,-8,25,Michigan,NCAA,per,,PROPN,PROPN,pobj,compound,NNP,NNP,6,1
533,509.0,36,seeing,2,15,15,0,14,20,-13,13,Marvel Comics,Marvel UK,org-org,-,PROPN-PROPN,PROPN-PROPN,compound-pobj,compound-dobj,NNP-NNP,NNP-NNP,0,1
534,510.0,28,were,5,5,24,19,4,3,0,19,Robert,United States,per,-,PROPN,PROPN-PROPN,conj,compound-pobj,NNP,NNP-NNP,5,1
535,511.0,26,accompanied,2,4,20,16,3,5,-2,18,Hashim al-Atassi,Syria,-,per,PROPN-PROPN,PROPN,compound-dobj,pobj,NNP-NNP,NNP,9,1
536,512.0,22,led,2,5,9,4,4,12,-3,7,Hanshin Tigers,Central League,-,org-org,PROPN-PROPN,PROPN-PROPN,compound-dobj,compound-compound,NNP-NNP,NNP-NNP,4,1
537,513.0,53,published,9,8,45,37,7,7,1,36,Fresno,Gary Soto,org,-,PROPN,PROPN-PROPN,compound,compound-compound,NNP,NNP-NNP,14,1
538,514.0,44,conducted,12,25,25,0,24,18,-13,13,Kosovo Protection Corps,Kosovo,per-per-per,,PROPN-PROPN-PROPN,PROPN,compound-compound-pobj,pobj,NNP-NNP-NNP,NNP,0,1
539,515.0,14,established,3,2,9,7,1,4,1,6,1974,Independent Commission Against Corruption,per,---,NUM,PROPN-PROPN-ADP-PROPN,pobj,compound-appos-prep-pobj,CD,NNP-NNP-IN-NNP,3,1
540,516.0,11,is,2,8,10,2,7,0,-6,8,Sacramento,X-Raided,,org,PROPN,PROPN,compound,nummod,NNP,NNP,3,1
541,517.0,44,believe,1,4,19,15,3,24,-3,18,FlyGlobespan,Edinburgh,,per,PROPN,PROPN,nmod,pobj,NNP,NNP,10,1
542,518.0,34,woke,2,7,31,24,6,2,-5,29,Nairobi hospital,Kenya,org-org,,PROPN-NOUN,PROPN,compound-pobj,pobj,NNP-NN,NNP,10,1
543,519.0,48,Hawi,2,1,25,24,0,22,1,23,William Hawi,Kataeb,-,org,PROPN-PROPN,PROPN,compound-nsubj,compound,NNP-NNP,NNP,4,1
544,520.0,22,represented,7,3,17,14,2,4,4,10,Illinois Fighting Illini,Division I,--,per-per,PROPN-PROPN-PROPN,PROPN-PRON,compound-compound-compound,compound-compound,NNP-NNP-NNP,NNP-PRP,6,1
545,521.0,38,returned,1,1,22,21,0,15,0,21,Lucas,Minister,org,,PROPN,PROPN,nsubj,pobj,NNP,NNP,6,1
546,522.0,43,supported,19,15,16,1,14,26,4,-3,Finland,Lauri Kristian Relander,org,--,PROPN,PROPN-PROPN-PROPN,compound,compound-compound-pobj,NNP,NNP-NNP-NNP,2,1
547,523.0,20,is,4,1,16,15,0,3,3,12,Forestburg Independent School District,Texas,per-per-per-per,,PROPN-PROPN-PROPN-PROPN,PROPN,compound-compound-compound-nsubj,pobj,NNP-NNP-NNP-NNP,NNP,10,1
548,524.0,33,is,1,11,10,-1,10,22,-10,9,Victoria of the United Kingdom,Queen,----,org,PROPN-ADP-DET-PROPN-PROPN,PROPN,pobj-prep-det-compound-pobj,compound,NNP-IN-DT-NNP-NNP,NNP,1,1
549,525.0,33,killed,21,7,16,9,6,16,14,-5,9th Division,Army,per-per,,ADJ-PROPN,PROPN,amod-nsubj,poss,JJ-NNP,NNP,6,1
550,526.0,43,moved,5,8,25,17,7,17,-3,20,Washington,Ben Shepherd,,per-per,PROPN,PROPN-PROPN,compound,compound-ROOT,NNP,NNP-NNP,3,1
551,527.0,27,are,4,3,10,7,2,16,1,6,CMU,Isabelo S. Alcordo,org,--,PROPN,PROPN-PROPN-PROPN,compound,compound-compound-ROOT,NNP,NNP-NNP-NNP,4,1
552,528.0,23,wrote,5,2,17,15,1,5,3,12,1967,Leadership Dynamics,per,-,NUM,PROPN-PROPN,pobj,compound-dobj,CD,NNP-NNPS,4,1
553,529.0,25,attended,7,10,14,4,9,10,-3,7,East High School,Park Forest,--,org-org,PROPN-PROPN-PROPN,PROPN-PROPN,compound-compound-dobj,compound-compound,NNP-NNP-NNP,NNP-NNP,4,1
554,530.0,19,made,1,9,13,4,8,5,-8,12,Angola,Fernando da Piedade Dias dos Santos,,per-per-per-per-per-per,PROPN,PROPN-PROPN-PROPN-PROPN-PROPN-PROPN,poss,compound-compound-compound-pobj-compound-appos,NNP,NNP-NNP-NNP-NNP-NNP-NNP,3,1
555,531.0,29,said,6,1,5,4,0,23,5,-1,West Virginia,Jay Rockefeller,org-org,-,PROPN-PROPN,PROPN-PROPN,compound-compound,compound-nsubj,NNP-NNP,NNP-NNP,3,1
556,532.0,25,is,2,1,8,7,0,16,1,6,Naomi Phoenix,Warwick,-,org,PROPN-PROPN,PROPN,compound-nsubj,pobj,NNP-NNP,NNP,3,1
557,533.0,25,said,22,1,8,7,0,16,21,-14,Indonesia,Pertamina,org,,PROPN,PROPN,poss,appos,NNP,NNP,2,1
558,2578.0,31,announced,8,1,8,7,0,22,7,0,Indonesia,Pertamina,per,,PROPN,PROPN,poss,nsubj,NNP,NNP,2,1
559,534.0,30,expected,3,9,12,3,8,17,-6,9,Mikkel Kessler,Denmark,-,per,PROPN-PROPN,PROPN,compound-dobj,pobj,NNP-NNP,NNP,3,1
560,535.0,18,is,3,3,15,12,2,2,0,12,Navy,Military of Kuwait,,per-per-per,PROPN,PROPN-ADP-PROPN,nsubj,pobj-prep-pobj,NNP,NNP-IN-NNP,5,1
561,536.0,26,second-generation,1,5,24,19,4,1,-4,23,Indiana,Evan Bayh,per,-,PROPN,PROPN-PROPN,compound,compound-pobj,NNP,NNP-NNP,7,1
562,537.0,37,was,15,1,22,21,0,14,14,7,Franklin Pierce,United States,-,org-org,PROPN-PROPN,PROPN-PROPN,compound-nsubj,compound-pobj,NNP-NNP,NNP-NNP,4,1
563,1496.0,23,was,1,8,14,6,7,8,-7,13,Franklin Pierce,United States,per-per,-,PROPN-PROPN,PROPN-PROPN,compound-nmod,compound-pobj,NNP-NNP,NNP-NNP,3,1
564,538.0,25,Centre,4,4,16,12,3,8,0,12,International Centre for Theoretical Physics,1964,per-per-per-per-per,,PROPN-PROPN-ADP-PROPN-PROPN,NUM,compound-ROOT-prep-compound-pobj,pobj,NNP-NNP-IN-NNP-NNP,CD,2,1
565,1737.0,75,Founder,0,6,17,11,5,57,-6,17,International Centre for Theoretical Physics,1964,----,org,PROPN-PROPN-ADP-PROPN-PROPN,NUM,compound-pobj-prep-compound-pobj,pobj,NNP-NNP-IN-NNP-NNP,CD,4,1
566,539.0,56,reflected,14,12,23,11,11,32,2,9,Japan,Kiichi Miyazawa,,org-org,PROPN,PROPN-PROPN,conj,compound-nsubj,NNP,NNP-NNP,3,1
567,540.0,24,took,3,12,16,4,11,7,-9,13,Rannoch School,Scotland,-,per,PROPN-PROPN,PROPN,compound-pobj,pobj,NNP-NNP,NNP,3,1
568,542.0,42,thought,4,16,19,3,15,22,-12,15,Henry,Elizabeth of York,org,--,PROPN,PROPN-ADP-PROPN,compound,conj-prep-poss,NNP,NNP-IN-NNP,1,1
569,604.0,37,defeated,6,5,18,13,4,18,1,12,Henry,Elizabeth of York,per,--,PROPN,PROPN-ADP-PROPN,compound,nmod-prep-pobj,NNP,NNP-IN-NNP,4,1
570,2960.0,40,agreed,14,17,12,-5,16,27,-3,-2,Henry,Elizabeth of York,org,--,PROPN,PROPN-ADP-PROPN,nsubj,appos-prep-pobj,NNP,NNP-IN-NNP,4,1
571,543.0,28,became,3,1,11,10,0,16,2,8,Nur Muhammad Taraki,Afghanistan,--,per,PROPN-PROPN-PROPN,PROPN,compound-compound-nsubj,pobj,NNP-NNP-NNP,NNP,4,1
572,2710.0,26,became,8,1,25,24,0,0,7,17,Nur Muhammad Taraki,Afghanistan,org-org-org,,PROPN-PROPN-PROPN,PROPN,compound-compound-compound,pobj,NNP-NNP-NNP,NNP,3,1
573,544.0,32,is,1,7,10,3,6,21,-6,9,Andy McCoy,Hanoi Rocks,org-org,-,PROPN-PROPN,PROPN-PROPN,compound-pobj,compound-pobj,NNP-NNP,NNP-NNP,2,1
574,545.0,26,announced,7,9,17,8,8,8,-2,10,Longwood University,Virginia,per-per,,PROPN-PROPN,PROPN,compound-dative,pobj,NNP-NNP,NNP,3,1
575,546.0,43,awarded,18,2,2,0,1,40,16,-16,Manchester Centre for Integrative Systems Biology,Manchester,-----,per,PROPN-PROPN-ADP-PROPN-PROPN-PROPN,PROPN,compound-nsubjpass-prep-compound-compound-pobj,compound,NNP-NNP-IN-NNP-NNP-NNP,NNP,0,1
576,547.0,35,is,9,22,27,5,21,7,-13,18,he Bashar al-Ass,in Syr,per-per-per,-,PRON-PROPN-PROPN,ADP-PROPN,nmod-compound-nmod,prep-pobj,PRP-NNP-NNP,IN-NNP,6,1
577,548.0,23,is,7,2,10,8,1,12,5,3,11th Wing,United States Air Force,per-per,---,ADJ-NOUN,PROPN-PROPN-PROPN-PROPN,amod-nsubj,compound-compound-compound-compound,JJ-NN,NNP-NNP-NNP-NNP,4,1
578,549.0,14,is,6,1,3,2,0,10,5,-3,Emirates Airline,Dubai,org-org,,PROPN-PROPN,PROPN,compound-compound,poss,NNPS-NNP,NNP,2,1
579,550.0,35,forced,2,1,32,31,0,2,1,30,He,Government,,org,PRON,PROPN,nsubjpass,pobj,PRP,NNP,8,1
580,551.0,20,awarded,4,3,11,8,2,8,1,7,he,Singapore,per,,PRON,PROPN,nsubjpass,poss,PRP,NNP,6,1
581,552.0,37,scheduled,8,1,3,2,0,33,7,-5,Amtrak,Northeast Regional,,org-org,PROPN,PROPN-PROPN,poss,compound-compound,NNP,NNP-NNP,3,1
582,553.0,44,used,11,1,11,10,0,32,10,0,Emma Dean,Australia,org-org,,PROPN-PROPN,PROPN,compound-nsubj,pobj,NNP-NNP,NNP,1,1
583,554.0,68,received,40,5,63,58,4,4,35,23,UMK,Kelantan,per,,PROPN,PROPN,pobj,pobj,NNP,NNP,-1,1
584,555.0,19,is,1,9,16,7,8,2,-8,15,Reformed Episcopal Church,Robert Duncan,per-per-per,-,PROPN-PROPN-PROPN,PROPN-PROPN,compound-compound-pobj,compound-compound,NNP-NNP-NNP,NNP-NNP,10,1
585,556.0,48,get,36,41,44,3,40,3,-5,8,Guyana,Bharrat Jagdeo,org,-,PROPN,PROPN-PROPN,poss,compound-nsubj,NNP,NNP-NNP,3,1
586,557.0,26,said,12,8,10,2,7,15,4,-2,Rome,John Cabot University,per,--,PROPN,PROPN-PROPN-PROPN,poss,compound-compound-pobj,NNP,NNP-NNP-NNP,3,1
587,558.0,23,kept,1,1,11,10,0,11,0,10,Graham,Florida,org,,PROPN,PROPN,nsubj,compound,NNP,NNP,5,1
588,559.0,22,moved,3,7,3,-4,6,18,-4,0,British Columbia,he,org-org,,PROPN-PROPN,PRON,compound-pobj,nsubj,NNP-NNP,PRP,2,1
589,560.0,31,resides,1,4,26,22,3,4,-3,25,California,Emerica,,per,PROPN,PROPN,compound,compound,NNP,NNP,6,1
590,561.0,18,was,3,2,10,8,1,7,1,7,Capital Division,Republic of Korea,-,org-org-org,PROPN-PROPN,PROPN-ADP-PROPN,compound-nsubj,nmod-prep-compound,NNP-NNP,NNP-IN-NNP,6,1
591,562.0,25,secured,10,1,7,6,0,17,9,-3,Isaac Tigrett,Hard Rock Cafe,per-per,--,PROPN-PROPN,PROPN-PROPN-PROPN,compound-nsubj,compound-compound-compound,NNP-NNP,NNP-NNP-NNP,4,1
592,563.0,22,was,5,5,14,9,4,7,0,9,he,New Brunswick,,per-per,PRON,PROPN-PROPN,nsubj,compound-pobj,PRP,NNP-NNP,5,1
593,564.0,34,emigrated,1,1,30,29,0,3,0,29,She,Charlottesville,,org,PRON,PROPN,nsubj,poss,PRP,NNP,8,1
594,565.0,28,lost,1,9,21,12,8,6,-8,20,Jane Byrne,Chicago,-,org,PROPN-PROPN,PROPN,compound-dobj,poss,NNP-NNP,NNP,4,1
595,566.0,18,said,16,1,11,10,0,6,15,-5,Mao,Beijing,,org,PROPN,PROPN,poss,pobj,NNP,NNP,8,1
596,567.0,14,released,2,2,7,5,1,6,0,5,band,Jaws 2 Records,per,--,NOUN,PROPN-NUM-PROPN,nsubj,nmod-nummod-pobj,NN,NNP-CD-NNPS,4,1
597,568.0,30,Born,0,6,22,16,5,7,-6,22,Japan,Misono,per,,PROPN,PROPN,compound,compound,NNP,NNP,6,1
598,569.0,21,is,13,1,12,11,0,8,12,-1,Milton Nascimento,Brazil,per-per,,PROPN-PROPN,PROPN,compound-nsubj,appos,NNP-NNP,NNP,3,1
599,570.0,26,recorded,4,9,20,11,8,5,-5,16,DiscReet,Captain Beefheart,per,-,PROPN,PROPN-PROPN,compound,compound-poss,NNP,NNP-NNP,5,1
600,571.0,18,University,2,3,5,2,2,12,-1,3,University of Tirana,Tirana,per-per-per,,PROPN-ADP-PROPN,PROPN,ROOT-prep-pobj,compound,NNP-IN-NNP,NNP,3,1
601,572.0,24,staying,13,12,22,10,11,1,1,9,Divine,Los Angeles,,org-org,PROPN,PROPN-PROPN,nsubj,compound-pobj,NNP,NNP-NNP,5,1
602,573.0,17,studied,1,4,8,4,3,8,-3,7,Paul Langevin,de France,per-per,-,PROPN-PROPN,PROPN-PROPN,compound-pobj,nmod-pobj,NNP-NNP,NNP-NNP,4,1
603,574.0,25,formed,9,6,9,3,5,15,3,0,Russell,actress,,per,PROPN,NOUN,pobj,conj,NNP,NN,2,1
604,575.0,31,played,2,8,28,20,7,2,-6,26,Australian Football International Cup,Papua New Guinea,org-org-org-org,--,PROPN-PROPN-PROPN-PROPN,PROPN-PROPN-PROPN,compound-compound-compound-dobj,compound-compound-pobj,NNP-NNP-NNP-NNP,NNP-NNP-NNP,8,1
605,576.0,45,was,10,1,16,15,0,28,9,6,George Axelrod,playwright,per-per,,PROPN-PROPN,NOUN,compound-nsubj,nmod,NNP-NNP,NN,3,1
606,577.0,27,formed,6,2,12,10,1,14,4,6,Pittsburg State,NCAA,per-per,,PROPN-PROPN,PROPN,compound-compound,compound,NNP-NNP,NNP,7,1
607,578.0,18,is,9,2,3,1,1,14,7,-6,All Pakistan Federation of Labour,Pakistan,per-per-per-per-per,,PROPN-PROPN-PROPN-ADP-PROPN,PROPN,det-compound-nsubj-prep-pobj,pobj,NNP-NNP-NNP-IN-NNP,NNP,1,1
608,579.0,24,play,1,10,12,2,9,11,-9,11,China,Beijing Institute of Technology,org,---,PROPN,PROPN-PROPN-ADP-PROPN,dobj,compound-nmod-prep-pobj,NNP,NNP-NNP-IN-NNP,1,1
609,580.0,23,founded,6,2,9,7,1,13,4,3,Art Institute of Atlanta,1949,per-per-per-per,,PROPN-PROPN-ADP-PROPN,NUM,compound-nsubjpass-prep-pobj,pobj,NNP-NNP-IN-NNP,CD,2,1
610,581.0,19,went,6,16,17,1,15,1,-10,11,Georgia,Zviad Gamsakhurdia,,org-org,PROPN,PROPN-PROPN,compound,compound-pobj,NNP,NNP-NNP,1,1
611,582.0,30,works,15,8,27,19,7,2,7,12,Sliwa,Guardian Angels,org,-,PROPN,PROPN-PROPN,poss,compound-compound,NNP,NNP-NNPS,11,1
612,583.0,21,toppled,9,4,6,2,3,14,5,-3,Maldives,Gayoom,,org,PROPN,PROPN,pobj,poss,NNP,NNP,3,1
613,1923.0,22,allowed,3,7,21,14,6,0,-4,18,Maldives,Gayoom,org,,PROPN,PROPN,pobj,pobj,NNPS,NNP,2,1
614,584.0,51,apologised,39,18,26,8,17,24,21,-13,David Gilmour,Cambridge,org-org,,PROPN-PROPN,PROPN,compound-pobj,pobj,NNP-NNP,NNP,3,1
615,585.0,31,working,1,11,11,0,10,19,-10,10,; h,; Institute of Chemical Technology in Pragu,-,per-per-per-per-per-per-per,PUNCT-NOUN,PUNCT-PROPN-ADP-PROPN-PROPN-ADP-PROPN,punct-det,punct-conj-prep-compound-pobj-prep-compound,:-NN,:-NNP-IN-NNP-NNP-IN-NNP,0,1
616,586.0,15,catholique,3,4,14,10,3,0,-1,11,catholique de Louvain,Belgium,--,org,NOUN-X-PROPN,PROPN,ROOT-compound-compound,ROOT,NN-FW-NNP,NNP,4,1
617,587.0,54,signed,4,7,27,20,6,26,-3,23,Plan B,UK,-,per,PROPN-PROPN,PROPN,compound-dobj,compound,NNP-NNP,NNP,8,1
618,588.0,47,were,29,1,10,9,0,36,28,-19,Barton,High Court,per,-,PROPN,PROPN-PROPN,nsubj,compound-pobj,NNP,NNP-NNP,5,1
619,990.0,25,succeeded,15,2,13,11,1,11,13,-2,Barton,High Court,,per-per,PROPN,PROPN-PROPN,nsubj,compound-compound,NNP,NNP-NNP,6,1
620,589.0,21,conducted,3,12,20,8,11,0,-9,17,University of New Mexico,Albuquerque,per-per-per-per,,PROPN-ADP-PROPN-PROPN,PROPN,pobj-prep-compound-compound,pobj,NNP-IN-NNP-NNP,NNP,6,1
621,590.0,29,is,2,1,21,20,0,7,1,19,Pat McGeehan,United States,org-org,-,PROPN-PROPN,PROPN-PROPN,compound-nsubj,compound-compound,NNP-NNP,NNP-NNP,7,1
622,591.0,83,has,2,16,41,25,15,41,-14,39,Iowa,Northern Iowa Panthers,org,--,PROPN,PROPN-PROPN-PROPN,compound,pobj-compound-appos,NNP,NNP-NNP-NNPS,7,1
623,592.0,17,served,1,7,15,8,6,1,-6,14,Interior,Rogers Morton,per,-,PROPN,PROPN-PROPN,compound,compound-pobj,NNP,NNP-NNP,7,1
624,746.0,34,left,1,16,32,16,15,1,-15,31,Interior,Rogers Morton,per,-,PROPN,PROPN-PROPN,compound,compound-pobj,NNP,NNP-NNP,3,1
625,593.0,31,hopes,1,1,26,25,0,4,0,25,Russia,Mikhail Fradkov,org,-,PROPN,PROPN-PROPN,pobj,compound-nsubj,NNP,NNP-NNP,5,1
626,594.0,35,graduate,2,5,9,4,4,25,-3,7,Wheaton College,USA,per-per,,PROPN-PROPN,PROPN,compound-compound,pobj,NNP-NNP,NNP,5,1
627,595.0,56,attended,9,26,26,0,25,29,-17,17,West Virginia,West Virginia University,org-org,--,PROPN-PROPN,PROPN-PROPN-PROPN,compound-compound,compound-compound-appos,NNP-NNP,NNP-NNP-NNP,0,1
628,596.0,16,formed,2,1,11,10,0,4,1,9,Volgren,Grenda,,per,PROPN,PROPN,nsubjpass,compound,NNP,NNP,4,1
629,597.0,33,is,2,1,1,0,0,31,1,-1,Abingdon School,Abingdon,-,per,PROPN-PROPN,PROPN,compound-nsubj,compound,NNP-NNP,NNP,0,1
630,598.0,21,built,5,1,19,18,0,1,4,14,Northwest Classen High School,Oklahoma City,org-org-org-org,-,PROPN-PROPN-PROPN-PROPN,PROPN-PROPN,compound-compound-compound-nsubjpass,compound-pobj,NNP-NNP-NNP-NNP,NNP-NNP,8,1
631,599.0,31,breaking,3,23,29,6,22,1,-20,26,Smith,Southern Rhodesia,,org-org,PROPN,PROPN-PROPN,poss,compound-pobj,NNP,NNP-NNP,6,1
632,600.0,41,was,11,3,14,11,2,26,8,3,James Mitchell,United States,-,org-org,PROPN-PROPN,PROPN-PROPN,compound-nsubj,compound-compound,NNP-NNP,NNP-NNP,3,1
633,601.0,38,Formed,0,3,9,6,2,28,-3,9,Long Island,Public Enemy,org-org,-,PROPN-PROPN,PROPN-PROPN,compound-compound,compound-nsubjpass,NNP-NNP,NNP-NNP,5,1
634,602.0,14,based,10,1,3,2,0,10,9,-7,EADS,Military Transport Aircraft,org,--,PROPN,PROPN-PROPN-PROPN,compound,compound-compound-compound,NNP,NNP-NNP-NNP,3,1
635,603.0,44,Accompanying,0,31,34,3,30,9,-31,34,Muchadeyi Masunda,Harare,per-per,,PROPN-PROPN,PROPN,compound-conj,compound,NNP-NNP,NNP,2,1
636,605.0,37,formed,3,2,14,12,1,22,1,11,WEU,1948,,org,PROPN,NUM,nsubjpass,pobj,NNP,CD,2,1
637,606.0,29,expected,22,6,8,2,5,20,16,-14,Glendale,IHOP,org,,PROPN,PROPN,compound,dobj,NNP,NNP,1,1
638,607.0,21,released,2,8,11,3,7,9,-6,9,Pete Wentz,Decaydance,per-per,,PROPN-PROPN,PROPN,compound-poss,nmod,NNP-NNP,NNP,2,1
639,608.0,35,presented,1,11,11,0,10,23,-10,10,BBC,BBC News,,per-per,PROPN,PROPN-PROPN,poss,compound-compound,NNP,NNP-NNP,0,1
640,609.0,35,is,9,2,20,18,1,14,7,11,Britt Daniel,Texas,org-org,,PROPN-PROPN,PROPN,compound-nsubj,compound,NNP-NNP,NNP,7,1
641,610.0,27,is,4,1,16,15,0,10,3,12,Pacific Hills Christian School,Dural,---,org,PROPN-PROPN-PROPN-PROPN,PROPN,compound-compound-compound-nsubj,pobj,NNP-NNP-NNP-NNP,NNP,7,1
642,611.0,37,announced,13,9,11,2,8,25,4,-2,Rutgers University,Richard L. McCormick,per-per,--,PROPN-PROPN,PROPN-PROPN-PROPN,compound-compound,compound-compound-pobj,NNP-NNP,NNP-NNP-NNP,2,1
643,612.0,24,be,13,5,19,14,4,4,8,6,he,Iceland,org,,PRON,PROPN,nsubj,pobj,PRP,NNP,4,1
644,613.0,16,founded,6,2,14,12,1,1,4,8,King Arthur Flour,Henry Wood,per-per-per,-,PROPN-PROPN-PROPN,PROPN-PROPN,compound-compound-compound,compound-pobj,NNP-NNP-NNP,NNP-NNP,4,1
645,614.0,23,filmed,7,10,17,7,9,5,-3,10,Universal Studios,USA,org-org,,PROPN-PROPN,PROPN,compound-pobj,pobj,NNP-NNP,NNP,3,1
646,615.0,36,become,13,3,6,3,2,29,10,-7,Barneys,1923,org,,PROPN,NUM,nsubj,pobj,NNP,CD,1,1
647,616.0,26,said,9,1,13,12,0,12,8,4,Italy,Giuliano Amato,per,-,PROPN,PROPN-PROPN,nsubj,compound-nsubj,NNP,NNP-NNP,3,1
648,617.0,30,spent,2,16,18,2,15,11,-14,16,Connecticut,Joe Lieberman,org,-,PROPN,PROPN-PROPN,compound,compound-pobj,NNP,NNP-NNP,1,1
649,618.0,19,was,9,1,17,16,0,1,8,8,Natas,Detroit,org,,PROPN,PROPN,nsubj,compound,NNP,NNP,5,1
650,619.0,44,replaced,17,8,32,24,7,11,9,15,Monterey Bay,CSUMB,org-org,,PROPN-PROPN,PROPN,compound-pobj,pobj,NNP-NNP,NNP,13,1
651,620.0,30,come,2,26,27,1,25,2,-24,25,President,Abdullahi Yusuf Ahmed,,per-per-per,PROPN,PROPN-PROPN-PROPN,compound,compound-compound-pobj,NNP,NNP-NNP-NNP,2,1
652,621.0,49,During,0,23,26,3,22,22,-23,26,Pakistan Army,6th Armoured Division,-,per-per-per,PROPN-PROPN,ADJ-PROPN-PROPN,compound-poss,compound-compound-pobj,NNP-NNP,JJ-NNP-NNP,2,1
653,622.0,27,was,3,10,23,13,9,3,-7,20,Cairo,Fuad I of Egypt,per,---,PROPN,PROPN-PRON-ADP-PROPN,pobj,pobj-appos-prep-pobj,NNP,NNP-PRP-IN-NNP,5,1
654,623.0,26,called,16,6,18,12,5,7,10,2,Giorgio Napolitano,Italy,-,org,PROPN-PROPN,PROPN,compound-pobj,dobj,NNP-NNP,NNP,7,1
655,624.0,24,lost,4,3,18,15,2,5,1,14,Diosdado Macapagal,Philippines,-,per,PROPN-PROPN,PROPN,compound-nsubj,pobj,NNP-NNP,NNPS,4,1
656,625.0,25,re-elected,7,1,4,3,0,20,6,-3,Roberto Formigoni,Forza Italia,org-org,-,PROPN-PROPN,PROPN-PROPN,compound-nsubjpass,compound-appos,NNP-NNP,NNP-NNP,1,1
657,626.0,24,grew,1,1,11,10,0,12,0,10,He,Netherlands,,per,PRON,PROPN,nsubj,pobj,PRP,NNP,4,1
658,627.0,32,On,0,7,21,14,6,10,-7,21,Ethiopian Airlines,Ethiopia,per-per,,PROPN-PROPN,PROPN,compound-compound,pobj,NNP-NNPS,NNP,7,1
659,628.0,34,founded,3,2,5,3,1,28,1,2,1993,The Disclosure Project,per,--,NUM,DET-PROPN-PROPN,pobj,det-compound-dative,CD,DT-NNP-NNP,3,1
660,629.0,24,won,15,9,12,3,8,11,6,-3,John Temple,Rocky Mountain News,per-per,--,PROPN-PROPN,PROPN-PROPN-PROPN,compound-conj,compound-compound-nsubj,NNP-NNP,NNP-NNP-NNP,7,1
661,630.0,20,founded,2,1,5,4,0,14,1,3,Bard College,1860,per-per,,PROPN-PROPN,NUM,compound-nsubj,pobj,NNP-NNP,CD,2,1
662,631.0,24,run,4,21,23,2,20,0,-17,19,San Jose,State,org-org,,PROPN-PROPN,PROPN,compound-compound,pobj,NNP-NNP,NNP,9,1
663,632.0,38,chairman,13,5,6,1,4,31,8,-7,Philippines,Fidel V. Ramos,,org-org-org,PROPN,PROPN-PROPN-PROPN,compound,compound-compound-pobj,NNP,NNP-NNP-NNP,2,1
664,633.0,25,moved,2,14,17,3,13,7,-12,15,England,Sidcot School,,org-org,PROPN,PROPN-PROPN,pobj,compound-pobj,NNP,NNP-NNP,3,1
665,634.0,32,Enrichetta's,0,22,28,6,21,3,-22,28,Mary of Modena,James,org-org-org,,PROPN-ADP-PROPN,PROPN,nmod-prep-pobj,compound,NNP-IN-NNP,NNP,6,1
666,635.0,33,Monitoring,1,9,20,11,8,12,-8,19,Lebanon,Michel Suleiman,,org-org,PROPN,PROPN-PROPN,pobj,compound-pobj,NNP,NNP-NNP,7,1
667,636.0,25,said,11,11,21,10,10,3,0,10,Lebanon,American University of Beirut,,per-per-per-per,PROPN,PROPN-PROPN-ADP-PROPN,nsubj,compound-pobj-prep-pobj,NNP,NNP-NNP-IN-NNP,3,1
668,637.0,22,Castellaneta,2,1,2,1,0,19,1,0,Actor,Dan Castellaneta,,org-org,PROPN,PROPN-PROPN,compound,compound-ROOT,NNP,NNP-NNP,1,1
669,638.0,22,inspired,3,1,16,15,0,5,2,13,Barlas,Turkey,per,,PROPN,PROPN,nsubj,pobj,NNP,NNP,5,1
670,639.0,18,is,3,3,3,0,2,14,0,0,Virginia,Virginia Army National Guard,,per-per-per-per,PROPN,PROPN-PROPN-PROPN-PROPN,nsubj,compound-compound-compound-compound,NNP,NNP-NNP-NNP-NNP,0,1
671,640.0,20,held,12,2,11,9,1,8,10,-1,center,Florida,,org,NOUN,PROPN,nsubj,pobj,NN,NNP,2,1
672,641.0,70,parted,3,51,54,3,50,15,-48,51,Lou Gramm,Foreigner,-,per,PROPN-PROPN,PROPN,compound-ROOT,appos,NNP-NNP,NNP,-1,1
673,642.0,15,scheduled,4,1,11,10,0,3,3,7,Donald C. Winter,Navy,per-per-per,,PROPN-PROPN-PROPN,PROPN,compound-compound-nsubjpass,compound,NNP-NNP-NNP,NNP,5,1
674,643.0,28,Established,0,14,19,5,13,8,-14,19,Air Force Materiel Command,AFMC,---,org,PROPN-PROPN-PROPN-PROPN,PROPN,compound-compound-compound-nmod,appos,NNP-NNP-NNP-NNP,NNP,3,1
675,644.0,13,was,4,2,11,9,1,1,2,7,West Somerset Yeomanry,British Army,per-per-per,-,PROPN-PROPN-PROPN,ADJ-PROPN,compound-compound-nsubj,compound-pobj,NNP-NNP-NNP,JJ-NNP,5,1
676,645.0,32,is,4,1,13,12,0,18,3,9,King Henry VIII School,England,per-per-per-per,,PROPN-PROPN-PROPN-PROPN,PROPN,compound-compound-compound-nsubj,pobj,NNP-NNP-NNP-NNP,NNP,4,1
677,646.0,29,is,14,1,26,25,0,2,13,12,Datuk Seri Panglima Haji Musa bin Haji Aman,Sabah,per-per-per-per-per-per-per-per,,NOUN-PROPN-PROPN-PROPN-PROPN-NOUN-PROPN-PROPN,PROPN,compound-compound-compound-compound-compound-compound-compound-nsubj,pobj,NNS-NNP-NNP-NNP-NNP-NN-NNP-NNP,NNP,4,1
678,647.0,19,said,12,14,18,4,13,0,-2,6,Elon Musk,SpaceX,org-org,,PROPN-PROPN,PROPN,compound-compound,pobj,NNP-NNP,NNP,3,1
679,648.0,27,Go,5,4,24,20,3,2,1,19,Touch,Butthole Surfers,,org-org,PROPN,PROPN-PROPN,pobj,compound-conj,NNP,NNP-NNPS,9,1
680,649.0,41,scheduled,2,37,40,3,36,0,-35,38,Canada,Pound,org,,PROPN,PROPN,poss,pobj,NNP,NNP,10,1
681,650.0,26,graduated,1,4,11,7,3,14,-3,10,De La Salle Institute,Chicago,per-per-per-per,,PROPN-PROPN-PROPN-PROPN,PROPN,compound-nmod-nmod-nmod,pobj,NNP-NNP-NNP-NNP,NNP,5,1
682,651.0,41,initiated,10,19,20,1,18,20,-9,10,Honourable,Paul Keating,,org-org,ADJ,PROPN-PROPN,amod,compound-pobj,JJ,NNP-NNP,1,1
683,652.0,17,released,2,11,16,5,10,0,-9,14,Kai Hansen,Hamburg,org-org,,PROPN-PROPN,PROPN,compound-poss,pobj,NNP-NNP,NNP,5,1
684,653.0,71,are,3,66,66,0,65,4,-63,63,Chiang Mai University,Chiang Mai,--,per-per,PROPN-PROPN-PROPN,PROPN-PROPN,compound-compound-compound,compound-conj,NNP-NNP-NNP,NNP-NNP,0,1
685,654.0,29,told,15,1,18,17,0,10,14,3,Marc Garneau,Canada,org-org,,PROPN-PROPN,PROPN,compound-nsubj,compound,NNP-NNP,NNP,3,1
686,655.0,75,Archuleta,1,63,66,3,62,8,-62,65,Carly Smithson,San Diego,-,per-per,PROPN-PROPN,PROPN-PROPN,compound-conj,compound-appos,NNP-NNP,NNP-NNP,1,1
687,656.0,14,album,2,1,12,11,0,1,1,10,Their,Relapse Records,per,-,DET,PROPN-PROPN,poss,compound-pobj,PRP$,NNP-NNPS,4,1
688,657.0,38,referred,7,12,30,18,11,7,-5,23,ULM Warhawks,University of Louisiana at Monroe,org-org,----,PROPN-PROPN,PROPN-ADP-PROPN-ADP-PROPN,pobj-appos,dobj-prep-pobj-prep-pobj,NNP-NNP,NNP-IN-NNP-IN-NNP,8,1
689,658.0,41,composed,3,32,39,7,31,1,-29,36,Herbie Steward,Four Brothers,per-per,-,PROPN-PROPN,PROPN-PROPN,compound-conj,compound-pobj,NNP-NNP,NNP-NNPS,5,1
690,2734.0,32,played,1,20,28,8,19,3,-19,27,Herbie Steward,Four Brothers,per-per,-,PROPN-PROPN,PROPN-PROPN,compound-conj,compound-compound,NNP-NNP,NNP-NNPS,7,1
691,659.0,41,said,17,10,15,5,9,25,7,-2,Amy Poehler,Will Arnett,per-per,-,PROPN-PROPN,VERB-PROPN,compound-pobj,compound-appos,NNP-NNP,MD-NNP,2,1
692,660.0,22,returned,3,3,7,4,2,14,0,4,he,California,,org,PRON,PROPN,nsubj,compound,PRP,NNP,2,1
693,1172.0,38,Admitted,0,25,30,5,24,7,-25,30,he,California,,per,PRON,PROPN,nsubjpass,compound,PRP,NNP,3,1
694,661.0,30,blamed,6,16,25,9,15,4,-10,19,Byrne,Chicago,,org,PROPN,PROPN,pobj,poss,NNP,NNP,8,1
695,662.0,20,is,11,1,10,9,0,9,10,-1,Peter Wood,England,per-per,,PROPN-PROPN,PROPN,compound-nsubj,appos,NNP-NNP,NNP,1,1
696,663.0,25,amassed,4,1,1,0,0,23,3,-3,Dubai World,Dubai,per-per,,PROPN-PROPN,PROPN,compound-nsubj,poss,NNP-NNP,NNP,0,1
697,664.0,35,provided,2,8,11,3,7,23,-6,9,Air Force,442d Fighter Wing,per-per,--,PROPN-PROPN,PROPN-PROPN-PROPN,nmod-compound,compound-compound-pobj,NNP-NNP,NNPS-NNP-NNP,3,1
698,665.0,55,studied,1,13,45,32,12,9,-12,44,University of Wales,Aberystwyth University,per-per-per,-,PROPN-ADP-PROPN,PROPN-PROPN,nmod-prep-pobj,compound-appos,NNP-IN-NNP,NNP-NNP,5,1
699,666.0,19,is,4,1,12,11,0,6,3,8,Missouri Southern State University,Joplin,per-per-per-per,,PROPN-PROPN-PROPN-PROPN,PROPN,compound-compound-compound-nsubj,pobj,NNP-NNP-NNP-NNP,NNP,6,1
700,667.0,17,began,11,6,16,10,5,0,5,5,Desert Rose Band,McGuinn,org-org-org,,PROPN-PROPN-PROPN,PROPN,compound-compound-poss,pobj,NNP-NNP-NNP,NNP,7,1
701,668.0,8,heads,2,1,5,4,0,2,1,3,Masiello,Alternative Route Recordings,org,--,PROPN,PROPN-PROPN-PROPN,nsubj,compound-compound-dobj,NNP,NNP-NNP-NNPS,3,1
702,669.0,33,was,22,1,19,18,0,13,21,-3,Sentara Norfolk General Hospital,Eastern Virginia Medical School,---,org-org-org-org,PROPN-PROPN-PROPN-PROPN,PROPN-PROPN-PROPN-PROPN,compound-compound-compound-compound,compound-compound-compound-pobj,NNP-NNP-NNP-NNP,NNP-NNP-NNP-NNP,6,1
703,670.0,30,is,4,10,10,0,9,19,-6,6,Ohio Central Railroad,Ohio,org-org-org,,PROPN-PROPN-PROPN,PROPN,compound-compound-compound,pobj,NNP-NNP-NNP,NNP,0,1
704,2855.0,72,are,3,14,14,0,13,57,-11,11,Ohio Central Railroad,Ohio,org-org-org,,PROPN-PROPN-PROPN,PROPN,compound-compound-conj,pobj,NNP-NNP-NNP,NNP,0,1
705,671.0,24,worked,5,9,15,6,8,8,-4,10,Go,Butthole Surfers,org,-,PROPN,PROPN-PROPN,compound,compound-dobj,NNP,NNP-NNPS,2,1
706,672.0,39,tasked,14,9,21,12,8,17,5,7,1st Fighter Wing,United States,per-per-per,-,ADJ-PROPN-PROPN,PROPN-PROPN,amod-compound-pobj,compound-pobj,JJ-NNP-NNP,NNP-NNP,11,1
707,673.0,33,enacted,2,6,29,23,5,3,-4,27,Antonio de Santa Anna,Mexico,---,org,PROPN-ADP-PROPN-PROPN,PROPN,nmod-compound-compound-pobj,pobj,NNP-IN-NNP-NNP,NNP,8,1
708,674.0,34,oversee,3,6,6,0,5,27,-3,3,Oklahoma,Oklahoma State Bureau of Investigation,org,----,PROPN,PROPN-PROPN-PROPN-ADP-PROPN,compound,compound-compound-appos-prep-pobj,NNP,NNP-NNP-NNP-IN-NNP,0,1
709,675.0,15,born,2,7,12,5,6,2,-5,10,Jacksonville,Englewood High School,org,--,PROPN,PROPN-PROPN-PROPN,compound,compound-compound-dobj,NNP,NNP-NNP-NNP,3,1
710,676.0,35,serves,2,17,33,16,16,1,-15,31,Siena Heights University,Michigan,org-org-org,,PROPN-PROPN-PROPN,PROPN,compound-compound-compound,compound,NNP-NNP-NNP,NNP,7,1
711,677.0,42,commandeered,20,16,18,2,15,23,4,-2,Jersey City,Bernard J. Berry,per-per,--,PROPN-PROPN,PROPN-PROPN-PROPN,compound-compound,compound-compound-pobj,NNP-NNP,NNP-NNP-NNP,4,1
712,678.0,34,authorized,26,15,20,5,14,13,11,-6,Seth Warner,Green Mountain Boys,-,org-org-org,PROPN-PROPN,PROPN-PROPN-PROPN,compound-poss,compound-compound-pobj,NNP-NNP,NNP-NNP-NNPS,4,1
713,679.0,44,called,4,12,14,2,11,29,-8,10,Wisconsin,Gaylord Nelson,,org-org,PROPN,PROPN-PROPN,compound,compound-nsubj,NNP,NNP-NNP,1,1
714,680.0,23,was,5,1,20,19,0,2,4,15,Elizabeth Glaser,Paul Michael Glaser,org-org,--,PROPN-PROPN,PROPN-PROPN-PROPN,compound-compound,compound-compound-pobj,NNP-NNP,NNP-NNP-NNP,3,1
715,681.0,48,scandal,3,39,47,8,38,0,-36,44,James G. Watt,Interior,--,per,PROPN-PROPN-PROPN,PROPN,compound-compound-pobj,pobj,NNP-NNP-NNP,NNP,4,1
716,682.0,17,became,1,1,16,15,0,0,0,15,ACT,Brumbies,,org,PROPN,PROPN,nsubj,pobj,NNP,NNPS,6,1
717,683.0,25,is,3,1,1,0,0,23,2,-2,Bartlett High School,Bartlett,--,per,PROPN-PROPN-PROPN,PROPN,compound-compound-nsubj,compound,NNP-NNP-NNP,NNP,0,1
718,684.0,15,signed,8,7,14,7,6,0,1,6,AESOP,1987,,per,PROPN,NUM,pobj,pobj,NNP,CD,2,1
719,685.0,13,is,2,1,10,9,0,2,1,8,Federal-Mogul,Southfield,per,,PROPN,PROPN,amod,compound,NNP,NNP,6,1
720,686.0,26,born,2,1,21,20,0,4,1,19,Papandreou,Greek,org,,PROPN,ADJ,nsubjpass,amod,NNP,JJ,8,1
721,687.0,30,appointed,2,6,19,13,5,10,-4,17,Oregon,Phil Keisling,org,-,PROPN,PROPN-PROPN,compound,compound-poss,NNP,NNP-NNP,8,1
722,688.0,31,referred,3,1,26,25,0,4,2,23,Mshasho,The Dogg,org,-,PROPN,DET-PROPN,compound,det-compound,NNP,DT-NNP,-1,1
723,1700.0,27,turned,2,13,19,6,12,7,-11,17,Mshasho,The Dogg,,per-per,PROPN,DET-PROPN,compound,det-pobj,NNP,DT-NNP,3,1
724,689.0,32,was,1,6,24,18,5,7,-5,23,Loukas Kanakaris-Roufos,Italy,org-org,,PROPN-PROPN,PROPN,compound-pobj,pobj,NNP-NNP,NNP,8,1
725,690.0,31,discovered,3,5,20,15,4,10,-2,17,Killer Mike,Atlanta,per-per,,PROPN-PROPN,PROPN,compound-nsubj,compound,NNP-NNP,NNP,7,1
726,691.0,15,said,2,4,13,9,3,1,-2,11,Pakistan,her,,per,PROPN,DET,nsubj,poss,NNP,PRP$,4,1
727,692.0,24,are,5,15,22,7,14,1,-10,17,Jack Klugman,Brett Somers,-,per-per,PROPN-PROPN,PROPN-PROPN,compound-pobj,compound-dobj,NNP-NNP,NNP-NNP,2,1
728,693.0,27,is,7,4,6,2,3,20,3,-1,Ateneo,Manila,per,,PROPN,PROPN,nmod,compound,NNPS,NNP,2,1
729,694.0,29,cite,2,6,10,4,5,18,-4,8,Mikhail Fradkov,Russia,per-per,,PROPN-PROPN,PROPN,compound-dobj,nsubj,NNP-NNP,NNP,5,1
730,696.0,19,grew,8,4,12,8,3,6,4,4,Chelsea and Westminster Hospital,Tadworth,---,per,PROPN-CCONJ-PROPN-PROPN,PROPN,nmod-cc-conj-compound,compound,NNP-CC-NNP-NNP,NNP,6,1
731,697.0,17,offered,4,9,10,1,8,6,-5,6,President,Lee Myung-bak,per,-,PROPN,PROPN-PROPN,compound,pobj-punct,NNP,NNP-NNP,2,1
732,1579.0,31,arrived,8,1,7,6,0,23,7,-1,President,Lee Myung-bak,org,-,PROPN,PROPN-PROPN,nsubj,appos-punct,NNP,NNP-NNP,2,1
733,2812.0,19,said,1,16,17,1,15,1,-15,16,President,Lee Myung-bak,,org-org,PROPN,PROPN-PROPN,compound,pobj-npadvmod,NNP,NNP-NNP,2,1
734,698.0,36,was,2,1,2,1,0,33,1,0,RAF Tangmere,Tangmere,org-org,,PROPN-PROPN,PROPN,compound-nsubj,compound,NNP-NNP,NNP,1,1
735,699.0,18,Following,0,4,8,4,3,9,-4,8,Victoriano Huerta,Mexico,per-per,,PROPN-PROPN,PROPN,compound-nsubj,pobj,NNP-NNP,NNP,2,1
736,2274.0,83,is,2,1,10,9,0,72,1,8,Victoriano Huerta,Mexico,org-org,,PROPN-PROPN,PROPN,compound-nsubj,pobj,NNP-NNP,NNP,6,1
737,700.0,68,included,4,12,16,4,11,51,-8,12,Hodding Carter,Greenville,per-per,,PROPN-PROPN,PROPN,compound-pobj,compound,NNP-NNP,NNP,5,1
738,701.0,19,is,3,1,12,11,0,6,2,9,The National,New York,org-org,-,DET-PROPN,PROPN-PROPN,det-compound,compound-pobj,DT-NNP,NNP-NNP,4,1
739,702.0,29,met,8,10,23,13,9,5,-2,15,DJ Jazzy Jeff,Philadelphia,--,per,PROPN-PROPN-PROPN,PROPN,compound-compound-dobj,poss,NNP-NNP-NNP,NNP,8,1
740,703.0,14,is,7,2,7,5,1,6,5,0,Heineken Cup,1995,org-org,,PROPN-PROPN,NUM,compound-nsubj,pobj,NNP-NNP,CD,1,1
741,704.0,26,became,4,9,25,16,8,0,-5,21,Cryonics Institute,1976,per-per,,PROPN-PROPN,NUM,compound-pobj,pobj,NNPS-NNP,CD,9,1
742,705.0,45,molding,3,11,17,6,10,27,-8,14,Miami,Gloria Estefan,per,-,PROPN,PROPN-PROPN,compound,compound-poss,NNP,NNP-NNP,9,1
743,706.0,26,announced,3,1,3,2,0,22,2,0,Malaysia,Petronas,org,,PROPN,PROPN,poss,nsubj,NNP,NNP,3,1
744,707.0,27,came,23,9,10,1,8,16,14,-13,President,Ian Khama,per,-,PROPN,PROPN-PROPN,compound,compound-pobj,NNP,NNP-NNP,1,1
745,708.0,24,charged,19,4,10,6,3,13,15,-9,Durham,Duke University,org,-,PROPN,PROPN-PROPN,compound,compound-compound,NNP,NNP-NNP,4,1
746,709.0,28,are,5,1,15,14,0,12,4,10,Lotus Cars,Hethel,org-org,,PROPN-PROPN,PROPN,compound-nsubj,compound,NNP-NNPS,NNP,2,1
747,710.0,11,attended,6,4,8,4,3,2,2,2,Chicago,Northeastern Illinois University,,per-per-per,PROPN,PROPN-PROPN-PROPN,compound,compound-compound-dobj,NNP,NNP-NNP-NNP,6,1
748,711.0,39,presents,13,1,10,9,0,28,12,-3,Markku Ruotsila,University of Helsinki,-,org-org-org,PROPN-PROPN,PROPN-ADP-PROPN,compound-nsubj,pobj-prep-pobj,NNP-NNP,NNP-IN-NNP,5,1
749,712.0,10,RugbyU,0,5,7,2,4,2,-5,7,Crusaders,Super 14,,per-per,PROPN,PROPN-NUM,dobj,nmod-nummod,NNP,NNP-CD,3,1
750,2210.0,33,put,2,5,10,5,4,22,-3,8,Crusaders,Super 14,org,-,PROPN,PROPN-NUM,dobj,nmod-nummod,NNPS,NNP-CD,4,1
751,713.0,21,is,4,1,14,13,0,6,3,10,al-Aqsa University,Gaza,-,org,PROPN-PROPN,PROPN,compound-nsubj,compound,NNP-NNP,NNP,7,1
752,714.0,32,received,4,2,17,15,1,14,2,13,Empire of Japan,IJN,org-org-org,,PROPN-ADP-PROPN,PROPN,nsubj-prep-pobj,nsubj,NNP-IN-NNP,NNP,-1,1
753,715.0,33,initiated,16,26,31,5,25,1,-10,15,United Kingdom,Wellcome Trust,-,org-org,PROPN-PROPN,PROPN-PROPN,compound-pobj,compound-pobj,NNP-NNP,NNP-NNP,7,1
754,716.0,26,represents,10,4,19,15,3,6,6,9,Michigan Technological University,NCAA,--,org,PROPN-PROPN-PROPN,PROPN,compound-compound-dobj,compound,NNP-NNP-NNP,NNP,7,1
755,717.0,33,said,6,1,5,4,0,27,5,-1,Uganda,Apolo Nsibambi,,org-org,PROPN,PROPN-PROPN,poss,compound-nsubj,NNP,NNP-NNP,3,1
756,718.0,18,were,11,5,8,3,4,9,6,-3,Madeline Lee Gilford,Jack Gilford,org-org-org,-,PROPN-PROPN-PROPN,PROPN-PROPN,compound-compound-compound,compound-conj,NNP-NNP-NNP,NNP-NNP,2,1
757,719.0,32,aired,2,5,18,13,4,13,-3,16,Bosnia,NTV HAYAT,,org-org,PROPN,PROPN-PROPN,pobj,compound-conj,NNP,NNP-NNP,7,1
758,720.0,33,is,9,20,20,0,19,12,-11,11,Delft,Delft University of Technology,,org-org-org-org,PROPN,PROPN-PROPN-ADP-PROPN,pobj,compound-pobj-prep-pobj,NNP,NNP-NNP-IN-NNP,0,1
759,721.0,14,provide,2,1,11,10,0,2,1,9,Viacom,MTV,,org,PROPN,PROPN,nsubj,compound,NNP,NNP,4,1
760,722.0,41,was,7,18,40,22,17,0,-11,33,Diego,Spain,,per,PROPN,PROPN,pobj,pobj,NNP,NNP,17,1
761,2952.0,30,sold,22,7,19,12,6,10,15,-3,Diego,Spain,,org,PROPN,PROPN,nsubj,pobj,NNP,NNP,1,1
762,723.0,18,declared,1,1,17,16,0,0,0,16,Christophe,Haiti,,per,PROPN,PROPN,nsubj,pobj,NNP,NNP,-1,1
763,2388.0,29,led,2,9,14,5,8,14,-7,12,Christophe,Haiti,,org,PROPN,PROPN,pobj,pobj,NNP,NNP,7,1
764,724.0,17,continued,2,1,15,14,0,1,1,13,DC Chaudhary,Minneapolis,-,org,PROPN-PROPN,PROPN,compound-nsubj,compound,NNP-NNP,NNP,4,1
765,725.0,34,Fan,1,23,3,-20,22,30,-22,2,he University of Californ,( UC,---,org-org,PRON-PROPN-ADP-PROPN,PUNCT-PROPN,compound-appos-prep-pobj,punct-compound,PRP-NNP-IN-NNP,-LRB--NNP,5,1
766,726.0,33,Gambetta,3,24,32,8,23,0,-21,29,Charles de Freycinet,France,org-org-org,,PROPN-PROPN-PROPN,PROPN,nmod-compound-conj,pobj,NNP-NNP-NNP,NNP,8,1
767,1932.0,38,In,0,4,11,7,3,26,-4,11,Charles de Freycinet,France,org-org-org,,PROPN-PROPN-PROPN,PROPN,compound-compound-nsubj,pobj,NNP-NNP-NNP,NNP,6,1
768,727.0,20,replaced,2,1,14,13,0,5,1,12,She,Celtic Woman,per,-,PRON,PROPN-PROPN,nsubjpass,compound-pobj,PRP,NNP-NNP,6,1
769,728.0,34,Raised,0,22,31,9,21,2,-22,31,2nd Division,New South Wales,per-per,--,ADJ-PROPN,PROPN-PROPN-PROPN,compound-pobj,compound-compound-pobj,JJ-NNP,NNP-NNP-NNP,10,1
770,729.0,18,is,6,13,17,4,12,0,-7,11,Lamar University,Texas,per-per,,PROPN-PROPN,PROPN,compound-pobj,pobj,NNP-NNP,NNP,3,1
771,730.0,16,operated,5,2,2,0,1,13,3,-3,US Airways Shuttle,US,org-org-org,,PROPN-PROPN-PROPN,PROPN,compound-compound-nsubjpass,compound,NNP-NNP-NNP,NNP,0,1
772,731.0,32,Note,0,3,11,8,2,20,-3,11,Memphis Slim,Peter Chatman,per-per,-,PROPN-PROPN,PROPN-PROPN,compound-npadvmod,compound-pobj,NNP-NNP,NNP-NNP,6,1
773,732.0,37,founded,3,1,8,7,0,28,2,5,City Year,Michael Brown,per-per,-,PROPN-PROPN,PROPN-PROPN,compound-nsubjpass,compound-pobj,NNP-NNP,NNP-NNP,3,1
774,733.0,30,includes,3,14,20,6,13,9,-11,17,Clive Barker,Razorline,org-org,,PROPN-PROPN,PROPN,compound-pobj,compound,NNP-NNP,NNP,5,1
775,734.0,22,Fassi,1,1,17,16,0,4,0,16,El Fassi,Morocco,org-org,,PROPN-PROPN,PROPN,compound-ROOT,pobj,NNP-NNP,NNP,2,1
776,735.0,25,is,2,1,23,22,0,1,1,21,Michelle Wright,Savannah,-,org,PROPN-PROPN,PROPN,compound-nsubj,compound,NNP-NNP,NNP,4,1
777,736.0,36,starred,5,4,9,5,3,26,1,4,Demi Moore,United States,per-per,-,PROPN-PROPN,PROPN-PROPN,compound-conj,compound-pobj,NNP-NNP,NNP-NNP,4,1
778,737.0,27,arranged,1,1,8,7,0,18,0,7,Crosby,Decca,org,,PROPN,PROPN,nsubj,compound,NNP,NNP,4,1
779,2204.0,15,recorded,1,1,13,12,0,1,0,12,Crosby,Decca,,per,PROPN,PROPN,nsubj,compound,NNP,NNP,4,1
780,738.0,18,is,4,1,12,11,0,5,3,8,Nicholas Orem Middle School,Hyattsville,per-per-per-per,,PROPN-PROPN-PROPN-PROPN,PROPN,compound-compound-compound-nsubj,compound,NNP-NNP-NNP-NNP,NNP,7,1
781,739.0,40,are,8,8,14,6,7,25,0,6,Australia,SelecTV,,org,PROPN,PROPN,pobj,attr,NNP,NNP,1,1
782,740.0,17,studied,2,1,14,13,0,2,1,12,Stewart,Alabama,per,,PROPN,PROPN,nsubj,compound,NNP,NNP,6,1
783,741.0,33,born,3,1,9,8,0,23,2,6,Bailey Rae,England,per-per,,PROPN-PROPN,PROPN,compound-nsubjpass,pobj,NNP-NNP,NNP,2,1
784,742.0,20,is,9,8,16,8,7,3,1,7,Birmingham,UAB Blazers,per,-,PROPN,PROPN-PROPN,compound,compound-compound,NNP,NNP-NNP,8,1
785,743.0,25,was,4,2,11,9,1,13,2,7,2nd Guards Army,Soviet Union,per-per-per,-,ADJ-PROPN-PROPN,PROPN-PROPN,compound-compound-nsubj,compound-poss,JJ-NNPS-NNP,NNP-NNP,6,1
786,744.0,25,offer,19,17,21,4,16,3,2,2,Old Dominion University,NCAA Division I,org-org-org,--,PROPN-PROPN-PROPN,PROPN-PROPN-PRON,compound-compound-conj,compound-dobj-nsubj,NNP-NNP-NNP,NNP-NNP-PRP,4,1
787,745.0,20,is,1,10,18,8,9,1,-9,17,The Kovenant,Nuclear Blast,-,org-org,DET-PROPN,PROPN-PROPN,det-nsubjpass,compound-pobj,DT-NNP,NNP-NNP,5,1
788,747.0,44,lowered,10,33,38,5,32,5,-23,28,Reserve Bank of Australia,Glenn Stevens,per-per-per-per,-,PROPN-PROPN-ADP-PROPN,PROPN-PROPN,nmod-nmod-prep-pobj,compound-nsubj,NNP-NNP-IN-NNP,NNP-NNP,4,1
789,748.0,22,notes,2,12,12,0,11,9,-10,10,Erhard,Erhard Seminars Training,,org-org-org,PROPN,PROPN-PROPN-PROPN,dobj,compound-compound-appos,NNP,NNP-NNPS-NNP,0,1
790,749.0,29,traces,3,1,9,8,0,19,2,6,Face to Face,1988,org-org-org,,NOUN-ADP-PROPN,NUM,nsubj-prep-pobj,pobj,NN-IN-NNP,CD,4,1
791,750.0,18,born,2,5,10,5,4,7,-3,8,Santiago,Manuel Balmaceda,,org-org,PROPN,PROPN-PROPN,compound,compound-pobj,NNP,NNP-NNP,3,1
792,751.0,26,contributed,14,7,12,5,6,13,7,-2,Relient K,Matt Thiessen,per-per,-,PROPN-PROPN,PROPN-PROPN,compound-poss,compound-compound,NNP-NNP,NNP-NNP,3,1
793,752.0,22,provided,13,19,21,2,18,0,-6,8,Setanta Sports,Ireland,-,per,PROPN-PROPN,PROPN,compound-compound,conj,NNP-NNPS,NNP,5,1
794,753.0,35,referred,4,1,2,1,0,32,3,-2,Team Losi,Losi,org-org,,PROPN-PROPN,PROPN,compound-nsubj,compound,NNP-NNP,NNP,2,1
795,754.0,37,studied,2,8,14,6,7,22,-6,12,Eastman School of Music,N.Y.,---,org,PROPN-PROPN-ADP-PROPN,PROPN,compound-pobj-prep-pobj,pobj,NNP-NNP-IN-NNP,NNP,3,1
796,755.0,31,cancelled,9,1,6,5,0,24,8,-3,India,Jet Airways,org,-,PROPN,PROPN-PROPN,poss,compound-nsubj,NNP,NNP-NNP,2,1
797,756.0,65,left,28,61,64,3,60,0,-33,36,Hillsdale College,Michigan,-,per,PROPN-PROPN,PROPN,compound-conj,pobj,NNP-NNP,NNP,4,1
798,757.0,64,played,45,21,43,22,20,20,24,-2,Chinese,Zhao Ziyang,,per-per,PROPN,PROPN-PROPN,pobj,compound-nsubjpass,NNPS,NNP-NNP,6,1
799,758.0,23,reached,2,6,19,13,5,3,-4,17,Arizona,Apollo High School,org,--,PROPN,PROPN-PROPN-PROPN,compound,compound-compound-pobj,NNP,NNP-NNP-NNP,7,1
800,759.0,38,attended,5,8,21,13,7,16,-3,16,University of Massachusetts Lowell,River Hawks,per-per-per-per,-,PROPN-ADP-PROPN-PROPN,PROPN-PROPN,dobj-prep-compound-pobj,pobj-compound,NNP-IN-NNP-NNP,NNP-NNPS,6,1
801,760.0,31,offered,3,11,17,6,10,13,-8,14,India,University of Delhi,org,--,PROPN,PROPN-ADP-PROPN,pobj,pobj-prep-pobj,NNP,NNP-IN-NNP,4,1
802,761.0,39,Use,31,11,14,3,10,24,20,-17,Public Enemy,Chuck D,-,org-org,PROPN-PROPN,PROPN-PROPN,compound-poss,compound-nsubj,NNP-NNP,NNP-NNP,1,1
803,762.0,37,is,8,18,34,16,17,2,-10,26,Ukraine,Roshen,org,,PROPN,PROPN,pobj,compound,NNP,NNP,6,1
804,763.0,40,was,23,13,29,16,12,10,10,6,Willi Stoph,Council,-,per,PROPN-PROPN,PROPN,compound-conj,pobj,NNP-NNP,NNP,14,1
805,764.0,30,performed,3,25,29,4,24,0,-22,26,Saratoga High School,California,--,org,PROPN-PROPN-PROPN,PROPN,compound-compound-compound,pobj,NNP-NNP-NNP,NNP,6,1
806,765.0,34,served,2,9,26,17,8,7,-7,24,Kansas,Missouri and Northern Arkansas Railroad,org,----,PROPN,PROPN-CCONJ-PROPN-PROPN-PROPN,compound,conj-cc-compound-compound-conj,NNP,NNP-CC-NNP-NNP-NNP,12,1
807,766.0,37,made,6,3,6,3,2,30,3,0,Arista,Wariner,,org,PROPN,PROPN,dobj,nsubj,NNP,NNP,3,1
808,767.0,19,wrote,9,3,18,15,2,0,6,9,Giorgio Vasari,Italy,-,per,PROPN-PROPN,PROPN,compound-compound,pobj,NNP-NNP,NNP,9,1
809,768.0,12,provides,2,6,11,5,5,0,-4,9,Magners League,Ireland,-,org,PROPN-PROPN,PROPN,compound-compound,pobj,NNPS-NNP,NNP,4,1
810,769.0,30,attempted,1,1,7,6,0,22,0,6,Najibullah,Kabul,per,,PROPN,PROPN,nsubj,pobj,NNP,NNP,2,1
811,770.0,26,is,7,6,20,14,5,5,1,13,Labor,Frances Perkins,org,-,PROPN,PROPN-PROPN,compound,compound-compound,NNP,NNP-NNP,5,1
812,2898.0,33,put,5,10,12,2,9,20,-5,7,Labor,Frances Perkins,org,-,PROPN,PROPN-PROPN,compound,compound-nsubj,NNP,NNP-NNP,3,1
813,771.0,30,Sirivadhanabhakdi,2,8,23,15,7,6,-6,21,Fraser and Neave,Singapore,org-org-org,,PROPN-CCONJ-PROPN,PROPN,pobj-cc-compound,pobj,NNP-CC-NNP,NNP,4,1
814,772.0,21,taught,2,1,12,11,0,8,1,10,He,TIFR,,per,PRON,PROPN,nsubj,nmod,PRP,NNP,3,1
815,773.0,27,opened,7,1,22,21,0,4,6,15,H. Lee Moffitt Cancer Center Research Institute,Florida,per-per-per-per-per-per-per,,PROPN-PROPN-PROPN-PROPN-PROPN-PROPN-PROPN,PROPN,compound-compound-compound-compound-compound-compound-nsubj,pobj,NNP-NNP-NNP-NNP-NNP-NNP-NNP,NNP,8,1
816,774.0,33,appointing,5,9,15,6,8,17,-4,10,W?adys?aw IV Va,of Lithuan,org-org-org,-,VERB-PROPN-PROPN,ADP-PROPN,compound-compound-compound,prep-pobj,VBP-NNP-NNP,IN-NNP,5,1
817,775.0,34,deal,2,27,32,5,26,1,-25,30,Jann Wenner,Rolling Stone,per-per,-,PROPN-PROPN,PROPN-PROPN,compound-pobj,compound-pobj,NNP-NNP,NNP-NNP,3,1
818,776.0,37,made,3,9,24,15,8,12,-6,21,India,Srinivasa Ramanujan,org,-,PROPN,PROPN-PROPN,pobj,compound-pobj,NNP,NNP-NNP,7,1
819,777.0,42,After,0,26,32,6,25,9,-26,32,Israel,Ben-Gurion University of the Negev,org,----,PROPN,PROPN-PROPN-ADP-DET-PROPN,pobj,compound-pobj-prep-det-pobj,NNP,NNP-NNP-IN-DT-NNP,6,1
820,778.0,33,Japan,0,1,17,16,0,15,-1,17,Japan,Takuro,per,,PROPN,PROPN,ROOT,compound,NNP,NNP,-1,1
821,2450.0,20,ranked,4,11,13,2,10,6,-7,9,Japan,Takuro,org,,PROPN,PROPN,poss,compound,NNP,NNP,2,1
822,779.0,28,returned,1,3,19,16,2,8,-2,18,him,Iowa,org,,PRON,PROPN,dobj,compound,PRP,NNP,4,1
823,780.0,25,offers,2,1,22,21,0,2,1,20,Towson University,Colonial Athletic Association,per-per,--,PROPN-PROPN,PROPN-PROPN-PROPN,compound-nsubj,compound-compound-pobj,NNP-NNP,NNP-NNP-NNP,8,1
824,781.0,33,felt,5,4,20,16,3,12,1,15,Argentina,Yrigoyen,,org,PROPN,PROPN,pobj,pobj,NNP,NNP,5,1
825,782.0,40,succeeded,8,5,8,3,4,31,3,0,Houston,UHD,,per,PROPN,PROPN,nsubj,nsubj,NNP,NNP,4,1
826,783.0,26,consists,5,2,13,11,1,12,3,8,Sounder commuter rail,Tacoma,--,org,PROPN-NOUN-NOUN,PROPN,compound-compound-compound,pobj,NNP-NN-NN,NNP,7,1
827,784.0,42,co-hosted,1,17,41,24,16,0,-16,40,Dolphy,Philippines,,per,PROPN,PROPN,pobj,pobj,NNP,NNP,6,1
828,785.0,26,believes,19,14,17,3,13,8,5,-2,The Citadel,Charleston,per-per,,DET-PROPN,PROPN,det-pobj,compound,DT-NNP,NNP,3,1
829,786.0,36,born,2,7,18,11,6,17,-5,16,Wales,Brynteg Comprehensive School,,org-org-org,PROPN,PROPN-PROPN-PROPN,pobj,compound-compound-appos,NNP,NNP-NNP-NNP,6,1
830,787.0,69,Department,0,7,9,2,6,59,-7,9,University of Turin,Turin,--,per,PROPN-ADP-PROPN,PROPN,conj-prep-compound,compound,NNP-IN-NNP,NNP,3,1
831,788.0,50,gave,14,14,49,35,13,0,0,35,TITV,2004,,org,PROPN,NUM,pobj,pobj,NNP,CD,1,1
832,789.0,51,married,1,1,46,45,0,4,0,45,Rivero,Puerto Rico,org,-,PROPN,PROPN-PROPN,pobj,compound-ROOT,NNP,NNP-NNP,-1,1
833,790.0,38,taught,33,18,18,0,17,19,15,-15,Stony Brook,Stony Brook University,per-per,--,PROPN-PROPN,PROPN-PROPN-PROPN,compound-pobj,compound-compound-attr,NNP-NNP,NNP-NNP-NNP,0,1
834,1316.0,28,joined,1,10,10,0,9,17,-9,9,Stony Brook,Stony Brook University,-,org-org-org,PROPN-PROPN,PROPN-PROPN-PROPN,compound-pobj,compound-compound-appos,NNP-NNP,NNP-NNP-NNP,0,1
835,791.0,32,is,7,25,26,1,24,5,-18,19,singer,Custodio Loyola,org,-,NOUN,PROPN-PROPN,compound,compound-pobj,NN,NNP-NNP,1,1
836,792.0,22,Ange,1,1,16,15,0,5,0,15,Criss Angel,musician,-,org,PROPN-PROPN,ADJ,compound-nsubj,amod,NNP-NNP,JJ,5,1
837,793.0,25,said,6,1,5,4,0,19,5,-1,New Zealand,Helen Clark,org-org,-,PROPN-PROPN,PROPN-PROPN,compound-compound,compound-nsubj,NNP-NNP,NNP-NNP,2,1
838,794.0,20,created,3,12,19,7,11,0,-9,16,Edmund Barton,Australia,org-org,,PROPN-PROPN,PROPN,compound-pobj,pobj,NNP-NNP,NNP,4,1
839,795.0,23,headed,5,1,8,7,0,14,4,3,AJS,Nick Brown,per,-,PROPN,PROPN-PROPN,compound,compound-pobj,NNP,NNP-NNP,4,1
840,796.0,29,is,12,11,23,12,10,5,1,11,Rome,University of Rome Tor Vergata,,org-org-org-org-org,PROPN,PROPN-ADP-PROPN-PROPN-PROPN,pobj,nmod-prep-pobj-compound-compound,NNP,NNP-IN-NNP-NNP-NNP,6,1
841,797.0,30,left,6,22,26,4,21,3,-16,20,Murfreesboro,Middle Tennessee State University,,per-per-per-per,PROPN,PROPN-PROPN-PROPN-PROPN,compound,compound-compound-compound-dobj,NNP,NNP-NNP-NNP-NNP,5,1
842,798.0,27,was,4,3,21,18,2,5,1,17,Ambrose,New York,per,-,PROPN,PROPN-PROPN,nsubj,compound-dobj,NNP,NNP-NNP,13,1
843,1169.0,35,made,6,6,23,17,5,11,0,17,Ambrose,New York,org,-,PROPN,PROPN-PROPN,nsubj,compound-nmod,NNP,NNP-NNP,7,1
844,799.0,13,moved,6,2,9,7,1,3,4,3,Colin,Castleknock,,per,PROPN,PROPN,nsubj,compound,NNP,NNP,4,1
845,800.0,29,appointed,5,7,14,7,6,14,-2,9,Port Klang Authority,Ong Tee Keat,per-per-per,--,PROPN-PROPN-PROPN,PROPN-PROPN-PROPN,compound-compound-compound,compound-compound-pobj,NNP-NNP-NNP,NNP-NNP-NNP,-1,1
846,801.0,46,announced,3,19,38,19,18,7,-16,35,Value City,Emerald Capital Management LLC,org-org,---,PROPN-PROPN,PROPN-PROPN-PROPN-PROPN,compound-compound,compound-compound-compound-pobj,NNP-NNP,NNP-NNP-NNP-NNP,13,1
847,802.0,28,is,1,1,6,5,0,21,0,5,Aberystwyth University,University of Wales,-,org-org-org,PROPN-PROPN,PROPN-ADP-PROPN,compound-pobj,nmod-prep-pobj,NNP-NNP,NNP-IN-NNP,4,1
848,803.0,35,makes,1,21,30,9,20,4,-20,29,Choummaly Sayasone,Lao People,-,org-org,PROPN-PROPN,PROPN-PROPN,compound-pobj,compound-poss,NNP-NNP,NNP-NNPS,5,1
849,804.0,61,was,1,11,7,-4,10,53,-10,6,April 29 1974,University of Montenegro,per-per-per,--,PROPN-NUM-NUM,PROPN-ADP-PROPN,pobj-nummod-nummod,appos-prep-pobj,NNP-CD-CD,NNP-IN-NNP,7,1
850,805.0,31,stepped,5,1,25,24,0,5,4,20,Russia,Yukos,per,,PROPN,PROPN,nsubj,compound,NNP,NNP,9,1
851,806.0,25,represented,9,4,20,16,3,4,5,11,East Tennessee State University,Division I,---,per-per,PROPN-PROPN-PROPN-PROPN,PROPN-PRON,compound-compound-compound-dobj,pobj-nsubj,NNP-NNP-NNP-NNP,NNP-PRP,7,1
852,807.0,33,told,8,3,8,5,2,24,5,0,Gordon Smith,Oregon,-,org,PROPN-PROPN,PROPN,compound-nsubj,pobj,NNP-NNP,NNP,1,1
853,808.0,21,led,5,1,17,16,0,3,4,12,Tokyo,Sumitomo Mitsui Financial Group,org,---,PROPN,PROPN-PROPN-PROPN-PROPN,poss,compound-compound-compound-conj,NNP,NNP-NNP-NNP-NNP,9,1
854,809.0,24,built,1,1,8,7,0,15,0,7,He,Veracruz,,org,PRON,PROPN,nsubj,poss,PRP,NNP,4,1
855,810.0,23,said,3,2,14,12,1,8,1,11,airline Lufthansa,Frankfurt,-,org,NOUN-PROPN,PROPN,compound-nsubj,compound,NN-NNP,NNP,4,1
856,811.0,48,On,0,5,27,22,4,20,-5,27,Ho,Vietnam,,org,PROPN,PROPN,nsubj,pobj,NNP,NNP,8,1
857,812.0,28,was,6,6,25,19,5,2,0,19,bank,Huntingdon Life Sciences,,org-org-org,NOUN,PROPN-PROPN-PROPN,nsubj,compound-compound-appos,NN,NNP-NNP-NNPS,9,1
858,813.0,13,is,0,8,11,3,7,1,-8,11,Goichi Suda,Grasshopper Manufacture,per-per,-,PROPN-PROPN,PROPN-PROPN,compound-pobj,compound-pobj,NNP-NNP,NNP-NNP,2,1
859,814.0,32,won,7,3,6,3,2,25,4,-1,Clash,2004,,org,PROPN,NUM,compound,pobj,NNP,CD,3,1
860,815.0,36,said,4,28,31,3,27,4,-24,27,Federal Reserve,Alan Greenspan,per-per,-,PROPN-PROPN,PROPN-PROPN,compound-compound,compound-appos,NNP-NNP,NNP-NNP,4,1
861,816.0,35,unveiled,4,19,25,6,18,9,-15,21,Kay Barnes,Mayor,org-org,,PROPN-PROPN,PROPN,compound-appos,dobj,NNP-NNP,NNP,4,1
862,817.0,32,located,3,1,17,16,0,14,2,14,Lincoln High,United States,per-per,-,PROPN-PROPN,PROPN-PROPN,compound-nsubjpass,compound-pobj,NNP-NNP,NNP-NNP,8,1
863,818.0,37,said,14,1,5,4,0,31,13,-9,Richard Riordan,Los Angeles,org-org,-,PROPN-PROPN,PROPN-PROPN,compound-nsubj,compound-compound,NNP-NNP,NNP-NNP,2,1
864,819.0,18,born,2,5,12,7,4,5,-3,10,Tolui,Sorghaghtani Beki,,org-org,PROPN,PROPN-PROPN,pobj,compound-conj,NNP,NNP-NNP,4,1
865,820.0,17,held,4,2,7,5,1,9,2,3,tournament,2000,org,,NOUN,NUM,nsubjpass,pobj,NN,CD,2,1
866,821.0,26,is,6,5,23,18,4,2,1,17,ARC,Sacramento,,per,PROPN,PROPN,appos,compound,NNP,NNP,9,1
867,822.0,30,painted,3,2,11,9,1,18,1,8,Milan,San Carlo,per,-,PROPN,PROPN-PROPN,pobj,compound-pobj,NNP,NNP-NNP,6,1
868,823.0,63,saw,1,17,28,11,16,34,-16,27,Kenneth MacMillan,London,org-org,,PROPN-PROPN,PROPN,compound-poss,pobj,NNP-NNP,NNP,10,1
869,824.0,28,served,2,12,17,5,11,10,-10,15,State for Trade and Industry,Norman Tebbit,per-per-per-per-per,-,PROPN-ADP-PROPN-CCONJ-PROPN,PROPN-PROPN,pobj-prep-pobj-cc-conj,compound-ROOT,NNP-IN-NNP-CC-NNP,NNP-NNP,2,1
870,825.0,48,used,2,39,47,8,38,0,-37,45,Constantine,Greece,,per,PROPN,PROPN,poss,pobj,NNP,NNP,12,1
871,1311.0,18,accepted,11,1,9,8,0,8,10,-2,Constantine,Greece,per,,NOUN,PROPN,nsubj,pobj,NN,NNP,4,1
872,826.0,44,found,22,39,42,3,38,1,-17,20,North Carolina,Erskine Bowles,org-org,-,PROPN-PROPN,PROPN-PROPN,compound-compound,compound-pobj,NNP-NNP,NNP-NNP,2,1
873,827.0,32,is,2,2,8,6,1,23,0,6,university,Group of Eight,org,--,NOUN,PROPN-ADP-NUM,nsubj,nmod-prep-pobj,NN,NNP-IN-CD,4,1
874,828.0,19,was,7,4,15,11,3,3,3,8,Christian Outreach College,Mansfield,--,org,PROPN-PROPN-PROPN,PROPN,compound-compound-compound,pobj,NNP-NNP-NNP,NNP,9,1
875,829.0,31,Turmel's,0,7,16,9,6,14,-7,16,Social Credit Party of Canada,1935,per-per-per-per-per,,PROPN-PROPN-PROPN-ADP-PROPN,NUM,compound-compound-dobj-prep-pobj,pobj,NNP-NNP-NNP-IN-NNP,CD,6,1
876,830.0,30,Along,0,15,20,5,14,9,-15,20,Dusty Hill,Dallas,-,per,PROPN-PROPN,PROPN,compound-conj,compound,NNP-NNP,NNP,5,1
877,831.0,40,collaborated,3,8,16,8,7,23,-5,13,Tim Berners-Lee,World Wide Web Foundation,per-per,---,PROPN-PROPN,PROPN-PROPN-PROPN-PROPN,compound-pobj,compound-compound-compound-pobj,NNP-NNP,NNP-NNP-NNP-NNP,6,1
878,832.0,13,served,1,1,8,7,0,4,0,7,Khalil,Egypt,,per,PROPN,PROPN,nsubj,pobj,NNP,NNP,1,1
879,1908.0,22,served,4,4,21,17,3,0,0,17,Khalil,Egypt,,org,PROPN,PROPN,nsubj,pobj,NNP,NNP,1,1
880,2817.0,20,known,3,1,17,16,0,2,2,14,Khalil,Egypt,,org,PROPN,PROPN,nsubjpass,pobj,NNP,NNP,8,1
881,833.0,30,Custis,3,2,24,22,1,5,1,21,Washington,American,,org,PROPN,ADJ,pobj,amod,NNP,JJ,-1,1
882,834.0,122,conducts,36,15,15,0,14,106,21,-21,DGSE Companies,DGSE,org-org,,PROPN-PROPN,PROPN,compound-compound,compound,NNP-NNPS,NNP,0,1
883,835.0,23,Jacques-Charles,5,6,13,7,5,9,-1,8,Jacques-Charles Dupont de l'Eure,Provisional Government,org-org-org-org,-,PROPN-PROPN-PROPN-PROPN,PROPN-PROPN,ROOT-nmod-nmod-punct,compound-pobj,NNP-NNP-NNP-NNP,NNP-NNP,5,1
884,836.0,77,replied,11,49,51,2,48,25,-38,40,United States,VIII Corps,per-per,-,PROPN-PROPN,PROPN-PROPN,compound-compound,compound-nsubj,NNP-NNP,NNP-NNP,6,1
885,837.0,30,was,4,14,23,9,13,6,-10,19,Ahmed,Guinea,,org,PROPN,PROPN,pobj,nsubj,NNP,NNP,3,1
886,838.0,29,starred,4,6,25,19,5,3,-2,21,Liza Minnelli,Actress,per-per,,PROPN-PROPN,PROPN,compound-dobj,pobj,NNP-NNP,NNP,5,1
887,839.0,26,signed,3,20,21,1,19,4,-17,18,actress,Tricia Helfer,,per-per,NOUN,PROPN-PROPN,compound,compound-pobj,NN,NNP-NNP,1,1
888,840.0,30,promoted,4,22,27,5,21,2,-18,23,Soviet Union,4th Mechanized Corps,org-org,--,PROPN-PROPN,ADJ-PROPN-PROPN,compound-compound,amod-amod-dobj,NNP-NNP,JJ-NNP-NNP,9,1
889,841.0,24,is,8,1,14,13,0,9,7,6,Gavin Exell,footballer,per-per,,PROPN-PROPN,NOUN,compound-nsubj,attr,NNP-NNP,NN,4,1
890,842.0,46,visiting,19,36,41,5,35,4,-17,22,Marios Garoyian,House,org-org,,PROPN-PROPN,PROPN,compound-conj,pobj,NNP-NNP,NNP,4,1
891,843.0,20,forgave,2,1,9,8,0,10,1,7,Ted,his,per,,PROPN,DET,nsubj,poss,NNP,PRP$,4,1
892,844.0,14,Completed,0,7,13,6,6,0,-7,13,Larrinaga Steamship Co Ltd,London,per-per-per-per,,PROPN-PROPN-PROPN-PROPN,PROPN,compound-compound-compound-compound,pobj,NNP-NNP-NNP-NNP,NNP,4,1
893,845.0,14,available,2,6,10,4,5,3,-4,8,The Ledger,Florida,-,per,DET-PROPN,PROPN,det-pobj,compound,DT-NNP,NNP,3,1
894,846.0,25,included,5,7,17,10,6,7,-2,12,Donald Sangster,Jamaica,-,org,PROPN-PROPN,PROPN,compound-compound,pobj,NNP-NNP,NNP,4,1
895,847.0,20,is,3,9,17,8,8,2,-6,14,Frog Eyes,Absolutely Kosher,per-per,-,PROPN-PROPN,PROPN-PROPN,compound-pobj,compound-compound,NNP-NNP,NNP-NNP,6,1
896,848.0,63,included,3,17,21,4,16,41,-14,18,Carl Cox,England,per-per,,PROPN-PROPN,PROPN,compound-ROOT,appos,NNP-NNP,NNP,1,1
897,849.0,29,filmed,8,17,28,11,16,0,-9,20,Brooklyn,Jones,,per,PROPN,PROPN,compound,pobj,NNP,NNP,8,1
898,850.0,23,returned,7,17,22,5,16,0,-10,15,Vic Sotto,host,org-org,,PROPN-PROPN,NOUN,compound-pobj,pobj,NNP-NNP,NN,8,1
899,851.0,32,With,0,13,20,7,12,11,-13,20,Berlin,Air Berlin,org,-,PROPN,PROPN-PROPN,pobj,compound-nsubj,NNP,NNP-NNP,8,1
900,852.0,22,defrauded,6,6,11,5,5,10,0,5,Sweden,Nordea,per,,PROPN,PROPN,pobj,poss,NNP,NNP,5,1
901,853.0,30,drawing,2,7,11,4,6,18,-5,9,New Democracy,Constantine Mitsotakis,per-per,-,PROPN-PROPN,PROPN-PROPN,compound-compound,compound-pobj,NNP-NNP,NNP-NNP,3,1
902,854.0,15,founded,3,1,11,10,0,3,2,8,Pakistan Tehreek-e-Insaf,1996,per-per,,PROPN-PROPN,NUM,compound-nsubjpass,nummod,NNP-NNP,CD,2,1
903,855.0,12,became,3,2,10,8,1,1,1,7,1944,Dominion Network,,per-per,NUM,PROPN-PROPN,pobj,compound-pobj,CD,NNP-NNP,6,1
904,856.0,30,came,3,13,17,4,12,12,-10,14,Illinois,Stephen A. Douglas,per,--,PROPN,PROPN-PROPN-PROPN,poss,compound-compound-nsubj,NNP,NNP-NNP-NNP,4,1
905,857.0,32,were,20,24,28,4,23,3,-4,8,Georgia,Lado Gurgenidze,,org-org,PROPN,PROPN-PROPN,poss,compound-nsubj,NNP,NNP-NNP,3,1
906,2705.0,20,became,4,10,18,8,9,1,-6,14,Georgia,Lado Gurgenidze,,per-per,PROPN,PROPN-PROPN,pobj,compound-pobj,NNP,NNP-NNP,3,1
907,858.0,79,was,2,27,51,24,26,27,-25,49,Hong Kong,Open University of Hong Kong,-,org-org-org-org-org,PROPN-PROPN,PROPN-PROPN-ADP-PROPN-PROPN,compound-appos,compound-pobj-prep-compound-pobj,NNP-NNP,NNP-NNP-IN-NNP-NNP,-1,1
908,859.0,27,went,10,21,25,4,20,1,-11,15,Lewis-Clark State College,Lewiston,--,per,VERB-PROPN-PROPN,PROPN,amod-compound-dep,compound,VB-NNP-NNP,NNP,3,1
909,860.0,28,released,5,5,26,21,4,1,0,21,band,Rise Records,org,-,NOUN,PROPN-PROPN,nsubj,compound-pobj,NN,NNP-NNPS,8,1
910,861.0,27,says,3,2,20,18,1,6,1,17,Communist Party,Mikhail Gorbachev,-,org-org,PROPN-PROPN,PROPN-PROPN,compound-nsubj,compound-nsubj,NNP-NNP,NNP-NNP,9,1
911,862.0,35,defeated,8,12,17,5,11,17,-4,9,Julius C. Burrows,Michigan,--,per,PROPN-PROPN-PROPN,PROPN,compound-compound-dobj,poss,NNP-NNP-NNP,NNP,6,1
912,863.0,41,got,7,2,3,1,1,37,5,-4,President,Zine El Abidine Ben Ali,,per-per-per-per-per,PROPN,PROPN-PROPN-PROPN-PROPN-PROPN,compound,compound-compound-compound-compound-nsubj,NNP,NNP-NNP-NNP-NNP-NNP,2,1
913,864.0,24,is,2,2,19,17,1,4,0,17,Reading,Berkshire,,org,PROPN,PROPN,pcomp,compound,NNP,NNP,7,1
914,865.0,31,was,1,21,25,4,20,5,-20,24,Geoff Lawson,Australian,org-org,,PROPN-PROPN,PROPN,compound-dobj,nsubjpass,NNP-NNP,NNP,3,1
915,866.0,19,moved,4,4,7,3,3,11,0,3,company,Canton,per,,NOUN,PROPN,nsubj,compound,NN,NNP,2,1
916,867.0,20,was,1,10,11,1,9,8,-9,10,Poland,Boles?aw II the Bol,,per-per-per-per,PROPN,PROPN-PROPN-DET-PROPN,nmod,compound-pobj-det-compound,NNP,NNP-NNP-DT-NNP,1,1
917,868.0,60,purchased,32,14,31,17,13,28,18,-1,Birmingham Small Arms Company,BSA,per-per-per-per,,PROPN-PROPN-PROPN-PROPN,PROPN,compound-compound-compound-pobj,nsubjpass,NNP-NNP-NNPS-NNP,NNP,9,1
918,869.0,28,prompted,1,7,8,1,6,19,-6,7,Japan,Ryutaro Hashimoto,,per-per,PROPN,PROPN-PROPN,pobj,compound-dobj,NNP,NNP-NNP,1,1
919,870.0,27,published,5,5,23,18,4,3,0,18,Torres,Barcelona,,org,PROPN,PROPN,nsubj,appos,NNP,NNP,2,1
920,871.0,28,said,4,4,18,14,3,9,0,14,Uyghurs,China,per,,PROPN,PROPN,pobj,pobj,NNPS,NNP,5,1
921,872.0,26,is,13,19,19,0,18,6,-6,6,Oxford Brookes University,Oxford,org-org-org,,PROPN-PROPN-PROPN,PROPN,compound-compound-pobj,compound,NNP-NNP-NNP,NNP,0,1
922,873.0,22,remain,5,13,17,4,12,4,-8,12,American,Shannon Walker,,per-per,ADJ,PROPN-PROPN,amod,compound-appos,JJ,NNP-NNP,4,1
923,874.0,12,is,7,1,5,4,0,6,6,-2,Cory Spinks,Missouri,org-org,,PROPN-VERB,PROPN,compound-compound,compound,NNP-VBZ,NNP,2,1
924,875.0,50,labels,21,10,18,8,9,31,11,-3,Apocalypse,Musea,,per,PROPN,PROPN,appos,pobj,NNP,NNP,6,1
925,876.0,37,taught,12,2,12,10,1,24,10,0,she,Dassanowsky,per,,PRON,PROPN,nsubj,pobj,PRP,NNP,1,1
926,877.0,43,received,2,2,23,21,1,19,0,21,he,Valand School of Fine Arts,per,----,PRON,PROPN-PROPN-ADP-PROPN-PROPN,nsubj,compound-pobj-prep-compound-pobj,PRP,NNP-NNP-IN-NNP-NNPS,6,1
927,878.0,27,founded,3,8,21,13,7,5,-5,18,Sunday Morning Records,Short Stack,--,org-org,PROPN-PROPN-PROPN,PROPN-PROPN,compound-compound-dobj,compound-dobj,NNP-NNP-NNPS,NNP-NNP,4,1
928,879.0,25,received,5,9,12,3,8,12,-4,7,Germany,Richard von,,per-per,PROPN,PROPN-PROPN,compound,compound-conj,NNP,NNP-NNP,1,1
929,880.0,19,established,9,2,18,16,1,0,7,9,Civil Affairs Police Force,Malaya,per-per-per-per,,PROPN-PROPN-PROPN-PROPN,PROPN,compound-compound-compound-nsubjpass,pobj,NNP-NNPS-NNP-NNP,NNP,4,1
930,881.0,27,told,4,8,13,5,7,13,-4,9,Howard,Sydney,per,,PROPN,PROPN,nsubjpass,poss,NNP,NNP,2,1
931,882.0,49,featured,22,2,29,27,1,19,20,7,Richards,New Barbarians,,per-per,PROPN,PROPN-PROPN,nsubj,compound-conj,NNP,NNP-NNPS,4,1
932,883.0,41,was,10,6,13,7,5,27,4,3,Amsterdam,Dutch East India Company,per,---,PROPN,PROPN-PROPN-PROPN-PROPN,pobj,compound-compound-compound-nmod,NNP,NNP-NNP-NNP-NNP,5,1
933,884.0,21,represented,7,3,3,0,2,17,4,-4,Jacksonville,Jacksonville State University,,per-per-per,PROPN,PROPN-PROPN-PROPN,compound,compound-compound-dobj,NNP,NNP-NNP-NNP,0,1
934,885.0,30,won,4,8,14,6,7,15,-4,10,Dr. Korto,Education,-,per,PROPN-PROPN,PROPN,compound-nsubjpass,pobj,NNP-NNP,NNP,2,1
935,886.0,44,investigating,3,14,28,14,13,15,-11,25,Rajasthan Royals,2008,org-org,,PROPN-PROPN,NUM,nmod-nmod,pobj,NNP-NNPS,CD,7,1
936,887.0,35,founded,6,2,8,6,1,26,4,2,Fred Myers,HSUS,per-per,,PROPN-PROPN,PROPN,compound-nsubj,dobj,NNP-NNP,NNP,3,1
937,888.0,37,puzzled,2,17,21,4,16,15,-15,19,Montana,Max Baucus,per,-,PROPN,PROPN-PROPN,compound,compound-appos,NNP,NNP-NNP,3,1
938,889.0,34,entered,6,19,31,12,18,2,-13,25,Newport Television,Providence Equity Partners,-,org-org-org,PROPN-PROPN,PROPN-PROPN-PROPN,compound-pobj,compound-compound-appos,NNP-NNP,NNP-NNP-NNPS,7,1
939,890.0,18,are,4,2,15,13,1,2,2,11,Oakland Golden Grizzlies,Rochester,--,org,PROPN-PROPN-PROPN,PROPN,compound-compound-nsubj,compound,NNP-NNP-NNPS,NNP,8,1
940,891.0,47,born,2,15,18,3,14,28,-13,16,Nuala,Claiborne Pell,per,-,PROPN,PROPN-PROPN,compound,compound-conj,NNP,NNP-NNP,1,1
941,892.0,34,fits,3,1,9,8,0,24,2,6,Tacoda,AOL,org,,PROPN,PROPN,poss,poss,NNP,NNP,9,1
942,893.0,33,started,3,21,32,11,20,0,-18,29,OpenLink Software,2007,-,org,PROPN-PROPN,NUM,compound-pobj,pobj,NNP-NNP,CD,5,1
943,894.0,23,was,4,1,6,5,0,16,3,2,His,Afghanistan,,per,DET,PROPN,poss,poss,PRP$,NNP,4,1
944,895.0,34,is,10,1,9,8,0,24,9,-1,Saeta TV,Raul Fontaina,org-org,-,PROPN-PROPN,PROPN-PROPN,compound-compound,compound-pobj,NNP-NNP,NNP-NNP,4,1
945,896.0,44,asked,2,27,29,2,26,14,-25,27,Rome,Alitalia,org,,PROPN,PROPN,pobj,compound,NNP,NNP,1,1
946,897.0,27,was,1,1,8,7,0,18,0,7,Tangmere,RAF Tangmere,,per-per,PROPN,PROPN-PROPN,nsubj,compound-compound,NNP,NNP-NNP,4,1
947,898.0,24,sold,5,2,19,17,1,4,3,14,Volkswagen,Wolfsburg,,org,PROPN,PROPN,compound,pobj,NNP,NNP,3,1
948,899.0,23,reacted,3,2,21,19,1,1,1,18,United States,Wesley Merritt,org-org,-,PROPN-PROPN,PROPN-PROPN,compound-nsubj,compound-pobj,NNP-NNP,NNP-NNP,6,1
949,2567.0,27,1898,3,10,22,12,9,4,-7,19,United States,Wesley Merritt,-,per-per,PROPN-PROPN,PROPN-PROPN,compound-nsubj,compound-pobj,NNP-NNP,NNP-NNP,3,1
950,900.0,23,planned,7,1,3,2,0,19,6,-4,Cuomo,New York,per,-,PROPN,PROPN-PROPN,nsubj,compound-compound,NNP,NNP-NNP,4,1
951,901.0,31,releases,6,5,13,8,4,17,1,7,Verve,Astrud Gilberto,org,-,PROPN,PROPN-PROPN,compound,compound-conj,NNP,NNP-NNP,6,1
952,902.0,29,spun,20,3,27,24,2,1,17,7,SFX,Live Nation,,org-org,PROPN,ADJ-PROPN,dobj,compound-dobj,NNP,JJ-NNP,4,1
953,903.0,21,said,13,15,20,5,14,0,-2,7,Chissano,Mozambique,,org,PROPN,PROPN,nsubj,pobj,NNP,NNP,4,1
954,904.0,35,appeared,6,31,32,1,30,2,-25,26,director,J. J. Abrams,per,--,NOUN,PROPN-PROPN-PROPN,compound,compound-compound-pobj,NN,NNP-NNP-NNP,2,1
955,905.0,34,said,4,18,33,15,17,0,-14,29,Jean-Marie Le Pen,France,--,per,PROPN-PROPN-PROPN,PROPN,compound-compound-pobj,pobj,NNP-NNP-NNP,NNP,11,1
956,907.0,25,is,8,13,2,-11,12,22,-5,-6,American,Winans family,,per-per,PROPN,PROPN-NOUN,amod,compound-pobj,NNP,NNPS-NN,5,1
957,908.0,33,is,10,1,15,14,0,17,9,5,Joseph,writer,,org,PROPN,NOUN,compound,attr,NNP,NN,4,1
958,909.0,17,born,2,1,8,7,0,8,1,6,Pfaff,New York,per,-,PROPN,PROPN-PROPN,nsubjpass,compound-pobj,NNP,NNP-NNP,4,1
959,910.0,42,reported,24,27,30,3,26,11,-3,6,Japan Airlines,JAL,-,org,PROPN-PROPN,PROPN,compound-nsubj,appos,NNP-NNP,NNP,4,1
960,911.0,13,is,8,1,7,6,0,5,7,-1,Ray Williams,England,-,per,PROPN-PROPN,PROPN,compound-nsubj,npadvmod,NNP-NNP,NNP,2,1
961,912.0,35,succeeded,12,5,19,14,4,15,7,7,Viktor Yanukovych,Party of Regions,per-per,--,PROPN-PROPN,PROPN-ADP-PROPN,compound-pobj,pobj-prep-pobj,NNP-NNP,NNP-IN-NNPS,9,1
962,913.0,52,has,1,14,21,7,13,30,-13,20,Liga Nacional de Baloncesto Profesional,Halcones UV Xalapa,----,org-org-org,PROPN-PROPN-PROPN-PROPN-PROPN,PROPN-PROPN-PROPN,compound-compound-compound-compound-attr,compound-compound-nsubj,NNP-NNP-NNP-NNP-NNP,NNPS-NNP-NNP,4,1
963,914.0,24,is,1,7,22,15,6,1,-6,21,United Malays National Organisation,Barisan Nasional,---,per-per,PROPN-PROPN-PROPN-PROPN,PROPN-PROPN,compound-compound-compound-pobj,compound-appos,NNP-NNP-NNP-NNP,NNP-NNP,8,1
964,915.0,20,is,7,5,17,12,4,2,2,10,San State University,Spartans,per-per-per,,PROPN-PROPN-PROPN,PROPN,compound-compound-compound,compound,NNP-NNP-NNP,NNPS,9,1
965,916.0,49,founded,4,2,20,18,1,28,2,16,United Church,Canada,per-per,,PROPN-PROPN,PROPN,compound-nsubjpass,pobj,NNP-NNP,NNP,3,1
966,917.0,50,operates,8,20,35,15,19,14,-12,27,Kansas City Power Light,Great Plains Energy,org-org-org-org,--,PROPN-PROPN-PROPN-PROPN,PROPN-PROPN-PROPN,compound-compound-compound-ROOT,compound-compound-pobj,NNP-NNP-NNP-NNP,NNP-NNPS-NNP,-1,1
967,918.0,20,arrived,1,1,4,3,0,15,0,3,Haines,Chicago,per,,NOUN,PROPN,nsubj,pobj,NNS,NNP,1,1
968,919.0,19,noted,4,8,9,1,7,9,-4,5,drummer,Ray Luzier,per,-,NOUN,PROPN-PROPN,compound,compound-nsubj,NN,NNP-NNP,1,1
969,920.0,57,are,10,20,21,1,19,35,-10,11,George Eastman,Eastman Kodak,org-org,-,PROPN-PROPN,PROPN-PROPN,compound-pobj,compound-pobj,NNP-NNP,NNP-NNP,1,1
970,921.0,10,Goode,2,5,8,3,4,1,-3,6,His,Chess,,org,DET,PROPN,poss,compound,PRP$,NNP,2,1
971,922.0,68,holds,2,11,14,3,10,53,-9,12,New University of Lisbon,Lisbon,org-org-org-org,,PROPN-PROPN-ADP-PROPN,PROPN,compound-appos-prep-pobj,dobj,NNP-NNP-IN-NNP,NNP,2,1
972,923.0,12,served,2,1,4,3,0,7,1,2,Frederick Sumaye,Tanzania,org-org,,PROPN-PROPN,PROPN,compound-nsubj,dobj,NNP-NNP,NNP,2,1
973,924.0,44,reproduced,6,40,41,1,39,2,-34,35,Sinaloa,cartel,org,,PROPN,NOUN,compound,compound,NNP,NN,4,1
974,925.0,37,served,6,5,24,19,4,12,1,18,Japan,r Emperor Taish,per,--,PROPN,PROPN-PROPN-PROPN,pobj,nummod-compound-conj,NNP,NNP-NNP-NNP,3,1
975,926.0,22,murdered,5,2,16,14,1,5,3,11,Scott La Rock,BDP,--,per,PROPN-PROPN-PROPN,PROPN,compound-compound-nsubjpass,poss,NNP-NNP-NNP,NNP,8,1
976,927.0,20,grew,3,1,17,16,0,2,2,14,Washington Medical College,Maryland,--,org,PROPN-PROPN-PROPN,PROPN,compound-compound-nsubj,compound,NNP-NNP-NNP,NNP,11,1
977,928.0,32,Founded,0,5,26,21,4,5,-5,26,China,PBOC,per,,PROPN,PROPN,dobj,nmod,NNP,NNP,9,1
978,929.0,24,recruited,3,6,17,11,5,6,-3,14,Directors Guild of America,1936,org-org-org-org,,PROPN-PROPN-ADP-PROPN,NUM,compound-nmod-prep-pobj,pobj,NNPS-NNP-IN-NNP,CD,3,1
979,930.0,10,studied,1,1,4,3,0,5,0,3,He,Italy,per,,PRON,PROPN,nsubj,pobj,PRP,NNP,3,1
980,931.0,29,is,9,2,4,2,1,24,7,-5,United States,Air Force Space Command,-,per-per-per-per,PROPN-PROPN,PROPN-PROPN-PROPN-PROPN,compound-compound,compound-compound-compound-compound,NNP-NNP,NNP-NNP-NNP-NNP,1,1
981,1618.0,18,gained,8,12,14,2,11,3,-4,6,United States,Air Force Space Command,per-per,---,PROPN-PROPN,PROPN-PROPN-PROPN-PROPN,compound-compound,compound-compound-compound-pobj,NNP-NNP,NNP-NNP-NNP-NNP,2,1
982,932.0,21,produced,4,14,19,5,13,1,-10,15,CBC,Leslie Nielsen,,per-per,PROPN,PROPN-PROPN,compound,compound-pobj,NNP,NNP-NNP,8,1
983,933.0,38,is,24,1,2,1,0,35,23,-22,Victoria Lorna Aluquin-Fernandez,Lorna Tolentino,--,org-org,PROPN-PROPN-PROPN,PROPN-PROPN,compound-compound-nsubj,compound-pobj,NNP-NNP-NNP,NNP-NNP,2,1
984,934.0,33,transferred,1,4,22,18,3,10,-3,21,Michigan Technological University,Huskies,--,org,PROPN-PROPN-PROPN,PROPN,compound-compound-pobj,compound,NNP-NNP-NNP,NNP,7,1
985,935.0,24,attended,1,3,3,0,2,20,-2,2,St. Augustine High School,St. Augustine,---,org-org,PROPN-PROPN-PROPN-PROPN,PROPN-PROPN,compound-compound-compound-dobj,compound-nmod,NNP-NNP-NNP-NNP,NNP-NNP,0,1
986,936.0,39,performed,6,21,35,14,20,3,-15,29,Bard College,Annandale-on-Hudson,org-org,,PROPN-PROPN,PROPN,compound-poss,compound,NNP-NNP,NNP,6,1
987,938.0,24,appeared,2,14,22,8,13,1,-12,20,Webbie,United States,,org-org,PROPN,PROPN-PROPN,dobj,compound-pobj,NNP,NNP-NNP,3,1
988,939.0,52,told,20,11,22,11,10,29,9,2,Francesco Cossiga,Italy,-,per,PROPN-PROPN,PROPN,compound-nsubj,poss,NNP-NNP,NNP,6,1
989,940.0,38,proved,2,32,37,5,31,0,-30,35,Marcy,State,,per,PROPN,PROPN,dobj,pobj,NNP,NNP,4,1
990,941.0,31,had,2,16,23,7,15,7,-14,21,James Abbott McNeill Whistler,London,org-org-org-org,,PROPN-PROPN-PROPN-PROPN,PROPN,compound-compound-compound-appos,pobj,NNP-NNP-NNP-NNP,NNP,3,1
991,942.0,30,attended,1,9,15,6,8,14,-8,14,Beaver Brae Secondary School,Ontario,org-org-org-org,,PROPN-PROPN-PROPN-PROPN,PROPN,compound-compound-compound-dobj,pobj,NNP-NNP-NNP-NNP,NNP,2,1
992,943.0,20,presented,2,11,19,8,10,0,-9,17,Alfonso Portillo,Guatemala,org-org,,PROPN-PROPN,PROPN,compound-pobj,pobj,NNP-NNP,NNP,6,1
993,944.0,17,Angeles-based,9,11,15,4,10,1,-2,6,Lola Montes,Spanish,org-org,,PROPN-PROPN,ADJ,compound-dobj,amod,NNP-NNPS,JJ,3,1
994,945.0,16,educated,2,5,15,10,4,0,-3,13,Edgehill College,Devon,per-per,,PROPN-PROPN,PROPN,compound-pobj,pobj,NNP-NNP,NNP,3,1
995,946.0,34,attended,7,9,14,5,8,19,-2,7,Boylan Catholic High School,Rockford,per-per-per-per,,PROPN-PROPN-PROPN-PROPN,PROPN,compound-compound-compound-dobj,compound,NNP-NNP-NNP-NNP,NNP,4,1
996,947.0,30,remains,22,6,20,14,5,9,16,-2,Army,Washington,per,,PROPN,PROPN,compound,poss,NNP,NNP,7,1
997,948.0,87,decided,13,45,49,4,44,37,-32,36,University of Kent,Canterbury,per-per-per,,PROPN-ADP-PROPN,PROPN,pobj-prep-pobj,pobj,NNP-IN-NNP,NNP,2,1
998,949.0,57,featured,4,4,14,10,3,42,0,10,360,Firehouse Subs,org,-,NUM,PROPN-PROPN,nummod,compound-compound,CD,NNP-NNP,6,1
999,950.0,66,born,2,52,52,0,51,13,-50,50,George,George VI of the United Kingdom,per,-----,PROPN,PROPN-PROPN-ADP-DET-PROPN-PROPN,oprd,compound-pobj-prep-det-compound-pobj,NNP,NNP-NNP-IN-DT-NNP-NNP,0,1
1000,951.0,24,responded,6,1,5,4,0,18,5,-1,Canada,John Baird,per,-,PROPN,PROPN-PROPN,poss,compound-nsubj,NNP,NNP-NNP,3,1
1001,952.0,43,was,8,26,11,-15,25,31,-18,3,St Kilda Football Club,Australian Football League,org-org-org-org,--,PROPN-PROPN-PROPN-PROPN,PROPN-PROPN-PROPN,compound-compound-compound-pobj,compound-compound-pobj,NNP-NNP-NNP-NNP,NNP-NNP-NNP,8,1
1002,953.0,47,spends,7,42,45,3,41,1,-35,38,Lazard,Bruce Wasserstein,org,-,PROPN,PROPN-PROPN,nmod,compound-pobj,NNP,NNP-NNP,1,1
1003,954.0,41,is,6,16,27,11,15,13,-10,21,Spain,Diego,org,,PROPN,PROPN,pobj,pobj,NNP,NNP,6,1
1004,955.0,17,located,8,2,15,13,1,1,6,7,University of Girona,Catalonia,org-org-org,,PROPN-ADP-PROPN,PROPN,nsubjpass-prep-pobj,compound,NNP-IN-NNP,NNP,6,1
1005,956.0,31,occupy,17,6,9,3,5,21,11,-8,Victoria of the United Kingdom,United Kingdom,org-org-org-org-org,-,PROPN-ADP-DET-PROPN-PROPN,PROPN-PROPN,pobj-prep-det-compound-pobj,compound-conj,NNP-IN-DT-NNP-NNP,NNP-NNP,1,1
1006,957.0,30,began,15,6,26,20,5,3,9,11,Michigan,Twinkie,,per,PROPN,PROPN,pobj,compound,NNP,NNP,7,1
1007,958.0,32,are,1,21,25,4,20,6,-20,24,Timken Company,Canton,-,per,PROPN-PROPN,PROPN,compound-pobj,pobj,NNP-NNP,NNP,4,1
1008,1455.0,14,founded,1,4,12,8,3,1,-3,11,Timken Company,Canton,per-per,,PROPN-PROPN,PROPN,compound-dobj,compound,NNP-NNP,NNP,3,1
1009,959.0,29,is,4,8,11,3,7,17,-4,7,politician,Gilles Duceppe,,org-org,NOUN,PROPN-PROPN,attr,compound-conj,NN,NNP-NNP,2,1
1010,960.0,60,are,1,33,44,11,32,15,-32,43,Simon Hughes,Liberal Democrats,org-org,-,PROPN-PROPN,PROPN-PROPN,compound-compound,compound-pobj,NNP-NNP,NNP-NNPS,4,1
1011,961.0,15,coached,4,7,11,4,6,3,-3,7,Augusta GreenJackets,South Atlantic League,-,per-per-per,PROPN-PROPN,PROPN-PROPN-PROPN,compound-dobj,compound-compound-compound,NNP-NNP,NNP-NNP-NNP,5,1
1012,962.0,36,is,31,7,7,0,6,28,24,-24,San Francisco State University,San Francisco State Normal School,org-org-org-org,----,PROPN-PROPN-PROPN-PROPN,PROPN-PROPN-PROPN-PROPN-PROPN,compound-compound-compound-pobj,compound-compound-compound-compound-appos,NNP-NNP-NNP-NNP,NNP-NNP-NNP-NNP-NNP,0,1
1013,963.0,45,Eagle,1,24,29,5,23,15,-23,28,Executive Airlines,Puerto Rico,per-per,-,PROPN-PROPN,PROPN-PROPN,compound-nsubj,compound-pobj,NNP-NNPS,NNP-NNP,3,1
1014,1382.0,59,used,7,23,29,6,22,29,-16,22,Executive Airlines,Puerto Rico,org-org,-,PROPN-PROPN,PROPN-PROPN,compound-pobj,compound-pobj,NNP-NNPS,NNP-NNP,6,1
1015,964.0,39,seen,12,26,37,11,25,1,-14,25,Jasmine Trias,Honolulu,-,per,PROPN-PROPN,PROPN,compound-pobj,compound,NNP-NNP,NNP,8,1
1016,965.0,32,gone,6,18,4,-14,17,27,-12,-2,Joe Clark,Alberta,org-org,,PROPN-PROPN,PROPN,nmod-nmod,poss,NNP-NNP,NNP,8,1
1017,966.0,32,born,2,1,10,9,0,21,1,8,Bartholomew,United States,,per-per,PROPN,PROPN-PROPN,nsubjpass,compound-pobj,NNP,NNP-NNP,4,1
1018,967.0,52,stopped,10,2,26,24,1,25,8,16,Odex,Singapore,,org,PROPN,PROPN,nsubj,pobj,NNP,NNP,3,1
1019,968.0,50,drove,9,18,41,23,17,8,-9,32,Chad,Idriss,,org,PROPN,PROPN,pobj,pobj,NNP,NNP,10,1
1020,969.0,24,received,1,1,12,11,0,11,0,11,He,Chicago,org,,PRON,PROPN,nsubj,pobj,PRP,NNP,1,1
1021,970.0,49,is,22,29,34,5,28,14,-7,12,Austrian,Hans Hass,org,-,ADJ,PROPN-PROPN,amod,compound-appos,JJ,NNP-NNP,3,1
1022,971.0,23,is,6,14,15,1,13,7,-8,9,musician,Prince,per,,NOUN,PROPN,compound,pobj,NN,NNP,1,1
1023,972.0,34,took,2,8,16,8,7,17,-6,14,Helmut Kohl,Germany,per-per,,PROPN-PROPN,PROPN,compound-nsubjpass,pobj,NNP-NNP,NNP,2,1
1024,973.0,43,won,3,8,27,19,7,15,-5,24,Venezuela,Universidad Metropolitana,per,-,PROPN,PROPN-PROPN,pobj,compound-appos,NNP,NNP-NNP,6,1
1025,974.0,37,was,2,24,24,0,23,12,-22,22,California,California State University,org,--,PROPN,PROPN-PROPN-PROPN,pobj,compound-compound-compound,NNP,NNP-NNP-NNP,0,1
1026,975.0,20,include,4,3,7,4,2,12,1,3,Stave Puzzles,Elizabeth II,-,per-per,PROPN-PROPN,PROPN-PROPN,compound-pobj,compound-compound,NNP-NNPS,NNP-NNP,4,1
1027,976.0,16,said,6,1,5,4,0,10,5,-1,Rocky Mountain News,John Temple,per-per-per,-,PROPN-PROPN-PROPN,PROPN-PROPN,compound-compound-compound,compound-nsubj,NNP-NNP-NNP,NNP-NNP,2,1
1028,977.0,18,is,2,1,14,13,0,3,1,12,Jason Perry,Suffolk,-,per,PROPN-PROPN,PROPN,compound-nsubj,npadvmod,NNP-NNP,NNP,6,1
1029,978.0,24,said,5,2,4,2,1,19,3,-1,Defence,Arturo Parisi,,per-per,PROPN,PROPN-PROPN,compound,compound-nsubj,NNP,NNP-NNP,1,1
1030,979.0,18,attended,1,3,3,0,2,14,-2,2,Tyler Junior College,Tyler,per-per-per,,PROPN-PROPN-PROPN,PROPN,compound-compound-dobj,compound,NNP-NNP-NNP,NNP,0,1
1031,980.0,55,signed,35,12,28,16,11,26,23,-7,Imperial Japanese Army,Empire of Japan,--,org-org-org,PROPN-PROPN-PROPN,PROPN-ADP-PROPN,compound-compound-pobj,pobj-prep-pobj,NNP-NNP-NNP,NNP-IN-NNP,6,1
1032,981.0,12,purchased,4,1,7,6,0,4,3,3,Portsea Passenger Service,Grenda,--,org,PROPN-PROPN-PROPN,PROPN,compound-compound-nsubjpass,compound,NNP-NNP-NNP,NNP,4,1
1033,982.0,39,brought,6,20,27,7,19,11,-14,21,Samoan,David Tua,org,-,PROPN,PROPN-PROPN,nsubj,compound-appos,NNP,NNP-NNP,3,1
1034,983.0,30,confiscated,6,9,10,1,8,19,-3,4,King,Henry VIII of England,org,---,PROPN,PROPN-PROPN-ADP-PROPN,compound,compound-pobj-prep-pobj,NNP,NNP-NNP-IN-NNP,2,1
1035,984.0,25,given,14,2,13,11,1,11,12,-1,Antonio Sanchez,Mexico,per-per,,PROPN-PROPN,PROPN,compound-nsubjpass,pobj,NNP-NNP,NNP,2,1
1036,985.0,21,downed,10,16,19,3,15,1,-6,9,Teru,Japan,,per,PROPN,PROPN,compound,pobj,NNP,NNP,3,1
1037,986.0,17,honeymooned,2,13,15,2,12,1,-11,13,Italian,Amedeo Modigliani,org,-,ADJ,PROPN-PROPN,amod,compound-dobj,JJ,NNP-NNP,1,1
1038,987.0,36,travelled,3,21,34,13,20,1,-18,31,Gymnasium Paulinum,797,org-org,,PROPN-PROPN,NUM,compound-nsubjpass,pobj,NNP-NNP,CD,2,1
1039,988.0,14,based,2,1,12,11,0,1,1,10,LVMH,Paris,,org,PROPN,PROPN,nsubjpass,compound,NNP,NNP,6,1
1040,989.0,24,located,3,17,19,2,16,4,-14,16,University of Derby,Derby,--,per,PROPN-ADP-PROPN,PROPN,pobj-prep-pobj,pobj,NNP-IN-NNP,NNP,4,1
1041,991.0,23,accounts,10,2,21,19,1,1,8,11,Haksan Culture Company,South Korea,per-per-per,-,PROPN-PROPN-PROPN,PROPN-PROPN,compound-compound-pobj,compound-pobj,NNP-NNP-NNP,NNP-NNP,9,1
1042,992.0,17,are,6,3,11,8,2,5,3,5,170th Group,Nebraska,per-per,,ADJ-PROPN,PROPN,amod-pobj,compound,JJ-NNP,NNP,7,1
1043,993.0,30,tried,2,1,11,10,0,18,1,9,Sweyn Forkbeard,Denmark,-,per,PROPN-PROPN,PROPN,compound-nsubj,pobj,NNP-NNP,NNP,2,1
1044,994.0,21,studied,1,8,14,6,7,6,-7,13,National Film and Television School,Beaconsfield,org-org-org-org-org,,PROPN-PROPN-CCONJ-PROPN-PROPN,PROPN,nmod-nmod-cc-conj-pobj,compound,NNP-NNP-CC-NNP-NNP,NNP,3,1
1045,995.0,18,is,10,10,14,4,9,3,0,4,it,Business School,org,-,PRON,PROPN-PROPN,nsubj,compound-attr,PRP,NNP-NNP,1,1
1046,996.0,29,exhibited,4,7,16,9,6,12,-3,12,Mexico,Clemente Orozco,org,-,PROPN,PROPN-PROPN,compound,compound-compound,NNP,NNP-NNP,9,1
1047,2054.0,45,works,2,13,27,14,12,17,-11,25,Mexico,Clemente Orozco,,per-per,PROPN,PROPN-PROPN,nmod,compound-pobj,NNP,NNP-NNP,6,1
1048,997.0,35,heard,2,10,18,8,9,16,-8,16,Paula P-Orridge,Psychic TV,per-per,-,PROPN-PROPN,PROPN-PROPN,compound-conj,compound-poss,NNP-NNP,NNP-NNP,6,1
1049,998.0,35,is,1,22,34,12,21,0,-21,33,Paul Gray,Iowa,org-org,,PROPN-PROPN,PROPN,compound-compound,pobj,NNP-NNP,NNP,4,1
1050,999.0,42,is,1,34,37,3,33,4,-33,36,Value City,Columbus,-,org,PROPN-PROPN,PROPN,compound-conj,pobj,NNP-NNP,NNP,2,1
1051,1000.0,55,marries,1,24,31,7,23,23,-23,30,Golda,Jerusalem,per,,PROPN,PROPN,poss,pobj,NNP,NNP,9,1
1052,1001.0,24,said,13,15,22,7,14,1,-2,9,Janice Min,US Weekly,org-org,-,PROPN-PROPN,PROPN-PROPN,compound-compound,compound-appos,NNP-NNP,NNP-NNP,4,1
1053,1002.0,27,moved,3,6,11,5,5,15,-3,8,Portugal,F.C. Porto,per,-,PROPN,PROPN-PROPN,compound,compound-nsubj,NNP,NNP-NNP,2,1
1054,1003.0,21,served,1,1,17,16,0,3,0,16,Adlam,40th Regiment of Foot,,per-per-per-per,PROPN,ADJ-NOUN-ADP-PROPN,nsubj,compound-pobj-prep-pobj,NNP,JJ-NN-IN-NNP,4,1
1055,1004.0,19,is,3,2,1,-1,1,17,1,-2,New Haven,Yale School of Medicine,-,org-org-org-org,PROPN-PROPN,PROPN-PROPN-ADP-PROPN,compound-nsubj,compound-pobj-prep-pobj,NNP-NNP,NNP-NNP-IN-NNP,1,1
1056,1005.0,50,moved,26,26,32,6,25,17,0,6,PSDB,Fernando Henrique Cardoso,per,--,PROPN,PROPN-PROPN-PROPN,pobj,compound-compound-nsubj,NNP,NNP-NNP-NNP,7,1
1057,1006.0,28,is,2,1,24,23,0,3,1,22,Amblin Entertainment,Frank Marshall,org-org,-,PROPN-PROPN,PROPN-PROPN,compound-nsubj,compound-conj,NNP-NNP,NNP-NNP,6,1
1058,1007.0,15,produced,3,6,9,3,5,5,-3,6,Britt Daniel,Spoon,per-per,,PROPN-PROPN,PROPN,compound-pobj,pobj,NNP-NNP,NNP,3,1
1059,1008.0,21,runs,2,10,20,10,9,0,-8,18,UCL,Bloomsbury,,org,PROPN,PROPN,compound,pobj,NNP,NNP,7,1
1060,1009.0,25,is,10,1,17,16,0,7,9,7,TunisAir,Tunisia,,org,PROPN,PROPN,compound,pobj,NNP,NNP,4,1
1061,1010.0,29,served,1,1,7,6,0,21,0,6,Snyder,University of Chicago,,org-org-org,NOUN,PROPN-ADP-PROPN,nsubj,nmod-prep-pobj,NN,NNP-IN-NNP,5,1
1062,1011.0,25,was,4,1,24,23,0,0,3,20,His,Sweden,,org,DET,PROPN,poss,pobj,PRP$,NNP,2,1
1063,1012.0,20,founded,5,1,10,9,0,9,4,5,Cooper Firearms of Montana,Dan Cooper,---,per-per,PROPN-PROPN-ADP-PROPN,PROPN-PROPN,compound-nsubjpass-prep-pobj,compound-pobj,NNP-NNP-IN-NNP,NNP-NNP,3,1
1064,1013.0,25,was,2,6,12,6,5,12,-4,10,Thin Lizzy,Gary Moore,org-org,-,PROPN-PROPN,PROPN-PROPN,compound-compound,compound-nsubj,NNP-NNP,NNP-NNP,4,1
1065,1014.0,29,won,7,1,3,2,0,25,6,-4,Italy,Marco Simoncelli,per,-,PROPN,PROPN-PROPN,poss,compound-nsubj,NNP,NNP-NNP,2,1
1066,1015.0,62,was,13,13,18,5,12,43,0,5,Armenia,State Engineering University of Armenia,org,----,PROPN,PROPN-PROPN-PROPN-ADP-PROPN,pobj,pobj-compound-attr-prep-pobj,NNP,NNP-NNP-NNP-IN-NNP,2,1
1067,1016.0,43,continued,1,1,12,11,0,30,0,11,Pickett,RCA,org,,PROPN,PROPN,nsubj,pobj,NNP,NNP,2,1
1068,1017.0,27,is,4,2,11,9,1,15,2,7,16th Sustainment Brigade,Theater Sustainment Command,per-per-per,--,ADJ-PROPN-PROPN,PROPN-PROPN-PROPN,amod-compound-nsubj,compound-compound-pobj,JJ-NNP-NNP,NNP-NNP-NNP,6,1
1069,1018.0,15,formed,3,1,11,10,0,3,2,8,Saosin,Justin Shekoski,per,-,PROPN,PROPN-PROPN,compound,compound-pobj,NNP,NNP-NNP,4,1
1070,1019.0,20,founded,3,2,10,8,1,9,1,7,company,H. J. Gray,org,--,NOUN,PROPN-PROPN-PROPN,nsubjpass,compound-compound-nsubj,NN,NNP-NNP-NNP,6,1
1071,1020.0,28,going,3,11,19,8,10,8,-8,16,Donna Ladd,Jackson Free Press,-,per-per-per,PROPN-PROPN,PROPN-PROPN-PROPN,compound-appos,compound-compound-pobj,NNP-NNP,NNP-NNP-NNP,6,1
1072,1021.0,31,reported,6,5,10,5,4,20,1,4,Knoxville,TVA,,per,PROPN,PROPN,compound,nsubj,NNP,NNP,5,1
1073,1022.0,47,served,1,14,15,1,13,31,-13,14,Ottawa,Larry O'Brien,,org-org,PROPN,PROPN-PROPN,compound,compound-pobj,NNP,NNP-NNP,1,1
1074,1231.0,11,pay,5,1,3,2,0,7,4,-2,Ottawa,Larry O'Brien,,org-org,PROPN,PROPN-PROPN,compound,compound-nsubj,NNP,NNP-NNP,1,1
1075,1023.0,23,made,7,4,13,9,3,9,3,6,Zellers,HBC,per,,PROPN,PROPN,compound,nsubj,NNP,NNP,4,1
1076,1024.0,47,showed,7,36,36,0,35,10,-29,29,Virginia and Truckee Railroad,Virginia,---,org,PROPN-CCONJ-PROPN-PROPN,PROPN,nmod-cc-conj-conj,compound,NNP-CC-NNP-NNP,NNP,0,1
1077,1025.0,12,headquartered,2,1,7,6,0,4,1,5,It,California,,per,PRON,PROPN,nsubjpass,compound,PRP,NNP,3,1
1078,1026.0,40,went,3,8,24,16,7,15,-5,21,Canada,Chante,org,,PROPN,PROPN,nmod,poss,NNP,NNP,-1,1
1079,1027.0,41,battled,2,2,17,15,1,23,0,15,Tigers,SEC,,org,PROPN,PROPN,nsubj,compound,NNPS,NNP,4,1
1080,1028.0,27,provides,2,8,12,4,7,14,-6,10,Air Mobility Command,AMC,--,org,PROPN-PROPN-PROPN,PROPN,nmod-nmod-nmod,nmod,NNP-NNP-NNP,NNP,7,1
1081,2000.0,58,is,2,11,21,10,10,36,-9,19,Air Mobility Command,AMC,--,org,PROPN-PROPN-PROPN,PROPN,compound-compound-pobj,appos,NNP-NNP-NNP,NNP,4,1
1082,1029.0,42,was,18,9,28,19,8,13,9,10,Dorset,Edward IV of England,,per-per-per-per,PROPN,PROPN-PROPN-ADP-PROPN,pobj,compound-pobj-prep-pobj,NNP,NNP-NNP-IN-NNP,10,1
1083,1030.0,25,founded,1,3,7,4,2,17,-2,6,Bad Boy,Sean Combs,-,org-org,PROPN-PROPN,PROPN-PROPN,compound-compound,compound-pobj,NNP-NNP,NNP-NNPS,4,1
1084,1031.0,36,Bloomfield,5,26,31,5,25,4,-21,26,Rick Danko,Breeze Hill,org-org,-,PROPN-PROPN,PROPN-PROPN,compound-conj,compound-pobj,NNP-NNP,NNP-NNP,6,1
1085,1032.0,23,grew,2,7,13,6,6,9,-5,11,Washington,Sidwell Friends School,per,--,PROPN,PROPN-PROPN-PROPN,compound,compound-compound-dative,NNP,NNP-NNPS-NNP,6,1
1086,1033.0,43,completed,11,4,18,14,3,24,7,7,Westinghouse Electric Company,Toshiba,--,per,PROPN-PROPN-PROPN,PROPN,compound-compound-pobj,nsubj,NNP-NNP-NNP,NNP,6,1
1087,1034.0,17,was,2,8,15,7,7,1,-6,13,S. Husky,Los Angeles,-,org-org,PROPN-PROPN,PROPN-PROPN,compound-pobj,compound-conj,NNP-NNP,NNP-NNP,3,1
1088,1035.0,27,sentenced,12,4,10,6,3,16,8,-2,Cecilia Ibru,Oceanic Bank,org-org,-,PROPN-PROPN,PROPN-PROPN,compound-pobj,compound-pobj,NNP-NNP,NNP-NNP,3,1
1089,1036.0,19,went,2,1,8,7,0,10,1,6,Esther Ouwehand,Katwijk,-,per,PROPN-PROPN,PROPN,compound-nsubj,pobj,NNP-NNP,NNP,5,1
1090,1037.0,42,became,3,3,11,8,2,30,0,8,Anneli,Finland,,per,PROPN,PROPN,nsubj,pobj,NNP,NNP,1,1
1091,1038.0,22,is,1,1,21,20,0,0,0,20,LJMU,England,per,,PROPN,PROPN,nsubj,pobj,NNP,NNP,1,1
1092,1039.0,17,remained,3,1,14,13,0,2,2,11,She,University of Karachi,,org-org-org,PRON,PROPN-ADP-PROPN,nsubj,pobj-prep-pobj,PRP,NNP-IN-NNP,6,1
1093,1040.0,43,received,2,1,42,41,0,0,1,40,Kish Air,Iran,-,org,PROPN-PROPN,PROPN,compound-nsubj,pobj,NNP-NNP,NNP,2,1
1094,1041.0,15,chosen,4,10,14,4,9,0,-6,10,Samsung's Anycall,Anyband,per-per,,PROPN-PROPN,PROPN,compound-compound,pobj,NNP-NNP,NNP,3,1
1095,1042.0,47,inducted,4,27,25,-2,26,21,-23,21,Maryland,University of Baltimore,,org-org-org,PROPN,PROPN-ADP-PROPN,pobj,appos-prep-compound,NNP,NNP-IN-NNP,4,1
1096,1043.0,33,is,1,8,13,5,7,19,-7,12,Quincy,Take-Two Interactive,per,-,PROPN,PROPN-PROPN,pobj,compound-compound,NNP,NNP-NNP,5,1
1097,1044.0,19,reside,10,1,17,16,0,1,9,7,Joseph,Los Angeles,per,-,PROPN,PROPN-PROPN,nsubj,compound-pobj,NNP,NNP-NNP,6,1
1098,1045.0,32,restored,4,21,25,4,20,6,-17,21,Infrastructure and Transport,Antonio Di Pietro,org-org-org,--,NOUN-CCONJ-PROPN,PROPN-PROPN-PROPN,nmod-cc-conj,compound-compound-nsubj,NN-CC-NNP,NNP-NNP-NNP,2,1
1099,1046.0,23,trained,2,1,15,14,0,7,1,13,Smith,Canada,per,,PROPN,PROPN,nsubjpass,pobj,NNP,NNP,5,1
1100,1047.0,14,lost,5,4,12,8,3,1,1,7,Troy King,GOP,org-org,,PROPN-PROPN,PROPN,compound-nsubj,compound,NNP-NNP,NNP,5,1
1101,1048.0,24,met,6,5,13,8,4,10,1,7,Italy,Beretta,org,,PROPN,PROPN,pobj,compound,NNP,NNP,4,1
1102,1049.0,13,based,2,1,5,4,0,7,1,3,Artumas,Canada,,org,PROPN,PROPN,nsubjpass,pobj,NNP,NNP,2,1
1103,1050.0,37,signed,6,11,29,18,10,7,-5,23,Atlantic,Jimmy Page,,org-org,PROPN,PROPN-PROPN,compound,compound-pobj,NNP,NNP-NNP,9,1
1104,1051.0,25,is,5,10,24,14,9,0,-5,19,Vincent van Gogh,France,per-per-per,,PROPN-PROPN-PROPN,PROPN,compound-compound-pobj,pobj,NNP-NNP-NNP,NNP,8,1
1105,1052.0,22,proposed,3,3,19,16,2,2,0,16,he,Maine,,per,PRON,PROPN,nsubj,poss,PRP,NNP,8,1
1106,1053.0,20,was,1,9,13,4,8,6,-8,12,Southern Sting,National Bank Cup,per-per,--,PROPN-PROPN,PROPN-PROPN-PROPN,compound-appos,compound-compound-pobj,NNP-NNP,NNP-NNP-NNP,3,1
1107,1054.0,22,appointed,2,5,14,9,4,7,-3,12,Nikki Haley,Department of Employment and Workforce,per-per,----,PROPN-PROPN,PROPN-ADP-PROPN-CCONJ-PROPN,compound-pobj,pobj-prep-pobj-cc-conj,NNP-NNP,NNP-IN-NNP-CC-NNP,7,1
1108,1055.0,11,born,3,1,10,9,0,0,2,7,Munir Bashir,Iraq,-,org,PROPN-PROPN,PROPN,compound-nsubjpass,pobj,NNP-NNP,NNP,2,1
1109,1056.0,30,examined,18,2,13,11,1,16,16,-5,United States Department of Transportation,Federal Aviation Administration,org-org-org-org-org,--,PROPN-PROPN-PROPN-ADP-PROPN,PROPN-PROPN-PROPN,compound-compound-nsubj-prep-pobj,compound-compound-dobj,NNP-NNP-NNP-IN-NNP,NNP-NNP-NNP,4,1
1110,1057.0,35,said,5,4,11,7,3,23,1,6,Eurobank EFG,Athens,-,per,PROPN-PROPN,PROPN,compound-nsubj,nsubjpass,NNP-NNP,NNP,4,1
1111,1058.0,24,represent,9,4,12,8,3,11,5,3,Miami Hurricanes,University of Miami,per-per,--,PROPN-PROPN,PROPN-ADP-PROPN,nmod-nmod,dobj-prep-pobj,NNP-NNP,NNP-IN-NNP,3,1
1112,1059.0,47,launched,27,30,43,13,29,3,-3,16,Liberal Reformers,People of Freedom,per-per,--,PROPN-PROPN,PROPN-ADP-PROPN,compound-dobj,nmod-prep-pobj,NNP-NNPS,NNPS-IN-NNP,8,1
1113,1060.0,29,is,3,10,17,7,9,11,-7,14,New Zealand,Max Merritt,-,org-org,PROPN-PROPN,PROPN-PROPN,compound-compound,compound-pobj,NNP-NNP,NNP-NNP,5,1
1114,1061.0,31,cast,6,1,10,9,0,20,5,4,Evan Dando,guitarist,per-per,,PROPN-PROPN,NOUN,compound-nsubjpass,compound,NNP-NNP,NN,4,1
1115,1062.0,19,is,2,1,15,14,0,3,1,13,Tezpur University,1994,per-per,,PROPN-PROPN,NUM,compound-nsubj,pobj,NNP-NNP,CD,4,1
1116,1063.0,24,began,2,14,21,7,13,2,-12,19,Cobalt,y Shueish,org,-,PROPN,PROPN-PROPN,pobj,nmod-compound,NNP,NNP-NNP,3,1
1117,1064.0,28,closed,7,10,9,-1,9,18,-3,2,Hampton High School,The Old Hamptonians Association Inc,org-org-org,----,PROPN-PROPN-PROPN,PROPN-PROPN-PROPN-PROPN-PROPN,compound-compound-compound,det-compound-compound-compound-nsubjpass,NNP-NNP-NNP,NNP-NNP-NNPS-NNP-NNP,2,1
1118,1065.0,27,served,2,1,9,8,0,17,1,7,Madison,State,,org,PROPN,PROPN,nsubj,pobj,NNP,NNP,2,1
1119,1066.0,20,reassigned,3,2,7,5,1,12,1,4,unit,United States,,org-org,NOUN,PROPN-PROPN,nsubjpass,compound-pobj,NN,NNP-NNP,3,1
1120,1067.0,13,is,3,1,11,10,0,1,2,8,Winn-Dixie,Jacksonville,,org,PROPN,PROPN,compound,compound,NNP,NNP,5,1
1121,1068.0,62,rejected,11,24,44,20,23,17,-13,33,Andries Treurnicht,Conservative Party,per-per,-,PROPN-PROPN,PROPN-PROPN,compound-pobj,compound-dobj,NNPS-NNP,NNP-NNP,8,1
1122,1069.0,20,said,5,1,4,3,0,15,4,-1,AGL,Michael Fraser,org,-,PROPN,PROPN-PROPN,compound,compound-nsubj,NNP,NNP-NNP,2,1
1123,1070.0,29,chosen,11,7,15,8,6,13,4,4,Pirates of the Sea,Latvia,org-org-org-org,,PROPN-ADP-DET-PROPN,PROPN,nsubjpass-prep-det-pobj,dobj,NNPS-IN-DT-NNP,NNP,4,1
1124,1071.0,19,is,5,3,18,15,2,0,2,13,Christen Middle School,Texas,org-org-org,,PROPN-PROPN-PROPN,PROPN,compound-compound-nsubj,pobj,NNP-NNP-NNP,NNP,3,1
1125,1072.0,22,been,4,2,14,12,1,7,2,10,RTL Klub,Hungary,per-per,,PROPN-PROPN,PROPN,compound-nsubj,pobj,NNP-NNP,NNP,2,1
1126,1073.0,24,created,16,6,11,5,5,12,10,-5,Puerto Rican Independence Party,Partido Independentista,org-org-org-org,-,ADJ-ADJ-PROPN-PROPN,PROPN-PROPN,compound-amod-compound-nsubjpass,compound-appos,JJ-JJ-NNP-NNP,NNP-NNP,2,1
1127,1074.0,36,refused,1,1,19,18,0,16,0,18,China,Junichiro Koizumi,org,-,PROPN,PROPN-PROPN,nsubj,compound-poss,NNP,NNP-NNP,4,1
1128,1075.0,20,say,2,7,19,12,6,0,-5,17,Nawaz,Pakistan,,org,PROPN,PROPN,nsubj,dobj,NNP,NNP,4,1
1129,1076.0,37,found,1,1,33,32,0,3,0,32,Kantor,Independent School of Art,org,---,PROPN,PROPN-PROPN-ADP-PROPN,nsubj,compound-pobj-prep-pobj,NNP,NNP-NNP-IN-NNP,7,1
1130,1077.0,31,shortened,7,1,21,20,0,9,6,14,Matthew Humberstone Church,North East Lincolnshire,per-per-per,--,PROPN-PROPN-PROPN,PROPN-PROPN-PROPN,compound-compound-nsubj,compound-compound-compound,NNP-NNP-NNP,NNP-NNP-NNP,8,1
1131,1078.0,35,announce,6,19,27,8,18,7,-13,21,Vietnam,Ho,org,,PROPN,PROPN,appos,pobj,NNP,NNP,7,1
1132,1079.0,27,was,3,13,21,8,12,5,-10,18,Air Education and Training Command,Randolph Air Force Base,org-org-org-org-org,---,PROPN-PROPN-CCONJ-PROPN-PROPN,PROPN-PROPN-PROPN-PROPN,compound-nmod-cc-conj-pobj,compound-compound-compound-pobj,NNP-NNP-CC-NNP-NNP,NNP-NNP-NNP-NNP,7,1
1133,1080.0,18,said,8,1,16,15,0,1,7,8,RealAge,Hearst Magazines,org,-,PROPN,PROPN-PROPN,nsubj,compound-pobj,NNP,NNP-NNPS,5,1
1134,1081.0,28,elected,2,1,7,6,0,20,1,5,He,New Brunswick,,per-per,PRON,PROPN-PROPN,nsubjpass,compound-compound,PRP,NNP-NNP,5,1
1135,1082.0,29,divided,1,6,6,0,5,22,-5,5,Hialeah,Hialeah High School,per,--,PROPN,PROPN-PROPN-PROPN,pobj,compound-compound-nsubj,NNP,NNP-NNP-NNP,0,1
1136,1083.0,20,mayor,2,6,11,5,5,8,-4,9,Environment and Natural Resources,Lito Atienza,per-per-per-per,-,PROPN-CCONJ-PROPN-PROPN,PROPN-PROPN,conj-cc-compound-conj,compound-nsubjpass,NNP-CC-NNP-NNP,NNP-NNP,4,1
1137,1084.0,39,taken,18,26,30,4,25,8,-8,12,State,Norma Paulus,org,-,PROPN,PROPN-PROPN,pobj,compound-conj,NNP,NNP-NNP,5,1
1138,1085.0,34,is,1,10,32,22,9,1,-9,31,Yogyakarta,UKDW,,per,PROPN,PROPN,pobj,appos,NNP,NNP,-1,1
1139,1086.0,58,noted,14,10,14,4,9,43,4,0,New York,Hikind,-,org,PROPN-PROPN,PROPN,compound-compound,pobj,NNP-NNP,NNP,2,1
1140,1087.0,35,gained,1,1,7,6,0,27,0,6,Malawi,Hastings Banda,,org-org,PROPN,PROPN-PROPN,nsubj,compound-nsubj,NNP,NNP-NNP,2,1
1141,1509.0,17,was,5,14,15,1,13,1,-9,10,Malawi,Hastings Banda,,per-per,PROPN,PROPN-PROPN,compound,compound-pobj,NNP,NNP-NNP,1,1
1142,1088.0,16,is,4,4,10,6,3,5,0,6,Academy,Rotterdam,per,,PROPN,PROPN,nsubj,pobj,NNP,NNP,5,1
1143,1089.0,17,became,2,1,7,6,0,9,1,5,Dakota Power,Black Hills Corporation,-,org-org-org,PROPN-PROPN,PROPN-PROPN-PROPN,compound-nsubj,compound-compound-attr,NNP-NNP,NNP-NNPS-NNP,5,1
1144,1090.0,18,was,1,1,4,3,0,13,0,3,Namesys,California,,per,PROPN,PROPN,nsubj,compound,NNP,NNP,1,1
1145,1091.0,44,began,4,36,42,6,35,1,-32,38,Arkansas,Alice Walton,,per-per,PROPN,PROPN-PROPN,compound,compound-dobj,NNP,NNP-NNP,4,1
1146,1092.0,52,were,7,28,29,1,27,22,-21,22,actress,Evanna Lynch,org,-,NOUN,PROPN-PROPN,compound,compound-pobj,NN,NNP-NNP,1,1
1147,1093.0,31,district,4,7,8,1,6,22,-3,4,Democrat,Dan Seals,,per-per,PROPN,PROPN-PROPN,compound,compound-nsubj,NNP,NNP-NNP,1,1
1148,1094.0,27,was,1,6,10,4,5,16,-5,9,Enrique,Nicaragua,,per,PROPN,PROPN,compound,pobj,NNP,NNP,5,1
1149,1095.0,37,came,2,7,20,13,6,16,-5,18,Robert Fico,Slovakia,-,org,PROPN-PROPN,PROPN,compound-nsubj,pobj,NNP-NNP,NNP,8,1
1150,1096.0,13,knighted,2,5,8,3,4,4,-3,6,Oliver Cromwell,Whitehall,-,org,PROPN-PROPN,PROPN,compound-pobj,pobj,NNP-NNP,NNP,3,1
1151,1097.0,19,requested,5,1,4,3,0,14,4,-1,Nintendo,Satoru Iwata,per,-,PROPN,PROPN-PROPN,poss,compound-appos,NNP,NNP-NNP,3,1
1152,1098.0,50,started,2,1,10,9,0,39,1,8,Side-line,David Noiret,,per-per,NOUN,PROPN-PROPN,nsubjpass,compound-appos,NN,NNP-NNP,4,1
1153,1099.0,29,visit,5,7,16,9,6,12,-2,11,Roy Rogers,Apple Valley,-,per-per,PROPN-PROPN,PROPN-PROPN,compound-dobj,compound-compound,NNP-NNP,NNP-NNP,6,1
1154,1100.0,39,took,2,16,19,3,15,19,-14,17,SPDC,Than Shwe,,per-per,PROPN,ADP-PROPN,appos,mark-pobj,NNP,IN-NNP,2,1
1155,1101.0,30,intervened,3,25,28,3,24,1,-22,25,Gillette,Procter Gamble,per,-,PROPN,PROPN-PROPN,compound,compound-pobj,NNP,NNP-NNP,2,1
1156,1102.0,33,was,1,1,10,9,0,22,0,9,She,Norway,per,,PRON,PROPN,nsubj,pobj,PRP,NNP,4,1
1157,1103.0,45,arrived,15,1,9,8,0,35,14,-6,Jose Miguel Insulza,Organization of American States,per-per-per,---,PROPN-PROPN-PROPN,PROPN-ADP-PROPN-PROPN,compound-compound-compound,pobj-prep-compound-pobj,NNP-NNP-NNP,NNP-IN-NNP-NNP,5,1
1158,1104.0,24,attended,5,4,16,12,3,7,1,11,Tobago,Fatima College,org,-,PROPN,PROPN-PROPN,conj,compound-pobj,NNP,NNP-NNP,4,1
1159,1105.0,14,was,1,3,8,5,2,5,-2,7,his,Columbia,org,,DET,PROPN,poss,compound,PRP$,NNP,4,1
1160,1106.0,36,said,3,11,22,11,10,13,-8,19,Hagemeyer,Rexel,per,,PROPN,PROPN,compound,pobj,NNP,NNP,3,1
1161,1107.0,24,include,1,3,8,5,2,15,-2,7,Yusuf Khan,Dilip Kumar,-,per-per,PROPN-PROPN,PROPN-PROPN,compound-dobj,compound-appos,NNP-NNP,NNP-NNP,2,1
1162,1108.0,21,confirmed,8,2,3,1,1,17,6,-5,Moscow,Aeroflot,,org,PROPN,PROPN,nmod,nmod,NNP,NNP,2,1
1163,1109.0,39,formed,32,1,8,7,0,30,31,-24,The Dingoes,Broderick Smith,per-per,-,DET-PROPN,PROPN-PROPN,det-nsubj,compound-pobj,DT-NNPS,NNP-NNP,2,1
1164,1110.0,18,is,4,2,17,15,1,0,2,13,Johnstown Inclined Plane,Pennsylvania,--,org,PROPN-PROPN-PROPN,PROPN,compound-compound-nsubj,pobj,NNP-NNP-NNP,NNP,3,1
1165,1111.0,34,damaged,2,15,23,8,14,10,-13,21,Socialist,Jospin,,org,PROPN,PROPN,compound,nsubjpass,NNP,NNP,5,1
1166,1112.0,42,was,5,21,41,20,20,0,-16,36,Pieter Cort van der Linden,Netherlands,per-per-per-per-per,,PROPN-PROPN-PROPN-NOUN-PROPN,PROPN,compound-compound-compound-pobj-appos,pobj,NNP-NNP-NNP-NN-NNP,NNP,7,1
1167,1113.0,11,promoted,4,2,4,2,1,6,2,0,Jacksonville,Curtis,,org,PROPN,PROPN,pobj,nsubj,NNP,NNP,2,1
1168,1114.0,19,won,3,13,17,4,12,1,-10,14,Kansas City,Mac Lethal,-,per-per,PROPN-PROPN,PROPN-PROPN,nmod-nmod,compound-appos,NNP-NNP,NNP-NNP,2,1
1169,1115.0,47,worth,7,33,36,3,32,10,-26,29,Netscape,Marc Andreessen,,org-org,PROPN,PROPN-PROPN,compound,compound-conj,NNP,NNP-NNP,2,1
1170,1116.0,41,moved,2,34,35,1,33,5,-32,33,XLRI,School of Business,,per-per-per,PROPN,PROPN-ADP-PROPN,compound,pobj-prep-pobj,NNP,NNP-IN-NNP,1,1
1171,1117.0,32,known,18,1,28,27,0,3,17,10,Miyazawa,Japan,org,,PROPN,PROPN,nsubjpass,poss,NNP,NNP,10,1
1172,1118.0,12,grew,2,1,10,9,0,1,1,8,Jennifer Nettles,Douglas,-,per,PROPN-PROPN,PROPN,compound-nsubj,compound,NNP-NNP,NNP,5,1
1173,1119.0,36,elected,7,12,32,20,11,3,-5,25,House of Commons,Brian Mulroney,per-per-per,-,PROPN-ADP-PROPN,PROPN-PROPN,pobj-prep-pobj,compound-dobj,NNP-IN-NNP,NNP-NNP,9,1
1174,1120.0,27,found,13,1,13,12,0,13,12,0,Tom,England,,per,PROPN,PROPN,nsubj,pobj,NNP,NNP,2,1
1175,1121.0,24,held,3,7,18,11,6,5,-4,15,Argentine,Eva,,per,ADJ,PROPN,amod,poss,JJ,NNP,7,1
1176,1122.0,21,considered,7,7,9,2,6,11,0,2,Ukraine,herself,org,,PROPN,PRON,pobj,nsubj,NNP,PRP,2,1
1177,1123.0,34,is,1,10,27,17,9,6,-9,26,Yogyakarta,Duta Wacana Christian University,org,---,PROPN,PROPN-PROPN-PROPN-PROPN,pobj,compound-compound-compound-conj,NNP,NNP-NNP-NNP-NNP,-1,1
1178,1124.0,26,compete,5,2,5,3,1,20,3,0,Nottingham High School,Northstars,per-per-per,,PROPN-PROPN-PROPN,PROPN,compound-compound-compound,nsubj,NNP-NNP-NNP,NNPS,3,1
1179,1125.0,22,was,16,1,6,5,0,15,15,-10,Sugar Ray Robinson,Walker Smith Jr.,per-per-per,--,NOUN-PROPN-PROPN,PROPN-PROPN-PROPN,compound-compound-nsubj,compound-compound-dobj,NN-NNP-NNP,NNP-NNP-NNP,3,1
1180,1126.0,34,served,1,7,13,6,6,20,-6,12,Helios Airways,Cyprus,-,per,PROPN-PROPN,PROPN,compound-poss,pobj,NNP-NNP,NNP,5,1
1181,1127.0,26,was,1,12,13,1,11,12,-11,12,India,Morarji Desai,per,-,PROPN,PROPN-PROPN,compound,compound-pobj,NNP,NNP-NNP,1,1
1182,1128.0,51,served,1,42,48,6,41,2,-41,47,Philippines,Philippine Stock Exchange,,per-per-per,PROPN,PROPN-PROPN-PROPN,pobj,compound-compound-pobj,NNP,NNP-NNP-NNP,5,1
1183,1129.0,29,is,4,1,12,11,0,16,3,8,Perry Hall High School,1963,---,per,PROPN-PROPN-PROPN-PROPN,NUM,compound-compound-compound-nsubj,pobj,NNP-NNP-NNP-NNP,CD,3,1
1184,1130.0,19,rode,4,10,13,3,9,5,-6,9,Simone Corsi,Italy,-,org,PROPN-PROPN,PROPN,compound-pobj,pobj,NNP-NNP,NNP,1,1
1185,1131.0,18,attended,14,2,3,1,1,14,12,-11,President,Valdas Adamkus,org,-,PROPN,PROPN-PROPN,compound,compound-nsubj,NNP,NNP-NNP,1,1
1186,1132.0,26,were,4,13,15,2,12,10,-9,11,Diamond,Australia,per,,PROPN,PROPN,pobj,pobj,NNP,NNP,2,1
1187,1133.0,42,announced,22,1,14,13,0,27,21,-8,Avianca,German Efromovich,org,-,PROPN,PROPN-PROPN,poss,nmod-appos,NNP,NNP-NNP,7,1
1188,1134.0,38,provide,23,1,20,19,0,17,22,-3,Windsor,University of Windsor,,per-per-per,NOUN,PROPN-ADP-PROPN,nsubj,nsubj-prep-pobj,NN,NNP-IN-NNP,2,1
1189,1135.0,10,reunited,6,5,9,4,4,0,1,3,Chiaki Ishikawa,See-Saw,-,org,PROPN-PROPN,NOUN,compound-conj,pobj,NNP-NNP,NN,5,1
1190,1136.0,41,returned,9,9,18,9,8,22,0,9,Youngman,Mutant Press,org,-,PROPN,PROPN-PROPN,nsubj,compound-compound,NNP,NNP-NNP,3,1
1191,1137.0,27,remained,2,8,16,8,7,10,-6,14,Mauritius,Anerood Jugnauth,per,-,PROPN,PROPN-PROPN,pobj,compound-nsubj,NNP,NNP-NNP,5,1
1192,1146.0,18,is,5,14,16,2,13,1,-9,11,Mauritius,Anerood Jugnauth,,per-per,PROPN,PROPN-PROPN,compound,compound-pobj,NNP,NNP-NNP,1,1
1193,2652.0,24,going,3,12,17,5,11,6,-9,14,Mauritius,Anerood Jugnauth,per,-,PROPN,PROPN-PROPN,appos,compound-nsubj,NNP,NNP-NNP,2,1
1194,1138.0,23,appointed,14,5,6,1,4,16,9,-8,President,Yayi Boni,,per-per,PROPN,PROPN-PROPN,compound,compound-pobj,NNP,NNP-NNP,1,1
1195,1139.0,38,signed,11,2,10,8,1,27,9,-1,President,Roh Moo-hyun,per,-,PROPN,PROPN-PROPN,compound,compound-appos,NNP,NNP-NNP,3,1
1196,1140.0,42,serves,2,30,34,4,29,7,-28,32,Chanakya National Law University,Patna,org-org-org-org,,PROPN-PROPN-PROPN-PROPN,PROPN,compound-compound-compound-compound,pobj,NNP-NNP-NNP-NNP,NNP,8,1
1197,1141.0,33,produced,16,15,26,11,14,6,1,10,William Ackerman,Imaginary Road,-,org-org,PROPN-PROPN,PROPN-PROPN,compound-pobj,compound-compound,NNP-NNP,NNP-NNP,12,1
1198,1142.0,47,become,2,1,6,5,0,40,1,4,Houston,director,per,,PROPN,NOUN,nsubj,attr,NNP,NN,3,1
1199,1143.0,15,located,9,5,12,7,4,2,4,3,SaskTel,Regina,per,,PROPN,PROPN,compound,compound,NNP,NNP,5,1
1200,1144.0,49,executive,4,7,13,6,6,35,-3,9,Singapore Airlines,AAPA,-,per,PROPN-PROPN,PROPN,compound-pobj,compound,NNP-NNP,NNP,4,1
1201,1145.0,43,proved,2,15,19,4,14,23,-13,17,Salmon P. Chase,United States,--,per-per,PROPN-PROPN-PROPN,PROPN-PROPN,compound-compound-attr,compound-compound,NNP-NNP-NNP,NNP-NNP,3,1
1202,1147.0,22,was,3,1,9,8,0,12,2,6,Thomas W. Ferry,Michigan,org-org-org,,PROPN-PROPN-PROPN,PROPN,compound-compound-nsubj,pobj,NNP-NNP-NNP,NNP,4,1
1203,2937.0,25,favored,22,14,18,4,13,6,8,-4,Thomas W. Ferry,Michigan,per-per-per,,PROPN-PROPN-PROPN,PROPN,compound-compound-pobj,pobj,NNP-NNP-NNP,NNP,6,1
1204,1148.0,43,helped,7,6,37,31,5,5,1,30,Iain Macleod,Exchequer,per-per,,PROPN-PROPN,PROPN,compound-nsubj,pobj,NNP-NNPS,NNP,5,1
1205,1149.0,18,was,1,7,13,6,6,4,-6,12,Pakistan,Ibrahim Ismail Chundrigar,per,--,PROPN,PROPN-PROPN-PROPN,pobj,compound-compound-pobj,NNP,NNP-NNP-NNP,2,1
1206,1150.0,30,says,8,18,21,3,17,8,-10,13,David Vitter,Louisiana,org-org,,PROPN-PROPN,PROPN,compound-pobj,pobj,NNP-NNP,NNP,4,1
1207,1880.0,28,acknowledged,8,4,7,3,3,20,4,-1,David Vitter,Louisiana,-,org,PROPN-PROPN,PROPN,compound-nsubj,compound,NNP-NNP,NNP,1,1
1208,1151.0,24,received,1,17,23,6,16,0,-16,22,Madigan Army Medical Center,Washington,---,org,PROPN-PROPN-PROPN-PROPN,PROPN,compound-compound-compound-compound,pobj,NNP-NNP-NNP-NNP,NNP,7,1
1209,1152.0,40,promoted,6,34,38,4,33,1,-28,32,Transvaal Scottish Regiment,South Africa,per-per-per,-,PROPN-PROPN-PROPN,PROPN-PROPN,compound-compound-pobj,compound-pobj,NNP-NNP-NNP,NNP-NNP,1,1
1210,1153.0,22,divided,6,4,16,12,3,5,2,10,2000,Transgaz,,per,NUM,PROPN,nummod,compound,CD,NNP,6,1
1211,1154.0,38,used,21,9,12,3,8,25,12,-9,Taiwan,Compal Electronics,per,-,PROPN,PROPN-PROPN,compound,compound-pobj,NNP,NNP-NNPS,4,1
1212,1155.0,17,is,7,1,6,5,0,10,6,-1,Universidad de Especialidades Santo,UEES,per-per-per-per,,PROPN-PROPN-PROPN-PROPN,PROPN,nmod-compound-compound-nsubj,appos,NNP-NNP-NNP-NNP,NNP,4,1
1213,1156.0,26,arrived,5,2,4,2,1,21,3,-1,Prime Minister,Lawrence Gonzi,-,per-per,PROPN-PROPN,PROPN-PROPN,compound-compound,compound-nsubj,NNP-NNP,NNP-NNP,1,1
1214,1157.0,23,said,4,1,3,2,0,19,3,-1,Japan,Nikon,per,,PROPN,PROPN,poss,compound,NNP,NNP,2,1
1215,1158.0,30,said,13,8,12,4,7,17,5,-1,Northeastern University,Tim Howard,org-org,-,PROPN-PROPN,PROPN-PROPN,compound-compound,compound-appos,NNP-NNP,NNP-NNP,1,1
1216,1159.0,33,ruled,6,23,32,9,22,0,-17,26,Indonesia,Indosat,org,,PROPN,PROPN,poss,conj,NNP,NNP,9,1
1217,1160.0,27,Anjunadeep,0,14,26,12,13,0,-14,26,Above Beyond,Anjunabeats,-,org,ADP-PROPN,PROPN,compound-pobj,pobj,IN-NNP,NNPS,8,1
1218,1161.0,44,Abbreviation,7,30,36,6,29,7,-23,29,ry board under the Min,try,----,org,NOUN-NOUN-ADP-DET-PROPN,NOUN,compound-nsubj-prep-det-pobj,acomp,NN-NN-IN-DT-NNP,NN,5,1
1219,1162.0,17,is,5,1,12,11,0,4,4,7,WIUM,Macomb,,org,PROPN,PROPN,nsubj,compound,NNP,NNP,7,1
1220,1163.0,31,appointed,2,1,9,8,0,21,1,7,He,Ukraine,,per,PRON,PROPN,nsubjpass,pobj,PRP,NNP,2,1
1221,1164.0,11,is,0,2,10,8,1,0,-2,10,Misia,Japan,,org,PROPN,PROPN,poss,pobj,NNP,NNP,4,1
1222,1165.0,69,announced,10,32,17,-15,31,51,-22,7,Cuba,Castro,,per,PROPN,PROPN,pobj,pobj,NNP,NNP,8,1
1223,1166.0,24,is,1,9,13,4,8,10,-8,12,Asbury Theological Seminary,Wilmore,--,org,PROPN-PROPN-PROPN,PROPN,compound-compound-pobj,compound,NNP-NNP-NNP,NNP,3,1
1224,1167.0,36,said,5,3,5,2,2,30,2,0,Infineon Technologies,AG,-,org,PROPN-PROPN,PROPN,compound-compound,nsubj,NNP-NNP,NNP,2,1
1225,1168.0,31,born,3,1,8,7,0,22,2,5,Hayedeh,Dadehbala,org,,PROPN,PROPN,nsubj,dobj,NNP,NNP,2,1
1226,1170.0,54,reported,5,18,28,10,17,25,-13,23,Dylan,New York City,per,--,PROPN,PROPN-PROPN-PROPN,nsubj,compound-compound-pobj,NNP,NNP-NNP-NNP,5,1
1227,1171.0,18,earned,2,11,14,3,10,3,-9,12,Canon Law,Saint Paul University,per-per,--,PROPN-PROPN,PROPN-PROPN-PROPN,compound-pobj,compound-compound-compound,NNP-NNP,NNP-NNP-NNP,7,1
1228,1173.0,31,is,2,17,27,10,16,3,-15,25,Florida,University of North Florida,org,---,PROPN,PROPN-ADP-PROPN-PROPN,pobj,pobj-prep-compound-pobj,NNP,NNP-IN-NNP-NNP,5,1
1229,1174.0,31,are,1,26,29,3,25,1,-25,28,Silverchair,Daniel Johns,org,-,PROPN,PROPN-PROPN,compound,compound-appos,NNP,NNP-NNP,2,1
1230,1175.0,67,ran,4,41,43,2,40,23,-37,39,Liberal,Brenda Chamberlain,per,-,PROPN,PROPN-PROPN,compound,compound-pobj,NNP,NNP-NNP,3,1
1231,1176.0,40,was,1,23,25,2,22,14,-22,24,Tennessee,Pauline LaFon Gore,per,--,PROPN,PROPN-PROPN-PROPN,pobj,compound-compound-conj,NNP,NNP-NNPS-NNP,2,1
1232,1177.0,84,warned,2,65,71,6,64,12,-63,69,Saint Lucia,Kenny Anthony,per-per,-,PROPN-PROPN,PROPN-PROPN,compound-poss,compound-nsubj,NNP-NNP,NNP-NNP,2,1
1233,1178.0,41,taught,1,22,39,17,21,1,-21,38,University of Texas Southwestern Medical School,Dallas,-----,org,PROPN-ADP-PROPN-PROPN-PROPN-PROPN,PROPN,nmod-prep-pobj-compound-compound-appos,compound,NNP-IN-NNP-NNP-NNP-NNP,NNP,10,1
1234,1179.0,36,contested,23,9,12,3,8,23,14,-11,George Reid,East Sydney,per-per,-,PROPN-PROPN,PROPN-PROPN,compound-pobj,compound-pobj,NNP-NNP,NNP-NNP,4,1
1235,1180.0,27,states,15,7,25,18,6,1,8,10,Jane Frank,Maryland,-,org,PROPN-PROPN,PROPN,compound-pobj,pobj,NNP-NNP,NNP,13,1
1236,1181.0,21,After,0,2,9,7,1,11,-2,9,Carola,Sweden,,per,PROPN,PROPN,poss,nsubj,NNP,NNP,4,1
1237,1182.0,31,said,24,1,14,13,0,16,23,-10,Akzo Nobel,ICI,-,per,PROPN-PROPN,PROPN,compound-nsubj,poss,NNP-NNP,NNP,4,1
1238,1183.0,34,took,4,14,17,3,13,16,-10,13,Sen Dog,Cypress Hill,-,per-per,PROPN-PROPN,PROPN-PROPN,compound-pobj,compound-pobj,NNP-NNP,NNP-NNP,2,1
1239,1184.0,16,Nathan,2,3,13,10,2,2,-1,11,Nathan,Manitoba,,per,PROPN,PROPN,ROOT,pobj,NNP,NNP,3,1
1240,1185.0,37,said,2,1,36,35,0,0,1,34,Martinez,Florida,org,,PROPN,PROPN,nsubj,pobj,NNP,NNP,3,1
1241,1186.0,34,include,3,6,33,27,5,0,-3,30,Ukrainian Free University,Munich,per-per-per,,PROPN-PROPN-PROPN,PROPN,compound-compound-pobj,pobj,NNP-NNP-NNP,NNP,3,1
1242,1187.0,36,scheduled,20,16,18,2,15,17,4,-2,Nauru,Marcus Stephen,per,-,PROPN,PROPN-PROPN,conj,compound-conj,NNP,NNP-NNP,1,1
1243,1188.0,26,Suck,0,13,20,7,12,5,-13,20,Kimberley Walsh,Girls Aloud,per-per,-,PROPN-PROPN,PROPN-PROPN,compound-pobj,compound-pobj,NNP-NNP,NNP-NNP,3,1
1244,1189.0,29,has,3,1,24,23,0,4,2,21,Volkswagen AG,Scania AB,-,org-org,PROPN-PROPN,PROPN-PROPN,compound-nsubj,compound-pobj,NNP-NNP,NNP-NNP,10,1
1245,1190.0,31,announced,9,9,30,21,8,0,0,21,Navistar,Illinois,per,,PROPN,PROPN,pobj,dobj,NNP,NNP,1,1
1246,1191.0,25,met,16,6,4,-2,5,20,10,-12,Detroit,Winans family,per,-,PROPN,PROPN-NOUN,compound,compound-pobj,NNP,NNPS-NN,1,1
1247,1192.0,32,appear,5,21,28,7,20,3,-16,23,Virgin,Hammill,per,,PROPN,PROPN,compound,poss,NNP,NNP,2,1
1248,1193.0,32,withdrawn,8,18,28,10,17,3,-10,20,Tamil Nadu Dr. M.G.R. Medical University,Research Institute,org-org-org-org-org-org,-,PROPN-PROPN-PROPN-PROPN-PROPN-PROPN,PROPN-PROPN,compound-compound-compound-compound-compound-pobj,compound-appos,NNP-NNP-NNP-NNP-NNP-NNP,NNP-NNP,6,1
1249,1194.0,24,cited,6,20,23,3,19,0,-14,17,John Norvell,Michigan,-,per,PROPN-PROPN,PROPN,compound-pobj,pobj,NNP-NNP,NNP,8,1
1250,1195.0,26,is,2,1,22,21,0,3,1,20,FC Bunyodkor,Uzbekistan,per-per,,PROPN-PROPN,PROPN,compound-nsubj,pobj,NNP-NNP,NNP,4,1
1251,1196.0,27,served,16,1,21,20,0,5,15,5,Isaac Lawrence Milliken,Chicago,org-org-org,,PROPN-PROPN-PROPN,PROPN,compound-compound-nsubj,compound,NNP-NNP-NNP,NNP,6,1
1252,1197.0,40,declared,4,12,13,1,11,26,-8,9,Navy,Paul Hamilton,org,-,PROPN,PROPN-PROPN,pobj,compound-nsubj,NNP,NNP-NNP,1,1
1253,1198.0,20,distributed,1,1,8,7,0,11,0,7,Atlantic,Pickett,,per,ADJ,PROPN,nsubj,dobj,JJ,NNP,2,1
1254,1199.0,24,is,7,1,19,18,0,4,6,12,Kleiner Perkins Caufield Byers,Menlo Park,---,per-per,PROPN-PROPN-PROPN-PROPN,PROPN-PROPN,compound-compound-compound-nsubj,compound-pobj,NNP-NNP-NNP-NNP,NNP-NNP,8,1
1255,1200.0,16,located,5,1,12,11,0,3,4,7,Iron Horse Middle School,San Ramon,---,org-org,NOUN-PROPN-PROPN-PROPN,PROPN-PROPN,compound-compound-compound-nsubjpass,compound-compound,NN-NNP-NNP-NNP,NNP-NNP,5,1
1256,1201.0,30,is,1,5,16,11,4,13,-4,15,Elisa,Italy,per,,PROPN,PROPN,compound,nmod,NNP,NNP,7,1
1257,2053.0,53,Isoardi,1,1,22,21,0,30,0,21,Elisa,Italy,,org,PROPN,PROPN,compound,pobj,NNP,NNP,3,1
1258,1202.0,15,died,5,11,14,3,10,0,-6,9,her,Switzerland,org,,DET,PROPN,poss,pobj,PRP$,NNP,3,1
1259,1203.0,60,came,16,5,26,21,4,33,11,10,John Edwards,Politician,per-per,,PROPN-PROPN,PROPN,compound-poss,pobj,NNP-NNP,NNP,10,1
1260,1204.0,13,is,2,1,10,9,0,2,1,8,Bishop Allen,Brooklyn,-,per,PROPN-PROPN,PROPN,compound-nsubj,compound,NNP-NNP,NNP,5,1
1261,1205.0,49,created,14,5,20,15,4,28,9,6,Ahmad Zia Massoud,Afghanistan,--,per,PROPN-PROPN-PROPN,PROPN,compound-compound-compound,pobj,NNP-NNP-NNP,NNP,3,1
1262,1206.0,24,elected,3,1,19,18,0,4,2,16,Keating,Blaxland,org,,PROPN,PROPN,nsubjpass,pobj,NNP,NNP,4,1
1263,1207.0,53,endorsed,1,36,38,2,35,14,-35,37,Georgia,Max Cleland,org,-,PROPN,PROPN-PROPN,compound,compound-pobj,NNP,NNP-NNP,1,1
1264,1448.0,26,Cleland,9,6,9,3,5,16,3,0,Georgia,Max Cleland,,per-per,PROPN,PROPN-PROPN,compound,compound-ROOT,NNP,NNP-NNP,2,1
1265,1208.0,33,sold,16,3,12,9,2,20,13,-4,Institute for Creation Research,Texas,per-per-per-per,,PROPN-ADP-PROPN-PROPN,PROPN,nsubj-prep-compound-pobj,pobj,NNP-IN-NNP-NNP,NNP,3,1
1266,2689.0,33,reported,9,13,26,13,12,6,-4,17,Institute for Creation Research,Texas,---,per,PROPN-ADP-PROPN-PROPN,PROPN,nsubj-prep-compound-pobj,pobj,NNP-IN-NNP-NNP,NNP,4,1
1267,1209.0,30,collapsed,7,6,20,14,5,9,1,13,Franz Vranitzky,Austria,per-per,,PROPN-PROPN,PROPN,compound-pobj,pobj,NNP-NNP,NNP,4,1
1268,1210.0,22,renamed,2,4,13,9,3,8,-2,11,Wilfrid Laurier,Ontario,per-per,,PROPN-PROPN,PROPN,compound-compound,pobj,NNP-NNP,NNP,3,1
1269,1211.0,27,christened,23,4,23,19,3,3,19,0,European,he,per,,ADJ,PRON,amod,nsubj,JJ,PRP,2,1
1270,1212.0,47,exist,5,24,30,6,23,16,-19,25,California Institute of Integral Studies,San Francisco,per-per-per-per-per,-,PROPN-PROPN-ADP-PROPN-PROPN,PROPN-PROPN,compound-pobj-prep-compound-pobj,compound-pobj,NNP-NNP-IN-NNP-NNPS,NNP-NNP,4,1
1271,1213.0,22,was,11,1,15,14,0,6,10,4,Christos Stefanopoulos,ek politici,per-per,-,PROPN-PROPN,PROPN-NOUN,compound-nsubj,attr-acl,NNP-NNP,NNP-NN,2,1
1272,1214.0,18,is,4,2,16,14,1,1,2,12,Columbia,Jo Stafford,,per-per,PROPN,PROPN-PROPN,compound,compound-pobj,NNP,NNP-NNP,8,1
1273,1215.0,13,is,4,9,11,2,8,1,-5,7,American,Jack Johnson,org,-,ADJ,PROPN-PROPN,amod,compound-pobj,JJ,NNP-NNP,1,1
1274,1216.0,24,purchased,9,3,5,2,2,18,6,-4,Larry Ellison,CEO,per-per,,PROPN-PROPN,PROPN,compound-compound,nsubj,NNP-NNP,NNP,2,1
1275,1217.0,43,Miramontez,1,22,26,4,21,16,-21,25,U2,The Edge,org,-,PROPN,DET-PROPN,compound,det-nsubj,NNP,DT-NNP,2,1
1276,1218.0,37,is,10,5,22,17,4,14,5,12,FAW-Volkswagen,First Automobile Works,,per-per-per,PROPN,PROPN-PROPN-PROPN,compound,compound-compound-compound,NNP,NNP-NNP-NNP,5,1
1277,1219.0,39,said,12,19,24,5,18,14,-7,12,Sichuan University,Chengdu,org-org,,PROPN-PROPN,PROPN,compound-pobj,compound,NNP-NNP,NNP,2,1
1278,1220.0,19,are,5,14,17,3,13,1,-9,12,Dov Hikind,New York,per-per,-,PROPN-PROPN,PROPN-PROPN,compound-conj,compound-pobj,NNP-NNP,NNP-NNP,2,1
1279,1221.0,38,became,1,1,18,17,0,19,0,17,She,India,,per,PRON,PROPN,nsubj,pobj,PRP,NNP,8,1
1280,1222.0,45,produced,32,18,20,2,17,24,14,-12,Connecticut,Eastern Color Printing,,per-per-per,PROPN,PROPN-PROPN-PROPN,compound,compound-compound-appos,NNP,NNP-NNP-NNP,2,1
1281,1223.0,30,took,4,24,28,4,23,1,-20,24,Lancashire,LYR,per,,PROPN,PROPN,compound,appos,NNP,NNP,2,1
1282,1224.0,21,administered,5,9,17,8,8,3,-4,12,Internal Revenue Service,Department of the Treasury,--,per-per-per-per,PROPN-PROPN-PROPN,PROPN-ADP-DET-PROPN,compound-compound-pobj,pobj-prep-det-pobj,NNP-NNP-NNP,NNP-IN-DT-NNP,6,1
1283,1225.0,10,attends,1,4,8,4,3,1,-3,7,University,Fort Worth,,org-org,PROPN,PROPN-PROPN,compound,compound-pobj,NNP,NNP-NNP,3,1
1284,1226.0,42,was,1,10,41,31,9,0,-9,40,Christoforos Nezer,Greece,org-org,,PROPN-PROPN,PROPN,compound-pobj,pobj,NNP-NNP,NNP,14,1
1285,1227.0,16,cast,12,5,15,10,4,0,7,3,Bryan Brown,Australia,per-per,,PROPN-PROPN,PROPN,compound-compound,pobj,NNP-NNP,NNP,3,1
1286,1228.0,43,founded,8,4,35,31,3,7,4,27,Wolverhampton,University of Wolverhampton,per,--,PROPN,PROPN-ADP-PROPN,nmod,nsubj-prep-pobj,NNP,NNP-IN-NNP,5,1
1287,1229.0,28,went,10,8,13,5,7,14,2,3,Girija Prasad Koirala,India,--,org,PROPN-PROPN-PROPN,PROPN,compound-compound-nsubj,pobj,NNP-NNP-NNP,NNP,3,1
1288,1230.0,33,is,24,1,1,0,0,31,23,-23,New Mexico Institute of Mining and Technology,New Mexico,------,org-org,PROPN-PROPN-PROPN-ADP-PROPN-CCONJ-PROPN,PROPN-PROPN,compound-compound-nsubj-prep-pobj-cc-conj,compound-pobj,NNP-NNP-NNP-IN-NNP-CC-NNP,NNP-NNP,0,1
1289,1232.0,12,signed,2,1,11,10,0,0,1,9,La,Canada,org,,PROPN,PROPN,nsubj,pobj,NNP,NNP,2,1
1290,1233.0,45,quoted,14,21,29,8,20,15,-7,15,Ralph Klein,Colleen Klein,per-per,-,PROPN-PROPN,PROPN-PROPN,compound-pobj,compound-nsubj,NNP-NNP,NNP-NNP,8,1
1291,1234.0,29,Society,2,1,13,12,0,15,1,11,Massachusetts,He,per,,PROPN,PRON,compound,nsubj,NNP,PRP,3,1
1292,1235.0,9,opened,3,1,8,7,0,0,2,5,Homewood-Flossmoor High School,1959,--,org,PROPN-PROPN-PROPN,NUM,compound-compound-nsubj,pobj,NNP-NNP-NNP,CD,4,1
1293,1236.0,44,School,3,1,1,0,0,42,2,-2,Caesar Rodney High School,Caesar Rodney School District,per-per-per-per,---,PROPN-PROPN-PROPN-PROPN,PROPN-PROPN-PROPN-PROPN,compound-compound-compound-ROOT,compound-compound-compound-pobj,NNP-NNP-NNP-NNP,NNP-NNP-NNP-NNP,0,1
1294,1237.0,27,was,7,1,21,20,0,5,6,14,Grenville C. Emery,Harvard-Westlake School,org-org-org,-,PROPN-PROPN-PROPN,PROPN-PROPN,compound-compound-nsubj,compound-attr,NNP-NNP-NNP,NNP-NNP,9,1
1295,1238.0,41,started,1,31,36,5,30,4,-30,35,Central Connecticut State University,New Britain,---,per-per,PROPN-PROPN-PROPN-PROPN,PROPN-PROPN,compound-compound-compound-pobj,compound-compound,NNP-NNP-NNP-NNP,NNP-NNP,5,1
1296,1239.0,20,developed,7,1,6,5,0,13,6,-1,Nissan Motors,Carlos Ghosn,org-org,-,PROPN-PROPN,PROPN-PROPN,compound-compound,compound-nsubj,NNP-NNPS,NNP-NNP,2,1
1297,1240.0,40,receive,3,25,27,2,24,12,-22,24,Lorie,French,per,,PROPN,ADJ,pobj,amod,NNP,JJ,3,1
1298,1241.0,22,was,5,5,14,9,4,7,0,9,Sasseville,113th Wing,,per-per,PROPN,PROPN-NOUN,nsubj,compound-pobj,NNP,NNP-NN,3,1
1299,1242.0,46,is,6,15,14,-1,14,31,-9,8,Northern Ireland,Carrickfergus Grammar School,org-org,--,PROPN-PROPN,PROPN-PROPN-PROPN,compound-pobj,compound-compound-dobj,NNP-NNP,NNP-NNP-NNP,1,1
1300,1243.0,36,are,26,9,12,3,8,23,17,-14,John Breaux,Louisiana,-,org,PROPN-PROPN,PROPN,compound-pobj,pobj,NNP-NNP,NNP,3,1
1301,1244.0,22,is,8,1,2,1,0,19,7,-6,41 Canadian Brigade Group,Canadian Army,---,org-org,NUM-PROPN-PROPN-PROPN,PROPN-PROPN,nummod-compound-compound-nsubj,compound-conj,CD-NNP-NNP-NNP,NNP-NNP,2,1
1302,1245.0,22,is,1,7,19,12,6,2,-6,18,Roger McGuinn,Columbia,org-org,,PROPN-PROPN,PROPN,compound-poss,compound,NNP-NNP,NNP,5,1
1303,1246.0,50,kept,18,11,15,4,10,34,7,-3,Aristotle,Jacqueline Kennedy,org,-,PROPN,PROPN-PROPN,poss,compound-compound,NNP,NNP-NNP,4,1
1304,1247.0,24,returned,2,6,20,14,5,3,-4,18,United States,NCIS,per-per,,PROPN-PROPN,PROPN,compound-pobj,compound,NNP-NNP,NNP,8,1
1305,1248.0,27,released,6,1,17,16,0,9,5,11,Australian Crawl,Guy McDonough,-,org-org,ADJ-PROPN,PROPN-PROPN,amod-compound,compound-poss,JJ-NNP,NNP-NNP,10,1
1306,1249.0,44,Following,0,8,14,6,7,29,-8,14,Go,their,,org,VERB,DET,conj,poss,VB,PRP$,7,1
1307,1250.0,59,was,1,19,29,10,18,29,-18,28,Ballet Nacional de Cuba,English,per-per-per-per,,PROPN-PROPN-ADP-PROPN,PROPN,nmod-nmod-nmod-appos,compound,NNP-NNP-IN-NNP,NNP,6,1
1308,1251.0,22,served,5,19,21,2,18,0,-14,16,SilkAir,Singapore,,org,PROPN,PROPN,conj,pobj,NNP,NNP,2,1
1309,1252.0,37,included,35,22,11,-11,21,25,13,-24,Ringo Starr,The Beatles,per-per,-,PROPN-PROPN,DET-PROPN,compound-conj,det-nsubj,NNP-NNP,DT-NNPS,4,1
1310,1253.0,19,grew,1,8,15,7,7,3,-7,14,Englewood,Dwight Morrow High School,per,---,PROPN,PROPN-PROPN-PROPN-PROPN,compound,compound-compound-compound-dobj,NNP,NNP-NNP-NNP-NNP,5,1
1311,1254.0,31,launched,4,9,16,7,8,14,-5,12,1993,QVC,,org,NUM,PROPN,nummod,pobj,CD,NNP,6,1
1312,1255.0,28,committed,2,14,19,5,13,8,-12,17,Fox School of Business,Temple University,org-org-org-org,-,PROPN-PROPN-ADP-PROPN,PROPN-PROPN,compound-pobj-prep-pobj,compound-pobj,NNP-NNP-IN-NNP,NNP-NNP,2,1
1313,1256.0,43,May,1,1,4,3,0,38,0,3,Brian May,Queen,-,per,PROPN-PROPN,PROPN,amod-ROOT,compound,NNP-NNP,NNP,2,1
1314,1257.0,51,featured,8,6,22,16,5,28,2,14,Grand Ole Opry,Uncle Dave Macon,org-org-org,--,PROPN-PROPN-PROPN,PROPN-PROPN-PROPN,compound-compound-nsubj,compound-compound-compound,NNP-NNP-NNP,NNP-NNP-NNP,10,1
1315,1258.0,22,passed,4,9,17,8,8,4,-5,13,Cleveland Transit System,Greater Cleveland Regional Transit Authority,org-org-org,----,PROPN-PROPN-PROPN,PROPN-PROPN-PROPN-PROPN-PROPN,compound-compound-pobj,compound-compound-compound-compound-pobj,NNP-NNP-NNP,NNP-NNP-NNP-NNP-NNP,7,1
1316,1259.0,42,is,5,22,40,18,21,1,-17,35,Moderate Party,Carl Bildt,per-per,-,PROPN-PROPN,PROPN-PROPN,compound-poss,compound-conj,NNP-NNP,NNP-NNP,6,1
1317,1260.0,18,adopted,7,10,15,5,9,2,-3,8,NTV7,Media Prima,,org-org,PROPN,PROPN-PROPN,pobj,compound-compound,NNP,NNP-NNP,4,1
1318,1261.0,25,Karad?i,5,6,12,6,5,12,-1,7,Karad?i,he Republika Srps,per,--,X,PRON-PROPN-PROPN,ROOT,dobj-compound-appos,ADD,PRP-NNP-NNP,-1,1
1319,1262.0,13,moved,3,3,6,3,2,6,0,3,she,Toronto,,org,PRON,PROPN,nsubj,pobj,PRP,NNP,1,1
1320,1263.0,54,expresses,6,33,45,12,32,8,-27,39,Boyd Gaines,Actress,-,org,PROPN-PROPN,PROPN,compound-conj,pobj,NNP-NNP,NNP,6,1
1321,1264.0,42,extended,7,18,13,-5,17,28,-11,6,Vietnam,Viet Minh,,org-org,PROPN,PROPN-PROPN,pobj,compound-dobj,NNP,NNP-NNP,3,1
1322,1265.0,35,said,6,2,3,1,1,31,4,-3,Islamabad,PIA,,per,PROPN,PROPN,amod,compound,NNP,NNP,1,1
1323,1266.0,36,comes,2,12,17,5,11,18,-10,15,New York,Andrew Cuomo,-,org-org,PROPN-PROPN,PROPN-PROPN,compound-compound,compound-pobj,NNP-NNP,NNP-NNP,3,1
1324,1267.0,26,had,6,12,21,9,11,4,-6,15,Reality,Doug E. Fresh,,per-per-per,PROPN,PROPN-PROPN-PROPN,compound,compound-compound-pobj,NNP,NNP-NNP-NNP,4,1
1325,1268.0,47,were,3,39,44,5,38,2,-36,41,Edward I of England,Eleanor of Castile,---,org-org-org,PROPN-PROPN-ADP-PROPN,PROPN-ADP-PROPN,compound-pobj-prep-pobj,conj-prep-pobj,NNP-NNP-IN-NNP,NNP-IN-NNP,3,1
1326,1269.0,30,is,14,2,10,8,1,19,12,-4,Revolutionary Left Movement,Movimiento de Izquierda Revolucionaria,per-per-per,---,PROPN-PROPN-PROPN,PROPN-PROPN-PROPN-PROPN,compound-compound-nsubj,compound-compound-compound-appos,NNP-NNP-NNP,NNP-NNP-NNP-NNP,3,1
1327,1270.0,47,appointed,16,6,15,9,5,31,10,-1,Liechtenstein,Otmar Hasler,per,-,PROPN,PROPN-PROPN,compound,compound-nsubj,NNP,NNP-NNP,5,1
1328,1271.0,28,sung,4,7,27,20,6,0,-3,23,Brian McFadden,Westlife,per-per,,PROPN-PROPN,PROPN,compound-pobj,appos,NNP-NNP,NNP,9,1
1329,1272.0,21,rescued,6,1,3,2,0,17,5,-3,Ali,Abu Talib,,per-per,PROPN,PROPN-PROPN,compound,compound-nsubj,NNP,NNP-NNP,1,1
1330,1273.0,36,said,22,5,21,16,4,14,17,-1,CNN,Jim Walton,,org-org,PROPN,PROPN-PROPN,pobj,compound-nsubj,NNP,NNP-NNP,3,1
1331,1274.0,34,ran,2,1,18,17,0,15,1,16,Paul,Quebec,,per,PROPN,PROPN,nsubj,compound,NNP,NNP,8,1
1332,1275.0,53,recalled,9,3,17,14,2,35,6,8,Finland,Ryti,,per,PROPN,PROPN,poss,dobj,NNP,NNP,7,1
1333,1276.0,44,studied,4,9,20,11,8,23,-5,16,Stella Adler,American,per-per,,PROPN-PROPN,PROPN,compound-nsubj,compound,NNP-NNP,NNP,8,1
1334,1277.0,27,is,12,11,16,5,10,10,1,4,Toronto,bassist,org,,PROPN,NOUN,compound,amod,NNP,NN,5,1
1335,1278.0,34,had,6,24,31,7,23,2,-18,25,United States,its,-,per,PROPN-PROPN,DET,compound-compound,poss,NNP-NNP,PRP$,8,1
1336,1279.0,51,emigrated,3,14,31,17,13,19,-11,28,Lee Strasberg Theatre and Film Institute,Marilyn Monroe,per-per-per-per-per-per,-,PROPN-PROPN-PROPN-CCONJ-PROPN-PROPN,PROPN-PROPN,compound-compound-nmod-cc-compound-conj,compound-nsubj,NNP-NNP-NNP-CC-NNP-NNP,NNP-NNP,8,1
1337,1280.0,31,are,3,16,25,9,15,5,-13,22,Abu Sayyaf,al-Qaeda,per-per,,PROPN-PROPN,PROPN,compound-compound,compound,NNP-NNP,NNP,6,1
1338,1281.0,19,made,6,13,18,5,12,0,-7,12,Dublin,Taoiseach,org,,PROPN,PROPN,pobj,pobj,NNP,NNP,5,1
1339,1282.0,27,directed,4,17,26,9,16,0,-13,22,Phil Collen,England,per-per,,PROPN-PROPN,PROPN,compound-poss,pobj,NNP-NNP,NNP,4,1
1340,1284.0,37,extended,8,13,29,16,12,7,-5,21,Australia,Woolworths,per,,PROPN,PROPN,pobj,nmod,NNP,NNP,8,1
1341,1285.0,28,SRI,4,3,26,23,2,1,1,22,Inc.,United States,,per-per,PROPN,PROPN-PROPN,subtok,compound-pobj,NNP,NNP-NNP,7,1
1342,1286.0,20,was,5,5,17,12,4,2,0,12,Harrison,British,,org,PROPN,PROPN,nsubj,compound,NNP,NNP,6,1
1343,1287.0,23,represented,2,9,20,11,8,2,-7,18,South Alabama Jaguars,Sun Belt,--,per-per,PROPN-PROPN-PROPN,PROPN-PROPN,compound-compound-pobj,compound-compound,NNP-NNP-NNPS,NNP-NNP,8,1
1344,1288.0,22,directed,3,8,14,6,7,7,-5,11,Stephen Moorer,California,per-per,,PROPN-PROPN,PROPN,compound-pobj,compound,NNP-NNP,NNP,2,1
1345,1289.0,24,is,12,1,15,14,0,8,11,3,Nuri Bilge Ceylan,Turkey,--,per,PROPN-PROPN-PROPN,PROPN,compound-compound-nsubj,nmod,NNP-NNP-NNP,NNP,-1,1
1346,1290.0,35,are,5,8,25,17,7,9,-3,20,Ibrahim Babangida,Nigeria,per-per,,PROPN-PROPN,PROPN,compound-attr,compound,NNP-NNP,NNP,5,1
1347,1312.0,28,autocracy,24,10,16,6,9,11,14,-8,Ibrahim Babangida,Nigeria,org-org,,PROPN-PROPN,PROPN,compound-conj,poss,NNP-NNP,NNP,5,1
1348,1291.0,21,changed,11,1,19,18,0,1,10,8,Poland,Polish Navy,org,-,PROPN,PROPN-PROPN,poss,compound-pobj,NNP,NNP-NNP,6,1
1349,1292.0,28,With,0,15,19,4,14,8,-15,19,New York,Jean Grae,org-org,-,PROPN-PROPN,PROPN-PROPN,compound-nmod,compound-appos,NNP-NNP,NNP-NNP,1,1
1350,1293.0,23,was,16,5,11,6,4,11,11,-5,Leo Tindemans,Belgium,org-org,,PROPN-PROPN,PROPN,compound-pobj,pobj,NNP-NNPS,NNP,3,1
1351,1294.0,36,received,2,26,31,5,25,4,-24,29,Royal Bank,UK,per-per,,PROPN-PROPN,PROPN,compound-dobj,compound,NNP-NNP,NNP,3,1
1352,1295.0,26,chosen,17,1,13,12,0,12,16,-4,Jean-Pierre Raffarin,France,-,org,PROPN-PROPN,PROPN,compound-nsubjpass,pobj,NNP-NNP,NNP,5,1
1353,1296.0,14,parked,3,1,8,7,0,5,2,5,Her,Paris,per,,DET,PROPN,poss,compound,PRP$,NNP,4,1
1354,1297.0,48,established,8,3,33,30,2,14,5,25,University of North London,1896,per-per-per-per,,PROPN-ADP-PROPN-PROPN,NUM,pobj-prep-compound-pobj,appos,NNP-IN-NNP-NNP,CD,2,1
1355,1298.0,21,Mitra,2,1,18,17,0,2,1,16,Sisir Kumar Mitra,Indian,per-per-per,,PROPN-PROPN-PROPN,PROPN,compound-compound-ROOT,amod,NNP-NNP-NNP,NNP,4,1
1356,1299.0,47,was,4,25,35,10,24,11,-21,31,Revolutionary United Front,Foday Sankoh,--,org-org,PROPN-PROPN-PROPN,PROPN-PROPN,compound-compound-nmod,compound-pobj,NNP-NNP-NNP,NNP-NNP,6,1
1357,1300.0,31,remembered,2,27,29,2,26,1,-25,27,Prime Minister,Harold Wilson,-,per-per,PROPN-PROPN,PROPN-PROPN,compound-compound,compound-dobj,NNP-NNP,NNP-NNP,1,1
1358,1301.0,31,was,11,22,29,7,21,1,-11,18,John Tyler,United States,per-per,-,PROPN-PROPN,PROPN-PROPN,compound-pobj,compound-pobj,NNP-NNP,NNP-NNP,5,1
1359,1302.0,32,Benton,2,1,20,19,0,11,1,18,Thomas Hart Benton,Missouri,org-org-org,,PROPN-PROPN-PROPN,PROPN,compound-compound-ROOT,pobj,NNP-NNP-NNP,NNP,4,1
1360,1303.0,15,been,2,4,11,7,3,3,-2,9,Theodore William Richards,Harvard University,per-per-per,-,PROPN-PROPN-PROPN,PROPN-PROPN,compound-compound-compound,compound-pobj,NNP-NNP-NNP,NNP-NNP,4,1
1361,1304.0,35,found,10,14,19,5,13,15,-4,9,Western Pacific Railroad Museum,Portola California,per-per-per-per,-,PROPN-PROPN-PROPN-PROPN,PROPN-PROPN,compound-compound-compound-pobj,compound-pobj,NNP-NNP-NNP-NNP,NNP-NNP,4,1
1362,2175.0,37,tender,2,5,35,30,4,1,-3,33,Western Pacific Railroad Museum,Portola California,---,org-org,PROPN-PROPN-PROPN-PROPN,PROPN-PROPN,compound-compound-compound-pobj,compound-pobj,NNP-NNP-NNP-NNP,NNP-NNP,7,1
1363,1305.0,22,represented,7,3,17,14,2,4,4,10,Northern Illinois Huskies,Division I,org-org-org,-,PROPN-PROPN-PROPN,PROPN-PRON,compound-compound-compound,compound-compound,NNP-NNP-NNPS,NNP-PRP,6,1
1364,1306.0,32,rooted,11,4,19,15,3,12,7,8,1968,egg,per,,NUM,NOUN,pobj,compound,CD,NN,5,1
1365,1307.0,46,are,22,4,6,2,3,39,18,-16,South African,Mark Shuttleworth,-,per-per,ADJ-ADJ,PROPN-PROPN,compound-compound,compound-compound,JJ-JJ,NNP-NNP,1,1
1366,1308.0,18,represented,3,7,16,9,6,1,-4,13,Social Democratic Party,Socialist International,--,per-per,PROPN-PROPN-PROPN,PROPN-PROPN,compound-compound-dobj,compound-pobj,NNP-NNP-NNP,NNP-NNP,6,1
1367,1309.0,32,is,7,1,5,4,0,26,6,-2,Comcast SportsNet,CSN Chicago,per-per,-,PROPN-PROPN,PROPN-PROPN,compound-compound,compound-appos,NNP-NNP,NNP-NNP,2,1
1368,1310.0,19,credited,6,9,17,8,8,1,-3,11,Crazy Legs,Bronx,per-per,,PROPN-PROPN,PROPN,compound-pobj,compound,NNP-NNPS,NNP,4,1
1369,1313.0,21,been,5,10,20,10,9,0,-5,15,MIT,Cambridge,,org,PROPN,PROPN,nsubjpass,pobj,NNP,NNP,5,1
1370,1314.0,25,come,4,7,23,16,6,1,-3,19,Japan,Yasuo Fukuda,,org-org,PROPN,PROPN-PROPN,pobj,compound-conj,NNP,NNP-NNP,6,1
1371,1315.0,43,Camerino,6,28,7,-21,27,35,-22,1,University of Camerino,Camerino,--,per,PROPN-ADP-PROPN,PROPN,pobj-prep-pobj,compound,NNP-IN-NNP,NNP,8,1
1372,1317.0,43,said,1,8,33,25,7,9,-7,32,Georgia,Travis Tritt,,org-org,PROPN,PROPN-PROPN,compound,compound-pobj,NNP,NNP-NNP,4,1
1373,1318.0,13,is,5,1,12,11,0,0,4,7,Arnoldo Mondadori Editore,Italy,per-per-per,,PROPN-PROPN-PROPN,PROPN,compound-compound-nsubj,pobj,NNP-NNP-NNP,NNP,3,1
1374,1319.0,28,appoints,6,2,18,16,1,9,4,12,Fiji,Frank Bainimarama,per,-,PROPN,PROPN-PROPN,nsubj,compound-pobj,NNP,NNP-NNP,8,1
1375,1320.0,17,started,3,1,10,9,0,6,2,7,G-Unit,DJ Whoo Kid,per,--,PROPN,NOUN-PROPN-PROPN,nsubj,compound-compound-pobj,NNP,NN-NNP-NNP,8,1
1376,1321.0,20,was,6,1,5,4,0,14,5,-1,Arizona,AIC,org,,PROPN,PROPN,compound,appos,NNP,NNP,3,1
1377,1322.0,33,released,3,26,32,6,25,0,-23,29,Sophie Ellis-Bextor,London,-,per,PROPN-PROPN,PROPN,compound-conj,pobj,NNP-NNP,NNP,3,1
1378,1323.0,12,was,4,3,11,8,2,0,1,7,Jomo Kenyatta,Kenya,org-org,,PROPN-PROPN,PROPN,compound-appos,pobj,NNP-NNP,NNP,3,1
1379,1596.0,37,known,2,9,27,18,8,9,-7,25,Jomo Kenyatta,Kenya,per-per,,PROPN-PROPN,PROPN,compound-pobj,pobj,NNP-NNP,NNP,5,1
1380,1324.0,36,received,12,2,8,6,1,27,10,-4,Alabama Cooperative Extension System,Auburn University,---,org-org,PROPN-PROPN-PROPN-PROPN,PROPN-PROPN,compound-compound-compound-nsubj,compound-pobj,NNP-NNP-NNP-NNP,NNP-NNP,5,1
1381,1325.0,21,became,3,3,20,17,2,0,0,17,Walton,Oklahoma,,per,PROPN,PROPN,nsubj,pobj,NNP,NNP,5,1
1382,1326.0,29,made,1,11,18,7,10,10,-10,17,EAC,Tanzania,org,,PROPN,PROPN,compound,pobj,NNP,NNP,5,1
1383,1327.0,27,returned,1,10,22,12,9,4,-9,21,Thomas White,Cetus Corporation,-,per-per,PROPN-PROPN,PROPN-PROPN,compound-pobj,compound-appos,NNP-NNP,NNP-NNP,8,1
1384,1328.0,15,came,8,7,8,1,6,6,1,0,Kotor,he,org,,PROPN,PRON,pobj,nsubj,NNP,PRP,1,1
1385,1329.0,9,Labels,0,3,4,1,2,4,-3,4,California,George Takei,,org-org,PROPN,PROPN-PROPN,compound,compound-compound,NNP,NNP-NNP,2,1
1386,1330.0,43,established,1,4,7,3,3,35,-3,6,Kasturba Medical College,Manipal,per-per-per,,PROPN-PROPN-PROPN,PROPN,compound-compound-compound,dobj,NNP-NNP-NNP,NNP,4,1
1387,1331.0,48,were,32,17,27,10,16,20,15,-5,Hugh Hopper,Soft Machine,per-per,-,PROPN-PROPN,PROPN-NOUN,compound-pobj,compound-appos,NNP-NNP,NNP-NN,5,1
1388,1333.0,23,is,11,2,20,18,1,2,9,9,34th Infantry Regiment,United States,per-per-per,-,ADJ-PROPN-PROPN,PROPN-PROPN,amod-compound-nsubj,compound-compound,JJ-NNP-NNP,NNP-NNP,6,1
1389,1334.0,21,elected,5,4,10,6,3,10,1,5,he,Nepali Congress,org,-,PRON,PROPN-PROPN,nsubjpass,compound-pobj,PRP,NNP-NNP,4,1
1390,1335.0,26,died,5,14,24,10,13,1,-9,19,Chile,Michelle Bachelet,,org-org,PROPN,PROPN-PROPN,dobj,compound-pobj,NNP,NNP-NNP,5,1
1391,1336.0,29,named,4,10,12,2,9,16,-6,8,XFL,Orlando Rage,,per-per,PROPN,PROPN-PROPN,poss,compound-pobj,NNP,NNP-NNP,2,1
1392,1337.0,25,was,1,1,12,11,0,12,0,11,Kemp,Melbourne,,per,PROPN,PROPN,nsubj,pobj,NNP,NNP,1,1
1393,1338.0,26,was,11,1,15,14,0,10,10,4,William Hale Thompson,Chicago,org-org-org,,PROPN-PROPN-PROPN,PROPN,compound-compound-nsubj,pobj,NNP-NNP-NNP,NNP,3,1
1394,1339.0,32,referred,9,13,24,11,12,7,-4,15,DuPont,1802,,org,PROPN,NUM,nsubj,nummod,NNP,CD,3,1
1395,1340.0,31,goes,23,23,30,7,22,0,0,7,Academy,1802,,per,PROPN,NUM,pobj,pobj,NNP,CD,1,1
1396,1341.0,32,coached,3,11,20,9,10,11,-8,17,Maple Leaf Sports Entertainment,Toronto Marlies,---,org-org,PROPN-PROPN-PROPN-PROPN,PROPN-PROPN,compound-compound-compound-pobj,compound-appos,NNP-NNP-NNPS-NNP,NNP-NNPS,4,1
1397,2718.0,40,operated,3,6,1,-5,5,38,-3,-2,Maple Leaf Sports Entertainment,Toronto Marlies,org-org-org-org,-,PROPN-PROPN-PROPN-PROPN,PROPN-PROPN,compound-compound-compound-compound,compound-conj,NNP-NNP-NNPS-NNP,NNP-NNPS,4,1
1398,1342.0,32,is,17,2,11,9,1,20,15,-6,John Paul II Institute,Family at The Catholic University of America,per-per-per-per,------,PROPN-PROPN-PROPN-PROPN,PROPN-ADP-DET-PROPN-PROPN-ADP-PROPN,compound-compound-compound-nsubj,conj-prep-det-compound-pobj-prep-pobj,NNP-NNP-NNP-NNP,NNP-IN-DT-NNP-NNP-IN-NNP,5,1
1399,2172.0,41,obtained,3,13,22,9,12,18,-10,19,John Paul II Institute,Family at The Catholic University of America,---,org-org-org-org-org-org-org,PROPN-PROPN-PROPN-PROPN,PROPN-ADP-DET-PROPN-PROPN-ADP-PROPN,compound-compound-compound-pobj,conj-prep-det-compound-pobj-prep-pobj,NNP-NNP-NNP-NNP,NNP-IN-DT-NNP-NNP-IN-NNP,5,1
1400,1343.0,21,'m,1,14,18,4,13,2,-13,17,Vodafone,UK,,per,PROPN,PROPN,compound,compound,NNP,NNP,4,1
1401,1344.0,36,worked,4,11,11,0,10,24,-7,7,Chicago,Chicago Union Station Company,org,---,PROPN,PROPN-PROPN-PROPN-PROPN,compound,compound-compound-compound-conj,NNP,NNP-NNP-NNP-NNP,0,1
1402,1345.0,22,President,0,6,14,8,5,7,-6,14,Wal-Mart,Arkansas,per,,PROPN,PROPN,punct,appos,NNP,NNP,3,1
1403,1346.0,44,Chun-yan,2,1,19,18,0,24,1,17,Albert Ho,of the Hon,per-per,--,PROPN-PROPN,ADP-DET-PROPN,compound-compound,prep-det-compound,NNP-NNP,IN-DT-NNP,3,1
1404,1347.0,44,noted,8,17,33,16,16,10,-9,25,UDP,Dean Barrow,org,-,PROPN,PROPN-PROPN,appos,compound-nsubjpass,NNP,NNP-NNP,7,1
1405,1348.0,35,responded,1,17,34,17,16,0,-16,33,he,G-Unit,org,,PRON,PROPN,nsubj,conj,PRP,NNP,7,1
1406,1349.0,47,named,5,12,19,7,11,27,-7,14,University of Southern California,Troy,org-org-org-org,,PROPN-ADP-PROPN-PROPN,PROPN,poss-prep-compound-pobj,compound,NNP-IN-NNP-NNP,NNP,7,1
1407,1350.0,55,awarded,4,50,52,2,49,2,-46,48,Austrian,Rudolf,org,,ADJ,PROPN,amod,dobj,JJ,NNP,2,1
1408,1351.0,32,established,8,27,30,3,26,1,-19,22,Malaysia,UMS,org,,PROPN,PROPN,compound,appos,NNP,NNP,1,1
1409,1352.0,30,was,2,4,26,22,3,3,-2,24,James Monroe,Virginia,-,org,PROPN-PROPN,PROPN,compound-compound,pobj,NNP-NNP,NNP,4,1
1410,1353.0,42,announced,12,28,38,10,27,3,-16,26,UCF,Florida,org,,PROPN,PROPN,pobj,poss,NNP,NNP,6,1
1411,1354.0,14,is,2,1,11,10,0,2,1,9,Albemarle Corporation,Baton Rouge,per-per,-,PROPN-PROPN,PROPN-PROPN,compound-nsubj,compound-compound,NNP-NNP,NNP-NNP,7,1
1412,1355.0,32,warned,6,23,24,1,22,7,-17,18,President,Viktor Yushchenko,,per-per,PROPN,PROPN-PROPN,compound,compound-pobj,NNP,NNP-NNP,1,1
1413,1356.0,28,line,3,8,8,0,7,19,-5,5,Utah and Northern Railway,Utah,per-per-per-per,,PROPN-CCONJ-PROPN-PROPN,PROPN,pobj-cc-compound-conj,compound,NNP-CC-NNP-NNP,NNP,0,1
1414,1357.0,19,attended,1,3,5,2,2,13,-2,4,Bromsgrove School,Worcestershire,org-org,,PROPN-PROPN,PROPN,compound-compound,dobj,NNP-NNP,NNP,3,1
1415,1358.0,34,is,1,1,6,5,0,27,0,5,Winchester,Patsy Cline,,per-per,PROPN,PROPN-PROPN,nsubj,compound-compound,NNP,NNP-NNP,4,1
1416,1359.0,33,supported,9,25,29,4,24,3,-16,20,California,Kamala Harris,,org-org,PROPN,PROPN-PROPN,compound,compound-conj,NNP,NNP-NNP,3,1
1417,1360.0,31,shot,12,21,25,4,20,5,-9,13,her,Keith Lieberthal,per,-,DET,PROPN-PROPN,poss,compound-pobj,PRP$,NNP-NNP,6,1
1418,1361.0,37,lambasted,5,18,24,6,17,12,-13,19,where she made cutting remarks,shaukat Aziz,org-org-org-org-org,-,ADV-PRON-VERB-VERB-NOUN,ADP-PROPN,advmod-nsubj-pcomp-advcl-dobj,compound-pobj,WRB-PRP-VBD-VBG-NNS,IN-NNP,6,1
1419,1362.0,24,is,7,2,2,0,1,21,5,-5,High Point,High Point University,org-org,--,PROPN-PROPN,PROPN-PROPN-PROPN,compound-compound,compound-compound-dobj,NNP-NNP,NNP-NNP-NNP,0,1
1420,1363.0,40,took,6,27,27,0,26,12,-21,21,Georgia Army National Guard,Georgia,---,per,PROPN-PROPN-PROPN-PROPN,PROPN,compound-compound-compound-ROOT,appos,NNP-NNP-NNP-NNP,NNP,0,1
1421,1364.0,35,filled,13,16,25,9,15,9,-3,12,Toktar Aubakirov,Kazakhstan,-,org,PROPN-PROPN,PROPN,compound-pobj,pobj,NNP-NNP,NNP,5,1
1422,1365.0,28,sold,12,4,25,21,3,2,8,13,Long Beach,CSULB,org-org,,PROPN-PROPN,NOUN,compound-compound,compound,NNP-NNP,NNS,8,1
1423,1366.0,39,began,10,18,36,18,17,2,-8,26,Siegen,Peter Paul Rubens,,per-per-per,PROPN,PROPN-PROPN-PROPN,pobj,compound-compound-pobj,NNP,NNP-NNP-NNP,7,1
1424,1367.0,26,represented,8,3,16,13,2,9,5,8,North Carolina Tar Heels,Chapel Hill,---,per-per,PROPN-PROPN-PROPN-PROPN,PROPN-PROPN,compound-nmod-compound-compound,compound-pobj,NNP-NNP-NNP-NNP,NNP-NNP,4,1
1425,1368.0,33,took,17,1,9,8,0,23,16,-8,Ignat Bednarik,Romania,per-per,,PROPN-PROPN,PROPN,compound-nsubj,pobj,NNP-NNP,NNP,2,1
1426,1369.0,22,founded,3,6,18,12,5,3,-3,15,M.A. Razaq,General Motors,-,per-per,PROPN-PROPN,PROPN-PROPN,compound-pobj,compound-compound,NNP-NNP,NNP-NNPS,10,1
1427,1370.0,37,was,20,12,31,19,11,5,8,11,KGB,1954,,org,PROPN,NUM,appos,pobj,NNP,CD,8,1
1428,1371.0,29,is,17,9,28,19,8,0,8,11,ZDF,Germany,org,,PROPN,PROPN,appos,pobj,NNP,NNP,7,1
1429,1372.0,19,took,1,16,17,1,15,1,-15,16,President,Marc Ravalomanana,per,-,PROPN,PROPN-PROPN,compound,compound-pobj,NNP,NNP-NNP,1,1
1430,1373.0,39,established,7,1,13,12,0,25,6,6,Cab Calloway School of the Arts,1992,-----,org,PROPN-PROPN-PROPN-ADP-DET-PROPN,NUM,compound-compound-nsubjpass-prep-det-pobj,pobj,NNP-NNP-NNP-IN-DT-NNPS,CD,3,1
1431,1374.0,31,was,2,16,20,4,15,10,-14,18,Christian Democratic Appeal,CDA,--,per,PROPN-PROPN-PROPN,PROPN,compound-compound-pobj,appos,NNP-NNP-NNP,NNP,2,1
1432,1375.0,31,created,4,6,17,11,5,13,-2,13,Chicago,ShoreBank,org,,PROPN,PROPN,poss,appos,NNP,NNP,4,1
1433,1376.0,39,was,3,36,38,2,35,0,-33,35,his,Australia,per,,DET,PROPN,poss,pobj,PRP$,NNP,1,1
1434,1377.0,14,conducted,4,1,10,9,0,3,3,6,Pennsylvania,Lower Dauphin School district,,org-org-org-org,PROPN,PROPN-PROPN-PROPN-NOUN,compound,compound-compound-compound-pobj,NNP,NNP-NNP-NNP-NN,7,1
1435,1378.0,30,includes,2,7,25,18,6,4,-5,23,University of Pretoria,university,org-org-org,,PROPN-ADP-PROPN,NOUN,nmod-prep-pobj,poss,NNP-IN-NNP,NN,11,1
1436,1380.0,24,is,7,1,3,2,0,20,6,-4,Altimo,Alfa Group,,per-per,PROPN,PROPN-PROPN,nsubj,compound-compound,NNP,NNP-NNP,2,1
1437,1381.0,46,became,2,28,35,7,27,10,-26,33,James Madison,United States,org-org,-,PROPN-PROPN,PROPN-PROPN,compound-pobj,compound-pobj,NNP-NNP,NNP-NNP,3,1
1438,1383.0,75,said,1,30,49,19,29,25,-29,48,People's Republic of China,Tsinghua University,---,org-org,PROPN-PROPN-ADP-PROPN,PROPN-PROPN,compound-poss-prep-pobj,compound-pobj,NNP-NNP-IN-NNP,NNP-NNP,7,1
1439,1384.0,25,decided,7,3,5,2,2,19,4,-2,USF,Stephen Privett,per,-,PROPN,PROPN-PROPN,compound,compound-compound,NNP,NNP-NNP,2,1
1440,1385.0,22,served,5,9,20,11,8,1,-4,15,Quebec,Jean Charest,,org-org,PROPN,PROPN-PROPN,compound,compound-pobj,NNP,NNP-NNP,6,1
1441,1386.0,29,is,5,14,18,4,13,10,-9,13,Jon Van Caneghem,New World Computing,--,org-org-org,PROPN-PROPN-PROPN,PROPN-PROPN-PROPN,compound-compound-pobj,compound-compound-pobj,NNP-NNP-NNP,NNP-NNP-NNP,2,1
1442,1387.0,26,was,16,9,21,12,8,4,7,5,he,Chile,per,,PRON,PROPN,nsubj,pobj,PRP,NNP,2,1
1443,1388.0,31,become,4,23,26,3,22,4,-19,22,Bam Margera,Melissa,-,org,PROPN-PROPN,PROPN,compound-conj,compound,NNP-NNP,NNP,1,1
1444,1389.0,31,appeared,2,5,9,4,4,21,-3,7,Troy Donahue,she,per-per,,PROPN-PROPN,PRON,compound-pobj,nsubj,NNP-NNP,PRP,4,1
1445,1390.0,26,formed,4,2,23,21,1,2,2,19,2nd Division,Imperial Japanese Army,org-org,--,ADJ-PROPN,PROPN-PROPN-PROPN,compound-nsubjpass,amod-amod-pobj,JJ-NNP,NNP-NNP-NNP,9,1
1446,1391.0,24,became,10,5,7,2,4,16,5,-3,Prime Minister,Sadiq al-Mahdi,-,org-org,PROPN-PROPN,PROPN-PROPN,compound-compound,compound-compound,NNP-NNP,NNP-NNP,2,1
1447,1392.0,21,Guard,8,6,11,5,5,9,2,3,Hawaii,HANG,org,,PROPN,PROPN,compound,nmod,NNP,NNP,3,1
1448,1393.0,29,said,6,20,28,8,19,0,-14,22,Zimbabwe,ZCTU,,per,PROPN,PROPN,pobj,pobj,NNP,NNP,5,1
1449,1394.0,48,received,2,31,36,5,30,11,-29,34,Cable,New York,,org-org,PROPN,PROPN-PROPN,pobj,compound-pobj,NNP,NNP-NNP,4,1
1450,1395.0,31,charged,5,2,10,8,1,20,3,5,British Armed Forces,United Kingdom,per-per-per,-,ADJ-PROPN-PROPN,PROPN-PROPN,compound-compound-nsubjpass,compound-dobj,JJ-NNP-NNPS,NNP-NNP,5,1
1451,1396.0,21,retained,11,1,14,13,0,6,10,3,The Times Literary Supplement,News International,per-per-per-per,-,DET-PROPN-PROPN-PROPN,PROPN-PROPN,det-compound-compound-nsubjpass,compound-pobj,DT-NNP-NNP-NNP,NNP-NNP,4,1
1452,1397.0,25,praised,6,2,5,3,1,19,4,-1,Eagle Forum,Phyllis Schlafly,-,per-per,PROPN-PROPN,PROPN-PROPN,compound-compound,compound-nsubj,NNP-NNP,NNP-NNP,2,1
1453,1398.0,21,is,13,1,20,19,0,0,12,7,Feni Rose,entrepreneur,-,org,PROPN-PROPN,NOUN,compound-conj,conj,NNP-NNP,NN,2,1
1454,1399.0,16,was,10,1,15,14,0,0,9,5,Oreste Bilancia,actor,-,per,PROPN-PROPN,NOUN,compound-nsubj,attr,NNP-NNP,NN,2,1
1455,1400.0,24,founded,3,1,10,9,0,13,2,7,Technology Review,The,-,org,PROPN-PROPN,DET,compound-nsubjpass,det,NNP-NNP,DT,3,1
1456,1401.0,36,been,13,23,25,2,22,10,-10,12,California,Clair Engle,,org-org,PROPN,PROPN-PROPN,pobj,compound-conj,NNP,NNP-NNP,7,1
1457,1402.0,30,is,3,14,17,3,13,12,-11,14,Taylor,England,org,,PROPN,PROPN,nsubj,pobj,NNP,NNP,2,1
1458,1403.0,58,held,6,17,22,5,16,35,-11,16,Citytv,NewNet,org,,PROPN,PROPN,appos,ROOT,NNP,NNP,7,1
1459,1404.0,26,decreased,8,14,23,9,13,2,-6,15,Dirk Hermann,Solidarity,org-org,,PROPN-PROPN,PROPN,compound-nsubj,appos,NNP-NNP,NNP,1,1
1460,1405.0,42,is,20,1,38,37,0,3,19,18,Erika Jo,Nashville Star,per-per,-,PROPN-PROPN,PROPN-PROPN,compound-compound,compound-compound,NNP-NNP,NNP-NNP,10,1
1461,1406.0,15,Missouri,2,3,6,3,2,8,-1,4,Missouri,University of Missouri,per,--,PROPN,PROPN-ADP-PROPN,compound,appos-prep-pobj,NNP,NNP-IN-NNP,3,1
1462,1407.0,24,released,2,5,10,5,4,13,-3,8,Mercury,Rod,per,,PROPN,PROPN,compound,compound,NNP,NNP,6,1
1463,1408.0,27,was,4,6,9,3,5,17,-2,5,Swedbank,Sweden,per,,PROPN,PROPN,compound,pobj,NNP,NNP,2,1
1464,1409.0,47,provoked,2,33,37,4,32,9,-31,35,Japan,Shinzo Abe,,per-per,PROPN,PROPN-PROPN,poss,compound-appos,NNP,NNP-NNP,3,1
1465,1410.0,20,became,2,12,18,6,11,1,-10,16,San Juan,his,per-per,,PROPN-PROPN,DET,compound-pobj,poss,NNP-NNP,PRP$,11,1
1466,1411.0,21,come,18,4,16,12,3,4,14,-2,Capitol Records,Michael Lardie,org-org,-,PROPN-PROPN,PROPN-PROPN,compound-nsubj,compound-pobj,NNP-NNPS,NNP-NNP,5,1
1467,1412.0,33,said,20,2,22,20,1,10,18,2,Japan,Waseda University,,org-org,PROPN,PROPN-PROPN,compound,compound-compound,NNP,NNP-NNP,9,1
1468,1413.0,80,In,0,49,59,10,48,20,-49,59,Sony Music,Shakira,per-per,,PROPN-PROPN,PROPN,compound-ROOT,ROOT,NNP-NNP,NNP,4,1
1469,1414.0,37,founded,3,6,8,2,5,28,-3,5,1999,Korea Aerospace Industries,,org-org-org,NUM,PROPN-PROPN-PROPN,pobj,compound-compound-pobj,CD,NNP-NNP-NNP,2,1
1470,1415.0,46,is,9,28,31,3,27,14,-19,22,Studio Ghibli,Isao Takahata,-,per-per,PROPN-PROPN,PROPN-PROPN,compound-compound,compound-appos,NNP-NNP,NNP-NNP,2,1
1471,1416.0,83,declined,2,60,80,20,59,2,-58,78,Michael Capellas,First Data,org-org,-,PROPN-PROPN,PROPN-PROPN,compound-conj,compound-compound,NNP-NNP,NNP-NNP,7,1
1472,1417.0,20,is,2,11,1,-10,10,18,-9,-1,California,Panda Restaurant Group,,per-per-per,PROPN,PROPN-PROPN-PROPN,pobj,compound-compound-pobj,NNP,NNP-NNP-NNP,5,1
1473,1418.0,32,is,11,2,21,19,1,10,9,10,Khaleda Zia,Bangladesh,-,per,PROPN-PROPN,PROPN,compound-nsubj,pobj,NNP-NNP,NNP,4,1
1474,2093.0,34,found,17,15,7,-8,14,26,2,-10,Khaleda Zia,Bangladesh,org-org,,PROPN-PROPN,PROPN,compound-pobj,compound,NNP-NNP,NNP,6,1
1475,1419.0,38,announced,6,12,23,11,11,14,-6,17,?eljko Joksimovi,in Belgra,-,per-per,PUNCT-PROPN,ADP-PROPN,punct-ROOT,prep-compound,.-NNP,IN-NNP,-1,1
1476,1420.0,32,In,0,4,19,15,3,12,-4,19,Yousaf Raza Gillani,Board of Management,org-org-org,--,PROPN-PROPN-PROPN,PROPN-ADP-PROPN,compound-compound-pobj,pobj-prep-pobj,NNP-NNP-NNP,NNP-IN-NNP,7,1
1477,1421.0,17,formed,9,8,11,3,7,5,1,2,David Geffen,DreamWorks,-,per,PROPN-PROPN,PROPN,compound-conj,compound,NNP-NNP,NNP,3,1
1478,1422.0,43,explained,22,3,6,3,2,36,19,-16,David Wilmot,Pennsylvania,-,org,PROPN-PROPN,PROPN,compound-nsubj,pobj,NNP-NNP,NNP,1,1
1479,1423.0,24,represent,17,8,3,-5,7,20,9,-14,Oakland University,Michigan,org-org,,PROPN-PROPN,PROPN,compound-compound,compound,NNP-NNP,NNP,2,1
1480,1424.0,20,is,12,2,15,13,1,4,10,3,Charles Walker,American,-,org,PROPN-PROPN,ADJ,compound-nsubj,amod,NNP-NNP,JJ,3,1
1481,1425.0,48,rumors,2,34,45,11,33,2,-32,43,Ruby Dee,Ossie Davis,-,org-org,PROPN-PROPN,PROPN-PROPN,compound-appos,compound-ROOT,NNP-NNP,NNP-NNP,4,1
1482,1426.0,34,shocked,1,1,17,16,0,16,0,16,Dubai,World,per,,PROPN,PROPN,nsubj,nsubj,NNP,NNP,4,1
1483,1427.0,44,keyboardists,20,26,39,13,25,4,-6,19,Ian Stewart,Rolling Stones,per-per,-,PROPN-PROPN,PROPN-PROPN,compound-compound,compound-dobj,NNP-NNP,NNP-NNPS,6,1
1484,1428.0,27,buried,2,19,22,3,18,4,-17,20,NCAA,UK,per,,PROPN,PROPN,compound,pobj,NNP,NNP,3,1
1485,1429.0,47,was,5,5,19,14,4,27,0,14,Omaha,2nd Ranger Battalion,,org-org-org,PROPN,NOUN-PROPN-PROPN,pobj,compound-compound-conj,NNP,NN-NNP-NNP,5,1
1486,1430.0,27,suspended,5,2,10,8,1,16,3,5,GOME Electrical Appliances,Huang Guangyu,per-per-per,-,PROPN-PROPN-PROPN,PROPN-PROPN,compound-compound-nsubj,compound-appos,NNP-NNP-NNPS,NNP-NNP,4,1
1487,1431.0,18,produce,5,2,15,13,1,2,3,10,2002,Cris Morena Group,org,--,NUM,PROPN-PROPN-PROPN,pobj,compound-compound-appos,CD,NNP-NNP-NNP,4,1
1488,1432.0,45,said,38,40,42,2,39,2,-2,4,LAFD,Douglas L. Barry,per,--,PROPN,PROPN-PROPN-PROPN,compound,compound-compound-nsubj,NNP,NNP-NNP-NNP,3,1
1489,1433.0,23,named,16,19,15,-4,18,7,-3,-1,American,Scott Carpenter,per,-,ADJ,PROPN-PROPN,amod,compound-pobj,JJ,NNP-NNP,4,1
1490,1434.0,18,held,4,1,14,13,0,3,3,10,Pennsylvania,Arlen Specter,,org-org,PROPN,PROPN-PROPN,compound,compound-poss,NNP,NNP-NNP,5,1
1491,1435.0,26,make,3,1,11,10,0,14,2,8,Angkor Airways,Cambodia,per-per,,PROPN-PROPN,PROPN,compound-nsubj,pobj,NNP-NNP,NNP,3,1
1492,1436.0,29,Owned,0,5,9,4,4,19,-5,9,Prince Khalid Abdullah,Juddmonte Farms,org-org-org,-,PROPN-PROPN-PROPN,PROPN-PROPN,compound-compound-poss,compound-compound,NNP-NNP-NNP,NNP-NNPS,3,1
1493,1437.0,17,appointed,7,5,11,6,4,5,2,4,Franklin D. Roosevelt,New York,--,org-org,PROPN-PROPN-PROPN,PROPN-PROPN,compound-compound-nsubj,compound-compound,NNP-NNP-NNP,NNP-NNP,5,1
1494,1438.0,27,took,5,15,24,9,14,2,-10,19,Central Coast,ARC,org-org,,PROPN-PROPN,PROPN,compound-compound,compound,NNP-NNP,NNP,7,1
1495,1439.0,40,said,5,5,12,7,4,27,0,7,Netherlands,Rembrandt,,org,PROPN,PROPN,pobj,pobj,NNP,NNP,4,1
1496,1440.0,22,elected,6,10,12,2,9,9,-4,6,Georgia,Eduard Shevardnadze,org,-,PROPN,PROPN-PROPN,pobj,compound-nsubjpass,NNP,NNP-NNP,2,1
1497,1441.0,29,produced,3,18,22,4,17,6,-15,19,Prime Minister,Faisal al-Fayez,org-org,-,PROPN-PROPN,PROPN-PROPN,compound-appos,compound-pobj,NNP-NNP,NNP-NNP,2,1
1498,1442.0,54,finished,12,7,22,15,6,31,5,10,Virginia Tech,Division I,-,per-per,PROPN-PROPN,PROPN-NUM,compound-compound,pobj-appos,NNP-NNP,NNP-CD,7,1
1499,1443.0,18,School,2,1,5,4,0,12,1,3,Aylesbury High School,Buckinghamshire,--,per,PROPN-PROPN-PROPN,PROPN,compound-compound-ROOT,appos,NNP-NNP-NNP,NNP,4,1
1500,2011.0,6,Buckinghamshire,4,1,5,4,0,0,3,1,Aylesbury High School,Buckinghamshire,per-per-per,,PROPN-PROPN-PROPN,PROPN,compound-compound-compound,ROOT,NNP-NNP-NNP,NNP,3,1
1501,1444.0,18,met,3,13,16,3,12,1,-10,13,Alaska,Ernest Gruening,org,-,PROPN,PROPN-PROPN,nmod,compound-pobj,NNP,NNP-NNP,3,1
1502,1445.0,16,was,4,10,11,1,9,4,-6,7,singer,he,,org,NOUN,PRON,conj,nsubj,NN,PRP,1,1
1503,1446.0,31,came,3,12,30,18,11,0,-9,27,the Libertines,London,per-per,,DET-NOUN,PROPN,det-appos,pobj,DT-NNS,NNP,8,1
1504,1447.0,12,is,3,1,10,9,0,1,2,7,University of Guadalajara,Jalisco,org-org-org,,PROPN-ADP-PROPN,PROPN,nsubj-prep-pobj,compound,NNP-IN-NNP,NNP,5,1
1505,1449.0,29,was,10,1,24,23,0,4,9,14,Luigi Luzzatti,Italy,-,per,PROPN-PROPN,PROPN,compound-nsubj,pobj,NNP-NNP,NNP,3,1
1506,1450.0,23,named,3,7,22,15,6,0,-4,19,Air Training Command,Texas,--,per,PROPN-PROPN-PROPN,PROPN,compound-compound-poss,pobj,NNP-NNP-NNP,NNP,6,1
1507,1451.0,17,married,4,6,15,9,5,1,-2,11,Sheldon Whitehouse,Rhode Island,-,org-org,PROPN-PROPN,PROPN-PROPN,compound-dobj,compound-pobj,NNP-NNP,NNP-NNP,5,1
1508,1452.0,26,made,2,15,16,1,14,9,-13,14,King,George V of the United Kingdom,org,-----,PROPN,PROPN-PROPN-ADP-DET-PROPN-PROPN,compound,compound-pobj-prep-det-compound-pobj,NNP,NNP-NNP-IN-DT-NNP-NNP,1,1
1509,1453.0,29,born,4,12,19,7,11,9,-8,15,Calgary,his,,per,PROPN,DET,pobj,poss,NNP,PRP$,6,1
1510,1454.0,21,took,7,4,15,11,3,5,3,8,Australian,David Boon,,per-per,ADJ,PROPN-PROPN,amod,compound-pobj,JJ,NNP-NNP,7,1
1511,1456.0,26,School,2,1,22,21,0,3,1,20,Wath Comprehensive School,Rotherham,org-org-org,,PROPN-PROPN-PROPN,PROPN,compound-compound-ROOT,compound,NNP-NNP-NNP,NNP,6,1
1512,1457.0,13,toured,3,6,12,6,5,0,-3,9,Bootsy Collins,Parliament-Funkadelic,-,per,PROPN-PROPN,PROPN,compound-pobj,pobj,NNP-NNP,NNP,6,1
1513,1458.0,27,believed,10,8,14,6,7,12,2,4,Paul Keating,Australia,per-per,,PROPN-PROPN,PROPN,compound-conj,pobj,NNP-NNP,NNP,6,1
1514,1459.0,35,appointed,14,5,23,18,4,11,9,9,John Faulkner,Advisory Council of the Museum of Australian Democracy,org-org,-------,PROPN-PROPN,PROPN-PROPN-ADP-DET-PROPN-ADP-ADJ-PROPN,compound-pobj,compound-pobj-prep-det-pobj-prep-compound-pobj,NNP-NNP,NNP-NNP-IN-DT-NNP-IN-JJ-NNP,6,1
1515,1460.0,9,located,4,1,1,0,0,7,3,-3,Spring Arbor University,Spring Arbor,per-per-per,-,PROPN-PROPN-PROPN,PROPN-PROPN,compound-compound-nsubjpass,compound-pobj,NNP-NNP-NNP,NNP-NNP,0,1
1516,1461.0,14,operated,2,11,13,2,10,0,-9,11,China,The9,,per,PROPN,PROPN,pobj,pobj,NNP,NNP,4,1
1517,1462.0,36,told,14,8,12,4,7,23,6,-2,Southwest Airlines,Gary C. Kelly,-,per-per-per,PROPN-PROPN,PROPN-PROPN-PROPN,nmod-nmod,compound-compound-nsubj,NNP-NNP,NNP-NNP-NNP,3,1
1518,1463.0,30,is,7,19,22,3,18,7,-12,15,MI5,United Kingdom,,per-per,PROPN,PROPN-PROPN,pobj,compound-poss,NNP,NNP-NNP,-1,1
1519,1464.0,22,left,3,2,16,14,1,5,1,13,he,State,org,,PRON,PROPN,nsubj,compound,PRP,NNP,3,1
1520,1465.0,36,attended,5,8,11,3,7,24,-3,6,University of Alaska Anchorage,Anchorage,org-org-org-org,,PROPN-ADP-PROPN-PROPN,PROPN,nmod-prep-pobj-dobj,compound,NNP-IN-NNP-NNP,NNP,4,1
1521,1466.0,45,ran,5,3,4,1,2,40,2,-1,Broadcom,Henry Samueli,,org-org,PROPN,PROPN-PROPN,compound,compound-dobj,NNP,NNP-NNP,1,1
1522,1467.0,59,Starting,0,21,33,12,20,25,-21,33,1968,turned,per,,NUM,VERB,pobj,ccomp,CD,VBN,2,1
1523,1468.0,15,continued,1,8,10,2,7,4,-7,9,Iraq,RAF Habbaniya,per,-,PROPN,PROPN-PROPN,pobj,compound-pobj,NNP,NNP-NNP,1,1
1524,1469.0,11,created,5,2,10,8,1,0,3,5,Bank of Mexico,1925,org-org-org,,PROPN-ADP-PROPN,NUM,nsubjpass-prep-pobj,nummod,NNP-IN-NNP,CD,3,1
1525,1470.0,54,planned,25,11,24,13,10,29,14,-1,Malawi,Banda,,org,PROPN,PROPN,dobj,compound,NNP,NNP,7,1
1526,1471.0,11,Georgia,9,4,10,6,3,0,5,1,Emory University School of Medicine,Georgia,org-org-org-org-org,,PROPN-PROPN-PROPN-ADP-PROPN,PROPN,compound-compound-nmod-prep-pobj,ROOT,NNP-NNP-NNP-IN-NNP,NNP,2,1
1527,1472.0,19,became,6,5,16,11,4,2,1,10,1964,Njala University,org,-,NUM,PROPN-PROPN,pobj,compound-compound,CD,NNP-NNP,5,1
1528,1473.0,40,came,2,15,35,20,14,4,-13,33,Tego,Puerto Rico,per,-,PROPN,PROPN-PROPN,compound,compound-pobj,NNP,NNP-NNP,13,1
1529,1475.0,21,is,7,6,15,9,5,5,1,8,TVBS-G,Taiwan,org,,PROPN,PROPN,appos,pobj,NNP,NNP,7,1
1530,1476.0,36,born,6,9,17,8,8,18,-3,11,Spain,he,,org,PROPN,PRON,pobj,nsubj,NNP,PRP,3,1
1531,1477.0,26,statistics,1,4,14,10,3,11,-3,13,Sweden,Church of Sweden,,org-org-org,PROPN,PROPN-ADP-PROPN,compound,pobj-prep-pobj,NNP,NNP-IN-NNP,7,1
1532,1478.0,40,said,12,10,34,24,9,5,2,22,6th Infantry Division,Datu Saudi Ampatuan,org-org-org,--,PROPN-PROPN-PROPN,PROPN-PROPN-PROPN,compound-compound-pobj,compound-compound-compound,NNP-NNP-NNP,NNP-NNP-NNP,-1,1
1533,1479.0,13,was,2,1,5,4,0,7,1,3,Pontiac,General Motors,,per-per,PROPN,PROPN-PROPN,compound,compound-compound,NNP,NNP-NNPS,3,1
1534,1480.0,55,was,4,41,53,12,40,1,-37,49,Veja,Editora Abril,org,-,PROPN,PROPN-PROPN,compound,compound-pobj,NNP,NNP-NNP,7,1
1535,1481.0,27,looks,5,21,24,3,20,2,-16,19,NFL Europa,Hamburg Sea Devils,-,org-org-org,PROPN-PROPN,PROPN-PROPN-PROPN,nmod-amod,compound-compound-pobj,NNP-NNP,NNP-NNP-NNP,3,1
1536,1482.0,23,rebuilding,7,3,22,19,2,0,4,15,Estonian Air,Estonia,per-per,,PROPN-PROPN,PROPN,compound-compound,dobj,NNP-NNP,NNP,3,1
1537,1483.0,14,performed,5,5,8,3,4,5,0,3,he,Canada,per,,PRON,PROPN,nsubj,dobj,PRP,NNP,1,1
1538,1484.0,21,acts,1,1,8,7,0,12,0,7,Armstrong,Hellcat,org,,PROPN,PROPN,nsubj,pobj,NNP,NNP,1,1
1539,1485.0,18,attended,7,4,9,5,3,8,3,2,Brooklyn,Medgar Evers College,,per-per-per,PROPN,PROPN-PROPN-PROPN,compound,compound-compound-dobj,NNP,NNP-NNP-NNP,7,1
1540,1486.0,11,elected,5,3,7,4,2,3,2,2,Millard Fillmore,United States,-,org-org,PROPN-PROPN,PROPN-PROPN,compound-nsubjpass,compound-compound,NNP-NNP,NNP-NNP,3,1
1541,1487.0,47,Sleep,0,14,17,3,13,29,-14,17,Jeff Martin,The Tea Party,per-per,--,PROPN-PROPN,DET-PROPN-PROPN,compound-pobj,det-nmod-nmod,NNP-NNP,DT-NNP-NNP,3,1
1542,1488.0,20,was,1,1,12,11,0,7,0,11,He,Azerbaijan,,org,PRON,PROPN,nsubj,poss,PRP,NNP,9,1
1543,1489.0,12,students,3,1,7,6,0,4,2,4,Esperanza High School,Placentia-Yorba Linda Unified School District,org-org-org,----,PROPN-PROPN-PROPN,PROPN-PROPN-PROPN-PROPN-PROPN,compound-compound-compound,amod-compound-compound-compound-conj,NNP-NNP-NNP,NNP-NNP-NNP-NNP-NNP,4,1
1544,1490.0,24,is,1,11,23,12,10,0,-10,22,Mehsud,Pakistan,org,,PROPN,PROPN,pobj,pobj,NNP,NNP,3,1
1545,1491.0,47,sold,4,3,6,3,2,40,1,2,Richard Li,STAR TV,org-org,-,PROPN-PROPN,PROPN-PROPN,compound-nsubj,compound-dobj,NNP-NNP,NNP-NNP,2,1
1546,1492.0,34,was,3,9,29,20,8,4,-6,26,England,Elizabeth I of England,per,---,PROPN,PROPN-PROPN-ADP-PROPN,pobj,compound-pobj-prep-pobj,NNP,NNP-NNP-IN-NNP,8,1
1547,1493.0,42,risen,4,8,23,15,7,18,-4,19,Puerto Rican Independence Party,Manuel Orellana,per-per-per-per,-,ADJ-ADJ-PROPN-PROPN,PROPN-PROPN,nmod-amod-compound-nmod,compound-pobj,JJ-JJ-NNP-NNP,NNP-NNP,9,1
1548,1494.0,18,be,2,9,16,7,8,1,-7,14,Bret Schundler,Jersey City,-,org-org,PROPN-PROPN,PROPN-PROPN,compound-nsubjpass,compound-pobj,NNP-NNP,NNP-NNP,4,1
1549,1495.0,26,worked,3,3,14,11,2,11,0,11,Gilford,New York,per,-,PROPN,PROPN-PROPN,nsubj,nmod-nmod,NNP,NNP-NNP,5,1
1550,1497.0,31,said,1,1,17,16,0,13,0,16,Maybank,Malaysia,per,,PROPN,PROPN,nsubj,pobj,NNP,NNP,6,1
1551,1498.0,15,Bohras,2,1,11,10,0,3,1,9,Kuwait Times,Ahmad Al-Khaled,-,org-org,PROPN-PROPN,PROPN-PROPN,compound-compound,nmod-prep,NNP-NNP,NNP-NNP,5,1
1552,1500.0,35,signed,5,7,9,2,6,25,-2,4,American,Bill Haley,,org-org,ADJ,PROPN-PROPN,amod,compound-dobj,JJ,NNP-NNP,1,1
1553,1501.0,20,was,5,3,11,8,2,8,2,6,Pierre P. Garven,New Jersey,--,per-per,PROPN-PROPN-PROPN,PROPN-PROPN,compound-compound-nsubj,compound-compound,NNP-NNP-NNP,NNP-NNP,8,1
1554,1660.0,21,was,6,1,12,11,0,8,5,6,Pierre P. Garven,New Jersey,per-per-per,-,PROPN-PROPN-PROPN,PROPN-PROPN,compound-compound-nsubj,compound-compound,NNP-NNP-NNP,NNP-NNP,6,1
1555,1502.0,26,Started,0,8,20,12,7,5,-8,20,Rail,Phong Bui,,per-per,PROPN,PROPN-PROPN,nsubj,compound-conj,NNP,NNP-NNP,5,1
1556,1503.0,21,is,3,11,14,3,10,6,-8,11,Tiny Vipers,Sub Pop Records,per-per,--,PROPN-PROPN,PROPN-PROPN-PROPN,compound-pobj,compound-compound-pobj,NNP-NNPS,NNP-NNP-NNPS,2,1
1557,1504.0,21,vowed,5,3,14,11,2,6,2,9,Vanuatu,Kalkot Mataskelekele,per,-,PROPN,PROPN-PROPN,conj,compound-poss,NNP,NNP-NNP,5,1
1558,1505.0,21,said,19,2,3,1,1,17,17,-16,Germany,Deutsche Telekom,per,-,PROPN,PROPN-PROPN,compound,compound-nsubj,NNP,NNP-NNP,1,1
1559,1506.0,40,was,6,36,38,2,35,1,-30,32,Jersey City,Samuel Wescott,org-org,-,PROPN-PROPN,PROPN-PROPN,compound-compound,compound-pobj,NNP-NNP,NNP-NNP,1,1
1560,1507.0,31,serves,2,2,9,7,1,21,0,7,school,Lincolnshire,org,,NOUN,PROPN,nsubj,pobj,NN,NNP,1,1
1561,1508.0,29,are,7,16,27,11,15,1,-9,20,Virginia State University,United States,per-per-per,-,PROPN-PROPN-PROPN,PROPN-PROPN,compound-compound-pobj,compound-pobj,NNP-NNP-NNP,NNP-NNP,9,1
1562,1510.0,28,member,1,10,20,10,9,7,-9,19,Billy Mitchell,Wisconsin,per-per,,PROPN-PROPN,PROPN,compound-nsubj,pobj,NNP-NNP,NNP,7,1
1563,1511.0,28,decided,5,4,4,0,3,23,1,-1,France 4,France,org-org,,PROPN-NUM,PROPN,nsubj-nummod,pobj,NNP-CD,NNP,0,1
1564,1512.0,11,visited,1,3,8,5,2,2,-2,7,Switzerland,Paul Klee,,org-org,PROPN,PROPN-PROPN,dobj,compound-dobj,NNP,NNP-NNP,3,1
1565,1513.0,26,is,14,6,25,19,5,0,8,11,119th Command and Control Squadron,Tennessee,----,per,PROPN-PROPN-CCONJ-PROPN-PROPN,PROPN,amod-nmod-cc-conj-nsubj,pobj,NNP-NNP-CC-NNP-NNP,NNP,4,1
1566,1514.0,18,is,8,1,14,13,0,3,7,6,Clarence Avant,entrepreneur,-,org,PROPN-PROPN,NOUN,compound-nsubj,attr,NNP-NNP,NN,3,1
1567,1515.0,30,is,1,13,9,-4,12,20,-12,8,Toronto,Canadian Western Bank,,per-per-per,PROPN,PROPN-PROPN-PROPN,pobj,amod-compound-appos,NNP,NNP-NNP-NNP,4,1
1568,1516.0,22,released,20,3,7,4,2,14,17,-13,he,Sony BMG,org,-,PRON,PROPN-PROPN,nsubjpass,compound-pobj,PRP,NNP-NNP,3,1
1569,1517.0,27,has,5,13,16,3,12,10,-8,11,Ratt,Stephen Pearcy,org,-,PROPN,PROPN-PROPN,compound,compound-pobj,NNP,NNP-NNP,2,1
1570,1518.0,15,attended,1,3,7,4,2,7,-2,6,Thornlea Secondary School,Thornhill,--,per,PROPN-PROPN-PROPN,PROPN,compound-compound-dobj,compound,NNP-NNP-NNP,NNP,3,1
1571,1519.0,32,warning,10,5,19,14,4,12,5,9,Seattle,Brad,per,,PROPN,PROPN,pobj,nsubj,NNP,NNP,5,1
1572,1520.0,40,been,33,3,23,20,2,16,30,-10,he,Israel,,org,PRON,PROPN,nsubj,compound,PRP,NNP,9,1
1573,1521.0,46,shifted,5,12,17,5,11,28,-7,12,Delhi,IITD,,per,PROPN,PROPN,compound,compound,NNP,NNP,4,1
1574,1523.0,28,recognized,20,1,5,4,0,22,19,-15,Michel,Alejandro Sanz,per,-,PROPN,PROPN-PROPN,nsubj,compound-appos,NNP,NNP-NNP,3,1
1575,1524.0,21,opened,3,9,17,8,8,3,-6,14,DBU,Dallas,,org,PROPN,PROPN,poss,dobj,NNP,NNP,4,1
1576,1525.0,27,founded,12,11,17,6,10,9,1,5,England,Anita Roddick,per,-,PROPN,PROPN-PROPN,pobj,compound-pobj,NNP,NNP-NNP,3,1
1577,1526.0,33,purchased,11,10,21,11,9,11,1,10,Harold Bradley,Nashville,-,per,PROPN-PROPN,PROPN,compound-appos,pobj,NNP-NNP,NNP,7,1
1578,1527.0,40,announced,10,2,5,3,1,34,8,-5,China Airlines,CAL,org-org,,PROPN-PROPN,PROPN,compound-nsubj,appos,NNP-NNP,NNP,2,1
1579,1528.0,20,come,4,3,8,5,2,11,1,4,school,Northumberland,,per,NOUN,PROPN,nsubj,poss,NN,NNP,5,1
1580,1529.0,24,acquired,6,10,12,2,9,11,-4,6,Company,Avro,per,,PROPN,PROPN,dobj,nmod,NNP,NNP,2,1
1581,1530.0,112,chemists,7,76,79,3,75,32,-69,72,Chiang Mai University,Thailand,--,org,PROPN-PROPN-PROPN,PROPN,compound-compound-compound,ROOT,NNP-NNP-NNP,NNP,5,1
1582,1531.0,13,is,3,1,10,9,0,2,2,7,The Morning Of,Newburgh,per-per-per,,DET-NOUN-ADP,PROPN,det-compound-nsubj,compound,DT-NN-IN,NNP,2,1
1583,1532.0,26,elected,6,5,10,5,4,15,1,4,he,Gatineau,per,,PRON,PROPN,nsubjpass,pobj,PRP,NNP,5,1
1584,1533.0,22,moved,6,4,6,2,3,15,2,0,New Zealand,Wareham,org-org,,PROPN-PROPN,PROPN,compound-compound,pobj,NNP-NNP,NNP,4,1
1585,1534.0,17,re-elected,8,1,5,4,0,11,7,-3,Albania,Sali Berisha,,per-per,PROPN,PROPN-PROPN,poss,compound-nsubjpass,NNP,NNP-NNP,3,1
1586,1535.0,23,is,8,1,19,18,0,3,7,11,Prince Matriculation Higher Secondary School,Chennai,per-per-per-per-per,,PROPN-PROPN-PROPN-PROPN-PROPN,PROPN,compound-compound-compound-compound-nsubj,compound,NNP-NNP-NNP-NNP-NNP,NNP,8,1
1587,1536.0,19,is,8,1,15,14,0,3,7,7,Mohamed Camara,actor,org-org,,PROPN-PROPN,NOUN,compound-nsubj,conj,NNP-NNP,NN,3,1
1588,1537.0,25,is,11,1,15,14,0,9,10,4,Afshin Ellian,professor,org-org,,PROPN-PROPN,NOUN,compound-nsubj,attr,NNP-NNP,NN,-1,1
1589,1538.0,32,held,5,11,18,7,10,13,-6,13,Otis College of Art and Design,Los Angeles,-----,org-org,PROPN-PROPN-ADP-PROPN-CCONJ-PROPN,PROPN-PROPN,compound-pobj-prep-pobj-cc-conj,compound-pobj,NNP-NNP-IN-NNP-CC-NNP,NNP-NNP,4,1
1590,1539.0,31,is,22,6,16,10,5,14,16,-6,Witte Automotive,Germany,org-org,,PROPN-PROPN,PROPN,compound-appos,compound,NNP-NNP,NNP,6,1
1591,1540.0,13,belongs,2,1,6,5,0,6,1,4,His,Vietnam,per,,DET,PROPN,poss,pobj,PRP$,NNP,4,1
1592,1541.0,24,cofounded,4,3,9,6,2,14,1,5,Anatol Rapoport,General Systems,per-per,-,PROPN-PROPN,PROPN-PROPN,compound-nsubj,compound-compound,NNP-NNP,NNP-NNPS,5,1
1593,1542.0,41,came,36,16,35,19,15,5,20,-1,Apple,Badfinger,,per,PROPN,PROPN,compound,nsubj,NNP,NNP,7,1
1594,1543.0,31,was,7,23,26,3,22,4,-16,19,Head of,DLJ Merchant Banking Partners,-,per-per-per-per,PROPN-ADP,PROPN-PROPN-PROPN-PROPN,conj-prep,compound-compound-compound-compound,NNP-IN,NNP-NNP-NNP-NNPS,3,1
1595,1544.0,25,left,14,1,16,15,0,8,13,2,Clapton,The Yardbirds,org,-,PROPN,DET-PROPN,nsubj,det-dobj,NNP,DT-NNPS,1,1
1596,1545.0,24,used,6,4,6,2,3,17,2,0,Ferrari,Italy,per,,PROPN,PROPN,compound,nsubj,NNP,NNP,2,1
1597,1546.0,24,is,11,2,10,8,1,13,9,-1,Chokkanatha Nayak,Mangammal,per-per,,PROPN-PROPN,PROPN,compound-compound,compound,NNP-NNP,NNP,4,1
1598,1547.0,13,is,1,8,12,4,7,0,-7,11,Glenlyon Norfolk School,Victoria,org-org-org,,PROPN-PROPN-PROPN,PROPN,compound-compound-pobj,pobj,NNP-NNP-NNP,NNP,5,1
1599,1548.0,34,district,2,16,27,11,15,6,-14,25,Baltimore,Digital Harbor High School,org,---,PROPN,PROPN-PROPN-PROPN-PROPN,compound,compound-compound-compound-pobj,NNP,NNP-NNP-NNP-NNP,8,1
1600,1549.0,18,is,1,8,17,9,7,0,-7,16,Future US,Revolver,per-per,,PROPN-PROPN,PROPN,compound-compound,conj,NNP-NNP,NNP,5,1
1601,2225.0,20,serves,2,8,18,10,7,1,-6,16,Future US,Revolver,-,org,PROPN-PROPN,PROPN,compound-compound,compound,NNP-NNP,NNP,4,1
1602,1550.0,14,had,4,1,4,3,0,9,3,0,LAN Airlines,Chile,-,org,PROPN-PROPN,PROPN,compound-nsubj,pobj,NNP-NNPS,NNP,1,1
1603,1551.0,29,moved,9,7,8,1,6,20,2,-1,Army Air Corps,Air Corps Tactical School,--,per-per-per-per,PROPN-PROPN-PROPN,PROPN-PROPN-PROPN-PROPN,compound-compound-nsubj,compound-compound-compound-dobj,NNP-NNP-NNP,NNP-NNP-NNP-NNP,2,1
1604,1552.0,24,grouped,4,7,18,11,6,5,-3,14,Gerhard Richter,Germany,-,org,PROPN-PROPN,PROPN,compound-pobj,pobj,NNP-NNP,NNP,5,1
1605,1553.0,75,lost,19,3,38,35,2,36,16,19,French Polynesia,Gaston Tong Sang,per-per,--,PROPN-PROPN,PROPN-PROPN-PROPN,amod-pobj,compound-compound-nsubjpass,NNP-NNP,NNP-NNP-NNP,10,1
1606,1554.0,9,was,1,1,6,5,0,2,0,5,He,lawyer,org,,PRON,NOUN,nsubj,conj,PRP,NN,2,1
1607,1555.0,52,Born,0,29,45,16,28,6,-29,45,LA,Brotha Lynch Hung,,per-per-per,PROPN,PROPN-PROPN-PROPN,compound,compound-compound-pobj,NNP,NNP-NNP-NNP,3,1
1608,1556.0,21,is,8,1,13,12,0,7,7,5,Jerry Lewis,actor,org-org,,PROPN-PROPN,NOUN,compound-nsubj,nmod,NNP-NNP,NN,5,1
1609,1557.0,34,VI,2,1,33,32,0,0,1,31,Nana,Ghana,,org,PROPN,PROPN,nsubj,pobj,NNP,NNP,9,1
1610,1783.0,17,is,3,2,10,8,1,6,1,7,Nana,Ghana,,org,PROPN,PROPN,compound,pobj,NNP,NNP,4,1
1611,1558.0,24,marked,7,1,23,22,0,0,6,16,His,Colorado,org,,DET,PROPN,poss,pobj,PRP$,NNP,2,1
1612,1559.0,17,is,8,1,11,10,0,5,7,3,Fletcher Sibthorp,British,org-org,,PROPN-PROPN,ADJ,compound-nsubj,amod,NNP-NNP,JJ,2,1
1613,1560.0,14,was,4,3,13,10,2,0,1,9,Amedeo Modigliani,France,org-org,,PROPN-PROPN,PROPN,compound-appos,pobj,NNP-NNP,NNP,3,1
1614,1561.0,44,comprises,8,15,15,0,14,28,-7,7,PLA Air Force,PLA,per-per-per,,PROPN-PROPN-PROPN,PROPN,compound-compound-appos,compound,NNP-NNP-NNP,NNP,0,1
1615,1562.0,32,is,6,1,20,19,0,11,5,14,BP,Tony Hayward,,per-per,PROPN,PROPN-PROPN,compound,compound-pobj,NNP,NNP-NNP,7,1
1616,1563.0,25,founded,2,1,14,13,0,10,1,12,La,Ricardo Castro Beeche,per,--,PROPN,PROPN-PROPN-PROPN,nsubjpass,compound-compound-nsubj,NNP,NNP-NNP-NNP,4,1
1617,1564.0,21,is,10,2,7,5,1,13,8,-3,Mongolian Stock Exchange,1991,--,per,PROPN-PROPN-PROPN,NUM,compound-compound-nsubj,pobj,NNP-NNP-NNP,CD,3,1
1618,1565.0,34,vanden,23,2,23,21,1,10,21,0,the Nation,Katrina vanden Heuvel,per-per,--,DET-NOUN,PROPN-NOUN-PROPN,det-pobj,nsubj-ROOT-dobj,DT-NN,NNP-NN-NNP,4,1
1619,1566.0,25,is,2,1,9,8,0,15,1,7,77th Street,Singapore,per-per,,ADJ-PROPN,PROPN,amod-nsubj,pobj,JJ-NNP,NNP,3,1
1620,1567.0,38,marked,9,28,36,8,27,1,-19,27,Shaikh Khalifa Bin Zayed Bangladesh Islamia School,Abu Dhabi,per-per-per-per-per-per-per,-,PROPN-PROPN-PROPN-PROPN-PROPN-PROPN-PROPN,PROPN-PROPN,compound-compound-compound-compound-compound-compound-pobj,compound-pobj,NNP-NNP-NNP-NNP-NNP-NNP-NNP,NNP-NNP,5,1
1621,1568.0,20,born,2,1,14,13,0,5,1,12,Yesung,Cheonan,per,,PROPN,PROPN,nsubjpass,compound,NNP,NNP,5,1
1622,1569.0,47,had,2,20,41,21,19,5,-18,39,Chile,Abraham Oyanedel,per,-,PROPN,PROPN-PROPN,pobj,compound-pobj,NNP,NNP-NNP,6,1
1623,1570.0,25,is,6,15,19,4,14,5,-9,13,Carthage College,Wisconsin,-,org,PROPN-PROPN,PROPN,compound-pobj,pobj,NNP-NNP,NNP,3,1
1624,1571.0,17,sold,9,2,14,12,1,2,7,5,Volvo,Ford,org,,PROPN,PROPN,compound,pobj,NNP,NNP,2,1
1625,1572.0,14,Founded,0,5,10,5,4,3,-5,10,SCO,Kyrgyzstan,org,,PROPN,PROPN,compound,compound,NNP,NNP,1,1
1626,1573.0,28,born,2,1,4,3,0,23,1,2,Hurley,Brian Hurley,org,-,PROPN,PROPN-PROPN,nsubjpass,compound-dobj,NNP,NNP-NNP,2,1
1627,1574.0,55,begin,24,40,54,14,39,0,-16,30,Democratic Party,Cher,org-org,,PROPN-PROPN,PROPN,compound-compound,conj,NNP-NNP,NNP,-1,1
1628,1575.0,30,said,13,26,29,3,25,0,-13,16,Cardiff University,Wales,org-org,,PROPN-PROPN,PROPN,compound-pobj,pobj,NNP-NNP,NNP,2,1
1629,1576.0,21,went,2,5,13,8,4,7,-3,11,Switzerland,Burton,org,,PROPN,PROPN,pobj,pobj,NNP,NNP,3,1
1630,1577.0,28,born,2,16,24,8,15,3,-14,22,Astrid of Sweden,Leopold III of Belgium,per-per-per,---,PROPN-ADP-PROPN,PROPN-PROPN-ADP-PROPN,appos-prep-pobj,compound-pobj-prep-pobj,NNP-IN-NNP,NNP-NNP-IN-NNP,5,1
1631,1578.0,29,said,1,4,12,8,3,16,-3,11,Taiwan,Kymco,,per,PROPN,PROPN,poss,appos,NNP,NNP,4,1
1632,1580.0,17,founded,6,2,14,12,1,2,4,8,Mendoza College of Business,John Francis O'Hara,---,org-org-org,PROPN-PROPN-ADP-PROPN,PROPN-PROPN-PROPN,compound-nsubjpass-prep-pobj,compound-compound-pobj,NNP-NNP-IN-NNP,NNP-NNP-NNP,4,1
1633,1581.0,14,came,8,1,5,4,0,8,7,-3,Morocco,Abbas El Fassi,org,--,PROPN,PROPN-PROPN-PROPN,poss,compound-compound-appos,NNP,NNP-NNP-NNP,4,1
1634,1582.0,27,supported,1,8,17,9,7,9,-7,16,Jim Flaherty,Ontario,per-per,,PROPN-PROPN,PROPN,compound-pobj,pobj,NNP-NNP,NNP,7,1
1635,1583.0,41,sustained,3,30,32,2,29,8,-27,29,6th Arkansas Infantry,Infantry,--,per,ADJ-PROPN-PROPN,PROPN,compound-compound-compound,compound,JJ-NNP-NNP,NNP,2,1
1636,1584.0,19,signed,2,15,17,2,14,1,-13,15,Fantasy,John Fogerty,org,-,PROPN,PROPN-PROPN,compound,compound-pobj,NNP,NNP-NNP,1,1
1637,1585.0,24,underwent,3,1,20,19,0,3,2,17,Gyllenhaal,Los Angeles,,per-per,PROPN,PROPN-PROPN,nsubj,compound-compound,NNP,NNP-NNP,9,1
1638,1586.0,35,implied,5,1,3,2,0,31,4,-2,Tesla,Frank Hannon,,per-per,PROPN,PROPN-PROPN,compound,compound-nsubj,NNP,NNP-NNP,1,1
1639,1587.0,24,was,5,4,13,9,3,10,1,8,Sinclair Weeks,Massachusetts,-,org,PROPN-PROPN,PROPN,compound-nsubj,pobj,NNP-NNPS,NNP,6,1
1640,1588.0,25,used,3,17,19,2,16,5,-14,16,Northern Ireland,Terence O'Neill,-,per-per,PROPN-PROPN,PROPN-PROPN,compound-compound,compound-pobj,NNP-NNP,NNP-NNP,3,1
1641,1589.0,10,buys,5,1,4,3,0,5,4,-1,Canada,Uranium One,org,-,PROPN,PROPN-PROPN,poss,compound-nsubj,NNP,NNP-NNP,3,1
1642,1590.0,35,arrives,10,8,31,23,7,3,2,21,Maggie McNamara,United States,-,per-per,PROPN-PROPN,PROPN-PROPN,compound-appos,compound-compound,NNP-NNP,NNP-NNP,10,1
1643,1591.0,28,Mark,1,6,9,3,5,18,-5,8,Helena Guergis,Ontario,per-per,,PROPN-PROPN,PROPN,conj-conj,pobj,NNP-NNP,NNP,5,1
1644,1592.0,22,was,5,16,19,3,15,2,-11,14,architects,Kansas City,,org-org,NOUN,PROPN-PROPN,pobj,compound-compound,NNS,NNP-NNP,2,1
1645,1593.0,12,is,2,1,10,9,0,1,1,8,Ron Davis,Toronto,-,per,PROPN-PROPN,PROPN,compound-nsubj,compound,NNP-NNP,NNP,5,1
1646,1594.0,41,chose,19,31,39,8,30,1,-12,20,Regent University,Pat Robertson,per-per,-,PROPN-PROPN,PROPN-PROPN,compound-pobj,compound-pobj,NNP-NNP,NNP-NNP,7,1
1647,1595.0,47,said,3,20,37,17,19,9,-17,34,Council of Labor Affairs,Taiwan,---,per,PROPN-ADP-PROPN-PROPN,PROPN,conj-prep-compound-pobj,pobj,NNP-IN-NNP-NNPS,NNP,9,1
1648,1597.0,66,option,0,21,40,19,20,25,-21,40,Singapore,NATIONAL UNIVERSITY OF SINGAPORE,,per-per-per-per,PROPN,PROPN-PROPN-ADP-PROPN,compound,compound-pobj-prep-pobj,NNP,NNP-NNP-IN-NNP,8,1
1649,1598.0,14,MP,4,3,7,4,2,6,1,3,William Cautley,Waimea,-,org,PROPN-PROPN,PROPN,compound-conj,pobj,NNP-NNP,NNP,3,1
1650,1599.0,72,was,25,41,44,3,40,27,-16,19,University of North Texas,Texas Normal College,per-per-per-per,--,PROPN-ADP-PROPN-PROPN,PROPN-PROPN-PROPN,pobj-prep-compound-compound,compound-compound-pobj,NNP-IN-NNP-NNP,NNP-NNP-NNP,1,1
1651,1600.0,40,represents,6,2,2,0,1,37,4,-4,Ball State Cardinals,Ball State University,per-per-per,--,PROPN-PROPN-PROPN,PROPN-PROPN-PROPN,compound-compound-compound,compound-compound-dobj,NNP-NNP-NNPS,NNP-NNP-NNP,0,1
1652,1601.0,88,http://www.hotchkiss.org/alumni/Accomplishments.aspx,0,4,9,5,3,78,-4,9,Edsel,Ford Motor Company,per,--,PROPN,PROPN-PROPN-PROPN,compound,compound-compound-pobj,NNP,NNP-NNP-NNP,3,1
1653,1602.0,32,is,16,3,3,0,2,28,13,-13,Saudi Aramco,Saudi Arabia,per-per,-,ADJ-PROPN,PROPN-PROPN,compound-compound,compound-pobj,JJ-NNP,NNP-NNP,0,1
1654,1603.0,16,launched,3,9,11,2,8,4,-6,8,Romania,Boom TV,org,-,PROPN,PROPN-NOUN,poss,compound-compound,NNP,NNP-NN,3,1
1655,1604.0,46,Bank,1,2,21,19,1,24,-1,20,Bank of China,schools of,org-org-org,-,PROPN-ADP-PROPN,NOUN-ADP,ROOT-prep-pobj,dobj-prep,NNP-IN-NNP,NNS-IN,6,1
1656,1605.0,126,girl,3,100,124,24,99,1,-97,121,Bell,Barry Manilow,per,-,PROPN,PROPN-PROPN,compound,compound-pobj,NNP,NNP-NNP,8,1
1657,1606.0,34,recommended,28,21,25,4,20,8,7,-3,his,Mississippi,,org,DET,PROPN,poss,compound,PRP$,NNP,4,1
1658,1607.0,20,disclosed,1,1,17,16,0,2,0,16,Citigroup,partner Morgan Stanley,per,--,PROPN,NOUN-PROPN-PROPN,nsubj,advcl-compound-dobj,NNP,NN-NNP-NNP,4,1
1659,1608.0,26,said,15,3,15,12,2,10,12,0,Shimon Peres,Israel,-,org,PROPN-PROPN,PROPN,compound-nsubj,pobj,NNP-NNP,NNP,2,1
1660,1609.0,26,is,2,1,16,15,0,9,1,14,Cebu Pacific,Philippines,-,org,PROPN-PROPN,PROPN,compound-nsubj,pobj,NNP-NNP,NNPS,5,1
1661,1610.0,17,book,2,1,16,15,0,0,1,14,His,2004,,org,DET,NUM,poss,pobj,PRP$,CD,3,1
1662,1611.0,23,started,2,1,12,11,0,10,1,10,Operation Mobilisation,George Verwer,per-per,-,PROPN-PROPN,PROPN-PROPN,compound-nsubj,compound-conj,NNP-NNP,NNP-NNP,4,1
1663,1612.0,36,announced,5,4,8,4,3,27,1,3,Carphone Warehouse,TalkTalk,org-org,,PROPN-PROPN,PROPN,compound-nsubj,nsubjpass,NNP-NNP,NNP,3,1
1664,1613.0,35,Coltishall,4,10,1,-9,9,33,-6,-3,RAF Coltishall,Royal Air Force,-,org-org-org,PROPN-PROPN,PROPN-PROPN-PROPN,compound-pobj,compound-compound-compound,NNP-NNP,NNP-NNP-NNP,6,1
1665,1614.0,31,founded,23,22,25,3,21,5,1,2,2006,Eznis Airways,org,-,NUM,PROPN-PROPN,nummod,compound-dobj,CD,NNP-NNP,2,1
1666,1615.0,25,resulted,2,8,17,9,7,7,-6,15,Enron,Jeffrey Skilling,,per-per,PROPN,PROPN-PROPN,poss,compound-conj,NNP,NNP-NNP,5,1
1667,1616.0,40,said,38,14,34,20,13,5,24,-4,Europe,ETUC,per,,PROPN,PROPN,poss,conj,NNP,NNP,11,1
1668,1617.0,13,started,6,5,10,5,4,2,1,4,Hugh Robinson,school,-,per,PROPN-PROPN,NOUN,compound-nsubj,pobj,NNP-NNP,NN,3,1
1669,1619.0,15,located,4,7,14,7,6,0,-3,10,Universiti Teknologi Malaysia,Johor,org-org-org,,PROPN-PROPN-PROPN,PROPN,compound-compound-pobj,pobj,NNP-NNP-NNP,NNP,4,1
1670,1620.0,22,started,4,9,21,12,8,0,-5,17,St. Lunatics,Ali,org-org,,PROPN-PROPN,PROPN,compound-compound,dobj,NNP-NNP,NNP,6,1
1671,1621.0,24,represented,7,3,15,12,2,8,4,8,Illinois Fighting Illini,Champaign,org-org-org,,PROPN-PROPN-PROPN,PROPN,compound-compound-compound,pobj,NNP-NNP-NNP,NNP,4,1
1672,1622.0,29,is,3,12,12,0,11,16,-9,9,Oslo University College,Oslo,--,org,PROPN-PROPN-PROPN,PROPN,compound-compound-compound,compound,NNP-NNP-NNP,NNP,0,1
1673,1623.0,19,were,3,7,9,2,6,9,-4,6,SEIU,Andy Stern,org,-,PROPN,PROPN-PROPN,compound,compound-pobj,NNP,NNP-NNP,1,1
1674,1624.0,32,is,2,1,10,9,0,21,1,8,Bethlehem University,West Bank,-,org-org,PROPN-PROPN,PROPN-PROPN,compound-nsubj,compound-pobj,NNP-NNP,NNP-NNP,5,1
1675,1625.0,38,expanded,1,1,35,34,0,2,0,34,Switzerland,Polytechnique de Lausanne,org,--,PROPN,PROPN-ADP-PROPN,pobj,compound-compound-pobj,NNP,NNP-IN-NNP,7,1
1676,1626.0,27,was,11,1,14,13,0,12,10,3,Charlotte of Mecklenburg-Strelitz,queen consort,--,org-org,PROPN-ADP-PROPN,NOUN-NOUN,nsubj-prep-pobj,compound-attr,NNP-IN-NNP,NN-NN,4,1
1677,1627.0,35,Known,0,4,10,6,3,24,-4,10,Benny,Lakewood,,org,PROPN,PROPN,compound,compound,NNP,NNP,5,1
1678,1629.0,14,prodigy,2,7,9,2,6,4,-5,7,Texas,Albert Collins,org,-,PROPN,PROPN-PROPN,compound,compound-pobj,NNP,NNP-NNP,1,1
1679,1630.0,26,is,12,1,17,16,0,8,11,5,Mary Louise Wilson,Drama Desk Award-winning,--,per-per-per,PROPN-PROPN-PROPN,PROPN-PROPN-VERB,compound-compound-nsubj,conj-npadvmod-nmod,NNP-NNP-NNP,NNP-NNP-VBG,4,1
1680,1631.0,12,In,0,4,7,3,3,4,-4,7,Gerald Levert,Atlantic,org-org,,PROPN-PROPN,PROPN,compound-pobj,appos,NNP-NNP,NNP,2,1
1681,1632.0,20,is,7,5,5,0,4,14,2,-2,San Jose,San State University,org-org,--,PROPN-PROPN,PROPN-PROPN-PROPN,compound-compound,compound-compound-compound,NNP-NNP,NNP-NNP-NNP,0,1
1682,1633.0,31,owns,4,1,3,2,0,27,3,-1,England,Amir Khan,org,-,PROPN,PROPN-PROPN,poss,compound-nsubj,NNP,NNP-NNP,2,1
1683,1635.0,41,doing,4,26,29,3,25,11,-22,25,Vanity Fair,Graydon Carter,-,org-org,PROPN-PROPN,PROPN-PROPN,compound-poss,compound-pobj,NNP-NNP,NNP-NNP,1,1
1684,1636.0,26,is,1,8,20,12,7,5,-7,19,Prince Philip Duke of Edinburgh,Elizabeth II of the United Kingdom,per-per-per-per-per,-----,PROPN-PROPN-PROPN-ADP-PROPN,PROPN-PROPN-ADP-DET-PROPN-PROPN,compound-compound-pobj-prep-pobj,compound-conj-prep-det-compound-pobj,NNP-NNP-NNP-IN-NNP,NNP-NNP-IN-DT-NNP-NNP,5,1
1685,1637.0,27,hosts,1,1,10,9,0,16,0,9,Djibouti,Combined Joint Task Force - Horn of Africa,per,-------,NOUN,PROPN-PROPN-PROPN-PROPN-PUNCT-PROPN-ADP-PROPN,nsubj,compound-compound-compound-compound-punct-appos-prep-pobj,NN,NNP-NNP-NNP-NNP-HYPH-NNP-IN-NNP,3,1
1686,1638.0,16,plays,1,1,14,13,0,1,0,13,Marist,Poughkeepsie,per,,PROPN,PROPN,nsubj,compound,NNP,NNP,4,1
1687,1639.0,44,is,5,15,18,3,14,25,-10,13,Christine Guldbrandsen,Norway,-,per,PROPN-PROPN,PROPN,nmod-pobj,nmod,NNP-NNP,NNP,1,1
1688,1640.0,26,is,1,1,7,6,0,18,0,6,Johnson,Equity,per,,PROPN,PROPN,nsubj,compound,NNP,NNP,5,1
1689,1641.0,21,is,4,11,11,0,10,9,-7,7,Kolkata Metro,Kolkata,per-per,,PROPN-PROPN,PROPN,compound-pobj,compound,NNP-NNP,NNP,0,1
1690,1642.0,37,were,2,4,35,31,3,1,-2,33,New York,Tallulah Bankhead,-,org-org,PROPN-PROPN,PROPN-PROPN,compound-compound,compound-conj,NNP-NNP,NNP-NNP,4,1
1691,1643.0,16,declared,4,2,9,7,1,6,2,5,he,Barbados,,per,PRON,PROPN,nsubjpass,poss,PRP,NNP,7,1
1692,1644.0,84,expressed,19,75,18,-57,74,65,-56,-1,Abdelaziz Belkhadem,FLN,per-per,,PROPN-PROPN,PROPN,compound-pobj,pobj,NNP-NNP,NNP,-1,1
1693,1645.0,16,became,3,6,11,5,5,4,-3,8,Krause Gentle Corporation,Kum Go,org-org-org,-,PROPN-PROPN-PROPN,PROPN-PROPN,compound-compound-attr,compound-poss,NNP-NNP-NNP,NNP-NNP,4,1
1694,1646.0,36,reconnoitred,7,5,6,1,4,29,2,-1,Yeomanry,Mounted Divisions,,per-per,PROPN,PROPN-PROPN,conj,compound-nsubj,NNP,NNP-NNPS,2,1
1695,1647.0,30,found,4,2,9,7,1,20,2,5,2003,Glam Media,,org-org,NUM,PROPN-PROPN,pobj,compound-pobj,CD,NNP-NNP,5,1
1696,1648.0,18,is,1,1,16,15,0,1,0,15,Colchester,Essex,org,,PROPN,PROPN,nsubj,compound,NNP,NNP,8,1
1697,1649.0,29,provided,3,3,9,6,2,19,0,6,Sanger,Team Fat,per,-,PROPN,PROPN-PROPN,nsubj,compound-compound,NNP,NNP-NNP,4,1
1698,1650.0,21,became,1,1,17,16,0,3,0,16,He,Serbia,per,,PRON,PROPN,nsubj,pobj,PRP,NNP,5,1
1699,1651.0,29,attended,4,6,11,5,5,17,-2,7,Silver Creek High School,San Jose,org-org-org-org,-,PROPN-PROPN-PROPN-PROPN,PROPN-PROPN,compound-compound-compound-dobj,compound-compound,NNP-NNP-NNP-NNP,NNP-NNP,4,1
1700,1652.0,27,documented,2,4,22,18,3,4,-2,20,Reformed,John Knox,,per-per,PROPN,PROPN-PROPN,compound,compound-conj,NNP,NNP-NNP,9,1
1701,1653.0,20,cut,2,10,14,4,9,5,-8,12,Norfolk Southern Corp.,Union Pacific,per-per-per,-,PROPN-PROPN-PROPN,PROPN-PROPN,compound-compound-appos,compound-conj,NNP-NNP-NNP,NNP-NNP,2,1
1702,1654.0,42,are,1,8,8,0,7,33,-7,7,Stirling,Stirling High School,per,--,VERB,VERB-PROPN-PROPN,pobj,compound-compound-dobj,VBG,VBG-NNP-NNP,0,1
1703,1655.0,27,signed,3,2,6,4,1,20,1,3,band,Philips Records,org,-,NOUN,PROPN-PROPN,nsubjpass,compound-pobj,NN,NNP-NNPS,3,1
1704,1656.0,26,taught,3,14,23,9,13,2,-11,20,Northwestern College,Orange City Iowa,-,org-org-org,PROPN-PROPN,PROPN-PROPN-PROPN,compound-appos,compound-compound-pobj,NNP-NNP,NNP-NNP-NNP,4,1
1705,1657.0,11,1986,0,3,6,3,2,4,-3,6,Columbia,Johnny Cash,,org-org,PROPN,PROPN-PROPN,compound,compound-dobj,NNP,NNP-NNP,2,1
1706,1658.0,26,trained,5,11,21,10,10,4,-6,16,London,Imperial College School of Medicine,,org-org-org-org-org,PROPN,PROPN-PROPN-PROPN-ADP-PROPN,poss,compound-compound-dobj-prep-pobj,NNP,NNP-NNP-NNP-IN-NNP,8,1
1707,1659.0,25,was,3,2,17,15,1,7,1,14,1st Division,Army,per-per,,ADJ-PROPN,PROPN,amod-nsubj,poss,JJ-NNP,NNP,7,1
1708,1661.0,48,worked,2,7,24,17,6,23,-5,22,Australia,James Morrison,org,-,PROPN,PROPN-PROPN,poss,compound-conj,NNP,NNP-NNP,5,1
1709,1662.0,31,brought,2,8,9,1,7,21,-6,7,Singer,Raageshwari,org,,PROPN,PROPN,compound,nsubj,NNP,NNP,2,1
1710,1663.0,19,raised,6,10,14,4,9,4,-4,8,Flintshire,Elfed High School,,org-org-org,PROPN,PROPN-PROPN-PROPN,compound,compound-compound-dobj,NNP,NNP-NNP-NNP,5,1
1711,1664.0,27,said,6,5,6,1,4,20,1,0,Lebanon,Lahoud,,org,PROPN,PROPN,compound,pobj,NNP,NNP,3,1
1712,1665.0,28,met,12,16,25,9,15,2,-4,13,Stanley Teitel,Stuyvesant High School,per-per,--,PROPN-PROPN,PROPN-PROPN-PROPN,compound-pobj,compound-compound-pobj,NNP-NNP,NNP-NNP-NNP,4,1
1713,1666.0,43,is,1,25,26,1,24,16,-24,25,actress,Mischa Barton,org,-,NOUN,PROPN-PROPN,compound,compound-pobj,NN,NNP-NNP,1,1
1714,1667.0,67,continued,1,30,38,8,29,28,-29,37,Second Army,Germans,-,per,PROPN-PROPN,PROPN,compound-pobj,nsubj,NNP-NNP,NNPS,-1,1
1715,1668.0,92,dissolved,5,52,60,8,51,31,-47,55,Marie CURIE,Paris,-,org,PROPN-PROPN,PROPN,compound-compound,pobj,NNP-NNP,NNP,-1,1
1716,1669.0,49,In,0,9,9,0,8,39,-9,9,France,France 5,,org-org,PROPN,PROPN-NUM,appos,nsubj-nummod,NNP,NNP-CD,0,1
1717,1832.0,33,comprises,2,1,1,0,0,31,1,-1,France,France 5,,org-org,PROPN,PROPN-NUM,compound,appos-nummod,NNP,NNP-CD,0,1
1718,1670.0,29,backed,3,17,18,1,16,10,-14,15,Parliament,Nino Burjanadze,per,-,PROPN,PROPN-PROPN,pobj,compound-nsubjpass,NNP,NNP-NNP,2,1
1719,1671.0,22,was,1,16,20,4,15,1,-15,19,Lewis Clark College,Portland,--,per,PROPN-PROPN-PROPN,PROPN,compound-compound-pobj,compound,NNP-NNP-NNP,NNP,4,1
1720,1672.0,28,wrote,2,6,23,17,5,4,-4,21,Los Angeles,Steve Williams,-,per-per,PROPN-PROPN,PROPN-PROPN,compound-compound,compound-conj,NNP-NNP,NNP-NNP,8,1
1721,1673.0,32,is,1,13,13,0,12,18,-12,12,Green,Green Party,,org-org,PROPN,PROPN-PROPN,pobj,nmod-nmod,NNP,NNP-NNP,0,1
1722,1674.0,19,performed,7,12,16,4,11,2,-5,9,University of Windsor,Assumption University,--,per-per,PROPN-ADP-PROPN,PROPN-PROPN,poss-prep-pobj,compound-compound,NNP-IN-NNP,NNP-NNP,3,1
1723,1675.0,45,accepted,34,5,18,13,4,26,29,-16,Greece,Eleftherios Venizelos,,org-org,PROPN,PROPN-PROPN,pobj,compound-appos,NNP,NNP-NNP,3,1
1724,1676.0,42,is,32,1,5,4,0,36,31,-27,Indian Institute of Technology Roorkee,Roorkee,----,per,PROPN-PROPN-ADP-PROPN-PROPN,PROPN,amod-nsubj-prep-pobj-pobj,pobj,NNP-NNP-IN-NNP-NNP,NNP,3,1
1725,1677.0,36,joined,9,12,16,4,11,19,-3,7,de Havilland,1964,-,org,PROPN-PROPN,NUM,compound-compound,pobj,NNP-NNP,CD,5,1
1726,1678.0,38,Headlined,0,26,28,2,25,9,-26,28,HRH,Chulabhorn Walailak,org,-,PROPN,PROPN-PROPN,compound,compound-pobj,NNP,NNP-NNP,1,1
1727,1679.0,44,was,1,10,27,17,9,16,-9,26,Division I,Auburn Tigers,-,org-org,PROPN-PRON,PROPN-PROPN,pobj-compound,compound-conj,NNP-PRP,NNP-NNPS,12,1
1728,1680.0,13,was,5,2,3,1,1,9,3,-2,2006,Houston Dynamo,org,-,NUM,PROPN-PROPN,nummod,compound-compound,CD,NNP-NNP,1,1
1729,1681.0,24,played,3,13,23,10,12,0,-10,20,Shady,Eminem,org,,PROPN,PROPN,compound,pobj,NNP,NNP,3,1
1730,1682.0,18,announced,2,1,17,16,0,0,1,15,CTVglobemedia,MTV,,per,NOUN,PROPN,nsubj,conj,NNS,NNP,8,1
1731,1683.0,27,comprised,4,2,13,11,1,13,2,9,Combatant Clergy Association,Akbar Hashemi Rafsanjani,--,org-org-org,PROPN-PROPN-PROPN,PROPN-PROPN-PROPN,compound-compound-nsubj,compound-compound-dobj,NNP-NNP-NNP,NNP-NNP-NNP,5,1
1732,1684.0,54,abolished,2,39,7,-32,38,46,-37,5,Lucius Cornelius Sulla,Roman Republic,org-org-org,-,PROPN-PROPN-PROPN,PROPN-PROPN,compound-compound-nsubjpass,compound-pobj,NNP-NNP-NNP,NNP-NNP,-1,1
1733,1685.0,19,is,5,2,2,0,1,16,3,-3,Kuwait national cricket team,Kuwait,---,per,PROPN-ADJ-NOUN-NOUN,PROPN,nmod-amod-compound-nsubj,pobj,NNP-JJ-NN-NN,NNP,0,1
1734,1686.0,24,attended,1,3,6,3,2,17,-2,5,Butte College,California,org-org,,PROPN-PROPN,PROPN,compound-dobj,pobj,NNP-NNP,NNP,2,1
1735,1687.0,25,is,4,1,2,1,0,22,3,-2,China CITIC Bank,CITIC Group,org-org-org,-,PROPN-PROPN-PROPN,PROPN-PROPN,compound-compound-compound,compound-appos,NNP-NNP-NNP,NNP-NNP,2,1
1736,1688.0,31,was,2,1,20,19,0,10,1,18,Arman,French,,per,PROPN,PROPN,compound,amod,NNP,NNP,6,1
1737,1689.0,38,favours,2,24,26,2,23,11,-22,24,Collingwood,Ryan Lonie,org,-,PROPN,PROPN-PROPN,poss,compound-conj,NNP,NNP-NNP,4,1
1738,1690.0,27,said,7,10,20,10,9,6,-3,13,Arizona,Grant Woods,,org-org,PROPN,PROPN-PROPN,compound,compound-ROOT,NNP,NNP-NNP,-1,1
1739,1691.0,21,singing,4,1,15,14,0,5,3,11,He,Radiohead,,org,PRON,PROPN,nsubj,nsubj,PRP,NNP,4,1
1740,1692.0,30,declined,1,7,12,5,6,17,-6,11,Tata Motors,Jaguar Land Rover,org-org,--,PROPN-PROPN,PROPN-PROPN-PROPN,compound-nsubj,compound-compound-pobj,NNP-NNPS,NNP-NNP-NNP,4,1
1741,1693.0,42,is,2,12,17,5,11,24,-10,15,American,Bo Diddley,,per-per,ADJ,PROPN-PROPN,amod,compound-nsubj,JJ,NNP-NNP,2,1
1742,1694.0,21,made,4,3,11,8,2,9,1,7,Giant,United States,per,-,PROPN,PROPN-PROPN,compound,compound-pobj,NNP,NNP-NNP,4,1
1743,1695.0,47,was,19,18,23,5,17,23,1,4,Scatman John,musician,org-org,,PROPN-PROPN,NOUN,compound-nsubj,attr,NNP-NNP,NN,8,1
1744,1696.0,21,belonged,12,9,15,6,8,5,3,3,Ween,Dean Ween,org,-,PROPN,PROPN-PROPN,nsubj,compound-poss,NNP,NNP-NNP,7,1
1745,1697.0,23,Press,8,6,14,8,5,8,2,6,Wilfrid Laurier University,Waterloo,--,org,PROPN-PROPN-PROPN,PROPN,compound-compound-compound,compound,NNP-NNP-NNP,NNP,4,1
1746,1698.0,31,renamed,7,9,20,11,8,10,-2,13,T-Mobile,International AG,per,-,PROPN,PROPN-PROPN,compound,compound-pobj,NNP,NNP-NNP,7,1
1747,1699.0,29,have,2,1,24,23,0,4,1,22,Kyrgyzstan,Igor Chudinov,,per-per,PROPN,PROPN-PROPN,nsubj,compound-appos,NNP,NNP-NNP,3,1
1748,1701.0,17,tells,1,1,8,7,0,8,0,7,Qureshi,Pakistan,per,,PROPN,PROPN,nsubj,nsubj,NNP,NNP,2,1
1749,1702.0,20,referred,4,1,2,1,0,17,3,-2,West Negros University,Negros Occidental,org-org-org,-,PROPN-PROPN-PROPN,PROPN-PROPN,compound-compound-nsubj,compound-compound,NNP-NNP-NNP,NNP-NNP,1,1
1750,1703.0,30,is,7,2,16,14,1,13,5,9,Argentine Army,Armed Forces of the Argentine Republic,-,per-per-per-per-per-per,PROPN-PROPN,PROPN-PROPN-ADP-DET-PROPN-PROPN,compound-nsubj,compound-pobj-prep-det-compound-pobj,NNP-NNP,NNP-NNPS-IN-DT-NNP-NNP,4,1
1751,1704.0,21,attended,6,3,8,5,2,12,3,2,Los Angeles,Washington Preparatory High School,per-per,---,PROPN-PROPN,PROPN-PROPN-PROPN-PROPN,compound-compound,compound-compound-compound-dobj,NNP-NNP,NNP-NNP-NNP-NNP,6,1
1752,1705.0,114,were,1,95,9,-86,94,104,-94,8,Jorge Alessandri,Chile,per-per,,PROPN-PROPN,PROPN,compound-appos,pobj,NNP-NNP,NNP,8,1
1753,2797.0,41,was,10,1,16,15,0,24,9,6,Jorge Alessandri,Chile,org-org,,PROPN-PROPN,PROPN,compound-nsubj,pobj,NNP-NNP,NNP,2,1
1754,1706.0,27,said,11,4,18,14,3,8,7,7,France,Suez,,per,PROPN,PROPN,compound,pobj,NNP,NNP,4,1
1755,1707.0,24,begins,16,11,14,3,10,9,5,-2,Vietnam,Ho Chi Minh,per,--,PROPN,PROPN-PROPN-PROPN,pobj,compound-compound-pobj,NNP,NNP-NNP-NNP,3,1
1756,2805.0,53,At,0,25,31,6,24,21,-25,31,Vietnam,Ho Chi Minh,,org-org-org,PROPN,PROPN-PROPN-PROPN,pobj,compound-compound-pobj,NNP,NNP-NNP-NNP,4,1
1757,1708.0,42,is,7,17,36,19,16,5,-10,29,Metro Vancouver,TransLink,-,org,PROPN-PROPN,PROPN,compound-pobj,advcl,NNP-NNP,NNP,13,1
1758,1709.0,24,owned,3,8,15,7,7,8,-5,12,Doordarshan,Broadcasting,,per,PROPN,PROPN,pobj,compound,NNP,NNP,3,1
1759,1710.0,70,remarked,31,20,22,2,19,47,11,-9,Collingwood,Dick Lee,org,-,PROPN,PROPN-PROPN,compound,compound-nsubj,NNP,NNP-NNP,1,1
1760,1711.0,28,had,1,1,27,26,0,0,0,26,Smith,Chicago,per,,PROPN,PROPN,nsubj,pobj,NNP,NNP,2,1
1761,1712.0,46,was,11,35,44,9,34,1,-24,33,Yawovi Agboyibo,CAR,org-org,,PROPN-PROPN,PROPN,compound-ROOT,appos,NNPS-NNP,NNP,5,1
1762,1713.0,57,appear,5,31,35,4,30,21,-26,30,Miho Hatori,Cibo Matto,-,org-org,PROPN-PROPN,PROPN-PROPN,compound-ROOT,compound-pobj,NNP-NNP,NNP-NNP,2,1
1763,1714.0,19,represented,6,4,3,-1,3,15,2,-3,Seahawks,Wagner College,,org-org,PROPN,PROPN-PROPN,compound,compound-dobj,NNPS,NNP-NNP,2,1
1764,1715.0,19,formed,2,6,12,6,5,6,-4,10,New York,Teddy Riley,per-per,-,PROPN-PROPN,PROPN-PROPN,compound-pobj,compound-compound,NNP-NNP,NNP-NNP,5,1
1765,1716.0,43,earned,1,8,8,0,7,34,-7,7,Germany national football team,Germany,org-org-org-org,,PROPN-ADJ-NOUN-NOUN,PROPN,nmod-amod-compound-pobj,pobj,NNP-JJ-NN-NN,NNP,0,1
1766,1717.0,32,established,11,4,27,23,3,4,7,16,University Schools of Studies,Guru Gobind Singh Indraprastha University,---,per-per-per-per-per,PROPN-PROPN-ADP-PROPN,PROPN-PROPN-PROPN-PROPN-PROPN,compound-pobj-prep-pobj,compound-compound-compound-compound-pobj,NNP-NNPS-IN-NNPS,NNP-NNP-NNP-NNP-NNP,9,1
1767,1947.0,32,Founded,0,4,27,23,3,4,-4,27,University Schools of Studies,Guru Gobind Singh Indraprastha University,org-org-org-org,----,PROPN-PROPN-ADP-PROPN,PROPN-PROPN-PROPN-PROPN-PROPN,compound-pobj-prep-pobj,compound-compound-compound-compound-pobj,NNP-NNPS-IN-NNPS,NNP-NNP-NNP-NNP-NNP,8,1
1768,1718.0,40,continue,16,5,13,8,4,26,11,-3,National Association of Professional Base Ball Players,Boston Red Stockings,------,org-org-org,PROPN-PROPN-ADP-PROPN-PROPN-PROPN-PROPN,PROPN-PROPN-PROPN,compound-pobj-prep-compound-compound-compound-pobj,compound-compound-nsubj,NNP-NNP-IN-NNP-NNP-NNP-NNP,NNP-NNP-NNPS,4,1
1769,1719.0,47,set,7,29,44,15,28,2,-22,37,Pakistan,Liaquat Ali Khan,,org-org-org,PROPN,PROPN-PROPN-PROPN,compound,compound-compound-pobj,NNP,NNP-NNP-NNP,-1,1
1770,1726.0,46,issued,8,1,6,5,0,39,7,-2,Pakistan,Liaquat Ali Khan,org,--,PROPN,PROPN-PROPN-PROPN,poss,compound-compound-appos,NNP,NNP-NNP-NNP,4,1
1771,1720.0,15,is,8,1,12,11,0,2,7,4,Harel Skaat,singer,-,per,PROPN-PROPN,NOUN,compound-nsubj,attr,NNP-NNP,NN,3,1
1772,1721.0,53,Released,0,24,14,-10,23,38,-24,14,United Kingdom,The Human League,per-per,--,PROPN-PROPN,DET-PROPN-PROPN,compound-pobj,det-compound-compound,NNP-NNP,DT-NNP-NNP,4,1
1773,1722.0,41,signed,13,13,38,25,12,2,0,25,HBC,The Bay,per,-,PROPN,DET-PROPN,nsubj,det-compound,NNP,DT-NNP,14,1
1774,1723.0,25,operates,10,7,24,17,6,0,3,14,Massachusetts,Cape,per,,PROPN,PROPN,compound,pobj,NNP,NNP,7,1
1775,1724.0,13,is,2,4,11,7,3,1,-2,9,Sadiq al-Mahdi,Umma Party,-,org-org,PROPN-NUM,PROPN-PROPN,compound-compound,compound-pobj,NNP-CD,NNP-NNP,5,1
1776,1725.0,8,grew,2,1,6,5,0,1,1,4,Kat Goldman,Toronto,-,per,PROPN-PROPN,PROPN,compound-nsubj,compound,NNP-NNP,NNP,3,1
1777,1727.0,23,has,15,1,1,0,0,21,14,-14,Reed Business Information,Reed Elsevier,--,org-org,PROPN-PROPN-PROPN,PROPN-PROPN,compound-compound-nsubj,compound-compound,NNP-NNP-NNP,NNP-NNP,0,1
1778,1728.0,14,released,1,1,12,11,0,1,0,11,He,Shady,org,,PRON,PROPN,nsubj,compound,PRP,NNP,5,1
1779,1729.0,57,entered,9,5,6,1,4,50,4,-3,African Methodist Episcopal Zion Church,Methodist,----,per,PROPN-PROPN-PROPN-PROPN-PROPN,PROPN,compound-compound-compound-compound-nsubj,nmod,NNP-NNP-NNP-NNP-NNP,NNP,1,1
1780,1730.0,38,played,12,16,1,-15,15,36,-4,-11,Netherlands,Van Basten,per,-,PROPN,PROPN-PROPN,pobj,compound-nsubj,NNP,NNP-NNP,3,1
1781,1731.0,19,is,2,17,18,1,16,0,-15,16,Optimus,S.A.,,per,PROPN,PROPN,compound,appos,NNP,NNP,6,1
1782,1732.0,28,is,12,1,19,18,0,8,11,7,Dick Dale,guitarist,-,org,PROPN-PROPN,NOUN,compound-nsubj,attr,NNP-NNP,NN,3,1
1783,1733.0,35,filed,6,22,34,12,21,0,-16,28,United Farm Workers,UFW,org-org-org,,PROPN-PROPN-PROPN,PROPN,compound-compound-pobj,pobj,NNP-NNP-NNPS,NNP,8,1
1784,1734.0,42,stopped,5,1,5,4,0,36,4,0,Japan,Hirohito,per,,PROPN,PROPN,poss,nsubj,NNP,NNP,3,1
1785,1735.0,31,looked,10,3,10,7,2,20,7,0,Norfolk and Norwich University Hospital,England,per-per-per-per-per,,PROPN-CCONJ-PROPN-PROPN-PROPN,PROPN,pobj-cc-compound-compound-conj,pobj,NNP-CC-NNP-NNP-NNP,NNP,4,1
1786,1736.0,31,On,0,10,13,3,9,17,-10,13,Division,6th Infantry Division,,per-per-per,PROPN,PROPN-PROPN-PROPN,pobj,compound-compound-nsubjpass,NNP,NNP-NNP-NNP,2,1
1787,1738.0,63,refused,24,10,16,6,9,46,14,-8,Stewart,Alberta,per,,PROPN,PROPN,nsubj,poss,NNP,NNP,9,1
1788,2213.0,32,considering,4,7,27,20,6,4,-3,23,Stewart,Alberta,per,,PROPN,PROPN,dobj,compound,NNP,NNP,7,1
1789,1739.0,34,Inspired,0,6,25,19,5,8,-6,25,Ludwig Boltzmann,University of Vienna,-,org-org-org,PROPN-PROPN,PROPN-ADP-PROPN,compound-compound,pobj-prep-pobj,NNP-NNP,NNP-IN-NNP,9,1
1790,1740.0,33,named,9,20,28,8,19,4,-11,19,Space,Netherlands,,per,PROPN,PROPN,conj,pobj,NNP,NNP,7,1
1791,1741.0,27,followed,6,14,26,12,13,0,-8,20,Miguel de Legazpi,Philippines,org-org-org,,PROPN-PROPN-PROPN,PROPN,compound-compound-pobj,dobj,NNP-NNP-NNP,NNPS,7,1
1792,2327.0,42,arrived,8,6,12,6,5,29,2,4,Miguel de Legazpi,Philippines,--,per,PROPN-PROPN-PROPN,PROPN,compound-compound-nsubj,pobj,NNP-NNP-NNP,NNP,3,1
1793,1742.0,17,recorded,4,2,3,1,1,13,2,-1,singer,Wilson Pickett,per,-,NOUN,PROPN-PROPN,compound,compound-nsubj,NN,NNP-NNP,1,1
1794,1743.0,40,Sessions,3,3,1,-2,2,38,0,-2,Jeff Sessions,Alabama,org-org,,PROPN-PROPN,PROPN,compound-ROOT,compound,NNP-NNPS,NNP,2,1
1795,1744.0,42,created,16,8,14,6,7,27,8,-2,Italy,Democratic Party,,per-per,PROPN,PROPN-PROPN,poss,compound-nsubjpass,NNP,NNP-NNP,6,1
1796,1745.0,30,remained,11,2,18,16,1,11,9,7,she,Finland,org,,PRON,PROPN,nsubj,pobj,PRP,NNP,4,1
1797,1746.0,21,ran,4,3,11,8,2,9,1,7,Domenici,Albuquerque,org,,PROPN,PROPN,nsubj,compound,NNP,NNP,6,1
1798,1747.0,68,established,51,15,24,9,14,43,36,-27,Movement for the Social Evolution of Black Africa,MESAN,org-org-org-org-org-org-org-org,,NOUN-ADP-DET-PROPN-PROPN-ADP-PROPN-PROPN,PROPN,appos-prep-det-compound-pobj-prep-compound-pobj,conj,NN-IN-DT-NNP-NNP-IN-NNP-NNP,NNP,2,1
1799,1748.0,53,cymbals,18,41,42,1,40,10,-23,24,guitarist,Snooks Eaglin,per,-,NOUN,PROPN-PROPN,compound,compound-conj,NN,NNP-NNP,1,1
1800,1749.0,55,consulted,5,35,36,1,34,18,-30,31,Bulgaria,Sergey Stanishev,per,-,PROPN,PROPN-PROPN,pobj,compound-compound,NNP,NNP-NNP,4,1
1801,2886.0,36,is,1,8,27,19,7,8,-7,26,Bulgaria,Sergey Stanishev,per,-,PROPN,PROPN-PROPN,nsubj,compound-nsubj,NNP,NNP-NNP,-1,1
1802,1750.0,16,was,1,7,14,7,6,1,-6,13,Elisabeth of Bavaria,Austria,org-org-org,,PROPN-ADP-PROPN,PROPN,pobj-prep-pobj,pobj,NNP-IN-NNP,NNP,5,1
1803,1751.0,20,is,2,1,17,16,0,2,1,15,Jarrah,John Butler,per,-,PROPN,PROPN-PROPN,compound,compound-compound,NNP,NNP-NNP,8,1
1804,1752.0,28,continued,3,2,25,23,1,2,1,22,university,Melbourne,,per,NOUN,PROPN,nsubj,compound,NN,NNP,10,1
1805,1753.0,38,presented,13,8,11,3,7,26,5,-2,Professor,Oulu,per,,PROPN,PROPN,compound,compound,NNP,NNP,1,1
1806,1754.0,25,is,4,1,1,0,0,23,3,-3,Dongfeng,Dongfeng Motor Corporation,,org-org-org,PROPN,PROPN-PROPN-PROPN,compound,compound-compound-pobj,NNP,NNP-NNP-NNP,0,1
1807,1755.0,40,arose,30,33,38,5,32,1,-3,8,Rugby,James Morrison,per,-,PROPN,PROPN-PROPN,pobj,compound-nsubj,NNP,NNP-NNP,3,1
1808,1756.0,18,named,13,1,11,10,0,6,12,-2,James J. Braddock,New Jersey,per-per-per,-,PROPN-PROPN-PROPN,PROPN-PROPN,compound-compound-compound,compound-pobj,NNP-NNP-NNP,NNP-NNP,3,1
1809,1757.0,27,hopes,8,1,1,0,0,25,7,-7,China,China Film Group,,org-org-org,PROPN,PROPN-PROPN-PROPN,poss,compound-compound-nsubj,NNP,NNP-NNP-NNP,0,1
1810,1758.0,38,is,1,6,17,11,5,20,-5,16,John Jay College of Criminal Justice,New York,-----,per-per,PROPN-PROPN-PROPN-ADP-PROPN-PROPN,PROPN-PROPN,compound-compound-pobj-prep-compound-pobj,compound-compound,NNP-NNP-NNP-IN-NNP-NNP,NNP-NNP,7,1
1811,1759.0,25,referred,3,2,23,21,1,1,1,20,University of Western Ontario,London,---,per,PROPN-ADP-PROPN-PROPN,PROPN,pobj-prep-compound-pobj,compound,NNP-IN-NNP-NNP,NNP,11,1
1812,1760.0,46,visiting,3,5,16,11,4,29,-2,13,Laos,Bouasone Bouphavanh,per,-,PROPN,PROPN-PROPN,dobj,compound-nsubjpass,NNP,NNP-NNP,6,1
1813,1761.0,17,represents,6,5,11,6,4,5,1,5,Sub Pop,No Age,-,per-per,PROPN-PROPN,DET-NOUN,compound-pobj,det-nsubj,NNP-NNP,DT-NN,9,1
1814,1762.0,22,represented,7,3,10,7,2,11,4,3,California Golden Bears,University of California,org-org-org,--,PROPN-PROPN-PROPN,PROPN-ADP-PROPN,compound-compound-compound,nmod-prep-pobj,NNP-NNP-NNP,NNP-IN-NNP,5,1
1815,1763.0,35,became,1,7,8,1,6,26,-6,7,NBC,Red Network,per,-,PROPN,PROPN-PROPN,compound,compound-pobj,NNP,NNP-NNP,1,1
1816,2872.0,43,moved,6,10,11,1,9,31,-4,5,NBC,Red Network,org,-,PROPN,PROPN-PROPN,compound,compound-pobj,NNP,NNP-NNP,1,1
1817,1764.0,11,worked,3,1,7,6,0,3,2,4,Caspar Weinberger,San Francisco,-,org-org,PROPN-PROPN,PROPN-PROPN,compound-nsubj,compound-compound,NNP-NNP,NNP-NNP,4,1
1818,1765.0,36,moved,3,8,10,2,7,25,-5,7,Sydney,he,,per,PROPN,PRON,pobj,nsubj,NNP,PRP,2,1
1819,1766.0,20,is,8,12,16,4,11,3,-4,8,University of West Georgia,Carrollton,per-per-per-per,,PROPN-ADP-PROPN-PROPN,PROPN,pobj-prep-pobj-compound,compound,NNP-IN-NNP-NNP,NNP,3,1
1820,1767.0,34,Clark,8,2,3,1,1,30,6,-5,Leader,Stockwell Day,,org-org,PROPN,PROPN-PROPN,compound,compound-compound,NNP,NNP-NNP,1,1
1821,1768.0,25,arrested,8,7,24,17,6,0,1,16,federal police,Belgium,org-org,,ADJ-NOUN,PROPN,amod-nsubj,pobj,JJ-NNS,NNP,2,1
1822,1769.0,28,is,4,1,25,24,0,2,3,21,His,Pennsylvania,org,,DET,PROPN,poss,compound,PRP$,NNP,6,1
1823,1770.0,20,is,4,1,1,0,0,18,3,-3,Shanghai Airlines,Shanghai,-,per,PROPN-PROPN,PROPN,compound-nsubj,compound,NNP-NNPS,NNP,0,1
1824,1771.0,38,include,4,9,14,5,8,23,-5,10,QC,John Thaw,,per-per,PROPN,PROPN-PROPN,dobj,compound-parataxis,NNP,NNP-NNP,3,1
1825,1772.0,31,based,25,2,28,26,1,2,23,3,Robert Wood Johnson Foundation,Princeton,---,org,PROPN-PROPN-PROPN-PROPN,PROPN,compound-compound-compound-nsubj,compound,NNP-NNP-NNP-NNP,NNP,6,1
1826,1773.0,22,give,3,5,19,14,4,2,-2,16,Notre Dame,Norfolk,org-org,,PROPN-PROPN,PROPN,compound-dative,compound,NNP-NNP,NNP,6,1
1827,1774.0,44,deployed,9,6,23,17,5,20,3,14,Commando,42 Commando,per,-,PROPN,NUM-PROPN,compound,nummod-compound,NNP,CD-NNP,8,1
1828,1775.0,27,is,8,1,18,17,0,8,7,10,Ray Wilson,Hawthorn,-,per,PROPN-PROPN,PROPN,compound-nsubj,pobj,NNP-NNP,NNP,4,1
1829,1776.0,37,defeated,26,6,35,29,5,1,20,9,Australia,Mark Latham,org,-,PROPN,PROPN-PROPN,pobj,compound-pobj,NNP,NNP-NNP,4,1
1830,1777.0,34,found,15,7,14,7,6,19,8,-1,Shahid Beheshti University of Medical Sciences,Tehran,-----,per,PROPN-PROPN-PROPN-ADP-PROPN-PROPN,PROPN,compound-compound-pobj-prep-compound-pobj,pobj,NNP-NNP-NNP-IN-NNP-NNPS,NNP,6,1
1831,1778.0,25,founded,2,1,6,5,0,18,1,4,Safeco,Washington,org,,PROPN,PROPN,nsubjpass,pobj,NNP,NNP,2,1
1832,1779.0,44,quoted,40,35,38,3,34,5,5,-2,Iceland,Geir Haarde,per,-,PROPN,PROPN-PROPN,compound,compound-nsubjpass,NNP,NNP-NNP,2,1
1833,1780.0,33,sent,11,9,10,1,8,22,2,-1,Defense,Frank Carlucci,org,-,PROPN,PROPN-PROPN,pobj,compound-nsubj,NNP,NNP-NNP,1,1
1834,1781.0,50,reporting,4,12,17,5,11,32,-8,13,Aubrey O'Day,Danity Kane,-,per-per,PROPN-PROPN,PROPN-PROPN,compound-pobj,compound-nsubj,NNP-NNP,NNP-NNP,3,1
1835,1782.0,21,attended,1,3,7,4,2,13,-2,6,King College,Tennessee,org-org,,PROPN-PROPN,PROPN,compound-dobj,pobj,NNP-NNP,NNP,2,1
1836,1784.0,28,said,7,16,23,7,15,4,-9,16,Pakistan,Liaquat,org,,PROPN,PROPN,nsubj,appos,NNP,NNP,3,1
1837,1785.0,13,switched,9,7,9,2,6,3,2,0,Verve,Montgomery,per,,PROPN,PROPN,conj,pobj,NNP,NNP,6,1
1838,1786.0,23,was,10,1,17,16,0,5,9,7,Alan Browning,actor,-,per,PROPN-PROPN,NOUN,compound-nsubj,attr,NNP-NNP,NN,3,1
1839,1787.0,29,planned,3,1,20,19,0,8,2,17,He,Kentucky,org,,PRON,PROPN,nsubj,pobj,PRP,NNP,3,1
1840,1788.0,31,established,3,1,6,5,0,24,2,3,Retro Jams,December 2007,per-per,-,PROPN-PROPN,PROPN-NUM,compound-nsubjpass,pobj-nummod,NNP-NNP,NNP-CD,4,1
1841,1789.0,31,said,11,1,8,7,0,22,10,-3,Jeremy Dear,National Union of Journalists,-,per-per-per-per,PROPN-PROPN,PROPN-PROPN-ADP-PROPN,compound-nmod,compound-pobj-prep-pobj,NNP-NNP,NNP-NNP-IN-NNPS,4,1
1842,1790.0,21,released,2,5,11,6,4,9,-3,9,Corinthian,Stafford,,per,PROPN,PROPN,compound,pobj,NNP,NNP,5,1
1843,1791.0,32,is,20,13,18,5,12,13,7,-2,Bulgaria,Gloria,per,,PROPN,PROPN,pobj,pobj,NNP,NNP,6,1
1844,1792.0,21,born,2,6,16,10,5,4,-4,14,Illinois,University of Illinois at Chicago,org,----,PROPN,PROPN-ADP-PROPN-ADP-PROPN,pobj,pobj-prep-pobj-prep-pobj,NNP,NNP-IN-NNP-IN-NNP,5,1
1845,1793.0,29,founded,3,1,9,8,0,19,2,6,Duquesne University,Pittsburgh,per-per,,PROPN-PROPN,PROPN,compound-nsubjpass,compound,NNP-NNP,NNP,4,1
1846,1794.0,18,owned,4,12,12,0,11,5,-8,8,United Biscuits,United Kingdom,-,per-per,PROPN-PROPN,PROPN-PROPN,compound-conj,compound-pobj,NNP-NNP,NNP-NNP,0,1
1847,1795.0,28,Established,0,3,9,6,2,18,-3,9,1888,Siriraj Hospital,,per-per,NUM,PROPN-PROPN,pobj,compound-pobj,CD,NNP-NNP,3,1
1848,1796.0,17,formed,8,4,7,3,3,9,4,-1,1932,Progressive Party,per,-,NUM,PROPN-PROPN,nummod,compound-nsubj,CD,NNP-NNP,4,1
1849,1797.0,27,approved,8,5,10,5,4,16,3,2,Windsor,Masse,per,,PROPN,PROPN,compound,poss,NNP,NNP,5,1
1850,1798.0,44,born,2,19,40,21,18,3,-17,38,Italy,Giuseppe Zanardelli,org,-,PROPN,PROPN-PROPN,pobj,compound-poss,NNP,NNP-NNP,11,1
1851,1799.0,20,represented,6,4,9,5,3,10,2,3,Wildcats,University of Arizona,,org-org-org,PROPN,PROPN-ADP-PROPN,compound,dobj-prep-pobj,NNP,NNP-IN-NNP,4,1
1852,1800.0,27,re-elected,2,1,11,10,0,15,1,9,Craitor,Niagara Falls,,per-per,PROPN,PROPN-PROPN,nsubjpass,compound-pobj,NNP,NNP-NNP,6,1
1853,1801.0,64,set,9,5,21,16,4,42,4,12,England,Billy J. Kramer,,per-per-per,PROPN,PROPN-PROPN-PROPN,pobj,compound-compound-pobj,NNP,NNP-NNP-NNP,8,1
1854,1802.0,37,signed,3,3,6,3,2,30,0,3,Novembre,Peaceville Records,,org-org,PROPN,PROPN-PROPN,nsubj,compound-pobj,NNP,NNP-NNPS,2,1
1855,1803.0,18,worked,2,5,16,11,4,1,-3,14,Nast Publications,Vogue,org-org,,PROPN-PROPN,PROPN,compound-pobj,compound,NNP-NNP,NNP,8,1
1856,1804.0,19,is,3,2,18,16,1,0,1,15,Godolphin School,1726,org-org,,PROPN-PROPN,NUM,compound-nsubj,pobj,NNP-NNP,CD,2,1
1857,1805.0,60,List,0,35,54,19,34,5,-35,54,MASkargo,Kuala Lumpur,,org-org,NOUN,PROPN-PROPN,nmod,compound-compound,NN,NNP-NNP,8,1
1858,1806.0,44,broke,10,24,28,4,23,15,-14,18,Sierra Leone,Foday Sankoh,-,org-org,PROPN-PROPN,PROPN-PROPN,compound-compound,compound-appos,NNP-NNP,NNP-NNP,1,1
1859,1807.0,44,With,0,10,14,4,9,29,-10,14,United States,Manhattan Project,-,org-org,PROPN-PROPN,PROPN-PROPN,compound-pobj,compound-pobj,NNP-NNP,NNP-NNP,6,1
1860,1808.0,34,born,7,12,19,7,11,14,-5,12,he,Nepal,,per,PRON,PROPN,nsubjpass,pobj,PRP,NNP,5,1
1861,1809.0,59,is,14,39,42,3,38,16,-25,28,Myawaddy TV,Myanmar,-,org,PROPN-PROPN,PROPN,compound-pobj,pobj,NNP-NNP,NNP,4,1
1862,1810.0,29,held,10,13,14,1,12,14,-3,4,CBS,Television Distribution,per,-,PROPN,PROPN-PROPN,compound,compound-pobj,NNP,NNP-NNP,2,1
1863,1811.0,19,said,17,6,14,8,5,4,11,-3,Peng Liyuan,Xi Jinping,-,per-per,PROPN-PROPN,PROPN-PROPN,compound-nsubj,compound-pobj,NNP-NNP,NNP-NNP,3,1
1864,1812.0,48,Campbell,1,1,19,18,0,28,0,18,Kim Campbell,Canada,per-per,,PROPN-PROPN,PROPN,compound-ROOT,conj,NNP-NNP,NNP,3,1
1865,1813.0,29,set,3,11,27,16,10,1,-8,24,Russian,Mikhail Korniyenko,,org-org,ADJ,PROPN-PROPN,amod,compound-conj,JJ,NNP-NNP,9,1
1866,1814.0,14,branded,3,8,11,3,7,2,-5,8,Tallaght,ITT,org,,PROPN,PROPN,compound,compound,NNP,NNP,1,1
1867,1815.0,19,was,3,1,11,10,0,7,2,8,The Virginia Informer,College of William and Mary,--,org-org-org-org-org,DET-PROPN-PROPN,PROPN-ADP-PROPN-CCONJ-PROPN,det-compound-nsubj,pobj-prep-pobj-cc-conj,DT-NNP-NNP,NNP-IN-NNP-CC-NNP,6,1
1868,1816.0,42,began,7,6,7,1,5,34,1,0,Lebanon,she,,per,PROPN,PRON,pobj,nsubj,NNP,PRP,1,1
1869,1817.0,34,founded,12,3,16,13,2,17,9,4,Texas,University of Texas at San Antonio,,org-org-org-org-org-org,PROPN,PROPN-ADP-PROPN-ADP-PROPN-PROPN,compound,pobj-prep-pobj-prep-compound-pobj,NNP,NNP-IN-NNP-IN-NNP-NNP,4,1
1870,1818.0,53,returned,10,5,20,15,4,32,5,10,Santa Margarita Catholic High School,California,per-per-per-per-per,,PROPN-PROPN-PROPN-PROPN-PROPN,PROPN,compound-compound-compound-compound-compound,dobj,NNP-NNP-NNP-NNP-NNP,NNP,5,1
1871,1819.0,21,said,19,10,13,3,9,7,9,-6,Hosni Mubarak,Egypt,org-org,,PROPN-PROPN,PROPN,compound-dobj,pobj,NNP-NNP,NNP,3,1
1872,1820.0,29,faced,5,14,18,4,13,10,-9,13,Richard Hake,Constitution Party of Oregon,org-org,---,PROPN-PROPN,PROPN-PROPN-ADP-PROPN,compound-dobj,compound-pobj-prep-pobj,NNP-NNP,NNP-NNP-IN-NNP,2,1
1873,1821.0,11,was,1,6,8,2,5,2,-5,7,Bayer,Leverkusen,,per,PROPN,PROPN,compound,compound,NNP,NNP,3,1
1874,1822.0,12,produced,3,6,10,4,5,1,-3,7,George Harrison,Handmade Films,per-per,-,PROPN-PROPN,PROPN-PROPN,compound-poss,compound-appos,NNP-NNP,NNP-NNPS,2,1
1875,1823.0,47,Founded,0,6,16,10,5,30,-6,16,Kwok Tak Seng,Co.,--,per,PROPN-PROPN-PROPN,PROPN,compound-compound-pobj,compound,NNP-NNP-NNP,NNP,-1,1
1876,1824.0,29,said,14,2,9,7,1,19,12,-5,Southern Catholic College,Dawsonville,--,org,PROPN-PROPN-PROPN,PROPN,compound-compound-compound,compound,NNP-NNP-NNP,NNP,5,1
1877,1825.0,15,became,1,9,14,5,8,0,-8,13,Immature,IMx,,org,PROPN,NOUN,appos,pobj,NNP,NNS,5,1
1878,1826.0,33,Due,0,6,13,7,5,19,-6,13,Park Jin Young,JYP Entertainment,--,per-per,PROPN-PROPN-PROPN,PROPN-PROPN,compound-compound-pobj,compound-pobj,NNP-NNP-NNP,NNP-NNP,2,1
1879,1827.0,22,Grow,1,4,12,8,3,9,-3,11,Venezuela,Hugo Chavez,,org-org,PROPN,PROPN-PROPN,compound,compound-nsubj,NNP,NNP-NNP,6,1
1880,1828.0,80,Publisher,0,74,78,4,73,1,-74,78,Appeal-Democrat,Freedom Communications,org,-,NOUN,PROPN-PROPN,nsubjpass,compound-pobj,NN,NNP-NNPS,3,1
1881,1829.0,18,was,10,6,16,10,5,1,4,6,Henry,Anne Boleyn,per,-,PROPN,PROPN-PROPN,compound,compound-appos,NNP,NNP-NNP,4,1
1882,1830.0,36,composed,2,1,14,13,0,21,1,12,It,Daniel Ortega,,org-org,PRON,PROPN-PROPN,nsubjpass,compound-appos,PRP,NNP-NNP,6,1
1883,1831.0,12,Co-founder,5,3,9,6,2,2,2,4,Al-Quds University Gaza,Group,--,org,PROPN-PROPN-PROPN,PROPN,compound-compound-compound,pobj,NNP-NNP-NNP,NNP,-1,1
1884,1833.0,46,was,1,1,24,23,0,21,0,23,Nano,Albania,,org,PROPN,PROPN,nsubj,pobj,NNP,NNP,3,1
1885,1834.0,30,said,16,23,27,4,22,2,-7,11,Mercer,Marsh McLennan,org,-,PROPN,PROPN-PROPN,pobj,compound-compound,NNP,NNP-NNP,5,1
1886,1835.0,18,appealed,6,1,3,2,0,14,5,-3,Seychelles,James Michel,,per-per,PROPN,PROPN-PROPN,compound,compound-nsubj,NNP,NNP-NNP,1,1
1887,1836.0,34,Counsel,22,12,15,3,11,18,10,-7,Internal Revenue Service,Dallas District Counsel,--,org-org-org,PROPN-PROPN-PROPN,PROPN-PROPN-PROPN,compound-compound-compound,compound-compound-pobj,NNP-NNP-NNP,NNP-NNP-NNP,3,1
1888,1837.0,38,was,1,7,11,4,6,26,-6,10,Glenville High School,Cleveland,--,per,PROPN-PROPN-PROPN,PROPN,compound-compound-pobj,compound,NNP-NNP-NNP,NNP,2,1
1889,1838.0,19,was,3,1,16,15,0,2,2,13,His,University of Zagreb,per,--,DET,PROPN-ADP-PROPN,poss,pobj-prep-pobj,PRP$,NNP-IN-NNP,4,1
1890,1839.0,33,was,1,17,21,4,16,11,-16,20,Paine College,GA,-,per,PROPN-PROPN,PROPN,compound-pobj,pobj,NNP-NNP,NNP,2,1
1891,1840.0,19,says,6,5,16,11,4,2,1,10,Mirek Topolanek,Civic Democratic Party,per-per,--,PROPN-PROPN,PROPN-PROPN-PROPN,compound-nsubj,compound-compound-pobj,NNP-NNP,NNP-NNP-NNP,7,1
1892,1841.0,56,founded,26,2,5,3,1,50,24,-21,National University of Trujillo,Trujillo,---,org,PROPN-PROPN-ADP-PROPN,PROPN,compound-nsubj-prep-pobj,compound,NNP-NNP-IN-NNP,NNP,1,1
1893,1842.0,30,closed,4,4,14,10,3,15,0,10,Navteq,Nokia,,org,PROPN,PROPN,nsubj,pobj,NNP,NNP,2,1
1894,1843.0,30,acquired,5,5,8,3,4,21,0,3,ABC,Blue Network,per,-,PROPN,PROPN-PROPN,nsubj,compound-dobj,NNP,NNP-NNP,1,1
1895,1844.0,23,credited,9,4,17,13,3,5,5,8,Correa,Ecuador,per,,PROPN,PROPN,nsubjpass,poss,NNP,NNP,8,1
1896,2421.0,17,became,3,3,9,6,2,7,0,6,Correa,Ecuador,,per,PROPN,PROPN,nsubj,pobj,NNP,NNP,3,1
1897,1845.0,24,is,2,1,10,9,0,13,1,8,Parkland College,Illinois,-,per,PROPN-PROPN,PROPN,compound-nsubj,compound,NNP-NNP,NNP,5,1
1898,1846.0,20,began,1,1,8,7,0,11,0,7,Shahn,artist,org,,PROPN,NOUN,nsubj,attr,NNP,NN,4,1
1899,1847.0,15,is,5,3,14,11,2,0,2,9,Dunbar High School,Dayton,org-org-org,,PROPN-PROPN-PROPN,PROPN,compound-compound-nsubj,pobj,NNP-NNP-NNP,NNP,4,1
1900,1848.0,21,became,3,3,9,6,2,11,0,6,Smith,Connecticut,per,,PROPN,PROPN,nsubj,compound,NNP,NNP,3,1
1901,1849.0,55,introduced,3,39,43,4,38,11,-36,40,Carville,Governor,org,,PROPN,PROPN,nsubj,compound,NNP,NNP,7,1
1902,1850.0,34,collaborated,10,3,7,4,2,26,7,-3,Japan,Yoshiki,,org,PROPN,PROPN,poss,dobj,NNP,NNP,4,1
1903,1851.0,27,visited,4,9,14,5,8,12,-5,10,Telstra,Australia,org,,PROPN,PROPN,pobj,pobj,NNP,NNP,3,1
1904,1852.0,27,dedication,1,12,24,12,11,2,-11,23,Ohio,William Howard Taft,,org-org-org,PROPN,PROPN-PROPN-PROPN,compound,compound-compound-pobj,NNP,NNP-NNP-NNP,6,1
1905,1853.0,51,remembered,1,29,30,1,28,20,-28,29,Navy,Abel P. Upshur,org,--,PROPN,PROPN-PROPN-PROPN,compound,compound-compound-pobj,NNP,NNP-NNP-NNP,2,1
1906,1854.0,27,signed,4,7,10,3,6,16,-3,6,Mushroom Records,Freud,per-per,,PROPN-PROPN,PROPN,compound-pobj,conj,NNP-NNPS,NNP,3,1
1907,1855.0,22,been,6,1,15,14,0,6,5,9,Pianist,Bill Evans,org,-,PROPN,PROPN-PROPN,compound,compound-dobj,NNP,NNP-NNP,7,1
1908,1856.0,26,represented,14,3,17,14,2,8,11,3,Alabama Crimson Tide,University of Alabama,--,org-org-org,PROPN-PROPN-PROPN,PROPN-ADP-PROPN,compound-compound-compound,dobj-prep-pobj,NNP-NNP-NNP,NNP-IN-NNP,5,1
1909,1857.0,32,written,6,22,18,-4,21,13,-16,12,Detroit,The Nice Device,per,--,PROPN,DET-PROPN-PROPN,poss,det-compound-appos,NNP,DT-NNP-NNP,5,1
1910,1858.0,26,began,1,13,22,9,12,3,-12,21,Boyzone,Stephen Gately,per,-,PROPN,PROPN-PROPN,pobj,compound-conj,NNP,NNP-NNP,6,1
1911,1859.0,29,came,8,13,14,1,12,14,-5,6,Sabah,Musa,per,,PROPN,PROPN,compound,pobj,NNP,NNP,5,1
1912,1860.0,18,returned,5,3,8,5,2,9,2,3,Ward,Shrewsbury,per,,PROPN,PROPN,nsubj,pobj,NNP,NNP,2,1
1913,1861.0,36,reads,1,9,17,8,8,18,-8,16,John Hancock,Boston,-,per,PROPN-PROPN,PROPN,compound-pobj,pobj,NNP-NNP,NNP,3,1
1914,1862.0,30,signed,1,1,7,6,0,22,0,6,Randell,CBS,org,,PROPN,PROPN,nsubj,compound,NNP,NNP,3,1
1915,1863.0,31,Inspired,0,22,28,6,21,2,-22,28,William E. Macaulay Honors College,CUNY,----,per,PROPN-PROPN-PROPN-PROPN-PROPN,PROPN,compound-compound-compound-compound-pobj,pobj,NNP-NNP-NNP-NNPS-NNP,NNP,4,1
1916,1864.0,14,opposed,5,4,11,7,3,2,1,6,Clinton,United States,,per-per,PROPN,PROPN-PROPN,nsubj,compound-compound,NNP,NNP-NNP,5,1
1917,1865.0,19,merged,13,1,2,1,0,16,12,-11,Cardiff University,University of Wales,-,per-per-per,PROPN-PROPN,PROPN-ADP-PROPN,compound-nsubj,nmod-prep-pobj,NNP-NNP,NNP-IN-NNP,1,1
1918,1866.0,45,went,2,8,13,5,7,31,-6,11,St. Ignatius College Preparatory,San Francisco,---,per-per,PROPN-PROPN-PROPN-PROPN,PROPN-PROPN,compound-compound-compound-pobj,compound-pobj,NNP-NNP-NNP-NNP,NNP-NNP,3,1
1919,1867.0,36,dated,16,30,32,2,29,3,-14,16,f Vietna,m Nguy?n T?n,-,org-org-org,X-PROPN,PROPN-PROPN-PROPN,intj-compound,compound-compound-compound,XX-NNP,NNP-NNP-NNP,6,1
1920,1868.0,21,have,5,1,20,19,0,0,4,15,Prince Hitachi,Tokyo,-,per,PROPN-PROPN,PROPN,compound-nsubj,pobj,NNP-NNP,NNP,2,1
1921,1869.0,37,scored,4,19,31,12,18,5,-15,27,Changchun Yatai,Chinese Super League,-,per-per-per,PROPN-PROPN,PROPN-PROPN-PROPN,compound-pobj,compound-compound-compound,NNP-NNP,NNP-NNP-NNP,15,1
1922,1870.0,13,is,8,1,12,11,0,0,7,4,Monica,actress,,per,PROPN,NOUN,compound,attr,NNP,NN,2,1
1923,1871.0,24,founded,8,2,19,17,1,4,6,11,YTL Corporation,Yeoh Tiong Lay,per-per,--,PROPN-PROPN,PROPN-PROPN-PROPN,compound-nsubjpass,compound-compound-pobj,NNP-NNP,NNP-NNP-NNP,-1,1
1924,1872.0,21,pitted,1,14,18,4,13,2,-13,17,Division I,Appalachian State Mountaineers,per-per,--,PROPN-PRON,PROPN-PROPN-PROPN,pobj-nsubj,compound-compound-dobj,NNP-PRP,NNP-NNP-NNPS,8,1
1925,1873.0,12,directed,3,6,7,1,5,4,-3,4,actor,David Boreanaz,per,-,NOUN,PROPN-PROPN,compound,compound-pobj,NN,NNP-NNP,1,1
1926,1874.0,23,is,9,2,22,20,1,0,7,13,Glenn Coffee,Oklahoma,-,org,PROPN-PROPN,PROPN,compound-nsubj,pobj,NNP-NNP,NNP,2,1
1927,1875.0,21,held,4,9,10,1,8,10,-5,6,Gainesville,Florida Gators baseball,per,--,PROPN,PROPN-PROPN-NOUN,pobj,compound-compound-compound,NNP,NNP-NNP-NN,3,1
1928,1876.0,28,works,7,12,19,7,11,8,-5,12,dancer,Chita Rivera,org,-,NOUN,PROPN-PROPN,pobj,compound-appos,NN,NNP-NNP,4,1
1929,1877.0,15,begin,11,6,9,3,5,5,5,-2,Hudson Soft,Konami,org-org,,PROPN-PROPN,PROPN,compound-pobj,pobj,NNP-NNP,NNP,4,1
1930,1878.0,36,insisted,1,1,4,3,0,31,0,3,Henry,Elizabeth,,per,PROPN,PROPN,nsubj,nsubj,NNP,NNP,3,1
1931,1879.0,33,formed,4,9,13,4,8,19,-5,9,Canadian Alliance,Stockwell Day,per-per,-,PROPN-PROPN,PROPN-PROPN,compound-pobj,compound-pobj,NNP-NNP,NNP-NNP,3,1
1932,1881.0,42,balanced,8,7,17,10,6,24,1,9,DeWine,Ohio,per,,PROPN,PROPN,conj,compound,NNP,NNP,3,1
1933,1882.0,41,formed,3,29,40,11,28,0,-26,37,Cheltenham College,Gloucestershire,org-org,,PROPN-PROPN,PROPN,compound-pobj,pobj,NNP-NNP,NNP,4,1
1934,1883.0,17,was,1,9,15,6,8,1,-8,14,Venezuela,Gustavo Dudamel,org,-,PROPN,PROPN-PROPN,pobj,compound-appos,NNP,NNP-NNP,4,1
1935,1884.0,36,is,3,25,29,4,24,6,-22,26,Philip I. Kent,Turner Broadcasting System,--,per-per-per,PROPN-PROPN-PROPN,PROPN-PROPN-PROPN,compound-compound-appos,compound-compound-pobj,NNP-NNP-NNP,NNP-NNP-NNP,4,1
1936,1885.0,34,said,13,9,12,3,8,21,4,-1,Austin,Eric Johnson,per,-,PROPN,PROPN-PROPN,compound,compound-nsubj,NNP,NNP-NNP,3,1
1937,1886.0,11,is,5,2,9,7,1,1,3,4,Peugeot,Sochaux,,org,PROPN,PROPN,compound,compound,NNP,NNP,3,1
1938,1887.0,26,agreed,21,4,8,4,3,17,17,-13,Travelport,Galileo,org,,PROPN,PROPN,compound,compound,NNP,NNP,1,1
1939,1888.0,11,steal,1,8,9,1,7,1,-7,8,China,CBA,,per,PROPN,PROPN,compound,compound,NNP,NNP,1,1
1940,1889.0,24,served,1,1,10,9,0,13,0,9,USDTV,Utah,org,,PROPN,PROPN,nsubj,pobj,NNP,NNP,1,1
1941,1890.0,79,ran,7,23,70,47,22,8,-16,63,Virginian Railway,1907,-,per,PROPN-PROPN,NUM,compound-compound,nummod,NNP-NNP,CD,15,1
1942,1891.0,23,born,2,6,10,4,5,12,-4,8,Delaware,Caesar Rodney High School,org,---,PROPN,PROPN-PROPN-PROPN-PROPN,pobj,compound-compound-compound-pobj,NNP,NNP-NNP-NNP-NNP,5,1
1943,1892.0,20,said,16,12,15,3,11,4,4,-1,Chairman,Bernard Arnault,per,-,PROPN,PROPN-PROPN,pobj,compound-nsubj,NNP,NNP-NNP,2,1
1944,1893.0,21,questioned,10,15,16,1,14,4,-5,6,Finance,Didier Reynders,per,-,PROPN,PROPN-NOUN,pobj,compound-dobj,NNP,NNP-NNS,1,1
1945,2404.0,37,said,35,10,14,4,9,22,25,-21,Finance,Didier Reynders,org,-,PROPN,PROPN-PROPN,pobj,compound-conj,NNP,NNP-NNPS,5,1
1946,1894.0,31,operate,3,1,11,10,0,19,2,8,US,PSA Airlines,,org-org,PROPN,PROPN-PROPN,compound,compound-compound,NNP,NNP-NNPS,7,1
1947,1895.0,24,proposed,5,17,22,5,16,1,-12,17,Cleveland High School,Washington,--,per,PROPN-PROPN-PROPN,PROPN,compound-compound-pobj,appos,NNP-NNP-NNP,NNP,3,1
1948,1896.0,19,groups,3,9,6,-3,8,12,-6,3,Abram Lyle,Tate Lyle,-,org-org,PROPN-PROPN,PROPN-PROPN,compound-compound,compound-dobj,NNP-NNP,NNP-NNP,2,1
1949,1897.0,17,disbanded,3,1,14,13,0,2,2,11,Honey Is Cool,Rabid Records,--,per-per,NOUN-VERB-PROPN,PROPN-PROPN,nsubj-auxpass-nsubj,compound-compound,NN-VBZ-NNP,NNP-NNPS,6,1
1950,1898.0,27,performed,19,5,12,7,4,14,14,-7,Slayer,Jeff Hanneman,org,-,PROPN,PROPN-PROPN,poss,compound-conj,NNP,NNP-NNP,6,1
1951,1899.0,32,divided,11,7,27,20,6,4,4,16,1945,Liberal Party,org,-,NUM,PROPN-PROPN,conj,compound-pobj,CD,NNP-NNP,8,1
1952,1900.0,17,played,1,1,13,12,0,3,0,12,She,Manhattan,,org,PRON,PROPN,nsubj,poss,PRP,NNP,1,1
1953,1901.0,37,announced,11,5,10,5,4,26,6,-1,Lawrence Cannon,Foreign Affairs,org-org,-,PROPN-PROPN,PROPN-PROPN,compound-compound,compound-pobj,NNP-NNP,NNP-NNPS,3,1
1954,1902.0,27,confirmed,6,2,5,3,1,21,4,-1,China,Huawei,org,,PROPN,PROPN,poss,compound,NNP,NNP,3,1
1955,1903.0,21,picks,12,5,16,11,4,4,7,4,Liberia,Moses Blah,,org-org,PROPN,PROPN-PROPN,poss,compound-dobj,NNP,NNP-NNP,6,1
1956,1904.0,39,declared,7,9,14,5,8,24,-2,7,Burma,Ne Win,,per-per,PROPN,PROPN-PROPN,nmod,compound-nsubj,NNP,NNP-NNP,3,1
1957,1905.0,91,organized,20,70,87,17,69,3,-50,67,USA,United Nations University,,per-per-per,PROPN,PROPN-PROPN-PROPN,pobj,compound-compound-compound,NNP,NNP-NNP-NNP,10,1
1958,1906.0,37,feared,27,16,31,15,15,5,11,4,Kabul,Najibullah,org,,PROPN,PROPN,poss,pobj,NNP,NNP,11,1
1959,1907.0,10,says,5,1,7,6,0,2,4,2,UK,BoE,org,,PROPN,PROPN,nsubj,compound,NNP,NNP,4,1
1960,1909.0,12,switched,4,3,7,4,2,4,1,3,Hayes,Columbia,per,,PROPN,PROPN,nsubj,compound,NNP,NNP,3,1
1961,1910.0,45,told,6,1,20,19,0,24,5,14,Caritas Christi Health Care,Carney Hospital,---,per-per,PROPN-PROPN-PROPN-PROPN,PROPN-PROPN,compound-compound-compound-compound,compound-conj,NNP-NNP-NNP-NNP,NNP-NNP,9,1
1962,1911.0,69,plans,20,28,7,-21,27,61,-8,-13,Afghan National Army,Afghanistan,--,org,PROPN-PROPN-PROPN,PROPN,compound-compound-pobj,dobj,NNP-NNP-NNP,NNP,6,1
1963,1912.0,32,offers,20,3,11,8,2,20,17,-9,Convergence Media Studies,University of Kerala,per-per-per,--,PROPN-PROPN-PROPN,PROPN-ADP-PROPN,compound-compound-pobj,pobj-prep-pobj,NNP-NNP-NNP,NNP-IN-NNP,7,1
1964,1913.0,47,want,1,23,36,13,22,10,-22,35,European Space Agency,Netherlands,per-per-per,,PROPN-PROPN-PROPN,PROPN,compound-compound-poss,pobj,NNP-NNP-NNP,NNP,3,1
1965,1914.0,26,played,19,3,17,14,2,8,16,-2,Rugby League World Cup,New Zealand,---,org-org,PROPN-PROPN-PROPN-PROPN,PROPN-PROPN,compound-compound-compound-poss,compound-conj,NNP-NNP-NNP-NNP,NNP-NNP,6,1
1966,1915.0,43,held,8,36,41,5,35,1,-28,33,Ogilvy Mather Worldwide,WPP Group,--,per-per,PROPN-PROPN-PROPN,PROPN-PROPN,compound-compound-compound,compound-pobj,NNP-NNP-NNP,NNP-NNP,4,1
1967,1916.0,24,confirmed,7,4,23,19,3,0,3,16,Eminem,Michigan,,per,PROPN,PROPN,poss,pobj,NNP,NNP,10,1
1968,1917.0,35,founded,3,1,9,8,0,25,2,6,Liberty,Massachusetts,org,,PROPN,PROPN,compound,compound,NNP,NNP,4,1
1969,1918.0,38,founded,3,19,19,0,18,18,-16,16,Ana Matronic,Ana Lynch,-,per-per,PROPN-PROPN,PROPN-PROPN,compound-ROOT,compound-appos,NNP-NNP,NNP-NNP,0,1
1970,1919.0,20,is,5,2,11,9,1,8,3,6,Utah Army National Guard,United States,---,org-org,PROPN-PROPN-PROPN-PROPN,PROPN-PROPN,compound-compound-compound-nsubj,compound-compound,NNP-NNP-NNP-NNP,NNP-NNP,6,1
1971,1920.0,52,claim,1,27,45,18,26,6,-26,44,The Evergreen State College,Olympia,per-per-per-per,,DET-PROPN-PROPN-PROPN,PROPN,det-compound-compound-pobj,compound,DT-NNP-NNP-NNP,NNP,9,1
1972,1921.0,31,came,6,1,6,5,0,24,5,0,Chao,Taiwan,per,,PROPN,PROPN,nsubj,pobj,NNP,NNP,3,1
1973,1922.0,35,found,1,19,31,12,18,3,-18,30,Oregon,Meier Frank,org,-,PROPN,PROPN-PROPN,pobj,compound-compound,NNP,NNP-NNP,6,1
1974,1924.0,33,begun,15,6,9,3,5,23,9,-6,du travail,CGT,-,org,ADJ-NOUN,PROPN,compound-pobj,appos,JJ-NN,NNP,2,1
1975,1925.0,25,appointed,4,8,22,14,7,2,-4,18,Douglas Elliman Realty,Vector Group,org-org-org,-,PROPN-PROPN-PROPN,PROPN-PROPN,compound-compound-pobj,compound-compound,NNP-NNP-NNP,NNP-NNP,11,1
1976,1926.0,18,ended,3,3,8,5,2,9,0,5,N.E.R.D,Virgin,org,,PROPN,PROPN,pobj,compound,NNP,NNP,3,1
1977,1927.0,51,Henzell,1,1,12,11,0,38,0,11,Perry Henzell,Jamaica,-,org,PROPN-PROPN,PROPN,compound-ROOT,nsubj,NNP-NNP,NNP,2,1
1978,1928.0,58,Baker,1,1,5,4,0,52,0,4,Duck Baker,Richard R. Baker,org-org,--,PROPN-PROPN,PROPN-PROPN-PROPN,compound-ROOT,compound-compound-compound,NNP-NNP,NNP-NNP-NNP,3,1
1979,1929.0,28,is,4,1,26,25,0,1,3,22,Omni Air International,Oklahoma,org-org-org,,PROPN-PROPN-PROPN,PROPN,compound-compound-compound,compound,NNP-NNP-NNP,NNP,8,1
1980,1930.0,18,asserted,1,1,12,11,0,5,0,11,Lombardo,Slayer,per,,PROPN,PROPN,nsubj,nsubj,NNP,NNP,6,1
1981,1931.0,14,sealed,4,1,7,6,0,6,3,3,Ne Win,Burma,-,org,PROPN-PROPN,PROPN,compound-nsubj,dobj,NNP-NNP,NNP,2,1
1982,1933.0,33,started,12,3,6,3,2,26,9,-6,Hamad bin Khalifa,Al Thani,per-per-per,-,PROPN-PROPN-PROPN,PROPN-PROPN,compound-compound-compound,compound-nsubj,NNP-NNP-NNP,NNP-NNP,1,1
1983,1934.0,31,accepted,9,9,14,5,8,16,0,5,Brockman,Kansas,,org,PROPN,PROPN,dobj,compound,NNP,NNP,4,1
1984,1935.0,41,worsened,2,9,21,12,8,19,-7,19,KKR,John Buchanan,,per-per,PROPN,PROPN-PROPN,pobj,compound-appos,NNP,NNP-NNP,10,1
1985,1936.0,27,performed,3,16,20,4,15,6,-13,17,Italy,Franco Battiato,org,-,PROPN,PROPN-PROPN,poss,compound-conj,NNP,NNP-NNP,3,1
1986,1937.0,27,said,11,3,11,8,2,15,8,0,ECB,Spain,org,,PROPN,PROPN,compound,pobj,NNP,NNP,4,1
1987,1938.0,48,is,9,2,3,1,1,44,7,-6,Oulu,University of Oulu,per,--,PROPN,PROPN-ADP-PROPN,compound,pobj-prep-pobj,NNP,NNP-IN-NNP,2,1
1988,1939.0,26,became,5,3,25,22,2,0,2,20,Carl Schurz,Interior,per-per,,PROPN-PROPN,PROPN,compound-nsubj,pobj,NNP-NNP,NNP,8,1
1989,1940.0,41,According,0,4,11,7,3,29,-4,11,Central Organisation of Finnish Trade Unions,SAK,per-per-per-per-per-per,,PROPN-PROPN-ADP-PROPN-PROPN-PROPN,PROPN,compound-pobj-prep-compound-compound-pobj,appos,NNP-NNP-IN-NNP-NNP-NNPS,NNP,4,1
1990,1941.0,53,see,3,16,16,0,15,36,-13,13,Consett,Consett A.F.C.,org,-,PROPN,PROPN-PROPN,compound,compound-pobj,NNP,NNP-NNP,0,1
1991,1943.0,34,Mail,0,15,29,14,14,4,-15,29,Malaysian Nature Society,Bukit Persekutuan,per-per-per,-,PROPN-PROPN-PROPN,PROPN-PROPN,amod-compound-compound,compound-ROOT,NNP-NNP-NNP,NNP-NNP,5,1
1992,1944.0,40,said,30,17,21,4,16,18,13,-9,von,Los Angeles,per,-,PROPN,PROPN-PROPN,compound,compound-compound,NNP,NNP-NNP,4,1
1993,1945.0,38,is,1,7,15,8,6,22,-6,14,University of Wollongong Undergraduate Students ' Association,WUSA,per-per-per-per-per-per-per,,PROPN-ADP-PROPN-PROPN-PROPN-PART-PROPN,PROPN,pobj-prep-pobj-compound-poss-case-ROOT,appos,NNP-IN-NNP-NNP-NNP-POS-NNP,NNP,5,1
1994,1946.0,14,is,5,4,12,8,3,1,1,7,Vincent Cassel,Monica Bellucci,per-per,-,PROPN-PROPN,PROPN-PROPN,compound-nsubj,compound-appos,NNP-NNP,NNP-NNP,5,1
1995,1948.0,43,became,32,17,27,10,16,15,15,-5,host,Terrence J.,,per-per,NOUN,PROPN-PROPN,attr,compound-appos,NN,NNP-NNP,4,1
1996,1949.0,27,given,12,3,25,22,2,1,9,13,Keith Emerson,The Nice,org-org,-,PROPN-PROPN,DET-PROPN,compound-poss,det-pobj,NNP-NNP,DT-NNP,11,1
1997,1950.0,38,returned,7,10,18,8,9,19,-3,11,Hawaii,Modern Folk Quartet,,org-org-org,PROPN,PROPN-PROPN-PROPN,pobj,compound-compound-appos,NNP,NNP-NNP-NNP,5,1
1998,1951.0,20,s,2,1,4,3,0,15,1,2,Malaysia,Astro,per,,PROPN,PROPN,nsubj,nsubj,NNP,NNP,4,1
1999,1952.0,34,use,27,20,25,5,19,8,7,-2,The Streets,Birmingham,org-org,,DET-PROPN,PROPN,det-pobj,pobj,DT-NNPS,NNP,3,1
2000,1953.0,37,convinced,10,6,9,3,5,27,4,-1,Armenian Communist Party,Karen Demirchyan,org-org-org,-,PROPN-PROPN-PROPN,PROPN-PROPN,compound-compound-compound,compound-pobj,NNP-NNP-NNP,NNP-NNP,2,1
2001,1954.0,33,Returned,0,15,16,1,14,16,-15,16,Treasury,Salmon P. Chase,,per-per-per,PROPN,PROPN-PROPN-PROPN,pobj,compound-compound-pobj,NNP,NNP-NNP-NNP,8,1
2002,1955.0,46,known,13,37,44,7,36,1,-24,31,The Wailers,Peter Tosh,org-org,-,DET-PROPN,PROPN-PROPN,det-appos,compound-conj,DT-NNPS,NNP-NNP,6,1
2003,1956.0,42,defeated,23,1,12,11,0,29,22,-11,Emily Lau,Legislative Council,per-per,-,PROPN-PROPN,PROPN-PROPN,compound-poss,compound-compound,NNP-NNP,NNP-NNP,6,1
2004,1957.0,16,ran,1,7,11,4,6,4,-6,10,Andre Ward,USA,-,org,PROPN-PROPN,PROPN,compound-appos,pobj,NNP-NNP,NNP,3,1
2005,1958.0,63,elected,2,15,47,32,14,15,-13,45,Colorado,Ken Salazar,per,-,PROPN,PROPN-PROPN,compound,compound-poss,NNP,NNP-NNP,-1,1
2006,1959.0,13,made,3,1,12,11,0,0,2,9,He,Ontario,,org,PRON,PROPN,nsubj,pobj,PRP,NNP,2,1
2007,1960.0,31,was,1,1,23,22,0,7,0,22,She,Ecuador,,per,PRON,PROPN,nsubj,poss,PRP,NNP,6,1
2008,1961.0,37,represented,5,7,22,15,6,14,-2,17,Maryland,Benjamin F. Kramer,per,--,PROPN,PROPN-PROPN-PROPN,poss,compound-compound-appos,NNP,NNP-NNP-NNP,6,1
2009,1962.0,25,is,2,1,14,13,0,10,1,12,Marietta College,USA,-,per,PROPN-PROPN,PROPN,compound-nsubj,pobj,NNP-NNP,NNP,5,1
2010,1963.0,32,said,30,10,14,4,9,17,20,-16,National Police Agency,NPA,--,org,PROPN-PROPN-PROPN,PROPN,compound-compound-dobj,compound,NNP-NNP-NNP,NNP,2,1
2011,1964.0,33,founded,3,15,8,-7,14,24,-12,5,1894,Camillo Eitzen Co,per,--,NUM,PROPN-PROPN-NOUN,pobj,compound-compound-pobj,CD,NNP-NNP-NN,-1,1
2012,1965.0,34,ranked,4,6,17,11,5,16,-2,13,Golf Digest,United States,-,per-per,PROPN-PROPN,PROPN-PROPN,compound-poss,compound-pobj,NNP-NNP,NNP-NNP,5,1
2013,1966.0,22,Hospital,2,6,19,13,5,2,-4,17,Mount Olive College,NC,org-org-org,,PROPN-PROPN-PROPN,PROPN,compound-compound-pobj,compound,NNP-NNP-NNP,NNP,9,1
2014,1967.0,43,filmed,4,22,23,1,21,19,-18,19,actress,Gena Rowlands,,per-per,NOUN,PROPN-PROPN,compound,compound-conj,NN,NNP-NNP,5,1
2015,1968.0,25,is,11,1,1,0,0,23,10,-10,Rush Medical College,Rush University,per-per-per,-,PROPN-PROPN-PROPN,PROPN-PROPN,compound-compound-nsubj,compound-pobj,NNP-NNP-NNP,NNP-NNP,0,1
2016,1969.0,22,had,13,7,18,11,6,3,6,5,London,Macfarlane,per,,PROPN,PROPN,compound,pobj,NNP,NNP,7,1
2017,1970.0,25,is,15,1,24,23,0,0,14,9,Xinjiang Xinxin Mining Industry Company,China,----,per,PROPN-PROPN-PROPN-PROPN-PROPN,PROPN,compound-compound-compound-compound-nsubj,pobj,NNP-NNP-NNP-NNP-NNP,NNP,3,1
2018,1971.0,22,released,2,12,18,6,11,3,-10,16,Priority,Beats By The Pound,per,---,PROPN,NOUN-ADP-DET-PROPN,compound,pobj-prep-det-pobj,NNP,NNS-IN-DT-NNP,5,1
2019,1972.0,11,referring,2,5,10,5,4,0,-3,8,Washington,Virginia,per,,PROPN,PROPN,poss,pobj,NNP,NNP,5,1
2020,1973.0,12,was,8,4,7,3,3,4,4,-1,Dougray Scott,Claire Forlani,-,per-per,PROPN-PROPN,PROPN-PROPN,compound-pobj,compound-conj,NNP-NNP,NNP-NNP,1,1
2021,1974.0,33,toured,6,10,8,-2,9,24,-4,2,Sarah Slean,Canada,org-org,,PROPN-PROPN,PROPN,compound-pobj,compound,NNP-NNP,NNP,1,1
2022,1975.0,24,was,15,2,15,13,1,8,13,0,Sun Yat-sen University,China,org-org-org,,PROPN-PROPN-PROPN,PROPN,nsubj-compound-nsubj,pobj,NNP-NNP-NNP,NNP,6,1
2023,1976.0,21,is,2,7,16,9,6,4,-5,14,producer,Robert Zemeckis,,org-org,NOUN,PROPN-PROPN,attr,compound-compound,NN,NNP-NNP,4,1
2024,1977.0,12,keen,3,1,3,2,0,8,2,0,Malaysia,CIMB,org,,PROPN,NOUN,poss,nsubj,NNP,NNS,3,1
2025,1978.0,22,said,4,14,20,6,13,1,-10,16,Major League Soccer,Colorado Rapids,org-org-org,-,PROPN-PROPN-PROPN,PROPN-PROPN,compound-compound-compound,compound-pobj,NNP-NNP-NNP,NNP-NNPS,5,1
2026,1979.0,23,was,10,2,6,4,1,16,8,-4,his,Maryland,,per,DET,PROPN,poss,compound,PRP$,NNP,2,1
2027,1980.0,11,is,6,5,8,3,4,2,1,2,Sierra Leone,Ernest Bai Koroma,-,org-org-org,PROPN-PROPN,PROPN-PROPN-PROPN,compound-pobj,compound-compound-attr,NNP-NNP,NNP-NNP-NNP,5,1
2028,1981.0,47,is,4,13,18,5,12,28,-9,14,Israel,Israeli Educational Television,,per-per-per,PROPN,ADJ-PROPN-PROPN,pobj,amod-compound-nsubj,NNP,JJ-NNP-NNP,5,1
2029,1982.0,19,performed,2,2,7,5,1,11,0,5,Sugababes,London,org,,PROPN,PROPN,nsubj,poss,NNP,NNP,4,1
2030,1983.0,37,performing,3,5,26,21,4,10,-2,23,Ronnie Spector,New York,-,per-per,PROPN-PROPN,PROPN-PROPN,compound-poss,compound-compound,NNP-NNP,NNP-NNP,8,1
2031,1984.0,25,is,1,9,9,0,8,15,-8,8,Vector Group,Vector Tobacco,per-per,-,PROPN-PROPN,PROPN-PROPN,compound-pobj,compound-compound,NNP-NNP,NNP-NNP,0,1
2032,1985.0,17,released,12,1,9,8,0,7,11,-3,Amaru,Afeni Shakur,per,-,PROPN,PROPN-PROPN,compound,compound-pobj,NNP,NNP-NNP,5,1
2033,1986.0,24,formed,9,1,11,10,0,12,8,2,Faye Hamlin,Play,per-per,,PROPN-PROPN,PROPN,nmod-nmod,poss,NNP-NNP,NNP,6,1
2034,1987.0,79,sure,42,26,37,11,25,41,16,-5,Giza,Cairo University,org,-,PROPN,PROPN-PROPN,compound,nmod-nmod,NNP,NNP-NNP,6,1
2035,1988.0,23,said,8,10,16,6,9,6,-2,8,Gene Russianoff,Straphangers Campaign,-,per-per,PROPN-PROPN,PROPN-PROPN,compound-nsubj,compound-nmod,NNP-NNP,NNPS-NNP,3,1
2036,1989.0,41,granted,3,14,7,-7,13,33,-11,4,Chile,Manuel Montt,,org-org,PROPN,PROPN-PROPN,compound,compound-pobj,NNP,NNP-NNP,8,1
2037,1990.0,39,was,1,9,19,10,8,19,-8,18,Massachusetts Institute of Technology,Charles Stark Draper,org-org-org-org,--,PROPN-PROPN-ADP-PROPN,PROPN-PROPN-PROPN,compound-poss-prep-pobj,compound-compound-compound,NNP-NNP-IN-NNP,NNP-NNP-NNP,6,1
2038,1991.0,25,wants,1,1,19,18,0,5,0,18,Opel,Germany,per,,PROPN,PROPN,nsubj,pobj,NNP,NNP,4,1
2039,1992.0,22,made,1,1,20,19,0,1,0,19,She,United States,,per-per,PRON,PROPN-PROPN,nsubj,compound-pobj,PRP,NNP-NNP,6,1
2040,1993.0,9,formed,3,3,8,5,2,0,0,5,he,Fie,,org,PRON,PROPN,nsubj,appos,PRP,NNP,1,1
2041,1994.0,21,is,3,2,13,11,1,7,1,10,Ronald Stordahl,Digi-Key,per-per,,PROPN-PROPN,PROPN,compound-nsubj,compound,NNP-NNP,NNP,5,1
2042,1995.0,10,opened,6,2,4,2,1,5,4,-2,1971,University of Bremen,per,--,NUM,PROPN-ADP-PROPN,pobj,nsubj-prep-pobj,CD,NNP-IN-NNP,2,1
2043,1996.0,29,was,3,3,9,6,2,19,0,6,Nixon,United States House,org,--,PROPN,PROPN-PROPN-PROPN,nsubj,compound-compound-pobj,NNP,NNP-NNP-NNP,4,1
2044,1997.0,27,became,2,9,13,4,8,13,-7,11,2003,Atari Interactive,,org-org,NUM,PROPN-PROPN,nummod,compound-compound,CD,NNP-NNP,4,1
2045,1998.0,15,established,4,2,12,10,1,2,2,8,1981,Abia State University,,org-org-org,NUM,PROPN-PROPN-PROPN,pobj,compound-compound-pobj,CD,NNP-NNP-NNP,7,1
2046,1999.0,51,named,3,8,17,9,7,33,-5,14,Georges Clemenceau,France,-,org,PROPN-PROPN,PROPN,compound-pobj,pobj,NNP-NNP,NNP,2,1
2047,2001.0,53,announced,20,18,19,1,17,33,2,-1,Minister,Clemente Mastella,,per-per,PROPN,PROPN-PROPN,compound,compound-nsubj,NNP,NNP-NNP,1,1
2048,2002.0,37,was,3,25,32,7,24,4,-22,29,Quebec,Robert Bourassa,,org-org,PROPN,PROPN-PROPN,pobj,compound-pobj,NNP,NNP-NNP,3,1
2049,2003.0,21,was,12,1,15,14,0,5,11,3,George Johnson Clarke,New Brunswick,--,org-org,PROPN-PROPN-PROPN,PROPN-PROPN,compound-compound-compound,compound-compound,NNP-NNP-NNP,NNP-NNP,4,1
2050,2004.0,19,designed,3,2,18,16,1,0,1,15,hospital,Thailand,per,,NOUN,PROPN,nsubjpass,pobj,NN,NNP,2,1
2051,2005.0,43,used,4,32,35,3,31,7,-28,31,American,Jasper Johns,per,-,ADJ,PROPN-PROPN,amod,compound-compound,JJ,NNP-NNP,3,1
2052,2006.0,21,grown,11,8,9,1,7,11,3,-2,1960,JMS,,org,NUM,PROPN,pobj,pobj,CD,NNP,6,1
2053,2007.0,23,announced,8,6,8,2,5,14,2,0,singer,DeLeon,,org,NOUN,PROPN,compound,nsubj,NN,NNP,2,1
2054,2008.0,35,was,1,3,18,15,2,16,-2,17,one,Lennart von Post,per,--,NUM,PROPN-PROPN-PROPN,attr,compound-compound-pobj,CD,NNP-NNP-NNP,7,1
2055,2009.0,30,is,5,2,27,25,1,2,3,22,Stony Brook Seawolves,Division I,--,org-org,PROPN-PROPN-PROPN,PROPN-PRON,compound-compound-compound,conj-nsubj,NNP-NNP-NNPS,NNP-PRP,13,1
2056,2010.0,21,is,1,14,16,2,13,4,-13,15,IRL,Brian Barnhart,,org-org,PROPN,PROPN-PROPN,compound,compound-nsubj,NNP,NNP-NNP,1,1
2057,2012.0,25,said,12,1,11,10,0,13,11,-1,Slovakia,Robert Fico,org,-,PROPN,PROPN-PROPN,nsubj,compound-nsubj,NNP,NNP-NNP,3,1
2058,2013.0,43,Launched,0,5,6,1,4,36,-5,6,1990,The Movie Channel,,per-per-per,NUM,PROPN-PROPN-PROPN,pobj,det-compound-nsubj,CD,NNP-NNP-NNP,2,1
2059,2014.0,32,de-listed,4,1,21,20,0,10,3,17,CBOT,CME Group,,per-per,PROPN,PROPN-PROPN,compound,compound-compound,NNP,NNP-NNP,9,1
2060,2015.0,30,was,7,1,25,24,0,4,6,18,Magdallan,Ken Tamplin,per,-,PROPN,PROPN-PROPN,nsubj,compound-pobj,NNP,NNP-NNP,9,1
2061,2016.0,39,met,21,10,17,7,9,21,11,-4,nd Radovan Karad?,imed Republika Sr,per-per-per,--,PROPN-PROPN-ADJ,VERB-PROPN-PROPN,nmod-compound-compound,amod-compound-compound,NNP-NNP-JJ,VBD-NNP-NNP,5,1
2062,2017.0,22,is,7,2,2,0,1,19,5,-5,Morehead State University,Morehead,--,per,PROPN-PROPN-PROPN,PROPN,compound-compound-dobj,compound,NNP-NNP-NNP,NNP,0,1
2063,2018.0,20,imprisoned,9,1,13,12,0,6,8,4,Calloway,United States,,org-org,PROPN,PROPN-PROPN,compound,compound-pobj,NNP,NNP-NNP,6,1
2064,2019.0,20,served,2,17,18,1,16,1,-15,16,President,Jakaya Kikwete,,per-per,PROPN,PROPN-PROPN,compound,compound-pobj,NNP,NNP-NNP,1,1
2065,2020.0,35,announced,7,1,6,5,0,28,6,-1,Madonna,Ritchie,,per,PROPN,PROPN,nmod,nsubj,NNP,NNP,3,1
2066,2021.0,49,became,1,4,37,33,3,11,-3,36,Libertarian,Tommy Thompson,,org-org,ADJ,PROPN-PROPN,amod,compound-nsubj,JJ,NNP-NNP,9,1
2067,2022.0,15,were,5,7,11,4,6,3,-2,6,Ted Danson,Mary Steenburgen,org-org,-,PROPN-PROPN,PROPN-PROPN,compound-attr,compound-conj,NNP-NNP,NNP-NNP,1,1
2068,2023.0,33,is,13,10,20,10,9,12,3,7,Data Systems Solutions,Rolls-Royce plc,org-org-org,-,PROPN-PROPN-PROPN,PROPN-NOUN,compound-compound-pobj,amod-pobj,NNP-NNPS-NNPS,NNP-NN,10,1
2069,2024.0,13,located,3,2,9,7,1,3,1,6,MHC,Medicine Hat,,per-per,PROPN,PROPN-PROPN,nsubjpass,compound-compound,NNP,NNP-NNP,6,1
2070,2025.0,11,considering,2,1,8,7,0,2,1,6,He,Canadian,,org,PRON,ADJ,nsubj,amod,PRP,JJ,5,1
2071,2026.0,23,supported,1,1,3,2,0,19,0,2,Rugova,Kosovo,,org,PROPN,PROPN,nsubj,poss,NNP,NNP,3,1
2072,2027.0,23,represents,17,3,3,0,2,19,14,-14,Liberal,Liberal International,org,-,PROPN,PROPN-PROPN,compound,compound-nsubj,NNP,NNP-NNP,0,1
2073,2028.0,68,(,0,11,3,-8,10,64,-11,3,United States,John,per-per,,PROPN-PROPN,PROPN,compound-pobj,poss,NNP-NNP,NNP,2,1
2074,2029.0,38,regarded,5,4,14,10,3,23,1,9,he,Japan,org,,PRON,PROPN,nsubjpass,pobj,PRP,NNP,2,1
2075,2030.0,27,dismissed,6,5,10,5,4,16,1,4,Canning Fok,the firm,per-per,-,PROPN-PROPN,DET-NOUN,compound-appos,det-nsubj,NNP-NNP,DT-NN,4,1
2076,2031.0,19,released,7,1,10,9,0,8,6,3,Paparizou,Greece,,per,NOUN,PROPN,poss,pobj,NN,NNP,4,1
2077,2032.0,36,played,2,10,13,3,9,22,-8,11,Audie Desbrow,Great White,-,per-per,PROPN-PROPN,PROPN-PROPN,compound-conj,compound-appos,NNP-NNP,NNP-NNP,1,1
2078,2033.0,20,was,4,3,18,15,2,1,1,14,Michael Jackson,his,-,per,PROPN-PROPN,DET,compound-nsubj,poss,NNP-NNP,PRP$,9,1
2079,2034.0,28,was,2,7,27,20,6,0,-5,25,Smith,London,,per,PROPN,PROPN,nsubj,pobj,NNP,NNP,5,1
2080,2035.0,40,was,3,18,39,21,17,0,-15,36,Downer,Australia,,org,PROPN,PROPN,pobj,pobj,NNP,NNP,11,1
2081,2036.0,18,continued,4,9,15,6,8,2,-5,11,Manny Diaz,Miami,org-org,,PROPN-PROPN,PROPN,compound-nsubjpass,pobj,NNP-NNP,NNP,6,1
2082,2037.0,21,With,0,11,17,6,10,3,-11,17,Selwyn Lloyd,Exchequer,per-per,,PROPN-PROPN,PROPN,compound-dobj,pobj,NNP-NNP,NNP,2,1
2083,2038.0,26,were,2,1,11,10,0,14,1,9,Gazprom,RTS,per,,NOUN,PROPN,compound,compound,NN,NNP,4,1
2084,2039.0,15,played,3,7,12,5,6,2,-4,9,North Sydney Bears,NSWRL,--,org,PROPN-PROPN-PROPN,PROPN,compound-compound-pobj,compound,NNP-NNP-NNP,NNP,6,1
2085,2040.0,25,introduced,7,4,6,2,3,18,3,-1,Minnesota,Rod Grams,,per-per,PROPN,PROPN-PROPN,compound,compound-nsubj,NNP,NNP-NNP,1,1
2086,2041.0,26,born,2,18,22,4,17,3,-16,20,Greece,German School of Athens,per,---,PROPN,PROPN-PROPN-ADP-PROPN,compound,compound-dobj-prep-pobj,NNP,NNP-NNP-IN-NNP,8,1
2087,2042.0,52,Contributing,0,36,46,10,35,5,-36,46,New York,George Walsh,-,org-org,PROPN-PROPN,PROPN-PROPN,compound-pobj,compound-conj,NNP-NNP,NNP-NNP,5,1
2088,2043.0,42,titled,3,5,13,8,4,28,-2,10,Garth Brooks,Chris Gaines,per-per,-,PROPN-PROPN,PROPN-PROPN,compound-dobj,compound-pobj,NNP-NNP,NNP-NNP,-1,1
2089,2044.0,30,got,13,1,9,8,0,20,12,-4,Keiji Inafune,Capcom,per-per,,PROPN-PROPN,PROPN,compound-nsubj,poss,NNP-NNP,NNP,7,1
2090,2045.0,21,established,5,2,13,11,1,7,3,8,Malayan Union,Edward Gent,-,per-per,PROPN-PROPN,PROPN-PROPN,compound-nsubjpass,compound-nsubjpass,NNP-NNP,NNP-NNP,3,1
2091,2105.0,19,came,8,6,14,8,5,4,2,6,Malayan Union,Edward Gent,per-per,-,PROPN-PROPN,PROPN-PROPN,compound-nsubj,compound-pobj,NNP-NNP,NNP-NNP,3,1
2092,2046.0,31,created,16,6,29,23,5,1,10,13,Soviet Union,Tank Army,per-per,-,PROPN-PROPN,PROPN-PROPN,compound-pobj,compound-pobj,NNP-NNP,NNP-NNP,10,1
2093,2047.0,22,works,3,11,18,7,10,3,-8,15,Adelaide,Pulteney Grammar School,per,--,PROPN,PROPN-PROPN-PROPN,pobj,compound-compound-compound,NNP,NNP-NNP-NNP,8,1
2094,2048.0,24,were,5,1,4,3,0,19,4,-1,Massachusetts,Henry Knox,per,-,PROPN,PROPN-PROPN,compound,compound-pobj,NNP,NNP-NNP,2,1
2095,2049.0,27,sent,4,16,17,1,15,9,-12,13,Ontario,George A. Drew,per,--,PROPN,PROPN-PROPN-PROPN,pobj,compound-compound-appos,NNP,NNP-NNP-NNP,1,1
2096,2050.0,49,named,2,1,8,7,0,40,1,6,Qasimov,Azerbaijan,,org,PROPN,PROPN,nsubjpass,pobj,NNP,NNP,4,1
2097,2051.0,25,aired,1,7,16,9,6,8,-6,15,CBC Radio One,Canada,--,org,PROPN-PROPN-PROPN,PROPN,compound-compound-pobj,pobj,NNP-NNP-NNP,NNP,5,1
2098,2052.0,20,draw,15,5,13,8,4,6,10,-2,Ghost Box Music,The Focus Group,--,per-per-per,PROPN-PROPN-PROPN,DET-PROPN-PROPN,compound-compound-compound,det-compound-conj,NNP-NNP-NNP,DT-NNP-NNP,6,1
2099,2055.0,52,S.A.,1,1,11,10,0,40,0,10,Avianca S.A.,Colombia,-,per,PROPN-PROPN,PROPN,compound-ROOT,compound,NNP-NNP,NNP,1,1
2100,2056.0,13,renamed,2,6,10,4,5,2,-4,8,North-West Mobile Force,NORFORCE,--,org,PROPN-PROPN-PROPN,PROPN,compound-compound-pobj,conj,NNP-NNP-NNP,NNP,5,1
2101,2057.0,27,began,12,11,18,7,10,8,1,6,Canadian Tire,1922,-,per,ADJ-PROPN,NUM,compound-pobj,pobj,JJ-NNP,CD,2,1
2102,2058.0,37,Qayyum,2,20,30,10,19,6,-18,28,Pakistan,Pervez Musharraf,org,-,PROPN,PROPN-PROPN,pobj,compound-nsubj,NNP,NNP-NNP,3,1
2103,2059.0,28,leveled,18,14,17,3,13,10,4,-1,Cairo,Nasr,,org,PROPN,PROPN,compound,compound,NNP,NNP,2,1
2104,2060.0,31,expected,1,14,23,9,13,7,-13,22,Cyprus,Central Bank,,per-per,PROPN,PROPN-PROPN,compound,compound-compound,NNP,NNP-NNP,13,1
2105,2061.0,13,served,1,1,11,10,0,1,0,10,Kramer,Maryland,,per,PROPN,PROPN,nsubj,compound,NNP,NNP,4,1
2106,2062.0,19,was,1,1,7,6,0,11,0,6,Gimson,Singapore,per,,PROPN,PROPN,nsubj,pobj,NNP,NNP,2,1
2107,2063.0,15,Recorded,0,5,13,8,4,1,-5,13,Martin Bisi,New York,org-org,-,PROPN-PROPN,PROPN-PROPN,compound-pobj,compound-pobj,NNP-NNP,NNP-NNP,6,1
2108,2064.0,18,formed,2,1,17,16,0,0,1,15,Midlake,Texas,org,,PROPN,PROPN,nsubjpass,pobj,NNP,NNP,2,1
2109,2065.0,23,was,6,1,18,17,0,4,5,12,Victorino Bustillos,Venezuela,per-per,,PROPN-PROPN,PROPN,compound-nsubj,pobj,NNP-NNP,NNP,3,1
2110,2066.0,69,include,8,14,24,10,13,44,-6,16,Punjab National Bank,India,--,per,PROPN-PROPN-PROPN,PROPN,compound-compound-compound,compound,NNP-NNP-NNP,NNP,3,1
2111,2067.0,21,died,13,4,12,8,3,8,9,-1,three,William Marshall,org,-,NUM,PROPN-PROPN,nummod,compound-nsubj,CD,NNP-NNP,3,1
2112,2068.0,28,made,6,1,16,15,0,11,5,10,Chuan,Thailand,,org,PROPN,PROPN,poss,pobj,NNP,NNP,4,1
2113,2069.0,12,incorporated,6,3,11,8,2,0,3,5,Lamborghini,1963,org,,PROPN,NUM,compound,nummod,NNP,CD,4,1
2114,2070.0,28,commented,2,5,11,6,4,16,-3,9,Moscow,CSTO,,per,PROPN,PROPN,poss,poss,NNP,NNP,6,1
2115,2071.0,18,is,7,1,16,15,0,1,6,9,Texas Tech University College of Human Sciences,Lubbock,org-org-org-org-org-org-org,,PROPN-PROPN-PROPN-PROPN-ADP-PROPN-PROPN,PROPN,compound-compound-compound-nsubj-prep-compound-pobj,compound,NNP-NNP-NNP-NNP-IN-NNP-NNPS,NNP,8,1
2116,2072.0,38,said,14,22,25,3,21,12,-8,11,Wikimedia Foundation,San Francisco,-,org-org,PROPN-PROPN,PROPN-PROPN,compound-pobj,compound-pobj,NNP-NNP,NNP-NNP,3,1
2117,2073.0,15,is,1,1,13,12,0,1,0,12,He,Tinted Windows,per,-,PRON,VERB-PROPN,nsubj,compound-conj,PRP,VBD-NNP,6,1
2118,2074.0,35,resigned,13,9,4,-5,8,30,4,-9,Waimea,William Cautley,per,-,PROPN,PROPN-PROPN,nmod,compound-conj,NNP,NNP-NNP,3,1
2119,2075.0,33,signed,3,13,30,17,12,2,-10,27,Pierre Nkurunziza,Burundi,per-per,,PROPN-PROPN,PROPN,compound-conj,amod,NNP-NNP,NNP,10,1
2120,2076.0,25,bought,5,2,17,15,1,7,3,12,Television Networks,Hearst,org-org,,PROPN-PROPN,PROPN,compound-nsubj,compound,NNP-NNP,NNP,-1,1
2121,2077.0,9,born,4,1,7,6,0,1,3,3,Seth Woodbury MacFarlane,Kent,per-per-per,,PROPN-PROPN-PROPN,PROPN,compound-compound-nsubjpass,compound,NNP-NNP-NNP,NNP,4,1
2122,2078.0,66,raised,15,13,21,8,12,44,2,6,Montana,Baucus,org,,PROPN,PROPN,compound,nsubj,NNP,NNP,3,1
2123,2079.0,54,Jean-Jacques,0,23,40,17,22,13,-23,40,Michael Foale,British,-,per,PROPN-PROPN,ADJ,compound-nsubj,conj,NNP-NNP,JJ,6,1
2124,2080.0,34,used,8,1,15,14,0,18,7,7,His,Ninja Tune,per,-,DET,PROPN-PROPN,poss,compound-poss,PRP$,NNP-NNP,7,1
2125,2081.0,25,joined,6,13,16,3,12,8,-7,10,Humble Pie,Peter Frampton,org-org,-,PROPN-PROPN,PROPN-PROPN,compound-dobj,compound-compound,NNP-NNP,NNP-NNP,4,1
2126,2082.0,26,married,1,16,24,8,15,1,-15,23,Chile,Manuel Bulnes,,org-org,PROPN,PROPN-PROPN,pobj,compound-pobj,NNP,NNP-NNP,5,1
2127,2083.0,35,achieved,2,9,1,-8,8,33,-7,-1,Milwaukee,The Gufs,org,-,PROPN,DET-PROPN,compound,det-conj,NNP,DT-NNP,5,1
2128,2084.0,18,was,1,1,12,11,0,5,0,11,He,Canada,org,,PRON,PROPN,nsubj,pobj,PRP,NNP,3,1
2129,2085.0,23,has,1,1,15,14,0,7,0,14,Uponor,Finland,per,,PROPN,PROPN,nsubj,compound,NNP,NNP,3,1
2130,2086.0,33,was,5,5,11,6,4,21,0,6,CIPS,1958,,per,PROPN,NUM,pobj,pobj,NNP,CD,3,1
2131,2087.0,30,was,3,1,16,15,0,13,2,13,Newport Television,Sandy DiPasquale,per-per,-,PROPN-PROPN,PROPN-PROPN,compound-compound,compound-conj,NNP-NNP,NNP-NNP,7,1
2132,2088.0,28,is,9,12,26,14,11,1,-3,17,Danish Superliga,F.C. Copenhagen,-,org-org,PROPN-PROPN,PROPN-PROPN,compound-compound,compound-pobj,NNP-NNP,NNP-NNP,8,1
2133,2089.0,27,is,2,14,23,9,13,3,-12,21,Bill Sienkiewicz,Epic Comics,per-per,-,PROPN-PROPN,PROPN-PROPN,compound-pobj,compound-oprd,NNP-NNP,NNP-NNP,6,1
2134,2090.0,59,started,1,9,21,12,8,37,-8,20,Cuba,Alicia Alonso,,per-per,PROPN,PROPN-PROPN,pobj,compound-compound,NNP,NNP-NNP,9,1
2135,2091.0,41,spoke,4,4,27,23,3,13,0,23,he,Los Angeles,per,-,PRON,PROPN-PROPN,nsubj,compound-pobj,PRP,NNP-NNP,3,1
2136,2092.0,55,defeated,6,12,16,4,11,38,-6,10,Labor,Andrew Fisher,per,-,PROPN,PROPN-PROPN,compound,compound-pobj,NNP,NNP-NNP,3,1
2137,2095.0,16,says,1,3,5,2,2,10,-2,4,Norway,Statoil,,org,PROPN,PROPN,poss,compound,NNP,NNP,2,1
2138,2096.0,29,nominated,6,25,27,2,24,1,-19,21,Family politics,Rosy Bindi,per-per,-,PROPN-NOUN,PROPN-PROPN,compound-pobj,compound-pobj,NNP-NNS,NNP-NNP,1,1
2139,2097.0,24,said,6,11,18,7,10,5,-5,12,Chrysler,Cerberus Capital Management,org,--,PROPN,PROPN-PROPN-PROPN,compound,compound-compound-nsubj,NNP,NNP-NNP-NNP,6,1
2140,2098.0,33,students,2,8,30,22,7,2,-6,28,Cumberland Regional High School,Upper Deerfield Township,org-org-org-org,--,PROPN-PROPN-PROPN-PROPN,PROPN-PROPN-PROPN,compound-compound-compound-dobj,compound-conj-ROOT,NNP-NNP-NNP-NNP,NNP-NNP-NNP,6,1
2141,2099.0,18,was,1,8,12,4,7,5,-7,11,XVIII Airborne Corps,Fort Bragg,org-org-org,-,PROPN-PROPN-PROPN,PROPN-PROPN,compound-compound-pobj,compound-compound,NNP-NNP-NNP,NNP-NNP,6,1
2142,2100.0,19,brought,7,5,12,7,4,6,2,5,Progressive Enterprises,Woolworths Limited,org-org,-,PROPN-PROPN,PROPN-PROPN,compound-nsubjpass,compound-pobj,NNP-NNPS,NNP-NNP,4,1
2143,2101.0,21,premiered,10,10,19,9,9,1,0,9,KEWLopolis,American Greetings,,org-org,PROPN,PROPN-PROPN,nsubj,compound-conj,NNP,NNP-NNPS,4,1
2144,2102.0,12,born,2,1,9,8,0,2,1,7,He,United Arab Emirates,,per-per-per,PRON,PROPN-PROPN-PROPN,nsubjpass,compound-compound-appos,PRP,NNP-NNP-NNPS,4,1
2145,2103.0,36,works,10,1,10,9,0,25,9,0,Sharada,India,per,,PROPN,PROPN,compound,pobj,NNP,NNP,3,1
2146,2104.0,42,questioned,3,10,32,22,9,9,-7,29,Bloc,Quebec,,per,PROPN,PROPN,nsubj,pobj,NNP,NNP,10,1
2147,2106.0,46,initiated,5,14,18,4,13,27,-9,13,Hans Adriaansens,Roosevelt Academy,org-org,-,PROPN-PROPN,PROPN-PROPN,compound-nsubj,compound-dobj,NNP-NNP,NNP-NNP,2,1
2148,2107.0,80,Matters,5,64,1,-63,63,78,-59,-4,HKIEd,Hong Kong,,org-org,PROPN,PROPN-PROPN,nsubj,compound-pobj,NNPS,NNP-NNP,-1,1
2149,2108.0,25,did,6,10,17,7,9,7,-4,11,Arizona,me,,per,PROPN,PRON,pobj,nsubj,NNP,PRP,4,1
2150,2109.0,41,known,4,25,32,7,24,8,-21,28,Derek and the Dominos,Jim Gordon,---,org-org,PROPN-CCONJ-DET-PROPN,PROPN-PROPN,nsubj-cc-det-conj,compound-compound,NNP-CC-DT-NNP,NNP-NNP,5,1
2151,2110.0,47,received,1,32,44,12,31,2,-31,43,Schofield Barracks,25th Infantry Division,org-org,--,PROPN-PROPN,NOUN-PROPN-PROPN,compound-compound,compound-compound-pobj,NNP-NNP,NN-NNP-NNP,5,1
2152,2111.0,22,supported,10,1,3,2,0,18,9,-7,Talabani,Patriotic Union of Kurdistan,org,---,PROPN,PROPN-PROPN-ADP-PROPN,poss,compound-nsubj-prep-pobj,NNP,NNP-NNP-IN-NNP,2,1
2153,2112.0,21,appointed,4,10,15,5,9,5,-6,11,Aris T. Allen,Maryland,--,org,PROPN-PROPN-PROPN,PROPN,compound-compound-dobj,compound,NNP-NNP-NNP,NNP,3,1
2154,2113.0,16,born,2,9,14,5,8,1,-7,12,Edward Hoos,New Jersey,-,org-org,PROPN-PROPN,PROPN-PROPN,compound-pobj,compound-pobj,NNP-NNP,NNP-NNP,2,1
2155,2114.0,38,failed,10,31,5,-26,30,32,-21,-5,Father Lawrence Andrew,the Herald,per-per-per,-,PROPN-PROPN-PROPN,DET-PROPN,compound-compound-compound,det-pobj,NNP-NNP-NNP,DT-NNP,7,1
2156,2115.0,28,contacted,5,3,15,12,2,12,2,10,Liverpool,his,per,,PROPN,DET,pobj,poss,NNP,PRP$,4,1
2157,2116.0,25,elected,3,15,24,9,14,0,-12,21,David Christopherson,Ontario,per-per,,PROPN-PROPN,PROPN,compound-nsubjpass,pobj,NNP-NNP,NNP,5,1
2158,2117.0,30,was,1,6,19,13,5,10,-5,18,Union for Europe of the Nations,Fianna,-----,per,PROPN-ADP-PROPN-ADP-DET-PROPN,PROPN,pobj-prep-pobj-prep-det-compound,nsubj,NNP-IN-NNP-IN-DT-NNPS,NNP,7,1
2159,2118.0,26,born,4,2,11,9,1,14,2,7,Ingmar Bergman,Sweden,-,org,PROPN-PROPN,PROPN,compound-nsubjpass,pobj,NNP-NNP,NNP,2,1
2160,2119.0,39,grew,2,10,21,11,9,17,-8,19,Henry Pelham,Exchequer,org-org,,PROPN-PROPN,PROPN,compound-pobj,pobj,NNP-NNP,NNP,5,1
2161,2120.0,20,followed,6,8,11,3,7,8,-2,5,Duffy,Slaughter the Dogs,,per-per-per,PROPN,PROPN-DET-PROPN,dobj,dobj-det-appos,NNP,NNP-DT-NNP,4,1
2162,2121.0,36,is,3,1,13,12,0,22,2,10,Rockland Community College,New York,--,per-per,PROPN-PROPN-PROPN,PROPN-PROPN,compound-compound-nsubj,compound-pobj,NNP-NNP-NNP,NNP-NNP,6,1
2163,2122.0,76,lost,19,3,73,70,2,2,16,54,French Polynesia,Temaru,org-org,,PROPN-PROPN,PROPN,amod-pobj,poss,NNP-NNP,NNP,11,1
2164,2123.0,28,based,1,5,23,18,4,4,-4,22,Los Angeles,Shaun Cassidy,-,org-org,PROPN-PROPN,PROPN-PROPN,compound-pobj,compound-appos,NNP-NNP,NNP-NNP,6,1
2165,2124.0,35,said,32,1,14,13,0,20,31,-18,Paul Stookey,Peter Paul and Mary,per-per,---,PROPN-PROPN,PROPN-PROPN-CCONJ-PROPN,compound-nsubj,compound-appos-cc-conj,NNP-NNP,NNP-NNP-CC-NNP,8,1
2166,2125.0,34,suffered,1,7,24,17,6,9,-6,23,Chris Adams,England,per-per,,PROPN-PROPN,PROPN,compound-nsubj,compound,NNP-NNP,NNP,10,1
2167,2126.0,26,said,15,12,25,13,11,0,3,10,Shah Mehmood Qureshi,Pakistan,--,org,PROPN-PROPN-PROPN,PROPN,compound-compound-compound,pobj,NNP-NNP-NNP,NNP,9,1
2168,2127.0,20,is,2,11,18,7,10,1,-9,16,Spirit,Randy California,,per-per,PROPN,PROPN-PROPN,pobj,compound-ROOT,NNP,NNP-NNP,5,1
2169,2128.0,36,is,29,7,12,5,6,23,22,-17,Cramlington Junior Learning Village,2008,per-per-per-per,,PROPN-PROPN-PROPN-PROPN,NUM,compound-compound-compound-nsubj,dobj,NNP-NNP-NNP-NNP,CD,3,1
2170,2129.0,57,accused,16,18,24,6,17,32,-2,8,Uptown,Sean Combs,org,-,PROPN,PROPN-PROPN,compound,compound-dobj,NNP,NNP-NNPS,2,1
2171,2130.0,35,expanded,4,9,9,0,8,25,-5,5,BAE Systems,BAE Systems Land and Armaments,per-per,----,PROPN-PROPN,PROPN-PROPN-PROPN-CCONJ-PROPN,compound-nsubj,compound-compound-dobj-cc-conj,NNP-NNPS,NNP-NNPS-NNP-CC-NNPS,0,1
2172,2131.0,50,were,45,23,32,9,22,17,22,-13,Peter Franchot,Maryland,per-per,,PROPN-PROPN,PROPN,compound-compound,nmod,NNP-NNP,NNP,5,1
2173,2132.0,18,served,2,11,14,3,10,3,-9,12,Gannon University,Pennsylvania,-,org,PROPN-PROPN,PROPN,compound-pobj,pobj,NNP-NNP,NNP,3,1
2174,2133.0,29,were,21,4,7,3,3,21,17,-14,Fillmore,New York,org,-,PROPN,PROPN-PROPN,nsubjpass,compound-compound,NNP,NNP-NNP,4,1
2175,2134.0,29,stated,12,10,14,4,9,14,2,2,Big Machine,Taylor,-,per,PROPN-PROPN,PROPN,compound-compound,compound,NNP-NNP,NNP,6,1
2176,2135.0,20,trees,4,10,12,2,9,7,-6,8,CNU,Daejeon,,per,PROPN,PROPN,poss,compound,NNP,NNP,3,1
2177,2136.0,31,University,2,1,18,17,0,12,1,16,Clark Atlanta University,SIAC,per-per-per,,PROPN-PROPN-PROPN,PROPN,compound-compound-ROOT,appos,NNP-NNP-NNP,NNP,7,1
2178,2137.0,19,is,3,1,15,14,0,3,2,12,The Peninsula School,Mount Eliza,per-per-per,-,DET-PROPN-PROPN,PROPN-PROPN,det-compound-nsubj,compound-compound,DT-NNP-NNP,NNP-NNP,6,1
2179,2138.0,45,sent,23,4,11,7,3,33,19,-12,England,Thomas Wolsey,per,-,PROPN,PROPN-PROPN,pobj,compound-pobj,NNP,NNP-NNP,4,1
2180,2139.0,49,transliterated,5,1,19,18,0,29,4,14,Royal Jordanian,Jordan,org-org,,ADJ-PROPN,PROPN,compound-compound,pobj,JJ-NNP,NNP,4,1
2181,2140.0,39,is,2,1,24,23,0,14,1,22,Tinted Windows,Adam Schlesinger,org-org,-,PROPN-PROPN,PROPN-PROPN,amod-nsubj,compound-pobj,NNP-NNP,NNP-NNP,5,1
2182,2141.0,27,Finance,0,20,26,6,19,0,-20,26,Jetstar Airways,Qantas,-,per,PROPN-PROPN,PROPN,compound-pobj,pobj,NNP-NNP,NNP,3,1
2183,2142.0,33,spent,1,7,9,2,6,23,-6,8,Bundesliga,Bayer 04 Leverkusen,org,--,PROPN,PROPN-NUM-PROPN,pobj,pobj-nummod-dobj,NNP,NNP-CD-NNP,3,1
2184,2143.0,16,located,10,7,14,7,6,1,3,4,Kwansei Gakuin University,Hyg,per-per-per,,PROPN-PROPN-PROPN,PROPN,compound-compound-pobj,compound,NNP-NNP-NNP,NNP,5,1
2185,2144.0,41,elevated,21,23,23,0,22,17,-2,2,Savannah State College,Savannah State University,org-org-org,--,PROPN-PROPN-PROPN,PROPN-PROPN-PROPN,compound-compound-dobj,compound-compound-pobj,NNP-NNP-NNP,NNP-NNP-NNP,0,1
2186,2145.0,34,was,23,9,20,11,8,13,14,-3,Megawati Sukarnoputri,Indonesia,per-per,,PROPN-PROPN,PROPN,compound-nmod,pobj,NNP-NNP,NNP,3,1
2187,2146.0,35,are,2,11,29,18,10,5,-9,27,Kilmarnock,Ben Johnston,,per-per,PROPN,PROPN-PROPN,compound,compound-conj,NNP,NNP-NNP,-1,1
2188,2147.0,34,released,1,1,15,14,0,18,0,14,Costello,Lost Highway,org,-,PROPN,PROPN-PROPN,nsubj,compound-compound,NNP,NNP-NNP,7,1
2189,2148.0,22,come,19,3,8,5,2,13,16,-11,Paul McCartney,artist,-,org,PROPN-PROPN,NOUN,compound-dative,appos,NNP-NNP,NN,3,1
2190,2149.0,52,announced,3,14,33,19,13,18,-11,30,New Democratic Party,Andrea Horwath,org-org-org,-,PROPN-PROPN-PROPN,PROPN-PROPN,compound-compound-pobj,compound-conj,NNP-NNP-NNP,NNP-NNP,-1,1
2191,2150.0,27,was,1,11,25,14,10,1,-10,24,Salem College,1772,-,per,PROPN-PROPN,NUM,compound-pobj,pobj,NNP-NNP,CD,4,1
2192,2151.0,25,is,12,1,18,17,0,6,11,6,Nicolas Maranda,musician,org-org,,PROPN-PROPN,NOUN,compound-nsubj,nmod,NNP-NNP,NN,3,1
2193,2152.0,16,owns,1,8,10,2,7,5,-7,9,Venezuela,Canal i,,per-per,PROPN,PROPN-PRON,pobj,oprd-nsubj,NNP,NNP-PRP,3,1
2194,2153.0,19,Arundale,2,1,16,15,0,2,1,14,Rukmini Devi Arundale,Chennai,--,org,PROPN-PROPN-PROPN,PROPN,compound-compound-ROOT,pobj,NNP-NNP-NNP,NNP,2,1
2195,2154.0,15,finished,1,8,12,4,7,2,-7,11,David Caplan,Ontario,org-org,,PROPN-PROPN,PROPN,compound-appos,compound,NNP-NNP,NNP,3,1
2196,2155.0,34,came,1,4,18,14,3,15,-3,17,Tokyo,Kuroda Seiki,org,-,PROPN,PROPN-PROPN,pobj,compound-conj,NNP,NNP-NNP,7,1
2197,2156.0,23,is,1,10,12,2,9,10,-9,11,Indonesia,Yudhoyono,,org,PROPN,PROPN,appos,nsubj,NNP,NNP,-1,1
2198,2157.0,23,is,2,11,14,3,10,8,-9,12,Plies,Atlantic Records,per,-,NOUN,PROPN-PROPN,pobj,compound-pobj,NNS,NNP-NNPS,2,1
2199,2158.0,43,come,21,12,15,3,11,27,9,-6,New York,John D. Rockefeller,-,per-per-per,PROPN-PROPN,PROPN-PROPN-PROPN,compound-pobj,compound-compound-appos,NNP-NNP,NNP-NNP-NNP,6,1
2200,2159.0,13,are,4,1,7,6,0,5,3,3,United Utilities,Warrington,per-per,,PROPN-PROPN,PROPN,compound-poss,pobj,NNP-NNP,NNP,3,1
2201,2160.0,16,known,10,5,7,2,4,8,5,-3,Lois Hirshkowitz,Monmouth Academy,per-per,-,PROPN-PROPN,PROPN-PROPN,compound-compound,compound-pobj,NNP-NNP,NNP-NNP,1,1
2202,2161.0,20,attended,1,3,7,4,2,12,-2,6,Granby High School,Norfolk,--,per,PROPN-PROPN-PROPN,PROPN,compound-compound-dobj,pobj,NNP-NNP-NNP,NNP,4,1
2203,2162.0,24,opened,5,3,13,10,2,10,2,8,King Arthur Flour,Vermont,org-org-org,,PROPN-PROPN-PROPN,PROPN,compound-compound-nsubj,pobj,NNP-NNP-NNP,NNP,3,1
2204,2163.0,47,appointed,2,42,44,2,41,2,-40,42,Hong Kong,University Grants Committee,per-per,--,PROPN-PROPN,PROPN-PROPN-PROPN,compound-compound,compound-compound-conj,NNP-NNP,NNP-NNPS-NNP,2,1
2205,2164.0,26,changed,9,5,6,1,4,19,4,-3,Australia,Blasko,,org,PROPN,PROPN,compound,poss,NNP,NNP,1,1
2206,2165.0,51,is,12,11,30,19,10,20,1,18,England,Dire Straits,per,-,PROPN,PROPN-PROPN,npadvmod,compound-appos,NNP,NNP-NNPS,9,1
2207,2167.0,60,is,6,1,9,8,0,50,5,3,Mark Williams,New Zealand,-,per-per,PROPN-PROPN,PROPN-PROPN,compound-nsubj,compound-nmod,NNP-NNP,NNP-NNP,4,1
2208,2168.0,10,executive,2,2,5,3,1,4,0,3,Anheuser-Busch,August Busch,,per-per,ADJ,PROPN-PROPN,amod,compound-nsubj,JJ,NNP-NNP,3,1
2209,2169.0,36,is,1,18,21,3,17,14,-17,20,India,Punjab National Bank,per,--,PROPN,PROPN-PROPN-PROPN,pobj,compound-compound-compound,NNP,NNP-NNP-NNP,3,1
2210,2170.0,28,sold,6,4,27,23,3,0,2,21,Kaija Koo,Finland,-,per,PROPN-PROPN,PROPN,compound-nsubj,pobj,NNP-NNP,NNP,6,1
2211,2171.0,33,awarded,4,14,26,12,13,6,-10,22,Bellevue College,Washington,org-org,,PROPN-PROPN,PROPN,compound-pobj,nmod,NNP-NNP,NNP,9,1
2212,2173.0,25,was,11,1,17,16,0,7,10,6,Francis Lightfoot Lee,House of Burgesses,org-org-org,--,PROPN-PROPN-PROPN,PROPN-ADP-PROPN,compound-compound-nsubj,pobj-prep-pobj,NNP-NNP-NNP,NNP-IN-NNP,6,1
2213,2174.0,43,won,1,23,27,4,22,15,-22,26,Fox Broadcasting Company,Barry Diller,org-org-org,-,PROPN-PROPN-PROPN,PROPN-PROPN,compound-compound-compound,compound-dobj,NNP-NNP-NNP,NNP-NNP,6,1
2214,2176.0,33,co-developed,2,27,31,4,26,1,-25,29,Edwin R. Gilliland,MIT,--,per,PROPN-PROPN-PROPN,PROPN,compound-compound-pobj,compound,NNP-NNP-NNP,NNP,3,1
2215,2177.0,14,identified,7,4,5,1,3,8,3,-2,author,Neil Peart,,per-per,NOUN,PROPN-PROPN,compound,compound-conj,NN,NNP-NNP,1,1
2216,2178.0,33,merged,5,9,23,14,8,9,-4,18,Leyland Motor Corporation,British Leyland,per-per-per,-,PROPN-PROPN-PROPN,PROPN-PROPN,compound-compound-dobj,compound-compound,NNP-NNP-NNP,NNP-NNP,7,1
2217,2761.0,20,incorporated,8,12,16,4,11,3,-4,8,Leyland Motor Corporation,British Leyland,--,per-per,PROPN-PROPN-PROPN,PROPN-PROPN,compound-compound-pobj,compound-oprd,NNP-NNP-NNP,NNP-NNP,4,1
2218,2179.0,37,Texas,1,2,26,24,1,10,-1,25,Texas,he,per,,PROPN,PRON,ROOT,nsubjpass,NNP,PRP,10,1
2219,2180.0,32,intensifying,30,3,15,12,2,16,27,-15,Mao,Congress,org,,PROPN,PROPN,poss,pobj,NNP,NNP,6,1
2220,2181.0,21,named,6,16,19,3,15,1,-10,13,Republic,Chiang Kai-shek,,org-org,PROPN,PROPN-PROPN,nmod,compound-pobj,NNP,NNP-NNP,4,1
2221,2182.0,21,hosted,5,11,15,4,10,5,-6,10,Bobby Limb,Dawn Lake,per-per,-,PROPN-PROPN,PROPN-PROPN,compound-pobj,compound-appos,NNP-NNP,NNP-NNP,2,1
2222,2183.0,27,had,1,7,14,7,6,12,-6,13,Arkansas,University of Arkansas,org,--,PROPN,PROPN-ADP-PROPN,pobj,nmod-prep-pobj,NNP,NNP-IN-NNP,6,1
2223,2184.0,19,taught,11,10,14,4,9,4,1,3,Judge,New York,,org-org,PROPN,PROPN-PROPN,compound,compound-nmod,NNP,NNP-NNP,5,1
2224,2185.0,46,plan,1,26,35,9,25,10,-25,34,New Mexico,Pat Garrett,per-per,-,PROPN-PROPN,PROPN-PROPN,compound-compound,compound-appos,NNP-NNP,NNP-NNP,11,1
2225,2186.0,17,is,9,1,16,15,0,0,8,7,Edward Petherbridge,artist,org-org,,PROPN-PROPN,NOUN,compound-nsubj,conj,NNP-NNP,NN,2,1
2226,2187.0,75,reactivated,3,32,55,23,31,19,-29,52,California National Guard,40th Infantry Division,org-org-org,--,PROPN-PROPN-PROPN,PROPN-PROPN-PROPN,compound-compound-compound,compound-compound-pobj,NNP-NNP-NNP,NNP-NNP-NNP,-1,1
2227,2188.0,26,had,1,8,23,15,7,2,-7,22,1974,Greater Manchester Police,per,--,NUM,PROPN-PROPN-PROPN,pobj,compound-compound-dobj,CD,NNP-NNP-NNP,4,1
2228,2189.0,33,After,0,25,31,6,24,1,-25,31,Errol Barrow,Prime Minister,-,per-per,PROPN-PROPN,PROPN-PROPN,compound-nsubj,compound-pobj,NNP-NNP,NNP-NNP,3,1
2229,2190.0,26,contains,3,15,24,9,14,1,-12,21,Gackt,Nippon Crown,,org-org,PROPN,PROPN-PROPN,conj,compound-pobj,NNP,NNP-NNP,6,1
2230,2191.0,16,married,1,9,13,4,8,2,-8,12,Connecticut,Roger Sherman,,per-per,PROPN,PROPN-PROPN,compound,compound-compound,NNP,NNP-NNP,3,1
2231,2192.0,23,includes,8,1,8,7,0,14,7,0,KVCC,Kalamazoo,per,,PROPN,PROPN,poss,pobj,NNP,NNP,3,1
2232,2193.0,43,were,1,1,37,36,0,5,0,36,Purplene,Sydney,,per,NOUN,PROPN,nsubj,poss,NNS,NNP,8,1
2233,2194.0,36,won,6,3,6,3,2,29,3,0,Gerhard Ertl,Germany,org-org,,PROPN-PROPN,PROPN,compound-nsubj,pobj,NNP-NNP,NNP,1,1
2234,2195.0,29,found,4,12,26,14,11,2,-8,22,New England Sports Network,Red Sox,per-per-per-per,-,PROPN-PROPN-PROPN-PROPN,PROPN-PROPN,compound-compound-compound-pobj,compound-compound,NNP-NNP-NNPS-NNP,NNP-NNPS,10,1
2235,2196.0,28,is,9,15,22,7,14,5,-6,13,screenwriter,Kevin Smith,,org-org,NOUN,PROPN-PROPN,nmod,compound-pobj,NN,NNP-NNP,5,1
2236,2197.0,37,said,16,6,15,9,5,21,10,-1,Monsanto,Hugh Grant,org,-,PROPN,PROPN-PROPN,poss,compound-appos,NNP,NNP-NNP,7,1
2237,2198.0,28,represents,6,2,17,15,1,10,4,11,Louisiana Tech Bulldogs,Division I,--,per-per,PROPN-PROPN-PROPN,PROPN-PROPN,compound-compound-compound,nmod-compound,NNP-NNP-NNP,NNP-NNP,8,1
2238,2199.0,14,was,1,1,12,11,0,1,0,11,It,Harpur Trust,per,-,PRON,PROPN-PROPN,nsubj,compound-pobj,PRP,NNP-NNP,8,1
2239,2200.0,28,is,19,1,18,17,0,9,18,-1,Tila Tequila,Miss,org-org,,PROPN-PROPN,PROPN,compound-appos,compound,NNP-NNP,NNP,5,1
2240,2201.0,29,managed,3,1,7,6,0,21,2,4,Firefly,Malaysia Airlines,,org-org,PROPN,PROPN-PROPN,nsubjpass,compound-pobj,NNP,NNP-NNPS,3,1
2241,2202.0,25,received,8,6,18,12,5,6,2,10,Mircea Druc,Moldova,per-per,,PROPN-PROPN,PROPN,compound-compound,pobj,NNP-NNP,NNP,3,1
2242,2203.0,37,began,5,2,4,2,1,32,3,-1,his,England,per,,DET,PROPN,poss,compound,PRP$,NNP,1,1
2243,2205.0,19,fronted,6,2,16,14,1,2,4,10,Sugarland,Jennifer Nettles,org,-,PROPN,PROPN-PROPN,poss,compound-compound,NNP,NNP-NNP,7,1
2244,2206.0,25,is,12,2,23,21,1,1,10,11,Moses H. Cone Memorial Hospital,North Carolina,per-per-per-per-per,-,PROPN-PROPN-PROPN-PROPN-PROPN,PROPN-PROPN,compound-compound-compound-compound-nsubj,compound-pobj,NNP-NNP-NNP-NNP-NNP,NNP-NNP,7,1
2245,2207.0,17,received,1,9,10,1,8,6,-8,9,singer,Katherine Jenkins,per,-,NOUN,PROPN-PROPN,compound,compound-pobj,NN,NNP-NNP,1,1
2246,2208.0,108,features,2,63,34,-29,62,73,-61,32,Emma Bonino,Italian,org-org,,PROPN-PROPN,ADJ,nmod-pobj,amod,NNP-NNP,JJ,7,1
2247,2209.0,81,slated,7,18,38,20,17,42,-11,31,Metallica,Lars Ulrich,,per-per,PROPN,PROPN-PROPN,pobj,compound-dobj,NNP,NNP-NNP,3,1
2248,2211.0,19,was,8,2,7,5,1,11,6,-1,Aircraft Manufacturing Company,Airco,--,org,PROPN-PROPN-PROPN,PROPN,compound-compound-nmod,nsubj,NNP-NNP-NNP,NNP,3,1
2249,2212.0,16,was,11,1,15,14,0,0,10,4,Paul Doughty Bartlett,chemist,per-per-per,,PROPN-PROPN-PROPN,NOUN,compound-compound-nsubj,attr,NNP-NNP-NNP,NN,3,1
2250,2214.0,47,sued,4,18,4,-14,17,42,-14,0,San Fernando High School,Gutierrez,---,org,PROPN-PROPN-PROPN-PROPN,PROPN,compound-compound-compound-pobj,nsubj,NNP-NNP-NNP-NNP,NNP,8,1
2251,2215.0,7,Buckinghamshire,5,2,6,4,1,0,3,1,Misbourne School,Buckinghamshire,org-org,,PROPN-PROPN,PROPN,compound-compound,ROOT,NNP-NNP,NNP,2,1
2252,2216.0,29,included,8,4,12,8,3,16,4,4,Essendon,Clyde Donaldson,per,-,PROPN,PROPN-PROPN,poss,compound-compound,NNP,NNP-NNP,8,1
2253,2217.0,15,dated,5,9,11,2,8,3,-4,6,1928,Anhui University,per,-,NUM,PROPN-PROPN,pobj,compound-nsubjpass,CD,NNP-NNP,2,1
2254,2218.0,38,Along,0,27,29,2,26,8,-27,29,Justice,Clemente Mastella,,per-per,PROPN,PROPN-PROPN,compound,compound-pobj,NNP,NNP-NNP,3,1
2255,2219.0,22,said,1,8,15,7,7,6,-7,14,Guebuza,Mozambique,org,,PROPN,PROPN,poss,dobj,NNP,NNP,4,1
2256,2220.0,24,became,1,1,8,7,0,15,0,7,He,Venezuela,,per,PRON,PROPN,nsubj,pobj,PRP,NNP,1,1
2257,2221.0,20,were,7,5,13,8,4,6,2,6,Kings,United States,per,-,NOUN,PROPN-PROPN,nsubj,compound-pobj,NNS,NNP-NNP,5,1
2258,2222.0,25,was,10,1,17,16,0,7,9,7,Samuel Prentiss,Vermont,-,per,PROPN-PROPN,PROPN,compound-nsubj,pobj,NNP-NNP,NNP,2,1
2259,2223.0,41,citing,4,14,23,9,13,17,-10,19,England,Brian Eno,,per-per,PROPN,PROPN-PROPN,pobj,compound-compound,NNP,NNP-NNP,15,1
2260,2224.0,33,was,7,6,14,8,5,18,1,7,Soviet Union,Gorbachev,-,org,PROPN-PROPN,PROPN,compound-pobj,dobj,NNP-NNP,NNP,6,1
2261,2226.0,36,operated,8,7,15,8,6,20,1,7,Lee Payant,France,per-per,,PROPN-PROPN,PROPN,compound-conj,nsubj,NNP-NNP,NNP,4,1
2262,2227.0,19,awarded,12,11,18,7,10,0,1,6,India,university,per,,PROPN,NOUN,pobj,pobj,NNP,NN,2,1
2263,2228.0,29,is,15,1,1,0,0,27,14,-14,Dwight Muhammad Qawi,Dwight Braxton,org-org-org,-,PROPN-PROPN-PROPN,PROPN-PROPN,compound-compound-nsubj,compound-dobj,NNP-NNP-NNP,NNP-NNP,0,1
2264,2229.0,70,quoted,7,5,16,11,4,53,2,9,Majestic Studios,Tim Croucher,org-org,-,PROPN-PROPN,PROPN-PROPN,compound-nsubjpass,compound-pobj,NNP-NNPS,NNP-NNP,5,1
2265,2230.0,38,alleged,2,11,30,19,10,7,-9,28,George Mason University,Division I,--,per-per,PROPN-PROPN-PROPN,PROPN-PRON,compound-compound-attr,compound-compound,NNP-NNP-NNP,NNP-PRP,12,1
2266,2231.0,25,competing,4,2,9,7,1,15,2,5,Adams,Texas,,org,PROPN,PROPN,nsubj,pobj,NNP,NNP,4,1
2267,2232.0,22,is,13,2,2,0,1,19,11,-11,Caracas Stock Exchange,Caracas,--,per,PROPN-PROPN-PROPN,PROPN,compound-compound-nsubj,conj,NNP-NNP-NNP,NNP,0,1
2268,2233.0,56,holds,1,28,35,7,27,20,-27,34,e Central European Universit,; Hungar,per-per-per-per,-,NUM-ADJ-PROPN-PROPN,PUNCT-PROPN,compound-compound-compound-compound,punct-npadvmod,CD-JJ-NNP-NNP,:-NNP,-1,1
2269,2234.0,78,was,5,45,46,1,44,31,-40,41,Patrick Swayze,Swayze,per-per,,PROPN-PROPN,PROPN,compound-appos,nsubj,NNP-NNP,NNP,1,1
2270,2235.0,20,founded,4,1,7,6,0,12,3,3,American Laser Centers,2002,per-per-per,,PROPN-PROPN-PROPN,NUM,compound-compound-nsubjpass,pobj,NNP-NNP-NNPS,CD,3,1
2271,2236.0,37,speculated,2,5,19,14,4,17,-3,17,Villepin,Minister,per,,PROPN,PROPN,nsubj,pobj,NNP,NNP,3,1
2272,2237.0,34,came,2,1,2,1,0,31,1,0,Mamiya,Juka,,per,PROPN,PROPN,compound,nsubj,NNP,NNP,1,1
2273,2238.0,17,shot,4,1,3,2,0,13,3,-1,Commerce,Harry Hopkins,,per-per,PROPN,PROPN-PROPN,compound,compound-nsubj,NNP,NNP-NNP,1,1
2274,2239.0,26,called,1,1,8,7,0,17,0,7,Newman,Los Angeles,org,-,NOUN,PROPN-PROPN,nsubj,compound-pobj,NN,NNP-NNP,4,1
2275,2240.0,18,emerged,8,8,12,4,7,5,0,4,ANC,Mbeki,per,,PROPN,PROPN,pobj,nsubjpass,NNP,NNP,2,1
2276,2241.0,35,released,13,3,26,23,2,8,10,13,Ciara,United States,,org-org,PROPN,PROPN-PROPN,pobj,compound-pobj,NNP,NNP-NNP,9,1
2277,2242.0,26,is,1,9,9,0,8,16,-8,8,Osaka University of Economics,Osaka,per-per-per-per,,PROPN-PROPN-ADP-PROPN,PROPN,compound-pobj-prep-pobj,compound,NNP-NNP-IN-NNP,NNP,0,1
2278,2243.0,25,is,1,1,15,14,0,9,0,14,Copps,Ontario,org,,PROPN,PROPN,nsubj,compound,NNP,NNP,8,1
2279,2245.0,30,was,4,15,15,0,14,14,-11,11,n TFF First Leagu,n Turke,per-per-per-per,-,CCONJ-PROPN-PROPN-PROPN,CCONJ-PROPN,ROOT-compound-compound-compound,ROOT-compound,CC-NNP-NNP-NNP,CC-NNP,0,1
2280,2246.0,35,chronicled,5,27,32,5,26,2,-22,27,Walt Whitman High School,Bethesda,org-org-org-org,,PROPN-PROPN-PROPN-PROPN,PROPN,compound-compound-compound-appos,compound,NNP-NNP-NNP-NNP,NNP,3,1
2281,2247.0,25,called,2,12,15,3,11,9,-10,13,Ron Wyden,Oregon,org-org,,PROPN-PROPN,PROPN,compound-pobj,pobj,NNP-NNP,NNP,2,1
2282,2248.0,16,is,5,2,3,1,1,12,3,-2,Central California Traction,California,per-per-per,,PROPN-PROPN-PROPN,PROPN,compound-compound-compound,pobj,NNP-NNP-NNP,NNP,2,1
2283,2249.0,21,is,8,1,3,2,0,17,7,-5,CPTM,Companhia Paulista de Trens Metropolitanos,org,----,PROPN,PROPN-PROPN-PROPN-PROPN-PROPN,nsubj,compound-compound-compound-compound-appos,NNP,NNP-NNP-NNP-NNP-NNP,2,1
2284,2250.0,8,is,2,1,5,4,0,2,1,3,Jason Collett,Toronto,per-per,,PROPN-PROPN,PROPN,compound-nsubj,npadvmod,NNP-NNP,NNP,3,1
2285,2251.0,18,is,3,2,16,14,1,1,1,13,Kelsey-Seybold Clinic,Houston,-,per,PROPN-PROPN,PROPN,compound-nsubj,compound,NNP-NNP,NNP,8,1
2286,2252.0,18,Press,16,5,7,2,4,10,11,-9,Lund University,Sweden,-,per,PROPN-PROPN,PROPN,compound-compound,nmod,NNP-NNP,NNP,1,1
2287,2253.0,26,re-incorporated,12,2,18,16,1,7,10,6,1906,Brooklyn Eastern District Terminal,per,---,NUM,PROPN-PROPN-PROPN-PROPN,pobj,compound-compound-compound-pobj,CD,NNP-NNP-NNP-NNP,5,1
2288,2254.0,35,is,7,13,25,12,12,9,-6,18,Scotland,University of Aberdeen,,per-per-per,PROPN,PROPN-ADP-PROPN,pobj,poss-prep-pobj,NNP,NNP-IN-NNP,6,1
2289,2255.0,36,served,25,18,3,-15,17,32,7,-22,Democratic Kampuchea,he,per-per,,PROPN-PROPN,PRON,compound-pobj,nsubj,NNP-NNP,PRP,9,1
2290,2256.0,14,is,2,6,7,1,5,6,-4,5,Young,NTUC,org,,PROPN,PROPN,compound,compound,NNP,NNP,1,1
2291,2257.0,20,were,6,2,2,0,1,17,4,-4,Boston University,Boston,per-per,,PROPN-PROPN,PROPN,compound-compound,compound,NNP-NNP,NNP,0,1
2292,2258.0,27,stated,1,14,19,5,13,7,-13,18,ATO,his,,org,PROPN,DET,pobj,poss,NNP,PRP$,5,1
2293,2259.0,13,is,1,3,11,8,2,1,-2,10,David Knopfler,Dire Straits,org-org,-,PROPN-PROPN,PROPN-PROPN,compound-poss,compound-dobj,NNP-NNP,NNP-NNPS,5,1
2294,2260.0,34,exhibit,21,9,11,2,8,22,12,-10,Proof,D12,org,,PROPN,PROPN,dobj,pobj,NNP,NNP,4,1
2295,2261.0,23,followed,3,3,22,19,2,0,0,19,Orbison,USA,per,,PROPN,PROPN,conj,pobj,NNP,NNP,1,1
2296,2262.0,27,attended,5,8,14,6,7,12,-3,9,Episode Six,Gillan,org-org,,PROPN-NUM,PROPN,compound-nummod,pobj,NNP-CD,NNP,5,1
2297,2263.0,35,reached,1,10,17,7,9,17,-9,16,Greek Super League,Cup,--,org,PROPN-PROPN-PROPN,PROPN,compound-compound-pobj,compound,NNP-NNP-NNP,NNP,6,1
2298,2264.0,20,established,3,5,10,5,4,9,-2,7,Telecom Italia Mobile,Italy,per-per-per,,PROPN-PROPN-PROPN,PROPN,compound-compound-compound,dobj,NNP-NNP-NNP,NNP,5,1
2299,2265.0,37,is,24,8,1,-7,7,35,16,-23,Roman Catholic,De Lisle Catholic Science College,org-org,----,PROPN-PROPN,PROPN-PROPN-PROPN-PROPN-PROPN,compound-compound,compound-compound-compound-compound-appos,NNP-NNP,NNP-NNP-NNP-NNP-NNP,3,1
2300,2266.0,15,born,3,1,14,13,0,0,2,11,Bismillah Khan,India,org-org,,PROPN-PROPN,PROPN,compound-nsubjpass,pobj,NNP-NNP,NNP,2,1
2301,2267.0,24,is,3,8,11,3,7,12,-5,8,Baltimore,Dan Deacon,,org-org,PROPN,PROPN-PROPN,nmod,compound-pobj,NNP,NNP-NNP,2,1
2302,2268.0,49,was,1,8,33,25,7,15,-7,32,Royal Bank of Scotland Group,ABN AMRO,----,org-org,PROPN-PROPN-ADP-PROPN-PROPN,PROPN-PROPN,compound-pobj-prep-compound-pobj,compound-compound,NNP-NNP-IN-NNP-NNP,NNP-NNP,9,1
2303,2269.0,34,is,1,8,25,17,7,8,-7,24,Douglas,Illinois,,per,PROPN,PROPN,nmod,compound,NNP,NNP,6,1
2304,2270.0,31,relocated,28,4,24,20,3,6,24,-4,London,Hanson HQ,,org-org,PROPN,PROPN-PROPN,compound,compound-compound,NNP,NNP-NNP,6,1
2305,2271.0,86,hosted,62,15,19,4,14,66,47,-43,Judi Sheppard Missett,Jazzercise,org-org-org,,PROPN-PROPN-PROPN,PROPN,compound-compound-nsubj,dobj,NNP-NNP-NNP,NNP,3,1
2306,2272.0,22,is,9,1,1,0,0,20,8,-8,Hunan University,Hunan,-,per,PROPN-PROPN,PROPN,compound-nsubj,compound,NNP-NNP,NNP,0,1
2307,2273.0,33,surged,3,3,32,29,2,0,0,29,Foxconn,Taiwan,per,,PROPN,PROPN,nsubj,pobj,NNP,NNP,4,1
2308,2275.0,50,coached,5,16,16,0,15,33,-11,11,Lake Forest High School,Lake Forest,per-per-per-per,-,PROPN-PROPN-PROPN-PROPN,PROPN-PROPN,compound-compound-compound-pobj,compound-compound,NNP-NNP-NNP-NNP,NNP-NNP,0,1
2309,2276.0,29,entered,5,1,3,2,0,25,4,-2,Eugene Stoner,Ares Incorporated,-,per-per,PROPN-PROPN,PROPN-PROPN,compound-compound,compound-nsubj,NNP-NNP,NNPS-NNP,1,1
2310,2277.0,17,is,3,2,2,0,1,14,1,-1,Sligo Weekender,Sligo,-,org,PROPN-PROPN,PROPN,compound-nsubj,compound,NNP-NNP,NNP,0,1
2311,2278.0,50,unsurpassed,7,19,22,3,18,27,-12,15,Youssou N'Dour,Senegal,org-org,,PROPN-PROPN,PROPN,compound-pobj,pobj,NNP-NNP,NNP,2,1
2312,2279.0,42,ended,10,22,24,2,21,17,-12,14,Defence,Peter MacKay,,org-org,PROPN,PROPN-PROPN,compound,compound-dobj,NNP,NNP-NNP,1,1
2313,2280.0,37,going,2,21,27,6,20,9,-19,25,Sir Philip Green,Arcadia group,per-per-per,-,PROPN-PROPN-PROPN,PROPN-NOUN,compound-compound-nsubj,compound-pobj,NNP-NNP-NNP,NNP-NN,4,1
2314,2281.0,36,calls,5,7,10,3,6,25,-2,5,Louisa Maria,Princess,-,per,PROPN-PROPN,PROPN,compound-dobj,appos,NNP-NNP,NNP,2,1
2315,2282.0,30,said,19,1,6,5,0,23,18,-13,Nova Scotia,Alexa McDonough,org-org,-,PROPN-PROPN,PROPN-PROPN,compound-compound,compound-nsubj,NNP-NNP,NNP-NNP,1,1
2316,2283.0,34,has,8,8,17,9,7,16,0,9,Halifax,instruments,per,,PROPN,NOUN,pobj,pobj,NNP,NNS,4,1
2317,2284.0,30,had,19,7,18,11,6,11,12,-1,Roger Moore,producer,-,org,PROPN-PROPN,NOUN,compound-pobj,appos,NNP-NNP,NN,8,1
2318,2285.0,57,started,1,49,56,7,48,0,-48,55,Moviecam,1976,,org,PROPN,NUM,pobj,pobj,NNP,CD,4,1
2319,2286.0,17,studied,2,6,12,6,5,4,-4,10,University of Leipzig,Wilhelm Ostwald,org-org-org,-,PROPN-ADP-PROPN,PROPN-PROPN,pobj-prep-pobj,compound-pobj,NNP-IN-NNP,NNP-NNP,5,1
2320,2287.0,49,took,8,3,12,9,2,36,5,4,Aftermath,Mel-Man,org,,PROPN,PROPN,compound,dobj,NNP,NNP,5,1
2321,2288.0,29,were,18,6,8,2,5,20,12,-10,Belgium,Dexia,per,,PROPN,PROPN,poss,nsubj,NNP,NNP,2,1
2322,2289.0,40,placed,14,9,13,4,8,26,5,-1,Gonzalo de Lozada,MNR,org-org-org,,PROPN-PROPN-PROPN,PROPN,nmod-nmod-appos,appos,NNP-NNP-NNP,NNP,2,1
2323,2290.0,31,04,2,4,11,7,3,19,-2,9,Kansas Jayhawks,University of Kansas,-,org-org-org,PROPN-PROPN,PROPN-ADP-PROPN,compound-compound,dobj-prep-pobj,NNP-NNP,NNP-IN-NNP,4,1
2324,2291.0,13,were,5,1,11,10,0,1,4,6,Burgundy,Aaron Neville,org,-,PROPN,PROPN-PROPN,poss,compound-conj,NNP,NNP-NNP,6,1
2325,2292.0,34,declared,21,9,17,8,8,16,12,-4,Thailand,Plaek Pibulsonggram,per,-,PROPN,PROPN-PROPN,pobj,compound-pobj,NNP,NNP-NNP,6,1
2326,2293.0,25,is,17,1,23,22,0,1,16,6,Andy Moor,Producer,-,per,PROPN-PROPN,PROPN,compound-nsubj,compound,NNP-NNP,NNP,3,1
2327,2294.0,19,issued,8,5,12,7,4,6,3,4,United States,Ronald Reagan,-,org-org,PROPN-PROPN,PROPN-PROPN,compound-compound,compound-nmod,NNP-NNP,NNP-NNP,6,1
2328,2295.0,40,became,4,3,18,15,2,21,1,14,Mario Menocal,Conservative Party,per-per,-,PROPN-PROPN,PROPN-PROPN,compound-nsubj,compound-dobj,NNP-NNP,NNP-NNP,5,1
2329,2296.0,16,served,3,1,13,12,0,2,2,10,California,Pasadena High School,,per-per-per,PROPN,PROPN-PROPN-PROPN,compound,compound-compound-conj,NNP,NNP-NNP-NNP,5,1
2330,2297.0,65,show,1,14,19,5,13,45,-13,18,Rob Halford,singer,-,per,PROPN-PROPN,NOUN,compound-ROOT,nsubj,NNP-NNP,NN,4,1
2331,2298.0,32,asked,6,4,5,1,3,26,2,-1,Chicago,Monroe Heath,per,-,PROPN,PROPN-PROPN,compound,compound-pobj,NNP,NNP-NNP,1,1
2332,2299.0,24,At,0,5,7,2,4,16,-5,7,Labor,Kevin Rudd,org,-,PROPN,PROPN-PROPN,compound,compound-poss,NNP,NNP-NNP,1,1
2333,2300.0,46,performed,2,9,14,5,8,31,-7,12,Robert B. Weaver III,The Paper Chase,org-org-org-org,--,PROPN-PROPN-PROPN-PROPN,DET-PROPN-PROPN,compound-compound-compound-pobj,det-compound-pobj,NNP-NNP-NNP-NNP,DT-NNP-NNP,4,1
2334,2301.0,31,founded,3,2,12,10,1,18,1,9,Transcript,Wentworth,,per,PROPN,PROPN,nsubjpass,conj,NNP,NNP,5,1
2335,2302.0,56,quoted,2,4,15,11,3,40,-2,13,Erik Prince,Blackwater Worldwide,-,per-per,PROPN-PROPN,PROPN-PROPN,compound-dobj,compound-pobj,NNP-NNP,NNP-NNP,3,1
2336,2303.0,33,is,14,6,20,14,5,12,8,6,Ares,guitarist,,org,PROPN,NOUN,pobj,attr,NNP,NN,6,1
2337,2304.0,40,said,29,31,38,7,30,1,-2,9,Joseph Sitt,Thor Equities,per-per,-,PROPN-VERB,PROPN-PROPN,compound-nsubj,compound-pobj,NNP-VBZ,NNP-NNP,15,1
2338,2305.0,51,built,11,6,14,8,5,36,5,3,Long Beach Museum of Art,1912,----,org,PROPN-PROPN-PROPN-ADP-PROPN,NUM,compound-compound-pobj-prep-pobj,pobj,NNP-NNP-NNP-IN-NNP,CD,6,1
2339,2306.0,46,is,12,1,20,19,0,25,11,8,A. Philip Randolph Academies of Technology,Jacksonville,-----,per,PROPN-PROPN-PROPN-PROPN-ADP-PROPN,PROPN,compound-compound-compound-nsubj-prep-pobj,compound,NNP-NNP-NNP-NNP-IN-NNP,NNP,7,1
2340,2307.0,42,run,31,2,26,24,1,15,29,-5,1943,ABC,,per,NUM,PROPN,pobj,dobj,CD,NNP,4,1
2341,2308.0,29,lived,4,7,27,20,6,1,-3,23,Frida Kahlo,Mexico,per-per,,PROPN-PROPN,PROPN,compound-compound,compound,NNP-NNP,NNP,8,1
2342,2309.0,16,attended,2,4,10,6,3,5,-2,8,St. Anthony Catholic High School,San Antonio,----,per-per,PROPN-PROPN-PROPN-PROPN-PROPN,PROPN-PROPN,compound-compound-compound-compound-dobj,compound-compound,NNP-NNP-NNP-NNP-NNP,NNP-NNP,4,1
2343,2310.0,32,present,13,5,8,3,4,23,8,-5,Adrian College,MI,per-per,,PROPN-PROPN,PROPN,compound-compound,compound,NNP-NNP,NNP,3,1
2344,2311.0,66,began,50,36,57,21,35,8,14,7,Canada,Teletoon,,org,PROPN,PROPN,pobj,pobj,NNP,NNP,8,1
2345,2312.0,13,is,1,10,11,1,9,1,-9,10,guitarist,Raul Seixas,per,-,NOUN,PROPN-PROPN,pobj,compound-appos,NN,NNP-NNP,1,1
2346,2313.0,32,honor,3,8,26,18,7,5,-5,23,Florida State University,Hugh Durham,--,per-per,PROPN-PROPN-PROPN,PROPN-PROPN,compound-compound-compound,compound-compound,NNP-NNP-NNP,NNP-NNP,13,1
2347,2314.0,34,announced,8,6,21,15,5,12,2,13,Dennis Publishing,Maxim,-,per,PROPN-PROPN,PROPN,compound-nsubj,pobj,NNP-NNP,NNP,7,1
2348,2315.0,54,was,7,1,9,8,0,44,6,2,Ontario,Edward Blake,,org-org,PROPN,PROPN-PROPN,poss,compound-attr,NNP,NNP-NNP,4,1
2349,2316.0,24,represents,9,4,19,15,3,4,5,10,Texas Tech Red Raiders,Division I,org-org-org-org,-,PROPN-PROPN-PROPN-PROPN,PROPN-PRON,compound-compound-compound-compound,pobj-nsubj,NNP-NNP-NNP-NNPS,NNP-PRP,8,1
2350,2317.0,34,confirmed,10,6,10,4,5,23,4,0,Omar Bongo,Gabon,-,org,PROPN-PROPN,PROPN,compound-compound,pobj,NNP-NNP,NNP,2,1
2351,2318.0,29,accused,1,3,16,13,2,12,-2,15,Tong Sang,French Polynesia,per-per,-,PROPN-PROPN,PROPN-PROPN,compound-dobj,compound-poss,NNP-NNP,NNP-NNP,8,1
2352,2319.0,23,warming,7,15,22,7,14,0,-8,15,Alberto Fujimori,Japan,-,org,PROPN-PROPN,PROPN,compound-nsubj,pobj,NNP-NNP,NNP,3,1
2353,2320.0,24,started,4,3,16,13,2,7,1,12,Castro,Israel,org,,PROPN,PROPN,compound,pobj,NNP,NNP,9,1
2354,2321.0,28,said,5,16,27,11,15,0,-11,22,HCL Technologies,India,org-org,,PROPN-PROPN,PROPN,compound-pobj,pobj,NNP-NNPS,NNP,5,1
2355,2322.0,32,decided,10,16,28,12,15,3,-6,18,Catherine of Aragon,Arthur Prince of Wales,--,org-org-org-org,PROPN-ADP-PROPN,PROPN-PROPN-ADP-PROPN,dobj-prep-pobj,compound-appos-prep-pobj,NNP-IN-NNP,NNP-NNP-IN-NNP,6,1
2356,2323.0,15,lost,2,11,13,2,10,1,-9,11,Conservative,Joy Smith,per,-,ADJ,PROPN-PROPN,amod,compound-pobj,JJ,NNP-NNP,1,1
2357,2324.0,29,represented,6,3,16,13,2,12,3,10,Connecticut Huskies,Division I FBS,org-org,--,PROPN-PROPN,PROPN-PRON-PROPN,compound-compound,compound-compound-compound,NNP-NNP,NNP-PRP-NNP,5,1
2358,2325.0,38,met,8,14,15,1,13,22,-6,7,Colombia,Enrique Olaya Herrera,org,--,PROPN,PROPN-PROPN-PROPN,compound,compound-compound-pobj,NNP,NNP-NNP-NNP,1,1
2359,2326.0,29,became,7,7,13,6,6,15,0,6,Serpell,Waingels Copse Comprehensive School,,org-org-org-org,PROPN,PROPN-PROPN-PROPN-PROPN,nsubj,compound-compound-compound-pobj,NNP,NNP-NNP-NNP-NNP,6,1
2360,2328.0,17,included,5,9,13,4,8,3,-4,8,William Hale Thompson,Illinois,--,per,PROPN-PROPN-PROPN,PROPN,compound-compound-dobj,compound,NNP-NNP-NNP,NNP,3,1
2361,2329.0,33,noted,14,24,31,7,23,1,-10,17,Ian Smith,South Africa,-,org-org,PROPN-PROPN,PROPN-PROPN,compound-poss,compound-conj,NNP-NNP,NNP-NNP,4,1
2362,2330.0,29,hopes,4,17,19,2,16,9,-13,15,OL,Olympique Lyonnais,,per-per,PROPN,PROPN-PROPN,nmod,compound-nmod,NNP,NNP-NNP,2,1
2363,2331.0,22,grew,1,1,8,7,0,13,0,7,He,Brooklyn,,org,PRON,PROPN,nsubj,compound,PRP,NNP,3,1
2364,2332.0,18,born,2,1,7,6,0,10,1,5,Mitsuda,Japan,per,,PROPN,PROPN,nsubjpass,pobj,NNP,NNP,2,1
2365,2333.0,41,referred,4,33,37,4,32,3,-29,33,Team CSC,UCI ProTour,per-per,-,PROPN-PROPN,PROPN-PROPN,compound-pobj,compound-compound,NNP-NNP,NNP-NNP,5,1
2366,2334.0,9,opened,3,2,8,6,1,0,1,5,University,1918,per,,PROPN,NUM,nsubjpass,nummod,NNP,CD,2,1
2367,2335.0,40,recognised,9,18,33,15,17,6,-9,24,France,Catherine of Valois,per,--,PROPN,PROPN-ADP-PROPN,pobj,nmod-prep-pobj,NNP,NNP-IN-NNP,5,1
2368,2336.0,38,is,2,12,15,3,11,22,-10,13,Canton,Matt Thiessen,org,-,PROPN,PROPN-PROPN,compound,compound-compound,NNP,NNP-NNP,5,1
2369,2337.0,19,owned,3,10,17,7,9,1,-7,14,Michael Hillegas,United States,per-per,-,PROPN-PROPN,PROPN-PROPN,compound-pobj,compound-pobj,NNP-NNP,NNP-NNP,3,1
2370,2338.0,32,are,8,7,18,11,6,13,1,10,Oleg Kotov,Russian,-,per,PROPN-PROPN,PROPN,compound-conj,compound,NNP-NNP,NNP,7,1
2371,2339.0,17,organized,13,11,16,5,10,0,2,3,NASCAR,1948,,org,PROPN,NUM,appos,pobj,NNP,CD,5,1
2372,2340.0,19,bought,4,11,16,5,10,2,-7,12,Tulsa,Spartan Aircraft Company,,per-per-per,PROPN,PROPN-PROPN-PROPN,pobj,compound-compound-oprd,NNP,NNP-NNP-NNP,5,1
2373,2341.0,18,founded,4,3,7,4,2,10,1,3,VMware,Diane Greene,per,-,PROPN,PROPN-PROPN,nsubjpass,compound-compound,NNP,NNP-NNP,5,1
2374,2342.0,37,lobbied,1,1,10,9,0,26,0,9,Chalabi,Iraq,per,,PROPN,PROPN,nsubj,compound,NNP,NNP,5,1
2375,2343.0,10,succeeded,2,1,5,4,0,4,1,3,She,Prime Minister,per,-,PRON,PROPN-PROPN,nsubjpass,compound-pobj,PRP,NNP-NNP,3,1
2376,2344.0,10,ended,4,1,7,6,0,2,3,3,The Black Scorpion,Flair,per-per-per,,DET-PROPN-PROPN,PROPN,det-compound-compound,poss,DT-NNP-NNP,NNP,7,1
2377,2345.0,31,elected,14,12,19,7,11,11,2,5,Pierre Trudeau,Liberal,-,org,PROPN-PROPN,PROPN,compound-pobj,compound,NNP-NNP,NNP,7,1
2378,2346.0,37,announced,7,6,6,0,5,30,1,-1,Bridgepoint Capital,Bridgepoint,per-per,,PROPN-PROPN,PROPN,compound-pobj,conj,NNP-NNP,NNP,0,1
2379,2347.0,25,made,15,1,12,11,0,12,14,-3,Levinson,Elefant Traks,per,-,PROPN,PROPN-PROPN,poss,compound-compound,NNP,NNP-NNP,8,1
2380,2348.0,24,returned,8,6,11,5,5,12,2,3,1st Infantry Division,Fort Riley,--,org-org,PROPN-PROPN-PROPN,PROPN-PROPN,compound-compound-nsubj,compound-pobj,NNP-NNP-NNP,NNP-NNP,4,1
2381,2349.0,69,credited,3,59,62,3,58,6,-56,59,Amintore Fanfani,Italy,org-org,,PROPN-PROPN,PROPN,compound-pobj,pobj,NNP-NNP,NNP,1,1
2382,2350.0,61,confirmed,5,26,5,-21,25,55,-21,0,US,BAE Systems plc,,per-per-per,PROPN,PROPN-PROPN-PROPN,compound,compound-compound-pobj,NNP,NNP-NNP-NNP,6,1
2383,2351.0,22,failed,2,5,7,2,4,14,-3,5,Premier Sports,Network,-,per,PROPN-PROPN,PROPN,compound-compound,nsubj,NNP-NNPS,NNP,2,1
2384,2352.0,36,rebounded,1,7,31,24,6,4,-6,30,Mexico,Williams,per,,PROPN,PROPN,poss,pobj,NNP,NNP,11,1
2385,2353.0,41,blasted,11,22,30,8,21,10,-11,19,Zoellick,State,per,,PROPN,PROPN,dative,compound,NNP,NNP,4,1
2386,2355.0,35,rebranded,2,5,11,6,4,23,-3,9,Network 2,Two,org-org,,PROPN-NUM,NUM,pobj-nummod,npadvmod,NNP-CD,CD,5,1
2387,2356.0,24,picked,3,11,17,6,10,6,-8,14,Tim Armstrong,Hellcat,-,org,PROPN-PROPN,PROPN,compound-poss,compound,NNP-NNP,NNP,2,1
2388,2357.0,46,is,1,5,20,15,4,25,-4,19,Pete Townshend,London,org-org,,PROPN-PROPN,PROPN,compound-pobj,pobj,NNP-NNP,NNP,9,1
2389,2358.0,52,sung,30,9,33,24,8,18,21,3,New Order,Bernard Sumner,per-per,-,PROPN-PROPN,PROPN-PROPN,compound-poss,compound-pobj,NNP-NNP,NNP-NNP,10,1
2390,2359.0,35,is,9,31,33,2,30,1,-22,24,boxing champion,Riddick Bowe,per-per,-,VERB-NOUN,PROPN-PROPN,compound-compound,compound-pobj,VBG-NN,NNP-NNP,1,1
2391,2360.0,33,received,1,1,16,15,0,16,0,15,Chembai,India,,per,PROPN,PROPN,nsubj,pobj,NNP,NNP,6,1
2392,2361.0,48,are,8,19,19,0,18,28,-11,11,Marlboro,Marlboro High School,per,--,PROPN,PROPN-PROPN-PROPN,compound,compound-compound-dobj,NNP,NNP-NNP-NNP,0,1
2393,2362.0,19,is,5,1,13,12,0,5,4,8,Robert E. Lee High School,Alabama,org-org-org-org-org,,PROPN-PROPN-PROPN-PROPN-PROPN,PROPN,compound-compound-compound-compound-nsubj,compound,NNP-NNP-NNP-NNP-NNP,NNP,5,1
2394,2363.0,45,guided,5,35,42,7,34,2,-30,37,MVSU,Division I,per,-,PROPN,PROPN-PRON,poss,pobj-compound,NNP,NNP-PRP,5,1
2395,2364.0,35,merged,3,7,13,6,6,21,-4,10,Tyne Brewery,Scottish Newcastle,org-org,-,PROPN-PROPN,PROPN-PROPN,compound-pobj,compound-compound,NNP-NNP,NNP-NNP,6,1
2396,2365.0,28,told,2,11,20,9,10,7,-9,18,Dylan,Columbia,per,,PROPN,PROPN,dobj,compound,NNP,NNP,5,1
2397,2366.0,80,left,13,5,13,8,4,66,8,0,Ernest Woodford Birch,Perak,org-org-org,,PROPN-PROPN-PROPN,PROPN,compound-compound-appos,pobj,NNP-NNP-NNP,NNP,3,1
2398,2367.0,92,Contributing,0,72,13,-59,71,78,-72,13,George Walsh,New York,-,org-org,PROPN-PROPN,PROPN-PROPN,compound-conj,compound-pobj,NNP-NNP,NNP-NNP,10,1
2399,2368.0,48,became,40,1,4,3,0,43,39,-36,Irimescu,Romania,,per,PROPN,PROPN,nsubj,pobj,NNP,NNP,1,1
2400,2369.0,14,is,2,1,9,8,0,4,1,7,Foxy Shazam,Cincinnati,per-per,,PROPN-PROPN,PROPN,compound-nsubj,compound,NNP-NNP,NNP,4,1
2401,2737.0,24,was,9,14,22,8,13,1,-5,13,Foxy Shazam,Cincinnati,org-org,,PROPN-PROPN,PROPN,compound-pobj,compound,NNP-NNP,NNP,7,1
2402,2370.0,29,formed,14,2,4,2,1,24,12,-10,1904,Braden Copper Company,,per-per-per,NUM,PROPN-PROPN-PROPN,pobj,compound-compound-nsubj,CD,NNP-NNP-NNP,3,1
2403,2371.0,39,chaired,4,9,16,7,8,22,-5,12,Asif Ali Zardari,Pakistan Peoples Party,--,org-org-org,PROPN-PROPN-PROPN,PROPN-PROPN-PROPN,compound-compound-appos,compound-compound-pobj,NNP-NNP-NNP,NNP-NNPS-NNP,3,1
2404,2372.0,20,created,3,2,10,8,1,9,1,7,2000,Bloc Pot,per,-,NUM,PROPN-PROPN,pobj,compound-compound,CD,NNP-NNP,5,1
2405,2373.0,46,served,2,22,22,0,21,23,-20,20,Boston,Boston and Maine Railroad,per,---,PROPN,PROPN-CCONJ-PROPN-PROPN,compound,conj-cc-compound-compound,NNP,NNP-CC-NNP-NNP,0,1
2406,2374.0,52,was,6,8,14,6,7,37,-2,8,Little Richard,Reprise,-,per,PROPN-PROPN,PROPN,compound-poss,compound,NNP-NNP,NNP,3,1
2407,2375.0,31,left,7,6,9,3,5,21,1,2,Paul Oscar,Iceland,-,per,PROPN-PROPN,PROPN,compound-nsubj,dobj,NNP-NNP,NNP,2,1
2408,2376.0,42,appointed,3,1,12,11,0,29,2,9,Sergei Bagapsh,Abkhazia,per-per,,PROPN-PROPN,PROPN,compound-nsubjpass,pobj,NNP-NNP,NNP,2,1
2409,2377.0,15,wrote,10,2,8,6,1,6,8,-2,Rhode Island,Samuel G. Arnold,-,org-org-org,PROPN-PROPN,PROPN-PROPN-PROPN,compound-compound,compound-compound-nsubj,NNP-NNP,NNP-NNP-NNP,3,1
2410,2378.0,29,catapult,16,10,22,12,9,6,6,6,Tom Petway,Florida,org-org,,PROPN-PROPN,PROPN,compound-pobj,pobj,NNP-NNP,NNP,7,1
2411,2379.0,13,Managed,0,3,8,5,2,4,-3,8,Montgomery County Public Schools,school,---,org,PROPN-PROPN-PROPN-PROPN,NOUN,compound-compound-compound-pobj,compound,NNP-NNP-NNP-NNPS,NN,4,1
2412,2380.0,19,competes,3,2,12,10,1,6,1,9,school,Illinois,,org,NOUN,PROPN,nsubj,compound,NN,NNP,8,1
2413,2381.0,50,elected,26,14,23,9,13,26,12,-3,Leader,Kevin Rudd,per,-,PROPN,PROPN-PROPN,conj,compound-compound,NNP,NNP-NNP,8,1
2414,2382.0,30,branded,5,1,8,7,0,21,4,3,Wilmington Savings Fund Society,WSFS Bank,org-org-org-org,-,PROPN-PROPN-PROPN-PROPN,PROPN-PROPN,compound-compound-compound-compound,compound-nsubj,NNP-NNP-NNP-NNP,NNP-NNP,6,1
2415,2383.0,33,ProSiebenSat,0,7,14,7,6,18,-7,14,ProSieben,Germany,per,,PROPN,PROPN,compound,pobj,NNP,NNP,1,1
2416,2384.0,35,became,1,1,20,19,0,14,0,19,It,Congress of Industrial Organizations,per,---,PRON,PROPN-ADP-PROPN-PROPN,nsubj,pobj-prep-compound-pobj,PRP,NNP-IN-NNP-NNP,5,1
2417,2385.0,22,reconstituted,2,11,14,3,10,7,-9,12,UTS,1988,per,,PROPN,NUM,appos,pobj,NNP,CD,4,1
2418,2386.0,19,is,9,1,8,7,0,10,8,-1,Our Airline,Nauru,-,org,DET-NOUN,PROPN,poss-nsubj,pobj,PRP$-NN,NNP,1,1
2419,2387.0,9,plays,1,7,8,1,6,0,-6,7,Podravka,Koprivnica,per,,PROPN,PROPN,compound,appos,NNP,NNP,3,1
2420,2389.0,39,said,21,10,23,13,9,15,11,2,the Libertines,he,-,org,DET-PROPN,PRON,det-conj,nsubj,DT-NNPS,PRP,5,1
2421,2390.0,11,born,3,1,6,5,0,4,2,3,Thomas Hill,England,per-per,,PROPN-PROPN,PROPN,compound-nsubjpass,pobj,NNP-NNP,NNP,2,1
2422,2391.0,44,was,6,11,21,10,10,22,-5,15,Barcelona University,Universitat de Barcelona,per-per,--,PROPN-PROPN,PROPN-PROPN-PROPN,compound-poss,compound-compound-appos,NNP-NNP,NNP-NNP-NNP,4,1
2423,2392.0,34,selected,4,9,9,0,8,24,-5,5,Special Operations Forces,Special Operations Command,per-per-per,--,PROPN-PROPN-PROPN,PROPN-PROPN-PROPN,compound-compound-dobj,compound-compound-compound,NNP-NNPS-NNPS,NNP-NNPS-NNP,0,1
2424,2393.0,29,is,12,2,12,10,1,16,10,0,CDB,1994,,per,PROPN,NUM,nsubj,pobj,NNP,CD,3,1
2425,2394.0,31,than,1,14,18,4,13,12,-13,17,George H. Thomas,Army of the Cumberland,per-per-per,---,PROPN-PROPN-PROPN,PROPN-ADP-DET-PROPN,compound-compound-poss,pobj-prep-det-pobj,NNP-NNP-NNP,NNP-IN-DT-NNP,2,1
2426,2395.0,9,laughs,2,1,8,7,0,0,1,6,Dweezil Zappa,California,-,org,PROPN-PROPN,PROPN,compound-nsubj,pobj,NNP-NNP,NNP,2,1
2427,2396.0,23,ELIZABETH-EDWARDS,0,6,11,5,5,11,-6,11,Fla.,Elizabeth Edwards,,org-org,PROPN,PROPN-PROPN,appos,compound-nsubj,NNP,NNP-NNP,-1,1
2428,2397.0,30,began,1,1,17,16,0,12,0,16,Acadia,Nova Scotia,per,-,PROPN,PROPN-PROPN,nsubj,compound-pobj,NNP,NNP-NNP,7,1
2429,2398.0,21,recorded,2,5,10,5,4,10,-3,8,Topper Headon,The Clash,-,per-per,PROPN-PROPN,DET-PROPN,compound-pobj,det-pobj,NNP-NNP,DT-NNP,5,1
2430,2399.0,28,/,0,10,27,17,9,0,-10,27,National Association of Letter Carriers,1889,----,org,PROPN-PROPN-ADP-PROPN-PROPN,NUM,compound-appos-prep-compound-pobj,nummod,NNP-NNP-IN-NNP-NNP,CD,5,1
2431,2400.0,22,established,6,2,21,19,1,0,4,15,Uttar Banga Krishi Viswavidyalaya,2001,org-org-org-org,,PROPN-PROPN-PROPN-PROPN,NUM,compound-compound-compound-nsubjpass,nummod,NNP-NNP-NNP-NNP,CD,3,1
2432,2401.0,31,is,15,11,28,17,10,2,4,13,South Korea,Polar Air Cargo,per-per,--,PROPN-PROPN,PROPN-PROPN-PROPN,compound-compound,compound-compound-conj,NNP-NNP,NNP-NNP-NNP,10,1
2433,2402.0,40,had,3,30,34,4,29,5,-27,31,Johnston Community College,Smithfield,org-org-org,,PROPN-PROPN-PROPN,PROPN,compound-compound-pobj,pobj,NNP-NNP-NNP,NNP,4,1
2434,2403.0,25,chose,3,3,3,0,2,21,0,0,Harland,Harland and Wolff,org,--,PROPN,PROPN-CCONJ-PROPN,nsubj,dobj-cc-conj,NNP,NNP-CC-NNP,0,1
2435,2405.0,27,represented,8,3,22,19,2,4,5,14,North Carolina Tar Heels,Division I FBS,per-per-per-per,--,PROPN-PROPN-PROPN-PROPN,PROPN-PRON-PROPN,compound-compound-compound-compound,compound-compound-compound,NNP-NNP-NNP-NNP,NNP-PRP-NNP,7,1
2436,2406.0,25,was,12,1,17,16,0,7,11,5,Patroklos Karantinos,ek archite,org-org,-,PROPN-PROPN,PART-VERB,compound-nsubj,attr-amod,NNP-NNP,TO-VB,3,1
2437,2407.0,21,is,2,11,18,7,10,2,-9,16,Princess Akishino,Japanese,per-per,,PROPN-PROPN,PROPN,compound-conj,amod,NNP-NNP,NNP,7,1
2438,2408.0,15,had,7,2,14,12,1,0,5,7,her,Coral,org,,DET,PROPN,poss,pobj,PRP$,NNP,3,1
2439,2409.0,28,founded,24,10,23,13,9,4,14,-1,Worcester,Bancroft School,,org-org,PROPN,PROPN-PROPN,pobj,compound-nsubj,NNP,NNP-NNP,4,1
2440,2410.0,43,held,10,7,21,14,6,21,3,11,CSA,Canada,org,,PROPN,PROPN,compound,pobj,NNP,NNP,10,1
2441,2411.0,24,born,2,1,7,6,0,16,1,5,Lamb,England,,org,PROPN,PROPN,nsubjpass,pobj,NNP,NNP,2,1
2442,2412.0,28,written,5,11,27,16,10,0,-6,22,Faust,Aborym,per,,PROPN,PROPN,pobj,pobj,NNP,NNP,6,1
2443,2413.0,36,During,0,15,20,5,14,15,-15,20,teams,NCAA,,per,NOUN,PROPN,dobj,nmod,NNS,NNP,4,1
2444,2414.0,12,merged,1,8,11,3,7,0,-7,10,1982,AMEC,org,,NUM,PROPN,pobj,dobj,CD,NNP,3,1
2445,2415.0,38,documented,5,3,7,4,2,30,2,2,University of,his,per-per,,PROPN-ADP,DET,pobj-prep,poss,NNP-IN,PRP$,5,1
2446,2416.0,40,were,15,4,9,5,3,30,11,-6,Paris,Roger Vadim,org,-,PROPN,PROPN-PROPN,pobj,compound-poss,NNP,NNP-NNP,4,1
2447,2417.0,30,given,8,12,23,11,11,6,-4,15,George H. W. Bush,United States,org-org-org-org,-,PROPN-PROPN-PROPN-PROPN,PROPN-PROPN,compound-compound-compound-pobj,compound-compound,NNP-NNP-NNP-NNP,NNP-NNP,8,1
2448,2418.0,12,opposed,10,6,9,3,5,2,4,-1,Jeff Merkley,Oregon,-,org,PROPN-PROPN,PROPN,compound-appos,pobj,NNP-NNP,NNP,3,1
2449,2419.0,21,represented,2,11,19,8,10,1,-9,17,Conservative,Jay Hill,org,-,PROPN,PROPN-PROPN,compound,compound-conj,NNP,NNP-NNP,3,1
2450,2420.0,20,was,10,10,16,6,9,3,0,6,Negroponte,United Nations,,org-org,PROPN,PROPN-PROPN,attr,compound-pobj,NNP,NNP-NNP,6,1
2451,2422.0,29,said,12,1,3,2,0,25,11,-9,Missouri,Kit Bond,,org-org,PROPN,PROPN-PROPN,compound,compound-nsubj,NNP,NNP-NNP,1,1
2452,2614.0,56,Announcement,1,20,24,4,19,31,-19,23,Missouri,Kit Bond,per,-,PROPN,PROPN-PROPN,poss,compound-appos,NNP,NNP-NNP,4,1
2453,2423.0,18,is,1,7,16,9,6,1,-6,15,University of Missouri,Brian Smith,per-per-per,-,PROPN-ADP-PROPN,PROPN-PROPN,pobj-prep-pobj,compound-pobj,NNP-IN-NNP,NNP-NNP,8,1
2454,2424.0,36,reported,6,16,32,16,15,3,-10,26,Samsung Electronics,group,per-per,,PROPN-PROPN,NOUN,compound-compound,poss,NNP-NNPS,NN,11,1
2455,2425.0,28,is,9,19,23,4,18,4,-10,14,State,Philippe,per,,PROPN,PROPN,compound,pobj,NNP,NNP,2,1
2456,2426.0,30,kicked,17,17,23,6,16,6,0,6,Ricciuto,Waikerie,,org,PROPN,PROPN,nsubj,nsubj,NNP,NNP,3,1
2457,2427.0,22,is,4,13,20,7,12,1,-9,16,College of Mount Saint Vincent,Bronx,org-org-org-org-org,,PROPN-ADP-PROPN-PROPN-PROPN,PROPN,pobj-prep-compound-compound-pobj,compound,NNP-IN-NNP-NNP-NNP,NNP,5,1
2458,2428.0,27,is,1,1,9,8,0,17,0,8,Birmingham,University College Birmingham,per,--,PROPN,PROPN-PROPN-PROPN,nsubj,compound-compound-appos,NNP,NNP-NNP-NNP,6,1
2459,2429.0,25,became,3,2,12,10,1,12,1,9,1991,United Church of Christ,per,---,NUM,PROPN-PROPN-ADP-PROPN,pobj,compound-pobj-prep-pobj,CD,NNP-NNP-IN-NNP,4,1
2460,2430.0,29,is,11,23,14,-9,22,14,-12,3,KF Tirana,Albanian Superliga,-,org-org,PROPN-PROPN,PROPN-PROPN,compound-pobj,compound-pobj,NNP-NNP,NNP-NNP,5,1
2461,2431.0,24,is,2,1,13,12,0,10,1,11,Barker College,Hornsby,-,org,PROPN-PROPN,PROPN,compound-nsubj,pobj,NNP-NNP,NNP,5,1
2462,2757.0,19,educated,8,11,14,3,10,4,-3,6,Barker College,Hornsby,org-org,,PROPN-PROPN,PROPN,compound-pobj,pobj,NNP-NNP,NNP,3,1
2463,2432.0,18,is,8,7,17,10,6,0,1,9,Art Institute,Mississippi,-,per,PROPN-PROPN,PROPN,compound-nsubj,pobj,NNP-NNP,NNP,2,1
2464,2433.0,28,retired,1,23,27,4,22,0,-22,26,Commonwealth Liberal Party,1909,--,per,PROPN-PROPN-PROPN,NUM,compound-compound-attr,pobj,NNP-NNP-NNP,CD,11,1
2465,2434.0,35,known,1,5,7,2,4,27,-4,6,university,NLIU,per,,NOUN,PROPN,pobj,poss,NN,NNP,3,1
2466,2435.0,30,led,3,9,27,18,8,2,-6,24,82nd Airborne Division,James M. Gavin,per-per-per,--,ADJ-PROPN-PROPN,PROPN-PROPN-PROPN,compound-compound-pobj,compound-compound-pobj,JJ-NNP-NNP,NNP-NNP-NNP,8,1
2467,2436.0,34,was,13,1,20,19,0,13,12,7,Chaudhry Muhammad Ali,Pakistan,--,per,PROPN-PROPN-PROPN,PROPN,compound-compound-nsubj,pobj,NNP-NNP-NNP,NNP,4,1
2468,2437.0,19,had,12,6,10,4,5,8,6,-2,United States,Mike Johnson,per-per,-,PROPN-PROPN,PROPN-PROPN,compound-compound,compound-nsubj,NNP-NNP,NNP-NNP,2,1
2469,2438.0,36,confirmed,8,5,25,20,4,10,3,17,Lothian and Borders Police,Margate,per-per-per-per,,PROPN-CCONJ-PROPN-PROPN,PROPN,nsubj-cc-conj-conj,pobj,NNP-CC-NNP-NNP,NNP,12,1
2470,2439.0,21,produced,6,11,19,8,10,1,-5,13,Bad Boy Records,The Hitmen,--,per-per,PROPN-PROPN-PROPN,DET-PROPN,compound-compound-pobj,det-appos,NNP-NNP-NNPS,DT-NNP,10,1
2471,2440.0,27,remastered,4,9,26,17,8,0,-5,22,Iva Davies,Australia,-,per,PROPN-PROPN,PROPN,compound-pobj,pobj,NNP-NNPS,NNP,8,1
2472,2441.0,29,participates,2,11,28,17,10,0,-9,26,Faulkner University,Montgomery,-,org,PROPN-PROPN,PROPN,compound-nsubj,pobj,NNP-NNP,NNP,2,1
2473,2442.0,26,set,17,4,10,6,3,15,13,-7,FAO Schwarz,New York,-,per-per,PROPN-PROPN,PROPN-PROPN,compound-appos,compound-compound,NNP-NNP,NNP-NNP,5,1
2474,2443.0,29,gathered,2,5,27,22,4,1,-3,25,Bangkok,Chulalongkorn University,per,-,PROPN,PROPN-PROPN,compound,compound-pobj,NNP,NNP-NNP,-1,1
2475,2444.0,34,Lastra,4,2,30,28,1,3,2,26,Francisco de la Lastra,Chile,org-org-org-org,,PROPN-PROPN-PROPN-PROPN,PROPN,nmod-nmod-compound-ROOT,pobj,NNP-NNP-NNP-NNP,NNP,6,1
2476,2445.0,35,take,2,18,27,9,17,7,-16,25,Khadaffy Janjalani,Abu Sayyaf,-,org-org,PROPN-PROPN,PROPN-PROPN,compound-pobj,compound-compound,NNP-NNP,NNP-NNP,4,1
2477,2446.0,28,scheduled,9,4,6,2,3,21,5,-3,Peterborough,Dean Del Mastro,,org-org-org,PROPN,PROPN-PROPN-PROPN,compound,compound-compound-nsubjpass,NNP,NNP-NNP-NNP,3,1
2478,2447.0,43,drawn,3,9,20,11,8,22,-6,17,France,Jean-Marie Le Pen,,org-org-org,PROPN,PROPN-PROPN-PROPN,pobj,compound-compound-nsubj,NNP,NNP-NNP-NNP,6,1
2479,2448.0,32,represented,8,4,26,22,3,5,4,18,Maryland Terrapins,Atlantic Coast Conference,org-org,--,PROPN-PROPN,PROPN-PROPN-PROPN,compound-compound,compound-compound-pobj,NNP-NNP,NNP-NNP-NNP,9,1
2480,2449.0,21,was,2,1,18,17,0,2,1,16,Charlie Ondras,Unsane,org-org,,PROPN-PROPN,PROPN,compound-nsubj,pobj,NNP-NNP,NNP,9,1
2481,2451.0,48,is,8,17,29,12,16,18,-9,21,the 18th Divis,m ( A,org-org-org,--,DET-ADJ-PROPN,NOUN-PUNCT-DET,det-amod-compound,pobj-punct-det,DT-JJ-NNP,NN--LRB--DT,7,1
2482,2452.0,14,makes,1,7,8,1,6,5,-6,7,singer,Minnie Riperton,org,-,NOUN,PROPN-PROPN,compound,compound-pobj,NN,NNP-NNP,1,1
2483,2453.0,80,was,14,23,36,13,22,43,-9,22,Canada,Jackson Beardy,per,-,PROPN,PROPN-PROPN,pobj,compound-compound,NNP,NNP-NNP,-1,1
2484,2454.0,21,founded,4,1,10,9,0,10,3,6,IBC Root Beer,Griesedieck,--,per,PROPN-PROPN-PROPN,PROPN,compound-compound-nsubjpass,compound,NNP-NNP-NNP,NNP,4,1
2485,2455.0,28,made,2,6,19,13,5,8,-4,17,DreamWorks,Fogerty,org,,PROPN,PROPN,compound,dobj,NNP,NNP,5,1
2486,2456.0,16,is,2,1,12,11,0,3,1,10,Kiwibank,New Zealand Post,org,--,PROPN,PROPN-PROPN-PROPN,compound,compound-compound-compound,NNP,NNP-NNP-NNP,4,1
2487,2457.0,39,dubbed,11,6,9,3,5,29,5,-2,Kosovo,Rugova,per,,PROPN,PROPN,poss,pobj,NNP,NNP,8,1
2488,2458.0,15,was,6,4,8,4,3,6,2,2,Zulfikar Ali Bhutto,Pakistan,org-org-org,,PROPN-PROPN-PROPN,PROPN,compound-compound-nsubj,poss,NNP-NNP-NNP,NNP,5,1
2489,2459.0,36,faced,9,1,5,4,0,30,8,-4,Samy,Malaysian Indian Congress,per,--,PROPN,ADJ-PROPN-PROPN,nsubj,amod-compound-compound,NNP,JJ-NNP-NNP,4,1
2490,2460.0,29,appointed,5,3,8,5,2,20,2,3,Muriel Humphrey,Minnesota,-,org,PROPN-PROPN,PROPN,compound-appos,poss,NNP-NNP,NNP,7,1
2491,2461.0,26,formed,2,1,5,4,0,20,1,3,Hush,Keith Lamb,per,-,PROPN,PROPN-PROPN,nsubjpass,compound-pobj,NNP,NNP-NNP,3,1
2492,2462.0,30,ruled,7,6,22,16,5,7,1,15,Thailand,Sarit Dhanarajata,,per-per,PROPN,PROPN-PROPN,nsubjpass,compound-conj,NNP,NNP-NNP,9,1
2493,2463.0,21,took,2,1,8,7,0,12,1,6,Air India,Indian Airlines,-,per-per,PROPN-PROPN,PROPN-PROPN,compound-nsubj,compound-compound,NNP-NNP,NNP-NNPS,4,1
2494,2464.0,28,opened,1,5,25,20,4,2,-4,24,UK,Freeserve,,per,PROPN,PROPN,compound,pobj,NNP,NNP,11,1
2495,2466.0,25,is,2,1,23,22,0,1,1,21,Sun Caged,Lion Music,-,org-org,PROPN-PROPN,PROPN-PROPN,compound-nsubj,compound-pobj,NNP-NNP,NNP-NNP,4,1
2496,2467.0,17,released,3,3,12,9,2,4,0,9,she,Dome Records,,per-per,PRON,PROPN-PROPN,nsubj,compound-pobj,PRP,NNP-NNPS,3,1
2497,2468.0,29,include,4,6,9,3,5,19,-2,5,Cabrillo College,Aptos,-,org,PROPN-PROPN,PROPN,compound-dobj,compound,NNP-NNP,NNP,2,1
2498,2822.0,21,played,2,15,19,4,14,1,-13,17,Cabrillo College,Aptos,-,org,PROPN-PROPN,PROPN,compound-pobj,compound,NNP-NNP,NNP,9,1
2499,2469.0,24,born,2,5,14,9,4,9,-3,12,London,Richard Harris,,per-per,PROPN,PROPN-PROPN,pobj,compound-pobj,NNP,NNP-NNP,4,1
2500,2470.0,33,stepping,21,14,29,15,13,3,7,8,St. Joe Company,Jacksonville,--,per,PROPN-PROPN-PROPN,PROPN,compound-compound-pobj,compound,NNP-NNP-NNP,NNP,9,1
2501,2471.0,28,said,25,1,12,11,0,15,24,-13,Paraguay,Nicanor Duarte,org,-,PROPN,PROPN-PROPN,poss,compound-compound,NNP,NNP-NNP,8,1
2502,2472.0,22,was,1,10,14,4,9,7,-9,13,Afghanistan,Gulbuddin Hekmatyar,,per-per,PROPN,PROPN-PROPN,compound,compound-pobj,NNP,NNP-NNP,3,1
2503,2473.0,23,held,2,14,17,3,13,5,-12,15,Elizabeth I of England,England,---,org,PROPN-PROPN-ADP-PROPN,PROPN,compound-pobj-prep-pobj,pobj,NNP-NNP-IN-NNP,NNP,3,1
2504,2474.0,53,formed,2,1,15,14,0,37,1,13,Institut Polaire,Erik Hecht,-,per-per,PROPN-PROPN,PROPN-PROPN,compound-nsubj,compound-appos,NNP-NNP,NNP-NNP,5,1
2505,2475.0,38,is,9,2,2,0,1,35,7,-7,St. Louis Community College,St. Louis,per-per-per-per,-,PROPN-PROPN-PROPN-PROPN,PROPN-PROPN,compound-compound-compound-compound,compound-compound,NNP-NNP-NNP-NNP,NNP-NNP,0,1
2506,2476.0,10,dismissed,2,5,9,4,4,0,-3,7,Peter,England,per,,PROPN,PROPN,pobj,pobj,NNP,NNP,2,1
2507,2477.0,83,counsel,23,19,42,23,18,40,4,19,Styles Bridges,New Hampshire,per-per,-,PROPN-PROPN,PROPN-PROPN,compound-pobj,compound-pobj,NNP-NNPS,NNP-NNP,5,1
2508,2478.0,50,appointed,4,28,38,10,27,11,-24,34,2007,CPN,org,,NUM,PROPN,pobj,nmod,CD,NNP,2,1
2509,2479.0,33,nominated,10,9,32,23,8,0,1,22,Hathaway,Interior,,per,PROPN,PROPN,nsubjpass,pobj,NNP,NNP,2,1
2510,2480.0,30,attended,5,5,12,7,4,17,0,7,Thailand,Chuan Leekpai,org,-,PROPN,PROPN-PROPN,pobj,compound-compound,NNP,NNP-NNP,4,1
2511,2481.0,45,said,40,37,39,2,36,5,3,-1,comScore,Gian Fulgoni,,org-org,NOUN,PROPN-PROPN,compound,compound-nsubj,NN,NNP-NNP,3,1
2512,2482.0,33,appointed,13,11,12,1,10,20,2,-1,Leader,Charles Kennedy,org,-,PROPN,PROPN-PROPN,compound,compound-nsubj,NNP,NNP-NNP,1,1
2513,2483.0,34,was,1,7,18,11,6,15,-6,17,Shasta Union High School District,Enterprise High School,----,org-org-org,PROPN-PROPN-PROPN-PROPN-PROPN,PROPN-PROPN-PROPN,compound-compound-compound-compound-pobj,compound-compound-pobj,NNP-NNP-NNP-NNP-NNP,NNP-NNP-NNP,7,1
2514,2484.0,43,became,4,1,11,10,0,31,3,7,Negroponte,National Intelligence,per,-,PROPN,PROPN-PROPN,nsubj,compound-pobj,NNP,NNP-NNP,5,1
2515,2485.0,30,frontman,3,1,29,28,0,0,2,26,The Smiths,England,org-org,,DET-PROPN,PROPN,det-nsubj,pobj,DT-NNP,NNP,7,1
2516,2486.0,36,is,12,1,15,14,0,20,11,3,John Noakes,British,-,per,PROPN-PROPN,ADJ,compound-nsubj,amod,NNP-NNP,JJ,3,1
2517,2487.0,42,are,2,1,11,10,0,30,1,9,The Kinks,Ray Davies,org-org,-,DET-PROPN,PROPN-PROPN,det-nsubj,compound-pobj,DT-NNPS,NNP-NNPS,4,1
2518,2488.0,35,working,4,32,33,1,31,1,-28,29,producer,David Guetta,,per-per,NOUN,PROPN-PROPN,conj,compound-npadvmod,NN,NNP-NNP,1,1
2519,2489.0,27,is,2,1,11,10,0,15,1,9,Klei Entertainment,Vancouver,-,per,PROPN-PROPN,PROPN,compound-nsubj,compound,NNP-NNP,NNP,5,1
2520,2490.0,52,On,0,16,38,22,15,13,-16,38,National Polytechnic Institute,Cinvestav,per-per-per,,PROPN-PROPN-PROPN,PROPN,compound-compound-attr,appos,NNP-NNP-NNP,NNP,4,1
2521,2491.0,24,blames,3,1,3,2,0,20,2,0,Troy,Delphi,org,,PROPN,PROPN,compound,nsubj,NNP,NNP,2,1
2522,2492.0,22,fell,7,1,14,13,0,7,6,7,Japan,Honda Motor Co. Ltd.,org,---,PROPN,PROPN-PROPN-PROPN-PROPN,poss,compound-compound-compound-nsubj,NNP,NNP-NNP-NNP-NNP,7,1
2523,2493.0,40,came,10,5,7,2,4,32,5,-3,Wessex,Edgar the Peaceful,per,--,PROPN,PROPN-DET-PROPN,compound,pobj-det-compound,NNP,NNP-DT-NNP,3,1
2524,2494.0,22,became,11,4,17,13,3,4,7,6,Antwerp,Peter Paul Rubens,per,--,PROPN,PROPN-PROPN-PROPN,pobj,compound-compound-pobj,NNP,NNP-NNP-NNP,7,1
2525,2495.0,29,took,9,19,4,-15,18,24,-10,-5,Isaac Hill,New Hampshire,-,org-org,PROPN-PROPN,PROPN-PROPN,compound-compound,compound-pobj,NNP-NNP,NNP-NNP,8,1
2526,2496.0,41,passed,23,6,18,12,5,22,17,-5,Central Electricity Generating Board,National Grid plc,per-per-per-per,--,PROPN-PROPN-PROPN-PROPN,PROPN-PROPN-NOUN,compound-compound-compound-pobj,compound-compound-ROOT,NNP-NNP-NNP-NNP,NNP-NNP-NN,9,1
2527,2497.0,26,traces,2,1,1,0,0,24,1,-1,Anderson University,Anderson,-,per,PROPN-PROPN,PROPN,compound-nsubj,pobj,NNP-NNP,NNP,0,1
2528,2498.0,42,warned,5,1,5,4,0,36,4,0,Yemen,Yemenia,org,,PROPN,PROPN,poss,appos,NNP,NNP,3,1
2529,2499.0,46,said,11,7,8,1,6,37,4,-3,Bishop,John Saxbee,,per-per,PROPN,PROPN-PROPN,compound,compound-nsubj,NNP,NNP-NNP,2,1
2530,2500.0,26,said,13,8,9,1,7,16,5,-4,Paris,Lam,org,,PROPN,PROPN,compound,poss,NNP,NNP,1,1
2531,2501.0,27,is,8,1,15,14,0,11,7,7,Bernard Makuza,Prime Minister,per-per,-,PROPN-PROPN,PROPN-PROPN,compound-nsubj,compound-attr,NNP-NNP,NNP-NNP,4,1
2532,2502.0,22,are,13,1,21,20,0,0,12,8,The Anyones,Australia,per-per,,DET-PROPN,PROPN,det-nsubj,pobj,DT-NNPS,NNP,2,1
2533,2503.0,31,became,8,4,13,9,3,17,4,5,Kean College,1997,per-per,,PROPN-PROPN,NUM,compound-nsubj,pobj,NNP-NNP,CD,2,1
2534,2504.0,17,removed,9,4,8,4,3,8,5,-1,Mussolini,Empire,,per,PROPN,PROPN,poss,dobj,NNP,NNP,6,1
2535,2505.0,74,is,14,12,26,14,11,47,2,12,RBS Group,UK,-,per,PROPN-PROPN,PROPN,compound-pobj,compound,NNP-NNP,NNP,6,1
2536,2506.0,19,was,3,3,17,14,2,1,0,14,Susie,New Brunswick,org,-,PROPN,PROPN-PROPN,appos,compound-pobj,NNP,NNP-NNP,5,1
2537,2507.0,47,adopted,31,10,16,6,9,30,21,-15,Nicaragua,Sandinista National Liberation Front,org,---,PROPN,PROPN-PROPN-PROPN-PROPN,pobj,compound-compound-compound-pobj,NNP,NNP-NNP-NNP-NNP,9,1
2538,2508.0,27,are,4,10,13,3,9,13,-6,9,University of Basel,Switzerland,--,org,PROPN-ADP-PROPN,PROPN,appos-prep-compound,pobj,NNP-IN-NNP,NNP,2,1
2539,2509.0,22,reached,9,4,6,2,3,15,5,-3,Letterman,Worldwide Pants,,org-org,PROPN,PROPN-PROPN,poss,compound-nsubj,NNP,NNP-NNPS,2,1
2540,2510.0,44,started,3,29,31,2,28,12,-26,28,e guitaris,t Mile Lojpu,-,per-per-per,X-NOUN,PUNCT-PROPN-PROPN,det-ROOT,compound-compound-compound,XX-NN,.-NNP-NNP,3,1
2541,2511.0,54,Daily,0,39,45,6,38,8,-39,45,Singapore,MediaCorp TV Channel 5,,per-per-per-per,PROPN,PROPN-PROPN-PROPN-NUM,pobj,compound-compound-pobj-nummod,NNP,NNP-NNP-NNP-CD,-1,1
2542,2512.0,45,love,1,8,26,18,7,18,-7,25,Indiana,Bayh,per,,PROPN,PROPN,pobj,nsubj,NNP,NNP,-1,1
2543,2514.0,18,lost,10,14,17,3,13,0,-4,7,Chang Hao,China,org-org,,PROPN-PROPN,PROPN,compound-pobj,pobj,NNP-NNP,NNP,2,1
2544,2515.0,16,founded,3,1,6,5,0,9,2,3,Tennessee Temple,1946,-,org,PROPN-PROPN,NUM,compound-nsubjpass,pobj,NNP-NNP,CD,2,1
2545,2516.0,43,was,1,18,19,1,17,23,-17,18,DJ,OG RON C.,,per-per-per,PROPN,PROPN-PROPN-PROPN,compound,compound-compound-pobj,NNP,NNP-NNP-NNP,2,1
2546,2517.0,11,born,2,1,6,5,0,4,1,4,McFadden,Ireland,,per,PROPN,PROPN,nsubjpass,pobj,NNP,NNP,2,1
2547,2518.0,33,is,6,1,24,23,0,8,5,18,Wells Fargo,1998,per-per,,PROPN-PROPN,NUM,compound-nsubj,pobj,NNP-NNP,CD,8,1
2548,2519.0,23,founded,10,10,13,3,9,9,0,3,Poland,National Bank,per,-,PROPN,PROPN-PROPN,pobj,compound-dobj,NNP,NNP-NNP,1,1
2549,2520.0,18,is,3,2,3,1,1,14,1,0,Turkey,she,org,,PROPN,PRON,pobj,nsubjpass,NNP,PRP,1,1
2550,2521.0,45,covers,4,35,36,1,34,8,-31,32,TAP Portugal,Portugal,per-per,,PROPN-PROPN,PROPN,compound-compound,pobj,NNP-NNP,NNP,1,1
2551,2522.0,34,said,5,10,13,3,9,20,-5,8,Emirates airline,Dubai,org-org,,PROPN-NOUN,PROPN,compound-nsubj,pobj,NNPS-NN,NNP,2,1
2552,2523.0,31,is,6,1,20,19,0,10,5,14,Tom Renyi,Bank,per-per,,PROPN-PROPN,PROPN,compound-nsubj,pobj,NNP-NNP,NNP,5,1
2553,2524.0,37,graduated,3,12,24,12,11,12,-9,21,Moscow State University,Anatoly Vlasov,--,org-org,PROPN-PROPN-PROPN,PROPN-PROPN,compound-compound-pobj,compound-pobj,NNP-NNP-NNP,NNP-NNP,7,1
2554,2525.0,70,Tucci,0,29,57,28,28,12,-29,57,Stanley Tucci,secretary,org-org,,PROPN-PROPN,NOUN,compound-nsubjpass,appos,NNP-NNP,NN,3,1
2555,2526.0,26,is,7,3,4,1,2,21,4,-3,Royal New Zealand Infantry Regiment,New Zealand,----,org-org,PROPN-PROPN-PROPN-PROPN-PROPN,PROPN-PROPN,compound-compound-compound-compound-nsubj,compound-pobj,NNP-NNP-NNP-NNP-NNP,NNP-NNP,1,1
2556,2527.0,16,went,1,4,15,11,3,0,-3,14,Arcadia High School,Arizona,--,per,PROPN-PROPN-PROPN,PROPN,compound-compound-pobj,pobj,NNP-NNP-NNP,NNP,4,1
2557,2528.0,24,was,8,6,13,7,5,10,2,5,National Bank,New Zealand,-,org-org,PROPN-PROPN,PROPN-PROPN,compound-pobj,compound-compound,NNP-NNP,NNP-NNP,10,1
2558,2529.0,62,formed,20,15,34,19,14,27,5,14,Winnipeg,Canwest,,per,PROPN,PROPN,pobj,compound,NNP,NNP,6,1
2559,2530.0,64,comprising,9,17,31,14,16,32,-8,22,Romania,and Grigore Preot,org,--,PROPN,CCONJ-PROPN-PROPN,pobj,cc-compound-compound,NNP,CC-NNP-NNP,-1,1
2560,2531.0,66,give,57,1,16,15,0,49,56,-41,Copley,Boston,per,,PROPN,PROPN,poss,pobj,NNP,NNP,3,1
2561,2532.0,24,went,3,18,18,0,17,5,-15,15,Jones Radio Networks,Jones Standards,org-org-org,-,PROPN-PROPN-PROPN,PROPN-PROPN,compound-compound-poss,compound-conj,NNP-NNP-NNP,NNP-NNP,0,1
2562,2533.0,41,acknowledged,11,10,20,10,9,20,1,9,MSNBC,United States,,per-per,PROPN,PROPN-PROPN,compound,compound-nsubj,NNP,NNP-NNP,3,1
2563,2534.0,15,worked,1,7,11,4,6,3,-6,10,Garry Leach,Atomeka Press,per-per,-,PROPN-PROPN,PROPN-PROPN,compound-conj,compound-dobj,NNP-NNP,NNP-NNP,6,1
2564,2535.0,21,died,9,1,18,17,0,2,8,9,Abraham Oyanedel,Chile,org-org,,PROPN-PROPN,PROPN,compound-compound,pobj,NNP-NNP,NNP,4,1
2565,2536.0,21,designed,5,8,9,1,7,11,-3,4,James Polshek,Polshek Partnership,-,org-org,PROPN-PROPN,PROPN-PROPN,compound-poss,compound-compound,NNP-NNP,NNP-NNP,1,1
2566,2537.0,44,is,4,11,2,-9,10,41,-7,-2,University of the East,UE Red Warriors,---,per-per-per,PROPN-ADP-DET-PROPN,PROPN-PROPN-PROPN,pobj-prep-det-pobj,compound-compound-appos,NNP-IN-DT-NNP,NNP-NNP-NNPS,6,1
2567,2538.0,31,was,1,11,11,0,10,19,-10,10,James I of England,James,org-org-org-org,,PROPN-PROPN-ADP-PROPN,PROPN,compound-pobj-prep-pobj,compound,NNP-NNP-IN-NNP,NNP,0,1
2568,2539.0,20,appointed,3,13,14,1,12,5,-10,11,Ontario,John Robarts,org,-,PROPN,PROPN-PROPN,pobj,compound-appos,NNP,NNP-NNP,1,1
2569,2540.0,24,represented,8,4,11,7,3,12,4,3,Oregon Ducks,University of Oregon,-,org-org-org,PROPN-PROPN,PROPN-ADP-PROPN,compound-compound,dobj-prep-pobj,NNP-NNPS,NNP-IN-NNP,3,1
2570,2541.0,69,grown,6,15,18,3,14,50,-9,12,Trick Daddy,Maurice Young,-,per-per,VERB-PROPN,PROPN-PROPN,compound-appos,compound-parataxis,VB-NNP,NNP-NNP,1,1
2571,2542.0,20,served,3,7,8,1,6,11,-4,5,Royal Guernsey Light Infantry,Guernsey,per-per-per-per,,PROPN-PROPN-PROPN-PROPN,PROPN,compound-compound-compound-compound,compound,NNP-NNP-NNP-NNP,NNP,2,1
2572,2543.0,31,Bio,2,1,13,12,0,17,1,11,Jim Boeven,Germany,org-org,,PROPN-PROPN,PROPN,compound-compound,pobj,NNP-NNP,NNP,4,1
2573,2544.0,31,are,1,7,19,12,6,11,-6,18,Quebec,Metro Inc.,org,-,PROPN,PROPN-PROPN,pobj,compound-pobj,NNP,NNP-NNP,3,1
2574,2545.0,21,has,2,2,13,11,1,7,0,11,college,Eastbourne,org,,NOUN,PROPN,nsubj,compound,NN,NNP,4,1
2575,2546.0,24,accused,4,1,16,15,0,7,3,12,Crvenkovski,Macedonia,,org,PROPN,PROPN,npadvmod,dobj,NNP,NNP,5,1
2576,2547.0,27,incorporated,3,1,8,7,0,18,2,5,Screenwriter,his,,per,PROPN,DET,compound,poss,NNP,PRP$,6,1
2577,2548.0,14,is,3,1,11,10,0,2,2,8,Trust,Dordrecht,per,,PROPN,PROPN,compound,pobj,NNP,NNP,8,1
2578,2549.0,10,winging,2,1,8,7,0,1,1,6,Jake Gyllenhaal,Los Angeles,org-org,-,PROPN-PROPN,PROPN-PROPN,compound-nsubj,compound-pobj,NNP-NNP,NNP-NNP,4,1
2579,2550.0,31,issued,4,20,24,4,19,6,-16,20,Selangor,Harun bin Idris,org,--,PROPN,PROPN-PROPN-PROPN,compound,compound-compound-pobj,NNP,NNP-NNP-NNP,2,1
2580,2551.0,37,seized,5,18,19,1,17,17,-13,14,President,Lon Nol,,org-org,PROPN,PROPN-PROPN,compound,compound-pobj,NNP,NNP-NNP,1,1
2581,2552.0,21,is,1,6,9,3,5,11,-5,8,New Delhi,Jawaharlal Nehru University,per-per,--,PROPN-PROPN,PROPN-PROPN-PROPN,compound-poss,compound-compound-pobj,NNP-NNP,NNP-NNP-NNP,2,1
2582,2553.0,24,came,12,12,23,11,11,0,0,11,Iceland,Glitnir,,org,PROPN,PROPN,pobj,conj,NNP,NNP,1,1
2583,2555.0,19,lives,1,1,11,10,0,7,0,10,He,author,per,,PRON,NOUN,nsubj,poss,PRP,NN,6,1
2584,2556.0,16,is,4,1,13,12,0,2,3,9,Olentangy Orange High School,Lewis Center,---,per-per,PROPN-PROPN-PROPN-PROPN,PROPN-PROPN,compound-compound-compound-nsubj,compound-compound,NNP-NNP-NNP-NNP,NNP-NNP,7,1
2585,2557.0,36,served,1,1,24,23,0,11,0,23,He,University of Connecticut,,org-org-org,PRON,PROPN-ADP-PROPN,nsubj,nmod-prep-pobj,PRP,NNP-IN-NNP,6,1
2586,2558.0,38,confirmed,7,5,10,5,4,27,2,3,Baghdad,Iraqi Airways,per,-,PROPN,PROPN-PROPN,pobj,compound-nmod,NNP,NNP-NNP,7,1
2587,2559.0,88,Comments,8,38,59,21,37,28,-30,51,Edward Bernays,United States,org-org,-,PROPN-PROPN,PROPN-PROPN,compound-pobj,compound-pobj,NNP-NNP,NNP-NNP,-1,1
2588,2560.0,22,formed,10,1,19,18,0,2,9,9,The Pyramid Companies,Robert J. Congel,per-per-per,--,DET-PROPN-PROPN,PROPN-PROPN-PROPN,det-compound-nsubjpass,compound-compound-pobj,DT-NNP-NNPS,NNP-NNP-NNP,6,1
2589,2561.0,25,reunited,4,1,17,16,0,7,3,13,Wynonna,Judds,,org,PROPN,PROPN,nsubj,pobj,NNP,NNP,8,1
2590,2562.0,17,is,1,11,16,5,10,0,-10,15,actress,Madonna,org,,NOUN,PROPN,compound,conj,NN,NNP,4,1
2591,2563.0,20,awarded,6,4,8,4,3,11,2,2,Long Island,Brentwood High School,per-per,--,PROPN-PROPN,PROPN-PROPN-PROPN,compound-compound,compound-compound-dobj,NNP-NNP,NNP-NNP-NNP,4,1
2592,2564.0,65,studied,5,29,42,13,28,22,-24,37,New York,George Luks,-,per-per,PROPN-PROPN,PROPN-PROPN,compound-compound,compound-pobj,NNP-NNP,NNP-NNP,8,1
2593,2565.0,34,became,1,3,17,14,2,16,-2,16,AKQA,Dan Norris-Jones,org,-,PROPN,PROPN-PROPN,poss,compound-appos,NNP,NNP-NNP,7,1
2594,2566.0,29,released,7,11,17,6,10,11,-4,10,Rykodisc,Andrew Bird,per,-,PROPN,PROPN-PROPN,pobj,compound-poss,NNP,NNP-NNP,5,1
2595,2568.0,23,began,1,1,12,11,0,10,0,11,He,Liberia,,per,PRON,PROPN,nsubj,pobj,PRP,NNP,5,1
2596,2569.0,24,formed,10,5,13,8,4,10,5,3,Andrew J. Hanscom,Omaha Horse Railway,--,org-org-org,PROPN-PROPN-PROPN,PROPN-PROPN-PROPN,compound-compound-nsubj,compound-compound-compound,NNP-NNP-NNP,NNP-NNP-NNP,4,1
2597,2570.0,18,is,1,7,7,0,6,10,-6,6,Mississippi Army National Guard,Mississippi,---,org,PROPN-PROPN-PROPN-PROPN,PROPN,compound-compound-compound-pobj,pobj,NNP-NNP-NNP-NNP,NNP,0,1
2598,2571.0,17,began,5,4,16,12,3,0,1,11,Ottoman Empire,Islam,org-org,,PROPN-PROPN,PROPN,compound-appos,pobj,NNP-NNP,NNP,3,1
2599,2573.0,34,announced,5,9,25,16,8,8,-4,20,Wilts Dorset,Poole,org-org,,PROPN-PROPN,PROPN,compound-compound,compound,NNPS-NNP,NNP,8,1
2600,2574.0,24,was,11,1,10,9,0,13,10,-1,Gaye,United States,per,-,PROPN,PROPN-PROPN,poss,compound-pobj,NNP,NNP-NNP,6,1
2601,2575.0,22,is,4,1,19,18,0,2,3,15,Monta Vista High School,Cupertino,---,org,PROPN-PROPN-PROPN-PROPN,PROPN,compound-compound-compound-nsubj,compound,NNP-NNP-NNP-NNP,NNP,7,0
2602,2576.0,12,is,5,4,10,6,3,1,1,5,Taylor University,Upland,per-per,,PROPN-PROPN,PROPN,compound-nsubj,compound,NNP-NNP,NNP,5,0
2603,2577.0,16,were,7,1,15,14,0,0,6,8,Bodast,London,org,,NOUN,PROPN,nsubj,pobj,NN,NNP,4,0
2604,2579.0,26,After,0,4,9,5,3,16,-4,9,Troy High School,California,--,per,PROPN-PROPN-PROPN,PROPN,compound-compound-pobj,compound,NNP-NNP-NNP,NNP,6,0
2605,2580.0,18,raised,8,4,8,4,3,9,4,0,United Bank,Pakistan,-,org,PROPN-PROPN,PROPN,compound-compound,pobj,NNP-NNP,NNP,2,0
2606,2581.0,37,imprisoned,21,8,18,10,7,18,13,-3,South Africa,Charles Robberts Swart,-,per-per-per,PROPN-PROPN,PROPN-PROPN-PROPN,compound-pobj,compound-compound-pobj,NNP-NNP,NNP-NNP-NNP,7,0
2607,2582.0,16,became,7,3,12,9,2,3,4,5,Ukrainian Premier League,Dynamo,org-org-org,,PROPN-PROPN-PROPN,PROPN,compound-compound-compound,poss,NNP-NNP-NNP,NNP,5,0
2608,2583.0,27,announced,6,6,13,7,5,13,0,7,Wada,Square Enix,,per-per,PROPN,PROPN-PROPN,nsubj,compound-pobj,NNP,NNP-NNP,5,0
2609,2584.0,17,hired,4,7,14,7,6,2,-3,10,Augustana College,Rock Island,-,per-per,PROPN-PROPN,PROPN-PROPN,compound-pobj,compound-compound,NNP-NNP,NNP-NNP,6,0
2610,2585.0,33,retired,1,1,12,11,0,20,0,11,Hilgenbrinck,Catholic Mount St. Mary,per,---,PROPN,PROPN-PROPN-PROPN-PROPN,nsubj,compound-compound-compound-poss,NNP,NNP-NNP-NNP-NNP,4,0
2611,2586.0,42,formed,23,22,29,7,21,12,1,6,West,Envision Financial,,org-org,PROPN,PROPN-PROPN,pobj,compound-nsubj,NNP,NNP-NNP,3,0
2612,2587.0,21,was,1,6,16,10,5,4,-5,15,William Adams Richardson,Treasury,org-org-org,,PROPN-PROPN-PROPN,PROPN,compound-compound-pobj,pobj,NNP-NNP-NNP,NNP,5,0
2613,2588.0,40,spread,11,5,27,22,4,12,6,16,Bluey,Australia,,org,PROPN,PROPN,compound,pobj,NNP,NNP,5,0
2614,2589.0,14,is,3,1,12,11,0,1,2,9,Ben Bradlee Jr.,Boston,--,per,PROPN-PROPN-PROPN,PROPN,compound-compound-nsubj,compound,NNP-NNP-NNP,NNP,5,0
2615,2590.0,10,is,1,1,4,3,0,5,0,3,Linamar,Guelph,org,,PROPN,PROPN,nsubj,nmod,NNP,NNP,3,0
2616,2591.0,28,manufacturing,15,1,1,0,0,26,14,-14,Holden,Holden Special Vehicles,per,--,PROPN,PROPN-PROPN-PROPN,compound,compound-compound-conj,NNP,NNP-NNP-NNPS,0,0
2617,2592.0,22,grew,3,1,2,1,0,19,2,-1,Actress,Zooey Deschanel,org,-,PROPN,PROPN-PROPN,compound,compound-nsubj,NNP,NNP-NNP,1,0
2618,2593.0,31,partners,1,1,3,2,0,27,0,2,Elevation partners,Fred Anderson,org-org,-,NOUN-NOUN,PROPN-PROPN,nsubj-ROOT,compound-dobj,NN-NNS,NNP-NNP,2,0
2619,2594.0,24,stylized,3,15,23,8,14,0,-12,20,Kumi Koda,Japan,per-per,,PROPN-PROPN,PROPN,compound-pobj,pobj,NNP-NNP,NNP,4,0
2620,2595.0,36,expects,9,7,8,1,6,27,2,-1,Renault,Dacia,,org,PROPN,PROPN,compound,compound,NNP,NNP,1,0
2621,2596.0,26,said,2,14,21,7,13,4,-12,19,John Marshall,Virginia,org-org,,PROPN-PROPN,PROPN,compound-compound,pobj,NNP-NNP,NNP,4,0
2622,2597.0,41,was,7,28,34,6,27,6,-21,27,Discovery Communications,Maryland,org-org,,PROPN-PROPN,PROPN,compound-compound,pobj,NNP-NNPS,NNP,5,0
2623,2598.0,38,was,10,1,14,13,0,23,9,4,Claudio Arrau,pianist,-,per,PROPN-PROPN,NOUN,compound-nsubj,attr,NNP-NNP,NN,3,0
2624,2599.0,49,is,11,1,26,25,0,22,10,15,Sergio Berlato,Alleanza Nazionale,org-org,-,PROPN-PROPN,PROPN-PROPN,compound-nsubj,compound-pobj,NNP-NNP,NNP-NNP,5,0
2625,2600.0,20,is,6,5,19,14,4,0,1,13,NCC,Australia,,org,PROPN,PROPN,appos,pobj,NNP,NNP,7,0
2626,2601.0,19,is,4,10,10,0,9,8,-6,6,Kutztown University of Pennsylvania,Kutztown,org-org-org-org,,PROPN-PROPN-ADP-PROPN,PROPN,compound-pobj-prep-pobj,compound,NNP-NNP-IN-NNP,NNP,0,0
2627,2602.0,29,known,7,3,21,18,2,7,4,14,Lisa Furukawa,Japanese,-,org,PROPN-PROPN,ADJ,compound-nsubjpass,amod,NNP-NNP,JJ,3,0
2628,2603.0,15,be,1,5,10,5,4,4,-4,9,dancer,Savion Glover,,org-org,NOUN,PROPN-PROPN,nsubj,compound-nmod,NN,NNP-NNP,4,0
2629,2604.0,20,records,1,1,15,14,0,4,0,14,He,Holy Mountain,per,-,PRON,PROPN-PROPN,nsubj,compound-conj,PRP,NNP-NNP,3,0
2630,2605.0,22,was,2,8,13,5,7,8,-6,11,Uganda People's Congress,Milton Obote,org-org-org,-,PROPN-PROPN-PROPN,PROPN-PROPN,compound-compound-pobj,compound-pobj,NNP-NNP-NNP,NNP-NNP,4,0
2631,2606.0,16,is,11,2,10,8,1,5,9,-1,John Lees,England,per-per,,PROPN-PROPN,PROPN,compound-nsubj,pobj,NNP-NNP,NNP,1,0
2632,2607.0,33,Supporting,0,2,8,6,1,24,-2,8,Actor,Matt Damon,org,-,NOUN,PROPN-PROPN,dobj,compound-compound,NN,NNP-NNP,3,0
2633,2608.0,41,see,7,1,1,0,0,39,6,-6,Nanjing,Nanjing University,org,-,VERB,PROPN-PROPN,csubj,compound-compound,VBG,NNP-NNP,0,0
2634,2609.0,20,became,12,7,8,1,6,11,5,-4,Henry Ford,Ford Motor Company,-,per-per-per,PROPN-PROPN,PROPN-PROPN-PROPN,compound-compound,compound-compound-pobj,NNP-NNP,NNP-NNP-NNP,1,0
2635,2611.0,57,helped,17,13,20,7,12,36,4,3,FIBA Americas Championships,USA,per-per-per,,PROPN-PROPN-PROPN,PROPN,compound-compound-compound,compound,NNP-NNPS-NNPS,NNP,9,0
2636,2612.0,35,took,7,21,23,2,20,11,-14,16,London,MacMillan,per,,PROPN,PROPN,pobj,poss,NNP,NNP,6,0
2637,2613.0,39,grew,10,1,10,9,0,28,9,0,Cokie Roberts,NPR,org-org,,PROPN-PROPN,PROPN,compound-nsubj,conj,NNP-NNP,NNP,1,0
2638,2615.0,43,was,1,14,19,5,13,23,-13,18,Jefferson Davis,Confederate States,org-org,-,PROPN-PROPN,PROPN-PROPN,compound-dobj,compound-pobj,NNP-NNP,NNP-NNPS,3,0
2639,2616.0,28,is,7,1,17,16,0,10,6,10,Hero Ibrahim Ahmed,Jalal Talabani,per-per-per,-,PROPN-PROPN-PROPN,PROPN-PROPN,compound-compound-nsubj,compound-pobj,NNP-NNP-NNP,NNP-NNP,6,0
2640,2617.0,21,credited,16,2,8,6,1,12,14,-8,her,Val Kilmer,per,-,DET,PROPN-PROPN,poss,compound-appos,PRP$,NNP-NNP,4,0
2641,2618.0,16,co-founded,3,3,5,2,2,10,0,2,Bezeq,Yes,org,,PROPN,INTJ,nsubj,intj,NNP,UH,1,0
2642,2619.0,34,is,2,1,8,7,0,25,1,6,Ben,songwriter,org,,PROPN,NOUN,compound,conj,NNP,NN,4,0
2643,2620.0,12,is,4,1,11,10,0,0,3,7,Piedra Vista High School,1,per-per-per-per,,PROPN-PROPN-PROPN-PROPN,NUM,compound-compound-compound-nsubj,nummod,NNP-NNP-NNP-NNP,CD,3,0
2644,2621.0,62,visited,38,13,22,9,12,39,25,-16,Great Council,Sitiveni Rabuka,-,per-per,PROPN-PROPN,PROPN-PROPN,compound-pobj,compound-compound,NNP-NNP,NNP-NNP,4,0
2645,2622.0,29,Born,0,11,10,-1,10,18,-11,10,Muslim League,his,per-per,,PROPN-PROPN,DET,compound-compound,poss,NNP-NNP,PRP$,2,0
2646,2623.0,15,joined,4,4,8,4,3,6,0,4,Oliver,New York,,per-per,PROPN,PROPN-PROPN,nsubj,compound-compound,NNP,NNP-NNP,2,0
2647,2624.0,20,returned,1,4,15,11,3,4,-3,14,Fiji,University of the South Pacific,per,----,PROPN,PROPN-ADP-DET-PROPN-PROPN,pobj,pobj-prep-det-compound-pobj,NNP,NNP-IN-DT-NNP-NNP,5,0
2648,2625.0,17,elected,4,1,12,11,0,4,3,8,Udall,Colorado,,per,NOUN,PROPN,compound,compound,NN,NNP,5,0
2649,2626.0,33,has,6,4,20,16,3,12,2,14,Karnataka,National Law School of India University,,org-org-org-org-org-org,PROPN,PROPN-PROPN-PROPN-ADP-PROPN-PROPN,pobj,compound-compound-conj-prep-compound-pobj,NNP,NNP-NNP-NNP-IN-NNP-NNP,6,0
2650,2627.0,39,purchased,3,13,31,18,12,7,-10,28,Zuffa,Dana White,,org-org,PROPN,PROPN-PROPN,compound,compound-pobj,NNP,NNP-NNP,6,0
2651,2628.0,28,rocked,2,1,5,4,0,22,1,3,Bruce Springsteen,US,-,per,PROPN-PROPN,PROPN,compound-nsubj,nmod,NNP-NNP,NNP,4,0
2652,2629.0,10,released,2,1,8,7,0,1,1,6,Gaines,Motown Records,org,-,NOUN,PROPN-PROPN,nsubj,compound-pobj,NNS,NNP-NNPS,3,0
2653,2630.0,19,Mexico,5,12,12,0,11,6,-7,7,Delft University of Technology,Delft,---,per,PROPN-PROPN-ADP-PROPN,PROPN,nmod-appos-prep-pobj,compound,NNP-NNP-IN-NNP,NNP,0,0
2654,2631.0,15,is,2,1,6,5,0,8,1,4,Ted Bruner,musician,per-per,,PROPN-PROPN,ADJ,compound-nsubj,amod,NNP-NNP,JJ,2,0
2655,2632.0,70,hosts,42,58,64,6,57,5,-16,22,CUNY TV,New York,-,per-per,PROPN-NOUN,PROPN-PROPN,compound-pobj,compound-compound,NNP-NN,NNP-NNP,3,0
2656,2633.0,37,increase,1,24,29,5,23,7,-23,28,Mario Draghi,Rome,per-per,,PROPN-PROPN,PROPN,compound-nsubj,pobj,NNP-NNP,NNP,7,0
2657,2634.0,25,fluctuated,5,11,18,7,10,6,-6,13,Ted Leo,songwriter,-,per,PROPN-PROPN,NOUN,compound-nsubj,nmod,NNP-NNP,NN,7,0
2658,2635.0,17,acquired,2,4,15,11,3,1,-2,13,Princess,Stanley McDonald,per,-,PROPN,PROPN-PROPN,compound,compound-pobj,NNP,NNP-NNP,5,0
2659,2636.0,37,had,8,1,14,13,0,22,7,6,KVS,SA,,org,PROPN,PROPN,nsubj,compound,NNP,NNP,7,0
2660,2637.0,17,was,1,1,8,7,0,8,0,7,MacKay,Progressive Conservative Party,per,--,PROPN,PROPN-PROPN-PROPN,nsubj,compound-compound-pobj,NNP,NNP-NNP-NNP,4,0
2661,2638.0,23,remained,1,15,22,7,14,0,-14,21,Jim Talent,Missouri,-,org,PROPN-PROPN,PROPN,compound-poss,pobj,NNP-NNP,NNP,7,0
2662,2639.0,28,began,9,8,8,0,7,19,1,-1,TAP Portugal,TAP,-,per,PROPN-PROPN,PROPN,compound-nsubj,dobj,NNP-NNP,NNP,0,0
2663,2641.0,46,conglomerate,2,14,31,17,13,14,-12,29,Citic Pacific,Hong Kong,per-per,-,PROPN-PROPN,PROPN-PROPN,compound-nsubj,compound-pobj,NNP-NNP,NNP-NNP,11,0
2664,2642.0,53,consisted,8,47,51,4,46,1,-39,43,Pacific Air Forces,PACAF,--,org,PROPN-PROPN-PROPN,PROPN,compound-compound-dobj,appos,NNP-NNP-NNPS,NNP,2,0
2665,2643.0,7,set,1,1,5,4,0,1,0,4,Burberry,London,per,,PROPN,PROPN,nsubj,compound,NNP,NNP,3,0
2666,2644.0,24,voted,5,3,10,7,2,13,2,5,Lang,Australia,,org,PROPN,PROPN,poss,compound,NNP,NNP,6,0
2667,2645.0,56,Prevented,0,16,50,34,15,5,-16,50,Atienza,Environment and Natural Resources,org,---,PROPN,PROPN-CCONJ-PROPN-PROPN,nsubjpass,pobj-cc-compound-compound,NNP,NNP-CC-NNP-NNPS,8,0
2668,2646.0,28,is,8,2,19,17,1,8,6,11,Northwestern Wildcats,Big Ten,per-per,-,PROPN-PROPN,PROPN-PROPN,compound-compound,compound-compound,NNP-NNP,NNP-NNP,7,0
2669,2647.0,32,Orchids,0,13,24,11,12,7,-13,24,University Press of Florida,Gainesville,per-per-per-per,,PROPN-PROPN-ADP-PROPN,PROPN,compound-conj-prep-compound,compound,NNP-NNP-IN-NNP,NNP,-1,0
2670,2648.0,25,voted,3,1,12,11,0,12,2,9,Iceland,Haarde,org,,PROPN,PROPN,poss,pobj,NNP,NNP,6,0
2671,2649.0,30,criticized,3,1,13,12,0,16,2,10,Merz,Switzerland,per,,PROPN,PROPN,nsubjpass,poss,NNP,NNP,8,0
2672,2650.0,30,married,3,9,26,17,8,3,-6,23,Beatrice Fullerton,Bethany High School,org-org,--,PROPN-PROPN,PROPN-PROPN-PROPN,compound-compound,compound-compound-compound,NNP-NNP,NNP-NNP-NNP,6,0
2673,2651.0,33,opened,5,24,30,6,23,2,-19,25,Humble Oil,Ross S. Sterling,per-per,--,PROPN-PROPN,PROPN-PROPN-PROPN,nmod-nmod,compound-compound-pobj,NNP-NNP,NNP-NNP-NNP,4,0
2674,2653.0,29,serve,23,20,23,3,19,5,3,0,Schurr High School,Montebello,org-org-org,,PROPN-PROPN-PROPN,PROPN,compound-compound-compound,compound,NNP-NNP-NNP,NNP,-1,0
2675,2654.0,15,established,5,4,9,5,3,5,1,4,Johnny Associates,J Storm,org-org,-,PROPN-PROPN,PROPN-PROPN,compound-nsubj,compound-appos,NNP-NNPS,NNP-NNP,2,0
2676,2655.0,26,served,1,10,16,6,9,9,-9,15,New Jersey,University of Medicine and Dentistry of New Jersey,per-per,-------,PROPN-PROPN,PROPN-ADP-PROPN-CCONJ-PROPN-ADP-PROPN-PROPN,compound-compound,pobj-prep-pobj-cc-conj-prep-compound-pobj,NNP-NNP,NNP-IN-NNP-CC-NNP-IN-NNP-NNP,4,0
2677,2656.0,11,opened,2,2,10,8,1,0,0,8,university,1964,per,,NOUN,NUM,nsubj,nummod,NN,CD,1,0
2678,2657.0,40,advised,4,16,22,6,15,17,-12,18,NYSE,Blackstone Group,org,-,PROPN,PROPN-PROPN,pobj,compound-nmod,NNP,NNP-NNP,2,0
2679,2658.0,45,episode,7,6,15,9,5,29,1,8,The Monkees,Davy Jones,per-per,-,DET-PROPN,PROPN-PROPN,det-nsubj,compound-appos,DT-NNPS,NNP-NNP,6,0
2680,2659.0,26,is,3,14,25,11,13,0,-11,22,University of Pittsburgh,Pennsylvania,org-org-org,,PROPN-ADP-PROPN,PROPN,pobj-prep-pobj,pobj,NNP-IN-NNP,NNP,7,0
2681,2660.0,115,McMahon,24,108,110,2,107,4,-84,86,Guardian Angels,Curtis Sliwa,org-org,-,PROPN-PROPN,PROPN-PROPN,compound-compound,compound-pobj,NNP-NNPS,NNP-NNP,3,0
2682,2661.0,40,known,4,1,29,28,0,10,3,25,Gaius Marius,politician,per-per,,PROPN-PROPN,NOUN,compound-compound,conj,NNP-NNP,NN,6,0
2683,2662.0,49,http://www.smartvoter.org/2004/11/02/oh/state/vote/brinkman_t/questions.html,0,9,30,21,8,18,-9,30,Brinkman,Ohio,per,,PROPN,PROPN,nsubj,compound,NNP,NNP,6,0
2684,2663.0,23,entered,1,8,17,9,7,5,-7,16,Socialist Party,Hollande,per-per,,PROPN-PROPN,PROPN,compound-pobj,appos,NNP-NNP,NNP,7,0
2685,2664.0,44,said,17,40,43,3,39,0,-23,26,Colby College,Maine,-,org,PROPN-PROPN,PROPN,compound-conj,pobj,NNP-NNP,NNP,7,0
2686,2665.0,21,were,5,4,16,12,3,4,1,11,Romina Power,Albano Carrisi,org-org,-,PROPN-PROPN,PROPN-PROPN,compound-conj,compound-pobj,NNP-NNP,NNP-NNP,6,0
2687,2666.0,15,asked,11,6,9,3,5,5,5,-2,Howard Baker,Tennessee,-,per,PROPN-PROPN,PROPN,compound-nsubj,pobj,NNP-NNP,NNP,4,0
2688,2667.0,10,Persecution,1,4,6,2,3,3,-3,5,BHS,18/12/98,per,,PROPN,NUM,compound,appos,NNP,CD,3,0
2689,2668.0,25,hired,14,12,20,8,11,4,2,6,Bayh,Indianapolis,,org,PROPN,PROPN,pobj,compound,NNP,NNP,7,0
2690,2669.0,21,had,4,1,18,17,0,2,3,14,Tempe,America West Airlines,org,--,PROPN,PROPN-PROPN-PROPN,nsubj,compound-compound-pobj,NNP,NNP-NNP-NNPS,7,0
2691,2670.0,23,grace,5,1,3,2,0,19,4,-2,US,Bruce Springsteen,,per-per,PROPN,PROPN-PROPN,compound,compound-nsubj,NNP,NNP-NNP,1,0
2692,2671.0,32,purchased,6,5,22,17,4,9,1,16,Hainan Airlines,Grand China Air,org-org,--,PROPN-PROPN,PROPN-PROPN-PROPN,compound-nsubj,compound-compound-pobj,NNP-NNPS,NNP-NNP-NNP,5,0
2693,2672.0,47,Shartava,1,1,15,14,0,31,0,14,Zhiuli Shartava,Georgian,-,org,PROPN-PROPN,ADJ,compound-ROOT,amod,NNP-NNP,JJ,2,0
2694,2673.0,41,is,4,1,12,11,0,28,3,8,Wheels,New Jersey,org,-,PROPN,PROPN-PROPN,compound,compound-pobj,NNP,NNP-NNP,9,0
2695,2674.0,66,contacted,7,33,50,17,32,15,-26,43,Rufus Thomas,Stax,org-org,,PROPN-PROPN,PROPN,compound-appos,compound,NNP-NNP,NNP,7,0
2696,2675.0,42,questioned,24,29,38,9,28,3,-5,14,Fox Sports,Australia,org-org,,PROPN-PROPN,PROPN,compound-pobj,pobj,NNP-NNPS,NNP,3,0
2697,2676.0,19,became,1,6,12,6,5,6,-5,11,Marvel UK,Paul Neary,org-org,-,PROPN-PROPN,PROPN-PROPN,compound-poss,compound-nsubj,NNP-NNP,NNP-NNP,6,0
2698,2677.0,15,won,6,3,12,9,2,2,3,6,Speaker Morgan,Navajo Nation Council,org-org,--,PROPN-PROPN,PROPN-PROPN-PROPN,compound-nsubj,compound-compound-dobj,NNP-NNP,NNP-NNP-NNP,4,0
2699,2678.0,35,auditioned,3,6,25,19,5,9,-3,22,Motown,Michael Jackson,org,-,PROPN,PROPN-PROPN,compound,compound-nsubj,NNP,NNP-NNP,8,0
2700,2679.0,34,was,1,8,23,15,7,10,-7,22,he,Democratic Kampuchea,org,-,PRON,ADJ-PROPN,nsubj,compound-pobj,PRP,JJ-NNP,4,0
2701,2680.0,32,said,17,26,29,3,25,2,-9,12,Meredith College,Raleigh,per-per,,PROPN-PROPN,PROPN,compound-pobj,compound,NNP-NNP,NNP,3,0
2702,2681.0,44,described,2,1,12,11,0,31,1,10,Christopher Cox,Chairman,per-per,,PROPN-PROPN,PROPN,compound-nsubj,attr,NNP-NNP,NNP,4,0
2703,2682.0,31,handed,6,21,29,8,20,1,-15,23,Kyocera,KDDI,,per,PROPN,PROPN,compound,compound,NNP,NNP,2,0
2704,2683.0,52,Ford's,0,13,21,8,12,30,-13,21,Fonda,USA,org,,PROPN,PROPN,pobj,pobj,NNP,NNP,6,0
2705,2684.0,110,Source,0,86,30,-56,85,79,-86,30,Democrat Party,Sonthi Boonyaratglin,org-org,-,PROPN-PROPN,PROPN-PROPN,compound-npadvmod,compound-compound,NNP-NNP,NNP-NNP,-1,0
2706,2685.0,23,is,3,5,20,15,4,2,-2,17,Alison Redford,Alberta,per-per,,PROPN-PROPN,PROPN,compound-attr,nmod,NNP-NNP,NNP,5,0
2707,2686.0,38,was,13,16,36,20,15,1,-3,23,British,Margaret Thatcher,org,-,ADJ,PROPN-PROPN,amod,compound-pobj,JJ,NNP-NNP,5,0
2708,2687.0,25,controlled,1,1,6,5,0,18,0,5,USARSOC,Special Operations Forces,per,--,PROPN,PROPN-PROPN-PROPN,nsubj,compound-compound-dobj,NNP,NNP-NNPS-NNPS,3,0
2709,2688.0,37,come,7,6,16,10,5,20,1,9,Bangladesh,SAARC,,org,PROPN,PROPN,pobj,dobj,NNP,NNP,7,0
2710,2690.0,23,is,11,1,17,16,0,5,10,6,Christina Rau,Johannes Rau,-,org-org,PROPN-PROPN,PROPN-PROPN,compound-compound,compound-npadvmod,NNP-NNP,NNP-NNP,4,0
2711,2691.0,22,called,3,2,6,4,1,15,1,3,Efromovich,OceanAir,per,,PROPN,PROPN,compound,oprd,NNP,NNP,2,0
2712,2692.0,30,said,16,10,13,3,9,16,6,-3,Brentwood school,Long Island,org-org,-,PROPN-NOUN,PROPN-PROPN,compound-compound,compound-poss,NNP-NN,NNP-NNP,6,0
2713,2693.0,20,is,2,1,19,18,0,0,1,17,Staffordshire Police,England,per-per,,PROPN-PROPN,PROPN,compound-nsubj,pobj,NNP-NNP,NNP,10,0
2714,2694.0,16,is,5,1,14,13,0,1,4,9,Animo Locke Technology High School,California,org-org-org-org-org,,PROPN-PROPN-PROPN-PROPN-PROPN,PROPN,compound-compound-compound-compound-nsubj,compound,NNP-NNP-NNP-NNP-NNP,NNP,5,0
2715,2695.0,32,is,1,8,23,15,7,8,-7,22,University of Nairobi,Kenya,org-org-org,,PROPN-ADP-PROPN,PROPN,pobj-prep-pobj,pobj,NNP-IN-NNP,NNP,9,0
2716,2696.0,46,named,9,38,44,6,37,1,-29,35,David M. Cote,Honeywell,per-per-per,,PROPN-PROPN-PROPN,PROPN,compound-compound-conj,compound,NNP-NNP-NNP,NNP,4,0
2717,2697.0,40,submitted,8,8,31,23,7,8,0,23,he,Melbourne,,per,PRON,PROPN,nsubj,pobj,PRP,NNP,5,0
2718,2698.0,55,spend,4,30,16,-14,29,38,-26,12,USA,Guardian Angels,per,-,PROPN,PROPN-PROPN,compound,compound-pobj,NNP,NNP-NNPS,-1,0
2719,2699.0,23,attended,1,17,20,3,16,2,-16,19,Chapman University,Orange,org-org,,PROPN-PROPN,PROPN,compound-conj,compound,NNP-NNP,NNP,8,0
2720,2700.0,38,is,16,3,24,21,2,13,13,8,Italy,Giuseppe Rinaldi,per,-,PROPN,PROPN-PROPN,pobj,compound-conj,NNP,NNP-NNP,4,0
2721,2701.0,20,met,4,17,18,1,16,1,-13,14,Lithuania,Valdas Adamkus,org,-,PROPN,PROPN-PROPN,compound,compound-pobj,NNP,NNP-NNP,1,0
2722,2702.0,56,was,22,1,43,42,0,12,21,21,John Alexander,United States,per-per,-,PROPN-PROPN,PROPN-PROPN,compound-compound,compound-compound,NNP-NNP,NNP-NNP,8,0
2723,2703.0,31,experienced,2,10,15,5,9,15,-8,13,DJ Krush,Japan,-,per,PROPN-PROPN,PROPN,compound-nsubj,poss,NNP-NNP,NNP,6,0
2724,2706.0,25,scheduled,14,3,7,4,2,17,11,-7,Levy Mwanawasa,Democratic Republic of Congo,org-org,---,PROPN-PROPN,PROPN-PROPN-ADP-PROPN,compound-nsubjpass,nmod-nmod-prep-pobj,NNP-NNP,NNP-NNP-IN-NNP,2,0
2725,2707.0,37,stayed,13,30,33,3,29,3,-17,20,Hotel,Sheraton Hotels and Resorts,,org-org-org-org,PROPN,PROPN-PROPN-CCONJ-PROPN,pobj,compound-pobj-cc-conj,NNP,NNP-NNPS-CC-NNPS,5,0
2726,2708.0,35,is,1,17,33,16,16,1,-16,32,Bank of England,UK,org-org-org,,PROPN-ADP-PROPN,PROPN,pobj-prep-pobj,compound,NNP-IN-NNP,NNP,11,0
2727,2709.0,20,is,3,10,17,7,9,2,-7,14,University of the West of England,Bristol,-----,per,PROPN-ADP-DET-PROPN-ADP-PROPN,PROPN,pobj-prep-det-pobj-prep-pobj,compound,NNP-IN-DT-NNP-IN-NNP,NNP,4,0
2728,2711.0,42,are,1,10,16,6,9,25,-9,15,University of Sierra Leone,Fourah Bay College,org-org-org-org,--,PROPN-ADP-PROPN-PROPN,PROPN-PROPN-PROPN,nsubj-prep-compound-pobj,compound-compound-pobj,NNP-IN-NNP-NNP,NNP-NNP-NNP,5,0
2729,2712.0,26,served,11,1,16,15,0,9,10,5,Martin H. Kennelly,Chicago,org-org-org,,PROPN-PROPN-PROPN,PROPN,compound-compound-nsubj,compound,NNP-NNP-NNP,NNP,6,0
2730,2713.0,25,was,6,1,15,14,0,9,5,9,Tetsu,Japan,org,,PROPN,PROPN,compound,pobj,NNP,NNP,7,0
2731,2714.0,22,arrived,1,4,16,12,3,5,-3,15,Austria,Thomas Klestil,org,-,PROPN,PROPN-PROPN,pobj,compound-pobj,NNP,NNP-NNP,6,0
2732,2715.0,19,worked,2,8,15,7,7,3,-6,13,Arthur Eve,New York,-,org-org,PROPN-PROPN,PROPN-PROPN,compound-pobj,compound-compound,NNP-NNP,NNP-NNP,6,0
2733,2716.0,34,Reyhan,0,1,13,12,0,20,-1,13,Reyhan ?ahi,; German,per-per,-,PROPN-PROPN,PUNCT-ADJ,ROOT-punct,punct-amod,NNP-NNP,:-JJ,-1,0
2734,2717.0,25,began,12,10,17,7,9,7,2,5,Hartman,Petra,,org,PROPN,PROPN,pobj,poss,NNP,NNP,11,0
2735,2719.0,14,was,1,1,13,12,0,0,0,12,He,India,,per,PRON,PROPN,nsubj,pobj,PRP,NNP,1,0
2736,2720.0,15,States,3,1,3,2,0,11,2,0,George,United States,,per-per,PROPN,PROPN-PROPN,compound,compound-ROOT,NNP,NNP-NNP,1,0
2737,2721.0,18,is,8,1,16,15,0,1,7,8,Lowell Selvin,PlanetOut Inc.,per-per,-,PROPN-PROPN,PROPN-PROPN,compound-nsubj,compound-pobj,NNP-NNP,NNP-NNP,4,0
2738,2722.0,23,named,10,6,8,2,5,14,4,-2,ACLU,1920,per,,PROPN,NUM,pobj,compound,NNP,CD,2,0
2739,2723.0,35,visited,1,1,14,13,0,20,0,13,Geyer,ABC-TV,org,,PROPN,ADJ,nsubj,amod,NNP,JJ,8,0
2740,2724.0,13,grew,2,2,10,8,1,2,0,8,Castro,Dallas,,per,PROPN,PROPN,nsubj,pobj,NNP,NNP,1,0
2741,2725.0,25,attended,8,5,11,6,4,13,3,3,London,Henrietta Barnett School,per,--,PROPN,PROPN-PROPN-PROPN,compound,compound-compound-dobj,NNP,NNP-NNP-NNP,5,0
2742,2726.0,28,created,13,1,22,21,0,5,12,9,Chile,Juan Antonio,,org-org,PROPN,PROPN-PROPN,poss,compound-pobj,NNP,NNP-NNP,8,0
2743,2727.0,23,moved,1,4,19,15,3,3,-3,18,England,Latymer Upper School,org,--,PROPN,PROPN-PROPN-PROPN,pobj,compound-compound-compound,NNP,NNP-NNP-NNP,7,0
2744,2728.0,32,poached,6,8,10,2,7,21,-2,4,Ericsson,Carl-Henric Svanberg,org,-,PROPN,PROPN-PROPN,compound,compound-dobj,NNP,NNP-NNP,2,0
2745,2729.0,33,taken,5,12,20,8,11,12,-7,15,Rawalpindi,Yahya Khan,per,-,PROPN,PROPN-PROPN,pobj,compound-pobj,NNP,NNP-NNP,3,0
2746,2730.0,23,served,8,8,21,13,7,1,0,13,Yulee,Florida,,org,PROPN,PROPN,nsubj,nsubj,NNP,NNP,4,0
2747,2731.0,36,supported,6,12,15,3,11,20,-6,9,Delaware,DuPont,per,,PROPN,PROPN,npadvmod,pobj,NNP,NNP,3,0
2748,2732.0,26,were,7,2,24,22,1,1,5,17,United States,George Washington,per-per,-,PROPN-PROPN,PROPN-PROPN,compound-compound,compound-pobj,NNP-NNP,NNP-NNP,9,0
2749,2733.0,40,established,3,29,38,9,28,1,-26,35,President,Chaim Weizmann,,per-per,PROPN,PROPN-PROPN,pobj,compound-pobj,NNP,NNP-NNP,9,0
2750,2735.0,42,include,3,6,36,30,5,5,-3,33,Atlanta,Pace Academy,per,-,PROPN,PROPN-PROPN,compound,compound-ROOT,NNP,NNP-NNP,2,0
2751,2736.0,25,incorporated,9,2,12,10,1,12,7,3,Yazoo and Mississippi Valley Railroad,1882,per-per-per-per-per,,PROPN-CCONJ-PROPN-PROPN-PROPN,NUM,nmod-cc-conj-compound-nsubjpass,pobj,NNP-CC-NNP-NNP-NNP,CD,4,0
2752,2738.0,19,called,2,1,18,17,0,0,1,16,NOC,Oklahoma,per,,PROPN,PROPN,nsubj,pobj,NNP,NNP,2,0
2753,2739.0,37,said,3,9,31,22,8,5,-6,28,Oneworld,British Airways,per,-,PROPN,PROPN-PROPN,compound,compound-compound,NNP,NNP-NNP,9,0
2754,2740.0,33,was,1,12,23,11,11,9,-11,22,Lithuania,Adamkus,,org,PROPN,PROPN,poss,nsubj,NNP,NNP,7,0
2755,2741.0,40,said,20,11,19,8,10,20,9,-1,International Association of Machinists and Aerospace Workers,IAM,org-org-org-org-org-org-org,,PROPN-PROPN-ADP-PROPN-CCONJ-PROPN-PROPN,PROPN,compound-nsubj-prep-pobj-cc-compound-conj,appos,NNP-NNP-IN-NNPS-CC-NNP-NNPS,NNP,1,0
2756,2742.0,19,been,2,8,17,9,7,1,-6,15,Irish,John Duddy,per,-,ADJ,PROPN-PROPN,amod,compound-dobj,JJ,NNP-NNP,4,0
2757,2743.0,32,is,11,4,30,26,3,1,7,19,Grateful Dead,Warner Bros,per-per,-,PROPN-PROPN,PROPN-PROPN,compound-compound,compound-pobj,NNP-NNP,NNP-NNP,11,0
2758,2744.0,36,studied,8,16,18,2,15,17,-8,10,University of Pisa,Pisa,--,org,PROPN-ADP-PROPN,PROPN,pobj-prep-pobj,pobj,NNP-IN-NNP,NNP,4,0
2759,2745.0,26,was,1,21,24,3,20,1,-20,23,Wiley College,Marshall,-,per,PROPN-PROPN,PROPN,compound-pobj,compound,NNP-NNP,NNP,4,0
2760,2746.0,21,attended,1,1,12,11,0,8,0,11,He,Tennessee,,org,PRON,PROPN,nsubj,pobj,PRP,NNP,4,0
2761,2747.0,13,is,3,1,11,10,0,1,2,8,Westside High School,United States,org-org-org,-,PROPN-PROPN-PROPN,PROPN-PROPN,compound-compound-nsubj,compound-pobj,NNP-NNP-NNP,NNP-NNP,5,0
2762,2748.0,19,plays,3,9,17,8,8,1,-6,14,The Frustrators,Adeline Records,-,per-per,DET-PROPN,PROPN-PROPN,det-appos,compound-appos,DT-NNPS,NNP-NNPS,4,0
2763,2749.0,22,parents,2,1,21,20,0,0,1,19,Martyn,England,per,,PROPN,PROPN,poss,conj,NNP,NNP,4,0
2764,2750.0,15,left,1,1,4,3,0,10,0,3,She,Illinois,,org,PRON,PROPN,nsubj,compound,PRP,NNP,1,0
2765,2751.0,42,was,1,9,11,2,8,30,-8,10,Transport,John Baird,,per-per,PROPN,PROPN-PROPN,compound,compound-nsubj,NNP,NNP-NNP,1,0
2766,2752.0,31,used,26,7,8,1,6,22,19,-18,League,Trinidad and Tobago,,per-per-per,PROPN,PROPN-CCONJ-PROPN,compound,pobj-cc-poss,NNP,NNP-CC-NNP,1,0
2767,2753.0,27,located,23,2,2,0,1,24,21,-21,Philippine Science High School Western Visayas Campus,Philippine Science High School,per-per-per-per-per-per-per,---,PROPN-PROPN-PROPN-PROPN-PROPN-PROPN-PROPN,PROPN-PROPN-PROPN-PROPN,compound-compound-compound-compound-compound-compound-nmod,compound-compound-compound-compound,NNP-NNP-NNP-NNP-NNP-NNP-NNP,NNP-NNP-NNP-NNP,0,0
2768,2754.0,18,created,2,2,9,7,1,8,0,7,airline,Jetstar Airways,,org-org,NOUN,PROPN-PROPN,nsubj,compound-appos,NN,NNP-NNP,1,0
2769,2755.0,28,is,1,5,17,12,4,10,-4,16,Iowa State University,research university,org-org-org,-,PROPN-PROPN-PROPN,NOUN-NOUN,compound-compound-nmod,compound-pobj,NNP-NNP-NNP,NN-NN,6,0
2770,2756.0,30,is,14,22,27,5,21,2,-8,13,Gold Coast Titans,National Rugby League,per-per-per,--,PROPN-PROPN-PROPN,PROPN-PROPN-PROPN,compound-compound-pobj,compound-compound-pobj,NNP-NNP-NNPS,NNP-NNP-NNP,4,0
2771,2758.0,21,sold,8,11,18,7,10,2,-3,10,Eagle Airways,Air New Zealand,org-org,--,PROPN-PROPN,PROPN-PROPN-PROPN,compound-pobj,compound-compound-pobj,NNP-NNP,NNP-NNP-NNP,7,0
2772,2759.0,23,demonstrated,11,6,8,2,5,14,5,-3,University of Panama,Panama City,--,per-per,PROPN-ADP-PROPN,PROPN-PROPN,pobj-prep-pobj,compound-pobj,NNP-IN-NNP,NNP-NNP,3,0
2773,2760.0,29,regarded,7,24,25,1,23,3,-17,18,Navy,George von Lengerke Meyer,org,---,PROPN,PROPN-PROPN-PROPN-PROPN,compound,compound-compound-compound-pobj,NNP,NNP-NNP-NNP-NNP,2,0
2774,2762.0,36,rumored,28,4,17,13,3,18,24,-11,Ice Cube,N.W.A,per-per,,PROPN-PROPN,PROPN,compound-poss,compound,NNP-NNP,NNP,6,0
2775,2763.0,7,belonged,2,1,5,4,0,1,1,3,Black Beat,SM Entertainment,org-org,-,PROPN-PROPN,PROPN-PROPN,compound-nsubj,compound-pobj,NNP-NNP,NNP-NNP,3,0
2776,2764.0,26,Deadline,1,16,16,0,15,9,-15,15,Osaka University,Osaka,org-org,,PROPN-PROPN,PROPN,compound-compound,compound,NNP-NNP,NNP,0,0
2777,2765.0,30,assassinated,5,10,11,1,9,18,-5,6,Afghanistan,Nur Muhammad Taraki,per,--,PROPN,PROPN-PROPN-PROPN,pobj,compound-compound-appos,NNP,NNP-NNP-NNP,2,0
2778,2766.0,24,refers,3,10,12,2,9,11,-7,9,VFA-14,Tophatters,org,,PROPN,PROPN,appos,nsubj,NNP,NNPS,3,0
2779,2767.0,26,is,12,1,11,10,0,14,11,-1,Ulises,Mexico,per,,PROPN,PROPN,compound,pobj,NNP,NNP,1,0
2780,2768.0,21,performing,3,1,20,19,0,0,2,17,The Police,England,per-per,,DET-NOUN,PROPN,det-nsubj,conj,DT-NNS,NNP,2,0
2781,2769.0,39,met,4,13,11,-2,12,27,-9,7,Northern Virginia,Army of the Potomac,per-per,---,PROPN-PROPN,PROPN-ADP-DET-PROPN,compound-pobj,pobj-prep-det-pobj,NNP-NNP,NNP-IN-DT-NNP,1,0
2782,2770.0,30,elected,2,1,18,17,0,11,1,16,He,Liberal,,per,PRON,ADJ,nsubjpass,amod,PRP,JJ,7,0
2783,2771.0,30,placed,2,1,22,21,0,7,1,20,Huang,China,org,,PROPN,PROPN,nsubjpass,poss,NNP,NNP,7,0
2784,2772.0,23,announced,7,6,15,9,5,7,1,8,Dr. Mahathir,Malaysia,-,org,PROPN-PROPN,PROPN,compound-nsubj,pobj,NNP-NNP,NNP,5,0
2785,2773.0,40,said,35,25,27,2,24,12,10,-8,IntelCenter,Alexandria,org,,PROPN,PROPN,pobj,compound,NNP,NNP,3,0
2786,2774.0,12,won,1,5,11,6,4,0,-4,10,FIBA World Championship for Women,Australia,org-org-org-org-org,,PROPN-PROPN-PROPN-ADP-PROPN,PROPN,compound-compound-dobj-prep-pobj,pobj,NNP-NNP-NNP-IN-NNPS,NNP,3,0
2787,2775.0,14,left,1,1,6,5,0,7,0,5,He,Guangzhou,,org,PRON,PROPN,nsubj,pobj,PRP,NNP,2,0
2788,2776.0,46,On,0,30,34,4,29,11,-30,34,Edward VII of the United Kingdom,United Kingdom,org-org-org-org-org-org,-,PROPN-PROPN-ADP-DET-PROPN-PROPN,PROPN-PROPN,compound-pobj-prep-det-compound-pobj,compound-pobj,NNP-NNP-IN-DT-NNP-NNP,NNP-NNP,4,0
2789,2777.0,19,Japan,2,3,10,7,2,8,-1,8,Japan,Tomiichi Murayama,org,-,PROPN,PROPN-PROPN,ROOT,compound-pobj,NNP,NNP-NNP,3,0
2790,2778.0,29,is,4,1,26,25,0,2,3,22,West Kirby Grammar School,Wirral Peninsula,org-org-org-org,-,PROPN-PROPN-PROPN-PROPN,PROPN-PROPN,compound-compound-compound-nsubj,compound-compound,NNP-NNP-NNP-NNP,NNP-NNP,10,0
2791,2779.0,28,include,12,12,14,2,11,13,0,2,Greece,Makedonia,,per,PROPN,PROPN,pobj,dobj,NNP,NNP,7,0
2792,2780.0,51,said,26,28,46,18,27,4,-2,20,Peter Andrews,University of Sheffield,-,per-per-per,PROPN-PROPN,PROPN-ADP-PROPN,compound-nsubj,conj-prep-pobj,NNP-NNP,NNP-IN-NNP,8,0
2793,2781.0,22,founded,8,7,10,3,6,11,1,2,Robert Rosenwald,Poisoned Pen Press,-,org-org-org,PROPN-PROPN,PROPN-PROPN-PROPN,compound-appos,compound-compound-dative,NNP-NNP,NNP-NNP-NNP,5,0
2794,2782.0,25,is,3,9,24,15,8,0,-6,21,Karen Carpenter,Carpenters,-,org,PROPN-PROPN,PROPN,compound-poss,attr,NNP-NNP,NNPS,6,0
2795,2783.0,61,Reagan,4,3,20,17,2,40,1,16,Governor,George W. Romney,org,--,PROPN,PROPN-PROPN-PROPN,compound,compound-compound-compound,NNP,NNP-NNP-NNP,5,0
2796,2784.0,30,founded,3,1,6,5,0,23,2,3,Taco Bell,Glen Bell,-,per-per,PROPN-PROPN,PROPN-PROPN,compound-nsubjpass,compound-pobj,NNP-NNP,NNP-NNP,3,0
2797,2785.0,22,Vegas,1,5,7,2,4,14,-4,6,Cristian Mijares,Mexico,org-org,,PROPN-PROPN,PROPN,compound-compound,dobj,NNP-NNP,NNP,2,0
2798,2786.0,20,founded,5,7,7,0,6,12,-2,2,Sunderland,Sunderland A.F.C.,per,-,PROPN,PROPN-PROPN,dobj,compound-attr,NNP,NNP-NNP,0,0
2799,2787.0,38,University,2,1,19,18,0,18,1,17,La Sierra University,Riverside,org-org-org,,PROPN-PROPN-PROPN,PROPN,compound-compound-ROOT,compound,NNP-NNP-NNP,NNP,3,0
2800,2788.0,20,said,6,1,4,3,0,15,5,-2,Frederick A. Henderson,GM,--,org,PROPN-NOUN-PROPN,PROPN,compound-compound-compound,poss,NNP-NN-NNP,NNP,2,0
2801,2789.0,41,deployed,28,12,23,11,11,17,16,-5,42nd Infantry Division,Troy,per-per-per,,PROPN-PROPN-PROPN,PROPN,compound-compound-pobj,compound,NNP-NNP-NNP,NNP,7,0
2802,2790.0,34,takes,7,11,26,15,10,7,-4,19,Gweedore,Mhaonaigh,per,,PROPN,PROPN,pobj,pobj,NNP,NNP,10,0
2803,2791.0,33,worked,1,12,21,9,11,11,-11,20,New York,Institute of Culinary Education,per-per,---,PROPN-PROPN,PROPN-ADP-PROPN-PROPN,compound-compound,pobj-prep-compound-pobj,NNP-NNP,NNP-IN-NNP-NNP,9,0
2804,2792.0,45,is,5,12,31,19,11,13,-7,26,Motown,The Supremes,org,-,PROPN,DET-PROPN,compound,det-compound,NNP,DT-NNP,4,0
2805,2793.0,40,left,1,37,38,1,36,1,-36,37,France,Championnat National,org,-,PROPN,PROPN-PROPN,compound,compound-pobj,NNP,NNP-NNP,1,0
2806,2794.0,34,participated,1,1,10,9,0,23,0,9,Ireland,Radio,per,,PROPN,PROPN,nsubj,pobj,NNP,NNP,3,0
2807,2795.0,35,overseen,2,11,11,0,10,23,-9,9,Bangor,Bangor University,per,-,PROPN,PROPN-PROPN,pobj,compound-oprd,NNP,NNP-NNP,0,0
2808,2796.0,27,is,11,1,17,16,0,9,10,6,HELP University College,Malaysia,--,per,PROPN-PROPN-PROPN,PROPN,compound-compound-pobj,pobj,NNP-NNP-NNP,NNP,2,0
2809,2798.0,39,was,9,2,19,17,1,19,7,10,Hugh Briggs,University of Adelaide,-,org-org-org,PROPN-PROPN,PROPN-ADP-PROPN,compound-nsubj,nmod-prep-pobj,NNP-NNP,NNP-IN-NNP,5,0
2810,2799.0,31,established,10,2,22,20,1,8,8,12,National Film and Television School,Buckinghamshire,----,org,PROPN-PROPN-CCONJ-PROPN-PROPN,PROPN,nmod-nmod-cc-conj-nsubjpass,pobj,NNP-NNP-CC-NNP-NNP,NNP,3,0
2811,2800.0,42,includes,4,2,14,12,1,27,2,10,Star Alliance,Asiana Airlines,-,org-org,PROPN-PROPN,PROPN-PROPN,compound-nsubj,compound-ROOT,NNP-NNP,NNP-NNP,2,0
2812,2801.0,32,founded,18,20,26,6,19,5,-2,8,Saudi Arabia,National Commercial Bank,per-per,--,PROPN-PROPN,PROPN-PROPN-PROPN,compound-poss,compound-compound-appos,NNP-NNP,NNP-NNP-NNP,3,0
2813,2802.0,30,taught,1,11,9,-2,10,20,-10,8,North Carolina,University of North Carolina at Greensboro,-,per-per-per-per-per-per,PROPN-PROPN,PROPN-ADP-PROPN-PROPN-ADP-PROPN,compound-pobj,pobj-prep-compound-pobj-prep-pobj,NNP-NNP,NNP-IN-NNP-NNP-IN-NNP,3,0
2814,2803.0,40,continued,8,21,2,-19,20,37,-13,-6,3rd Battalion,Australian Army,org-org,-,ADJ-PROPN,PROPN-PROPN,compound-compound,compound-poss,JJ-NNP,NNP-NNP,4,0
2815,2804.0,20,elected,4,3,16,13,2,3,1,12,he,Venezuela,per,,PRON,PROPN,nsubjpass,pobj,PRP,NNP,8,0
2816,2806.0,20,is,10,2,4,2,1,15,8,-6,University of Bath School of Management,Bath,org-org-org-org-org-org,,PROPN-ADP-PROPN-PROPN-ADP-PROPN,PROPN,nmod-prep-pobj-nsubj-prep-pobj,compound,NNP-IN-NNP-NNP-IN-NNP,NNP,2,0
2817,2807.0,42,leasing,28,4,20,16,3,21,24,-8,CEC Bank,Bucharest,-,org,PROPN-PROPN,PROPN,compound-pobj,pobj,NNP-NNP,NNP,3,0
2818,2808.0,22,is,2,12,17,5,11,4,-10,15,AC/DC,Bon Scott,org,-,NOUN,PROPN-PROPN,poss,compound-pobj,NN,NNP-NNP,6,0
2819,2809.0,73,worked,5,25,28,3,24,44,-20,23,MIC,Group Commander Intelligence Security Group,,per-per-per-per-per,PROPN,PROPN-PROPN-PROPN-PROPN-PROPN,compound,compound-compound-compound-compound-dobj,NNP,NNP-NNP-NNP-NNP-NNP,3,0
2820,2810.0,22,changed,6,5,9,4,4,12,1,3,CCTV-9,CCTV,,org,PROPN,PROPN,pobj,compound,NNP,NNP,3,0
2821,2811.0,32,had,2,16,25,9,15,6,-14,23,Danny Glover,San Francisco,org-org,-,PROPN-PROPN,PROPN-PROPN,compound-conj,compound-pobj,NNP-NNP,NNP-NNP,6,0
2822,2813.0,24,is,2,15,19,4,14,4,-13,17,producer,Reese Witherspoon,,org-org,NOUN,PROPN-PROPN,nmod,compound-pobj,NN,NNP-NNP,2,0
2823,2814.0,35,tokyohive.com,0,30,33,3,29,1,-30,33,Spin Aqua,Anna Tsuchiya,-,org-org,PROPN-PROPN,PROPN-PROPN,compound-compound,compound-dobj,NNP-NNP,NNP-NNP,2,0
2824,2815.0,13,began,5,3,8,5,2,4,2,3,Levi Strauss Co.,1853,org-org-org,,PROPN-PROPN-PROPN,NUM,compound-compound-nsubj,pobj,NNP-NNP-NNP,CD,4,0
2825,2816.0,20,was,7,13,18,5,12,1,-6,11,Ukraine,Leonid Kuchma,per,-,PROPN,PROPN-PROPN,poss,compound-appos,NNP,NNP-NNP,2,0
2826,2818.0,22,met,12,7,10,3,6,11,5,-2,Arizona,John McCain,org,-,PROPN,PROPN-PROPN,compound,compound-conj,NNP,NNP-NNP,7,0
2827,2819.0,25,is,3,5,11,6,4,13,-2,8,Saint-Pierre,Air Saint-Pierre,org,-,PROPN,PROPN-PROPN,acomp,compound-nsubjpass,NNP,NNP-NNP,-1,0
2828,2820.0,14,born,2,1,13,12,0,0,1,11,Cerati,Argentina,,org,PROPN,PROPN,nsubjpass,pobj,NNP,NNP,2,0
2829,2821.0,71,endangers,58,49,69,20,48,1,9,11,Liberty,United States,,org-org,PROPN,PROPN-PROPN,dobj,compound-pobj,NNP,NNP-NNP,11,0
2830,2823.0,26,kicked,6,20,11,-9,19,14,-14,5,Jumeirah,Dubai,per,,PROPN,PROPN,pobj,pobj,NNP,NNP,4,0
2831,2824.0,54,nicknamed,9,28,45,17,27,8,-19,36,Dave Brubeck,pianist,-,per,PROPN-PROPN,NOUN,compound-compound,compound,NNP-NNP,NN,10,0
2832,2825.0,80,is,10,1,5,4,0,74,9,-5,GeoEye,Orbital Sciences Corporation,org,--,PROPN,PROPN-PROPN-PROPN,pobj,compound-compound-pobj,NNP,NNP-NNPS-NNP,2,0
2833,2826.0,26,includes,4,1,19,18,0,6,3,15,The Byrds,Roger McGuinn,org-org,-,DET-PROPN,PROPN-PROPN,det-pobj,compound-compound,DT-NNPS,NNP-NNP,7,0
2834,2827.0,17,is,1,1,12,11,0,4,0,11,He,East Timor,,per-per,PRON,PROPN-PROPN,nsubj,compound-pobj,PRP,NNP-NNP,6,0
2835,2828.0,18,leads,8,4,8,4,3,9,4,0,Juan Carlos Wasmosy,Paraguay,org-org-org,,PROPN-PROPN-PROPN,PROPN,compound-compound-nsubj,pobj,NNP-NNP-NNP,NNP,2,0
2836,2829.0,33,followed,25,5,27,22,4,5,20,2,EMI,Palmer,org,,PROPN,PROPN,compound,poss,NNP,NNP,3,0
2837,2830.0,12,SingTel,0,8,10,2,7,1,-8,10,Pakistan,Warid Telecom,per,-,PROPN,PROPN-PROPN,poss,compound-pobj,NNP,NNP-NNP,2,0
2838,2831.0,34,meet,4,12,24,12,11,9,-8,20,D. Subbarao,Bombay Stock Exchange,-,per-per-per,PROPN-PROPN,PROPN-PROPN-PROPN,compound-pobj,compound-compound-pobj,NNP-NNP,NNP-NNP-NNP,9,0
2839,2832.0,25,become,7,4,23,19,3,1,3,16,Carroll Independent School District,Southlake,---,per,PROPN-PROPN-PROPN-PROPN,PROPN,compound-compound-compound-pobj,compound,NNP-NNP-NNP-NNP,NNP,8,0
2840,2833.0,32,Weakerthans,1,5,12,7,4,19,-4,11,Winnipeg,John K. Samson,,per-per-per,PROPN,PROPN-PROPN-PROPN,pobj,compound-compound-pobj,NNP,NNP-NNP-NNP,6,0
2841,2834.0,29,is,1,16,19,3,15,9,-15,18,Japan,Shinz Ab,org,-,PROPN,PROPN-PROPN,poss,compound-pobj,NNP,NNP-NNP,-1,0
2842,2835.0,39,merged,6,6,37,31,5,1,0,31,NTUC,NTUC-I,,per,PROPN,PROPN,pobj,appos,NNP,NNP,3,0
2843,2836.0,20,is,9,1,19,18,0,0,8,10,In Medias Res,Canada,per-per-per,,ADP-PROPN-PROPN,PROPN,prep-compound-pobj,pobj,IN-NNP-NNP,NNP,4,0
2844,2837.0,22,rejected,6,5,17,12,4,4,1,11,Roberto Castelli,Italy,-,per,PROPN-PROPN,PROPN,compound-nsubj,pobj,NNP-NNP,NNP,3,0
2845,2838.0,19,announced,5,11,17,6,10,1,-6,12,Gary Doer,Manitoba,-,org,PROPN-PROPN,PROPN,compound-dobj,compound,NNP-NNP,NNP,5,0
2846,2839.0,35,Oberlin,0,11,22,11,10,12,-11,22,Cleveland,United States,per,-,PROPN,PROPN-PROPN,pobj,compound-pobj,NNP,NNP-NNP,3,0
2847,2840.0,22,introduced,7,6,14,8,5,7,1,7,Sisamouth,Cambodia,org,,PROPN,PROPN,nsubj,pobj,NNP,NNP,3,0
2848,2841.0,31,started,18,8,16,8,7,14,10,-2,Cup,Lokomotiv Rostov,org,-,PROPN,PROPN-PROPN,nmod,compound-compound,NNP,NNP-NNP,5,0
2849,2842.0,24,is,12,2,10,8,1,13,10,-2,Ministry of Foreign Affairs,Moldova,org-org-org-org,,PROPN-ADP-PROPN-PROPN,PROPN,nsubj-prep-compound-pobj,pobj,NNP-IN-NNP-NNPS,NNP,3,0
2850,2843.0,86,described,1,49,72,23,48,13,-48,71,American Automobile Industry,Chrysler,per-per-per,,PROPN-PROPN-PROPN,PROPN,compound-compound-nsubj,pobj,NNP-NNP-NNP,NNP,6,0
2851,2844.0,10,elected,2,1,5,4,0,4,1,3,Edmondson,Oklahoma,org,,PROPN,PROPN,nsubjpass,compound,NNP,NNP,4,0
2852,2845.0,40,is,29,1,3,2,0,36,28,-26,Deutsche Schule Istanbul,Istanbul,--,per,PROPN-PROPN-PROPN,PROPN,compound-compound-nsubj,compound,NNP-NNP-NNP,NNP,3,0
2853,2846.0,16,is,1,1,13,12,0,2,0,12,Chapingo Autonomous University,Universidad Chapingo,per-per-per,-,PROPN-PROPN-PROPN,PROPN-PROPN,compound-compound-pobj,compound-appos,NNP-NNP-NNP,NNP-NNP,6,0
2854,2847.0,39,is,3,12,17,5,11,21,-9,14,Structural Dynamics Research Corporation,SDRC,per-per-per-per,,PROPN-PROPN-PROPN-PROPN,PROPN,compound-compound-compound-pobj,appos,NNP-NNPS-NNP-NNP,NNP,2,0
2855,2848.0,17,born,2,1,16,15,0,0,1,14,Alain,France,,per,PROPN,PROPN,nsubjpass,pobj,NNP,NNP,7,0
2856,2849.0,31,spent,1,10,20,10,9,10,-9,19,California,Richard Riordan,,org-org,PROPN,PROPN-PROPN,nmod,compound-conj,NNP,NNP-NNP,2,0
2857,2850.0,31,is,1,1,19,18,0,11,0,18,Europe,Joey Tempest,,org-org,PROPN,PROPN-PROPN,nsubj,compound-compound,NNP,NNP-NNP,5,0
2858,2851.0,32,features,1,13,28,15,12,3,-12,27,US,King,org,,PROPN,PROPN,compound,pobj,NNP,NNP,-1,0
2859,2852.0,17,merged,2,7,13,6,6,3,-5,11,Dover Heights,Rose Bay Secondary College,-,per-per-per-per,PROPN-PROPN,PROPN-PROPN-PROPN-PROPN,compound-compound,compound-compound-compound-dobj,NNP-NNP,NNP-NNP-NNP-NNP,6,0
2860,2853.0,12,holds,2,7,10,3,6,1,-5,8,Al-Azhar University,Cairo,-,per,PROPN-PROPN,PROPN,compound-pobj,compound,NNP-NNP,NNP,5,0
2861,2854.0,32,signs,6,18,27,9,17,4,-12,21,Ryutaro Hashimoto,Japan,-,org,PROPN-PROPN,PROPN,compound-pobj,pobj,NNP-NNP,NNP,6,0
2862,2856.0,32,favours,4,8,12,4,7,19,-4,8,Joseph Estrada,Philippines,per-per,,PROPN-PROPN,PROPN,compound-dobj,poss,NNP-NNP,NNPS,5,0
2863,2857.0,18,was,1,1,9,8,0,8,0,8,Serneholt,Sweden,per,,PROPN,PROPN,nsubj,pobj,NNP,NNP,4,0
2864,2858.0,22,is,2,11,17,6,10,4,-9,15,Bucharest Metro,Romania,per-per,,PROPN-PROPN,PROPN,compound-pobj,pobj,NNP-NNP,NNP,8,0
2865,2859.0,23,is,4,15,19,4,14,3,-11,15,Japan,Kreva,per,,PROPN,PROPN,pobj,compound,NNP,NNP,3,0
2866,2860.0,22,was,2,17,19,2,16,2,-15,17,Florida,David Levy Yulee,org,--,PROPN,PROPN-PROPN-PROPN,compound,compound-compound-pobj,NNP,NNP-NNP-NNP,2,0
2867,2861.0,28,has,5,20,24,4,19,3,-15,19,Capgemini,Serge Kampf,org,-,PROPN,PROPN-PROPN,compound,compound-pobj,NNP,NNP-NNP,3,0
2868,2862.0,58,acknowledged,2,48,55,7,47,2,-46,53,New Orleans,Dominick James LaRocca,-,per-per-per,PROPN-PROPN,PROPN-PROPN-PROPN,compound-pobj,compound-compound-oprd,NNP-NNP,NNP-NNP-NNP,8,0
2869,2863.0,15,acquired,6,5,8,3,4,6,1,2,Best Buy,Future Shop,per-per,-,PROPN-PROPN,PROPN-PROPN,compound-pobj,compound-dobj,NNP-NNP,NNP-NNP,3,0
2870,2864.0,39,created,9,23,28,5,22,10,-14,19,Flying Tigers,American Volunteer Group,org-org,--,PROPN-PROPN,PROPN-PROPN-PROPN,compound-nsubjpass,compound-compound-pobj,NNP-NNPS,NNP-NNP-NNP,4,0
2871,2865.0,14,performed,1,1,8,7,0,5,0,7,Issa,Canada,org,,PROPN,PROPN,nsubj,compound,NNP,NNP,2,0
2872,2866.0,34,elected,2,6,20,14,5,13,-4,18,Ontario,Jim Flaherty,,org-org,PROPN,PROPN-PROPN,compound,compound-conj,NNP,NNP-NNP,7,0
2873,2867.0,20,is,3,5,9,4,4,10,-2,6,Lara Giddings,Australian Labor Party,per-per,--,PROPN-PROPN,PROPN-PROPN-PROPN,compound-attr,compound-compound-pobj,NNP-NNP,NNP-NNP-NNP,3,0
2874,2868.0,25,is,9,2,6,4,1,18,7,-3,Academy,1907,,per,PROPN,NUM,nsubjpass,pobj,NNP,CD,3,0
2875,2869.0,40,conducted,11,15,25,10,14,14,-4,14,United States,Mayo Clinic,-,per-per,PROPN-PROPN,PROPN-PROPN,compound-pobj,compound-pobj,NNP-NNP,NNP-NNP,7,0
2876,2870.0,47,said,5,10,14,4,9,32,-5,9,chief financial officer,Continental Airlines,--,per-per,ADJ-ADJ-NOUN,PROPN-PROPN,amod-amod-appos,compound-subtok,JJ-JJ-NN,NNP-NNPS,5,0
2877,2871.0,32,became,18,1,10,9,0,21,17,-8,Russell A. Alger,Michigan,--,org,PROPN-NOUN-PROPN,PROPN,compound-compound-nsubj,compound,NNP-NN-NNP,NNP,6,0
2878,2873.0,25,is,6,2,3,1,1,21,4,-3,du Chicoutimi,Chicoutimi,per-per,,PROPN-PROPN,PROPN,nmod-nsubj,compound,NNP-NNP,NNP,2,0
2879,2874.0,32,grew,7,2,6,4,1,25,5,-1,Hosley,BMC,org,,PROPN,PROPN,pobj,compound,NNP,NNP,3,0
2880,2875.0,32,expressed,11,1,11,10,0,20,10,0,Piero Fassino,Italy,per-per,,PROPN-ADJ,PROPN,nmod-nmod,pobj,NNP-JJ,NNP,2,0
2881,2876.0,21,inspired,2,9,19,10,8,1,-7,17,Mexican,Clemente Orozco,per,-,PROPN,PROPN-PROPN,compound,compound-conj,NNP,NNP-NNP,7,0
2882,2877.0,27,was,3,11,24,13,10,2,-8,21,Ursula Burns,Xerox,org-org,,PROPN-PROPN,PROPN,compound-nsubj,poss,NNP-NNP,NNP,6,0
2883,2878.0,40,is,16,1,15,14,0,24,15,-1,Andre,Romania,,per,PROPN,PROPN,nsubj,pobj,NNP,NNP,2,0
2884,2879.0,17,studied,1,5,12,7,4,4,-4,11,Pennsylvania College of Art and Design,Lancaster,-----,per,PROPN-PROPN-ADP-PROPN-CCONJ-PROPN,PROPN,compound-pobj-prep-pobj-cc-conj,compound,NNP-NNP-IN-NNP-CC-NNP,NNP,2,0
2885,2880.0,40,assisted,17,24,29,5,23,10,-7,12,United Nations International School,New York,org-org-org-org,-,PROPN-PROPN-PROPN-PROPN,PROPN-PROPN,compound-compound-compound-pobj,compound-pobj,NNP-NNP-NNP-NNP,NNP-NNP,2,0
2886,2881.0,21,is,2,1,16,15,0,4,1,14,Big Pond,Rita MacNeil,-,per-per,ADJ-PROPN,PROPN-PROPN,compound-nsubj,compound-dobj,JJ-NNP,NNP-NNP,5,0
2887,2882.0,47,Division,7,4,16,12,3,30,3,9,NY1,New York,org,-,PROPN,PROPN-PROPN,compound,conj-nmod,NNP,NNP-NNP,6,0
2888,2883.0,26,pay,2,7,12,5,6,13,-5,10,Andy Stern,Service Employees International Union,-,org-org-org-org,PROPN-PROPN,PROPN-PROPN-PROPN-PROPN,compound-amod,compound-compound-compound-pobj,NNP-NNP,NNP-NNPS-NNP-NNP,4,0
2889,2884.0,26,appointed,10,5,16,11,4,9,5,6,Qantas,Geoff Dixon,per,-,PROPN,PROPN-PROPN,poss,compound-dobj,NNP,NNP-NNP,6,0
2890,2885.0,103,said,14,12,19,7,11,83,2,5,Australia,Richard Franklin,,per-per,PROPN,PROPN-PROPN,dobj,compound-compound,NNP,NNP-NNP,-1,0
2891,2887.0,6,43pts,3,1,3,2,0,2,2,0,Zhang Li,Guangdong,org-org,,PROPN-PROPN,PROPN,compound-compound,compound,NNP-NNP,NNP,2,0
2892,2888.0,34,Peck,1,18,32,14,17,1,-17,31,California,Gregory Peck,,org-org,PROPN,PROPN-PROPN,appos,compound-pobj,NNP,NNP-NNP,6,0
2893,2889.0,19,was,11,1,16,15,0,2,10,5,Lemuel John Tweedie,Chatham,--,org,PROPN-PROPN-PROPN,PROPN,compound-compound-nsubj,compound,NNP-NNP-NNP,NNP,6,0
2894,2890.0,37,is,7,6,31,25,5,5,1,24,Pacific Sun,Nadi,per-per,,PROPN-PROPN,PROPN,compound-pobj,compound,NNP-NNP,NNP,7,0
2895,2891.0,23,was,3,18,22,4,17,0,-15,19,University of Washington,Seattle,org-org-org,,PROPN-ADP-PROPN,PROPN,pobj-prep-pobj,pobj,NNP-IN-NNP,NNP,8,0
2896,2892.0,29,established,9,2,5,3,1,23,7,-4,2007,Geo Super Football League,org,---,NUM,PROPN-PROPN-PROPN-PROPN,pobj,compound-compound-compound-nsubjpass,CD,NNP-NNP-NNP-NNP,2,0
2897,2893.0,27,assumed,16,5,5,0,4,21,11,-11,Tiridates I of Armenia,Tiridates,---,org,PROPN-PRON-ADP-PROPN,PROPN,dobj-appos-prep-pobj,compound,NNP-PRP-IN-NNP,NNP,0,0
2898,2894.0,15,Be,1,9,12,3,8,2,-8,11,Detroit,Vanessa Bell Armstrong,per,--,PROPN,PROPN-PROPN-PROPN,compound,compound-compound-pobj,NNP,NNP-NNP-NNP,3,0
2899,2895.0,29,played,1,12,15,3,11,13,-11,14,Lee Dorrian,Rise Above Records,-,per-per-per,PROPN-PROPN,NOUN-ADP-PROPN,compound-poss,compound-compound-pobj,NNP-NNP,NN-IN-NNPS,2,0
2900,2896.0,17,lives,2,9,15,6,8,1,-7,13,New York,Bard College,-,org-org,PROPN-PROPN,PROPN-PROPN,compound-pobj,compound-pobj,NNP-NNP,NNP-NNP,5,0
2901,2897.0,18,taught,1,7,9,2,6,8,-6,8,University of Calgary,Calgary,per-per-per,,PROPN-ADP-PROPN,PROPN,nmod-prep-pobj,compound,NNP-IN-NNP,NNP,4,0
2902,2899.0,58,occurred,4,7,13,6,6,44,-3,9,Chicago,Levi Boone,org,-,PROPN,PROPN-PROPN,compound,compound-compound,NNP,NNP-NNP,5,0
2903,2900.0,52,acquiesced,45,16,44,28,15,7,29,-1,Prince Edward Island,Joe Ghiz,--,per-per,PROPN-PROPN-PROPN,PROPN-PROPN,compound-compound-compound,compound-pobj,NNP-NNP-NNP,NNP-NNP,5,0
2904,2901.0,9,born,2,1,5,4,0,3,1,3,Hoyte,Guyana,org,,PROPN,PROPN,nsubjpass,poss,NNP,NNP,5,0
2905,2902.0,38,cracked,4,18,27,9,17,10,-14,23,Brooklyn,Rex,,org,PROPN,PROPN,compound,compound,NNP,NNP,9,0
2906,2903.0,16,led,1,10,13,3,9,2,-9,12,Democratic Party,14 October 2007,org-org,--,PROPN-PROPN,NUM-PROPN-NUM,compound-pobj,nummod-pobj-nummod,NNP-NNP,CD-NNP-CD,4,0
2907,2904.0,46,made,2,9,15,6,8,30,-7,13,Canada,CBC,,per,PROPN,PROPN,compound,appos,NNP,NNP,4,0
2908,2905.0,13,attended,1,3,11,8,2,1,-2,10,Mt. San Antonio College,Walnut,---,per,PROPN-PROPN-PROPN-PROPN,PROPN,compound-compound-compound-dative,compound,NNP-NNP-NNP-NNP,NNP,4,0
2909,2906.0,26,known,8,1,2,1,0,23,7,-6,South Texas High School for Health Professions,Texas,per-per-per-per-per-per-per,,PROPN-PROPN-PROPN-PROPN-ADP-PROPN-PROPN,PROPN,compound-compound-compound-nsubj-prep-compound-pobj,pobj,NNP-NNP-NNP-NNP-IN-NNP-NNPS,NNP,2,0
2910,2907.0,33,renamed,29,24,31,7,23,1,5,2,CAA,Air Rhodesia,,per-per,PROPN,PROPN-PROPN,compound,compound-oprd,NNP,NNP-NNP,5,0
2911,2908.0,11,okays,5,1,10,9,0,0,4,5,Spain,Altadis,per,,PROPN,PROPN,poss,pobj,NNP,NNP,4,0
2912,2909.0,23,located,3,6,22,16,5,0,-3,19,Macquarie University,Australia,org-org,,PROPN-PROPN,PROPN,compound-pobj,pobj,NNP-NNP,NNP,3,0
2913,2910.0,21,is,3,13,17,4,12,3,-10,14,Trinity Western University,Langley,org-org-org,,PROPN-PROPN-PROPN,PROPN,compound-compound-pobj,compound,NNP-NNP-NNP,NNP,4,0
2914,2911.0,30,says,17,6,13,7,5,16,11,-4,Moore,Ashton Kutcher,,org-org,PROPN,PROPN-PROPN,pobj,compound-dobj,NNP,NNP-NNP,4,0
2915,2912.0,29,features,2,9,9,0,8,19,-7,7,Gabby La La,Gabby Lang,per-per-per,-,PROPN-PROPN-PROPN,PROPN-PROPN,compound-compound-appos,compound-pobj,NNP-NNP-NNP,NNP-NNP,0,0
2916,2913.0,20,decided,11,3,8,5,2,11,8,-3,Tim Armstrong,Rancid,-,per,PROPN-PROPN,PROPN,compound-poss,pobj,NNP-NNP,NNP,2,0
2917,2914.0,18,attended,1,3,7,4,2,10,-2,6,Lowndes High School,Valdosta,per-per-per,,PROPN-PROPN-PROPN,PROPN,compound-compound-dobj,compound,NNP-NNP-NNP,NNP,3,0
2918,2915.0,20,was,12,14,18,4,13,1,-2,6,Orascom Construction Industries,Cairo,--,org,PROPN-PROPN-PROPN,PROPN,compound-compound-attr,compound,NNP-NNP-NNPS,NNP,3,0
2919,2916.0,18,is,3,1,14,13,0,3,2,11,The Mitgang Audio,Brooklyn,org-org-org,,DET-PROPN-PROPN,PROPN,det-compound-nsubj,compound,DT-NNP-NNP,NNP,9,0
2920,2917.0,51,were,14,5,10,5,4,40,9,-4,Julie L. Myers,U.S. Immigration and Customs Enforcement,--,per-per-per-per-per,PROPN-PROPN-PROPN,PROPN-PROPN-CCONJ-PROPN-PROPN,compound-compound-pobj,nmod-nmod-cc-conj-pobj,NNP-NNP-NNP,NNP-NNP-CC-NNP-NNP,5,0
2921,2918.0,19,is,10,1,13,12,0,5,9,3,Michael Grant Ignatieff,Canadian,--,per,PROPN-PROPN-PROPN,ADJ,compound-compound-nsubj,amod,NNP-NNP-NNP,JJ,3,0
2922,2919.0,52,reported,2,1,14,13,0,37,1,12,Chaudhary,Minnesota,,per,PROPN,PROPN,nsubj,compound,NNP,NNP,6,0
2923,2920.0,21,fly,8,1,6,5,0,14,7,-2,Transavia.com,Air France-KLM,per,-,NOUN,PROPN-PROPN,nsubj,compound-pobj,NN,NNP-NNP,4,0
2924,2921.0,34,was,7,15,25,10,14,8,-8,18,Department of the Treasury,Bureau of Engraving and Printing,---,per-per-per-per-per,PROPN-ADP-DET-PROPN,PROPN-ADP-PROPN-CCONJ-PROPN,pobj-prep-det-pobj,pobj-prep-pobj-cc-conj,NNP-IN-DT-NNP,NNP-IN-NNP-CC-NNP,7,0
2925,2922.0,7,Dorset,5,1,6,5,0,0,4,1,Highcliffe School,Dorset,org-org,,PROPN-PROPN,PROPN,compound-compound,ROOT,NNP-NNP,NNP,3,0
2926,2923.0,18,competed,3,3,8,5,2,9,0,5,Carter,Tennessee,org,,PROPN,PROPN,nsubj,compound,NNP,NNP,2,0
2927,2924.0,27,combined,6,2,25,23,1,1,4,19,1907,Virginian Railway,org,-,NUM,ADJ-PROPN,pobj,compound-dobj,CD,JJ-NNP,4,0
2928,2925.0,27,included,2,8,13,5,7,13,-6,11,Jean-Claude Juncker,Luxembourg,org-org,,PROPN-PROPN,PROPN,compound-compound,pobj,NNP-NNP,NNP,4,0
2929,2926.0,21,is,2,13,19,6,12,1,-11,17,John Mellencamp,Mercury,-,org,PROPN-PROPN,PROPN,compound-pobj,compound,NNP-NNP,NNP,6,0
2930,2927.0,22,announced,5,4,12,8,3,9,1,7,2005,Veritas,,org,NUM,PROPN,nummod,pobj,CD,NNP,6,0
2931,2928.0,16,President,5,3,11,8,2,4,2,6,Susan Rogers,University of Texas at Dallas,org-org,----,PROPN-PROPN,PROPN-ADP-PROPN-ADP-PROPN,compound-compound,pobj-prep-pobj-prep-pobj,NNP-NNP,NNP-IN-NNP-IN-NNP,6,0
2932,2929.0,28,is,2,2,17,15,1,10,0,15,Enix,April 1 2003,org,--,PROPN,PROPN-NUM-NUM,nsubj,pobj-nummod-nummod,NNP,NNP-CD-CD,5,0
2933,2930.0,27,move,8,5,16,11,4,10,3,8,Monica,Atlanta,per,,PROPN,PROPN,nsubj,compound,NNP,NNP,4,0
2934,2931.0,31,known,3,1,15,14,0,15,2,12,It,United States,per,-,PRON,PROPN-PROPN,nsubjpass,compound-compound,PRP,NNP-NNP,7,0
2935,2932.0,30,gained,4,10,22,12,9,7,-6,18,Western Carolina University,NCAA,per-per-per,,PROPN-PROPN-PROPN,PROPN,compound-compound-pobj,compound,NNP-NNP-NNP,NNP,7,0
2936,2933.0,30,is,2,1,1,0,0,28,1,-1,Bradfield,Bradfield College,org,-,PROPN,PROPN-PROPN,compound,compound-appos,NNP,NNP-NNP,0,0
2937,2934.0,32,formed,6,1,11,10,0,20,5,5,K-1,Kazuyoshi Ishii,org,-,PROPN,PROPN-PROPN,poss,compound-pobj,NNP,NNP-NNP,6,0
2938,2935.0,34,is,10,12,6,-6,11,27,-2,-4,Memphis,Douglass High,per,-,PROPN,PROPN-PROPN,compound,compound-pobj,NNP,NNP-NNP,7,0
2939,2936.0,33,grew,30,8,19,11,7,13,22,-11,Dixie Chicks,Emily Robison,-,org-org,PROPN-PROPN,PROPN-PROPN,compound-dobj,compound-appos,NNP-NNPS,NNP-NNP,7,0
2940,2938.0,29,become,3,1,28,27,0,0,2,25,Manmohan Singh,Guwahati,per-per,,PROPN-PROPN,PROPN,compound-nsubj,pobj,NNP-NNP,NNP,9,0
2941,2939.0,17,is,1,1,13,12,0,3,0,12,She,Hawaii,,org,PRON,PROPN,nsubj,pobj,PRP,NNP,6,0
2942,2940.0,14,moved,1,1,7,6,0,6,0,6,Jurado,Mexico,org,,PROPN,PROPN,nsubj,compound,NNP,NNP,2,0
2943,2941.0,53,is,1,8,24,16,7,28,-7,23,Financial Access Initiative,Dean Karlan,org-org-org,-,PROPN-PROPN-PROPN,PROPN-PROPN,compound-compound-pobj,compound-conj,NNP-NNP-NNP,NNP-NNP,12,0
2944,2942.0,21,had,2,1,19,18,0,1,1,17,SAA,Odessa Richards,per,-,PROPN,PROPN-PROPN,nsubj,compound-conj,NNP,NNP-NNP,3,0
2945,2943.0,21,created,2,10,14,4,9,6,-8,12,J. J. Abrams,Bad Robot Productions,--,org-org-org,PROPN-PROPN-PROPN,PROPN-PROPN-PROPN,compound-compound-poss,compound-compound-pobj,NNP-NNP-NNP,NNP-NNP-NNPS,3,0
2946,2944.0,23,studied,1,10,14,4,9,8,-9,13,University of Berlin,Emil Warburg,per-per-per,-,PROPN-ADP-PROPN,PROPN-PROPN,pobj-prep-pobj,compound-pobj,NNP-IN-NNP,NNP-NNP,3,0
2947,2945.0,37,is,9,15,31,16,14,5,-6,22,Georgia Institute of Technology,he,per-per-per-per,,PROPN-PROPN-ADP-PROPN,PRON,compound-pobj-prep-pobj,nsubj,NNP-NNP-IN-NNP,PRP,5,0
2948,2946.0,37,made,12,11,27,16,10,9,1,15,Davis Cup,ITF,-,org,PROPN-PROPN,PROPN,compound-nsubj,pobj,NNP-NNP,NNP,6,0
2949,2947.0,26,URL,4,8,8,0,7,17,-4,4,BBC,BBC One,,org-org,PROPN,PROPN-PROPN,poss,compound-pobj,NNP,NNP-NNP,0,0
2950,2948.0,32,relocated,14,21,27,6,20,4,-7,13,Atlanta,RaceTrac,org,,PROPN,PROPN,compound,dobj,NNP,NNP,4,0
2951,2949.0,15,is,1,1,7,6,0,7,0,6,Dominique,France,per,,NOUN,PROPN,nsubj,pobj,NN,NNP,2,0
2952,2950.0,14,led,6,1,12,11,0,1,5,6,His,Vernal,per,,DET,PROPN,poss,compound,PRP$,NNP,5,0
2953,2951.0,31,stated,14,2,12,10,1,18,12,-2,Burson-Marsteller,Harold Burson,,org-org,PROPN,PROPN-PROPN,nsubjpass,compound-pobj,NNP,NNP-NNP,7,0
2954,2953.0,33,included,2,1,5,4,0,27,1,3,His,Israel,org,,DET,PROPN,poss,compound,PRP$,NNP,3,0
2955,2954.0,25,said,17,14,17,3,13,7,3,0,European Space Agency,ESA,--,org,PROPN-PROPN-PROPN,PROPN,compound-compound-compound,pobj,NNP-NNP-NNP,NNP,4,0
2956,2955.0,20,announced,9,6,8,2,5,11,3,-1,Prime Minister,Roosevelt Skerrit,-,per-per,PROPN-PROPN,PROPN-PROPN,compound-compound,compound-nsubj,NNP-NNP,NNP-NNP,1,0
2957,2956.0,27,joined,20,11,19,8,10,7,9,-1,Health and Human Services,Tommy Thompson,per-per-per-per,-,PROPN-CCONJ-PROPN-PROPN,PROPN-PROPN,pobj-cc-compound-conj,compound-pobj,NNP-CC-NNP-NNPS,NNP-NNP,5,0
2958,2957.0,32,regret,1,8,24,16,7,7,-7,23,Blair,United Kingdom,per,-,PROPN,PROPN-PROPN,pobj,compound-dobj,NNP,NNP-NNP,5,0
2959,2958.0,21,became,1,7,17,10,6,3,-6,16,Continental Micronesia,Guam,per-per,,PROPN-PROPN,PROPN,compound-pobj,compound,NNP-NNP,NNP,7,0
2960,2959.0,36,novel,3,13,24,11,12,11,-10,21,Eleanor of Aquitaine,Henry II of England,per-per-per,---,PROPN-ADP-PROPN,PROPN-PROPN-ADP-PROPN,dobj-prep-pobj,compound-pobj-prep-pobj,NNP-IN-NNP,NNP-NNP-IN-NNP,5,0
2961,2961.0,21,joined,1,4,10,6,3,10,-3,9,Industrial Workers of the World,IWW,org-org-org-org-org,,PROPN-PROPN-ADP-DET-PROPN,PROPN,compound-dobj-prep-det-pobj,appos,NNP-NNPS-IN-DT-NNP,NNP,2,0
2962,2962.0,30,was,11,22,26,4,21,3,-11,15,East Carolina University,Greenville,--,org,PROPN-PROPN-PROPN,PROPN,compound-compound-attr,compound,NNP-NNP-NNP,NNP,5,0
2963,2963.0,45,left,4,3,22,19,2,22,1,18,Matt Ellis,USA,-,per,PROPN-PROPN,PROPN,compound-nsubj,conj,NNP-NNP,NNP,9,0
2964,2964.0,21,was,1,11,13,2,10,7,-10,12,Jacksonville,Edward Waters College,,per-per-per,PROPN,PROPN-PROPN-PROPN,poss,compound-compound-pobj,NNP,NNP-NNP-NNP,3,0
2965,2965.0,12,won,4,2,7,5,1,4,2,3,NAZA,Malaysia,org,,PROPN,PROPN,compound,compound,NNP,NNP,4,0
2966,2966.0,51,reorganised,22,15,38,23,14,12,7,16,Centrale de Lille,France,org-org-org,,PROPN-ADP-PROPN,PROPN,nmod-compound-appos,appos,NNP-IN-NNP,NNP,8,0
0,0.0,24,is,9,2,7,5,1,16,7,-2,Mississippi,MS ANG,,org-org,PROPN,PROPN-PROPN,compound,compound-appos,NNP,NNP-NNP,2,1
1,1.0,42,became,9,24,29,5,23,12,-15,20,PSOP,Socialist Party,,org-org,PROPN,PROPN-PROPN,compound,compound-conj,NNP,NNP-NNP,2,1
2,2.0,25,was,3,1,18,17,0,6,2,15,Integra Bank,Indiana,org-org,,PROPN-PROPN,PROPN,compound-compound,pobj,NNP-NNP,NNP,6,1
3,3.0,27,amended,6,9,18,9,8,8,-3,12,SA Ambulance Service,SAAS,--,org,PROPN-PROPN-PROPN,PROPN,compound-compound-compound,nsubj,NNP-NNP-NNP,NNP,4,1
4,4.0,27,located,3,2,20,18,1,6,1,17,college,Kansas,org,,NOUN,PROPN,nsubjpass,pobj,NN,NNP,5,1
5,5.0,99,were,12,34,37,3,33,61,-22,25,North Carolina,Chapel Hill High School,-,org-org-org-org,PROPN-PROPN,PROPN-PROPN-PROPN-PROPN,compound-pobj,compound-compound-compound-conj,NNP-NNP,NNP-NNP-NNP-NNP,-1,1
6,6.0,57,taught,5,13,13,0,12,43,-8,8,Indiana,Indiana University of Pennsylvania,,org-org-org-org,PROPN,PROPN-PROPN-ADP-PROPN,compound,compound-appos-prep-pobj,NNP,NNP-NNP-IN-NNP,0,1
7,7.0,14,is,1,9,13,4,8,0,-8,12,Abbeyfield School,Wiltshire,org-org,,PROPN-PROPN,PROPN,compound-pobj,pobj,NNP-NNP,NNP,4,1
8,8.0,25,was,11,2,23,21,1,1,9,12,Styles Bridges,New Hampshire,per-per,-,PROPN-PROPN,PROPN-PROPN,compound-nsubj,compound-pobj,NNPS-NNPS,NNP-NNP,5,1
9,9.0,18,practiced,4,3,12,9,2,5,1,8,Dr. Hayhurst,Indiana,per-per,,PROPN-PROPN,PROPN,compound-nsubj,compound,NNP-NNP,NNP,6,1
10,10.0,19,ranked,7,5,11,6,4,7,2,4,Lambton High School,New South Wales,org-org-org,--,PROPN-PROPN-PROPN,PROPN-PROPN-PROPN,compound-compound-pobj,compound-compound-pobj,NNP-NNP-NNP,NNP-NNP-NNP,6,1
11,11.0,78,constructed,24,56,58,2,55,19,-32,34,Company,Avro,,org,PROPN,PROPN,pobj,appos,NNP,NNP,2,1
12,12.0,30,was,1,5,22,17,4,7,-4,21,MacKay,Nova Scotia,per,-,PROPN,PROPN-PROPN,nsubj,compound-compound,NNP,NNP-NNP,7,1
13,13.0,22,is,2,1,8,7,0,13,1,6,Greyhound Canada,FirstGroup plc,-,org-org,PROPN-PROPN,PROPN-NOUN,compound-nsubj,compound-pobj,NNP-NNP,NNP-NN,5,1
14,14.0,26,spent,1,1,12,11,0,13,0,11,Castro,Puerto Rico,per,-,PROPN,PROPN-PROPN,nsubj,compound-pobj,NNP,NNP-NNP,2,1
15,15.0,20,represented,7,3,3,0,2,16,4,-4,Marshall Thundering Herd,Marshall University,--,org-org,PROPN-PROPN-PROPN,PROPN-PROPN,compound-compound-compound,compound-dobj,NNP-NNP-NNP,NNP-NNP,0,1
16,16.0,16,fathered,1,3,15,12,2,0,-2,14,John C. C. Mayo,Kentucky,per-per-per-per,,PROPN-PROPN-PROPN-PROPN,PROPN,compound-compound-compound-dative,pobj,NNP-NNP-NNP-NNP,NNP,3,1
17,17.0,30,established,9,1,25,24,0,4,8,16,University Schools of Studies,Guru Gobind Singh Indraprastha University,---,org-org-org-org-org,PROPN-PROPN-ADP-PROPN,PROPN-PROPN-PROPN-PROPN-PROPN,compound-pobj-prep-pobj,compound-compound-compound-compound-pobj,NNP-NNPS-IN-NNPS,NNP-NNP-NNP-NNP-NNP,8,1
18,18.0,36,be,2,12,16,4,11,19,-10,14,Kent State University,Ohio,org-org-org,,PROPN-PROPN-PROPN,PROPN,compound-compound-pobj,compound,NNP-NNP-NNP,NNP,4,1
19,19.0,25,taught,1,18,20,2,17,4,-17,19,Hanover College,Indiana,org-org,,PROPN-PROPN,PROPN,compound-compound,conj,NNP-NNP,NNP,3,1
20,20.0,23,is,7,1,20,19,0,2,6,13,Ulverston Victoria High School,Cumbria,org-org-org-org,,PROPN-PROPN-PROPN-PROPN,PROPN,compound-compound-compound-nsubj,compound,NNP-NNP-NNP-NNP,NNP,8,1
21,21.0,42,arranged,14,10,13,3,9,28,4,-1,Banking,ABC,,org,PROPN,PROPN,compound,nsubj,NNP,NNP,4,1
22,22.0,40,led,23,5,19,14,4,20,18,-4,Grinnell,college,,org,PROPN,NOUN,compound,dobj,NNP,NN,8,1
23,23.0,33,established,16,2,22,20,1,10,14,6,Glenn Gould,Toronto,org-org,,PROPN-PROPN,PROPN,compound-compound,compound,NNP-NNP,NNP,4,1
24,24.0,17,Jon-Erik,0,1,13,12,0,3,-1,13,Jon-Erik Hexum,American,per-per,,PROPN-PROPN,ADJ,ROOT-nsubj,amod,NNP-NNP,JJ,4,1
25,25.0,20,is,6,1,1,0,0,18,5,-5,Northwestern Memorial Hospital,Northwestern University,--,org-org,PROPN-PROPN-PROPN,PROPN-PROPN,compound-compound-nsubj,compound-poss,NNP-NNP-NNP,NNP-NNP,0,1
26,26.0,62,began,5,38,48,10,37,13,-33,43,Steve Doll,Tennessee,per-per,,PROPN-PROPN,PROPN,compound-conj,pobj,NNP-NNP,NNP,3,1
27,27.0,42,say,3,14,16,2,13,25,-11,13,Hugo,Venezuela,per,,PROPN,PROPN,pobj,compound,NNP,NNP,5,1
28,28.0,17,has,1,1,8,7,0,8,0,7,Savings.com,California,org,,PROPN,PROPN,nsubj,pobj,NNP,NNP,2,1
29,29.0,48,is,15,5,28,23,4,19,10,13,Massachusetts Bay Transportation Authority,Silver Line,org-org-org-org,-,PROPN-PROPN-PROPN-PROPN,PROPN-PROPN,compound-compound-compound-pobj,compound-pobj,NNP-NNP-NNP-NNP,NNP-NNP,12,1
30,30.0,15,established,2,1,11,10,0,3,1,9,BCCI,Bupa,,org,PROPN,PROPN,nsubj,pobj,NNP,NNP,3,1
31,31.0,12,Newfoundland-based,8,7,10,3,6,1,1,2,St. John's,Provincial Airlines,-,org-org,PROPN-PROPN,PROPN-PROPN,compound-pobj,compound-dobj,NNP-NNP,NNP-NNPS,3,1
32,32.0,32,had,6,3,19,16,2,12,3,13,Liverpool,his,,per,PROPN,DET,pobj,poss,NNP,PRP$,4,1
33,33.0,25,is,1,1,17,16,0,7,0,16,Dominion,Virginia,org,,NOUN,PROPN,nsubj,compound,NN,NNP,8,1
34,34.0,9,is,2,1,5,4,0,3,1,3,Samsung Electronics,group,-,org,PROPN-PROPN,NOUN,compound-nsubj,poss,NNP-NNPS,NN,4,1
35,35.0,43,Chibnall,1,22,41,19,21,1,-21,40,Normandy,Robert Curthose,,per-per,PROPN,PROPN-PROPN,pobj,compound-pobj,NNP,NNP-NNP,12,1
36,36.0,28,was,10,5,10,5,4,17,5,0,1967,Algoma University College,,org-org-org,NUM,PROPN-PROPN-PROPN,pobj,compound-compound-pobj,CD,NNP-NNP-NNP,2,1
37,37.0,29,has,1,1,18,17,0,10,0,17,Semarang,Diponegoro University,org,-,PROPN,PROPN-PROPN,nsubj,compound-compound,NNP,NNP-NNP,-1,1
38,38.0,32,violate,3,5,13,8,4,18,-2,10,Viacom,MTV,org,,PROPN,PROPN,compound,pobj,NNP,NNP,9,1
39,39.0,46,Kayastha,2,23,29,6,22,16,-21,27,Banaras Hindu University,Varanasi,org-org-org,,PROPN-PROPN-PROPN,PROPN,compound-compound-ROOT,ROOT,NNP-NNP-NNP,NNP,4,1
40,40.0,38,told,1,21,23,2,20,14,-20,22,Ohio State,University Medical Center,-,org-org-org,PROPN-PROPN,PROPN-PROPN-PROPN,compound-compound,compound-compound-pobj,NNP-NNP,NNP-NNP-NNP,3,1
41,41.0,14,ordained,2,9,13,4,8,0,-7,11,Hebrew Union College,Cincinnati,org-org-org,,PROPN-PROPN-PROPN,PROPN,compound-compound-pobj,pobj,NNP-NNP-NNP,NNP,5,1
42,42.0,24,studied,1,4,8,4,3,15,-3,7,Sheridan College,Ontario,org-org,,PROPN-PROPN,PROPN,compound-pobj,pobj,NNP-NNP,NNP,3,1
43,43.0,30,selected,6,1,12,11,0,17,5,6,Eesti Televisioon,Estonia,-,org,PROPN-PROPN,PROPN,compound-nsubj,dobj,NNP-NNP,NNP,3,1
44,44.0,20,led,2,7,7,0,6,12,-5,5,Charlotte,Charlotte Area Transit System,,org-org-org-org,PROPN,PROPN-PROPN-PROPN-PROPN,compound,compound-compound-compound-dobj,NNP,NNP-NNP-NNP-NNP,0,1
45,45.0,16,located,4,1,1,0,0,14,3,-3,Woodstock College,Woodstock,org-org,,PROPN-PROPN,PROPN,compound-nsubjpass,compound,NNP-NNP,NNP,0,1
46,46.0,26,are,10,5,25,20,4,0,5,15,Killer Kowalski,Massachusetts,per-per,,PROPN-PROPN,PROPN,compound-pobj,pobj,NNP-NNP,NNP,8,1
47,47.0,24,was,4,6,20,14,5,3,-2,16,Arsenal Football Club,club,--,org,PROPN-PROPN-PROPN,NOUN,compound-compound-poss,poss,NNP-NNP-NNP,NN,7,1
48,48.0,38,moved,18,9,6,-3,8,31,9,-12,Panio Gianopoulos,her,-,per,PROPN-PROPN,DET,compound-appos,poss,NNP-NNP,PRP$,2,1
49,49.0,45,serves,34,1,12,11,0,32,33,-22,Mount Rainier High School,Washington,org-org-org-org,,PROPN-PROPN-PROPN-PROPN,PROPN,compound-compound-compound-nsubj,compound,NNP-NNP-NNP-NNP,NNP,6,1
50,50.0,30,1Institute,0,16,16,0,15,13,-16,16,Chongqing University,Chongqing,org-org,,PROPN-PROPN,PROPN,compound-pobj,nmod,NNP-NNP,NNP,0,1
51,51.0,19,is,10,3,4,1,2,14,7,-6,Martinez,Florida,per,,PROPN,PROPN,compound,poss,NNP,NNP,1,1
52,52.0,17,is,4,10,14,4,9,2,-6,10,University of Western Ontario,London,org-org-org-org,,PROPN-ADP-PROPN-PROPN,PROPN,pobj-prep-compound-pobj,compound,NNP-IN-NNP-NNP,NNP,2,1
53,53.0,22,had,9,7,9,2,6,12,2,0,University,Kent,org,,PROPN,PROPN,nsubj,pobj,NNP,NNP,2,1
54,54.0,56,are,10,5,17,12,4,38,5,7,Spartans,University of South Carolina Upstate,,org-org-org-org-org,PROPN,PROPN-ADP-PROPN-PROPN-PROPN,nsubj,nmod-prep-compound-compound-dobj,NNPS,NNP-IN-NNP-NNP-NNP,6,1
55,55.0,47,imposed,24,3,12,9,2,34,21,-12,SMU,NCAA,,org,PROPN,PROPN,compound,nsubj,NNP,NNP,5,1
56,56.0,25,merged,4,12,12,0,11,12,-8,8,Armstrong Siddeley,Armstrong Whitworth,-,org-org,PROPN-PROPN,PROPN-PROPN,compound-conj,compound-compound,NNP-NNP,NNP-NNP,0,1
57,57.0,30,is,6,2,2,0,1,27,4,-4,Chapel Hill-Carrboro Chamber of Commerce,Chapel Hill,org-org-org-org-org,-,PROPN-PROPN-PROPN-ADP-PROPN,PROPN-PROPN,compound-compound-nsubj-prep-pobj,compound-pobj,NNP-NNP-NNP-IN-NNP,NNP-NNP,0,1
58,58.0,17,settled,2,6,12,6,5,4,-4,10,Laurinburg Institute,North Carolina,org-org,-,PROPN-PROPN,PROPN-PROPN,compound-pobj,compound-pobj,NNP-NNP,NNP-NNP,5,1
59,59.0,39,board,11,8,8,0,7,30,3,-3,Gifu Bus,Gifu,per-per,,PROPN-PROPN,PROPN,compound-pobj,compound,NNP-NNP,NNP,0,1
60,60.0,34,Airborne,1,1,8,7,0,25,0,7,Carrier Airborne Early Warning Squadron 121,VAW-121,-----,org,PROPN-PROPN-PROPN-PROPN-PROPN-NUM,PROPN,compound-ROOT-amod-ROOT-nsubj-nummod,appos,NNP-NNP-NNP-NNP-NNP-CD,NNP,3,1
61,61.0,32,Lane,2,1,18,17,0,13,1,16,Franklin Knight Lane,California,per-per-per,,PROPN-PROPN-PROPN,PROPN,compound-compound-ROOT,pobj,NNP-NNP-NNP,NNP,5,1
62,62.0,65,was,3,9,56,47,8,8,-6,53,University of Minnesota Morris,UMAC,---,org,PROPN-ADP-PROPN-PROPN,PROPN,nmod-prep-pobj-compound,nmod,NNP-IN-NNP-NNP,NNP,-1,1
63,63.0,23,expanded,8,2,6,4,1,16,6,-2,National City Corp.,Cleveland,org-org-org,,PROPN-PROPN-PROPN,PROPN,compound-compound-nsubj,pobj,NNP-NNP-NNP,NNP,3,1
64,64.0,30,called,9,1,20,19,0,9,8,11,Ralph R. McKee Career,Staten Island,org-org-org-org,-,PROPN-PROPN-PROPN-PROPN,PROPN-PROPN,compound-compound-compound-compound,compound-compound,NNP-NNP-NNP-NNP,NNP-NNP,6,1
65,65.0,46,takes,21,20,30,10,19,15,1,9,England,Elizabeth I of England,,per-per-per-per,PROPN,PROPN-PROPN-ADP-PROPN,pobj,compound-pobj-prep-pobj,NNP,NNP-NNP-IN-NNP,5,1
66,264.0,27,is,1,10,23,13,9,3,-9,22,England,Elizabeth I of England,,per-per-per-per,PROPN,PROPN-PROPN-ADP-PROPN,pobj,compound-pobj-prep-pobj,NNP,NNP-NNP-IN-NNP,6,1
67,1073.0,37,was,10,24,1,-23,23,35,-14,-9,England,Elizabeth I of England,,org-org-org-org,PROPN,PROPN-PROPN-ADP-PROPN,pobj,pobj-appos-prep-pobj,NNP,NNP-NNP-IN-NNP,6,1
68,66.0,22,represented,7,3,3,0,2,18,4,-4,Fresno State Bulldogs,Fresno,org-org-org,,PROPN-PROPN-PROPN,PROPN,compound-compound-compound,dobj,NNP-NNP-NNPS,NNP,0,1
69,67.0,56,underwent,1,50,54,4,49,1,-49,53,Elizabethton Twins,Appalachian League,-,org-org,PROPN-PROPN,PROPN-PROPN,compound-conj,compound-pobj,NNP-NNP,NNP-NNP,3,1
70,68.0,41,proven,2,14,33,19,13,7,-12,31,RMTU,Philippines,,org,PROPN,PROPN,dobj,pobj,NNP,NNP,7,1
71,69.0,26,was,9,2,19,17,1,6,7,10,North American Institute of Aviation,Conway,org-org-org-org-org,,PROPN-PROPN-PROPN-ADP-PROPN,PROPN,compound-compound-nsubj-prep-pobj,compound,NNP-NNP-NNP-IN-NNP,NNP,7,1
72,70.0,25,carried,7,6,15,9,5,9,1,8,News,MediaCorp,org,,PROPN,PROPN,compound,dobj,NNP,NNP,2,1
73,71.0,15,relaunched,6,3,5,2,2,9,3,-1,1993,NDO,,org,NUM,PROPN,nummod,nsubjpass,CD,NNP,3,1
74,72.0,25,Books,3,21,24,3,20,0,-18,21,YRF,Mumbai,org,,PROPN,PROPN,compound,pobj,NNP,NNP,3,1
75,73.0,41,is,2,1,8,7,0,32,1,6,Etisalat,U.A.E.,,org,PROPN,PROPN,compound,pobj,NNP,NNP,6,1
76,74.0,30,educated,2,8,12,4,7,17,-6,10,Australia,Launceston Church Grammar School,,org-org-org-org,PROPN,PROPN-PROPN-PROPN-PROPN,conj,compound-compound-compound-dobj,NNP,NNP-NNP-NNP-NNP,3,1
77,75.0,37,fields,5,2,8,6,1,28,3,3,University,Division I,,org-org,PROPN,PROPN-PRON,nsubj,dobj-nsubj,NNP,NNP-PRP,4,1
78,76.0,39,are,1,15,23,8,14,15,-14,22,Swedish Confederation of Professional Employees,TCO,org-org-org-org-org,,PROPN-PROPN-ADP-PROPN-PROPN,PROPN,compound-appos-prep-compound-pobj,conj,NNP-NNP-IN-NNP-NNP,NNP,2,1
79,77.0,29,is,6,15,19,4,14,9,-9,13,General del Trabajo,CGT,org-org-org,,PROPN-PROPN-PROPN,PROPN,nmod-compound-nmod,pobj,NNP-NNP-NNP,NNP,3,1
80,78.0,39,supposed,26,12,19,7,11,19,14,-7,1850,university,,org,NUM,NOUN,conj,dobj,CD,NN,3,1
81,79.0,12,is,5,2,5,3,1,6,3,0,University of Central Arkansas,Arkansas,org-org-org-org,,PROPN-ADP-PROPN-PROPN,PROPN,nsubj-prep-compound-pobj,poss,NNP-IN-NNP-NNP,NNP,2,1
82,80.0,28,At,0,17,17,0,16,10,-17,17,Bryn Mawr College,Bryn Mawr,org-org-org,-,PROPN-PROPN-PROPN,PROPN-PROPN,compound-compound-pobj,compound-compound,NNP-NNP-NNP,NNP-NNP,0,1
83,81.0,19,sold,1,1,15,14,0,3,0,14,BMW,Rolls-Royce,org,,PROPN,PROPN,nsubj,amod,NNP,NNP,5,1
84,82.0,21,agreed,4,4,12,8,3,8,0,8,Qualcomm,Rapid Bridge LLC,org,--,PROPN,PROPN-PROPN-PROPN,nsubj,compound-compound-pobj,NNP,NNP-NNP-NNP,5,1
85,83.0,22,was,6,1,1,0,0,20,5,-5,Straight University,Straight College,org-org,-,PROPN-PROPN,PROPN-PROPN,compound-nsubj,compound-nsubj,NNP-NNP,NNP-NNP,0,1
86,84.0,26,appointed,1,6,10,4,5,15,-5,9,Indian Institute of Technology Delhi,Delhi,org-org-org-org-org,,PROPN-PROPN-ADP-PROPN-PROPN,PROPN,compound-conj-prep-pobj-appos,appos,NNP-NNP-IN-NNP-NNP,NNP,5,1
87,592.0,34,give,28,8,12,4,7,21,20,-16,Indian Institute of Technology Delhi,Delhi,----,org,PROPN-PROPN-ADP-PROPN-PROPN,PROPN,compound-nmod-prep-pobj-compound,compound,NNP-NNP-IN-NNP-NNP,NNP,3,1
88,85.0,24,won,4,15,22,7,14,1,-11,18,Otis College of Art and Design,Los Angeles,org-org-org-org-org-org,-,PROPN-PROPN-ADP-PROPN-CCONJ-PROPN,PROPN-PROPN,compound-pobj-prep-pobj-cc-conj,compound-pobj,NNP-NNP-IN-NNP-CC-NNP,NNP-NNP,2,1
89,86.0,38,acknowledged,3,23,28,5,22,9,-20,25,Ralph Klein,Alberta,per-per,,PROPN-PROPN,PROPN,compound-conj,pobj,NNP-NNP,NNP,8,1
90,87.0,17,left,13,6,10,4,5,6,7,-3,Germany,Adler,,per,PROPN,PROPN,pobj,nsubj,NNP,NNP,3,1
91,88.0,17,is,1,1,15,14,0,1,0,14,Elder-Beerman,The Bon-Ton,,org-org,NOUN,DET-PROPN,nsubj,det-pobj,NN,DT-NNP,8,1
92,89.0,30,moved,3,15,19,4,14,10,-12,16,he,Mr.,per,,PRON,PROPN,nsubjpass,compound,PRP,NNP,4,1
93,90.0,36,is,0,6,25,19,5,10,-6,25,Norway,Norwegian University of Science and Technology,,org-org-org-org-org-org,PROPN,PROPN-PROPN-ADP-PROPN-CCONJ-PROPN,pobj,compound-pobj-prep-pobj-cc-conj,NNP,NNP-NNP-IN-NNP-CC-NNP,6,1
94,91.0,26,said,5,16,25,9,15,0,-11,20,STRATFOR,Texas,org,,PROPN,PROPN,pobj,pobj,NNP,NNP,6,1
95,92.0,17,lived,7,5,6,1,4,10,2,-1,Suriname,Johan Ferrier,,per-per,PROPN,PROPN-PROPN,compound,compound-pobj,NNP,NNP-NNP,1,1
96,93.0,38,said,6,1,20,19,0,17,5,14,Germany,Airtricity,,org,PROPN,PROPN,poss,pobj,NNP,NNP,7,1
97,94.0,18,bore,7,7,12,5,6,5,0,5,Israel,Zalman Shazar,,per-per,PROPN,PROPN-PROPN,pobj,compound-nmod,NNP,NNP-NNP,4,1
98,95.0,41,lived,9,12,33,21,11,7,-3,24,India,Jawaharlal Nehru,,per-per,PROPN,PROPN-PROPN,pobj,compound-compound,NNP,NNP-NNP,13,1
99,96.0,37,was,3,17,36,19,16,0,-14,33,Josh Brown,Tennessee,per-per,,PROPN-PROPN,PROPN,compound-advcl,pobj,NNP-NNP,NNP,9,1
100,97.0,32,are,3,8,11,3,7,20,-5,8,La Trobe University,Victoria,org-org-org,,PROPN-PROPN-PROPN,PROPN,compound-compound-nmod,nmod,NNP-NNP-NNP,NNP,3,1
101,98.0,18,is,3,9,11,2,8,6,-6,8,Lemmy,Ian Fraser Kilmister,per,--,PROPN,PROPN-PROPN-PROPN,pobj,compound-compound-appos,NNP,NNP-NNP-NNP,2,1
102,99.0,35,include,3,17,30,13,16,4,-14,27,Huntington University,Indiana,-,org,PROPN-PROPN,PROPN,compound-compound,compound,NNP-NNP,NNP,10,1
103,100.0,20,attended,1,3,3,0,2,16,-2,2,Highland High School,Highland,org-org-org,,PROPN-PROPN-PROPN,PROPN,compound-compound-dobj,compound,NNP-NNP-NNP,NNP,0,1
104,101.0,33,feature,10,6,15,9,5,17,4,5,London,Rod Stewart,,per-per,PROPN,PROPN-PROPN,poss,compound-compound,NNP,NNP-NNP,9,1
105,121.0,65,become,3,13,17,4,12,47,-10,14,London,Rod Stewart,,per-per,PROPN,PROPN-PROPN,pobj,compound-ROOT,NNP,NNP-NNP,4,1
106,102.0,14,is,3,1,10,9,0,3,2,7,Westside Christian College,Goodna,org-org-org,,PROPN-PROPN-PROPN,PROPN,compound-compound-nsubj,compound,NNP-NNP-NNP,NNP,7,1
107,103.0,55,consists,7,44,2,-42,43,52,-37,-5,Transmile Air Services,Air Macau,org-org-org,-,PROPN-PROPN-PROPN,PROPN-PROPN,compound-compound-pobj,compound-compound,NNP-NNP-NNP,NNP-NNP,7,1
108,104.0,21,was,4,4,15,11,3,5,0,11,Egypt,Fuad I of Egypt,,per-per-per-per,PROPN,PROPN-PRON-ADP-PROPN,pobj,compound-appos-prep-pobj,NNP,NNP-PRP-IN-NNP,3,1
109,105.0,32,re-raised,11,4,29,25,3,2,7,18,5th Battalion,Australian Army,-,org-org,ADJ-PROPN,PROPN-PROPN,amod-nsubjpass,compound-compound,JJ-NNP,NNP-NNP,11,1
110,106.0,16,considered,2,1,3,2,0,12,1,1,Sydney,considered the A-League,,per-per-per,PROPN,VERB-DET-PROPN,compound,ROOT-det-poss,NNP,VBD-DT-NNP,5,1
111,107.0,48,named,31,28,40,12,27,7,3,9,Abraham Lincoln,United States,per-per,-,PROPN-PROPN,PROPN-PROPN,compound-compound,compound-pobj,NNP-NNP,NNP-NNP,10,1
112,108.0,19,located,6,2,10,8,1,8,4,4,Leatherman,Oregon,per,,PROPN,PROPN,nsubjpass,pobj,NNP,NNP,4,1
113,109.0,28,resigned,21,20,24,4,19,3,1,3,Joseph Laniel,France,per-per,,PROPN-PROPN,PROPN,compound-pobj,nsubj,NNP-NNP,NNP,4,1
114,110.0,44,put,7,14,16,2,13,27,-7,9,Va.,Washington-Lee High School,,org-org-org,PROPN,PROPN-PROPN-PROPN,poss,compound-compound-pobj,NNP,NNP-NNP-NNP,3,1
115,111.0,29,sworn,6,3,10,7,2,18,3,4,Susilo Bambang Yudhoyono,Indonesia,per-per-per,,PROPN-PROPN-PROPN,PROPN,compound-compound-nsubjpass,poss,NNP-NNP-NNP,NNP,3,1
116,112.0,12,graduated,1,4,10,6,3,1,-3,9,Harry D. Jacobs High School,Algonquin,org-org-org-org-org,,PROPN-PROPN-PROPN-PROPN-PROPN,PROPN,compound-compound-compound-compound-pobj,compound,NNP-NNP-NNP-NNP-NNP,NNP,3,1
117,113.0,18,Motivated,0,5,17,12,4,0,-5,17,he,California,per,,PRON,PROPN,nsubj,pobj,PRP,NNP,5,1
118,114.0,32,paid,1,15,15,0,14,16,-14,14,Florida Department of Education,Florida,org-org-org-org,,PROPN-PROPN-ADP-PROPN,PROPN,compound-pobj-prep-pobj,compound,NNP-NNP-IN-NNP,NNP,0,1
119,115.0,30,included,2,5,21,16,4,8,-3,19,Time Inc.,New York,org-org,-,PROPN-PROPN,PROPN-PROPN,compound-subtok,compound-pobj,NNP-NNP,NNP-NNP,-1,1
120,116.0,16,are,4,1,2,1,0,13,3,-2,Wales,Green Party of England and Wales,,org-org-org-org-org-org,PROPN,PROPN-PROPN-ADP-PROPN-CCONJ-PROPN,compound,compound-pobj-prep-pobj-cc-conj,NNP,NNP-NNP-IN-NNP-CC-NNP,1,1
121,117.0,18,founded,2,6,1,-5,5,16,-4,-1,Nebraska,Creighton University,,org-org,PROPN,PROPN-PROPN,pobj,compound-conj,NNP,NNP-NNP,2,1
122,118.0,27,replaces,16,4,13,9,3,13,12,-3,Sirimavo Bandaranaike,Sri Lanka,per-per,-,PROPN-PROPN,PROPN-PROPN,compound-compound,compound-compound,NNP-NNP,NNP-NNP,6,1
123,119.0,12,is,3,1,10,9,0,1,2,7,Ashdown Technology College,Dorset,org-org-org,,PROPN-PROPN-PROPN,PROPN,compound-compound-nsubj,compound,NNP-NNP-NNP,NNP,5,1
124,120.0,23,has,2,8,7,-1,7,15,-6,5,Norway,Oslo Stock Exchange,,org-org-org,PROPN,PROPN-PROPN-PROPN,pobj,compound-compound-pobj,NNP,NNP-NNP-NNP,4,1
125,122.0,20,is,6,5,19,14,4,0,1,13,SkyTrain,Vancouver,org,,PROPN,PROPN,compound,pobj,NNP,NNP,4,1
126,123.0,19,showed,13,6,10,4,5,8,7,-3,Nettbuss,Norwegian State Railways,per,--,PROPN,PROPN-PROPN-PROPN,conj,amod-compound-appos,NNP,NNP-NNP-NNPS,4,1
127,124.0,18,is,3,1,2,1,0,15,2,-1,T-Mobile,International AG,,org-org,PROPN,PROPN-PROPN,compound,compound-nsubj,NNP,NNP-NNP,2,1
128,125.0,43,Tong,1,1,13,12,0,29,0,12,Ronny Tong,Hong Kong,per-per,-,PROPN-PROPN,PROPN-PROPN,compound-ROOT,compound-pobj,NNP-NNP,NNP-NNP,3,1
129,126.0,26,is,10,9,18,9,8,7,1,8,CPES,University of Guelph,,org-org-org,PROPN,PROPN-ADP-PROPN,appos,pobj-prep-pobj,NNP,NNP-IN-NNP,8,1
130,127.0,30,are,5,24,26,2,23,3,-19,21,One,Ireland,org,,NUM,PROPN,pobj,pobj,CD,NNP,2,1
131,128.0,21,said,6,8,15,7,7,5,-2,9,Kumar,Indian,per,,PROPN,ADJ,nsubj,amod,NNP,JJ,4,1
132,129.0,36,proposed,11,11,13,2,10,22,0,2,TTC,Vaughan,org,,PROPN,PROPN,nsubj,compound,NNP,NNP,2,1
133,130.0,22,named,17,2,7,5,1,14,15,-10,Eva,Argentine,per,,PROPN,ADJ,nsubjpass,amod,NNP,JJ,3,1
134,131.0,20,supervised,11,2,5,3,1,14,9,-6,his,Institute of Chemical Technology in Prague,per,-----,DET,PROPN-ADP-PROPN-PROPN-ADP-PROPN,poss,pobj-prep-compound-pobj-prep-pobj,PRP$,NNP-IN-NNP-NNP-IN-NNP,3,1
135,132.0,13,was,7,1,12,11,0,0,6,5,Mohammad Musa Shafiq,Afghanistan,per-per-per,,PROPN-PROPN-PROPN,PROPN,compound-compound-nsubj,pobj,NNP-NNP-NNP,NNP,3,1
136,1335.0,14,born,4,1,11,10,0,2,3,7,Mohammad Musa Shafiq,Afghanistan,per-per-per,,PROPN-PROPN-PROPN,PROPN,compound-compound-nsubjpass,pobj,NNP-NNP-NNP,NNP,3,1
137,133.0,16,is,1,7,15,8,6,0,-6,14,United States Studies Centre,Sydney,---,org,PROPN-PROPN-PROPN-PROPN,PROPN,compound-compound-compound-pobj,pobj,NNP-NNP-NNPS-NNP,NNP,5,1
138,134.0,33,attended,5,8,10,2,7,22,-3,5,University of Notre Dame,Notre Dame Fighting Irish,org-org-org-org,---,PROPN-ADP-PROPN-PROPN,PROPN-PROPN-VERB-ADJ,nmod-prep-pobj-dobj,compound-pobj-advcl-amod,NNP-IN-NNP-NNP,NNP-NNP-VBG-JJ,2,1
139,135.0,21,served,2,1,10,9,0,10,1,8,Tommy Thompson,f Health and Human Service,per-per,----,PROPN-PROPN,PROPN-PROPN-CCONJ-PROPN-PROPN,compound-nsubj,det-appos-cc-compound-conj,NNP-NNP,NNP-NNP-CC-NNP-NNP,-1,1
140,136.0,33,emerged,3,17,19,2,16,13,-14,16,Japan,DJ Krush,,org-org,PROPN,PROPN-PROPN,dobj,compound-nsubj,NNP,NNP-NNP,4,1
141,137.0,10,dies,6,1,6,5,0,3,5,0,Johan Ferrier,Suriname,per-per,,PROPN-PROPN,PROPN,compound-nsubj,pobj,NNP-NNP,NNP,1,1
142,138.0,41,Airlines,1,1,4,3,0,36,0,3,China Airlines,CAL,org-org,,PROPN-PROPN,PROPN,compound-ROOT,appos,NNP-NNP,NNP,2,1
143,139.0,19,was,1,4,11,7,3,7,-3,10,Surfers,Go,,org,PROPN,VERB,poss,conj,NNPS,VB,4,1
144,140.0,14,is,2,1,11,10,0,2,1,9,Cyborg Attack,Germany,per-per,,PROPN-PROPN,PROPN,compound-nsubj,pobj,NNP-NNP,NNP,4,1
145,141.0,31,is,2,8,17,9,7,13,-6,15,ECU,Pirates,,org,PROPN,PROPN,compound,nsubj,NNP,NNPS,4,1
146,142.0,12,located,3,6,10,4,5,1,-3,7,Valley City State University,North Dakota,org-org-org-org,-,PROPN-PROPN-PROPN-PROPN,PROPN-PROPN,compound-compound-compound-compound,compound-pobj,NNP-NNP-NNP-NNP,NNP-NNP,3,1
147,143.0,41,initiate,8,2,6,4,1,34,6,-2,Land Transport Authority,LTA,org-org-org,,PROPN-PROPN-PROPN,PROPN,compound-compound-nsubj,appos,NNP-NNP-NNP,NNP,3,1
148,144.0,39,signed,18,6,10,4,5,28,12,-8,French University Paris-Sorbonne,Paris,org-org-org,,PROPN-PROPN-PROPN,PROPN,compound-pobj-pobj,compound,NNP-NNP-NNP,NNP,2,1
149,145.0,36,called,5,10,23,13,9,12,-5,18,Barbados national football team,World Cup,---,org-org,PROPN-ADJ-NOUN-NOUN,PROPN-PROPN,nmod-amod-compound-pobj,compound-compound,NNP-JJ-NN-NN,NNP-NNP,6,1
150,146.0,12,born,3,1,11,10,0,0,2,8,Emanuel Gregers,Denmark,per-per,,PROPN-PROPN,PROPN,compound-nsubjpass,pobj,NNP-NNP,NNP,2,1
151,147.0,41,attributed,18,1,13,12,0,27,17,-5,Joseph Goebbels,Germany,per-per,,PROPN-PROPN,PROPN,compound-nsubjpass,pobj,NNP-NNP,NNP,2,1
152,148.0,33,includes,3,3,2,-1,2,30,0,-1,Cup,Greek Super League,,org-org-org,PROPN,PROPN-PROPN-PROPN,nsubj,compound-compound-pobj,NNP,NNP-NNP-NNP,1,1
153,149.0,33,College,3,9,20,11,8,12,-6,17,BCCN,BCC,org,,PROPN,PROPN,compound,conj,NNP,NNP,1,1
154,150.0,34,studied,1,20,32,12,19,1,-19,31,Frank N. Wilcox,Cleveland,per-per-per,,PROPN-PROPN-PROPN,PROPN,compound-compound-conj,compound,NNP-NNP-NNP,NNP,7,1
155,151.0,35,stems,6,10,34,24,9,0,-4,28,Dominic Aitchison,Mogwai,per-per,,PROPN-PROPN,PROPN,compound-pobj,pobj,NNP-NNP,NNP,4,1
156,152.0,19,held,8,13,13,0,12,5,-5,5,Chiang Mai University,Chiang Mai,org-org-org,-,PROPN-PROPN-PROPN,PROPN-PROPN,compound-compound-compound,compound-compound,NNP-NNP-NNP,NNP-NNP,0,1
157,153.0,43,began,5,3,12,9,2,30,2,7,Boris Malenko,Florida,per-per,,PROPN-PROPN,PROPN,compound-compound,pobj,NNP-NNP,NNP,6,1
158,154.0,15,left,7,7,9,2,6,5,0,2,he,True North Records,per,--,PRON,PROPN-PROPN-PROPN,nsubj,compound-compound-dobj,PRP,NNP-NNP-NNPS,2,1
159,155.0,39,said,37,11,15,4,10,23,26,-22,Rufino Tamayo,Mexico,per-per,,PROPN-PROPN,PROPN,compound-pobj,poss,NNP-NNP,NNP,5,1
160,156.0,16,spent,1,1,14,13,0,1,0,13,Selznick,Jennifer Jones,per,-,PROPN,PROPN-PROPN,nsubj,compound-appos,NNP,NNP-NNP,5,1
161,157.0,22,taught,2,7,9,2,6,12,-5,7,University of Copenhagen,Copenhagen,org-org-org,,PROPN-ADP-PROPN,PROPN,nmod-prep-pobj,compound,NNP-IN-NNP,NNP,1,1
162,158.0,13,make,2,1,9,8,0,3,1,7,She,France,per,,PRON,PROPN,nsubj,pobj,PRP,NNP,3,1
163,159.0,62,written,4,25,29,4,24,32,-21,25,2008,logica,,org,NUM,NOUN,nummod,compound,CD,NN,-1,1
164,160.0,43,divided,6,37,41,4,36,1,-31,35,State Protection Group,SPG,org-org-org,,PROPN-PROPN-PROPN,PROPN,compound-compound-conj,appos,NNP-NNP-NNP,NNP,2,1
165,161.0,24,completed,2,19,22,3,18,1,-17,20,Madras Medical College,Chennai,org-org-org,,PROPN-PROPN-PROPN,PROPN,compound-compound-compound,compound,NNP-NNP-NNP,NNP,2,1
166,162.0,63,signed,3,8,29,21,7,33,-5,26,The Game,Universal Music Group,-,org-org-org,DET-PROPN,PROPN-PROPN-PROPN,det-nsubj,compound-compound-poss,DT-NNP,NNP-NNP-NNP,9,1
167,163.0,18,played,7,3,14,11,2,3,4,7,University of Detroit Mercy,Titans,org-org-org-org,,PROPN-ADP-PROPN-PROPN,PROPN,nmod-prep-pobj-compound,compound,NNP-IN-NNP-NNP,NNPS,6,1
168,164.0,38,acquired,6,4,9,5,3,28,2,3,FBM Marine,Babcock International Group,-,org-org-org,PROPN-PROPN,PROPN-PROPN-PROPN,compound-nsubjpass,compound-compound-compound,NNP-NNP,NNP-NNP-NNP,4,1
169,165.0,62,include,8,13,29,16,12,32,-5,21,Russia,Liberal Democratic Party,per,--,PROPN,PROPN-PROPN-PROPN,pobj,compound-compound-conj,NNP,NNP-NNP-NNP,8,1
170,166.0,22,served,3,1,15,14,0,6,2,12,El Fassi,Morocco,per-per,,PROPN-PROPN,PROPN,compound-nsubj,poss,NNP-NNP,NNP,6,1
171,167.0,75,featured,3,30,39,9,29,35,-27,36,Rik Emmett,Triumph,per-per,,PROPN-PROPN,PROPN,compound-poss,compound,NNP-NNP,NNP,5,1
172,168.0,30,are,12,1,26,25,0,3,11,14,Lawren Harris,Canada,per-per,,PROPN-PROPN,PROPN,compound-nsubj,poss,NNP-NNP,NNP,10,1
173,169.0,25,held,13,3,20,17,2,4,10,7,Gaylord Hotels,Nashville Tennessee,org-org,-,PROPN-PROPN,PROPN-PROPN,compound-compound,compound-pobj,NNP-NNP,NNP-NNP,5,1
174,968.0,18,held,13,2,11,9,1,6,11,-2,Gaylord Hotels,Nashville Tennessee,per-per,-,PROPN-PROPN,PROPN-PROPN,compound-compound,compound-pobj,NNP-NNP,NNP-NNP,6,1
175,170.0,24,nominated,5,10,17,7,9,6,-5,12,Banco Nacional de Obras y Servicios,BANOBRAS,-----,org,PROPN-PROPN-PROPN-PROPN-PROPN-PROPN,PROPN,nmod-nmod-nmod-appos-nummod-pobj,appos,NNP-NNP-NNP-NNP-NNP-NNPS,NNP,3,1
176,171.0,83,reelased,26,4,14,10,3,68,22,-12,Sylvie Vartan,Paris,per-per,,PROPN-PROPN,PROPN,compound-nsubj,pobj,NNP-NNP,NNP,3,1
177,172.0,26,said,1,14,24,10,13,1,-13,23,Vienna,his,,per,PROPN,DET,poss,poss,NNP,PRP$,9,1
178,173.0,18,founded,2,1,11,10,0,6,1,9,Odwalla,Greg Steltenpohl,org,-,PROPN,PROPN-PROPN,nsubjpass,compound-compound,NNP,NNP-NNP,4,1
179,174.0,20,teams,3,8,11,3,7,8,-5,8,university,NCAA,,org,NOUN,PROPN,compound,compound,NN,NNP,3,1
180,175.0,24,arranged,7,4,1,-3,3,22,3,-6,USA,The Culinary Institute of America,,org-org-org-org-org,PROPN,DET-PROPN-PROPN-ADP-PROPN,nmod,det-compound-pobj-prep-pobj,NNP,DT-NNP-NNP-IN-NNP,2,1
181,176.0,17,studied,3,1,16,15,0,0,2,13,Juan Esteban Montero,Chile,per-per-per,,PROPN-PROPN-PROPN,PROPN,compound-compound-nsubj,pobj,NNP-NNP-NNP,NNP,3,1
182,177.0,33,awarded,4,26,32,6,25,0,-22,28,Corvinus University of Budapest,Hungary,org-org-org-org,,PROPN-PROPN-ADP-PROPN,PROPN,compound-appos-prep-pobj,pobj,NNP-NNP-IN-NNP,NNP,3,1
183,178.0,27,brought,15,6,9,3,5,17,9,-6,Errol Barrow,Barbados,per-per,,PROPN-PROPN,PROPN,compound-pobj,pobj,NNP-NNP,NNP,3,1
184,179.0,32,became,6,12,29,17,11,2,-6,23,Chicago,William Hale Thompson,,per-per-per,PROPN,PROPN-PROPN-PROPN,poss,compound-compound-pobj,NNP,NNP-NNP-NNP,9,1
185,180.0,13,played,1,5,11,6,4,1,-4,10,New York Giants,NFL,--,org,PROPN-PROPN-PROPN,PROPN,compound-compound-pobj,compound,NNP-NNP-NNPS,NNP,5,1
186,181.0,108,include,6,49,72,23,48,35,-43,66,Maine West High School,Des Plaines,org-org-org-org,-,PROPN-PROPN-PROPN-PROPN,PROPN-PROPN,compound-compound-compound-ROOT,compound-compound,NNP-NNP-NNP-NNP,NNP-NNP,-1,1
187,182.0,20,had,4,10,1,-9,9,18,-6,-3,FirstGroup,Greyhound Canada,org,-,PROPN,PROPN-PROPN,npadvmod,compound-pobj,NNP,NNP-NNP,6,1
188,183.0,36,expressed,8,5,26,21,4,9,3,18,United States,Donald Rumsfeld,-,per-per,PROPN-PROPN,PROPN-PROPN,compound-compound,compound-poss,NNP-NNP,NNP-NNP,8,1
189,184.0,29,said,10,1,17,16,0,11,9,7,Indonesia,Telkomsel,,org,PROPN,PROPN,poss,dobj,NNP,NNP,6,1
190,185.0,14,played,1,7,12,5,6,1,-6,11,Christopher Columbus High School,Miami,org-org-org-org,,PROPN-PROPN-PROPN-PROPN,PROPN,compound-compound-compound-pobj,compound,NNP-NNP-NNP-NNP,NNP,3,1
191,186.0,26,is,6,2,18,16,1,7,4,12,Milwaukee Panthers,Horizon League,-,org-org,PROPN-PROPN,PROPN-PROPN,nmod-nmod,compound-pobj,NNP-NNPS,NNP-NNP,7,1
192,187.0,25,threatened,11,10,17,7,9,7,1,6,French Army,2nd Armored Division,org-org,--,PROPN-PROPN,NOUN-PROPN-PROPN,amod-pobj,nmod-amod-nmod,NNP-NNP,NN-NNP-NNP,6,1
193,188.0,27,There's,0,18,25,7,17,1,-18,25,Medgar Evers College,Brooklyn,org-org-org,,PROPN-PROPN-PROPN,PROPN,compound-compound-pobj,compound,NNP-NNP-NNP,NNP,7,1
194,189.0,37,is,2,11,24,13,10,12,-9,22,France Telecom,Orange,org-org,,PROPN-PROPN,PROPN,compound-pobj,compound,NNP-NNP,NNP,6,1
195,342.0,17,transmitting,3,1,14,13,0,2,2,11,France Telecom,Orange,-,org,PROPN-PROPN,PROPN,compound-nsubj,compound,NNP-NNP,NNP,5,1
196,624.0,48,Reading,1,19,22,3,18,25,-18,21,France Telecom,Orange,per-per,,PROPN-PROPN,PROPN,compound-pobj,appos,NNP-NNP,NNP,3,1
197,190.0,40,is,1,9,22,13,8,17,-8,21,Ringo Starr,Universal Music Group,per-per,--,PROPN-PROPN,PROPN-PROPN-PROPN,compound-nsubj,compound-compound-pobj,NNP-NNP,NNP-NNP-NNP,8,1
198,191.0,36,became,1,1,16,15,0,19,0,15,Smith,Southern Rhodesia,per,-,PROPN,PROPN-PROPN,nsubj,compound-compound,NNP,NNP-NNP,6,1
199,192.0,26,was,2,1,12,11,0,13,1,10,Bishop College,United States,org-org,-,PROPN-PROPN,PROPN-PROPN,compound-nsubj,compound-pobj,NNP-NNP,NNP-NNP,5,1
200,193.0,22,started,3,2,10,8,1,11,1,7,Pakistan,Quaid-i-Azam University,,org-org,PROPN,PROPN-PROPN,pobj,compound-pobj,NNP,NNP-NNP,5,1
201,194.0,27,is,5,14,25,11,13,1,-9,20,Lana Lane,Erik Norlander,-,per-per,PROPN-PROPN,PROPN-PROPN,compound-pobj,compound-pobj,NNP-NNP,NNP-NNP,6,1
202,195.0,46,is,12,35,38,3,34,7,-23,26,Finance Committee,Moraine Valley Community College,-,org-org-org-org,PROPN-PROPN,PROPN-PROPN-PROPN-PROPN,compound-pobj,compound-compound-compound-pobj,NNP-NNP,NNP-NNP-NNP-NNP,3,1
203,196.0,54,became,2,43,52,9,42,1,-41,50,Butthole Surfers,Go,per-per,,PROPN-PROPN,VERB,compound-compound,conj,NNP-NNPS,VB,5,1
204,197.0,39,say,14,1,13,12,0,25,13,-1,CACI,Arlington,org,,PROPN,PROPN,compound,compound,NNP,NNP,-1,1
205,198.0,19,amalgamated,4,2,12,10,1,6,2,8,1993,Maritime Union of Australia,,org-org-org-org,NUM,PROPN-PROPN-ADP-PROPN,pobj,compound-dobj-prep-pobj,CD,NNP-NNP-IN-NNP,4,1
206,199.0,25,supported,1,13,21,8,12,3,-12,20,Stockwell Day,Canadian Alliance,org-org,-,PROPN-PROPN,PROPN-PROPN,compound-poss,compound-dobj,NNP-NNP,NNP-NNP,3,1
207,200.0,54,born,6,40,47,7,39,6,-34,41,Francis II Holy Roman Emperor,Maria Teresa of Naples and Sicily,----,per-per-per-per-per-per,PROPN-PROPN-PROPN-PROPN-PROPN,PROPN-PROPN-ADP-PROPN-CCONJ-PROPN,compound-compound-compound-compound-pobj,compound-conj-prep-pobj-cc-conj,NNP-NNP-NNP-NNP-NNP,NNP-NNP-IN-NNP-CC-NNP,2,1
208,201.0,18,is,4,1,13,12,0,4,3,9,Apollo Group,Phoenix,org-org,,PROPN-PROPN,PROPN,compound-nsubj,compound,NNP-NNP,NNP,5,1
209,202.0,20,was,2,8,12,4,7,7,-6,10,Julie London,Liberty Records,per-per,-,PROPN-PROPN,PROPN-PROPN,compound-pobj,compound-pobj,NNP-NNP,NNP-NNPS,5,1
210,203.0,25,commenced,13,9,11,2,8,13,4,-2,City of Norwich School,Norwich,---,org,PROPN-ADP-PROPN-PROPN,PROPN,conj-prep-compound-pobj,compound,NNP-IN-NNP-NNP,NNP,1,1
211,204.0,28,was,3,1,23,22,0,4,2,20,Abbas el Fassi,Morocco,per-per-per,,PROPN-PROPN-PROPN,PROPN,compound-compound-nsubj,pobj,NNP-NNP-NNP,NNP,9,1
212,205.0,19,is,3,13,15,2,12,3,-10,12,University College Cork,Cork,org-org-org,,PROPN-PROPN-PROPN,PROPN,compound-compound-pobj,compound,NNP-NNP-NNP,NNP,2,1
213,206.0,25,led,7,4,18,14,3,6,3,11,Paris,Mitterrand,,per,PROPN,PROPN,pobj,poss,NNP,NNP,8,1
214,207.0,41,is,9,2,21,19,1,19,7,12,Kamal Kharazi,Foreign Affairs,per-per,-,PROPN-PROPN,PROPN-PROPN,compound-nsubj,compound-pobj,NNP-NNP,NNP-NNPS,6,1
215,208.0,33,was,5,4,13,9,3,19,1,8,Brian Deck,Red Red Meat,per-per,--,PROPN-PROPN,PROPN-PROPN-PROPN,compound-nsubj,compound-compound-pobj,NNP-NNP,NNP-NNP-NNP,5,1
216,209.0,69,was,14,53,57,4,52,11,-39,43,University of Stirling,Scotland,org-org-org,,PROPN-ADP-PROPN,PROPN,pobj-prep-pobj,pobj,NNP-IN-NNP,NNP,4,1
217,210.0,15,taught,2,8,13,5,7,1,-6,11,Queensland,Griffith University,org,-,PROPN,PROPN-PROPN,pobj,compound-pobj,NNP,NNP-NNP,4,1
218,932.0,98,are,1,14,32,18,13,65,-13,31,Queensland,Griffith University,,per-per,PROPN,PROPN-PROPN,compound,compound-compound,NNP,NNP-NNP,-1,1
219,211.0,24,is,9,1,8,7,0,15,8,-1,Luciana Souza,Brazil,per-per,,PROPN-PROPN,PROPN,compound-nsubj,appos,NNP-NNP,NNP,1,1
220,212.0,27,took,2,7,19,12,6,7,-5,17,Manchester,Oasis,,per,PROPN,PROPN,poss,pobj,NNP,NNP,8,1
221,213.0,14,released,7,1,12,11,0,1,6,5,Peggy Zina,BMG Greece,per-per,-,PROPN-PROPN,PROPN-PROPN,compound-poss,compound-pobj,NNP-NNP,NNP-NNP,3,1
222,214.0,23,is,2,1,15,14,0,7,1,13,Sergio,Philippines,per,,PROPN,PROPN,compound,pobj,NNP,NNP,6,1
223,215.0,19,set,3,12,18,6,11,0,-9,15,Thomas Jefferson,Virginia,per-per,,PROPN-PROPN,PROPN,compound-pobj,pobj,NNP-NNP,NNP,5,1
224,216.0,46,studied,1,18,29,11,17,16,-17,28,Italy,Luigi Einaudi,,per-per,PROPN,PROPN-PROPN,pobj,compound-attr,NNP,NNP-NNP,-1,1
225,217.0,29,is,3,1,14,13,0,14,2,11,Birds of Tokyo,Australia,per-per-per,,NOUN-ADP-PROPN,PROPN,nsubj-prep-pobj,pobj,NNS-IN-NNP,NNP,7,1
226,218.0,34,continues,1,10,25,15,9,8,-9,24,Marx,United States,per,-,PROPN,PROPN-PROPN,compound,compound-pobj,NNP,NNP-NNP,10,1
227,219.0,41,was,3,1,36,35,0,4,2,33,Discovery Networks Europe,Animal Planet,org-org-org,-,PROPN-PROPN-PROPN,PROPN-PROPN,compound-compound-nsubj,compound-nmod,NNP-NNPS-NNP,NNP-NNP,-1,1
228,220.0,62,remained,42,9,41,32,8,20,33,-1,New York,Tucker,-,per,PROPN-PROPN,PROPN,compound-pobj,pobj,NNP-NNP,NNP,10,1
229,221.0,40,told,33,20,25,5,19,14,13,-8,Minnesota,Mark Dayton,,per-per,PROPN,PROPN-PROPN,compound,compound-pobj,NNP,NNP-NNP,4,1
230,222.0,22,was,10,1,16,15,0,5,9,6,Arthur Barclay,Liberia,per-per,,PROPN-PROPN,PROPN,compound-nsubj,pobj,NNP-NNP,NNP,3,1
231,223.0,23,shot,1,1,7,6,0,15,0,6,Verhoeven,Netherlands,per,,PROPN,PROPN,nsubj,pobj,NNP,NNP,1,1
232,224.0,32,is,1,12,15,3,11,16,-11,14,Presbyterian College,Clinton,org-org,,PROPN-PROPN,PROPN,compound-pobj,compound,NNP-NNP,NNP,2,1
233,225.0,35,born,2,18,21,3,17,13,-16,19,Archduchess Gisela of Austria,Austria,per-per-per-per,,PROPN-PROPN-ADP-PROPN,PROPN,compound-appos-prep-pobj,pobj,NNP-NNP-IN-NNP,NNP,3,1
234,226.0,33,is,9,2,12,10,1,20,7,3,53d Wing,Air Force,-,org-org,NOUN-NOUN,PROPN-PROPN,nummod-pobj,compound-compound,NNS-NN,NNP-NNP,5,1
235,227.0,24,serves,5,3,19,16,2,4,2,14,Garmin,Kansas,org,,PROPN,PROPN,compound,pobj,NNP,NNP,5,1
236,228.0,39,sought,4,21,25,4,20,13,-17,21,Abu Dhabi,Mubadala Development Company,-,org-org-org,PROPN-PROPN,PROPN-PROPN-PROPN,compound-compound,compound-compound-pobj,NNP-NNP,NNP-NNP-NNP,3,1
237,229.0,32,is,1,9,12,3,8,19,-8,11,Monterey Bay,CSUMB,-,org,PROPN-PROPN,PROPN,compound-pobj,appos,NNP-NNP,NNP,1,1
238,230.0,49,was,23,5,30,25,4,18,18,7,New York,Bank of New York,-,org-org-org-org,PROPN-PROPN,PROPN-ADP-PROPN-PROPN,compound-compound,pobj-prep-compound-pobj,NNP-NNP,NNP-IN-NNP-NNP,7,1
239,231.0,24,born,2,1,8,7,0,15,1,6,Bell,England,per,,PROPN,PROPN,nsubjpass,pobj,NNP,NNP,5,1
240,232.0,22,based,14,7,21,14,6,0,7,7,submarine,England,per,,NOUN,PROPN,attr,pobj,NN,NNP,7,1
241,233.0,22,aired,8,18,21,3,17,0,-10,13,History Television,Canada,org-org,,PROPN-PROPN,PROPN,compound-conj,pobj,NNP-NNP,NNP,4,1
242,234.0,45,record,28,18,43,25,17,1,10,15,his,Sonet,per,,DET,PROPN,poss,compound,PRP$,NNP,6,1
243,235.0,29,said,27,1,20,19,0,8,26,-7,Brazil,Rio de Janeiro Stock Exchange,,org-org-org-org-org,PROPN,PROPN-PROPN-PROPN-PROPN-PROPN,poss,compound-compound-compound-compound-pobj,NNP,NNP-NNP-NNP-NNP-NNP,12,1
244,236.0,38,is,10,20,27,7,19,10,-10,17,his,Eagles,per,,DET,PROPN,poss,pobj,PRP$,NNPS,3,1
245,237.0,23,continued,2,8,8,0,7,14,-6,6,Ansett Australia,Ansett,org-org,,PROPN-PROPN,PROPN,compound-pobj,pobj,NNP-NNP,NNP,0,1
246,238.0,36,refused,1,7,19,12,6,16,-6,18,Japan,Junichiro Koizumi,,per-per,PROPN,PROPN-PROPN,pobj,compound-poss,NNP,NNP-NNP,6,1
247,239.0,33,involves,18,24,27,3,23,5,-6,9,Cintra,Spain,org,,PROPN,PROPN,appos,pobj,NNP,NNP,3,1
248,240.0,14,played,1,7,9,2,6,4,-6,8,University of Miami,Miami Hurricanes,org-org-org,-,PROPN-ADP-PROPN,PROPN-PROPN,pobj-prep-pobj,compound-pobj,NNP-IN-NNP,NNP-NNP,4,1
249,241.0,37,announced,13,7,32,25,6,4,6,19,Bell Globemedia,A-Channel,org-org,,PROPN-PROPN,PROPN,compound-nsubj,nmod,NNP-NNP,NNP,11,1
250,242.0,26,died,13,1,8,7,0,17,12,-5,Foday Sankoh,Revolutionary United Front,per-per,--,NOUN-VERB,PROPN-PROPN-PROPN,compound-npadvmod,compound-compound-pobj,NN-VB,NNP-NNP-NNP,4,1
251,243.0,29,graduated,4,15,14,-1,14,14,-11,10,Austria,Vienna University of Technology,,org-org-org-org,PROPN,PROPN-PROPN-ADP-PROPN,compound,compound-attr-prep-pobj,NNP,NNP-NNP-IN-NNP,1,1
252,244.0,19,graduated,3,13,18,5,12,0,-10,15,St. Francis Xavier University,Canada,org-org-org-org,,PROPN-PROPN-PROPN-PROPN,PROPN,compound-compound-compound-pobj,pobj,NNP-NNP-NNP-NNP,NNP,6,1
253,245.0,12,is,2,1,9,8,0,2,1,7,University Park,Illinois,org-org,,PROPN-PROPN,PROPN,compound-nsubj,compound,NNP-NNP,NNP,5,1
254,246.0,28,is,4,4,11,7,3,16,0,7,Ovalle,Chile,per,,PROPN,PROPN,nsubj,pobj,NNP,NNP,2,1
255,247.0,41,moved,2,17,24,7,16,16,-15,22,Wilfrid Laurier University,Waterloo,org-org-org,,PROPN-PROPN-PROPN,PROPN,compound-compound-pobj,compound,NNP-NNP-NNP,NNP,4,1
256,248.0,25,earned,3,16,19,3,15,5,-13,16,Roorkee,Indian Institute of Technology Roorkee,,org-org-org-org-org,PROPN,PROPN-PROPN-ADP-PROPN-PROPN,pobj,compound-nmod-prep-pobj-pobj,NNP,NNP-NNP-IN-NNP-NNP,7,1
257,249.0,24,was,12,1,18,17,0,5,11,6,William Plumer,New Hampshire,per-per,-,PROPN-PROPN,PROPN-PROPN,compound-compound,compound-pobj,NNP-NNP,NNP-NNP,5,1
258,250.0,30,was,1,9,12,3,8,17,-8,11,Austria,Falco,,per,PROPN,PROPN,compound,pobj,NNP,NNP,4,1
259,251.0,19,held,6,3,11,8,2,7,3,5,MuchMusic,Canada,org,,PROPN,PROPN,compound,pobj,NNP,NNP,3,1
260,252.0,30,been,7,6,28,22,5,1,1,21,Liverpool,Brian Epstein,,per-per,PROPN,PROPN-PROPN,pobj,compound-pobj,NNP,NNP-NNP,7,1
261,253.0,50,is,6,40,45,5,39,4,-34,39,United Russia,Vladimir Putin,-,per-per,PROPN-PROPN,PROPN-PROPN,compound-pobj,compound-pobj,NNP-NNP,NNP-NNP,4,1
262,254.0,27,received,1,22,24,2,21,2,-21,23,Odense University,Denmark,org-org,,PROPN-PROPN,PROPN,compound-compound,pobj,NNP-NNP,NNP,6,1
263,255.0,36,continued,2,22,13,-9,21,22,-20,11,Universiti Sains Malaysia,Malaysia,org-org-org,,PROPN-PROPN-PROPN,PROPN,compound-ROOT-compound,compound,NNP-NNP-NNP,NNP,1,1
264,256.0,43,are,5,13,18,5,12,24,-8,13,Bloodhound Gang,Pennsylvania,per-per,,PROPN-PROPN,PROPN,compound-pobj,compound,NNP-NNP,NNP,5,1
265,257.0,29,operated,10,2,8,6,1,20,8,-2,1979,Command Bus Company,,org-org-org,NUM,PROPN-PROPN-PROPN,pobj,compound-compound-nsubj,CD,NNP-NNP-NNP,3,1
266,258.0,17,born,5,1,9,8,0,7,4,4,George Victor Du Noyer,Ireland,per-per-per-per,,PROPN-PROPN-PROPN-PROPN,PROPN,compound-compound-compound-nsubjpass,pobj,NNP-NNP-NNP-NNP,NNP,3,1
267,259.0,23,Squadron,2,7,11,4,6,11,-5,9,Air Force Space Command,United States,---,org-org,PROPN-PROPN-PROPN-PROPN,PROPN-PROPN,compound-compound-compound-compound,compound-appos,NNP-NNP-NNP-NNP,NNP-NNP,3,1
268,260.0,89,released,3,56,87,31,55,1,-53,84,Larry Norman,United States,per-per,-,PROPN-PROPN,PROPN-PROPN,compound-oprd,compound-pobj,NNP-NNP,NNP-NNP,-1,1
269,261.0,22,founded,3,8,18,10,7,3,-5,15,1925,Sveriges Radio,,org-org,NUM,PROPN-PROPN,nummod,compound-oprd,CD,NNP-NNP,3,1
270,262.0,20,Born,0,5,17,12,4,2,-5,17,New York,William Russell,-,per-per,PROPN-PROPN,PROPN-PROPN,compound-pobj,compound-compound,NNP-NNP,NNP-NNP,6,1
271,263.0,39,said,21,34,38,4,33,0,-13,17,University of Vienna,Austria,org-org-org,,PROPN-ADP-PROPN,PROPN,pobj-prep-pobj,pobj,NNP-IN-NNP,NNP,8,1
272,265.0,121,provides,2,1,90,89,0,30,1,88,Heyco,Australia,per,,PROPN,PROPN,nsubj,ROOT,NNP,NNP,-1,1
273,266.0,14,became,4,2,9,7,1,4,2,5,Seoul,SK Group,org,-,PROPN,PROPN-PROPN,compound,compound-pobj,NNP,NNP-NNP,4,1
274,267.0,19,abbreviated,5,1,18,17,0,0,4,13,Aviation Week,McGraw-Hill,-,org,PROPN-PROPN,NUM,compound-compound,pobj,NNP-NNP,CD,9,1
275,268.0,18,is,6,2,4,2,1,13,4,-2,University of Catania,Catania,org-org-org,,PROPN-ADP-PROPN,PROPN,nsubj-prep-pobj,compound,NNP-IN-NNP,NNP,3,1
276,269.0,18,is,2,1,16,15,0,1,1,14,US Airways,Tempe,org-org,,PROPN-PROPN,PROPN,compound-nsubj,compound,NNP-NNP,NNP,5,1
277,270.0,40,pulled,13,12,24,12,11,15,1,11,ESPN,ABC Family,,org-org,PROPN,PROPN-PROPN,pobj,compound-compound,NNP,NNP-NNP,4,1
278,271.0,11,Operated,0,8,10,2,7,0,-8,10,Hadoulis Ltd,London,org-org,,PROPN-PROPN,PROPN,compound-compound,pobj,NNP-NNP,NNP,6,1
279,272.0,26,decided,3,3,13,10,2,12,0,10,ANTEL,Ancel,org,,PROPN,PROPN,nsubj,dobj,NNP,NNP,3,1
280,273.0,33,nominated,6,10,19,9,9,13,-4,13,Lyndon B. Johnson,United States,per-per-per,-,PROPN-PROPN-PROPN,PROPN-PROPN,compound-compound-pobj,compound-compound,NNP-NNP-NNP,NNP-NNP,8,1
281,274.0,19,continued,1,1,16,15,0,2,0,15,Prine,Oh Boy,per,-,PROPN,INTJ-PROPN,nsubj,compound-compound,NNP,UH-NNP,-1,1
282,275.0,28,was,1,10,22,12,9,5,-9,21,London,Winston Churchill,,per-per,PROPN,PROPN-PROPN,pobj,compound-pobj,NNP,NNP-NNP,7,1
283,276.0,39,was,1,22,27,5,21,11,-21,26,David Richards,Prodrive,-,per,PROPN-PROPN,ADJ,compound-nsubj,amod,NNP-NNP,JJ,2,1
284,277.0,51,thumb,0,36,44,8,35,6,-36,44,Italian,Raphael,,per,ADJ,PROPN,compound,pobj,JJ,NNP,3,1
285,278.0,17,said,15,11,14,3,10,2,4,-1,United States,Mike Sullivan,-,per-per,PROPN-PROPN,PROPN-PROPN,compound-compound,compound-nsubj,NNP-NNP,NNP-NNP,6,1
286,279.0,24,is,1,7,10,3,6,13,-6,9,Sunshine State Conference,Nova,--,per,PROPN-PROPN-PROPN,PROPN,compound-compound-compound,compound,NNP-NNP-NNP,NNP,2,1
287,280.0,58,is,1,42,1,-41,41,56,-41,0,UK,Swansea University,,org-org,PROPN,PROPN-PROPN,pobj,compound-pobj,NNP,NNP-NNP,-1,1
288,281.0,30,was,1,23,24,1,22,5,-22,23,Greece,Konstantinos Tsatsos,per,-,PROPN,PROPN-PROPN,compound,compound-pobj,NNP,NNP-NNP,1,1
289,282.0,21,made,5,1,13,12,0,7,4,8,Celestin,Columbia,,per,PROPN,PROPN,poss,compound,NNP,NNP,6,1
290,283.0,53,announced,3,14,25,11,13,27,-11,22,2008,A-League,per,,NUM,PROPN,nummod,nmod,CD,NNP,6,1
291,284.0,24,allows,9,2,2,0,1,21,7,-7,California Coastal Commission,California,--,org,PROPN-PROPN-PROPN,PROPN,compound-compound-nsubj,compound,NNP-NNP-NNP,NNP,0,1
292,285.0,29,made,7,5,15,10,4,13,2,8,General Services Administration,11,org-org-org,,PROPN-PROPN-PROPN,NUM,compound-compound-nsubj,nummod,NNP-NNPS-NNP,CD,5,1
293,286.0,22,saved,18,1,5,4,0,16,17,-13,Sabre Holdings,Texas,-,org,PROPN-PROPN,PROPN,compound-nsubj,pobj,NNP-NNP,NNP,2,1
294,287.0,42,Institute,1,2,17,15,1,24,-1,16,Institute for Cognitive Science Studies,tal ins,org-org-org-org-org,-,PROPN-ADP-PROPN-PROPN-PROPN,ADJ-NOUN,ROOT-prep-compound-compound-pobj,nsubj-ccomp,NNP-IN-NNP-NNP-NNPS,JJ-NNS,-1,1
295,288.0,40,said,20,34,39,5,33,0,-14,19,John Radcliffe Hospital,England,org-org-org,,PROPN-PROPN-PROPN,PROPN,compound-compound-pobj,pobj,NNP-NNP-NNP,NNP,8,1
296,289.0,31,spent,1,7,14,7,6,16,-6,13,Gulf Coast Community College,Florida,org-org-org-org,,PROPN-PROPN-PROPN-PROPN,PROPN,compound-compound-compound-pobj,pobj,NNP-NNP-NNP-NNP,NNP,4,1
297,290.0,9,attend,1,3,7,4,2,1,-2,6,Lathrop High School,Fairbanks,org-org-org,,PROPN-PROPN-PROPN,PROPN,compound-compound-dobj,compound,NNP-NNP-NNP,NNP,3,1
298,291.0,38,is,12,1,11,10,0,26,11,-1,Rustee Allen,U.S.,org-org,,PROPN-PROPN,PROPN,compound-nsubj,pobj,NNP-NNP,NNP,1,1
299,292.0,47,set,6,26,36,10,25,10,-20,30,North Korea,Kim Gu,per-per,-,PROPN-PROPN,PROPN-PROPN,compound-pobj,compound-pobj,NNP-NNP,NNP-NNP,8,1
300,293.0,55,Building,0,10,25,15,9,29,-10,25,Wundt,University of Leipzig,,per-per-per,PROPN,PROPN-ADP-PROPN,nsubj,pobj-prep-pobj,NNP,NNP-IN-NNP,15,1
301,294.0,29,is,6,1,1,0,0,27,5,-5,BAE Systems Land Systems,BAE Systems Land and Armaments,per-per-per-per,----,PROPN-PROPN-PROPN-PROPN,PROPN-PROPN-PROPN-CCONJ-PROPN,compound-compound-compound-compound,compound-compound-pobj-cc-conj,NNP-NNPS-NNP-NNPS,NNP-NNPS-NNP-CC-NNPS,0,1
302,295.0,41,tend,18,37,39,2,36,1,-19,21,Canada,he,,org,PROPN,PRON,pobj,nsubj,NNP,PRP,2,1
303,296.0,40,has,4,23,29,6,22,10,-19,25,Neeson,Natasha Richardson,,per-per,PROPN,PROPN-PROPN,nsubj,compound-appos,NNP,NNP-NNP,5,1
304,297.0,21,returned,14,14,17,3,13,3,0,3,McLaren,London,per,,PROPN,PROPN,nsubj,pobj,NNP,NNP,1,1
305,298.0,55,had,28,5,5,0,4,49,23,-23,Taylor Wimpey,Taylor Woodrow,org-org,-,PROPN-PROPN,PROPN-PROPN,compound-nsubj,compound-compound,NNP-NNP,NNP-NNP,0,1
306,299.0,57,signed,13,40,44,4,39,12,-27,31,Gilles Duceppe,Bloc,per-per,,PROPN-PROPN,PROPN,compound-pobj,conj,NNP-NNP,NNP,7,1
307,300.0,12,is,2,1,11,10,0,0,1,9,Amanda Falk,Canada,per-per,,PROPN-PROPN,PROPN,compound-nsubj,pobj,NNP-NNP,NNP,2,1
308,301.0,26,been,2,1,12,11,0,13,1,10,He,Wet Wet Wet,per,--,PRON,PROPN-PROPN-PROPN,nsubj,compound-compound-appos,PRP,NNP-NNP-NNP,6,1
309,302.0,74,was,3,25,36,11,24,37,-22,33,Kamehameha Schools,Bernice Pauahi Bishop,per-per,--,PROPN-PROPN,PROPN-PROPN-PROPN,compound-pobj,compound-compound-pobj,NNP-NNPS,NNP-NNP-NNP,6,1
310,303.0,45,was,12,16,24,8,15,20,-4,12,his,National Liberation Army,org,--,DET,PROPN-PROPN-PROPN,poss,compound-compound-pobj,PRP$,NNP-NNP-NNP,6,1
311,304.0,27,proceeded,1,10,22,12,9,4,-9,21,France,centrale de Lille,per,--,PROPN,NOUN-ADP-PROPN,pobj,compound-compound-pobj,NNP,NN-IN-NNP,6,1
312,305.0,20,said,2,11,16,5,10,3,-9,14,THQ,Juice Games,,org-org,PROPN,PROPN-PROPN,poss,compound-poss,NNP,NNP-NNPS,4,1
313,306.0,53,used,8,48,51,3,47,1,-40,43,Johns Hopkins University,Baltimore,org-org-org,,PROPN-PROPN-PROPN,PROPN,compound-compound-compound,compound,NNP-NNP-NNP,NNP,4,1
314,840.0,23,said,4,17,22,5,16,0,-13,18,Johns Hopkins University,Baltimore,org-org-org,,PROPN-PROPN-PROPN,PROPN,compound-compound-compound,pobj,NNP-NNP-NNP,NNP,4,1
315,307.0,38,is,9,5,22,17,4,15,4,13,Princess Louise Margaret of Prussia,Prince Arthur Duke of Connaught and Strathearn,org-org-org-org-org,------,PROPN-PROPN-PROPN-ADP-PROPN,PROPN-PROPN-PROPN-ADP-PROPN-CCONJ-PROPN,compound-compound-pobj-prep-pobj,compound-compound-dobj-prep-pobj-cc-conj,NNP-NNP-NNP-IN-NNP,NNP-NNP-NNP-IN-NNP-CC-NNP,10,1
316,308.0,30,said,24,2,6,4,1,23,22,-18,Shanghai,Yu Zhengsheng,per,-,PROPN,PROPN-PROPN,compound,compound-compound,NNP,NNP-NNP,4,1
317,309.0,26,served,11,1,17,16,0,8,10,6,Buckner Stith Morris,Illinois,--,per,PROPN-PROPN-PROPN,PROPN,compound-compound-nsubj,pobj,NNP-NNP-NNP,NNP,6,1
318,310.0,30,produced,24,2,4,2,1,25,22,-20,Foods,John Mackey,per,-,PROPN,PROPN-PROPN,compound,compound-poss,NNPS,NNP-NNP,1,1
319,311.0,25,denounced,11,4,10,6,3,14,7,-1,Guizot,France,org,,PROPN,PROPN,appos,pobj,NNP,NNP,3,1
320,312.0,38,year,2,8,9,1,7,28,-6,7,Afghanistan,Mohammad Hashim Maiwandwal,per,--,PROPN,PROPN-PROPN-PROPN,pobj,compound-compound-nsubjpass,NNP,NNP-NNP-NNP,-1,1
321,313.0,44,was,15,4,8,4,3,35,11,-7,Ying Lin,Ohio,-,per,PROPN-PROPN,PROPN,compound-appos,pobj,NNP-NNP,NNP,3,1
322,314.0,25,credited,2,5,19,14,4,5,-3,17,Mexico,Porfirio,per,,PROPN,PROPN,pobj,pobj,NNP,NNP,3,1
323,315.0,34,built,7,16,19,3,15,14,-9,12,University of Miami,Jackson Memorial Hospital,--,per-per-per,PROPN-ADP-PROPN,PROPN-PROPN-PROPN,nmod-prep-pobj,compound-compound-pobj,NNP-IN-NNP,NNP-NNP-NNP,2,1
324,316.0,35,referred,11,2,25,23,1,9,9,14,University of,Andalusia,org-org,,PROPN-ADP,PROPN,nsubj-prep,compound,NNP-IN,NNP,9,1
325,317.0,36,'re,1,13,28,15,12,7,-12,27,Bobby Darin,Capitol Records,org-org,-,PROPN-PROPN,PROPN-PROPN,compound-pobj,compound-pobj,NNP-NNP,NNP-NNPS,8,1
326,318.0,30,finished,14,14,18,4,13,11,0,4,UNCP,North Carolina,per,-,PROPN,PROPN-PROPN,nsubj,nmod-nmod,NNP,NNP-NNP,5,1
327,319.0,17,served,3,10,15,5,9,1,-7,12,State,Hamilton Fish,org,-,PROPN,PROPN-PROPN,pobj,compound-pobj,NNP,NNP-NNP,1,1
328,320.0,37,cited,15,12,18,6,11,18,3,3,New York,Nas,-,per,PROPN-PROPN,PROPN,compound-compound,dobj,NNP-NNP,NNP,4,1
329,321.0,41,trying,5,34,39,5,33,1,-29,34,Nicos Anastasiades,DISY,-,per,PROPN-PROPN,PROPN,compound-compound,compound,NNP-NNP,NNP,4,1
330,322.0,44,was,25,1,17,16,0,26,24,-8,Oswaldo Cruz,Brazil,per-per,,PROPN-PROPN,PROPN,compound-pobj,compound,NNP-NNP,NNP,-1,1
331,323.0,27,said,8,3,14,11,2,12,5,6,Houston,director,per,,PROPN,NOUN,nsubj,ccomp,NNP,NN,5,1
332,324.0,39,wrote,3,2,9,7,1,29,1,6,Mark Williams,New Zealand,per-per,-,PROPN-PROPN,PROPN-PROPN,compound-nsubj,compound-compound,NNP-NNP,NNP-NNP,6,1
333,325.0,16,announced,4,4,11,7,3,4,0,7,Telent,Warwick,per,,PROPN,PROPN,nsubj,pobj,NNP,NNP,4,1
334,326.0,30,rallied,3,3,27,24,2,2,0,24,Crusaders,Super 14,org,-,PROPN,PROPN-NUM,nsubj,nmod-nummod,NNPS,NNP-CD,4,1
335,327.0,25,is,6,1,11,10,0,13,5,5,Peggy Zina,by BMG Gree,-,org-org-org,PROPN-PROPN,ADP-PROPN-PROPN,compound-nsubj,agent-compound-compound,NNP-NNP,IN-NNP-NNP,5,1
336,328.0,25,been,2,1,21,20,0,3,1,19,VCU,Division I,per,-,PROPN,PROPN-PROPN,nsubj,pobj-compound,NNP,NNP-NNP,6,1
337,329.0,15,is,4,2,12,10,1,2,2,8,Charlie Parker,saxophonist,-,org,PROPN-PROPN,NOUN,compound-compound,compound,NNP-NNP,NN,6,1
338,330.0,37,are,7,20,27,7,19,9,-13,20,Timothy West,Prunella Scales,per-per,-,PROPN-PROPN,PROPN-PROPN,compound-pobj,compound-appos,NNP-NNP,NNP-NNPS,3,1
339,331.0,21,attended,1,3,7,4,2,13,-2,6,Inha University,South Korea,per-per,-,PROPN-PROPN,PROPN-PROPN,compound-dobj,compound-pobj,NNP-NNP,NNP-NNP,2,1
340,332.0,58,acquiried,3,30,38,8,29,19,-27,35,1912,Armstrong Whitworth Aircraft,org,--,NUM,PROPN-PROPN-PROPN,pobj,compound-compound-pobj,CD,NNP-NNP-NNP,4,1
341,333.0,41,became,19,3,12,9,2,28,16,-7,Santiago de Cuba,Cuban National Series,--,org-org-org,PROPN-PROPN-PROPN,PROPN-PROPN-PROPN,compound-compound-dobj,compound-compound-pobj,NNP-NNP-NNP,NNP-NNP-NNP,7,1
342,334.0,31,said,6,1,5,4,0,25,5,-1,Peru,Yehude Simon,,org-org,PROPN,PROPN-PROPN,poss,compound-appos,NNP,NNP-NNP,3,1
343,335.0,47,appeared,7,6,7,1,5,39,1,0,Munich,Schreck,,per,PROPN,PROPN,compound,pobj,NNP,NNP,2,1
344,336.0,22,sworn,7,5,21,16,4,0,2,14,Shehu Shagari,Nigeria,-,per,PROPN-PROPN,PROPN,compound-nsubjpass,pobj,NNP-NNP,NNP,6,1
345,337.0,22,withdrew,3,7,17,10,6,4,-4,14,Treasury,George Trenholm,per,-,PROPN,PROPN-PROPN,compound,compound-pobj,NNP,NNP-NNP,5,1
346,338.0,35,awarded,10,14,22,8,13,12,-4,12,Suzanne Bianchetti,France,-,per,PROPN-PROPN,PROPN,compound-dobj,pobj,NNP-NNP,NNP,5,1
347,339.0,23,said,7,15,18,3,14,4,-8,11,Qatar Airways,Greece,per-per,,PROPN-PROPN,PROPN,compound-nsubj,poss,NNP-NNP,NNP,6,1
348,340.0,25,appear,3,7,18,11,6,6,-4,15,St. Petersburg,University of South Florida St. Petersburg,org-org,-----,PROPN-PROPN,PROPN-ADP-PROPN-PROPN-PROPN-PROPN,compound-compound,nmod-prep-compound-compound-compound-pobj,NNP-NNP,NNP-IN-NNP-NNP-NNP-NNP,7,1
349,341.0,16,is,4,1,3,2,0,12,3,-1,Yrigoyen,Misiones Province,org,-,PROPN,PROPN-PROPN,nsubj,compound-pobj,NNP,NNP-NNP,2,1
350,343.0,35,chosen,3,26,30,4,25,4,-23,27,London,Malcolm McLaren,per,-,PROPN,PROPN-PROPN,compound,compound-pobj,NNP,NNP-NNP,3,1
351,344.0,35,born,3,1,7,6,0,27,2,4,Michael Dickinson,England,org-org,,PROPN-PROPN,PROPN,compound-nsubjpass,pobj,NNP-NNP,NNP,2,1
352,345.0,21,was,5,10,18,8,9,2,-5,13,Franz Joseph,Elisabeth of Bavaria,-,per-per-per,PROPN-PROPN,PROPN-ADP-PROPN,compound-pobj,appos-prep-pobj,NNP-NNP,NNP-IN-NNP,3,1
353,346.0,56,claims,12,2,8,6,1,47,10,-4,International Brotherhood of Electrical Workers,IBEW,per-per-per-per-per,,PROPN-PROPN-ADP-PROPN-PROPN,PROPN,compound-nsubj-prep-compound-pobj,appos,NNP-NNP-IN-NNP-NNPS,NNP,1,1
354,347.0,38,approved,11,27,27,0,26,10,-16,16,Jim Pattison,Jim Pattison Group,-,per-per-per,PROPN-PROPN,PROPN-PROPN-PROPN,compound-compound,compound-compound-pobj,NNP-NNP,NNP-NNP-NNP,0,1
355,348.0,27,MS,0,14,22,8,13,4,-14,22,Tallink,Tallinn,org,,VERB,PROPN,appos,compound,VB,NNP,4,1
356,349.0,41,gets,1,1,8,7,0,32,0,7,Alvirne,Hudson,,org,PROPN,PROPN,nsubj,compound,NNP,NNP,2,1
357,350.0,45,began,3,19,40,21,18,4,-16,37,University of Munich,Arnold Sommerfeld,org-org-org,-,PROPN-ADP-PROPN,PROPN-PROPN,nmod-prep-pobj,compound-pobj,NNP-IN-NNP,NNP-NNP,8,1
358,351.0,24,is,2,10,22,12,9,1,-8,20,Brian Ray,Whooray Records,org-org,-,PROPN-PROPN,PROPN-PROPN,compound-pobj,compound-appos,NNP-NNP,NNP-NNPS,7,1
359,352.0,38,comes,6,16,32,16,15,5,-10,26,Cuban League,Cuba,-,per,PROPN-PROPN,PROPN,compound-pobj,pobj,NNP-NNP,NNP,10,1
360,353.0,24,tours,2,10,15,5,9,8,-8,13,Brisbane,Kate Miller-Heidke,per,-,PROPN,PROPN-PROPN,compound,compound-dobj,NNP,NNP-NNP,2,1
361,354.0,32,flew,5,4,25,21,3,6,1,20,Alberto Fujimori,Peru,org-org,,PROPN-PROPN,PROPN,compound-nsubj,pobj,NNP-NNP,NNP,6,1
362,355.0,37,become,10,17,20,3,16,16,-7,10,Tory,George Canning,,per-per,PROPN,PROPN-PROPN,compound,compound-pobj,NNP,NNP-NNP,2,1
363,356.0,33,retain,4,1,23,22,0,9,3,19,Texas Wesleyan University,Fort Worth,per-per-per,-,PROPN-PROPN-PROPN,PROPN-PROPN,compound-compound-nsubj,compound-compound,NNP-NNP-NNP,NNP-NNP,5,1
364,357.0,74,left,2,43,64,21,42,9,-41,62,Margaret,actress,,per,PROPN,NOUN,compound,compound,NNP,NN,-1,1
365,358.0,33,viewed,5,1,32,31,0,0,4,27,Boston Medical Group,1998,org-org-org,,PROPN-PROPN-PROPN,NUM,compound-compound-nsubjpass,pobj,NNP-NNP-NNP,CD,3,1
366,359.0,29,improving,4,8,17,9,7,11,-4,13,China,Junichiro Koizumi,per,-,PROPN,PROPN-PROPN,pobj,compound-pobj,NNP,NNP-NNP,4,1
367,388.0,21,refused,1,1,7,6,0,13,0,6,China,Junichiro Koizumi,org,-,PROPN,PROPN-PROPN,nsubj,compound-pobj,NNP,NNP-NNP,4,1
368,360.0,27,*,0,13,15,2,12,11,-13,15,Ipoh Timur,Lim Kit Siang,org-org,--,PROPN-PROPN,PROPN-PROPN-PROPN,compound-compound,compound-compound-ROOT,NNP-NNP,NNP-NNP-NNP,3,1
369,361.0,14,founded,2,5,13,8,4,0,-3,11,1920,University,,per,NUM,PROPN,pobj,pobj,CD,NNP,2,1
370,362.0,37,offered,13,12,23,11,11,13,1,10,UNLV,University of Nevada,,org-org-org,PROPN,PROPN-ADP-PROPN,pobj,pobj-prep-compound,NNP,NNP-IN-NNP,6,1
371,944.0,22,represented,6,3,9,6,2,12,3,3,UNLV,University of Nevada,org,--,PROPN,PROPN-ADP-PROPN,compound,dobj-prep-compound,NNP,NNP-IN-NNP,4,1
372,363.0,20,is,2,14,17,3,13,2,-12,15,Wagner College,Staten Island,-,org-org,PROPN-PROPN,PROPN-PROPN,compound-pobj,compound-compound,NNP-NNP,NNP-NNP,3,1
373,364.0,38,devoted,8,8,18,10,7,19,0,10,Adenauer,Christian Democratic Union,org,--,PROPN,PROPN-PROPN-PROPN,pobj,compound-compound-appos,NNP,NNP-NNP-NNP,4,1
374,365.0,31,Fromkin,0,14,30,16,13,0,-14,30,Premier Viviani,France,org-org,,PROPN-PROPN,PROPN,compound-pobj,dobj,NNP-NNP,NNP,3,1
375,366.0,24,expects,14,6,14,8,5,9,8,0,Kyivstar,Telenor,per,,PROPN,PROPN,nsubj,nsubj,NNP,NNP,4,1
376,367.0,22,represented,8,8,14,6,7,7,0,6,Compaq,HP,per,,PROPN,PROPN,nsubj,poss,NNP,NNP,6,1
377,368.0,30,was,2,8,10,2,7,19,-6,8,Canada,Diefenbaker,,org,PROPN,PROPN,pobj,conj,NNP,NNP,3,1
378,369.0,29,stated,9,4,8,4,3,20,5,-1,Emily Robison,Dixie Chicks,-,org-org,PROPN-PROPN,PROPN-PROPN,compound-nsubj,compound-pobj,NNP-NNP,NNP-NNPS,2,1
379,370.0,14,is,3,1,13,12,0,0,2,10,Thomas Eldon Hayhurst,Indiana,--,per,PROPN-PROPN-PROPN,PROPN,compound-compound-nsubj,pobj,NNP-NNP-NNP,NNP,3,1
380,371.0,21,seems,5,15,17,2,14,3,-10,12,Feingold,Wisconsin,per,,PROPN,PROPN,conj,compound,NNP,NNP,2,1
381,372.0,25,is,6,1,1,0,0,23,5,-5,Parramatta High School,Parramatta,per-per-per,,PROPN-PROPN-PROPN,PROPN,compound-compound-nsubj,pobj,NNP-NNP-NNP,NNP,0,1
382,373.0,27,transferred,2,1,9,8,0,17,1,7,Hartinger,New York,per,-,PROPN,PROPN-PROPN,nsubj,compound-pobj,NNP,NNP-NNP,3,1
383,374.0,17,are,7,2,16,14,1,0,5,9,David Orr,Chicago,org-org,,PROPN-PROPN,PROPN,compound-nsubj,pobj,NNP-NNP,NNP,2,1
384,375.0,33,merged,4,2,8,6,1,24,2,4,Abram Lyle,Tate Lyle,per-per,-,PROPN-PROPN,PROPN-PROPN,compound-compound,compound-dobj,NNP-NNP,NNP-NNP,4,1
385,376.0,27,is,7,2,7,5,1,19,5,0,University of Bremen,1971,per-per-per,,PROPN-ADP-PROPN,NUM,nsubj-prep-pobj,pobj,NNP-IN-NNP,CD,3,1
386,377.0,35,release,4,12,17,5,11,17,-8,13,Darryl Neudorf,Canada,-,org,PROPN-PROPN,PROPN,compound-pobj,pobj,NNP-NNP,NNP,5,1
387,378.0,13,peaked,2,8,12,4,7,0,-6,10,Newton-John,Australia,org,,PROPN,PROPN,poss,appos,NNP,NNP,3,1
388,379.0,53,accepted,18,6,17,11,5,35,12,-1,Susilo Bambang Yudhoyono,Kristiani Herawati,per-per-per,-,PROPN-PROPN-PROPN,PROPN-PROPN,compound-compound-nmod,compound-nsubj,NNP-NNP-NNP,NNP-NNP,4,1
389,380.0,20,estimated,5,3,4,1,2,15,2,-1,Interior,Mario Scelba,per,-,PROPN,PROPN-PROPN,pobj,compound-nsubj,NNP,NNP-NNP,1,1
390,381.0,25,is,3,1,16,15,0,8,2,13,Top Shelf Productions,Chris Staros,per-per-per,-,PROPN-PROPN-PROPN,PROPN-PROPN,compound-compound-nsubj,compound-pobj,NNP-NNP-NNPS,NNP-NNP,8,1
391,382.0,32,is,15,2,5,3,1,26,13,-10,Universidade Federal de Pelotas,Pelotas,---,per,PROPN-PROPN-PROPN-PROPN,PROPN,nmod-compound-compound-nsubj,pobj,NNP-NNP-NNP-NNP,NNP,3,1
392,383.0,16,published,8,12,15,3,11,0,-4,7,school,1971,org,,NOUN,NUM,nsubj,pobj,NN,CD,2,1
393,1212.0,27,include,2,6,10,4,5,16,-4,8,school,1971,per,,NOUN,NUM,nsubjpass,pobj,NN,CD,2,1
394,384.0,24,Title,0,9,18,9,8,5,-9,18,Drake University,United States,org-org,-,PROPN-PROPN,PROPN-PROPN,compound-compound,compound-nsubj,NNP-NNP,NNP-NNP,5,1
395,385.0,28,is,1,12,26,14,11,1,-11,25,Finland,Tarja Turunen,org,-,PROPN,PROPN-PROPN,pobj,compound-conj,NNP,NNP-NNP,6,1
396,386.0,31,held,3,6,23,17,5,7,-3,20,University of A,Universidade da,org-org-org,-,PROPN-ADP-PROPN,PROPN-PROPN,pobj-prep-pobj,compound-compound,NNP-IN-NNP,NNP-NNP,8,1
397,387.0,59,works,11,35,47,12,34,11,-24,36,1985,NeXT,,per,NUM,PROPN,nummod,compound,CD,NNP,9,1
398,389.0,40,include,9,21,33,12,20,6,-12,24,Continental Airlines,Texas,-,org,PROPN-PROPN,PROPN,compound-pobj,compound,NNP-NNPS,NNP,8,1
399,390.0,37,Gehry-designed,13,22,30,8,21,6,-9,17,Chicago,Styx,,per,PROPN,PROPN,compound,poss,NNP,NNP,10,1
400,391.0,21,played,1,7,14,7,6,6,-6,13,Tottenville High School,Staten Island,--,org-org,PROPN-PROPN-PROPN,PROPN-PROPN,compound-compound-pobj,compound-compound,NNP-NNP-NNP,NNP-NNP,8,1
401,392.0,49,was,1,25,33,8,24,15,-24,32,Crosby,Decca,,per,PROPN,PROPN,nsubj,compound,NNP,NNP,5,1
402,393.0,17,re-branded,3,1,2,1,0,14,2,-1,V Australia,Australia,org-org,,PROPN-PROPN,PROPN,compound-nsubjpass,poss,NNP-NNP,NNP,1,1
403,394.0,22,compete,2,2,6,4,1,15,0,4,Bears,Big,per,,NOUN,ADJ,nsubj,amod,NNS,JJ,4,1
404,395.0,16,made,1,1,7,6,0,8,0,6,He,Edinburgh,org,,PRON,PROPN,nsubj,pobj,PRP,NNP,2,1
405,396.0,36,begun,8,17,31,14,16,4,-9,23,San Francisco State University,California,---,org,PROPN-PROPN-PROPN-PROPN,PROPN,compound-compound-compound-appos,pobj,NNP-NNP-NNP-NNP,NNP,10,1
406,397.0,17,made,3,1,14,13,0,2,2,11,John Barrowman,UK,per-per,,PROPN-PROPN,PROPN,compound-nsubj,compound,NNP-NNP,NNP,6,1
407,398.0,17,is,1,1,12,11,0,4,0,11,Maverick,Veronica,org,,PROPN,PROPN,nsubj,compound,NNP,NNP,6,1
408,399.0,15,was,4,2,14,12,1,0,2,10,New England Blizzard,Connecticut,per-per-per,,PROPN-PROPN-PROPN,PROPN,compound-compound-nsubj,pobj,NNP-NNP-NNP,NNP,6,1
409,400.0,15,born,1,9,14,5,8,0,-8,13,Philippine General Hospital,Philippines,org-org-org,,PROPN-PROPN-PROPN,PROPN,compound-compound-pobj,pobj,NNP-NNP-NNP,NNP,4,1
410,401.0,22,are,5,4,18,14,3,3,1,13,THANASI Foods,United States,org-org,-,PROPN-PROPN,PROPN-PROPN,compound-pobj,compound-pobj,NNP-NNPS,NNP-NNP,6,1
411,402.0,21,granted,1,5,18,13,4,2,-4,17,Ohio,company,org,,PROPN,NOUN,compound,nsubjpass,NNP,NN,5,1
412,403.0,32,founded,2,1,8,7,0,23,1,6,Adobe,John Warnock,per,-,PROPN,PROPN-PROPN,nsubjpass,compound-pobj,NNP,NNP-NNP,3,1
413,404.0,31,moment,3,9,13,4,8,17,-6,10,Euan,he,,org,PROPN,PRON,poss,nsubj,NNP,PRP,3,1
414,405.0,23,is,3,3,13,10,2,9,0,10,AnyBand,Samsung's Anycall,org,-,PROPN,PROPN-PROPN,appos,compound-pobj,NNP,NNP-NNP,6,1
415,406.0,36,says,2,6,4,-2,5,31,-4,2,Germany,Deutsche Bank,,per-per,PROPN,PROPN-PROPN,poss,compound-dative,NNP,NNP-NNP,2,1
416,407.0,31,is,11,10,22,12,9,8,1,11,Uzbekistan,FC Bunyodkor,,org-org,PROPN,PROPN-PROPN,pobj,compound-pobj,NNP,NNP-NNP,6,1
417,408.0,11,are,3,1,10,9,0,0,2,7,Yanmar,Japan,,org,PROPN,PROPN,poss,pobj,NNP,NNP,7,1
418,409.0,22,is,10,1,20,19,0,1,9,10,Chatham Grammar School for Boys,Kent,----,org,PROPN-PROPN-PROPN-ADP-PROPN,PROPN,compound-compound-nsubj-prep-pobj,compound,NNP-NNP-NNP-IN-NNPS,NNP,7,1
419,410.0,19,accomplished,17,1,15,14,0,3,16,-2,Spain,Cecilia,org,,PROPN,PROPN,poss,compound,NNP,NNP,7,1
420,411.0,29,attended,1,23,27,4,22,1,-22,26,Lewis-Clark State College,Lewiston,org-org-org,,VERB-PROPN-PROPN,PROPN,amod-compound-conj,compound,VB-NNP-NNP,NNP,3,1
421,412.0,69,served,6,49,60,11,48,8,-43,54,Missouri,Jim Talent,,per-per,PROPN,PROPN-PROPN,compound,compound-conj,NNP,NNP-NNP,1,1
422,413.0,20,criticized,6,11,18,7,10,1,-5,12,Norman Lamm,Yeshiva University,org-org,-,PROPN-PROPN,PROPN-PROPN,compound-compound,compound-pobj,NNP-NNP,NNP-NNP,4,1
423,414.0,33,is,9,3,9,6,2,23,6,0,1907,school,,per,NUM,NOUN,pobj,nsubj,CD,NN,2,1
424,415.0,21,was,2,9,13,4,8,7,-7,11,30th Infantry Division,Old Hickory,--,org-org,PROPN-PROPN-PROPN,PROPN-PROPN,amod-compound-pobj,compound-appos,NNP-NNP-NNP,NNP-NNP,2,1
425,416.0,27,is,8,1,23,22,0,3,7,15,Marie Bountrogianni,Ontario,-,org,PROPN-PROPN,PROPN,compound-nsubj,compound,NNP-NNP,NNP,3,1
426,417.0,40,overseen,2,36,37,1,35,2,-34,35,model,Anna Nicole Smith,org,--,NOUN,PROPN-PROPN-PROPN,compound,compound-compound-pobj,NN,NNP-NNP-NNP,2,1
427,418.0,26,said,7,1,6,5,0,19,6,-1,Stephenson King,Saint Lucia,per-per,-,PROPN-PROPN,PROPN-PROPN,compound-compound,compound-pobj,NNP-NNP,NNP-NNP,3,1
428,419.0,24,started,1,1,16,15,0,7,0,15,Birthmark,Athens,,per,PROPN,PROPN,nsubj,pobj,NNP,NNP,7,1
429,420.0,44,Act,3,28,32,4,27,11,-25,29,Quebec,Robert Bourassa,per,-,PROPN,PROPN-PROPN,pobj,compound-pobj,NNP,NNP-NNP,2,1
430,421.0,50,said,5,4,5,1,3,44,1,0,Austria,Wolfgang,per,,PROPN,PROPN,compound,pobj,NNP,NNP,3,1
431,422.0,15,Corporate,1,4,9,5,3,5,-3,8,Disney Consumer Products,The Walt Disney Company,--,per-per-per-per,PROPN-PROPN-PROPN,DET-PROPN-PROPN-PROPN,compound-compound-ROOT,det-compound-compound-pobj,NNP-NNP-NNP,DT-NNP-NNP-NNP,6,1
432,423.0,51,lay,3,14,15,1,13,35,-11,12,Bacharuddin,Jusuf Habibie,,per-per,PROPN,PROPN-PROPN,compound,compound-pobj,NNP,NNP-NNP,2,1
433,424.0,33,had,15,13,20,7,12,12,2,5,Yasser Arafat,Fatah,-,org,PROPN-PROPN,PROPN,compound-compound,poss,NNP-NNP,NNP,4,1
434,425.0,17,is,6,12,16,4,11,0,-6,10,Afghanistan,university,,per,PROPN,NOUN,compound,pobj,NNP,NN,4,1
435,426.0,31,supported,1,1,13,12,0,17,0,12,He,Finland,per,,PRON,PROPN,nsubj,pobj,PRP,NNP,1,1
436,427.0,15,followed,5,1,4,3,0,10,4,-1,Suzy Amis,Sam Robards,-,org-org,PROPN-PROPN,PROPN-PROPN,compound-nsubj,compound-conj,NNP-NNP,NNP-NNP,1,1
437,428.0,21,is,3,1,20,19,0,0,2,17,Liberty,Massachusetts,per,,PROPN,PROPN,compound,pobj,NNP,NNP,3,1
438,429.0,47,married,20,43,25,-18,42,21,-23,5,Standard Oil,William Rockefeller,-,per-per,PROPN-PROPN,PROPN-PROPN,compound-compound,compound-pobj,NNP-NNP,NNP-NNP,8,1
439,430.0,40,was,9,1,16,15,0,23,8,7,John Pope,Kentucky,org-org,,PROPN-PROPN,PROPN,compound-nsubj,pobj,NNP-NNP,NNP,4,1
440,431.0,22,announced,8,6,21,15,5,0,2,13,GAC,Tennessee,org,,PROPN,PROPN,compound,pobj,NNP,NNP,3,1
441,432.0,88,opined,23,4,5,1,3,82,19,-18,Harvey,Island,per,,PROPN,PROPN,compound,compound,NNP,NNP,1,1
442,433.0,19,Indexing,0,5,12,7,4,6,-5,12,IET,Technology,org,,PROPN,PROPN,nmod,conj,NNP,NNP,-1,1
443,434.0,31,based,2,5,25,20,4,5,-3,23,London,Granada Productions,per,-,PROPN,PROPN-PROPN,pobj,compound-conj,NNP,NNP-NNP,9,1
444,435.0,27,backed,6,8,16,8,7,10,-2,10,Afghan,Mohammad Najibullah,org,-,ADJ,PROPN-PROPN,amod,compound-pobj,JJ,NNP-NNP,3,1
445,436.0,21,is,2,13,18,5,12,2,-11,16,Liberal Democrats,Nick Clegg,-,org-org,PROPN-PROPN,PROPN-PROPN,compound-pobj,compound-compound,NNP-NNPS,NNP-NNP,-1,1
446,437.0,12,is,1,1,11,10,0,0,0,10,He,Wisconsin,,per,PRON,PROPN,nsubj,pobj,PRP,NNP,1,1
447,438.0,49,were,9,27,34,7,26,14,-18,25,Andrew Bonar Law,Exchequer,org-org-org,,PROPN-PROPN-PROPN,PROPN,compound-compound-conj,pobj,NNP-NNP-NNP,NNP,3,1
448,439.0,44,interviewed,2,33,38,5,32,5,-31,36,Bucaram,Ecuador,per,,PROPN,PROPN,pobj,pobj,NNP,NNP,3,1
449,440.0,34,allowed,7,14,16,2,13,17,-7,9,Iran,him,per,,PROPN,PRON,pobj,dobj,NNP,PRP,2,1
450,441.0,18,is,7,1,17,16,0,0,6,10,The Wharf,China,per-per,,DET-PROPN,PROPN,det-compound,pobj,DT-NNP,NNP,7,1
451,442.0,26,was,1,8,11,3,7,14,-7,10,Charles MacArthur,Helen Hayes,-,per-per,PROPN-PROPN,PROPN-PROPN,compound-pobj,compound-conj,NNP-NNP,NNP-NNP,1,1
452,443.0,27,Pritzker,2,1,1,0,0,25,1,-1,Liesel Anne Pritzker,Liesel Matthews,org-org-org,-,PROPN-PROPN-PROPN,PROPN-PROPN,compound-compound-ROOT,compound-nsubj,NNP-NNP-NNP,NNP-NNP,0,1
453,444.0,29,contributed,5,5,19,14,4,9,0,14,USA,Robert Armstrong,,per-per,PROPN,PROPN-ADP,pobj,compound-pobj,NNP,NNP-IN,3,1
454,445.0,31,said,4,2,27,25,1,3,2,23,UnitedHealth Group,Minnetonka,-,per,PROPN-PROPN,PROPN,compound-compound,nmod,NNP-NNP,NNP,10,1
455,446.0,13,opened,6,3,11,8,2,1,3,5,Columbia,Stephens College,,per-per,PROPN,PROPN-PROPN,compound,compound-attr,NNP,NNP-NNP,4,1
456,447.0,30,said,8,5,7,2,4,22,3,-1,AFT,Randi Weingarten,org,-,PROPN,PROPN-PROPN,compound,compound-nsubj,NNP,NNP-NNP,1,1
457,448.0,17,taught,1,14,16,2,13,0,-13,15,Brennen College,Thalassery,-,org,PROPN-PROPN,PROPN,compound-compound,pobj,NNP-NNP,NNP,8,1
458,449.0,27,Found,0,8,12,4,7,14,-8,12,Ross Copperman,UK,org-org,,PROPN-PROPN,PROPN,compound-pobj,pobj,NNP-NNP,NNP,3,1
459,450.0,26,named,7,2,10,8,1,15,5,3,Military Council for Justice and Democracy,Ely Ould Mohamed Vall,org-org-org-org-org-org,---,PROPN-PROPN-ADP-PROPN-CCONJ-PROPN,PROPN-PROPN-PROPN-PROPN,compound-nsubj-prep-pobj-cc-conj,compound-compound-compound-dobj,NNP-NNP-IN-NNP-CC-NNP,NNP-NNP-NNP-NNP,4,1
460,451.0,15,Bustamante,3,3,6,3,2,8,0,3,Alexander Bustamante,Jamaica,per-per,,PROPN-PROPN,PROPN,compound-ROOT,compound,NNP-NNP,NNP,4,1
461,452.0,33,spoke,7,1,4,3,0,28,6,-3,Robert Metz,party,-,per,PROPN-PROPN,NOUN,compound-nsubj,poss,NNP-NNP,NN,3,1
462,453.0,33,awarded,5,12,17,5,11,15,-7,12,Charlotte Area Transit System,CATS,per-per-per-per,,PROPN-PROPN-PROPN-PROPN,PROPN,compound-compound-compound-pobj,appos,NNP-NNP-NNP-NNP,NNP,2,1
463,454.0,25,is,8,1,18,17,0,6,7,10,Ben Jolley,Williamstown Seagulls,-,org-org,PROPN-PROPN,PROPN-PROPN,compound-nsubj,compound-pobj,NNP-NNP,NNP-NNPS,4,1
464,455.0,13,played,2,6,10,4,5,2,-4,8,Taiwan Beer,Super Basketball League,org-org,--,PROPN-PROPN,PROPN-PROPN-PROPN,compound-pobj,compound-compound-pobj,NNP-NNP,NNP-NNP-NNP,3,1
465,456.0,18,said,5,3,17,14,2,0,2,12,Abdul Kabir,Afghanistan,per-per,,PROPN-PROPN,PROPN,compound-compound,pobj,NNP-NNP,NNP,5,1
466,457.0,18,won,2,1,9,8,0,8,1,7,Brooke Fraser,New Zealand,-,org-org,PROPN-PROPN,PROPN-PROPN,compound-nsubj,compound-compound,NNP-NNP,NNP-NNP,7,1
467,458.0,14,moved,1,4,12,8,3,1,-3,11,England,Henry Moore,per,-,PROPN,PROPN-PROPN,pobj,compound-pobj,NNP,NNP-NNP,5,1
468,459.0,39,criticized,3,9,22,13,8,16,-6,19,Robert Taft,Ohio,per-per,,PROPN-PROPN,PROPN,compound-compound,pobj,NNP-NNP,NNP,3,1
469,460.0,38,sees,8,1,31,30,0,6,7,23,Japan,Shinz Ab,,per-per,PROPN,PROPN-PROPN,compound,compound-compound,NNP,NNP-NNP,-1,1
470,461.0,16,Is,2,9,14,5,8,1,-7,12,Los Angeles,LA Symphony,per-per,-,PROPN-PROPN,PROPN-PROPN,compound-compound,compound-pobj,NNP-NNP,NNP-NNP,2,1
471,462.0,30,given,8,12,23,11,11,6,-4,15,George H. W. Bush,United States,---,per-per,PROPN-PROPN-PROPN-PROPN,PROPN-PROPN,compound-compound-compound-pobj,compound-compound,NNP-NNP-NNP-NNP,NNP-NNP,8,1
472,463.0,34,adopted,23,9,29,20,8,4,14,6,New South Wales,him,--,org,PROPN-PROPN-PROPN,PRON,compound-compound-pobj,dobj,NNP-NNP-NNP,PRP,9,1
473,464.0,33,added,1,12,30,18,11,2,-11,29,Alliance Boots,UK,per-per,,PROPN-PROPN,PROPN,compound-pobj,pobj,NNP-NNPS,NNP,11,1
474,465.0,30,challenged,3,13,15,2,12,14,-10,12,Norway,Glittertind,,per,PROPN,PROPN,pobj,pobj,NNP,NNP,7,1
475,466.0,39,viewed,5,22,34,12,21,4,-17,29,Jana,Tuscarora,org,,PROPN,PROPN,pobj,conj,NNP,NNP,5,1
476,467.0,37,are,5,19,33,14,18,3,-14,28,Canada West,Allan MacNab,-,per-per,PROPN-PROPN,PROPN-PROPN,compound-pobj,compound-pobj,NNP-NNP,NNP-NNP,8,1
477,468.0,12,Nickles,6,3,6,3,2,5,3,0,Oklahoma,Don Nickles,per,-,PROPN,PROPN-PROPN,compound,compound-ROOT,NNP,NNP-NNP,3,1
478,469.0,39,produced,3,9,16,7,8,22,-6,13,Football League,Dean Brogan,-,per-per,PROPN-PROPN,PROPN-PROPN,compound-nmod,compound-pobj,NNP-NNP,NNP-NNP,3,1
479,470.0,11,have,3,2,8,6,1,2,1,5,Livaneli,Turkey,,per,PROPN,PROPN,nsubjpass,nsubj,NNP,NNP,3,1
480,471.0,26,is,10,1,7,6,0,18,9,-3,Fox Sports,Premier Media Group,-,per-per-per,PROPN-PROPN,PROPN-PROPN-PROPN,compound-compound,compound-compound-appos,NNP-NNPS,NNP-NNP-NNP,3,1
481,472.0,20,Among,0,4,8,4,3,11,-4,8,he,Munich,per,,PRON,PROPN,nsubj,compound,PRP,NNP,2,1
482,473.0,60,founded,8,20,29,9,19,30,-12,21,NSF,National Science Foundation,org,--,PROPN,PROPN-PROPN-PROPN,compound,compound-compound-pobj,NNP,NNP-NNP-NNP,5,1
483,474.0,32,wrote,12,9,11,2,8,20,3,-1,Montana,Mike Mansfield,per,-,PROPN,PROPN-PROPN,compound,compound-nsubj,NNP,NNP-NNP,1,1
484,475.0,32,hired,4,1,20,19,0,11,3,16,Time Warner,Jeffrey L. Bewkes,-,org-org-org,PROPN-PROPN,PROPN-PROPN-PROPN,compound-nsubj,compound-compound-nsubj,NNP-NNP,NNP-NNP-NNP,5,1
485,476.0,25,played,1,19,24,5,18,0,-18,23,Hinds Community College,Mississippi,--,per,PROPN-PROPN-PROPN,PROPN,compound-compound-pobj,pobj,NNP-NNP-NNP,NNP,7,1
486,477.0,27,headquartered,3,11,26,15,10,0,-8,23,Grande Holdings,Sansui,org-org,,PROPN-PROPN,PROPN,compound-pobj,conj,NNP-NNPS,NNP,5,1
487,941.0,18,purchased,6,4,17,13,3,0,2,11,Grande Holdings,Sansui,per-per,,PROPN-PROPN,PROPN,compound-pobj,conj,NNP-NNPS,NNP,2,1
488,478.0,35,is,5,16,16,0,15,18,-11,11,Florida,Florida Army National Guard,org,---,PROPN,PROPN-PROPN-PROPN-PROPN,compound,compound-compound-compound-conj,NNP,NNP-NNP-NNP-NNP,0,1
489,479.0,22,set,9,5,17,12,4,4,4,8,San Francisco,the morning of,org-org,--,PROPN-PROPN,DET-NOUN-ADP,compound-compound,det-pobj-prep,NNP-NNP,DT-NN-IN,6,1
490,480.0,20,October,1,9,12,3,8,7,-8,11,Algeria,Houari,,org,PROPN,PROPN,pobj,nsubj,NNP,NNP,3,1
491,481.0,44,was,15,1,20,19,0,23,14,5,Tammi Terrell,artist,-,per,PROPN-PROPN,NOUN,compound-nsubj,attr,NNP-NNP,NN,4,1
492,482.0,15,owned,6,4,13,9,3,1,2,7,Air Philippines,Lucio Tan,-,per-per,PROPN-PROPN,PROPN-PROPN,compound-conj,compound-pobj,NNP-NNP,NNP-NNP,4,1
493,483.0,35,ran,18,11,14,3,10,20,7,-4,minister,Al Sharpton,per,-,NOUN,PROPN-PROPN,pobj,compound-appos,NN,NNP-NNP,2,1
494,484.0,77,took,32,5,14,9,4,62,27,-18,William S. Rosecrans,Army of the Cumberland,org-org-org,---,PROPN-PROPN-PROPN,PROPN-ADP-DET-PROPN,compound-compound-nsubj,pobj-prep-det-pobj,NNP-NNP-NNP,NNP-IN-DT-NNP,6,1
495,485.0,17,releases,2,2,7,5,1,9,0,5,band,Pica Records,,per-per,NOUN,PROPN-PROPN,nsubj,compound-pobj,NN,NNP-NNP,2,1
496,486.0,41,appeared,5,4,9,5,3,31,1,4,King Diamond,Roadrunner,-,org,PROPN-PROPN,PROPN,compound-nsubj,compound,NNP-NNP,NNP,5,1
497,487.0,26,said,1,9,23,14,8,2,-8,22,EDS,Ronald A. Rittenmeyer,,org-org-org,PROPN,PROPN-PROPN-PROPN,poss,compound-compound-conj,NNP,NNP-NNP-NNP,9,1
498,488.0,23,expected,7,1,5,4,0,17,6,-2,Bulgaria,Sergey Stanishev,per,-,PROPN,PROPN-PROPN,poss,compound-nsubjpass,NNP,NNP-NNP,3,1
499,812.0,28,beat,11,1,15,14,0,12,10,4,Bulgaria,Sergey Stanishev,,per-per,PROPN,PROPN-PROPN,poss,compound-poss,NNP,NNP-NNP,6,1
500,489.0,46,elected,3,18,25,7,17,20,-15,22,Golda Meir,Mapai,org-org,,PROPN-PROPN,PROPN,compound-pobj,pobj,NNP-NNP,NNPS,4,1
501,490.0,20,represented,3,6,16,10,5,3,-3,13,Samy,Malaysian Indian Congress,,per-per-per,PROPN,ADJ-PROPN-PROPN,pobj,amod-compound-compound,NNP,JJ-NNP-NNP,5,1
502,491.0,13,merged,3,2,11,9,1,1,1,8,2007,Inverclyde Academy,per,-,NUM,PROPN-PROPN,pobj,compound-dobj,CD,NNP-NNP,3,1
503,492.0,24,is,1,13,18,5,12,5,-12,17,Scorpions,EMI,per,,PROPN,PROPN,pobj,compound,NNPS,NNP,3,1
504,493.0,28,housed,7,22,25,3,21,2,-15,18,Chonnam National University,Gwangju,--,org,PROPN-PROPN-PROPN,PROPN,compound-compound-conj,compound,NNP-NNP-NNP,NNP,4,1
505,494.0,25,career,5,4,11,7,3,13,1,6,Chaka,Rufus,per,,PROPN,PROPN,poss,appos,NNP,NNP,8,1
506,495.0,28,located,8,1,11,10,0,16,7,3,Ross Video,Iroquois,org-org,,PROPN-PROPN,PROPN,compound-poss,compound,NNP-NNP,NNP,5,1
507,496.0,26,holds,3,19,25,6,18,0,-16,22,Weizmann Institute of Science,Israel,per-per-per-per,,PROPN-PROPN-ADP-PROPN,PROPN,compound-appos-prep-compound,pobj,NNP-NNP-IN-NNP,NNP,4,1
508,497.0,30,are,8,13,28,15,12,1,-5,20,Monroig,Puerto Rico,org,-,PROPN,PROPN-PROPN,nsubj,compound-pobj,NNP,NNP-NNP,-1,1
509,498.0,17,has,1,1,4,3,0,12,0,3,Dearborn,Henry Ford,org,-,PROPN,PROPN-PROPN,nsubj,compound-dobj,NNP,NNP-NNP,3,1
510,499.0,35,is,2,1,23,22,0,11,1,21,Living Sacrifice,R.E.X. Records,per-per,-,VERB-PROPN,PROPN-PROPN,compound-nsubj,compound-pobj,VBG-NNP,NNP-NNPS,3,1
511,500.0,44,start,39,29,31,2,28,12,10,-8,Massive Attack,Robert Del Naja,-,org-org-org,PROPN-PROPN,PROPN-PROPN-PROPN,compound-compound,compound-compound-compound,NNP-NNP,NNP-NNP-NNP,3,1
512,501.0,27,spoke,2,16,17,1,15,9,-14,15,actress,Kathleen Beller,per,-,NOUN,PROPN-PROPN,compound,compound-dobj,NN,NNP-NNP,1,1
513,502.0,44,was,1,8,30,22,7,13,-7,29,Japan,4; Yasuo Fuku,,per-per-per,PROPN,NUM-PROPN-PROPN,pobj,compound-compound-compound,NNP,CD-NNP-NNP,-1,1
514,503.0,26,was,4,22,25,3,21,0,-18,21,Hahn Air,Germany,-,per,PROPN-PROPN,PROPN,compound-compound,pobj,NNP-NNP,NNP,2,1
515,504.0,30,Crowe,2,1,5,4,0,24,1,3,J. D. Crowe,New South,--,per-per,PROPN-PROPN-PROPN,PROPN-PROPN,compound-compound-ROOT,compound-conj,NNP-NNP-NNP,NNP-NNP,3,1
516,505.0,38,composed,3,2,16,14,1,21,1,13,SIDC,Air Force,org,-,PROPN,PROPN-PROPN,nsubjpass,compound-compound,NNP,NNP-NNP,4,1
517,506.0,29,grew,8,1,22,21,0,6,7,14,Louise,she,per,,PROPN,PRON,nsubj,nsubj,NNP,PRP,7,1
518,507.0,27,remained,15,6,18,12,5,8,9,3,Pacific Air Forces,PACAF,org-org-org,,PROPN-PROPN-PROPN,PROPN,compound-compound-dobj,pobj,NNP-NNP-NNPS,NNP,4,1
519,508.0,35,placed,19,6,19,13,5,15,13,0,Nicolas Sarkozy,Andorra,-,per,PROPN-PROPN,PROPN,compound-appos,pobj,NNP-NNP,NNP,6,1
520,509.0,51,known,3,16,7,-9,15,43,-13,4,Malaysia,Tunku Abdul Rahman,org,--,PROPN,PROPN-PROPN-PROPN,conj,compound-compound-compound,NNP,NNP-NNP-NNP,4,1
521,510.0,39,called,12,8,20,12,7,18,4,8,Jorge Montt,Chile,per-per,,PROPN-PROPN,PROPN,compound-pobj,pobj,NNP-NNP,NNP,8,1
522,511.0,30,Inc.,3,1,18,17,0,11,2,15,Raymond James,St. Petersburg,-,per-per,PROPN-PROPN,PROPN-PROPN,compound-compound,compound-compound,NNP-NNP,NNP-NNP,6,1
523,512.0,16,was,1,7,13,6,6,2,-6,12,United States Air Force Academy,Colorado Springs,per-per-per-per-per,-,PROPN-PROPN-PROPN-PROPN-PROPN,PROPN-PROPN,compound-compound-compound-compound-pobj,compound-compound,NNP-NNP-NNP-NNP-NNP,NNP-NNP,5,1
524,513.0,26,became,11,11,18,7,10,7,0,7,he,Virginia,org,,PRON,PROPN,nsubj,pobj,PRP,NNP,1,1
525,514.0,37,got,15,1,15,14,0,21,14,0,Proof,D12,org,,NOUN,PROPN,nsubj,appos,NN,NNP,5,1
526,515.0,39,WASHINGTON,0,3,24,21,2,14,-3,24,Tom Coburn,Muskogee,per-per,,PROPN-PROPN,PROPN,compound-nsubj,pobj,NNP-NNP,NNP,5,1
527,516.0,32,honored,7,11,13,2,10,18,-4,6,Italian,Carlo Azeglio Ciampi,,org-org-org,ADJ,PROPN-PROPN-PROPN,amod,compound-compound-appos,JJ,NNP-NNP-NNP,2,1
528,517.0,49,was,12,17,21,4,16,27,-5,9,Pastorius,Warner,per,,PROPN,PROPN,poss,pobj,NNP,NNP,1,1
529,518.0,35,born,5,9,8,-1,8,26,-4,3,Angus,Montrose Academy,,per-per,PROPN,PROPN-PROPN,compound,compound-pobj,NNP,NNP-NNP,2,1
530,519.0,20,asked,5,4,10,6,3,9,1,5,England,Benjamin Disraeli,per,-,PROPN,PROPN-PROPN,pobj,compound-appos,NNP,NNP-NNP,3,1
531,520.0,23,married,5,5,13,8,4,9,0,8,Tashman,Edmund Lowe,org,-,PROPN,PROPN-PROPN,nsubj,compound-conj,NNP,NNP-NNP,2,1
532,521.0,27,attended,1,20,24,4,19,2,-19,23,CA,Bonita High School,,org-org-org,PROPN,PROPN-PROPN-PROPN,pobj,compound-compound-pobj,NNP,NNP-NNP-NNP,5,1
533,522.0,44,is,6,17,34,17,16,9,-11,28,146th Airlift Wing,Naval Air Station Point Mugu,--,per-per-per-per-per,PROPN-PROPN-PROPN,PROPN-PROPN-PROPN-PROPN-PROPN,compound-compound-pobj,compound-compound-compound-compound-pobj,NNP-NNP-NNP,NNP-NNP-NNP-NNP-NNP,7,1
534,523.0,55,passed,27,17,22,5,16,32,10,-5,Tanzania,Bank of Tanzania,per,--,PROPN,PROPN-ADP-PROPN,pobj,nmod-prep-pobj,NNP,NNP-IN-NNP,6,1
535,524.0,21,Teach,1,9,16,7,8,4,-8,15,Sizzla,Greensleeves,,org,PROPN,PROPN,poss,pobj,NNP,NNP,4,1
536,525.0,21,represented,6,9,15,6,8,5,-3,9,Virginia Military Institute,NCAA,org-org-org,,PROPN-PROPN-PROPN,PROPN,compound-compound-dobj,compound,NNP-NNP-NNP,NNP,4,1
537,526.0,32,Jacques,1,7,16,9,6,15,-6,15,China,Ruttonjee Hospital,,org-org,PROPN,PROPN-PROPN,compound,compound-pobj,NNP,NNP-NNP,8,1
538,527.0,30,attending,25,9,12,3,8,17,16,-13,Hassanal Bolkiah,Brunei,per-per,,PROPN-PROPN,PROPN,amod-pobj,compound,NNP-NNP,NNP,-1,1
539,528.0,45,founded,3,14,30,16,13,14,-11,27,Minsk,Trudovye Rezervy-RIPO,,org-org,PROPN,PROPN-VERB,pobj,compound-conj,NNP,NNP-VBD,9,1
540,529.0,19,sworn,3,1,14,13,0,4,2,11,Ibrahim Nasir,Maldives,-,org,PROPN-PROPN,PROPN,compound-nsubjpass,pobj,NNP-NNP,NNPS,4,1
541,530.0,28,stated,7,13,24,11,12,3,-6,17,Tymoshenko,Ukraine,per,,PROPN,PROPN,nsubj,poss,NNP,NNP,7,1
542,531.0,32,is,5,8,2,-6,7,29,-3,-3,Israel,Israeli Air Force,,org-org-org,PROPN,ADJ-PROPN-PROPN,poss,amod-compound-compound,NNP,JJ-NNP-NNP,6,1
543,532.0,19,band,10,5,13,8,4,5,5,3,Jelly Roll Morton,Red Hot Peppers,per-per-per,--,PROPN-PROPN-PROPN,PROPN-PROPN-PROPN,compound-compound-nsubj,compound-compound-nsubj,NNP-NNP-NNP,NNP-NNP-NNPS,4,1
544,533.0,35,refer,25,17,19,2,16,15,8,-6,United States,Maritime,per-per,,PROPN-PROPN,PROPN,compound-compound,compound,NNP-NNP,NNP,1,1
545,534.0,27,grew,1,14,21,7,13,5,-13,20,Frank Hague,Democratic,-,org,PROPN-PROPN,PROPN,compound-dobj,compound,NNP-NNP,NNP,4,1
546,535.0,41,re-elected,7,5,13,8,4,27,2,6,he,Riksdag,per,,PRON,PROPN,nsubjpass,pobj,PRP,NNP,6,1
547,536.0,89,held,3,11,58,47,10,30,-8,55,Dubai,Zayed University,,per-per,PROPN,PROPN-PROPN,compound,compound-pobj,NNP,NNP-NNP,11,1
548,537.0,45,kept,3,10,17,7,9,27,-7,14,Essex,Mark Pettini,per,-,PROPN,PROPN-PROPN,poss,compound-pobj,NNP,NNP-NNP,5,1
549,538.0,19,born,5,16,17,1,15,1,-11,12,guitarist,Bucky Pizzarelli,per,-,NOUN,PROPN-PROPN,compound,compound-pobj,NN,NNP-NNP,1,1
550,539.0,27,year,2,4,16,12,3,10,-2,14,RCA,Nelson,,org,PROPN,PROPN,nsubj,compound,NNP,NNP,6,1
551,540.0,68,received,40,51,63,12,50,4,-11,23,Convocation,Kelantan,org,,PROPN,PROPN,pobj,pobj,NNP,NNP,3,1
552,541.0,15,is,3,1,14,13,0,0,2,11,Greatpac Sdn Bhd,Malaysia,--,per,PROPN-PROPN-PROPN,PROPN,compound-compound-nsubj,pobj,NNP-NNP-NNP,NNP,3,1
553,542.0,33,is,12,11,24,13,10,8,1,12,Germany,University of Bonn,,per-per-per,PROPN,PROPN-ADP-PROPN,pobj,pobj-prep-pobj,NNP,NNP-IN-NNP,7,1
554,543.0,8,From,0,3,5,2,2,2,-3,5,Brooklyn,Larry King,org,-,PROPN,PROPN-PROPN,pobj,compound-compound,NNP,NNP-NNP,3,1
555,544.0,19,expanded,2,2,18,16,1,0,0,16,group,Philippines,org,,NOUN,PROPN,nsubj,pobj,NN,NNP,1,1
556,545.0,28,dragged,2,14,17,3,13,10,-12,15,Steven Spielberg,Amblin Entertainment,-,org-org,PROPN-PROPN,PROPN-PROPN,compound-poss,compound-compound,NNP-NNP,NNP-NNP,4,1
557,546.0,31,announced,5,1,4,3,0,26,4,-1,Madonna,Ritchie,,per,PROPN,PROPN,nsubj,conj,NNP,NNP,3,1
558,547.0,30,served,1,7,14,7,6,15,-6,13,France A.,Purdue University,per-per,-,PROPN-PROPN,PROPN-PROPN,compound-pobj,compound-pobj,NNP-NNP,NNP-NNP,6,1
559,548.0,32,is,9,18,27,9,17,4,-9,18,of the,net of Junichiro K,-,org-org-org-org,ADP-DET,NOUN-ADP-PROPN-PROPN,prep-det,pobj-prep-compound-compound,IN-DT,NN-IN-NNP-NNP,9,1
560,549.0,25,was,4,16,18,2,15,6,-12,14,United States,Dwight D. Eisenhower,-,per-per-per,PROPN-PROPN,PROPN-PROPN-PROPN,compound-compound,compound-compound-pobj,NNP-NNP,NNP-NNP-NNP,2,1
561,550.0,28,merged,4,2,2,0,1,25,2,-2,Bath,Bath Chronicle,per,-,PROPN,PROPN-PROPN,compound,compound-pobj,NNP,NNP-NNP,0,1
562,551.0,29,been,6,25,27,2,24,1,-19,21,Alberta,Alison Redford,,per-per,PROPN,PROPN-PROPN,pobj,compound-pobj,NNP,NNP-NNP,1,1
563,552.0,25,entered,1,4,10,6,3,14,-3,9,Union,5th Maine Volunteer Infantry Regiment,,per-per-per-per-per,PROPN,ADJ-PROPN-PROPN-PROPN-PROPN,compound,amod-compound-compound-compound-pobj,NNP,JJ-NNP-NNP-NNP-NNP,7,1
564,553.0,15,PA,1,1,8,7,0,6,0,7,Philadelphia,Drexel University,,org-org,PROPN,PROPN-PROPN,compound,compound-compound,NNP,NNP-NNP,3,1
565,1474.0,32,opened,2,17,30,13,16,1,-15,28,Philadelphia,Drexel University,org,-,PROPN,PROPN-PROPN,pobj,compound-pobj,NNP,NNP-NNP,4,1
566,554.0,24,lost,11,1,5,4,0,18,10,-6,Republican National Committee,Henry Jarvis Raymond,--,per-per-per,PROPN-PROPN-PROPN,PROPN-PROPN-PROPN,compound-compound-compound,compound-compound-nsubj,NNP-NNP-NNP,NNP-NNP-NNP,4,1
567,555.0,13,began,3,8,11,3,7,1,-5,8,Pancrase,Minoru Suzuki,org,-,PROPN,PROPN-PROPN,dobj,compound-pobj,NNP,NNP-NNP,5,1
568,556.0,22,added,1,1,14,13,0,7,0,13,England,Tom Smith,,org-org,PROPN,PROPN-PROPN,nsubj,compound-conj,NNP,NNP-NNP,3,1
569,557.0,26,is,8,16,24,8,15,1,-8,16,Julio Iglesias,Sony,-,per,PROPN-PROPN,PROPN,compound-pobj,compound,NNP-NNP,NNP,5,1
570,558.0,20,began,3,3,19,16,2,0,0,16,he,Chicago,org,,PRON,PROPN,nsubj,pobj,PRP,NNP,1,1
571,559.0,27,HMX-1,0,14,22,8,13,4,-14,22,United States,Marine Corps Combat Development Command,-,per-per-per-per-per,PROPN-PROPN,PROPN-PROPN-PROPN-PROPN-PROPN,compound-pobj,compound-compound-compound-compound-pobj,NNP-NNP,NNP-NNP-NNP-NNP-NNP,8,1
572,560.0,21,bought,1,1,15,14,0,5,0,14,Atlantic,Covay,per,,PROPN,PROPN,nsubj,nsubj,NNP,NNP,2,1
573,561.0,36,--,0,13,20,7,12,15,-13,20,Vanderbilt University,TN,per-per,,PROPN-PROPN,PROPN,compound-appos,ROOT,NNP-NNP,NNP,4,1
574,562.0,42,elected,25,6,13,7,5,28,19,-12,Australia,Harold Holt,,org-org,PROPN,PROPN-PROPN,pobj,compound-pobj,NNP,NNP-NNP,3,1
575,1461.0,31,won,15,8,14,6,7,16,7,-1,Australia,Harold Holt,per,-,PROPN,PROPN-PROPN,pobj,compound-pobj,NNP,NNP-NNP,8,1
576,563.0,27,played,1,7,24,17,6,2,-6,23,University of Pittsburgh,NCAA,--,per,PROPN-ADP-PROPN,PROPN,pobj-prep-pobj,compound,NNP-IN-NNP,NNP,7,1
577,564.0,16,is,1,8,14,6,7,1,-7,13,Parts Labor,Jagjaguwar Records,org-org,-,PROPN-PROPN,PROPN-PROPN,compound-pobj,compound-pobj,NNP-NNP,NNP-NNPS,3,1
578,565.0,69,narrated,3,49,54,5,48,14,-46,51,Fairbanks North Star Borough,Jim Whitaker,---,per-per,PROPN-PROPN-PROPN-PROPN,PROPN-PROPN,compound-compound-compound-compound,compound-appos,NNP-NNP-NNP-NNP,NNP-NNP,4,1
579,566.0,45,was,1,1,9,8,0,35,0,8,Hesse,Germany,,org,PROPN,PROPN,nsubj,pobj,NNP,NNP,1,1
580,567.0,13,is,3,1,12,11,0,0,2,9,Ventura Bus Lines,Australia,per-per-per,,PROPN-PROPN-PROPN,PROPN,compound-compound-nsubj,pobj,NNP-NNP-NNP,NNP,3,1
581,568.0,41,realized,6,13,13,0,12,27,-7,7,University of Montenegro,University of,--,per-per,PROPN-ADP-PROPN,PROPN-ADP,nmod-prep-compound,pobj-prep,NNP-IN-NNP,NNP-IN,0,1
582,569.0,23,desalinating,14,7,10,3,6,12,7,-4,California,Energy Recovery Inc.,per,--,PROPN,PROPN-PROPN-PROPN,compound,compound-compound-appos,NNP,NNP-NNP-NNP,2,1
583,570.0,41,triggered,2,25,28,3,24,12,-23,26,Federal Reserve,Alan Greenspan,org-org,-,PROPN-PROPN,PROPN-PROPN,compound-compound,compound-nsubj,NNP-NNP,NNP-NNP,4,1
584,571.0,58,inspired,12,26,33,7,25,24,-14,21,Adolphe Thiers,France,-,org,PROPN-PROPN,PROPN,compound-appos,nsubj,NNP-NNPS,NNP,5,1
585,572.0,30,became,1,19,22,3,18,7,-18,21,Food Network,Canada,-,org,PROPN-PROPN,PROPN,compound-pobj,pobj,NNP-NNP,NNP,1,1
586,573.0,74,performed,2,6,6,0,5,67,-4,4,Springsteen,Springsteen,,per,PROPN,PROPN,compound,conj,NNP,NNP,0,1
587,574.0,44,ranks,26,5,8,3,4,35,21,-18,Richard Riordan,Los Angeles,per-per,-,PROPN-PROPN,PROPN-PROPN,compound-nmod,compound-compound,NNP-NNP,NNP-NNP,2,1
588,575.0,45,visited,2,21,21,0,20,23,-19,19,Communist Party of the Soviet Union,Communist Party of Great Britain,org-org-org-org-org-org,----,PROPN-PROPN-ADP-DET-PROPN-PROPN,PROPN-PROPN-ADP-PROPN-PROPN,compound-pobj-prep-det-compound-pobj,compound-pobj-prep-compound-pobj,NNP-NNP-IN-DT-NNP-NNP,NNP-NNP-IN-NNP-NNP,0,1
589,576.0,29,acknowledge,3,5,15,10,4,13,-2,12,Mr. Wolfowitz,World Bank Group,-,per-per-per,PROPN-PROPN,PROPN-PROPN-PROPN,compound-poss,compound-compound-nmod,NNP-NNP,NNP-NNP-NNP,8,1
590,577.0,31,is,8,2,6,4,1,24,6,-2,EA Canada,Burnaby,per-per,,PROPN-PROPN,PROPN,compound-nsubj,compound,NNP-NNP,NNP,4,1
591,578.0,43,Many,0,29,29,0,28,13,-29,29,Dhanmondi Tutorial,Dhanmondi,-,org,PROPN-PROPN,PROPN,compound-compound,pobj,NNP-NNP,NNP,0,1
592,579.0,19,is,4,10,14,4,9,4,-6,10,South Africa,Rhodes University,per-per,-,PROPN-PROPN,PROPN-PROPN,compound-pobj,compound-pobj,NNP-NNP,NNP-NNP,5,1
593,580.0,24,described,2,5,7,2,4,16,-3,5,Wisconsin,Russ Feingold,org,-,PROPN,PROPN-PROPN,compound,compound-dobj,NNP,NNP-NNP,1,1
594,581.0,34,abandoned,5,1,3,2,0,30,4,-2,Mexico,Pemex,org,,PROPN,PROPN,nmod,compound,NNP,NNP,1,1
595,582.0,35,placed,11,9,20,11,8,14,2,9,Company,1858,,org,PROPN,NUM,pobj,pobj,NNP,CD,2,1
596,583.0,29,organize,15,4,9,5,3,19,11,-6,Swedish Trade Union Confederation,Landsorganisationen i Sverige,---,per-per-per,PROPN-PROPN-PROPN-PROPN,PROPN-PROPN-PROPN,compound-compound-compound-nsubj,appos-punct-conj,NNP-NNP-NNP-NNP,NNP-NNP-NNP,4,1
597,584.0,10,e-newsletter,8,1,4,3,0,5,7,-4,ASA-Net,Autism Society of America,,org-org-org-org,CCONJ,PROPN-PROPN-ADP-PROPN,advmod,compound-poss-prep-pobj,CC,NNP-NNP-IN-NNP,3,1
598,585.0,25,returned,3,3,10,7,2,14,0,7,he,Camden,org,,PRON,PROPN,nsubj,compound,PRP,NNP,3,1
599,586.0,33,was,19,1,22,21,0,10,18,3,Frida Kahlo,Mexican,org-org,,PROPN-PROPN,ADJ,compound-compound,amod,NNP-NNP,JJ,3,1
600,587.0,22,include,2,8,19,11,7,2,-6,17,University,Scotland,org,,PROPN,PROPN,compound,pobj,NNP,NNP,5,1
601,588.0,34,brought,14,9,18,9,8,15,5,4,Sorensen,Washington,per,,PROPN,PROPN,poss,pobj,NNP,NNP,10,1
602,589.0,25,oversees,3,6,6,0,5,18,-3,3,North Dakota,North Dakota School for the Deaf,per-per,-----,PROPN-PROPN,PROPN-PROPN-PROPN-ADP-DET-PROPN,compound-compound,compound-compound-conj-prep-det-pobj,NNP-NNP,NNP-NNP-NNP-IN-DT-NNP,0,1
603,590.0,18,played,8,7,12,5,6,5,1,4,Christine Guldbrandsen,Norway,org-org,,PROPN-PROPN,PROPN,compound-nsubj,poss,NNP-NNP,NNP,5,1
604,591.0,39,says,6,31,36,5,30,2,-25,30,New York,Fox News Channel,per-per,--,PROPN-PROPN,PROPN-PROPN-PROPN,compound-compound,compound-compound-conj,NNP-NNP,NNP-NNP-NNP,2,1
605,593.0,21,came,2,1,10,9,0,10,1,8,Her,Anchorage,per,,DET,PROPN,poss,pobj,PRP$,NNP,3,1
606,594.0,33,Title,0,10,13,3,9,19,-10,13,The New School,Eugene Lang College,--,org-org-org,DET-PROPN-PROPN,PROPN-PROPN-PROPN,det-compound-compound,compound-compound-ROOT,DT-NNP-NNP,NNP-NNP-NNP,4,1
607,595.0,45,taken,6,41,44,3,40,0,-35,38,Sani Abacha,Nigeria,org-org,,PROPN-PROPN,PROPN,compound-pobj,pobj,NNP-NNP,NNP,10,1
608,596.0,19,began,3,3,15,12,2,3,0,12,he,Mauritania,per,,PRON,PROPN,nsubj,pobj,PRP,NNP,2,1
609,597.0,21,listed,8,4,13,9,3,7,4,5,her,Maryland,org,,DET,PROPN,poss,pobj,PRP$,NNP,5,1
610,598.0,44,is,1,17,23,6,16,20,-16,22,Asian Institute of Management,Manila,per-per-per-per,,PROPN-PROPN-ADP-PROPN,PROPN,compound-pobj-prep-pobj,pobj,NNP-NNP-IN-NNP,NNP,3,1
611,599.0,17,records,10,9,16,7,8,0,1,6,Cliff Richard,Columbia,per-per,,PROPN-PROPN,PROPN,compound-pobj,pobj,NNP-NNP,NNP,5,1
612,600.0,18,served,1,1,16,15,0,1,0,15,Graham,Florida,per,,PROPN,PROPN,nsubj,compound,NNP,NNP,3,1
613,601.0,30,graduated,9,1,8,7,0,21,8,-1,Juho Kusti Paasikivi,Finland,org-org-org,,PROPN-PROPN-PROPN,PROPN,compound-compound-nsubj,pobj,NNP-NNP-NNP,NNP,2,1
614,602.0,29,played,21,8,18,10,7,10,13,-3,Southern Methodist University,Division I,org-org-org,-,PROPN-PROPN-PROPN,PROPN-PRON,compound-compound-conj,nmod-compound,NNP-NNP-NNP,NNP-PRP,5,1
615,603.0,31,born,2,6,25,19,5,5,-4,23,Maine,Bates College,per,-,PROPN,PROPN-PROPN,pobj,compound-appos,NNP,NNP-NNP,5,1
616,604.0,36,contact,2,28,30,2,27,5,-26,28,Defence,Arturo Parisi,per,-,PROPN,PROPN-PROPN,compound,compound-nsubj,NNP,NNP-NNP,1,1
617,605.0,20,confronted,8,6,8,2,5,11,2,0,D12,Proof,per,,PROPN,PROPN,amod,nsubj,NNP,NNP,2,1
618,606.0,26,released,11,5,9,4,4,16,6,-2,Kill Rock Stars,The Old Haunts,--,org-org-org,PROPN-PROPN-PROPN,DET-PROPN-PROPN,compound-compound-compound,det-compound-nsubj,NNP-NNP-NNP,DT-NNP-NNPS,8,1
619,607.0,20,participated,7,2,6,4,1,13,5,-1,Secretary,Santiago Creel,,org-org,PROPN,PROPN-PROPN,nsubj,compound-pobj,NNP,NNP-NNP,2,1
620,608.0,45,sentenced,1,14,25,11,13,19,-13,24,Jameson,Cape Colony,,per-per,PROPN,PROPN-PROPN,nsubjpass,compound-pobj,NNP,NNP-NNP,6,1
621,609.0,46,honoured,12,19,44,25,18,1,-7,32,University of Pretoria,Sandton,--,per,PROPN-ADP-PROPN,PROPN,appos-prep-pobj,compound,NNP-IN-NNP,NNP,9,1
622,610.0,36,linked,4,19,19,0,18,16,-15,15,MARC,MARC Train,,per-per,PROPN,PROPN-PROPN,conj,compound-compound,NNP,NNP-NNP,0,1
623,611.0,61,said,36,15,21,6,14,39,21,-15,Akbar Bugti,Jamhoori Watan Party,-,per-per-per,PROPN-PROPN,PROPN-PROPN-PROPN,compound-dobj,compound-compound-pobj,NNP-NNP,NNP-NNP-NNP,4,1
624,612.0,31,included,3,5,9,4,4,21,-2,6,Army Air Corps,AC,per-per-per,,PROPN-PROPN-PROPN,PROPN,compound-compound-dobj,nmod,NNP-NNP-NNP,NNP,4,1
625,613.0,22,is,3,1,21,20,0,0,2,18,Choice Hotels,Maryland,org-org,,PROPN-PROPN,PROPN,compound-compound,pobj,NNP-NNP,NNP,3,1
626,614.0,42,is,6,28,34,6,27,7,-22,28,Danny DeVito,Rhea Perlman,-,org-org,PROPN-PROPN,PROPN-PROPN,compound-appos,compound-appos,NNP-NNP,NNP-NNP,6,1
627,615.0,30,collaborated,10,5,7,2,4,22,5,-3,New York,Worth,per-per,,PROPN-PROPN,PROPN,compound-compound,pobj,NNP-NNP,NNP,2,1
628,616.0,17,played,1,6,9,3,5,7,-5,8,Illawarra Steelers,Australia,-,org,PROPN-PROPN,PROPN,compound-conj,pobj,NNP-NNPS,NNP,3,1
629,617.0,21,was,3,8,19,11,7,1,-5,16,Slovakia,Robert Fico,org,-,PROPN,PROPN-PROPN,pobj,compound-pobj,NNP,NNP-NNP,4,1
630,618.0,47,was,4,37,42,5,36,4,-33,38,Ignace Cotolendi,Paris Foreign Missions Society,per-per,---,PROPN-PROPN,PROPN-PROPN-PROPN-PROPN,conj-appos,compound-compound-compound-pobj,NNP-NNP,NNP-NNP-NNPS-NNP,6,1
631,619.0,22,coached,3,2,20,18,1,1,1,17,Seminoles,Tallahassee,,per,PROPN,PROPN,nsubjpass,pobj,NNPS,NNP,6,1
632,620.0,21,lives,1,1,8,7,0,12,0,7,He,Gatineau,org,,PRON,PROPN,nsubj,pobj,PRP,NNP,1,1
633,621.0,24,is,9,16,23,7,15,0,-7,14,Costa Rica,Miguel,-,per,PROPN-PROPN,PROPN,compound-pobj,pobj,NNP-NNP,NNP,4,1
634,622.0,43,formed,1,12,15,3,11,27,-11,14,Anerood Jugnauth,Prime Minister,-,org-org,PROPN-PROPN,PROPN-PROPN,compound-pobj,compound-compound,NNP-NNP,NNP-NNP,3,1
635,623.0,28,won,2,1,18,17,0,9,1,16,Tony Lockett,St Kilda,org-org,-,PROPN-PROPN,PROPN-PROPN,compound-nsubj,compound-compound,NNP-NNP,NNP-NNP,4,1
636,625.0,33,launched,1,14,18,4,13,14,-13,17,Tony Hsieh,Zappos.com,-,per,PROPN-PROPN,PROPN,compound-compound,compound,NNP-NNP,NNP,5,1
637,626.0,41,is,11,2,2,0,1,38,9,-9,Royal Thai Armed Forces,Royal Thai Navy,per-per-per-per,--,PROPN-PROPN-PROPN-PROPN,PROPN-PROPN-PROPN,compound-compound-compound-compound,compound-compound-appos,NNP-NNP-NNP-NNPS,NNP-NNP-NNP,0,1
638,627.0,41,July,1,10,13,3,9,27,-9,12,Manchester United,FA Cup,per-per,-,PROPN-PROPN,PROPN-PROPN,compound-dobj,compound-compound,NNP-NNP,NNP-NNP,6,1
639,628.0,16,born,8,7,15,8,6,0,1,7,Abacha,Nigeria,,org,PROPN,PROPN,pobj,pobj,NNP,NNP,2,1
640,629.0,29,entertained,2,7,15,8,6,13,-5,13,James I of Scotland,Joan Beaufort,---,org-org,PROPN-PROPN-ADP-PROPN,PROPN-PROPN,compound-pobj-prep-pobj,compound-pobj,NNP-NNP-IN-NNP,NNP-NNP,5,1
641,630.0,31,named,16,8,12,4,7,18,8,-4,President,Thabo Mbeki,org,-,PROPN,PROPN-PROPN,pobj,compound-pobj,NNP,NNP-NNP,4,1
642,631.0,19,is,1,6,9,3,5,9,-5,8,Beverly Hills,Fox Interactive Media,-,org-org-org,PROPN-PROPN,PROPN-PROPN-PROPN,compound-pobj,compound-compound-compound,NNP-NNP,NNP-NNP-NNP,2,1
643,632.0,29,born,3,6,17,11,5,11,-3,14,Skipton,Iain Macleod,per,-,PROPN,PROPN-PROPN,pobj,compound-conj,NNP,NNP-NNP,4,1
644,633.0,26,Title,0,9,19,10,8,6,-9,19,Central Michigan University,MI,per-per-per,,PROPN-PROPN-PROPN,PROPN,compound-compound-compound,compound,NNP-NNP-NNP,NNP,5,1
645,634.0,34,concludes,17,8,20,12,7,13,9,3,Australia,Royal Australian Air Force,,per-per-per-per,PROPN,PROPN-PROPN-PROPN-PROPN,pobj,compound-compound-compound-pobj,NNP,NNP-NNP-NNP-NNP,4,1
646,635.0,26,says,3,14,15,1,13,10,-11,12,director,Roman Polanski,,org-org,NOUN,PROPN-PROPN,compound,compound-pobj,NN,NNP-NNP,1,1
647,636.0,23,moved,3,8,16,8,7,6,-5,13,Canada,Lance Storm,,per-per,PROPN,PROPN-PROPN,pobj,compound-pobj,NNP,NNP-NNP,4,1
648,637.0,25,was,1,16,23,7,15,1,-15,22,General,Robert Arbuthnot,org,-,PROPN,PROPN-PROPN,compound,compound-conj,NNP,NNP-NNP,2,1
649,638.0,48,praised,13,1,7,6,0,40,12,-6,Richard Koshalek,Art Center College of Design,-,org-org-org-org-org,PROPN-PROPN,PROPN-PROPN-PROPN-ADP-PROPN,compound-nsubj,compound-compound-pobj-prep-pobj,NNP-NNP,NNP-NNP-NNP-IN-NNP,4,1
650,639.0,25,were,1,20,23,3,19,1,-19,22,United States,George Washington,-,per-per,PROPN-PROPN,PROPN-PROPN,compound-pobj,compound-pobj,NNP-NNP,NNP-NNP,4,1
651,884.0,41,served,2,10,30,20,9,10,-8,28,United States,George Washington,-,per-per,PROPN-PROPN,PROPN-PROPN,compound-pobj,compound-nsubj,NNP-NNP,NNP-NNP,7,1
652,640.0,25,Chapter,1,12,22,10,11,2,-11,21,Maryland,Anderson,,per,PROPN,PROPN,poss,pobj,NNP,NNP,4,1
653,641.0,51,Selwyn-Lloyd,5,2,48,46,1,2,3,43,Selwyn Lloyd,Exchequer,-,per,PROPN-PROPN,PROPN,compound-nsubj,pobj,NNP-NNP,NNP,11,1
654,642.0,20,conscripted,2,6,18,12,5,1,-4,16,Israel,Golani Brigade,,org-org,PROPN,PROPN-PROPN,compound,compound-pobj,NNP,NNP-NNP,6,1
655,643.0,12,transition,2,8,11,3,7,0,-6,9,Nas,actor,,per,PROPN,NOUN,nsubj,attr,NNP,NN,4,1
656,644.0,44,working,3,1,26,25,0,17,2,23,Knowles,Daniel Smith,,per-per,PROPN,PROPN-PROPN,nsubj,compound-pobj,NNP,NNP-NNP,8,1
657,645.0,32,gatehouse,23,1,10,9,0,21,22,-13,Winchester College,William of Wykeham,per-per,--,PROPN-PROPN,PROPN-ADP-PROPN,compound-nsubj,pobj-prep-pobj,NNP-NNP,NNP-IN-NNP,5,1
658,646.0,31,congratulated,3,5,15,10,4,15,-2,12,Lee Myung-Bak,South Korea,-,org-org,PROPN-PROPN,PROPN-PROPN,compound-dobj,compound-pobj,NNP-NNP,NNP-NNP,7,1
659,647.0,20,hailed,3,13,14,1,12,5,-10,11,singer,Kumi Koda,per,-,NOUN,PROPN-PROPN,compound,compound-pobj,NN,NNP-NNP,2,1
660,648.0,49,Many,0,13,2,-11,12,46,-13,2,d Hideki T,of Ja,per-per-per,-,NOUN-PROPN-PROPN,ADP-PROPN,nummod-compound-dobj,prep-compound,NN-NNP-NNP,IN-NNP,7,1
661,649.0,37,show,18,3,16,13,2,20,15,-2,his,Delft,org,,DET,PROPN,poss,pobj,PRP$,NNP,3,1
662,650.0,36,rejected,1,20,29,9,19,6,-19,28,Jomo Kenyatta,Kenya,per-per,,PROPN-PROPN,PROPN,compound-dobj,compound,NNP-NNP,NNP,14,1
663,651.0,41,provides,1,6,17,11,5,23,-5,16,Pro TV,Romania,-,per,PROPN-NOUN,PROPN,nmod-compound,pobj,NNP-NN,NNP,6,1
664,652.0,72,were,8,1,47,46,0,24,7,39,James,Scotland,per,,PROPN,PROPN,poss,pobj,NNP,NNP,15,1
665,653.0,41,founded,12,2,15,13,1,25,10,3,ATCO,1947,per,,PROPN,NUM,compound,pobj,NNP,CD,4,1
666,654.0,34,called,4,18,32,14,17,1,-14,28,Republic,Chiang Ching-kuo,per,-,PROPN,PROPN-PROPN,nmod,compound-pobj,NNP,NNP-NNP,14,1
667,655.0,31,discusses,3,8,15,7,7,15,-5,12,Indian,Shobhaa De,org,-,ADJ,PROPN-PROPN,amod,compound-pobj,JJ,NNP-NNP,7,1
668,656.0,17,modified,5,11,12,1,10,4,-6,7,Kyosho,Corporation,per,,PROPN,PROPN,compound,pobj,NNP,NNP,2,1
669,657.0,9,comes,2,1,5,4,0,3,1,3,Marouf al-Bakhit,Jordan,-,per,PROPN-PROPN,PROPN,compound-nsubj,poss,NNP-NNP,NNP,3,1
670,658.0,50,declined,27,4,10,6,3,39,23,-17,Byrne,Ireland,org,,PROPN,PROPN,pobj,pobj,NNP,NNP,2,1
671,659.0,36,'re,1,20,26,6,19,9,-19,25,Daimler,Dieter Zetsche,,per-per,PROPN,PROPN-PROPN,pobj,compound-dobj,NNP,NNP-NNP,10,1
672,660.0,27,maintains,7,4,24,20,3,2,3,17,Japan,Tokio,,per,PROPN,PROPN,pobj,pobj,NNP,NNP,9,1
673,661.0,16,One,0,8,13,5,7,2,-8,13,Amirkabir University of Technology,Tehran,org-org-org-org,,PROPN-PROPN-ADP-PROPN,PROPN,compound-pobj-prep-pobj,compound,NNP-NNP-IN-NNP,NNP,1,1
674,662.0,45,headed,27,30,44,14,29,0,-3,17,Japan,Potshot,per,,PROPN,PROPN,pobj,npadvmod,NNP,NNP,2,1
675,663.0,35,is,8,27,11,-16,26,23,-19,3,Essendon Football Club,Australian Football League,per-per-per,--,PROPN-PROPN-PROPN,PROPN-PROPN-PROPN,compound-compound-pobj,compound-compound-pobj,NNP-NNP-NNP,NNP-NNP-NNP,5,1
676,664.0,32,stepping,6,17,21,4,16,10,-11,15,Sergey Brin,Google,org-org,,PROPN-PROPN,PROPN,compound-conj,pobj,NNP-NNP,NNP,8,1
677,665.0,31,met,4,3,14,11,2,16,1,10,Georgia Tech,GA,-,per,PROPN-PROPN,PROPN,compound-conj,pobj,NNP-NNP,NNP,6,1
678,666.0,44,Established,0,26,19,-7,25,24,-26,19,Touchstone Pictures,Disney,org-org,,PROPN-PROPN,PROPN,compound-compound,poss,NNP-NNPS,NNP,8,1
679,667.0,29,believed,2,23,25,2,22,3,-21,23,Ohio,Rob Portman,,per-per,PROPN,PROPN-PROPN,compound,compound-conj,NNP,NNP-NNP,1,1
680,668.0,24,designed,2,5,6,1,4,17,-3,4,Ruston,Proctor,,org,PROPN,PROPN,compound,compound,NNP,NNP,2,1
681,669.0,73,project,2,22,25,3,21,47,-20,23,Matt Helders,Arctic Monkeys,-,org-org,PROPN-PROPN,PROPN-PROPN,compound-ROOT,compound-compound,NNP-NNP,NNP-NNP,4,1
682,670.0,28,ensured,16,13,19,6,12,8,3,3,Seville,he,org,,PROPN,PRON,pobj,nsubj,NNP,PRP,3,1
683,671.0,42,gave,1,3,16,13,2,25,-2,15,Foday Sankoh,Sierra Leone,-,org-org,PROPN-PROPN,PROPN-PROPN,compound-dative,compound-poss,NNP-NNP,NNP-NNP,6,1
684,672.0,13,has,4,4,11,7,3,1,0,7,Reid,JR,,per,PROPN,PROPN,nsubj,compound,NNP,NNP,2,1
685,673.0,30,co-presented,3,12,15,3,11,14,-9,12,Northern Ireland,BBC Radio Ulster,org-org,--,PROPN-PROPN,PROPN-PROPN-PROPN,compound-pobj,compound-compound-compound,NNP-NNP,NNP-NNP-NNP,3,1
686,674.0,25,opened,8,8,21,13,7,3,0,13,Birmingham,Seaholm High School,per,--,PROPN,PROPN-PROPN-PROPN,pobj,compound-compound-pobj,NNP,NNP-NNP-NNP,4,1
687,675.0,21,were,3,5,8,3,4,12,-2,5,Ioannis Komnenos,Anna Dalassena,-,per-per,PROPN-PROPN,PROPN-PROPN,compound-attr,compound-conj,NNP-NNP,NNP-NNP,1,1
688,676.0,16,founded,10,8,12,4,7,3,2,2,Eizo,Irem,per,,PROPN,PROPN,compound,compound,NNP,NNP,4,1
689,677.0,39,was,1,9,19,10,8,19,-8,18,China Democracy Party,1998,per-per-per,,PROPN-PROPN-PROPN,NUM,compound-compound-pobj,pobj,NNP-NNP-NNP,CD,6,1
690,678.0,26,did,6,4,16,12,3,9,2,10,Paul Langevin,France,-,org,PROPN-PROPN,PROPN,compound-appos,pobj,NNP-NNP,NNP,2,1
691,679.0,29,published,3,6,11,5,5,17,-3,8,Bladet,Harstad Tidende,,org-org,PROPN,PROPN-PROPN,compound,compound-pobj,NNP,NNP-NNP,5,1
692,680.0,57,merged,28,15,8,-7,14,48,13,-20,Primary Reserve,the British Columbia Regiment,per-per,---,PROPN-PROPN,DET-PROPN-PROPN-PROPN,compound-compound,det-compound-compound-pobj,NNP-NNP,DT-NNP-NNP-NNP,8,1
693,681.0,27,battle,3,17,22,5,16,4,-14,19,1980,CNN,per,,NUM,PROPN,pobj,pobj,CD,NNP,2,1
694,682.0,18,was,1,1,9,8,0,8,0,8,Smith,The Dingoes,org,-,PROPN,DET-PROPN,nsubj,det-dobj,NNP,DT-NNP,2,1
695,683.0,43,explored,20,27,35,8,26,7,-7,15,1995,community organization,per,-,NUM,NOUN-NOUN,pobj,compound-nsubj,CD,NN-NN,5,1
696,684.0,15,is,3,3,6,3,2,8,0,3,school,Texas,,org,NOUN,PROPN,nsubj,nmod,NN,NNP,3,1
697,685.0,5,China,2,1,3,2,0,1,1,1,Liu Yan,China,org-org,,PROPN-PROPN,PROPN,compound-compound,ROOT,NNP-NNP,NNP,2,1
698,686.0,21,is,5,13,19,6,12,1,-8,14,School of International Service,Washington,---,org,PROPN-ADP-PROPN-PROPN,PROPN,pobj-prep-compound-compound,compound,NNP-IN-NNP-NNP,NNP,4,1
699,1109.0,41,accepted,5,12,21,9,11,19,-7,16,School of International Service,Washington,---,per,PROPN-ADP-PROPN-PROPN,PROPN,pobj-prep-compound-pobj,compound,NNP-IN-NNP-NNP,NNP,6,1
700,687.0,22,died,20,2,18,16,1,3,18,-2,Eddie Fisher,Elizabeth Taylor,per-per,-,PROPN-PROPN,PROPN-PROPN,compound-nsubj,compound-conj,NNP-NNP,NNP-NNP,4,1
701,688.0,15,is,4,1,13,12,0,1,3,9,Bournemouth School for Girls,Dorset,---,org,PROPN-PROPN-ADP-PROPN,PROPN,compound-nsubj-prep-pobj,compound,NNP-NNP-IN-NNP,NNP,5,1
702,689.0,19,was,5,1,12,11,0,6,4,7,Erich Mielke,Stasi,per-per,,PROPN-PROPN,PROPN,compound-compound,pobj,NNP-NNP,NNP,7,1
703,690.0,41,took,4,4,22,18,3,18,0,18,Hua,Central Military Commission,per,--,PROPN,PROPN-PROPN-PROPN,nsubj,compound-compound-pobj,NNP,NNP-NNP-NNP,6,1
704,691.0,27,is,5,1,5,4,0,21,4,0,Tranz Metro,KiwiRail,org-org,,PROPN-PROPN,PROPN,compound-nsubj,pobj,NNP-NNP,NNP,1,1
705,692.0,32,directed,9,6,21,15,5,10,3,12,National Military Commission,Chiang Kai-shek,--,per-per,PROPN-PROPN-PROPN,PROPN-PROPN,compound-compound-pobj,compound-pobj,NNP-NNP-NNP,NNP-NNP,10,1
706,693.0,15,is,5,1,14,13,0,0,4,9,Sacyr Vallehermoso,Madrid,org-org,,PROPN-PROPN,PROPN,compound-compound,pobj,NNP-NNP,NNP,3,1
707,694.0,27,operated,2,2,16,14,1,10,0,14,company,Portland,,org,NOUN,PROPN,nsubj,pobj,NN,NNP,7,1
708,695.0,38,University,6,10,25,15,9,12,-4,19,The Netherlands,Delft University of Technology,per-per,---,DET-PROPN,PROPN-PROPN-ADP-PROPN,det-ROOT,compound-ROOT-prep-pobj,DT-NNP,NNP-NNP-IN-NNP,-1,1
709,696.0,31,born,9,1,17,16,0,13,8,8,Zombo,singer,,org,PROPN,NOUN,nsubj,nmod,NNP,NN,5,1
710,697.0,40,chosen,6,10,18,8,9,21,-4,12,Venezuela,Leoni,,per,PROPN,PROPN,dobj,poss,NNP,NNP,4,1
711,698.0,32,won,1,1,9,8,0,22,0,8,Murray,Swan Districts Football Club,org,---,PROPN,PROPN-PROPN-PROPN-PROPN,nsubj,compound-compound-compound-pobj,NNP,NNP-NNPS-NNP-NNP,4,1
712,699.0,23,served,6,1,12,11,0,10,5,6,Gordon H. Mansfield,Veterans Affairs,org-org-org,-,PROPN-PROPN-PROPN,PROPN-PROPN,compound-compound-compound,pobj-pobj,NNP-NNP-NNP,NNP-NNPS,6,1
713,700.0,29,was,1,11,26,15,10,2,-10,25,Virginia,Dave Matthews,,org-org,PROPN,PROPN-PROPN,pobj,compound-compound,NNP,NNP-NNP,7,1
714,701.0,45,was,1,1,9,8,0,35,0,8,Gotch,Iowa,per,,PROPN,PROPN,nsubj,compound,NNP,NNP,6,1
715,702.0,41,led,15,24,25,1,23,15,-9,10,Exchequer,Iain Macleod,,per-per,PROPN,PROPN-PROPN,pobj,compound-pobj,NNP,NNP-NNP,1,1
716,703.0,23,known,7,2,20,18,1,2,5,13,High School,Sunrise 4A Region,per-per,--,PROPN-PROPN,PROPN-PROPN-PROPN,compound-poss,compound-compound-pobj,NNP-NNP,NNP-NNP-NNP,9,1
717,704.0,32,outbid,2,6,10,4,5,21,-4,8,Robert Holland,Jumeirah,per-per,,PROPN-PROPN,PROPN,compound-pobj,compound,NNP-NNP,NNP,1,1
718,705.0,47,founded,8,1,6,5,0,40,7,-2,Pan American Airways,PAA,--,per,PROPN-PROPN-PROPN,PROPN,compound-compound-compound,appos,NNP-NNP-NNP,NNP,3,1
719,706.0,39,said,18,21,24,3,20,14,-3,6,Jeff Sessions,Alabama,per-per,,PROPN-PROPN,PROPN,compound-nsubj,compound,NNP-NNPS,NNP,1,1
720,707.0,30,signed,8,11,14,3,10,15,-3,6,Indian,Rajiv Gandhi,,per-per,ADJ,PROPN-PROPN,amod,compound-pobj,JJ,NNP-NNP,2,1
721,708.0,34,inked,6,1,3,2,0,30,5,-3,Latvia,Valdis Zatlers,,org-org,PROPN,PROPN-PROPN,compound,compound-nsubj,NNP,NNP-NNP,1,1
722,709.0,36,PARIS,0,32,34,2,31,1,-32,34,French,Jacques Chirac,,org-org,ADJ,PROPN-PROPN,amod,compound-pobj,JJ,NNP-NNP,1,1
723,710.0,18,attended,1,1,8,7,0,9,0,7,Arnold,Tennessee,org,,PROPN,PROPN,nsubj,pobj,NNP,NNP,2,1
724,711.0,26,adjusted,8,3,23,20,2,2,5,15,Mass Transit Railway,MTR,per-per-per,,PROPN-PROPN-PROPN,PROPN,compound-compound-compound,dobj,NNP-NNP-NNP,NNP,5,1
725,712.0,39,is,6,21,29,8,20,9,-15,23,Scott D'Amore,Windsor,-,per,PROPN-PROPN,PROPN,compound-poss,compound,NNP-NNP,NNP,4,1
726,713.0,32,derived,13,20,28,8,19,3,-7,15,Abu Hafs al-Urduni,Arab Mujahideen in Chechnya,--,per-per-per-per,PROPN-PROPN-DET,PROPN-PROPN-ADP-PROPN,compound-compound-pobj,compound-pobj-prep-pobj,NNP-NNP-DT,NNP-NNP-IN-NNP,9,1
727,714.0,29,began,10,1,16,15,0,12,9,6,Aki,director,,per,PROPN,NOUN,nsubj,pobj,NNP,NN,5,1
728,715.0,20,featured,3,1,19,18,0,0,2,16,Davenport,Productions,per,,PROPN,PROPN,nsubjpass,conj,NNP,NNP,2,1
729,716.0,16,played,3,2,12,10,1,3,1,9,Blazers,Birmingham,,org,PROPN,PROPN,nsubj,compound,NNPS,NNP,3,1
730,717.0,21,decided,3,3,15,12,2,5,0,12,Effoa,Finnlines,per,,PROPN,PROPN,nsubj,pobj,NNP,NNPS,4,1
731,718.0,19,Spain's,4,3,13,10,2,5,1,9,La Liga,Real Madrid,per-per,-,PROPN-PROPN,PROPN-PROPN,compound-nmod,compound-pobj,NNP-NNP,NNP-NNP,6,1
732,719.0,18,dropped,1,1,13,12,0,4,0,12,Banharn,Thailand,per,,PROPN,PROPN,nsubj,dobj,NNP,NNP,2,1
733,720.0,24,File,0,6,6,0,5,17,-6,6,Richard,Richard II of England,per,---,PROPN,PROPN-PROPN-ADP-PROPN,pobj,compound-pobj-prep-pobj,NNP,NNP-NNP-IN-NNP,0,1
734,721.0,38,described,7,15,21,6,14,16,-8,14,Abu Ayyub al-Masri,Al-Qaeda in Iraq,org-org-org,--,PROPN-PROPN-PROPN,PROPN-ADP-PROPN,compound-compound-pobj,pobj-prep-pobj,NNP-NNP-NNP,NNP-IN-NNP,9,1
735,722.0,12,established,3,5,11,6,4,0,-2,8,Albert College,1866,per-per,,PROPN-PROPN,NUM,compound-dobj,pobj,NNP-NNP,CD,2,1
736,723.0,28,stated,11,11,27,16,10,0,0,16,Rome,Griffo,per,,PROPN,PROPN,pobj,pobj,NNP,NNP,3,1
737,724.0,10,bought,5,3,8,5,2,1,2,3,GCap Media,Global Radio,per-per,-,PROPN-PROPN,PROPN-PROPN,compound-nsubjpass,compound-pobj,NNP-NNP,NNP-NNP,3,1
738,725.0,34,named,14,17,33,16,16,0,-3,19,William Alexander Graham,Navy,--,per,PROPN-PROPN-PROPN,PROPN,compound-compound-pobj,pobj,NNP-NNP-NNP,NNP,4,1
739,726.0,68,located,11,26,32,6,25,35,-15,21,Nepal,Kantipur,,org,PROPN,PROPN,pobj,appos,NNP,NNP,3,1
740,727.0,10,belongs,1,1,5,4,0,4,0,4,It,Whittier Union High School District,org,----,PRON,PROPN-PROPN-PROPN-PROPN-PROPN,nsubj,compound-compound-compound-compound-pobj,PRP,NNP-NNP-NNP-NNP-NNP,3,1
741,728.0,83,coup,3,60,75,15,59,7,-57,72,Fiji,Frank Bainimarama,,per-per,PROPN,PROPN-PROPN,compound,compound-pobj,NNP,NNP-NNP,4,1
742,729.0,39,voted,3,6,8,2,5,30,-3,5,John Quincy,Adams,-,org,PROPN-PROPN,PROPN,compound-compound,nsubj,NNP-NNP,NNP,4,1
743,730.0,35,located,3,14,33,19,13,1,-11,30,West Virginia State University,Institute,per-per-per-per,,PROPN-PROPN-PROPN-PROPN,PROPN,compound-nmod-nmod-nmod,compound,NNP-NNP-NNP-NNP,NNP,10,1
744,731.0,26,was,10,2,3,1,1,22,8,-7,Royal Hong Kong Auxiliary Air Force,Hong Kong,-----,org-org,PROPN-PROPN-PROPN-PROPN-PROPN-PROPN,PROPN-PROPN,compound-compound-compound-compound-compound-nsubj,compound-pobj,NNP-NNP-NNP-NNP-NNP-NNP,NNP-NNP,1,1
745,732.0,26,returned,8,8,16,8,7,9,0,8,Clyde,Kansas,per,,PROPN,PROPN,nsubj,pobj,NNP,NNP,2,1
746,733.0,19,moved,3,7,11,4,6,7,-4,8,Minnesota,David Ellefson,,per-per,PROPN,PROPN-PROPN,pobj,compound-dobj,NNP,NNP-NNP,2,1
747,734.0,35,was,8,1,17,16,0,17,7,9,Kenner Collegiate Vocational Institute,Peterborough,---,per,PROPN-PROPN-PROPN-PROPN,PROPN,compound-compound-compound-nsubj,compound,NNP-NNP-NNP-NNP,NNP,7,1
748,735.0,20,announced,4,9,12,3,8,7,-5,8,Richard Branson,Virgin Comics,org-org,-,PROPN-PROPN,PROPN-PROPN,compound-poss,compound-dobj,NNP-NNP,NNP-NNP,1,1
749,736.0,30,comes,3,15,24,9,14,5,-12,21,France Telecom,Mobinil,org-org,,PROPN-PROPN,PROPN,compound-pobj,pobj,NNP-NNP,NNP,7,1
750,737.0,24,promised,6,15,18,3,14,5,-9,12,EDS,Plano,per,,PROPN,PROPN,pobj,compound,NNP,NNP,2,1
751,738.0,18,based,3,2,11,9,1,6,1,8,MCISB,Manchester,,per,PROPN,PROPN,nsubjpass,compound,NNP,NNP,5,1
752,739.0,22,is,13,1,12,11,0,9,12,-1,Tanisha,India,org,,PROPN,PROPN,nsubj,pobj,NNP,NNP,2,1
753,740.0,20,is,1,8,12,4,7,7,-7,11,Viva,York Region,,org-org,PROPN,PROPN-PROPN,compound,compound-poss,NNP,NNP-NNP,4,1
754,741.0,37,quoted,7,1,6,5,0,30,6,-1,Peter Munk,Barrick,-,org,PROPN-PROPN,PROPN,compound-nsubjpass,pobj,NNP-NNP,NNP,2,1
755,742.0,23,was,1,4,16,12,3,6,-3,15,Mountaineers,Big East,org,-,PROPN,PROPN-PROPN,poss,compound-compound,NNPS,NNP-NNP,7,1
756,743.0,26,awarded,10,2,24,22,1,1,8,14,Bangladesh,Jahangirnagar University,,org-org,PROPN,PROPN-PROPN,pobj,conj-pobj,NNP,NNP-NNP,9,1
757,744.0,21,was,2,1,14,13,0,6,1,12,Sallie Davis,Arizona,per-per,,PROPN-PROPN,PROPN,compound-nsubj,compound,NNP-NNP,NNP,8,1
758,745.0,38,given,8,4,4,0,3,33,4,-4,United States,United States Postal Inspection Service,org-org,----,PROPN-PROPN,PROPN-PROPN-PROPN-PROPN-PROPN,compound-pobj,compound-compound-compound-compound-dobj,NNP-NNP,NNP-NNP-NNP-NNP-NNP,0,1
759,746.0,38,disavowed,18,1,11,10,0,26,17,-7,Frederick Theodore Frelinghuysen,State,--,org,PROPN-PROPN-PROPN,PROPN,compound-compound-compound,pobj,NNP-NNP-NNP,NNP,3,1
760,747.0,23,represents,8,3,20,17,2,2,5,12,Virginia State University,Division II,--,org-org,PROPN-PROPN-PROPN,PROPN-PROPN,compound-compound-dobj,compound-compound,NNP-NNP-NNP,NNP-NNP,7,1
761,748.0,15,was,3,8,12,4,7,2,-5,9,Epic Games,Cary,-,org,PROPN-PROPN,PROPN,compound-pobj,compound,NNP-NNPS,NNP,6,1
762,749.0,16,astronaut,1,1,3,2,0,12,0,2,Japanese,Naoko Yamazaki,per,-,ADJ,PROPN-PROPN,amod,compound-nsubj,JJ,NNP-NNP,1,1
763,750.0,25,released,6,11,18,7,10,6,-5,12,Faye Tozer,Steps,-,org,PROPN-PROPN,PROPN,compound-dobj,npadvmod,NNP-NNP,NNPS,1,1
764,751.0,13,graduated,1,4,9,5,3,3,-3,8,Notre Dame High School,Sherman Oaks,per-per-per-per,-,PROPN-PROPN-PROPN-PROPN,PROPN-PROPN,compound-compound-compound-pobj,compound-pobj,NNP-NNP-NNP-NNP,NNP-NNPS,3,1
765,752.0,27,worked,4,22,24,2,21,2,-18,20,Prime Minister,R. B. Bennett,-,org-org-org,PROPN-PROPN,PROPN-PROPN-PROPN,compound-compound,compound-compound-pobj,NNP-NNP,NNP-NNP-NNP,2,1
766,753.0,17,served,1,1,5,4,0,11,0,4,He,Vermont,org,,PRON,PROPN,nsubj,compound,PRP,NNP,2,1
767,754.0,36,leads,2,14,25,11,13,10,-12,23,Partido Popular Cristiano,Peru,--,per,PROPN-PROPN-PROPN,PROPN,compound-compound-conj,pobj,NNP-NNP-NNP,NNP,5,1
768,755.0,49,split,26,35,39,4,34,9,-9,13,Goshen College,Indiana,per-per,,PROPN-PROPN,PROPN,compound-pobj,pobj,NNP-NNP,NNP,3,1
769,756.0,21,is,13,1,5,4,0,15,12,-8,Huey Lewis,Hugh Anthony Cregg,org-org,--,PROPN-PROPN,PROPN-PROPN-PROPN,compound-nsubj,compound-compound-compound,NNP-NNP,NNP-NNP-NNP,3,1
770,757.0,30,resolved,17,2,8,6,1,21,15,-9,Ricardo Romo,University of Texas at San Antonio,-,per-per-per-per-per-per,PROPN-PROPN,PROPN-ADP-PROPN-ADP-PROPN-PROPN,compound-nsubj,pobj-prep-pobj-prep-compound-pobj,NNP-NNP,NNP-IN-NNP-IN-NNP-NNP,5,1
771,758.0,13,is,2,5,10,5,4,2,-3,8,Tracy Pollan,Michael J. Fox,per-per,--,PROPN-PROPN,PROPN-PROPN-PROPN,compound-attr,compound-compound-pobj,NNP-NNP,NNP-NNP-NNP,5,1
772,759.0,30,selected,6,14,20,6,13,9,-8,14,USA,FIBA Americas Championship,org,--,PROPN,PROPN-PROPN-PROPN,pobj,compound-compound-pobj,NNP,NNP-NNPS-NNP,5,1
773,1150.0,43,selected,19,27,7,-20,26,35,-8,-12,USA,FIBA Americas Championship,,per-per-per,PROPN,PROPN-PROPN-PROPN,pobj,compound-compound-pobj,NNP,NNP-NNPS-NNP,12,1
774,760.0,16,assigned,2,6,15,9,5,0,-4,13,Air Training Command,Texas,org-org-org,,PROPN-PROPN-PROPN,PROPN,compound-compound-pobj,pobj,NNP-NNP-NNP,NNP,4,1
775,761.0,62,charged,14,6,47,41,5,14,8,33,EADS,European Aeronautic Defence,per,--,PROPN,PROPN-PROPN-PROPN,compound,compound-compound-compound,NNP,NNP-NNP-NNP,-1,1
776,762.0,105,is,7,86,91,5,85,13,-79,84,New York,James Earl Jones,-,org-org-org,PROPN-PROPN,PROPN-PROPN-PROPN,compound-compound,compound-compound-compound,NNP-NNP,NNP-NNP-NNP,6,1
777,763.0,34,is,1,23,27,4,22,6,-22,26,Cherie Currie,The Runaways,per-per,-,PROPN-PROPN,DET-PROPN,compound-appos,det-compound,NNP-NNP,DT-NNPS,3,1
778,764.0,32,was,25,1,24,23,0,7,24,-1,The Beatles,Brian Epstein,-,org-org,DET-PROPN,PROPN-PROPN,det-nsubj,compound-appos,DT-NNPS,NNP-NNP,-1,1
779,765.0,36,co-founded,2,1,8,7,0,27,1,6,TCHO,Timothy Childs,org,-,PROPN,PROPN-PROPN,nsubjpass,compound-pobj,NNP,NNP-NNP,2,1
780,766.0,19,is,4,1,2,1,0,16,3,-2,The New Zealand Herald,New Zealand,org-org-org-org,-,DET-PROPN-PROPN-PROPN,PROPN-PROPN,det-compound-compound-nsubj,compound-pobj,DT-NNP-NNP-NNP,NNP-NNP,1,1
781,767.0,18,represents,1,1,13,12,0,4,0,12,Helicon,Ivri Lider,,per-per,PROPN,PROPN-PROPN,nsubj,compound-compound,NNP,NNP-NNP,2,1
782,768.0,34,is,15,19,25,6,18,8,-4,10,France,Jean-Pierre Jeunet,per,-,PROPN,PROPN-PROPN,poss,compound-pobj,NNP,NNP-NNP,2,1
783,769.0,25,is,1,1,15,14,0,9,0,14,Armada,Costa Mesa,,per-per,PROPN,PROPN-PROPN,nsubj,compound-compound,NNP,NNP-NNP,5,1
784,770.0,24,Chief,2,7,12,5,6,11,-5,10,Nicolas Sarkozy,Minister,org-org,,PROPN-PROPN,PROPN,compound-pobj,pobj,NNP-NNP,NNP,6,1
785,771.0,15,finished,1,1,14,13,0,0,0,13,He,Athens,org,,PRON,PROPN,nsubj,pobj,PRP,NNP,1,1
786,772.0,13,is,1,1,12,11,0,0,0,11,Coakley,Massachusetts,,per,PROPN,PROPN,nsubj,pobj,NNP,NNP,1,1
787,773.0,21,is,11,4,17,13,3,3,7,6,Shanghai Jiao Tong University,in Sh,---,per-per,PROPN-PROPN-PROPN-PROPN,ADP-PROPN,compound-compound-compound-nsubj,prep-nmod,NNP-NNP-NNP-NNP,IN-NNP,6,1
788,774.0,15,offers,9,6,9,3,5,5,3,0,UVM,Medicine,org,,PROPN,PROPN,compound,pobj,NNP,NNP,1,1
789,775.0,40,All-new,0,3,5,2,2,34,-3,5,Dodge Challenger,SRT8,per-per,,PROPN-PROPN,PROPN,compound-compound,dobj,NNP-NNP,NNP,1,1
790,776.0,34,goes,1,1,4,3,0,29,0,3,BSC,Bridgewater,per,,PROPN,PROPN,nsubj,compound,NNP,NNP,2,1
791,777.0,25,assumed,10,7,8,1,6,16,3,-2,Navy,Richard W. Thompson,per,--,PROPN,PROPN-PROPN-PROPN,compound,compound-compound-pobj,NNP,NNP-NNP-NNP,2,1
792,778.0,29,is,7,2,19,17,1,9,5,12,Lincoln-Way East High School,Frankfort,org-org-org-org,,PROPN-PROPN-PROPN-PROPN,PROPN,compound-compound-compound-pobj,nsubj,NNP-NNP-NNP-NNP,NNP,6,1
793,779.0,26,joined,9,11,24,13,10,1,-2,15,Joseph Lyons,Australia,org-org,,PROPN-PROPN,PROPN,compound-dobj,compound,NNP-NNP,NNP,8,1
794,780.0,46,is,4,18,37,19,17,8,-14,33,Nevada,Henderson,org,,PROPN,PROPN,pobj,compound,NNP,NNP,6,1
795,781.0,29,released,17,3,8,5,2,20,14,-9,Matisyahu,JDub,org,,PROPN,PROPN,pobj,compound,NNP,NNP,3,1
796,782.0,33,smaller,4,19,31,12,18,1,-15,27,Helmut Schmidt University,Hamburg,--,per,PROPN-PROPN-PROPN,PROPN,compound-compound-pobj,pobj,NNP-NNP-NNP,NNP,5,1
797,783.0,43,said,37,34,37,3,33,5,3,0,Sogang University,Seoul,org-org,,PROPN-PROPN,PROPN,compound-pobj,pobj,NNP-NNP,NNP,2,1
798,784.0,20,born,2,5,10,5,4,9,-3,8,New York,Hunter College High School,per-per,---,PROPN-PROPN,PROPN-PROPN-PROPN-PROPN,compound-compound,nmod-nmod-compound-dobj,NNP-NNP,NNP-NNP-NNP-NNP,6,1
799,785.0,23,worked,4,1,21,20,0,1,3,17,Siqueiros,Mexico,org,,PROPN,PROPN,compound,compound,NNP,NNP,11,1
800,786.0,36,stars,1,5,8,3,4,27,-4,7,Joey Boy,Apisit Opsasaimlikit,per-per,-,PROPN-PROPN,PROPN-PROPN,compound-dobj,compound-appos,NNP-NNP,NNP-NNP,1,1
801,787.0,36,elected,5,1,16,15,0,19,4,11,Lucius Cornelius Sulla,Roman Republic,org-org-org,-,PROPN-PROPN-PROPN,PROPN-PROPN,compound-compound-nsubjpass,compound-pobj,NNP-NNP-NNP,NNP-NNP,9,1
802,788.0,37,considered,2,31,35,4,30,1,-29,33,Penn High School,Mishawaka,org-org-org,,PROPN-PROPN-PROPN,PROPN,compound-compound-dobj,compound,NNP-NNP-NNP,NNP,1,1
803,789.0,26,recorded,2,11,19,8,10,6,-9,17,Blue Note,Geri Allen,-,org-org,PROPN-PROPN,PROPN-PROPN,compound-pobj,compound-compound,NNP-NNP,NNP-NNP,3,1
804,790.0,140,Career,1,52,68,16,51,71,-51,67,George Mason University,Time All South Atlantic Honors,per-per-per,----,PROPN-PROPN-PROPN,PROPN-DET-PROPN-PROPN-PROPN,compound-compound-compound,appos-det-compound-compound-npadvmod,NNP-NNP-NNP,NNP-DT-NNP-NNP-NNPS,7,1
805,791.0,26,known,6,16,25,9,15,0,-10,19,Pierre Casiraghi,Monaco,per-per,,PROPN-PROPN,PROPN,compound-pobj,pobj,NNP-NNP,NNP,5,1
806,792.0,29,based,8,1,24,23,0,4,7,16,Surayud,Thailand,per,,PROPN,PROPN,poss,pobj,NNP,NNP,7,1
807,793.0,16,represents,7,2,2,0,1,13,5,-5,France national football team,France,org-org-org-org,,PROPN-ADJ-NOUN-NOUN,PROPN,nmod-amod-compound-nsubj,pobj,NNP-JJ-NN-NN,NNP,0,1
808,794.0,27,replied,25,22,24,2,21,2,3,-1,Stratfor,George Friedman,,per-per,PROPN,PROPN-PROPN,compound,compound-nsubj,NNP,NNP-NNP,1,1
809,795.0,23,met,8,1,5,4,0,17,7,-3,Equatorial Guinea,Teodoro Obiang Nguema Mbasogo,-,org-org-org-org,PROPN-PROPN,PROPN-PROPN-PROPN-PROPN,compound-poss,compound-compound-compound-nsubj,NNP-NNP,NNP-NNP-NNP-NNP,3,1
810,796.0,24,selected,6,5,22,17,4,1,1,16,Genzyme,United States,per,-,PROPN,PROPN-PROPN,nsubjpass,compound-pobj,NNP,NNP-NNP,6,1
811,797.0,21,is,11,11,18,7,10,2,0,7,STAR,Selangor,per,,PROPN,PROPN,pobj,pobj,NNP,NNP,4,1
812,798.0,36,received,5,2,5,3,1,30,3,0,Japan,Mana,org,,PROPN,PROPN,pobj,pobj,NNP,NNP,2,1
813,799.0,52,is,2,1,6,5,0,45,1,4,Cleveland Clinic,Ohio,org-org,,PROPN-PROPN,PROPN,compound-nsubj,pobj,NNP-NNP,NNP,3,1
814,800.0,10,plays,4,2,4,2,1,5,2,0,Dark Tranquillity,he,-,per,PROPN-PROPN,PRON,compound-pobj,nsubj,NNP-NNP,PRP,2,1
815,801.0,47,launched,27,25,30,5,24,16,2,3,Benedetto Della Vedova,Liberal Reformers,org-org-org,-,PROPN-PROPN-PROPN,PROPN-PROPN,compound-compound-pobj,compound-dobj,NNP-NNP-NNP,NNP-NNPS,5,1
816,802.0,31,wanted,2,1,6,5,0,24,1,4,He,minister,org,,PRON,NOUN,nsubj,attr,PRP,NN,4,1
817,803.0,6,dies,4,1,3,2,0,2,3,-1,Lazard,Bruce Wasserstein,,per-per,ADJ,PROPN-PROPN,compound,compound-nsubj,JJ,NNP-NNP,1,1
818,804.0,36,defeated,13,6,13,7,5,22,7,0,Houston,Cougars,org,,PROPN,PROPN,nsubj,nsubj,NNP,NNPS,5,1
819,805.0,44,named,12,5,15,10,4,28,7,3,Southern African Development Community,Botswana,---,per,PROPN-PROPN-PROPN-PROPN,PROPN,amod-compound-compound-pobj,compound,NNP-NNP-NNP-NNP,NNP,6,1
820,806.0,30,relocated,3,15,26,11,14,3,-12,23,McLennan,Brisbane,,org,PROPN,PROPN,conj,pobj,NNP,NNP,1,1
821,807.0,29,goes,2,11,14,3,10,14,-9,12,Mute Records,Daniel Miller,per-per,-,PROPN-PROPN,PROPN-PROPN,compound-poss,compound-pobj,NNP-NNPS,NNP-NNP,1,1
822,808.0,40,attended,15,26,32,6,25,7,-11,17,New Zealand,Helen Clark,per-per,-,PROPN-PROPN,PROPN-PROPN,compound-pobj,compound-pobj,NNP-NNP,NNP-NNP,5,1
823,809.0,24,acquainted,2,5,11,6,4,12,-3,9,Douglas McKay,Oregon,-,org,PROPN-PROPN,PROPN,compound-pobj,pobj,NNP-NNP,NNP,3,1
824,810.0,19,represents,8,3,3,0,2,15,5,-5,Cyprus national football team,Cyprus,org-org-org-org,,PROPN-ADJ-NOUN-NOUN,PROPN,nmod-amod-compound-nsubj,dative,NNP-JJ-NN-NN,NNP,0,1
825,811.0,14,grew,2,7,7,0,6,6,-5,5,Alvin,Alvin High School,org,--,PROPN,PROPN-PROPN-PROPN,compound,compound-compound-dobj,NNP,NNP-NNP-NNP,0,1
826,813.0,28,founded,7,1,11,10,0,16,6,4,Syrian Arab Airlines,1961,--,per,ADJ-PROPN-PROPN,NUM,amod-compound-nsubjpass,nummod,JJ-NNP-NNPS,CD,3,1
827,814.0,33,In,0,6,25,19,5,7,-6,25,EMI,his,per,,PROPN,DET,pobj,poss,NNP,PRP$,12,1
828,815.0,28,refused,4,10,18,8,9,9,-6,14,director,Polanski,org,,NOUN,PROPN,poss,nsubj,NN,NNP,7,1
829,816.0,29,featured,3,2,10,8,1,18,1,7,band,France,,org,NOUN,PROPN,nsubjpass,compound,NN,NNP,6,1
830,817.0,35,was,10,18,29,11,17,5,-8,19,U.S. Army,II Corps,-,per-per,PROPN-PROPN,PROPN-PROPN,compound-pobj,compound-dobj,NNP-NNP,NNP-NNP,8,1
831,818.0,41,was,17,23,26,3,22,14,-6,9,Ibrahim Rugova,Kosovo,org-org,,PROPN-PROPN,PROPN,compound-pobj,compound,NNP-NNP,NNP,3,1
832,819.0,31,operate,3,1,15,14,0,15,2,12,US Airways,Piedmont Airlines,-,per-per,PROPN-PROPN,PROPN-PROPN,compound-compound,compound-compound,NNP-NNP,NNP-NNPS,8,1
833,820.0,24,team,4,1,7,6,0,16,3,3,Queensland Cup,Souths Logan Magpies,-,per-per-per,PROPN-PROPN,PROPN-PROPN-PROPN,compound-compound,compound-compound-nsubj,NNP-NNP,NNP-NNP-NNPS,4,1
834,821.0,14,played,3,1,12,11,0,1,2,9,Paramount Pictures,network television,per-per,-,PROPN-PROPN,NOUN-NOUN,compound-nsubj,compound-pobj,NNP-NNP,NN-NN,5,1
835,822.0,17,resigns,7,3,6,3,2,10,4,-1,Japanese,Ryutaro Hashimoto,org,-,ADJ,PROPN-PROPN,amod,compound-nsubj,JJ,NNP-NNP,2,1
836,823.0,28,acquired,1,1,3,2,0,24,0,2,Swisscom,Fastweb,per,,PROPN,PROPN,nsubj,dobj,NNP,NNP,1,1
837,824.0,21,'m,1,7,11,4,6,9,-6,10,Ronald Reagan,Republican,org-org,,PROPN-PROPN,PROPN,compound-compound,compound,NNP-NNP,NNP,10,1
838,825.0,23,said,2,1,10,9,0,12,1,8,Dubai Properties,Group,org-org,,PROPN-PROPN,PROPN,compound-compound,compound,NNP-NNPS,NNP,4,1
839,826.0,47,was,9,3,27,24,2,19,6,18,his,Sudan,,org,DET,PROPN,poss,dobj,PRP$,NNP,6,1
840,827.0,35,resigned,30,28,20,-8,27,14,2,-10,Stasi,Erich Mielke,,per-per,PROPN,PROPN-PROPN,compound,compound-pobj,NNP,NNP-NNP,4,1
841,828.0,15,was,1,5,12,7,4,2,-4,11,of Serbian Superli,ad Belgra,--,org-org,ADP-PROPN-PROPN,NOUN-PROPN,prep-amod-compound,compound-compound,IN-NNP-NNP,NN-NNP,2,1
842,829.0,28,based,3,9,14,5,8,13,-6,11,record producer,Phil Spector,per-per,-,NOUN-NOUN,PROPN-PROPN,compound-compound,compound-appos,NN-NN,NNP-NNP,2,1
843,830.0,21,retained,4,1,4,3,0,16,3,0,Edwin Valero,Venezuela,org-org,,PROPN-PROPN,PROPN,compound-nsubj,pobj,NNP-NNP,NNP,1,1
844,831.0,25,shows,20,5,13,8,4,11,15,-7,Roger Meddows-Taylor,Queen,per-per,,PROPN-PROPN,PROPN,compound-poss,pobj,NNP-NNP,NNP,5,1
845,832.0,54,are,6,6,8,2,5,45,0,2,Turin,Lancia,org,,PROPN,PROPN,pobj,compound,NNP,NNP,9,1
846,833.0,34,came,11,21,30,9,20,3,-10,19,Butch Trucks,The Allman Brothers Band,org-org,---,PROPN-PROPN,DET-PROPN-PROPN-PROPN,compound-nsubj,det-compound-compound-pobj,NNP-NNPS,DT-NNP-NNPS-NNP,6,1
847,834.0,24,was,1,7,19,12,6,4,-6,18,Epic,she,,per,PROPN,PRON,compound,nsubj,NNP,PRP,5,1
848,835.0,14,obtained,1,7,10,3,6,3,-6,9,University of,Belgium,per-per,,PROPN-ADP,PROPN,pobj-prep,pobj,NNP-IN,NNP,1,1
849,836.0,45,elevated,12,8,3,-5,7,41,4,-9,namesake,Reg Grundy,per,-,NOUN,PROPN-PROPN,pobj,compound-appos,NN,NNP-NNP,5,1
850,837.0,37,included,2,6,23,17,5,13,-4,21,Peter Caruana,Gibraltar,-,org,PROPN-PROPN,PROPN,compound-compound,compound,NNP-NNP,NNP,7,1
851,838.0,32,cancelled,7,11,11,0,10,20,-4,4,IRA Army Council,IRA,--,org,PROPN-PROPN-PROPN,PROPN,compound-compound-compound,pobj,NNP-NNP-NNP,NNP,0,1
852,839.0,33,was,11,2,24,22,1,8,9,13,Michel-Gaspard Coppenrath,French Polynesia,-,per-per,PROPN-PROPN,PROPN-PROPN,compound-nsubj,amod-pobj,NNP-NNP,NNP-NNP,9,1
853,841.0,17,resigned,5,9,15,6,8,1,-4,10,party,Labour Party,,per-per,NOUN,PROPN-PROPN,pobj,compound-dobj,NN,NNP-NNP,3,1
854,842.0,18,began,6,10,16,6,9,1,-4,10,PAL Express,Philippine Airlines,per-per,-,PROPN-PROPN,PROPN-PROPN,compound-compound,compound-pobj,NNP-NNP,NNP-NNPS,5,1
855,843.0,25,is,9,6,8,2,5,16,3,-1,Elitserien,1975,,org,PROPN,NUM,pobj,pobj,NNP,CD,1,1
856,844.0,26,signed,18,13,15,2,12,10,5,-3,e-loan,Chris Larsen,per,-,NOUN,PROPN-PROPN,poss,compound-compound,NN,NNP-NNP,2,1
857,845.0,36,was,2,13,27,14,12,8,-11,25,James K. Polk,Tennessee,org-org-org,,PROPN-PROPN-PROPN,PROPN,compound-compound-appos,pobj,NNP-NNP-NNP,NNP,3,1
858,846.0,26,stabilized,9,2,5,3,1,20,7,-4,Thailand,Sarit Dhanarajata,org,-,PROPN,PROPN-PROPN,compound,compound-pobj,NNP,NNP-NNP,2,1
859,847.0,36,describe,3,9,22,13,8,13,-6,19,Pete Domenici,Albuquerque,-,org,PROPN-PROPN,PROPN,compound-compound,pobj,NNP-NNP,NNP,9,1
860,848.0,42,served,11,25,40,15,24,1,-14,29,LRA,Vincent Otti,org,-,PROPN,PROPN-PROPN,pobj,compound-conj,NNP,NNP-NNP,14,1
861,849.0,16,condmened,8,5,7,2,4,8,3,-1,Iraqi Kurdistan,Massoud Barzani,org-org,-,ADJ-PROPN,PROPN-PROPN,compound-compound,compound-pobj,JJ-NNP,NNP-NNP,1,1
862,850.0,20,Established,0,3,4,1,2,15,-3,4,1948,China Resources,per,-,NUM,PROPN-PROPN,pobj,compound-nsubj,CD,NNP-NNPS,1,1
863,851.0,44,said,4,8,24,16,7,19,-4,20,Chen Shui-bian,Taipei,-,per,PROPN-ADJ,PROPN,compound-nsubj,compound,NNP-JJ,NNP,5,1
864,852.0,18,was,1,9,9,0,8,8,-8,8,Lexington High School,Lexington,per-per-per,,PROPN-PROPN-PROPN,PROPN,compound-compound-pobj,compound,NNP-NNP-NNP,NNP,0,1
865,853.0,27,was,1,9,26,17,8,0,-8,25,James II of Scotland,England,org-org-org-org,,PROPN-PROPN-ADP-PROPN,PROPN,compound-pobj-prep-pobj,pobj,NNP-NNP-IN-NNP,NNP,4,1
866,854.0,22,is,2,1,15,14,0,6,1,13,Kim Jong-il,Workers ' Party,-,per-per-per,PROPN-PROPN,PROPN-PART-PROPN,compound-poss,poss-case-poss,NNP-NNP,NNPS-POS-NNP,5,1
867,855.0,54,was,2,42,52,10,41,1,-40,50,Four Brothers,Herbie Steward,-,org-org,PROPN-PROPN,PROPN-PROPN,compound-compound,compound-conj,NNP-NNPS,NNP-NNP,-1,1
868,856.0,13,commanded,8,8,11,3,7,1,0,3,Tamon,2nd Division,per,-,PROPN,PROPN-PROPN,nsubj,compound-dobj,NNP,NNP-NNP,1,1
869,857.0,26,known,3,12,10,-2,11,15,-9,7,Harold Wilson,Labour,org-org,,PROPN-PROPN,PROPN,compound-pobj,nsubj,NNP-NNP,NNP,1,1
870,858.0,17,accounted,2,13,15,2,12,1,-11,13,Hitwise,New York,per,-,PROPN,PROPN-PROPN,pobj,compound-pobj,NNP,NNP-NNP,1,1
871,859.0,45,argue,2,22,23,1,21,21,-20,21,President,Ludwig Scotty,per,-,PROPN,PROPN-PROPN,compound,compound-pobj,NNP,NNP-NNP,1,1
872,860.0,25,had,2,1,10,9,0,14,1,8,Carey Peck,California,-,per,PROPN-PROPN,PROPN,compound-nsubj,pobj,NNP-NNP,NNP,4,1
873,861.0,31,compromised,2,14,27,13,13,3,-12,25,Kenosha,University of Wisconsin-Parkside,,org-org-org,PROPN,PROPN-ADP-PROPN,conj,attr-prep-pobj,NNP,NNP-IN-NNP,9,1
874,862.0,12,is,5,1,5,4,0,6,4,0,Xstrata,Switzerland,per,,PROPN,PROPN,nsubj,pobj,NNP,NNP,2,1
875,863.0,30,gone,6,25,28,3,24,1,-19,22,Orson Welles,Rita Hayworth,org-org,-,PROPN-PROPN,PROPN-PROPN,compound-pobj,compound-conj,NNP-NNP,NNP-NNP,1,1
876,864.0,24,held,3,6,8,2,5,15,-3,5,Churchill,London,,per,PROPN,PROPN,poss,compound,NNP,NNP,3,1
877,865.0,31,grew,1,12,26,14,11,4,-11,25,Jimmy Smith,Verve,per-per,,PROPN-PROPN,PROPN,compound-compound,nmod,NNP-NNP,NNP,6,1
878,866.0,41,was,1,12,30,18,11,10,-11,29,Frederick Prince of Wales,Princess Augusta of Saxe-Gotha,---,org-org-org-org,PROPN-PROPN-ADP-PROPN,PROPN-PROPN-ADP-PROPN,compound-nsubj-prep-pobj,compound-pobj-prep-pobj,NNP-NNP-IN-NNP,NNP-NNP-IN-NNP,2,1
879,867.0,36,was,4,8,12,4,7,23,-4,8,Aventura,Anthony Santos,org,-,PROPN,PROPN-PROPN,amod,compound-pobj,NNP,NNP-NNP,3,1
880,868.0,48,*,0,42,46,4,41,1,-42,46,Southern Cross University,Australia,--,per,PROPN-PROPN-PROPN,PROPN,compound-compound-pobj,appos,NNP-NNP-NNP,NNP,2,1
881,869.0,29,organizes,1,8,8,0,7,20,-7,7,Kosovo,Kosovo national football team,per,---,PROPN,PROPN-ADJ-NOUN-NOUN,pobj,nmod-amod-compound-dobj,NNP,NNP-JJ-NN-NN,0,1
882,870.0,19,is,3,1,14,13,0,4,2,11,Boyd Conservation Area,Toronto and Region Conservation Authority,per-per-per,----,PROPN-PROPN-PROPN,PROPN-CCONJ-PROPN-PROPN-PROPN,compound-compound-nsubj,nmod-cc-conj-compound-pobj,NNP-NNP-NNP,NNP-CC-NNP-NNP-NNP,7,1
883,871.0,35,merged,6,26,31,5,25,3,-20,25,People's Justice Party,Wan Azizah,--,per-per,PROPN-PROPN-PROPN,PROPN-PROPN,compound-compound-conj,compound-pobj,NNP-NNP-NNP,NNP-NNP,3,1
884,872.0,34,is,8,7,6,-1,6,27,1,-2,MA,Boston University,,per-per,PROPN,PROPN-PROPN,npadvmod,compound-poss,NNP,NNP-NNP,2,1
885,873.0,15,educated,7,4,10,6,3,4,3,3,North Carolina,Lenoir-Rhyne University,org-org,-,PROPN-PROPN,PROPN-PROPN,compound-pobj,amod-nmod,NNP-NNP,NNP-NNP,7,1
886,874.0,41,assumed,5,12,2,-10,11,38,-7,-3,ESPN Radio,January 1 1992,-,org-org-org,PROPN-PROPN,PROPN-NUM-NUM,compound-poss,pobj-nummod-nummod,NNP-NNP,NNP-CD-CD,11,1
887,875.0,39,going,2,1,19,18,0,19,1,17,I,American,,org,PRON,ADJ,nsubj,amod,PRP,JJ,6,1
888,876.0,20,Drawn,0,6,15,9,5,4,-6,15,Paul,Sorbonne,,per,PROPN,PROPN,appos,pobj,NNP,NNP,5,1
889,877.0,32,is,10,1,21,20,0,10,9,11,Li Keqiang,People's Republic,-,org-org,PROPN-PROPN,PROPN-PROPN,compound-nsubj,compound-pobj,NNP-NNP,NNP-NNP,7,1
890,878.0,45,working,25,17,17,0,16,27,8,-8,Shanghai Airlines,Shanghai,-,org,PROPN-PROPN,PROPN,compound-pobj,compound,NNP-NNPS,NNP,0,1
891,879.0,30,wrote,3,7,24,17,6,5,-4,21,Los Angeles,Steve Williams,org-org,-,PROPN-PROPN,PROPN-PROPN,compound-compound,compound-conj,NNP-NNP,NNP-NNP,8,1
892,880.0,19,is,3,1,15,14,0,3,2,12,Bad Boy,Sean Combs,per-per,-,ADJ-PROPN,PROPN-PROPN,compound-compound,compound-pobj,JJ-NNP,NNP-NNPS,6,1
893,881.0,19,advanced,1,1,14,13,0,4,0,13,Swallows,Central League,per,-,NOUN,PROPN-PROPN,nsubj,compound-compound,NNS,NNP-NNP,3,1
894,882.0,27,headed,6,9,15,6,8,11,-3,9,Armando Guebuza,Mozambique,per-per,,PROPN-PROPN,PROPN,compound-pobj,pobj,NNP-NNP,NNP,2,1
895,883.0,35,was,11,8,15,7,7,19,3,4,Lucien Bouchard,Canada,org-org,,PROPN-PROPN,PROPN,compound-pobj,nsubj,NNP-NNP,NNP,5,1
896,885.0,22,was,3,12,13,1,11,8,-9,10,Ronda,Cayetano,,per,PROPN,PROPN,compound,pobj,NNP,NNP,7,1
897,886.0,27,appointed,7,24,26,2,23,0,-17,19,Leoni,Venezuela,,org,PROPN,PROPN,pobj,pobj,NNP,NNP,4,1
898,887.0,50,are,2,7,18,11,6,31,-5,16,Chicago,Tribune Company,per,-,PROPN,PROPN-PROPN,compound,compound-pobj,NNP,NNP-NNP,5,1
899,888.0,28,said,7,1,6,5,0,21,6,-1,Robert Polet,Gucci,per-per,,PROPN-PROPN,PROPN,compound-compound,compound,NNP-NNP,NNP,3,1
900,889.0,18,is,6,13,16,3,12,1,-7,10,KAIST,South Korea,,per-per,PROPN,PROPN-PROPN,pobj,compound-pobj,NNP,NNP-NNP,1,1
901,890.0,16,is,1,7,15,8,6,0,-6,14,Kevin Haskins,Bauhaus,-,per,PROPN-PROPN,PROPN,compound-pobj,pobj,NNP-NNP,NNP,4,1
902,891.0,29,added,3,23,11,-12,22,17,-20,8,TD Ameritrade,Omaha,per-per,,PROPN-PROPN,PROPN,compound-compound,pobj,NNP-NNP,NNP,7,1
903,892.0,11,was,1,3,9,6,2,1,-2,8,Walsh,ABC,,org,PROPN,PROPN,poss,compound,NNP,NNP,4,1
904,893.0,33,al-Beshir's,2,14,22,8,13,10,-12,20,Sudan,Sadiq al-Mahdi,,org-org,PROPN,PROPN-PROPN,compound,compound-conj,NNP,NNP-NNP,7,1
905,894.0,22,ring,8,3,15,12,2,6,5,7,Mumbai,Bombay Stock Exchange,org,--,PROPN,PROPN-PROPN-PROPN,compound,compound-compound-pobj,NNP,NNP-NNP-NNP,6,1
906,895.0,15,declared,8,2,7,5,1,7,6,-1,Seattle,Washington Mutual,per,-,PROPN,PROPN-PROPN,npadvmod,compound-appos,NNP,NNP-NNP,3,1
907,896.0,28,named,4,8,12,4,7,15,-4,8,Wales,Six Nations Championship,org,--,PROPN,NUM-PROPN-PROPN,compound,nummod-compound-pobj,NNP,CD-NNPS-NNP,3,1
908,897.0,30,is,9,15,29,14,14,0,-6,20,Vincent van Gogh,France,per-per-per,,PROPN-PROPN-PROPN,PROPN,compound-compound-pobj,pobj,NNP-NNP-NNP,NNP,8,1
909,898.0,27,convicted,2,15,19,4,14,7,-13,17,Shapour Bakhtiar,France,-,per,PROPN-PROPN,PROPN,compound-appos,pobj,NNP-NNP,NNP,8,1
910,899.0,16,changed,5,12,14,2,11,1,-7,9,Crookston,UMC,,org,PROPN,PROPN,pobj,appos,NNP,NNP,5,1
911,900.0,32,After,0,7,23,16,6,8,-7,23,Canada,Laval University,,org-org,PROPN,PROPN-PROPN,pobj,compound-pobj,NNP,NNP-NNP,6,1
912,901.0,10,bids,3,1,6,5,0,3,2,3,NYSE Euronext,Borsa Italiana,-,org-org,PROPN-PROPN,PROPN-PROPN,nmod-nmod,compound-pobj,NNP-NNP,NNP-NNP,3,1
913,902.0,27,grew,4,11,19,8,10,7,-7,15,Jefferson College,1802,per-per,,PROPN-PROPN,NUM,compound-pobj,pobj,NNP-NNP,CD,5,1
914,903.0,37,delivered,6,9,19,10,8,17,-3,13,Jeremiah S. Black,Secretary,per-per-per,,PROPN-PROPN-PROPN,PROPN,compound-compound-pobj,conj,NNP-NNP-NNP,NNP,4,1
915,904.0,28,graduated,1,8,16,8,7,11,-7,15,Felix Mendelssohn College of Music and Theatre,Leipzig,------,org,PROPN-PROPN-PROPN-ADP-PROPN-CCONJ-PROPN,PROPN,compound-compound-attr-prep-pobj-cc-conj,compound,NNP-NNP-NNP-IN-NNP-CC-NNP,NNP,4,1
916,905.0,16,is,4,1,12,11,0,3,3,8,Vikram University,Ujjain,-,org,PROPN-PROPN,PROPN,compound-nsubj,compound,NNP-NNP,NNP,7,1
917,906.0,20,recruit,4,2,9,7,1,10,2,5,Armed Forces,United Kingdom,org-org,-,PROPN-PROPN,PROPN-PROPN,compound-nsubj,compound-pobj,NNP-NNPS,NNP-NNP,4,1
918,907.0,21,operated,2,13,19,6,12,1,-11,17,British Columbia,BC Rail,org-org,-,PROPN-PROPN,PROPN-PROPN,compound-compound,compound-appos,NNP-NNP,NNP-NNP,2,1
919,908.0,29,retained,2,1,26,25,0,2,1,24,Norsk Transport,National Rail Administration,per-per,--,PROPN-PROPN,PROPN-PROPN-PROPN,compound-nsubj,compound-compound-pobj,NNP-NNP,NNP-NNP-NNP,9,1
920,909.0,27,resigned,11,20,22,2,19,4,-9,11,Georgian,Zhiuli Shartava,org,-,PROPN,PROPN-PROPN,compound,compound-nsubj,NNP,NNP-NNP,2,1
921,910.0,19,said,9,5,8,3,4,10,4,-1,Volvo Cars,Stephen,org-org,,PROPN-PROPN,PROPN,compound-compound,compound,NNP-NNP,NNP,2,1
922,911.0,32,formed,5,24,25,1,23,6,-19,20,Interior,Ethan A. Hitchcock,org,--,PROPN,PROPN-NOUN-PROPN,pobj,compound-compound-nsubj,NNP,NNP-NN-NNP,2,1
923,912.0,18,carried,1,1,17,16,0,0,0,16,SRC,Saskatchewan,,org,PROPN,PROPN,nsubj,pobj,NNP,NNP,7,1
924,913.0,55,committed,13,1,7,6,0,47,12,-6,Sir Reg Empey,Ulster Unionist Party,--,org-org-org,PROPN-PROPN-PROPN,PROPN-PROPN-PROPN,compound-compound-compound,compound-compound-pobj,NNP-NNP-NNP,NNP-NNP-NNP,4,1
925,914.0,33,be,7,24,27,3,23,5,-17,20,Caritor Inc.,San Ramon,-,per-per,PROPN-PROPN,PROPN-PROPN,compound-nsubj,compound-compound,NNP-NNP,NNP-NNP,3,1
926,915.0,45,held,31,8,22,14,7,22,23,-9,Oklahoma,Lance Cargill,org,-,PROPN,PROPN-PROPN,pobj,compound-appos,NNP,NNP-NNP,5,1
927,916.0,23,has,3,1,15,14,0,7,2,12,NBC Universal,CNBC,-,per,PROPN-PROPN,PROPN,compound-nsubj,compound,NNP-NNP,NNP,4,1
928,917.0,60,include,1,15,24,9,14,35,-14,23,Forza Italia,Marcello Pera,org-org,-,PROPN-PROPN,PROPN-PROPN,advmod-poss,nmod-nmod,NNP-NNP,NNP-NNP,2,1
929,918.0,10,Located,5,2,9,7,1,0,3,4,Confederation College,Ontario,-,org,PROPN-PROPN,PROPN,compound-compound,pobj,NNP-NNP,NNP,3,1
930,919.0,24,is,1,12,22,10,11,1,-11,21,Union Pacific Railroad,Omaha Nebraska,org-org-org,-,PROPN-PROPN-PROPN,PROPN-PROPN,compound-compound-compound,compound-pobj,NNP-NNP-NNP,NNP-NNP,6,1
931,920.0,37,returned,16,15,20,5,14,16,1,4,Allison Crowe,Canada,-,per,PROPN-PROPN,PROPN,compound-conj,pobj,NNP-NNP,NNP,7,1
932,921.0,22,procuced,2,18,20,2,17,1,-16,18,Alliance,Bounty Killer,org,-,PROPN,PROPN-PROPN,compound,compound-pobj,NNP,NNP-NNP,1,1
933,922.0,50,Born,0,11,20,9,10,29,-11,20,Santo,Rodolfo Guzman Huerta,,per-per-per,PROPN,PROPN-PROPN-PROPN,nsubj,compound-compound-pobj,NNP,NNP-NNP-NNP,-1,1
934,923.0,63,drop,11,2,8,6,1,54,9,-3,82nd Airborne Division,James M. Gavin,org-org-org,--,ADJ-PROPN-PROPN,PROPN-PROPN-PROPN,compound-compound-nsubj,compound-compound-pobj,JJ-NNP-NNP,NNP-NNP-NNP,4,1
935,924.0,32,begun,3,17,28,11,16,3,-14,25,Barbados,Caribbean Broadcasting Corporation,org,--,PROPN,PROPN-PROPN-PROPN,compound,compound-compound-pobj,NNP,NNP-NNP-NNP,5,1
936,925.0,23,apprenticed,2,1,10,9,0,12,1,8,David Bailly,Leiden,per-per,,PROPN-PROPN,PROPN,compound-nsubj,pobj,NNP-NNP,NNP,4,1
937,926.0,26,was,2,7,16,9,6,9,-5,14,Carlos Manuel de y Quesada,Cuba,----,per,PROPN-PROPN-PROPN-PROPN-PROPN,PROPN,compound-compound-nmod-compound-pobj,pobj,NNP-NNP-NNP-NNP-NNP,NNP,5,1
938,927.0,33,In,0,19,23,4,18,9,-19,23,Roman Polanski,Emmanuelle Seigner,per-per,-,PROPN-PROPN,PROPN-PROPN,compound-poss,compound-appos,NNP-NNP,NNP-NNP,3,1
939,928.0,25,appointed,8,3,16,13,2,8,5,8,Barton,High Court,org,-,PROPN,PROPN-PROPN,conj,compound-pobj,NNP,NNP-NNP,6,1
940,929.0,27,is,2,2,10,8,1,16,0,8,club,Maldives,,org,NOUN,PROPN,nsubj,pobj,NN,NNP,2,1
941,930.0,21,says,1,1,20,19,0,0,0,19,He,Haiti,per,,PRON,PROPN,nsubj,pobj,PRP,NNP,1,1
942,931.0,24,was,2,5,9,4,4,14,-3,7,Sierra Leone,Siaka Stevens,per-per,-,PROPN-PROPN,PROPN-PROPN,compound-poss,compound-appos,NNP-NNP,NNP-NNP,2,1
943,933.0,25,said,8,1,11,10,0,13,7,3,Television New Zealand,Henry,per-per-per,,PROPN-PROPN-PROPN,PROPN,compound-compound-compound,poss,NNP-NNP-NNP,NNP,8,1
944,934.0,33,brought,4,20,24,4,19,8,-16,20,rom Studio Ghi,44; Hayao Miyaz,org-org-org,--,NOUN-PROPN-PROPN,NUM-PROPN-PROPN,appos-nmod-ROOT,nummod-compound-nsubj,NN-NNP-NNP,CD-NNP-NNP,4,1
945,935.0,18,are,13,12,17,5,11,0,1,4,Ike Quartey,Bukom,per-per,,PROPN-PROPN,PROPN,compound-conj,pobj,NNP-NNPS,NNP,5,1
946,936.0,56,was,7,5,13,8,4,42,2,6,Tun,Malaysia,,per,PROPN,PROPN,npadvmod,poss,NNP,NNP,9,1
947,937.0,25,is,13,1,11,10,0,13,12,-2,Democrats 66,Democraten 66,org-org,-,PROPN-NUM,PROPN-NUM,nsubj-nummod,appos-nummod,NNPS-CD,NNP-CD,4,1
948,938.0,42,In,0,13,16,3,12,25,-13,16,Petro Symonenko,Communist Party of Ukraine,org-org,---,PROPN-PROPN,PROPN-PROPN-ADP-PROPN,compound-nsubj,compound-appos-prep-pobj,NNP-NNP,NNP-NNP-IN-NNP,1,1
949,939.0,12,calls,2,1,8,7,0,3,1,6,Greenpeace,1971,org,,VERB,NUM,nsubj,pobj,VB,CD,3,1
950,940.0,36,is,2,16,30,14,15,5,-14,28,Kelis,United States,per,-,PROPN,PROPN-PROPN,pobj,compound-pobj,NNP,NNP-NNP,2,1
951,942.0,72,covered,9,52,66,14,51,5,-43,57,Ahmed Chalabi,Iraq,per-per,,PROPN-PROPN,PROPN,compound-conj,pobj,NNP-NNP,NNP,6,1
952,943.0,17,founded,1,1,14,13,0,2,0,13,He,Windham Hill,,org-org,PRON,PROPN-PROPN,nsubj,compound-compound,PRP,NNP-NNP,3,1
953,945.0,14,worked,1,11,12,1,10,1,-10,11,Secretary,Tommy Thompson,per,-,PROPN,PROPN-PROPN,compound,compound-pobj,NNP,NNP-NNP,1,1
954,946.0,30,lost,13,8,23,15,7,6,5,10,leader,Hun Sen,org,-,NOUN,PROPN-PROPN,attr,compound-nsubj,NN,NNP-NNP,5,1
955,947.0,43,completed,1,6,31,25,5,11,-5,30,SC Vaslui,FC Vaslui,per-per,-,PROPN-PROPN,PROPN-PROPN,compound-pobj,compound-pobj,NNP-NNP,NNP-NNP,8,1
956,948.0,24,is,2,11,23,12,10,0,-9,21,Brazilian Army,Brazil,per-per,,PROPN-PROPN,PROPN,amod-pobj,pobj,NNP-NNP,NNP,4,1
957,949.0,63,released,43,9,13,4,8,49,34,-30,Italy,Rota,org,,PROPN,PROPN,pobj,pobj,NNP,NNP,4,1
958,950.0,51,was,1,38,41,3,37,9,-37,40,Maxi,Quebec,,per,PROPN,PROPN,compound,pobj,NNP,NNP,2,1
959,1308.0,47,expanded,6,16,19,3,15,27,-10,13,Maxi,Quebec,org,,PROPN,PROPN,compound,pobj,NNP,NNP,1,1
960,951.0,18,avoided,1,1,17,16,0,0,0,16,Kalsoom,Pakistan,,per,PROPN,PROPN,nsubj,pobj,NNP,NNP,1,1
961,952.0,32,',0,4,26,22,3,5,-4,26,Bruce Springsteen,Columbia,-,org,PROPN-PROPN,PROPN,compound-poss,compound,NNP-NNP,NNP,6,1
962,953.0,38,laid,3,2,17,15,1,20,1,14,Central Pacific,1863,org-org,,PROPN-PROPN,NUM,compound-nsubj,pobj,NNP-NNP,CD,5,1
963,954.0,28,was,8,23,27,4,22,0,-15,19,Sarah Lawrence College,1926,--,per,PROPN-PROPN-PROPN,NUM,compound-compound-dobj,pobj,NNP-NNP-NNP,CD,1,1
964,955.0,18,is,9,1,14,13,0,3,8,5,Roy Chiu,singer,org-org,,PROPN-PROPN,NOUN,compound-compound,nmod,NNP-NNP,NN,4,1
965,956.0,70,has,4,2,67,65,1,2,2,63,University of Zulia,May 29 1891,per-per-per,--,PROPN-ADP-PROPN,PROPN-NUM-NUM,nsubj-prep-pobj,pobj-nummod-nummod,NNP-IN-NNP,NNP-CD-CD,-1,1
966,957.0,31,had,4,19,22,3,18,8,-15,18,Soft Cell,Marc Almond,per-per,-,PROPN-PROPN,PROPN-PROPN,compound-compound,nmod-compound,NNP-NNP,NNP-NNP,2,1
967,958.0,32,helped,2,4,30,26,3,1,-2,28,Psychopathic,Joseph Bruce,org,-,PROPN,PROPN-PROPN,compound,compound-pobj,NNP,NNP-NNP,9,1
968,959.0,33,was,9,2,22,20,1,10,7,13,Technical University of British Columbia,1999,org-org-org-org-org,,PROPN-PROPN-ADP-PROPN-PROPN,NUM,compound-nsubj-prep-compound-pobj,pobj,NNP-NNP-IN-NNP-NNP,CD,4,1
969,960.0,12,associated,3,7,10,3,6,1,-4,7,Karan Johar,Dharma Productions,per-per,-,PROPN-PROPN,PROPN-PROPN,compound-poss,compound-pobj,NNP-NNP,NNP-NNP,1,1
970,961.0,35,featured,12,1,15,14,0,19,11,3,The Jam,Bruce Foxton,org-org,-,DET-PROPN,PROPN-PROPN,det-compound,compound-dobj,DT-NNP,NNP-NNP,3,1
971,962.0,39,were,4,23,33,10,22,5,-19,29,Cassie,United States,,per-per,PROPN,PROPN-PROPN,poss,nmod-nmod,NNP,NNP-NNP,5,1
972,963.0,31,were,2,2,26,24,1,4,0,24,they,Motown Records,,per-per,PRON,PROPN-PROPN,nsubj,compound-compound,PRP,NNP-NNPS,7,1
973,964.0,30,is,5,2,3,1,1,26,3,-2,actress,Kristin Scott Thomas,org,--,NOUN,PROPN-PROPN-PROPN,compound,compound-compound-nsubj,NN,NNP-NNP-NNP,1,1
974,965.0,46,transferred,13,17,21,4,16,24,-4,8,Air Mobility Command,Scott Air Force Base,--,org-org-org-org,PROPN-PROPN-PROPN,PROPN-PROPN-PROPN-PROPN,compound-compound-pobj,compound-compound-compound-pobj,NNP-NNP-NNP,NNP-NNP-NNP-NNP,5,1
975,966.0,23,distributed,2,19,21,2,18,1,-17,19,Editor,HM,,per,PROPN,PROPN,pobj,compound,NNP,NNP,1,1
976,967.0,33,created,3,1,9,8,0,23,2,6,NU,University of Sierra Leone,per,---,PROPN,PROPN-ADP-PROPN-PROPN,nsubjpass,pobj-prep-compound-pobj,NNP,NNP-IN-NNP-NNP,6,1
977,969.0,30,spent,5,1,17,16,0,12,4,12,Widmark,Connecticut,,per,PROPN,PROPN,nsubj,pobj,NNP,NNP,7,1
978,970.0,29,born,4,2,11,9,1,17,2,7,Guido Vildoso,Bolivia,org-org,,PROPN-PROPN,PROPN,compound-nsubj,nsubj,NNP-NNP,NNP,1,1
979,971.0,37,was,1,8,12,4,7,24,-7,11,Daimler-Benz,Mercedes-Benz,,org,PROPN,PROPN,amod,appos,NNP,NNP,3,1
980,972.0,23,was,14,1,22,21,0,0,13,8,Victor Kennedy,Hamilton,-,org,PROPN-PROPN,PROPN,compound-nsubj,pobj,NNP-NNP,NNP,3,1
981,973.0,20,make,13,1,19,18,0,0,12,6,Meacham,Oklahoma,org,,VERB,PROPN,nsubj,pobj,VB,NNP,5,1
982,974.0,32,Gettin,0,11,23,12,10,8,-11,23,Benny Golson,New Jazz,per-per,-,PROPN-PROPN,PROPN-PROPN,compound-pobj,compound-compound,NNP-NNP,NNP-NNP,9,1
983,975.0,35,reopened,6,5,30,25,4,4,1,24,Wellcome Trust,London,per-per,,PROPN-PROPN,PROPN,compound-compound,pobj,NNP-NNP,NNP,11,1
984,976.0,28,deliver,7,6,27,21,5,0,1,20,Morrissey,England,org,,PROPN,PROPN,pobj,pobj,NNP,NNP,7,1
985,977.0,34,taking,26,2,5,3,1,28,24,-21,Anote Tong,Kiribati,per-per,,PROPN-PROPN,PROPN,compound-nsubj,amod,NNP-NNP,NNP,4,1
986,978.0,45,befriended,7,9,12,3,8,32,-2,5,Rudolph Valentino,New York City,per-per,--,PROPN-PROPN,PROPN-PROPN-PROPN,compound-dobj,compound-compound-pobj,NNP-NNP,NNP-NNP-NNP,3,1
987,979.0,23,is,4,1,1,0,0,21,3,-3,Newton South High School,Newton,per-per-per-per,,PROPN-PROPN-PROPN-PROPN,PROPN,compound-compound-compound-nsubj,compound,NNP-NNP-NNP-NNP,NNP,0,1
988,980.0,25,honored,3,9,14,5,8,10,-6,11,Troy,Harry Tutunjian,org,-,PROPN,PROPN-PROPN,compound,compound-nsubj,NNP,NNP-NNP,7,1
989,981.0,18,released,9,1,15,14,0,2,8,6,James Brown,Federal,per-per,,PROPN-PROPN,PROPN,compound-poss,appos,NNP-NNP,NNP,3,1
990,982.0,21,dismissed,1,8,10,2,7,10,-7,9,Australia,Seven Network,per,-,PROPN,PROPN-PROPN,poss,nummod-dobj,NNP,NNP-NNP,2,1
991,983.0,19,is,1,8,10,2,7,8,-7,9,Dundee,The View,per,-,PROPN,DET-PROPN,compound,det-ROOT,NNP,DT-NNP,2,1
992,984.0,27,is,1,23,26,3,22,0,-22,25,Estonian Shipping Company,Tallinn,org-org-org,,PROPN-PROPN-PROPN,PROPN,compound-compound-compound,pobj,NNP-NNP-NNP,NNP,2,1
993,985.0,32,arrested,17,12,15,3,11,16,5,-2,Guatemala,Alfonso Portillo,,per-per,PROPN,PROPN-PROPN,pobj,compound-appos,NNP,NNP-NNP,2,1
994,986.0,29,is,1,1,9,8,0,19,0,8,Hinduja,India,per,,PROPN,PROPN,nsubj,pobj,NNP,NNP,2,1
995,987.0,31,was,10,13,9,-4,12,21,-3,-1,Sacramento,California National Guard,,org-org-org,PROPN,PROPN-PROPN-PROPN,pobj,compound-compound-pobj,NNP,NNP-NNP-NNP,7,1
996,988.0,26,Is,1,15,19,4,14,6,-14,18,Short Stack,Sunday Morning Records,-,per-per-per,PROPN-PROPN,PROPN-PROPN-PROPN,compound-pobj,compound-compound-pobj,NNP-NNP,NNP-NNP-NNPS,6,1
997,989.0,79,Kind,2,12,19,7,11,59,-10,17,US,Cher,org,,PROPN,PROPN,compound,compound,NNP,NNP,3,1
998,990.0,29,attended,2,4,22,18,3,6,-2,20,Syracuse,Maxwell School of Citizenship and Public Affairs,,per-per-per-per-per-per-per,PROPN,PROPN-PROPN-ADP-PROPN-CCONJ-PROPN-PROPN,compound,compound-pobj-prep-pobj-cc-compound-conj,NNP,NNP-NNP-IN-NNP-CC-NNP-NNPS,8,1
999,991.0,8,born,2,1,7,6,0,0,1,5,Yui,Japan,org,,PROPN,PROPN,nsubjpass,pobj,NNP,NNP,2,1
1000,992.0,16,Field,1,1,8,7,0,7,0,7,Sally Field,actress,-,org,PROPN-PROPN,NOUN,compound-ROOT,pobj,NNP-NNP,NN,5,1
1001,993.0,19,studied,2,5,8,3,4,10,-3,6,Jeffrey Sachs,Harvard University,-,org-org,PROPN-PROPN,PROPN-PROPN,compound-pobj,compound-pobj,NNP-NNP,NNP-NNP,4,1
1002,994.0,19,are,4,2,1,-1,1,17,2,-3,William Mary Tribe,The College of William Mary,--,per-per-per-per-per,PROPN-PROPN-PROPN,DET-PROPN-ADP-PROPN-PROPN,compound-compound-nsubj,det-dobj-prep-compound-pobj,NNP-NNP-NNP,DT-NNP-IN-NNP-NNP,2,1
1003,995.0,31,started,7,25,28,3,24,2,-18,21,Las Vegas,LVTS,org-org,,PROPN-PROPN,PROPN,compound-pobj,nsubj,NNP-NNP,NNP,4,1
1004,996.0,37,wrote,4,7,11,4,6,25,-3,7,Herb Kelleher,Southwest Airlines,per-per,-,PROPN-PROPN,PROPN-PROPN,compound-compound,compound-pobj,NNP-NNP,NNP-NNPS,3,1
1005,997.0,32,visiting,2,1,22,21,0,9,1,20,Michael Jackson,US,per-per,,PROPN-PROPN,PROPN,compound-nsubj,compound,NNP-NNP,NNP,3,1
1006,998.0,19,came,10,3,7,4,2,11,7,-3,Tun Perak,Sultanate,per-per,,PROPN-PROPN,PROPN,compound-nsubj,poss,NNP-NNP,NNP,3,1
1007,999.0,31,stopped,2,2,16,14,1,14,0,14,BOK,South Korea,org,-,PROPN,PROPN-PROPN,nsubj,compound-nsubj,NNP,NNP-NNP,5,1
1008,1000.0,16,is,2,11,14,3,10,1,-9,12,Jamia Millia Islamia,New Delhi,--,org-org,PROPN-PROPN-PROPN,PROPN-PROPN,compound-compound-compound,compound-pobj,NNP-NNP-NNP,NNP-NNP,-1,1
1009,1001.0,31,born,9,1,21,20,0,9,8,12,Zombo,producer,,org,PROPN,NOUN,nsubj,attr,NNP,NN,7,1
1010,1002.0,34,want,9,5,8,3,4,25,4,-1,New Jersey,Frank Lautenberg,per-per,-,PROPN-PROPN,PROPN-PROPN,compound-poss,compound-conj,NNP-NNP,NNP-NNP,3,1
1011,1003.0,20,released,12,9,15,6,8,4,3,3,Little Richard,Elektra,per-per,,PROPN-PROPN,PROPN,compound-pobj,compound,NNP-NNP,NNP,5,1
1012,1004.0,18,was,10,1,14,13,0,3,9,4,Madeline Kahn,actress,org-org,,PROPN-PROPN,NOUN,compound-nsubj,compound,NNP-NNP,NN,2,1
1013,1005.0,34,became,19,11,25,14,10,8,8,6,CBS Radio,Lucille Ball,org-org,-,PROPN-PROPN,PROPN-PROPN,compound-compound,compound-poss,NNP-NNP,NNP-NNP,14,1
1014,1006.0,22,represented,7,3,9,6,2,12,4,2,Fresno State Bulldogs,California State University,per-per-per,--,PROPN-PROPN-PROPN,PROPN-PROPN-PROPN,compound-compound-compound,compound-compound-compound,NNP-NNP-NNPS,NNP-NNP-NNP,6,1
1015,1007.0,15,reported,5,1,4,3,0,10,4,-1,Mexico City,El Universal,-,per-per,PROPN-PROPN,PROPN-PROPN,compound-compound,compound-nsubj,NNP-NNP,NNP-NNP,2,1
1016,1008.0,16,is,2,10,10,0,9,5,-8,8,Woolworths,Woolworths supermarkets,per,-,PROPN,PROPN-NOUN,compound,compound-pobj,NNP,NNP-NNS,0,1
1017,1009.0,30,said,16,3,6,3,2,23,13,-10,Department of Justice,Crime Victims,per-per-per,-,PROPN-ADP-PROPN,PROPN-PROPN,nmod-prep-pobj,compound-compound,NNP-IN-NNP,NNP-NNP,2,1
1018,1010.0,38,rejected,12,17,19,2,16,18,-5,7,Prime Minister,Jawaharlal Nehru,-,per-per,PROPN-PROPN,PROPN-PROPN,compound-compound,compound-pobj,NNP-NNP,NNP-NNP,1,1
1019,1011.0,41,play,5,35,35,0,34,5,-30,30,Fiji,Fiji Times,,org-org,PROPN,PROPN-PROPN,pobj,compound-nsubj,NNP,NNP-NNP,0,1
1020,1012.0,37,appointed,6,12,16,4,11,20,-6,10,Caribbean Broadcasting Corporation,Barbados,--,org,PROPN-PROPN-PROPN,PROPN,compound-compound-pobj,pobj,NNP-NNP-NNP,NNP,5,1
1021,1013.0,9,attended,1,1,7,6,0,1,0,6,Newman,Los Angeles,org,-,PROPN,PROPN-PROPN,nsubj,compound-appos,NNP,NNP-NNP,1,1
1022,1014.0,20,announced,4,4,16,12,3,3,0,12,NWA,airline,org,,PROPN,NOUN,nsubj,pobj,NNP,NN,2,1
1023,1015.0,53,are,20,4,6,2,3,46,16,-14,India,Gulzarilal Nanda,,per-per,PROPN,PROPN-PROPN,pobj,compound-pobj,NNP,NNP-NNP,1,1
1024,1016.0,53,McKee's,0,39,43,4,38,9,-39,43,Essendon,Scott Lucas,org,-,PROPN,PROPN-PROPN,poss,compound-dobj,NNP,NNP-NNP,4,1
1025,1017.0,29,attended,1,4,12,8,3,16,-3,11,Pontifical Catholic University of Puerto Rico,Ponce,org-org-org-org-org-org,,PROPN-PROPN-PROPN-ADP-PROPN-PROPN,PROPN,compound-compound-dobj-prep-compound-pobj,pobj,NNP-NNP-NNP-IN-NNP-NNP,NNP,6,1
1026,1018.0,44,Chairing,0,33,35,2,32,8,-33,35,CIA,Hyde Park,per,-,PROPN,PROPN-PROPN,poss,compound-compound,NNP,NNP-NNP,3,1
1027,1019.0,47,founded,3,32,44,12,31,2,-29,41,centre-left,Pier Luigi Bersani,,org-org-org,ADJ,PROPN-PROPN-PROPN,amod,compound-compound-pobj,JJ,NNP-NNP-NNP,5,1
1028,1020.0,15,turning,4,3,10,7,2,4,1,6,GM,Holden,,per,PROPN,PROPN,nsubj,appos,NNP,NNP,2,1
1029,1021.0,34,emigrated,1,6,19,13,5,14,-5,18,France,Jacques Hadamard,,per-per,PROPN,PROPN-PROPN,pobj,compound-pobj,NNP,NNP-NNP,7,1
1030,1022.0,30,wrote,7,5,6,1,4,23,2,-1,Australia,Robert French,org,-,PROPN,PROPN-PROPN,pobj,compound-nsubj,NNP,NNP-NNP,1,1
1031,1023.0,34,is,5,3,13,10,2,20,2,8,Burnie Burns,Rooster Teeth Productions,org-org,--,PROPN-PROPN,PROPN-PROPN-VERB,compound-pobj,compound-compound-pobj,NNP-NNP,NNP-NNP-VBZ,6,1
1032,1024.0,29,saw,6,8,26,18,7,2,-2,20,Fitzgerald,Reprise,,per,PROPN,PROPN,compound,compound,NNP,NNP,9,1
1033,1025.0,39,traveled,7,7,19,12,6,19,0,12,Boone,Florida,org,,PROPN,PROPN,nsubj,pobj,NNP,NNP,6,1
1034,1026.0,29,driven,12,4,7,3,3,21,8,-5,Grant Wood,American,-,per,PROPN-PROPN,ADJ,compound-npadvmod,amod,NNP-NNP,JJ,1,1
1035,1027.0,24,summoned,2,13,21,8,12,2,-11,19,Pierre Trudeau,Quebec,-,per,PROPN-PROPN,PROPN,compound-pobj,pobj,NNP-NNP,NNP,4,1
1036,1028.0,19,was,10,1,18,17,0,0,9,8,Jerry Edmonton,Steppenwolf,-,org,PROPN-PROPN,PROPN,compound-nsubj,pobj,NNP-NNP,NNP,2,1
1037,1029.0,23,serve,4,7,13,6,6,9,-3,9,U.S. Customs and Border Protection,CBP,per-per-per-per-per,,PROPN-PROPN-CCONJ-PROPN-PROPN,PROPN,nmod-nmod-cc-conj-nmod,nmod,NNP-NNP-CC-NNP-NNP,NNP,4,1
1038,1030.0,62,trace,1,38,59,21,37,2,-37,58,Exist Trace,Sequence Records,per-per,-,PROPN-PROPN,PROPN-PROPN,compound-nsubj,compound-compound,NNP-NNP,NNP-NNPS,9,1
1039,1031.0,30,encompass,3,2,16,14,1,13,1,13,Armed Forces,Royal Air Force,per-per,--,PROPN-PROPN,PROPN-PROPN-PROPN,compound-nsubj,compound-compound-conj,NNP-NNPS,NNP-NNP-NNP,5,1
1040,1032.0,30,S.A.L.T.S.,0,1,17,16,0,12,-1,17,S.A.L.T.S.,Victoria,per,,PROPN,PROPN,ROOT,compound,NNP,NNP,6,1
1041,1033.0,35,elected,2,16,30,14,15,4,-14,28,Canadian,Gilles Duceppe,per,-,ADJ,PROPN-PROPN,amod,compound-dobj,JJ,NNP-NNP,6,1
1042,1034.0,21,said,9,6,13,7,5,7,3,4,California,Eastwood,org,,PROPN,PROPN,compound,conj,NNP,NNP,6,1
1043,1035.0,26,announced,6,5,24,19,4,1,1,18,CBS,Television Distribution,,org-org,PROPN,PROPN-PROPN,compound,compound-dobj,NNP,NNP-NNP,5,1
1044,1036.0,43,said,5,2,4,2,1,38,3,-1,Prime Minister,Ahmed Nazif,org-org,-,PROPN-PROPN,PROPN-PROPN,compound-compound,compound-nsubj,NNP-NNP,NNP-NNP,1,1
1045,1037.0,23,maintained,6,4,10,6,3,12,2,4,Thomas-Institut,University of Cologne,org,--,PROPN,PROPN-ADP-PROPN,nsubjpass,pobj-prep-pobj,NNP,NNP-IN-NNP,5,1
1046,1038.0,34,is,22,7,25,18,6,8,15,3,NTUC,National Trades Union Congress,,per-per-per-per,PROPN,PROPN-PROPN-PROPN-PROPN,nsubj,compound-compound-compound-dative,NNP,NNP-NNPS-NNP-NNP,6,1
1047,1039.0,28,return,4,1,16,15,0,11,3,12,MAXjet,Dulles,,per,PROPN,PROPN,nsubj,pobj,NNP,NNP,10,1
1048,1040.0,15,He's,0,10,12,2,9,2,-10,12,UMass,Jack M. Wilson,org,--,PROPN,PROPN-PROPN-PROPN,compound,compound-compound-ccomp,NNP,NNP-NNP-NNP,3,1
1049,1041.0,13,founded,3,2,5,3,1,7,1,2,1972,The Related Companies,,per-per-per,NUM,DET-PROPN-PROPN,pobj,det-compound-dative,CD,DT-NNP-NNPS,3,1
1050,1042.0,10,is,2,1,2,1,0,7,1,0,Euronext Lisbon,Lisbon,-,org,PROPN-PROPN,PROPN,compound-nsubj,compound,NNP-NNP,NNP,1,1
1051,1043.0,12,is,2,1,11,10,0,0,1,9,Filey School,England,-,org,PROPN-PROPN,PROPN,compound-nsubj,pobj,NNP-NNP,NNP,2,1
1052,1044.0,26,provides,3,1,1,0,0,24,2,-2,BBC Worldwide,BBC World News,org-org,--,PROPN-PROPN,PROPN-PROPN-PROPN,compound-nsubj,compound-compound-conj,NNP-NNP,NNP-NNP-NNP,0,1
1053,1045.0,24,left,4,4,13,9,3,10,0,9,Poe,Richmond,org,,PROPN,PROPN,nsubj,compound,NNP,NNP,3,1
1054,1046.0,17,album,4,1,14,13,0,2,3,10,Thirsty Merc,Warner Music Australia,-,org-org-org,PROPN-PROPN,PROPN-PROPN-PROPN,compound-poss,compound-compound-pobj,NNP-NNP,NNP-NNP-NNP,6,1
1055,1047.0,24,represented,7,3,10,7,2,13,4,3,Air Force Falcons,United States Air Force Academy,org-org-org,----,PROPN-PROPN-PROPN,PROPN-PROPN-PROPN-PROPN-PROPN,compound-compound-compound,compound-compound-compound-compound-dobj,NNP-NNP-NNPS,NNP-NNP-NNP-NNP-NNP,5,1
1056,1048.0,19,is,2,10,15,5,9,3,-8,13,The O'Jays,Philadelphia International,org-org,-,DET-PROPN,PROPN-PROPN,det-nsubj,compound-compound,DT-NNP,NNP-NNP,5,1
1057,1049.0,37,speaks,4,17,18,1,16,18,-13,14,Elizabeth Edwards,Edwards,org-org,,PROPN-PROPN,PROPN,compound-appos,pobj,NNP-NNP,NNP,1,1
1058,1050.0,24,is,9,1,21,20,0,2,8,12,Woolwich Polytechnic,Greenwich,per-per,,PROPN-PROPN,PROPN,compound-compound,pobj,NNP-NNP,NNP,10,1
1059,1051.0,24,is,9,1,18,17,0,5,8,9,Pui Ching Middle School,an Tin,org-org-org-org,-,PROPN-PROPN-PROPN-PROPN,DET-PROPN,compound-compound-compound-nsubj,det-compound,NNP-NNP-NNP-NNP,DT-NNP,4,1
1060,1052.0,30,said,1,13,16,3,12,13,-12,15,Jalal Talabani,Patriotic Union of Kurdistan,-,org-org-org-org,PROPN-PROPN,PROPN-PROPN-ADP-PROPN,compound-poss,compound-conj-prep-pobj,NNP-NNP,NNP-NNP-IN-NNP,3,1
1061,1053.0,21,recording,1,12,13,1,11,7,-11,12,singer,Byron Stingily,,org-org,NOUN,PROPN-PROPN,compound,compound-attr,NN,NNP-NNP,1,1
1062,1054.0,31,was,2,15,16,1,14,14,-13,14,Chevron,UK,,per,PROPN,PROPN,compound,compound,NNP,NNP,1,1
1063,1055.0,25,developed,9,14,14,0,13,10,-5,5,Israel,Israel Military Industries,org,--,PROPN,PROPN-PROPN-PROPN,pobj,compound-compound-pobj,NNP,NNP-NNP-NNPS,0,1
1064,1056.0,41,blasted,14,9,21,12,8,19,5,7,Virginia Military Institute,US,org-org-org,,PROPN-PROPN-PROPN,PROPN,compound-compound-pobj,compound,NNP-NNP-NNP,NNP,11,1
1065,1057.0,29,is,4,19,17,-2,18,11,-15,13,Hong Kong,Kowloon Motor Bus,-,org-org-org,PROPN-PROPN,PROPN-PROPN-PROPN,compound-pobj,compound-compound-compound,NNP-NNP,NNP-NNP-NNP,2,1
1066,1058.0,12,Is,0,6,7,1,5,4,-6,7,singer,Peter Tosh,,per-per,NOUN,PROPN-PROPN,compound,compound-pobj,NN,NNP-NNP,1,1
1067,1059.0,19,Components,1,1,3,2,0,15,0,2,Aquin Components,GmbH,org-org,,PROPN-PROPN,PROPN,compound-ROOT,compound,NNP-NNP,NNP,1,1
1068,1060.0,17,promoted,5,4,16,12,3,0,1,11,he,Ireland,,org,PRON,PROPN,nsubjpass,pobj,PRP,NNP,3,1
1069,1061.0,38,said,21,2,19,17,1,18,19,-2,Air Finland,Cambodia,org-org,,PROPN-PROPN,PROPN,compound-compound,poss,NNP-NNP,NNP,8,1
1070,1062.0,16,spoke,2,8,15,7,7,0,-6,13,U-Haul,Phoenix,,org,PROPN,PROPN,compound,pobj,NNP,NNP,7,1
1071,1063.0,30,began,9,3,8,5,2,21,6,-1,United Kingdom,Royal Mail,-,per-per,PROPN-PROPN,PROPN-PROPN,compound-compound,compound-pobj,NNP-NNP,NNP-NNP,3,1
1072,1064.0,44,became,5,14,14,0,13,29,-9,9,Marietta High School,Marietta,org-org-org,,PROPN-PROPN-PROPN,PROPN,compound-compound-pobj,compound,NNP-NNP-NNP,NNP,0,1
1073,1065.0,10,Daughter,0,3,8,5,2,1,-3,8,Dorothy McGuire,John Swope,per-per,-,PROPN-PROPN,PROPN-PROPN,compound-pobj,compound-appos,NNP-NNP,NNP-NNP,3,1
1074,1066.0,63,announced,6,27,39,12,26,23,-21,33,Golden State Athletic Conference,Point Loma Nazarene University,org-org-org-org,---,PROPN-PROPN-PROPN-PROPN,PROPN-PROPN-PROPN-PROPN,compound-compound-compound-nmod,compound-compound-nmod-conj,NNP-NNP-NNP-NNP,NNP-NNP-NNP-NNP,5,1
1075,1067.0,15,affiliated,10,5,12,7,4,2,5,2,NED University of Engineering and Technology,Pakistan,org-org-org-org-org-org,,PROPN-PROPN-ADP-PROPN-CCONJ-PROPN,PROPN,nmod-nsubj-prep-pobj-cc-conj,compound,NNP-NNP-IN-NNP-CC-NNP,NNP,3,1
1076,1068.0,48,---------------------------------------------------------------------------,0,18,25,7,17,22,-18,25,US,Indian,,org,PROPN,ADJ,compound,amod,NNP,JJ,9,1
1077,1069.0,45,File,0,25,36,11,24,8,-25,36,Joseph Goebbels,Magda Goebbels,-,org-org,PROPN-PROPN,PROPN-PROPN,compound-nsubj,compound-conj,NNP-NNP,NNP-NNP,-1,1
1078,1070.0,76,led,9,8,62,54,7,13,1,53,Valentine Strasser,NPRC,per-per,,PROPN-PROPN,PROPN,compound-nsubj,appos,NNP-NNP,NNP,8,1
1079,1071.0,28,was,1,1,8,7,0,19,0,7,Bergmann,Kaiser Wilhelm Institute for Leather Research,org,-----,PROPN,PROPN-PROPN-PROPN-ADP-PROPN-PROPN,nsubj,compound-compound-pobj-prep-compound-pobj,NNP,NNP-NNP-NNP-IN-NNP-NNP,4,1
1080,1072.0,22,shared,12,9,9,0,8,12,3,-3,St. Charles,St. Charles North High School,org-org,----,PROPN-PROPN,PROPN-PROPN-PROPN-PROPN-PROPN,compound-compound,compound-compound-compound-compound-pobj,NNP-NNP,NNP-NNP-NNP-NNP-NNP,0,1
1081,1074.0,28,won,17,12,21,9,11,6,5,4,Colts,AAFC,per,,PROPN,PROPN,appos,compound,NNPS,NNP,5,1
1082,1075.0,59,founded,3,17,29,12,16,29,-14,26,Western Nigeria,Obafemi Awolowo,per-per,-,PROPN-PROPN,PROPN-PROPN,compound-pobj,compound-compound,NNP-NNP,NNP-NNP,7,1
1083,1076.0,20,is,2,1,16,15,0,3,1,14,KLM,Air France-KLM,per,-,PROPN,PROPN-PROPN,compound,compound-compound,NNP,NNP-NNP,9,1
1084,1077.0,30,was,3,2,17,15,1,12,1,14,Karelian Front,Soviet Union,-,org-org,PROPN-PROPN,PROPN-PROPN,compound-nsubj,compound-poss,NNP-NNP,NNP-NNP,8,1
1085,1078.0,60,agreed,3,53,58,5,52,1,-50,55,Jeff Greason,XCOR Aerospace,-,per-per,PROPN-PROPN,PROPN-PROPN,nmod-nmod,compound-pobj,NNP-NNP,NNP-NNP,3,1
1086,1079.0,20,intervened,3,1,6,5,0,13,2,3,Austria,BAWAG,,org,PROPN,PROPN,poss,poss,NNP,NNP,7,1
1087,1080.0,37,include,3,7,10,3,6,26,-4,7,Nunavut,Nancy Karetak-Lindell,,org-org,PROPN,PROPN-PROPN,compound,pobj-ccomp,NNP,NNP-NNP,3,1
1088,1081.0,24,composed,3,16,22,6,15,1,-13,19,University for Peace,Costa Rica,--,org-org,PROPN-ADP-PROPN,PROPN-PROPN,nmod-prep-pobj,compound-pobj,NNP-IN-NNP,NNP-NNP,3,1
1089,1082.0,28,said,1,1,13,12,0,14,0,12,Sonthi,Council for National Security,org,---,PROPN,PROPN-ADP-PROPN-PROPN,nsubj,pobj-prep-compound-pobj,NNP,NNP-IN-NNP-NNP,7,1
1090,1083.0,48,was,9,19,36,17,18,11,-10,27,Kosovo,Ibrahim Rugova,,org-org,PROPN,PROPN-PROPN,pobj,compound-pobj,NNP,NNP-NNP,-1,1
1091,1084.0,34,educated,2,1,7,6,0,26,1,5,He,Lahore,,org,PRON,PROPN,nsubjpass,pobj,PRP,NNP,2,1
1092,1085.0,30,declared,5,2,3,1,1,26,3,-2,President,Nambaryn Enkhbayar,,per-per,PROPN,PROPN-PROPN,compound,compound-nsubj,NNP,NNP-NNP,1,1
1093,1086.0,17,spent,5,12,15,3,11,1,-7,10,Brazil,Milton Nascimento,org,-,PROPN,PROPN-PROPN,pobj,compound-pobj,NNP,NNP-NNP,2,1
1094,1087.0,51,sent,24,7,16,9,6,34,17,-8,Chevrolet,General Motors,per,-,PROPN,PROPN-PROPN,compound,compound-conj,NNP,NNP-NNP,5,1
1095,1088.0,32,began,10,5,7,2,4,24,5,-3,Curtis,Atlantic,,per,PROPN,PROPN,pobj,compound,NNP,NNP,1,1
1096,1089.0,47,joined,6,6,9,3,5,37,0,3,Nolan,New York Dolls,per,--,PROPN,PROPN-PROPN-PROPN,pobj,compound-compound-dobj,NNP,NNP-NNP-NNPS,2,1
1097,1090.0,30,said,14,16,25,9,15,4,-2,11,George Brainard,Thomas Jefferson University,-,per-per-per,PROPN-PROPN,PROPN-PROPN-PROPN,compound-compound,compound-compound-pobj,NNP-NNP,NNP-NNP-NNP,6,1
1098,1091.0,43,helped,9,25,41,16,24,1,-16,32,Alberto Jardim,PSD,-,per,PROPN-PROPN,PROPN,compound-nmod,ROOT,NNP-NNP,NNP,4,1
1099,1092.0,37,founded,3,14,22,8,13,14,-11,19,Softdisk,game designer,,org-org,PROPN,NOUN-NOUN,appos,compound-compound,NNP,NN-NN,4,1
1100,1093.0,28,was,5,16,24,8,15,3,-11,19,Abdellatif Filali,Morocco,per-per,,PROPN-PROPN,PROPN,compound-pobj,pobj,NNP-NNP,NNP,8,1
1101,1094.0,25,is,7,1,17,16,0,7,6,10,Our Lady of Good Counsel High School,Olney,per-per-per-per-per-per-per,,DET-PROPN-ADP-PROPN-PROPN-PROPN-PROPN,PROPN,poss-nsubj-prep-compound-compound-compound-pobj,pobj,PRP$-NNP-IN-NNP-NNP-NNP-NNP,NNP,3,1
1102,1095.0,34,said,10,10,22,12,9,11,0,12,Taylor,Australia,,org,PROPN,PROPN,pobj,pobj,NNP,NNP,5,1
1103,1096.0,30,nominated,3,2,8,6,1,21,1,5,Calvin Coolidge,United States,per-per,-,PROPN-PROPN,PROPN-PROPN,compound-nsubj,compound-compound,NNP-NNP,NNP-NNP,4,1
1104,1373.0,34,received,5,12,20,8,11,13,-7,15,Calvin Coolidge,United States,per-per,-,PROPN-PROPN,PROPN-PROPN,compound-pobj,compound-compound,NNP-NNP,NNP-NNP,8,1
1105,1097.0,13,recalled,2,1,10,9,0,2,1,8,Lewis,Montana,org,,PROPN,PROPN,nsubj,compound,NNP,NNP,7,1
1106,1098.0,41,exhibition,2,5,11,6,4,29,-3,9,Courbet,Artist,per,,PROPN,PROPN,poss,nsubj,NNP,NNP,5,1
1107,1099.0,33,enters,9,11,11,0,10,21,-2,2,Baltimore,Baltimore Light Rail,org,--,PROPN,PROPN-PROPN-PROPN,dobj,compound-compound-poss,NNP,NNP-NNP-NNP,0,1
1108,1100.0,26,is,4,2,3,1,1,22,2,-1,Earth,United States,per,-,PROPN,PROPN-PROPN,compound,compound-compound,NNP,NNP-NNP,1,1
1109,1101.0,22,is,5,1,10,9,0,11,4,5,ZhayTee,composer,per,,PROPN,NOUN,nsubj,attr,NNP,NN,4,1
1110,1102.0,60,are,3,23,45,22,22,14,-20,42,Bloomberg L.P.,United States,per-per,-,PROPN-PROPN,PROPN-PROPN,compound-pobj,nmod-nmod,NNP-NNP,NNP-NNP,9,1
1111,1103.0,40,originated,3,2,9,7,1,30,1,6,Dynamis Ensemble,Italy,per-per,,PROPN-PROPN,PROPN,compound-nsubj,pobj,NNP-NNP,NNP,2,1
1112,1104.0,17,says,5,1,9,8,0,7,4,4,China,Huang Ju,,org-org,PROPN,PROPN-PROPN,poss,compound-nsubj,NNP,NNP-NNP,5,1
1113,1105.0,52,due,1,11,14,3,10,37,-10,13,Writers Guild of Canada,Canada,per-per-per-per,,PROPN-PROPN-ADP-PROPN,PROPN,compound-nsubj-prep-pobj,pobj,NNPS-NNP-IN-NNP,NNP,2,1
1114,1106.0,18,owned,4,10,16,6,9,1,-6,12,Gaston Flosse,French Polynesia,per-per,-,PROPN-PROPN,PROPN-PROPN,compound-pobj,amod-pobj,NNP-NNP,NNP-NNP,3,1
1115,1107.0,33,hosted,1,27,30,3,26,2,-26,29,South Ossetia,Sanakoyev,org-org,,PROPN-PROPN,PROPN,compound-pobj,poss,NNP-NNP,NNP,7,1
1116,1108.0,40,is,2,15,15,0,14,24,-13,13,Barstow,Barstow Community College,per,--,PROPN,PROPN-PROPN-PROPN,pobj,pobj-compound-compound,NNP,NNP-NNP-NNP,0,1
1117,1110.0,27,Quartermain,1,1,14,13,0,12,0,13,Joel Quartermain,guitarist,org-org,,PROPN-PROPN,ADJ,compound-ROOT,compound,NNP-NNP,JJ,5,1
1118,1111.0,26,considered,1,1,24,23,0,1,0,23,Brinkman,Ohio,per,,PROPN,PROPN,nsubj,compound,NNP,NNP,4,1
1119,1112.0,58,embarked,4,26,49,23,25,8,-22,45,Staffordshire,Keele University,,per-per,PROPN,PROPN-PROPN,pobj,compound-compound,NNP,NNP-NNP,7,1
1120,1113.0,30,acquaintance,1,13,25,12,12,4,-12,24,Greece,Georgios Papadopoulos,org,-,PROPN,PROPN-PROPN,pobj,compound-nsubjpass,NNP,NNP-NNP,8,1
1121,1114.0,32,hit,4,11,23,12,10,8,-7,19,New York,United States,org-org,-,PROPN-PROPN,PROPN-PROPN,compound-pobj,compound-pobj,NNP-NNP,NNP-NNP,8,1
1122,1115.0,29,left,3,15,22,7,14,6,-12,19,New York,NewsCorp,per-per,,PROPN-PROPN,PROPN,compound-compound,pobj,NNP-NNP,NNP,5,1
1123,1116.0,43,was,1,12,21,9,11,21,-11,20,Starbucks,Seattle,per,,PROPN,PROPN,compound,pobj,NNP,NNP,9,1
1124,1117.0,29,said,14,18,22,4,17,6,-4,8,Woods,Arizona,,org,PROPN,PROPN,ccomp,compound,NNP,NNP,4,1
1125,1118.0,64,scheduled,4,2,8,6,1,55,2,4,Air Koryo,Pyongyang,-,per,PROPN-PROPN,PROPN,compound-nsubj,compound,NNP-NNP,NNP,4,1
1126,1119.0,19,appeared,8,1,12,11,0,6,7,4,NYU,Division III,,org-org,PROPN,PROPN-PROPN,compound,compound-compound,NNP,NNP-NNP,6,1
1127,1120.0,16,returned,2,7,11,4,6,4,-5,9,law school,Emory University,-,org-org,NOUN-NOUN,PROPN-PROPN,compound-compound,compound-pobj,NN-NN,NNP-NNP,5,1
1128,1121.0,35,said,33,5,9,4,4,25,28,-24,Quebec,Jean Charest,org,-,PROPN,PROPN-PROPN,poss,compound-pobj,NNP,NNP-NNP,3,1
1129,1122.0,34,received,13,11,31,20,10,2,2,18,Kurt von Schleicher,Germany,per-per-per,,PROPN-PROPN-PROPN,PROPN,compound-compound-conj,dobj,NNP-NNP-NNP,NNP,9,1
1130,1123.0,47,announced,5,14,35,21,13,11,-9,30,Newcastle Knights,Brian Smith,org-org,-,PROPN-PROPN,PROPN-PROPN,compound-pobj,compound-pobj,NNP-NNPS,NNP-NNP,8,1
1131,1124.0,8,was,1,1,7,6,0,0,0,6,He,Peru,,org,PRON,PROPN,nsubj,pobj,PRP,NNP,1,1
1132,1125.0,33,ranked,5,4,9,5,3,23,1,4,school,Derbyshire,,org,NOUN,PROPN,nsubjpass,pobj,NN,NNP,2,1
1133,1126.0,34,postponed,27,7,22,15,6,11,20,-5,Jean-Marie Le Pen,France,--,per,PROPN-PROPN-PROPN,PROPN,compound-compound-pobj,pobj,NNP-NNP-NNP,NNP,7,1
1134,1127.0,34,won,3,8,10,2,7,23,-5,7,Alberta,Stewart,per,,PROPN,PROPN,pobj,conj,NNP,NNP,6,1
1135,1128.0,46,was,5,11,1,-10,10,44,-6,-4,King,Edmund,org,,PROPN,PROPN,compound,poss,NNP,NNP,5,1
1136,1129.0,26,is,3,6,24,18,5,1,-3,21,Luxembourg,Luxemburger Wort,per,-,PROPN,PROPN-PROPN,poss,compound-appos,NNP,NNP-NNP,5,1
1137,1130.0,45,Minister,3,1,5,4,0,39,2,2,Angola,Fernando da Piedade Dias dos Santos,org,-----,PROPN,PROPN-PROPN-PROPN-PROPN-PROPN-PROPN,poss,compound-compound-compound-appos-compound-nsubj,NNP,NNP-NNP-NNP-NNP-NNP-NNP,4,1
1138,1131.0,30,was,6,3,21,18,2,8,3,15,Alexander Mitchell,Milwaukee,per-per,,PROPN-PROPN,PROPN,compound-nsubj,compound,NNP-NNP,NNP,5,1
1139,1132.0,38,is,12,1,1,0,0,36,11,-11,Stephen Moyer,Stephen John Emery,-,per-per-per,PROPN-PROPN,PROPN-PROPN-PROPN,compound-nsubj,compound-compound-appos,NNP-NNP,NNP-NNP-NNP,0,1
1140,1133.0,82,included,2,37,40,3,36,41,-35,38,Hamad bin Khalifa,Al Thani,--,per-per,PROPN-PROPN-PROPN,PROPN-PROPN,compound-compound-compound,compound-dobj,NNP-NNP-NNP,NNP-NNP,2,1
1141,1134.0,32,is,15,3,15,12,2,16,12,0,1974,Concordia,,org,NUM,PROPN,pobj,conj,CD,NNP,2,1
1142,1135.0,28,is,1,8,8,0,7,19,-7,7,Anshan Iron and Steel Group,Anshan,----,per,PROPN-PROPN-CCONJ-PROPN-PROPN,PROPN,nmod-nmod-cc-conj-compound,pobj,NNP-NNP-CC-NNP-NNP,NNP,0,1
1143,1136.0,81,increased,16,8,74,66,7,6,8,58,Ohio University,Roderick McDavis,per-per,-,PROPN-PROPN,PROPN-PROPN,compound-compound,compound-dobj,NNP-NNP,NNP-NNP,-1,1
1144,1137.0,24,AP,3,10,15,5,9,8,-7,12,Hillary Clinton,Bill Clinton,per-per,-,PROPN-PROPN,PROPN-PROPN,compound-nsubj,compound-conj,NNP-NNP,NNP-NNP,1,1
1145,1138.0,106,born,25,3,100,97,2,5,22,75,Austria,Elisabeth of Bavaria,per,--,PROPN,PROPN-ADP-PROPN,pobj,appos-prep-pobj,NNP,NNP-IN-NNP,9,1
1146,1139.0,35,born,3,1,17,16,0,17,2,14,David Ayer,Minnesota,-,org,PROPN-PROPN,PROPN,compound-nsubjpass,pobj,NNP-NNP,NNP,5,1
1147,1140.0,30,admitted,5,3,9,6,2,20,2,4,Syracuse University,Association of American Universities,org-org,---,PROPN-PROPN,PROPN-ADP-PROPN-PROPN,compound-nsubjpass,pobj-prep-compound-pobj,NNP-NNP,NNP-IN-NNP-NNP,4,1
1148,1141.0,33,leased,7,6,6,0,5,26,1,-1,Welbeck,Welbeck College,org,-,PROPN,PROPN-PROPN,nsubjpass,compound-pobj,NNP,NNP-NNP,0,1
1149,1142.0,20,won,2,8,14,6,7,5,-6,12,NCAA,Howard University,per,-,PROPN,PROPN-PROPN,compound,compound-pobj,NNP,NNP-NNP,5,1
1150,1143.0,64,received,51,28,41,13,27,22,23,-10,University of Antioquia,Colombia,--,per,PROPN-ADP-PROPN,PROPN,pobj-prep-pobj,pobj,NNP-IN-NNP,NNP,9,1
1151,1144.0,30,Apart,0,19,25,6,18,4,-19,25,India,HDFC Bank,per,-,PROPN,PROPN-PROPN,poss,compound-nsubj,NNP,NNP-NNP,4,1
1152,1145.0,27,received,1,17,20,3,16,6,-16,19,British,Nigel Wright,,org-org,ADJ,PROPN-PROPN,amod,compound-dobj,JJ,NNP-NNP,2,1
1153,1146.0,22,failed,4,2,4,2,1,17,2,0,University,Toronto,,org,PROPN,PROPN,nsubj,pobj,NNP,NNP,2,1
1154,1147.0,47,presenting,3,33,45,12,32,1,-30,42,New York,Gertrude Lawrence,org-org,-,PROPN-PROPN,PROPN-PROPN,compound-pobj,compound-appos,NNP-NNP,NNP-NNP,7,1
1155,1148.0,21,was,14,1,17,16,0,3,13,3,Alexander Stirling Calder,American,org-org-org,,PROPN-PROPN-PROPN,ADJ,compound-compound-nsubj,amod,NNP-NNP-NNP,JJ,3,1
1156,1149.0,89,******,0,14,68,54,13,20,-14,68,Manager,BARBER,,org,PROPN,PROPN,compound,appos,NNP,NNP,6,1
1157,1151.0,46,arrested,13,10,7,-3,9,38,3,-6,Franklin,Hilltop Baptist School,org,--,PROPN,PROPN-PROPN-PROPN,compound,compound-compound-pobj,NNP,NNP-NNP-NNP,4,1
1158,1152.0,22,started,1,14,20,6,13,1,-13,19,Groupe Casino,Jean-Charles Naouri,-,per-per,PROPN-PROPN,PROPN-PROPN,conj-pobj,compound-pobj,NNP-NNP,NNP-NNP,4,1
1159,1153.0,37,is,1,1,8,7,0,28,0,7,It,Crown Investments Corporation Of Saskatchewan,per,----,PRON,PROPN-PROPN-PROPN-ADP-PROPN,nsubj,compound-compound-pobj-prep-pobj,PRP,NNP-NNPS-NNP-IN-NNP,4,1
1160,1154.0,28,is,3,2,13,11,1,14,1,10,Beechcraft,Beech Aircraft,per,-,PROPN,PROPN-PROPN,compound,compound-compound,NNP,NNP-NNP,4,1
1161,1155.0,36,refused,9,15,16,1,14,19,-6,7,Japan,Ysuke Matsuok,,org-org,PROPN,PROPN-PROPN,pobj,compound-appos,NNP,NNP-NNP,1,1
1162,1156.0,13,works,2,2,2,0,1,10,0,0,London,London School of Business and Finance,,org-org-org-org-org-org,PROPN,PROPN-PROPN-ADP-PROPN-CCONJ-PROPN,nsubj,compound-pobj-prep-pobj-cc-conj,NNP,NNP-NNP-IN-NNP-CC-NNP,0,1
1163,1157.0,22,OKADIGBO,1,1,15,14,0,6,0,14,CHUBA OKADIGBO,Nigeria,org-org,,PROPN-NOUN,PROPN,compound-ROOT,ROOT,NNP-NNS,NNP,-1,1
1164,1158.0,31,was,20,9,15,6,8,15,11,-5,Grumman,and chief,per,-,PROPN,CCONJ-ADJ,compound,cc-amod,NNP,CC-JJ,6,1
1165,1159.0,32,transferred,2,15,24,9,14,7,-13,22,Louise,France,org,,PROPN,PROPN,nsubj,pobj,NNP,NNP,5,1
1166,1160.0,16,received,1,11,14,3,10,1,-10,13,Progressive Conservative,Louis Plamondon,-,per-per,PROPN-PROPN,PROPN-PROPN,compound-amod,compound-pobj,NNP-NNP,NNP-NNP,2,1
1167,1161.0,50,laid,2,32,36,4,31,13,-30,34,John L. Mitchell,Wisconsin,--,org,PROPN-PROPN-PROPN,PROPN,compound-compound-pobj,pobj,NNP-NNP-NNP,NNP,7,1
1168,1162.0,20,born,4,3,16,13,2,3,1,12,Millet,French,per,,PROPN,ADJ,nsubjpass,amod,NNP,JJ,3,1
1169,1163.0,19,discussed,8,4,7,3,3,11,4,-1,songwriter,Gary Young,org,-,NOUN,PROPN-PROPN,nmod,compound-nsubj,NN,NNP-NNP,2,1
1170,1164.0,26,is,7,1,12,11,0,13,6,5,AQIS,Australia,per,,ADJ,PROPN,nmod,dative,JJ,NNP,8,1
1171,1165.0,39,is,1,13,33,20,12,5,-12,32,University of Toronto,Centre for Addiction and Mental Health,--,per-per-per-per-per-per,PROPN-ADP-PROPN,PROPN-ADP-PROPN-CCONJ-PROPN-PROPN,poss-prep-pobj,pobj-prep-pobj-cc-compound-conj,NNP-IN-NNP,NNP-IN-NNP-CC-NNP-NNP,9,1
1172,1166.0,59,arrived,20,16,19,3,15,39,4,-1,Pedro Pires,Cape Verde,per-per,-,PROPN-PROPN,PROPN-PROPN,compound-conj,compound-pobj,NNP-NNPS,NNP-NNP,2,1
1173,1167.0,21,led,8,1,3,2,0,17,7,-5,Dominica,Eugenia Charles,per,-,PROPN,PROPN-PROPN,poss,compound-nsubj,NNP,NNP-NNP,2,1
1174,1168.0,17,founded,2,1,8,7,0,8,1,6,Mercury,Ford,,per,PROPN,PROPN,nsubjpass,poss,NNP,NNP,5,1
1175,1169.0,25,is,18,9,12,3,8,12,9,-6,University of Wales,Bangor,org-org-org,,PROPN-ADP-PROPN,PROPN,nmod-prep-pobj,conj,NNP-IN-NNP,NNP,5,1
1176,1170.0,72,apply,3,19,34,15,18,37,-16,31,John A. Ferguson High School,Miami,org-org-org-org-org,,PROPN-PROPN-PROPN-PROPN-PROPN,PROPN,npadvmod-compound-pobj-compound-pobj,compound,NNP-NNP-NNP-NNP-NNP,NNP,5,1
1177,1171.0,21,turned,1,5,8,3,4,12,-4,7,China,Alibaba,per,,PROPN,PROPN,compound,pobj,NNP,NNP,4,1
1178,1172.0,43,born,4,6,14,8,5,28,-2,10,Yvette Marie Stevens,Chaka Khan,--,per-per,PROPN-PROPN-PROPN,PROPN-PROPN,compound-compound-dobj,compound-pobj,NNP-NNP-NNP,NNP-NNP,4,1
1179,1173.0,21,formed,2,1,16,15,0,4,1,14,Weezer,Matt Sharp,,org-org,PROPN,PROPN-PROPN,nsubjpass,compound-appos,NNP,NNP-NNP,5,1
1180,1174.0,21,was,1,1,12,11,0,8,0,11,He,State Law and Order Restoration Council,org,-----,PRON,PROPN-PROPN-CCONJ-PROPN-PROPN-PROPN,nsubj,nmod-nmod-cc-conj-compound-pobj,PRP,NNP-NNP-CC-NNP-NNP-NNP,6,1
1181,1175.0,57,bridged,18,8,8,0,7,48,10,-10,George,George I of Great Britain,,org-org-org-org-org,PROPN,PROPN-PRON-ADP-PROPN-PROPN,compound,compound-attr-prep-compound-pobj,NNP,NNP-PRP-IN-NNP-NNP,0,1
1182,1176.0,54,On,0,26,21,-5,25,32,-26,21,PLAN,People's Republic of China,,org-org-org-org,PROPN,PROPN-PROPN-ADP-PROPN,appos,compound-conj-prep-pobj,NNP,NNP-NNP-IN-NNP,2,1
1183,1177.0,35,criticized,3,21,24,3,20,10,-18,21,United,Star Alliance,,per-per,PROPN,PROPN-PROPN,nsubj,compound-dobj,NNP,NNP-NNP,3,1
1184,1178.0,36,known,4,7,1,-6,6,34,-3,-3,Ontario,Zehrs Markets,per,-,PROPN,PROPN-PROPN,pobj,compound-compound,NNP,NNP-NNP,2,1
1185,1179.0,25,formed,15,11,23,12,10,1,4,8,Allen Collins,Jacksonville,per-per,,PROPN-PROPN,PROPN,compound-pobj,compound,NNP-NNP,NNP,9,1
1186,1180.0,46,died,10,1,10,9,0,35,9,0,Henry Chapman Mercer,Pennsylvania,--,per,PROPN-PROPN-PROPN,PROPN,compound-compound-nsubj,appos,NNP-NNP-NNP,NNP,2,1
1187,1181.0,32,moved,8,8,18,10,7,13,0,10,Kadima,his,org,,PROPN,DET,pobj,poss,NNP,PRP$,8,1
1188,1182.0,36,consisted,2,1,6,5,0,29,1,4,Bassmint,Eminem,org,,PROPN,PROPN,compound,pobj,NNP,NNP,5,1
1189,1183.0,24,Partners,1,1,12,11,0,11,0,11,Elevation Partners,Bono,-,org,PROPN-VERB,PROPN,nsubj-ROOT,nsubj,NNP-VBZ,NNP,3,1
1190,1184.0,89,gains,4,26,39,13,25,49,-22,35,Roger Vadim,France,per-per,,PROPN-PROPN,PROPN,compound-compound,pobj,NNP-NNP,NNP,6,1
1191,1185.0,32,established,5,1,25,24,0,6,4,20,Its,UK,per,,DET,PROPN,poss,compound,PRP$,NNP,12,1
1192,1186.0,27,came,2,14,15,1,13,11,-12,13,chairman,Steve Gibson,,per-per,NOUN,PROPN-PROPN,compound,compound-pobj,NN,NNP-NNP,2,1
1193,1187.0,24,were,3,19,23,4,18,0,-16,20,Magritte,Brussels,org,,PROPN,PROPN,conj,pobj,NNP,NNP,6,1
1194,1188.0,66,chaired,2,22,26,4,21,39,-20,24,William H. King,Utah,org-org-org,,PROPN-PROPN-PROPN,PROPN,compound-compound-appos,pobj,NNP-NNP-NNP,NNP,2,1
1195,1189.0,26,Named,0,13,20,7,12,5,-13,20,Prince Philip Duke of Edinburgh,Elizabeth II of the United Kingdom,per-per-per-per-per,-----,PROPN-PROPN-PROPN-ADP-PROPN,PROPN-PROPN-ADP-DET-PROPN-PROPN,compound-compound-pobj-prep-compound,compound-pobj-prep-det-compound-pobj,NNP-NNP-NNP-IN-NNP,NNP-NNP-IN-DT-NNP-NNP,8,1
1196,1190.0,32,fed,11,5,9,4,4,22,6,-2,Air Force,Verne Orr,org-org,-,PROPN-PROPN,PROPN-PROPN,compound-compound,compound-pobj,NNP-NNP,NNP-NNP,4,1
1197,1191.0,41,lectured,2,8,13,5,7,27,-6,11,University of Burgundy,France,--,per,PROPN-ADP-PROPN,PROPN,pobj-prep-pobj,conj,NNP-IN-NNP,NNP,5,1
1198,1192.0,32,University,1,1,31,30,0,0,0,30,Norwegian University of Science and Technology,Norway,per-per-per-per-per-per,,PROPN-PROPN-ADP-PROPN-CCONJ-PROPN,PROPN,amod-ROOT-prep-pobj-cc-conj,pobj,NNP-NNP-IN-NNP-CC-NNP,NNP,8,1
1199,1193.0,41,interviewed,5,25,28,3,24,12,-20,23,Wesley Pentz,Diplo,per-per,,PROPN-PROPN,PROPN,compound-compound,appos,NNP-NNP,NNP,7,1
1200,1194.0,29,held,2,7,19,12,6,9,-5,17,New Hampshire,Judd Gregg,-,per-per,PROPN-PROPN,PROPN-PROPN,compound-compound,compound-pobj,NNP-NNP,NNP-NNP,8,1
1201,1195.0,36,claimed,6,1,9,8,0,26,5,3,Chinese Super League,A3 Champions Cup,--,per-per-per,PROPN-PROPN-PROPN,PROPN-PROPN-PROPN,compound-compound-compound,compound-compound-compound,NNP-NNP-NNP,NNP-NNPS-NNP,6,1
1202,1196.0,36,publishes,5,11,25,14,10,10,-6,20,Metro Silicon Valley,1985,org-org-org,,PROPN-PROPN-PROPN,NUM,compound-compound-pobj,pobj,NNP-NNP-NNP,CD,5,1
1203,1197.0,21,named,2,5,16,11,4,4,-3,14,Edward Livingston,State,org-org,,PROPN-PROPN,PROPN,compound-pobj,pobj,NNP-NNP,NNP,2,1
1204,1198.0,37,is,1,21,22,1,20,14,-20,21,Sultan,Selim I,,per-per,PROPN,PROPN-PRON,compound,pobj-ROOT,NNP,NNP-PRP,3,1
1205,1199.0,37,was,1,7,10,3,6,26,-6,9,Fuad I of Egypt,Egypt,---,per,PROPN-PRON-ADP-PROPN,PROPN,compound-pobj-prep-pobj,pobj,NNP-PRP-IN-NNP,NNP,1,1
1206,1200.0,40,changed,6,11,19,8,10,20,-5,13,William H. Seward,New York,--,org-org,PROPN-PROPN-PROPN,PROPN-PROPN,compound-compound-pobj,compound-compound,NNP-NNP-NNP,NNP-NNP,7,1
1207,1201.0,31,is,7,1,21,20,0,9,6,14,Dongfeng,oint-venture between Dongfe,org,--,PROPN,NOUN-ADP-PROPN,compound,ROOT-prep-compound,NNP,NN-IN-NNP,5,1
1208,1202.0,28,surprised,3,16,21,5,15,6,-13,18,Australian Labor Party,Gough Whitlam,per-per-per,-,PROPN-PROPN-PROPN,PROPN-PROPN,compound-compound-dobj,compound-pobj,NNP-NNP-NNP,NNP-NNP,4,1
1209,1203.0,15,lists,2,2,13,11,1,1,0,11,BSE,Infosys,,per,PROPN,PROPN,nsubj,compound,NNP,NNP,5,1
1210,1204.0,17,established,9,12,16,4,11,0,-3,7,college,1899,per,,NOUN,NUM,dobj,nummod,NN,CD,2,1
1211,1205.0,10,written,2,7,8,1,6,1,-5,6,guitarist,Masatoshi Mashima,per,-,NOUN,PROPN-PROPN,compound,compound-pobj,NN,NNP-NNP,2,1
1212,1206.0,23,graduated,3,7,10,3,6,12,-4,7,University of Warwick,England,--,org,PROPN-ADP-PROPN,PROPN,pobj-prep-compound,pobj,NNP-IN-NNP,NNP,5,1
1213,1207.0,18,brought,2,1,10,9,0,7,1,8,He,Urmston,,per,PRON,PROPN,nsubjpass,conj,PRP,NNP,2,1
1214,1208.0,24,applied,5,3,9,6,2,14,2,4,Florida Gulf Coast,Division I,org-org-org,-,PROPN-PROPN-PROPN,PROPN-PRON,compound-compound-nsubj,pobj-nsubj,NNP-NNP-NNP,NNP-PRP,4,1
1215,1209.0,30,introduced,6,9,10,1,8,19,-3,4,singer,Sasha,org,,VERB,PROPN,compound,pobj,VB,NNP,2,1
1216,1411.0,48,strung,2,25,26,1,24,21,-23,24,singer,Sasha,org,,NOUN,PROPN,conj,compound,NN,NNP,1,1
1217,1210.0,34,opposite,7,9,19,10,8,14,-2,12,Khamenei,Mashhad,,per,PROPN,PROPN,dobj,pobj,NNP,NNP,3,1
1218,1211.0,21,published,4,14,19,5,13,1,-10,15,author,Mathias Malzieu,org,-,NOUN,PROPN-PROPN,conj,compound-appos,NN,NNP-NNP,4,1
1219,1213.0,25,founded,3,2,6,4,1,18,1,3,University,1851,per,,PROPN,NUM,nsubjpass,pobj,NNP,CD,3,1
1220,1214.0,20,painted,5,2,12,10,1,7,3,7,his,Spain,,per,DET,PROPN,poss,pobj,PRP$,NNP,4,1
1221,1215.0,36,was,1,31,34,3,30,1,-30,33,American,Clement Greenberg,per,-,ADJ,PROPN-PROPN,amod,compound-appos,JJ,NNP-NNP,2,1
1222,1216.0,30,released,21,1,19,18,0,10,20,-2,Bread,Mike Botts,,per-per,PROPN,PROPN-PROPN,poss,compound-nsubjpass,NNP,NNP-NNP,7,1
1223,1217.0,22,says,3,2,5,3,1,16,1,2,Michelle Bachelet,Chile,org-org,,PROPN-PROPN,PROPN,compound-nsubj,nsubj,NNP-NNP,NNP,2,1
1224,1218.0,32,said,22,3,6,3,2,25,19,-16,Newsweek,Fareed Zakaria,org,-,PROPN,PROPN-PROPN,compound,compound-pobj,NNP,NNP-NNP,2,1
1225,1219.0,52,PH.D.,5,13,38,25,12,13,-8,33,Tisch School,New York,per-per,-,PROPN-PROPN,PROPN-PROPN,compound-pobj,compound-compound,NNP-NNP,NNP-NNP,9,1
1226,1220.0,17,decided,7,2,6,4,1,10,5,-1,Washington,Patty Murray,,per-per,PROPN,PROPN-PROPN,compound,compound-nsubj,NNP,NNP-NNP,3,1
1227,1221.0,28,budge,5,3,8,5,2,19,2,3,FHP,its,,per,PROPN,DET,nsubj,poss,NNP,PRP$,4,1
1228,1222.0,66,is,10,6,12,6,5,53,4,2,Hollywood Records,Demi Lovato,per-per,-,PROPN-PROPN,PROPN-PROPN,compound-poss,compound-poss,NNP-NNPS,NNP-NNP,7,1
1229,1223.0,27,founded,1,1,9,8,0,17,0,8,He,Funnel Film Centre,org,--,PRON,PROPN-PROPN-PROPN,nsubj,compound-compound-pobj,PRP,NNP-NNP-NNP,5,1
1230,1224.0,42,was,2,1,12,11,0,29,1,10,Studio Liverpool,Sony Computer Entertainment,-,org-org-org,PROPN-PROPN,PROPN-PROPN-PROPN,compound-nsubj,compound-compound-compound,NNP-NNP,NNP-NNP-NNP,6,1
1231,1225.0,65,gave,13,37,47,10,36,17,-24,34,Daniel Akaka,Hawaii,-,per,PROPN-PROPN,PROPN,compound-compound,compound,NNP-NNP,NNP,10,1
1232,1226.0,15,/,0,2,11,9,1,3,-2,11,Jagdgeschwader 26,France,org-org,,PROPN-NUM,PROPN,nmod-nummod,pobj,NNP-CD,NNP,4,1
1233,1227.0,14,moved,2,7,9,2,6,4,-5,7,Florida,Boone,,per,PROPN,PROPN,pobj,nsubj,NNP,NNP,1,1
1234,1228.0,14,sung,9,3,6,3,2,7,6,-3,his,Snot,per,,DET,PROPN,poss,compound,PRP$,NNP,2,1
1235,1229.0,17,opened,3,3,7,4,2,9,0,4,Stanford,1,,org,PROPN,NUM,nsubj,nummod,NNP,CD,3,1
1236,1230.0,23,declared,18,1,6,5,0,16,17,-12,Tommy Thompson,secretary,per-per,,PROPN-PROPN,NOUN,compound-nsubj,nsubj,NNP-NNP,NN,2,1
1237,1231.0,27,ended,23,1,17,16,0,9,22,-6,Kendal,Michael Rudman,org,-,PROPN,PROPN-PROPN,poss,compound-pobj,NNP,NNP-NNP,5,1
1238,1232.0,39,succeeded,28,23,31,8,22,7,5,3,Presidium,Andrei Gromyko,,per-per,PROPN,PROPN-PROPN,pobj,compound-pobj,NNP,NNP-NNP,9,1
1239,1233.0,18,made,5,4,17,13,3,0,1,12,Kate Bush,England,per-per,,PROPN-PROPN,PROPN,compound-nsubj,pobj,NNP-NNP,NNP,7,1
1240,1234.0,35,Founded,0,13,16,3,12,18,-13,16,Gyldendal,Copenhagen,org,,PROPN,PROPN,appos,pobj,NNP,NNP,3,1
1241,1235.0,21,joined,1,4,6,2,3,14,-3,5,Megaherz,1993,org,,PROPN,NUM,pobj,pobj,NNP,CD,2,1
1242,1236.0,14,said,12,7,12,5,6,1,5,0,Maine,Collins,per,,PROPN,PROPN,poss,pobj,NNP,NNP,5,1
1243,1237.0,32,merged,5,4,11,7,3,20,1,6,Armstrong Whitworth,Vickers-Armstrongs,per-per,,PROPN-PROPN,NOUN,compound-conj,dobj,NNP-NNP,NNS,6,1
1244,1238.0,47,joined,7,9,11,2,8,35,-2,4,Suicidal Tendencies,Muir,-,per,PROPN-PROPN,PROPN,compound-compound,nsubj,NNP-NNPS,NNP,2,1
1245,1239.0,11,shares,2,1,9,8,0,1,1,7,WSU,Washington,per,,PROPN,PROPN,compound,compound,NNP,NNP,4,1
1246,1240.0,21,was,1,11,16,5,10,4,-10,15,California,Warren G,org,-,PROPN,PROPN-PROPN,pobj,compound-pobj,NNP,NNP-NNP,2,1
1247,1241.0,15,Recorded,0,5,12,7,4,2,-5,12,Martin Bisi,Brooklyn,org-org,,PROPN-PROPN,PROPN,compound-pobj,compound,NNP-NNP,NNP,7,1
1248,1242.0,28,said,15,5,22,17,4,5,10,7,Bergman,Sweden,,per,PROPN,PROPN,dobj,nsubj,NNP,NNP,5,1
1249,1243.0,13,was,2,1,10,9,0,2,1,8,Woodstock College,1869,-,per,PROPN-PROPN,NUM,compound-nsubj,pobj,NNP-NNP,CD,4,1
1250,1244.0,24,is,11,10,22,12,9,1,1,11,Iran,Mahmoud Ahmadinejad,,org-org,PROPN,PROPN-PROPN,pobj,compound-pobj,NNP,NNP-NNP,6,1
1251,1245.0,44,said,25,17,24,7,16,19,8,-1,Shanghai Airlines,Star Alliance,-,per-per,PROPN-PROPN,PROPN-PROPN,compound-conj,compound-dobj,NNP-NNPS,NNP-NNP,9,1
1252,1246.0,25,received,4,3,23,20,2,1,1,19,Ramos-Horta,East Timor,,org-org,PROPN,PROPN-PROPN,pobj,compound-pobj,NNP,NNP-NNP,12,1
1253,1247.0,21,married,9,5,7,2,4,13,4,-2,North Tyneside,John,-,per,PROPN-PROPN,PROPN,compound-compound,pobj,NNP-NNP,NNP,5,1
1254,1248.0,70,In,0,14,53,39,13,16,-14,53,Thomas Jefferson,United States,per-per,-,PROPN-PROPN,PROPN-PROPN,compound-compound,compound-pobj,NNP-NNP,NNP-NNP,-1,1
1255,1249.0,41,kicked,6,14,21,7,13,19,-8,15,Democratic Party of Japan,Prime Minister,per-per-per-per,-,PROPN-PROPN-ADP-PROPN,PROPN-PROPN,compound-nmod-prep-pobj,compound-compound,NNP-NNP-IN-NNP,NNP-NNP,6,1
1256,1250.0,17,presented,1,10,11,1,9,5,-9,10,Russia,Vladimir Putin,org,-,PROPN,PROPN-PROPN,compound,compound-pobj,NNP,NNP-NNP,2,1
1257,1251.0,54,are,6,28,30,2,27,23,-22,24,Portugal,Sabrina,,per,PROPN,PROPN,poss,pobj,NNP,NNP,1,1
1258,1252.0,37,P.E.A.C.E.,0,21,23,2,20,13,-21,23,MDC,Dave Dictor,,org-org,PROPN,PROPN-PROPN,poss,compound-pobj,NNP,NNP-NNP,2,1
1259,1253.0,22,attended,1,1,21,20,0,0,0,20,Heitmeyer,Montreal,per,,PROPN,PROPN,nsubj,pobj,NNP,NNP,-1,1
1260,1254.0,30,vowed,1,14,16,2,13,13,-13,15,Vauxhall,General Motors,,per-per,PROPN,PROPN-PROPN,pobj,compound-nsubj,NNP,NNP-NNPS,2,1
1261,1255.0,25,is,5,15,20,5,14,4,-10,15,University of Northern Iowa,Cedar Falls,org-org-org-org,-,PROPN-ADP-PROPN-PROPN,PROPN-PROPN,pobj-prep-compound-pobj,compound-compound,NNP-IN-NNP-NNP,NNP-NNP,4,1
1262,1256.0,48,formed,14,22,23,1,21,24,-8,9,President,Uribe,org,,PROPN,PROPN,compound,compound,NNP,NNP,2,1
1263,1257.0,38,worked,4,25,30,5,24,7,-21,26,Secretary,Louis St. Laurent,,per-per-per,PROPN,PROPN-PROPN-PROPN,pobj,compound-compound-pobj,NNP,NNP-NNP-NNP,2,1
1264,1258.0,28,is,4,7,12,5,6,15,-3,8,South Wales Echo,1884,--,per,PROPN-PROPN-PROPN,NUM,compound-compound-attr,pobj,NNP-NNP-NNP,CD,5,1
1265,1259.0,22,took,4,4,21,17,3,0,0,17,NBG,Greece,,per,PROPN,PROPN,nsubj,pobj,NNP,NNP,1,1
1266,1260.0,23,said,20,1,19,18,0,3,19,-1,France,Nicolas Sarkozy,per,-,PROPN,PROPN-PROPN,nsubj,compound-pobj,NNP,NNP-NNP,6,1
1267,1261.0,48,opened,4,1,16,15,0,31,3,12,Great Oak High School,Temecula,---,org,PROPN-PROPN-PROPN-PROPN,PROPN,compound-compound-compound-nsubj,compound,NNP-NNP-NNP-NNP,NNP,10,1
1268,1262.0,30,was,1,1,5,4,0,24,0,4,Cederlund,Sweden,org,,NOUN,PROPN,nsubj,poss,NN,NNP,5,1
1269,1263.0,34,are,2,1,13,12,0,20,1,11,The Lines,England,-,per,DET-NOUN,PROPN,det-nsubj,pobj,DT-NNS,NNP,5,1
1270,1264.0,25,is,2,9,23,14,8,1,-7,21,Patrick Stump,Island Records,-,per-per,PROPN-PROPN,PROPN-PROPN,compound-pobj,compound-pobj,NNP-NNP,NNP-NNPS,5,1
1271,1265.0,15,published,5,1,2,1,0,12,4,-3,The Trinity Tripod,Trinity College,org-org-org,-,DET-PROPN-PROPN,PROPN-PROPN,det-compound-nsubjpass,compound-pobj,DT-NNP-NNP,NNP-NNP,1,1
1272,1266.0,32,released,12,11,30,19,10,1,1,18,Young Buck,Nashville,org-org,,PROPN-PROPN,PROPN,compound-nsubj,compound,NNP-NNP,NNP,11,1
1273,1267.0,19,served,2,8,15,7,7,3,-6,13,her,Brooklyn,,per,DET,PROPN,poss,pobj,PRP$,NNP,5,1
1274,1268.0,47,criticised,12,10,26,16,9,20,2,14,Tomiichi Murayama,Japanese,org-org,,PROPN-PROPN,ADJ,compound-pobj,amod,NNP-NNP,JJ,9,1
1275,1269.0,43,after,1,12,37,25,11,5,-11,36,Manuel Roxas,Philippines,per-per,,PROPN-PROPN,PROPN,compound-compound,pobj,NNP-NNP,NNPS,10,1
1276,1270.0,32,Born,0,4,6,2,3,25,-4,6,England,Kathleen Mary Nesbitt,per,--,PROPN,PROPN-PROPN-PROPN,pobj,compound-compound-pobj,NNP,NNP-NNP-NNP,2,1
1277,1271.0,35,are,1,18,28,10,17,6,-17,27,Fage,Greece,per,,PROPN,PROPN,compound,pobj,NNP,NNP,5,1
1278,1272.0,33,is,1,8,8,0,7,24,-7,7,Intel,Intel Ireland,org,-,PROPN,PROPN-PROPN,compound,compound-nsubjpass,NNP,NNP-NNP,0,1
1279,1273.0,23,stood,1,1,4,3,0,18,0,3,Putin,United Russia,per,-,PROPN,PROPN-PROPN,nsubj,compound-poss,NNP,NNP-NNP,3,1
1280,1274.0,15,returned,1,4,13,9,3,1,-3,12,France,Max Linder,per,-,PROPN,PROPN-PROPN,pobj,compound-appos,NNP,NNP-NNP,3,1
1281,1275.0,61,classics,43,3,17,14,2,43,40,-26,Otis Redding,Stax,per-per,,PROPN-NOUN,PROPN,compound-nsubjpass,compound,NNP-NN,NNP,7,1
1282,1276.0,12,was,1,8,10,2,7,1,-7,9,American,Raymond Massey,per,-,ADJ,PROPN-PROPN,amod,compound-dobj,JJ,NNP-NNP,1,1
1283,1277.0,31,served,2,1,17,16,0,13,1,15,Zoellick,State,,per,PROPN,PROPN,nsubj,compound,NNP,NNP,7,1
1284,1278.0,19,represented,6,3,3,0,2,15,3,-3,Syracuse Orange,Syracuse University,org-org,-,PROPN-PROPN,PROPN-PROPN,compound-compound,compound-dobj,NNP-NNP,NNP-NNP,0,1
1285,1279.0,26,founded,8,6,14,8,5,11,2,6,Gee Vaucher,Crass,org-org,,PROPN-PROPN,PROPN,compound-conj,nsubj,NNP-NNP,NNP,-1,1
1286,1280.0,20,received,1,7,14,7,6,5,-6,13,George Sykes,V Corps,per-per,-,PROPN-PROPN,PROPN-PROPN,compound-pobj,compound-pobj,NNP-NNP,NNP-NNP,5,1
1287,1281.0,31,is,4,13,3,-10,12,27,-9,-1,Bucharest,University of Bucharest,,per-per-per,PROPN,PROPN-ADP-PROPN,pobj,nmod-prep-pobj,NNP,NNP-IN-NNP,6,1
1288,1282.0,27,are,2,6,17,11,5,9,-4,15,ABA,Twin City Ballers,per,--,PROPN,PROPN-PROPN-PROPN,compound,compound-compound-nsubj,NNP,NNP-NNP-NNPS,4,1
1289,1283.0,22,merged,3,1,7,6,0,14,2,4,MAF,New Zealand,,per-per,PROPN,PROPN-PROPN,nsubj,compound-compound,NNP,NNP-NNP,4,1
1290,1284.0,21,is,1,1,10,9,0,10,0,9,She,Columbus,per,,PRON,PROPN,nsubj,compound,PRP,NNP,4,1
1291,1285.0,55,suggests,4,12,16,4,11,38,-8,12,Iorga,Romania,,org,PROPN,PROPN,nsubj,nsubjpass,NNP,NNP,3,1
1292,1286.0,74,requested,29,15,28,13,14,45,14,-1,Grand Fleet,John Jellicoe,-,org-org,PROPN-PROPN,PROPN-PROPN,compound-pobj,compound-nsubj,NNP-NNP,NNP-NNP,8,1
1293,1287.0,14,received,1,7,9,2,6,4,-6,8,Assiut University,Egypt,-,org,PROPN-PROPN,PROPN,compound-compound,pobj,NNP-NNP,NNP,2,1
1294,1288.0,33,has,1,1,22,21,0,10,0,21,Darlinghurst,St. Pauls Lutheran,,org-org-org,PROPN,PROPN-PROPN-PROPN,nsubj,compound-compound-compound,NNP,NNP-NNP-NNP,4,1
1295,1289.0,26,was,7,7,24,17,6,1,0,17,Quixtar,IBOs,org,,PROPN,PROPN,nsubj,appos,NNP,NNP,8,1
1296,1290.0,37,secured,3,17,32,15,16,4,-14,29,Terry Hollands,England,-,org,PROPN-PROPN,PROPN,compound-conj,poss,NNP-NNP,NNP,9,1
1297,1291.0,33,brought,19,1,5,4,0,27,18,-14,Jean,Haiti,per,,PROPN,PROPN,nsubj,pobj,NNP,NNP,2,1
1298,1292.0,13,was,1,11,12,1,10,0,-10,11,France,Paul,per,,PROPN,PROPN,compound,pobj,NNP,NNP,2,1
1299,1293.0,30,made,2,1,16,15,0,13,1,14,Ryan Miller,USA,org-org,,PROPN-PROPN,PROPN,compound-nsubj,nsubj,NNP-NNP,NNP,3,1
1300,1294.0,39,boiled,7,11,21,10,10,17,-4,14,his,Navy,org,,DET,PROPN,poss,pobj,PRP$,NNP,5,1
1301,1295.0,23,said,6,5,9,4,4,13,1,3,Dieter Zetsche,Mercedes-Benz,org-org,,PROPN-PROPN,PROPN,compound-nsubj,compound,NNP-NNP,NNP,5,0
1302,1296.0,20,is,10,8,1,-7,7,18,2,-9,Nottingham,University of Nottingham,org,--,PROPN,PROPN-ADP-PROPN,compound,pobj-prep-pobj,NNP,NNP-IN-NNP,6,0
1303,1297.0,28,became,12,19,24,5,18,3,-7,12,George B. McClellan,Army of the Potomac,per-per-per,---,PROPN-PROPN-PROPN,PROPN-ADP-DET-PROPN,compound-compound-pobj,pobj-prep-det-pobj,NNP-NNP-NNP,NNP-IN-DT-NNP,6,0
1304,1298.0,20,is,6,1,17,16,0,2,5,11,Einhart Lorenz,University of Oslo,per-per,--,PROPN-PROPN,PROPN-ADP-PROPN,compound-nsubj,pobj-prep-pobj,NNP-NNP,NNP-IN-NNP,6,0
1305,1299.0,21,was,1,1,6,5,0,14,0,5,She,David Johansen,,per-per,PRON,PROPN-PROPN,nsubj,compound-pobj,PRP,NNP-NNP,3,0
1306,1300.0,25,met,1,13,14,1,12,10,-12,13,Japan,Emperor Taish?,per,-,PROPN,PROPN-NOUN,compound,compound-pobj,NNP,NNP-NN,1,0
1307,1301.0,34,is,3,21,33,12,20,0,-18,30,Baltimore Police Department,Colicchio,per-per-per,,PROPN-PROPN-PROPN,PROPN,compound-compound-pobj,conj,NNP-NNP-NNP,NNP,13,0
1308,1302.0,29,is,8,2,26,24,1,2,6,18,Lake Park High School,Roselle,---,org,PROPN-PROPN-PROPN-PROPN,PROPN,compound-compound-compound-pobj,compound,NNP-NNP-NNP-NNP,NNP,12,0
1309,1303.0,20,is,8,1,19,18,0,0,7,11,38 Canadian Brigade Group,Manitoba,---,org,NUM-PROPN-PROPN-PROPN,PROPN,nummod-compound-compound-nsubj,pobj,CD-NNP-NNP-NNP,NNP,3,0
1310,1304.0,52,offers,25,8,16,8,7,35,17,-9,art dealer,Arthur Dove,-,org-org,NOUN-NOUN,PROPN-PROPN,compound-conj,compound-compound,NN-NN,NNP-NNP,6,0
1311,1305.0,19,Justice,2,12,16,4,11,2,-10,14,Ed Bruce,MCA Records,-,org-org,PROPN-PROPN,PROPN-PROPN,compound-compound,compound-compound,NNP-NNP,NNP-NNPS,4,0
1312,1306.0,31,moved,15,15,24,9,14,6,0,9,Cash,Columbia,,per,PROPN,PROPN,nsubj,poss,NNP,NNP,6,0
1313,1307.0,21,went,3,6,10,4,5,10,-3,7,Gleason,Actress,,per,PROPN,PROPN,pobj,pobj,NNP,NNP,2,0
1314,1309.0,18,made,7,1,6,5,0,11,6,-1,Georgia,Eduard Shevardnadze,org,-,PROPN,PROPN-PROPN,poss,compound-nsubj,NNP,NNP-NNP,3,0
1315,1310.0,23,is,5,2,19,17,1,3,3,14,Fairbanks Alaska,University of Alaska Fairbanks,org-org,---,PROPN-PROPN,PROPN-ADP-PROPN-PROPN,compound-pobj,nmod-prep-pobj-pobj,NNP-NNP,NNP-IN-NNP-NNPS,10,0
1316,1311.0,18,aged,2,2,6,4,1,11,0,4,Gayoom,Asia,,per,PROPN,PROPN,nsubj,poss,NNP,NNP,4,0
1317,1312.0,15,was,3,5,14,9,4,0,-2,11,Central Nazarene College,1929,per-per-per,,PROPN-PROPN-PROPN,NUM,compound-compound-attr,pobj,NNP-NNP-NNP,CD,3,0
1318,1313.0,27,is,1,5,5,0,4,21,-4,4,Elgin,Elgin High School,per,--,PROPN,PROPN-PROPN-PROPN,compound,compound-compound-dobj,NNP,NNP-NNP-NNP,0,0
1319,1314.0,20,formed,6,5,10,5,4,9,1,4,India,2nd Punjab Regiment,per,--,PROPN,ADJ-PROPN-PROPN,pobj,amod-compound-pobj,NNP,JJ-NNP-NNP,4,0
1320,1315.0,29,continued,13,1,7,6,0,21,12,-6,Shelley Martel,Sudbury,org-org,,PROPN-PROPN,PROPN,compound-nsubj,compound,NNP-NNP,NNP,3,0
1321,1316.0,32,served,21,7,18,11,6,13,14,-3,her,PPP,,per,DET,PROPN,poss,appos,PRP$,NNP,7,0
1322,1317.0,16,is,1,1,9,8,0,6,0,8,Bookmarks,United States,,org-org,PROPN,PROPN-PROPN,nsubj,compound-pobj,NNP,NNP-NNP,4,0
1323,1318.0,29,was,7,15,26,11,14,2,-8,19,United States,William Howard Taft,per-per,--,PROPN-PROPN,PROPN-PROPN-PROPN,compound-pobj,compound-compound-pobj,NNP-NNP,NNP-NNP-NNP,8,0
1324,1319.0,37,covered,5,25,26,1,24,10,-20,21,producer,Nujabes,org,,NOUN,PROPN,pobj,nsubj,NN,NNP,1,0
1325,1320.0,16,is,8,1,12,11,0,3,7,4,Sibel,Turkish,,org,PROPN,ADJ,nsubj,amod,NNP,JJ,-1,0
1326,1321.0,41,struggled,16,20,32,12,19,8,-4,16,Greece,Venizelos,,org,PROPN,PROPN,poss,conj,NNP,NNP,6,0
1327,1322.0,34,become,12,3,8,5,2,25,9,-4,Andy Stern,Service Employees International Union,per-per,---,PROPN-PROPN,PROPN-PROPN-PROPN-PROPN,compound-compound,compound-compound-compound-pobj,NNP-NNP,NNP-NNPS-NNP-NNP,4,0
1328,1323.0,30,continued,2,7,13,6,6,16,-5,11,Jorma,Jefferson Airplane,per,-,PROPN,PROPN-PROPN,nsubj,compound-compound,NNP,NNP-NNP,5,0
1329,1324.0,23,seen,3,9,22,13,8,0,-6,19,Cashville,C-Bo,org,,PROPN,PROPN,compound,conj,NNP,NNP,11,0
1330,1325.0,38,appointed,5,10,17,7,9,20,-5,12,Sierra Leone,Albert Margai,-,per-per,PROPN-PROPN,PROPN-PROPN,compound-compound,compound-pobj,NNP-NNP,NNP-NNP,6,0
1331,1326.0,40,met,7,10,16,6,9,23,-3,9,Mali,Amadou Toumani,,per-per,PROPN,PROPN-PROPN,pobj,compound-pobj,NNP,NNP-NNP,5,0
1332,1327.0,16,is,1,1,10,9,0,5,0,9,Orsa,Sweden,per,,PROPN,PROPN,nsubj,pobj,NNP,NNP,3,0
1333,1328.0,32,was,5,9,17,8,8,14,-4,12,artist,Nelly,,per,NOUN,PROPN,attr,pobj,NN,NNP,5,0
1334,1329.0,24,is,6,16,18,2,15,5,-10,12,Suede,Brett Anderson,,org-org,PROPN,PROPN-PROPN,poss,compound-pobj,NNP,NNP-NNP,2,0
1335,1330.0,23,said,19,1,11,10,0,11,18,-8,Australia,John Howard,per,-,PROPN,PROPN-PROPN,poss,compound-pobj,NNP,NNP-NNP,4,0
1336,1331.0,26,annexed,14,18,23,5,17,2,-4,9,Northville School District,Novi,org-org-org,,PROPN-PROPN-PROPN,PROPN,compound-compound-pobj,compound,NNP-NNP-NNP,NNP,6,0
1337,1332.0,37,formed,2,23,33,10,22,3,-21,31,Applause,Lareine,,per,PROPN,PROPN,compound,poss,NNP,NNP,9,0
1338,1333.0,13,are,1,1,10,9,0,2,0,9,Desaster,Germany,org,,PROPN,PROPN,nsubj,pobj,NNP,NNP,5,0
1339,1334.0,28,became,4,11,17,6,10,10,-7,13,French,Gouin,,per,PROPN,PROPN,pobj,nsubj,NNP,NNP,6,0
1340,1336.0,20,was,1,4,9,5,3,10,-3,8,network,Red Sox,,per-per,NOUN,PROPN-PROPN,poss,compound-compound,NN,NNP-NNPS,5,0
1341,1337.0,62,Eds,0,38,41,3,37,20,-38,41,director,Ron Howard,,per-per,NOUN,PROPN-PROPN,appos,compound-compound,NN,NNP-NNP,5,0
1342,1338.0,33,served,2,5,19,14,4,13,-3,17,President,his,,per,PROPN,DET,pobj,poss,NNP,PRP$,4,0
1343,1339.0,33,announced,5,1,14,13,0,18,4,9,LSU,Baton Rouge,org,-,PROPN,PROPN-PROPN,nsubj,compound-pobj,NNP,NNP-NNP,6,0
1344,1340.0,19,directed,3,2,8,6,1,10,1,5,she,Pakistan,,per,PRON,PROPN,nsubjpass,compound,PRP,NNP,3,0
1345,1341.0,21,is,5,1,16,15,0,4,4,11,William Vacanarat Shadrach Tubman,Liberia,per-per-per-per,,PROPN-PROPN-PROPN-PROPN,PROPN,compound-compound-compound-compound,compound,NNP-NNP-NNP-NNP,NNP,5,0
1346,1342.0,41,increased,4,32,12,-20,31,28,-28,8,his,DPP,,per,DET,PROPN,poss,pobj,PRP$,NNP,9,0
1347,1343.0,25,Title,0,13,18,5,12,6,-13,18,University of Otago,Dunedin,per-per-per,,PROPN-ADP-PROPN,PROPN,appos-prep-compound,compound,NNP-IN-NNP,NNP,2,0
1348,1344.0,39,include,11,32,33,1,31,5,-21,22,DJ,Tim Westwood,org,-,PROPN,PROPN-PROPN,compound,compound-nsubj,NNP,NNP-NNP,1,0
1349,1345.0,21,is,7,2,20,18,1,0,5,13,Jagadish Chandra Bose,India,--,per,PROPN-PROPN-PROPN,PROPN,compound-compound-compound,pobj,NNP-NNP-NNP,NNP,9,0
1350,1346.0,63,absented,52,10,10,0,9,52,42,-42,James II of England,James,---,per,PROPN-PROPN-ADP-PROPN,PROPN,compound-nsubj-prep-pobj,pobj,NNP-NNP-IN-NNP,NNP,0,0
1351,1347.0,44,created,3,8,34,26,7,9,-5,31,University,Switzerland,org,,PROPN,PROPN,pobj,pobj,NNP,NNP,6,0
1352,1348.0,42,unmatched,13,8,11,3,7,30,5,-2,McKendree University,Lebanon,per-per,,PROPN-PROPN,PROPN,compound-nmod,pobj,NNP-NNP,NNP,1,0
1353,1349.0,16,is,4,1,1,0,0,14,3,-3,Irving Independent School District,Irving,per-per-per-per,,PROPN-PROPN-PROPN-PROPN,PROPN,compound-compound-compound-nsubj,compound,NNP-NNP-NNP-NNP,NNP,0,0
1354,1350.0,40,announces,7,4,6,2,3,33,3,-1,Prime Minister,John Major,per-per,-,PROPN-PROPN,PROPN-PROPN,compound-compound,compound-nsubj,NNP-NNP,NNP-NNP,1,0
1355,1351.0,23,written,3,9,20,11,8,2,-6,17,Jonathan Donahue,The Flaming Lips,org-org,--,PROPN-PROPN,DET-PROPN-PROPN,compound-pobj,det-compound-pobj,NNP-NNP,DT-NNP-NNPS,7,0
1356,1352.0,43,collaborated,3,23,24,1,22,18,-20,21,poet,Rod McKuen,,per-per,NOUN,PROPN-PROPN,compound,compound-pobj,NN,NNP-NNP,1,0
1357,1353.0,10,dropped,5,3,8,5,2,1,2,3,he,Interscope,org,,PRON,PROPN,nsubjpass,compound,PRP,NNP,3,0
1358,1354.0,74,played,1,14,28,14,13,45,-13,27,Chatichai Choonhavan,Thailand,per-per,,PROPN-PROPN,PROPN,compound-pobj,appos,NNP-NNP,NNP,-1,0
1359,1355.0,19,attempted,8,7,18,11,6,0,1,10,Wolsey,England,org,,PROPN,PROPN,nsubj,pobj,NNP,NNP,2,0
1360,1356.0,21,represent,6,1,11,10,0,9,5,5,His,Colorado,org,,DET,PROPN,poss,pobj,PRP$,NNP,5,0
1361,1357.0,19,expressed,4,3,16,13,2,2,1,12,Valdis Zatlers,Latvia,org-org,,PROPN-PROPN,PROPN,compound-nsubj,pobj,NNP-NNP,NNP,8,0
1362,1358.0,24,is,3,1,1,0,0,22,2,-2,Sydney Adventist College,Sydney,--,per,PROPN-PROPN-PROPN,PROPN,compound-compound-nsubj,compound,NNP-NNP-NNP,NNP,0,0
1363,1359.0,17,switched,3,9,12,3,8,4,-6,9,Abarth,Italy,,org,PROPN,PROPN,compound,pobj,NNP,NNP,3,0
1364,1360.0,19,aired,4,7,9,2,6,9,-3,5,France,Canal J,,per-per,PROPN,PROPN-PROPN,poss,compound-pobj,NNP,NNP-NNP,2,0
1365,1361.0,30,represents,7,2,21,19,1,8,5,14,Cornell University,Ithaca,per-per,,PROPN-PROPN,PROPN,compound-dobj,compound,NNP-NNP,NNP,12,0
1366,1362.0,35,run,7,3,19,16,2,15,4,12,Birmingham,St Edmund Campion Catholic School,per,----,PROPN,PROPN-PROPN-PROPN-PROPN-PROPN,compound,compound-compound-compound-compound-pobj,NNP,NNP-NNP-NNP-NNP-NNP,12,0
1367,1363.0,35,named,3,6,15,9,5,19,-3,12,Michael Anthony,Chicago,per-per,,PROPN-PROPN,PROPN,compound-compound,pobj,NNP-NNP,NNP,5,0
1368,1364.0,46,Fields,0,32,40,8,31,5,-32,40,Intercounty Baseball League,Brantford Red Sox,per-per-per,--,PROPN-PROPN-PROPN,PROPN-PROPN-PROPN,compound-compound-conj,compound-compound-ROOT,NNP-NNP-NNP,NNP-NNP-NNPS,3,0
1369,1365.0,27,was,1,1,16,15,0,10,0,15,She,London,per,,PRON,PROPN,nsubj,compound,PRP,NNP,2,0
1370,1366.0,22,receiving,3,1,7,6,0,14,2,4,He,Guangzhou,org,,PRON,PROPN,nsubj,compound,PRP,NNP,5,0
1371,1367.0,45,were,2,24,28,4,23,16,-22,26,Connecticut,Phil Maymin,org,-,PROPN,PROPN-PROPN,compound,compound-nmod,NNP,NNP-NNP,3,0
1372,1368.0,62,delivered,24,21,22,1,20,39,3,-2,director,Sam Raimi,,org-org,NOUN,PROPN-PROPN,dobj,compound-appos,NN,NNP-NNP,1,0
1373,1369.0,26,applied,7,21,25,4,20,0,-14,18,Milchan,Israel,org,,PROPN,PROPN,poss,pobj,NNP,NNP,3,0
1374,1370.0,13,prides,2,2,12,10,1,0,0,10,company,Croatia,,org,NOUN,PROPN,nsubj,pobj,NN,NNP,1,0
1375,1371.0,43,include,7,29,40,11,28,2,-22,33,China,Sun Yat-sen,per,-,PROPN,PROPN-PROPN,nmod,compound-conj,NNP,NNP-NNP,5,0
1376,1372.0,60,served,2,14,17,3,13,42,-12,15,Central Bank of Egypt,Egypt,org-org-org-org,,PROPN-PROPN-ADP-PROPN,PROPN,compound-pobj-prep-pobj,pobj,NNP-NNP-IN-NNP,NNP,7,0
1377,1374.0,32,were,2,15,26,11,14,5,-13,24,Jim Valentino,ShadowLine,per-per,,PROPN-PROPN,PROPN,compound-poss,ROOT,NNP-NNP,NNP,4,0
1378,1375.0,50,became,5,5,23,18,4,26,0,18,Monument,Dolly Parton,,per-per,PROPN,ADV-PROPN,pobj,compound-compound,NNP,RB-NNP,13,0
1379,1376.0,33,Yoder,2,10,14,4,9,18,-8,12,Eastern Mennonite University,Harrisonburg,--,per,PROPN-PROPN-PROPN,PROPN,compound-compound-pobj,compound,NNP-NNP-NNP,NNP,5,0
1380,1377.0,35,elected,3,22,28,6,21,6,-19,25,Quebec,Pierre Trudeau,per,-,PROPN,PROPN-PROPN,compound,compound-nsubj,NNP,NNP-NNP,5,0
1381,1378.0,25,defeated,8,6,23,17,5,1,2,15,CA,Stockwell Day,org,-,PROPN,PROPN-PROPN,compound,compound-conj,NNP,NNP-NNP,8,0
1382,1379.0,134,administer,2,7,16,9,6,117,-5,14,San Sebastian College - Recoletos,Manila,----,org,PROPN-PROPN-PROPN-PUNCT-PROPN,PROPN,compound-compound-compound-punct-pobj,pobj,NNP-NNP-NNP-HYPH-NNP,NNP,3,0
1383,1380.0,44,In,0,2,15,13,1,28,-2,15,Australia,Ajax,org,,PROPN,PROPN,pobj,compound,NNP,NNP,4,0
1384,1381.0,19,wrote,3,2,7,5,1,11,1,4,Ahmet Altan,Taraf,per-per,,PROPN-PROPN,PROPN,compound-nsubj,compound,NNP-NNP,NNP,3,0
1385,1382.0,39,pay,3,19,20,1,18,18,-16,17,President,Giorgio Napolitano,,org-org,PROPN,PROPN-PROPN,compound,compound-pobj,NNP,NNP-NNP,1,0
1386,1383.0,16,covered,4,7,15,8,6,0,-3,11,Paton,Netherlands,,per,PROPN,PROPN,pobj,pobj,NNP,NNP,5,0
1387,1384.0,106,is,6,32,37,5,31,68,-26,31,uests : Ahme,f Prime M,org-org-org,--,NOUN-PUNCT-PROPN,PROPN-PROPN-PROPN,ROOT-punct-nmod,det-compound-compound,NNS-:-NNP,NNP-NNP-NNP,4,0
1388,1385.0,49,moved,1,14,20,6,13,28,-13,19,West Coast Hockey League,Tacoma Sabercats,---,per-per,PROPN-PROPN-PROPN-PROPN,PROPN-PROPN,compound-compound-compound-pobj,compound-pobj,NNP-NNP-NNP-NNP,NNP-NNPS,4,0
1389,1386.0,25,thanked,10,6,9,3,5,15,4,-1,Russian,Mikhail Fradkov,org,-,ADJ,PROPN-PROPN,amod,compound-pobj,JJ,NNP-NNP,2,0
1390,1387.0,29,found,14,11,21,10,10,7,3,7,Jennifer Hudson,Chicago,org-org,,PROPN-PROPN,PROPN,compound-pobj,compound,NNP-NNP,NNP,7,0
1391,1388.0,31,born,5,1,4,3,0,26,4,-1,Robert Williams,Dunn,-,org,PROPN-PROPN,PROPN,compound-compound,nsubjpass,NNP-NNP,NNP,3,0
1392,1389.0,35,resigns,6,4,21,17,3,13,2,15,Albania,Fatos Nano,,org-org,PROPN,PROPN-PROPN,compound,compound-pobj,NNP,NNP-NNP,-1,0
1393,1390.0,22,became,1,1,17,16,0,4,0,16,Smith,model,,per,PROPN,NOUN,nsubj,attr,NNP,NN,5,0
1394,1391.0,23,is,3,15,21,6,14,1,-12,18,New England Conservatory,Boston,per-per-per,,PROPN-PROPN-PROPN,PROPN,compound-compound-pobj,compound,NNP-NNP-NNP,NNP,3,0
1395,1392.0,15,educated,3,6,9,3,5,5,-3,6,Charterhouse School,Surrey,per-per,,PROPN-PROPN,PROPN,compound-pobj,pobj,NNP-NNP,NNP,2,0
1396,1393.0,19,led,1,4,13,9,3,5,-3,12,Natural Law Party of Ontario,1993,org-org-org-org-org,,PROPN-PROPN-PROPN-ADP-PROPN,NUM,compound-compound-dobj-prep-pobj,pobj,NNP-NNP-NNP-IN-NNP,CD,3,0
1397,1394.0,113,posted,5,16,65,49,15,47,-11,60,Roseanne,Lanford,,per,PROPN,PROPN,pobj,compound,NNP,NNP,8,0
1398,1395.0,31,said,6,4,5,1,3,25,2,-1,Director,Rob Portman,per,-,PROPN,PROPN-PROPN,compound,compound-nsubj,NNP,NNP-NNP,1,0
1399,1396.0,14,has,8,1,5,4,0,8,7,-3,Kele Okereke,London,per-per,,PROPN-PROPN,PROPN,compound-nsubj,compound,NNP-NNP,NNP,3,0
1400,1397.0,14,Witter,1,1,13,12,0,0,0,12,Rick Witter,England,-,per,PROPN-PROPN,PROPN,compound-ROOT,pobj,NNP-NNP,NNP,2,0
1401,1398.0,27,is,3,12,24,12,11,2,-9,21,Ho Chi Minh,44; Viet,per-per-per,-,PROPN-PROPN-PROPN,NUM-PROPN,compound-compound-pobj,nummod-compound,NNP-NNP-NNP,CD-NNP,-1,0
1402,1399.0,19,dates,3,1,9,8,0,9,2,6,AIG,Cornelius Vander Starr,org,--,PROPN,PROPN-PROPN-PROPN,poss,compound-compound-nsubj,NNP,NNP-NNP-NNP,9,0
1403,1400.0,23,signed,1,1,14,13,0,8,0,13,Waltman,Kid,org,,NOUN,PROPN,nsubj,pobj,NN,NNP,3,0
1404,1401.0,39,went,2,1,33,32,0,5,1,31,Murray Melvin,actor,org-org,,PROPN-PROPN,NOUN,compound-nsubj,pobj,NNP-NNP,NN,13,0
1405,1402.0,38,met,8,10,14,4,9,23,-2,6,Algeria,Ahmed Ben Bella,per,--,PROPN,PROPN-PROPN-PROPN,poss,compound-compound-appos,NNP,NNP-NNP-NNP,3,0
1406,1403.0,16,is,2,1,10,9,0,5,1,8,Virgin Comics,Richard Branson,-,per-per,PROPN-PROPN,PROPN-PROPN,compound-nsubj,compound-compound,NNP-NNP,NNP-NNP,5,0
1407,1404.0,36,was,3,3,8,5,2,27,0,5,Bella,Algeria,per,,PROPN,PROPN,nsubj,pobj,NNP,NNP,1,0
1408,1405.0,18,president,2,7,8,1,6,9,-5,6,Slovakia,Michal,per,,PROPN,PROPN,compound,pobj,NNP,NNP,4,0
1409,1406.0,13,born,2,5,5,0,4,7,-3,3,Miami,Miami Southridge High School,per,---,PROPN,PROPN-PROPN-PROPN-PROPN,compound,compound-compound-compound-dobj,NNP,NNP-NNP-NNP-NNP,0,0
1410,1407.0,30,says,2,16,18,2,15,11,-14,16,U2,The Edge,org,-,PROPN,DET-PROPN,poss,det-conj,NNP,DT-NNP,2,0
1411,1408.0,10,founded,3,1,6,5,0,3,2,3,The Breakers,Copenhagen,per-per,,DET-PROPN,PROPN,det-nsubjpass,compound,DT-NNPS,NNP,3,0
1412,1409.0,18,moved,5,2,4,2,1,13,3,-1,Geelong,Reg Hickey,per,-,PROPN,PROPN-PROPN,compound,compound-nsubj,NNP,NNP-NNP,1,0
1413,1410.0,24,is,1,1,4,3,0,19,0,3,Bloom,2004,,per,NOUN,NUM,nsubj,nummod,NN,CD,2,0
1414,1412.0,20,is,4,2,12,10,1,7,2,8,National Safety Council,1913,per-per-per,,PROPN-PROPN-PROPN,NUM,compound-compound-nsubj,pobj,NNP-NNP-NNP,CD,3,0
1415,1413.0,37,said,17,7,16,9,6,20,10,-1,Pakistan,Benazir Bhutto,,per-per,PROPN,PROPN-PROPN,compound,compound-pobj,NNP,NNP-NNP,5,0
1416,1414.0,34,Born,0,10,12,2,9,21,-10,12,Southern Rhodesia,Smith,-,org,PROPN-PROPN,PROPN,compound-compound,nsubjpass,NNP-NNP,NNP,3,0
1417,1415.0,56,Given,0,52,53,1,51,2,-52,53,Defense,Charles Erwin Wilson,,per-per-per,PROPN,PROPN-PROPN-PROPN,pobj,compound-compound-conj,NNP,NNP-NNP-NNP,1,0
1418,1416.0,31,said,6,4,6,2,3,24,2,0,Costa Rica,Arias,per-per,,PROPN-PROPN,PROPN,compound-compound,pobj,NNP-NNP,NNP,4,0
1419,1417.0,21,ordered,11,8,9,1,7,11,3,-2,Defense,Frank Carlucci,,per-per,PROPN,PROPN-PROPN,pobj,compound-compound,NNP,NNP-NNP,2,0
1420,1418.0,48,mastered,3,42,46,4,41,1,-39,43,Monotreme,Barzin,org,,PROPN,PROPN,compound,appos,NNP,NNP,1,0
1421,1419.0,34,is,28,3,27,24,2,6,25,-1,Edun,Rogan Gregory,,per-per,PROPN,PROPN-PROPN,appos,compound-pobj,NNP,NNP-NNP,7,0
1422,1420.0,103,Countersigned,13,28,32,4,27,70,-15,19,Council,ALCIDE DE GASPERI,org,--,PROPN,PROPN-PROPN-PROPN,pobj,compound-compound-appos,NNP,NNP-NNP-NNP,5,0
1423,1421.0,21,built,3,1,18,17,0,2,2,15,Khost University,Shaikh Zayed University,-,per-per-per,PROPN-PROPN,PROPN-PROPN-PROPN,compound-nsubjpass,compound-compound-oprd,NNP-NNP,NNP-NNP-NNP,5,0
1424,1422.0,30,hosted,1,3,7,4,2,22,-2,6,Sierra Leone,Joseph Saidu Momoh,-,per-per-per,PROPN-PROPN,PROPN-PROPN-PROPN,compound-poss,compound-compound-dobj,NNP-NNP,NNP-NNP-NNP,3,0
1425,1423.0,21,showed,1,9,10,1,8,10,-8,9,manager,Chas Chandler,,per-per,NOUN,PROPN-PROPN,compound,compound-pobj,NN,NNP-NNP,2,0
1426,1424.0,25,formed,5,1,8,7,0,16,4,3,Fidelity National Information Services,February 1 2006,---,per-per-per,PROPN-PROPN-PROPN-PROPN,PROPN-NUM-NUM,compound-compound-compound-nsubjpass,pobj-nummod-nummod,NNP-NNP-NNP-NNPS,NNP-CD-CD,5,0
1427,1425.0,17,grew,1,5,5,0,4,11,-4,4,Valley Stream,Valley Stream South High School,-,per-per-per-per-per,PROPN-PROPN,PROPN-PROPN-PROPN-PROPN-PROPN,compound-compound,compound-compound-compound-compound-dobj,NNP-NNP,NNP-NNP-NNP-NNP-NNP,0,0
1428,1426.0,27,is,3,3,20,17,2,6,0,17,Bangladesh,A. Q. M. Badruddoza Chowdhury,,per-per-per-per-per,PROPN,PROPN-PROPN-PROPN-PROPN-PROPN,nsubj,compound-compound-compound-compound-appos,NNP,NNP-NNP-NNP-NNP-NNP,4,0
1429,1427.0,27,founded,8,6,10,4,5,16,2,2,Ulrich Kiesow,Fantasy Productions,org-org,-,PROPN-PROPN,PROPN-PROPN,compound-conj,compound-dobj,NNP-NNP,NNP-NNPS,4,0
1430,1428.0,26,elected,9,6,16,10,5,9,3,7,Franklin D. Roosevelt,President,--,per,PROPN-PROPN-PROPN,PROPN,compound-compound-pobj,pobj,NNP-NNP-NNP,NNP,7,0
1431,1429.0,42,function,4,20,22,2,19,19,-16,18,Vogue,1892,org,,PROPN,NUM,compound,nummod,NNP,CD,5,0
1432,1430.0,29,led,17,9,15,6,8,13,8,-2,Company,Henry H. Rogers,,per-per-per,PROPN,PROPN-PROPN-PROPN,conj,compound-compound-conj,NNP,NNP-NNP-NNP,4,0
1433,1431.0,38,founded,2,1,5,4,0,32,1,3,Fontbonne University,1923,-,per,PROPN-PROPN,NUM,compound-nsubj,pobj,NNP-NNP,CD,2,0
1434,1432.0,44,said,24,18,20,2,17,23,6,-4,Yu Zhengsheng,Shanghai,org-org,,PROPN-PROPN,PROPN,compound-compound,poss,NNP-NNP,NNP,3,0
1435,1433.0,25,inducted,5,4,22,18,3,2,1,17,Ramones,Tommy,,org,PROPN,PROPN,nsubjpass,oprd,NNPS,NNP,6,0
1436,1434.0,31,raised,2,1,22,21,0,8,1,20,He,England,,per,PRON,PROPN,nsubjpass,pobj,PRP,NNP,3,0
1437,1435.0,29,originated,2,8,26,18,7,2,-6,24,Afghanistan,Mohammed Zahir Shah,,org-org-org,PROPN,PROPN-PROPN-PROPN,pobj,compound-compound-pobj,NNP,NNP-NNP-NNP,9,0
1438,1436.0,31,created,7,2,3,1,1,27,5,-4,1994,North American Free Trade Agreement,per,----,NUM,PROPN-PROPN-PROPN-PROPN-PROPN,nummod,amod-compound-compound-compound-nsubj,CD,NNP-NNP-NNP-NNP-NNP,1,0
1439,1437.0,25,was,10,1,13,12,0,11,9,3,Xenophon Zolotas,Greek,org-org,,PROPN-PROPN,ADJ,compound-nsubj,amod,NNP-NNP,JJ,2,0
1440,1438.0,21,is,1,11,12,1,10,8,-10,11,composer,Frank Klepacki,org,-,NOUN,PROPN-PROPN,compound,compound-pobj,NN,NNP-NNP,1,0
1441,1439.0,25,said,10,1,4,3,0,20,9,-6,Jamaica,Bob Marley,org,-,PROPN,PROPN-PROPN,nsubj,compound-nmod,NNP,NNP-NNP,1,0
1442,1440.0,22,been,13,1,7,6,0,14,12,-6,Birdman,New Orleans,per,-,PROPN,PROPN-PROPN,nsubj,compound-pobj,NNP,NNP-NNP,5,0
1443,1441.0,35,told,8,7,10,3,6,24,1,2,Francesco Cossiga,Italy,-,per,PROPN-PROPN,PROPN,compound-nsubj,poss,NNP-NNP,NNP,4,0
1444,1442.0,37,recalled,11,1,5,4,0,31,10,-6,Paul Levitz,DC Comics,per-per,-,PROPN-PROPN,PROPN-PROPN,compound-nsubj,compound-pobj,NNP-NNP,NNP-NNPS,3,0
1445,1443.0,35,said,6,1,5,4,0,29,5,-1,Steve Capus,NBC,-,per,PROPN-PROPN,PROPN,compound-compound,compound,NNP-NNP,NNP,3,0
1446,1444.0,38,Cat,1,1,9,8,0,28,0,8,Super Cat,Jamaica,-,org,PROPN-PROPN,PROPN,compound-ROOT,pobj,NNP-NNP,NNP,3,0
1447,1445.0,29,grew,1,22,25,3,21,3,-21,24,Sonora Matancera,Cruz,per-per,,PROPN-PROPN,PROPN,compound-pobj,nsubj,NNP-NNP,NNP,1,0
1448,1446.0,31,formed,12,9,19,10,8,11,3,7,Canada,Churchill Cup,,per-per,PROPN,PROPN-PROPN,nsubj,compound-dobj,NNP,NNP-NNP,4,0
1449,1447.0,116,had,9,7,28,21,6,87,2,19,Spider loc,Compton,-,per,PROPN-NOUN,PROPN,conj-nsubj,pobj,NNP-NN,NNP,6,0
1450,1448.0,40,gives,11,7,23,16,6,16,4,12,Companies House,Kia Joorabchian,per-per,-,PROPN-PROPN,PROPN-PROPN,compound-pobj,compound-appos,NNPS-NNP,NNP-NNP,7,0
1451,1449.0,33,said,26,1,24,23,0,8,25,-2,Greece,Bank of Greece,per,--,PROPN,PROPN-ADP-PROPN,poss,nsubj-prep-pobj,NNP,NNP-IN-NNP,6,0
1452,1450.0,10,started,4,4,9,5,3,0,0,5,Germany,ProSieben,,org,PROPN,PROPN,nsubj,pobj,NNP,NNP,1,0
1453,1451.0,18,attended,9,6,11,5,5,6,3,2,Roanoke,William Fleming High School,,org-org-org-org,PROPN,PROPN-PROPN-PROPN-PROPN,pobj,compound-compound-compound-dobj,NNP,NNP-NNP-NNP-NNP,4,0
1454,1452.0,32,fetched,4,15,31,16,14,0,-11,27,Irving Berlin,lyricist,per-per,,PROPN-PROPN,NOUN,compound-compound,conj,NNP-NNP,NN,4,0
1455,1453.0,21,was,14,3,17,14,2,3,11,3,Lennart von Post,Swedish,--,per,PROPN-PROPN-PROPN,ADJ,compound-compound-nsubj,amod,NNP-NNP-NNP,JJ,3,0
1456,1454.0,33,was,8,1,14,13,0,18,7,6,Maamun al-Kuzbari,politician,-,org,PROPN-PROPN,NOUN,compound-nsubj,attr,NNP-NNP,NN,4,0
1457,1455.0,17,left,6,12,14,2,11,2,-6,8,NAIA,Malone University,per,-,PROPN,PROPN-PROPN,compound,compound-compound,NNP,NNP-NNP,2,0
1458,1456.0,34,On,0,9,26,17,8,7,-9,26,Mexico,Bravo,,per,PROPN,PROPN,compound,pobj,NNP,NNP,10,0
1459,1457.0,27,won,20,13,17,4,12,9,7,-3,Middle Country,Newfield High School,-,org-org-org,PROPN-PROPN,PROPN-PROPN-PROPN,compound-compound,compound-compound-pobj,NNP-NNP,NNP-NNP-NNP,4,0
1460,1458.0,30,invented,3,11,24,13,10,5,-8,21,Alfred,Sulzer,,org,PROPN,PROPN,pcomp,nmod,NNP,NNP,8,0
1461,1459.0,42,was,1,23,26,3,22,15,-22,25,Eugenia Charles,Dominica,-,org,PROPN-PROPN,PROPN,compound-pobj,pobj,NNP-NNP,NNP,3,0
1462,1460.0,30,lives,1,4,24,20,3,5,-3,23,Los Angeles,Otis College of Art and Design,per-per,-----,PROPN-PROPN,PROPN-PROPN-ADP-PROPN-CCONJ-PROPN,compound-pobj,compound-pobj-prep-pobj-cc-conj,NNP-NNP,NNP-NNP-IN-NNP-CC-NNP,9,0
1463,1462.0,24,came,5,14,16,2,13,7,-9,11,Columbia,Mellencamp,per,,PROPN,PROPN,compound,pobj,NNP,NNP,7,0
1464,1463.0,24,hailed,5,3,23,20,2,0,2,18,Levy Mwanawasa,Zambia,org-org,,PROPN-PROPN,PROPN,compound-nsubj,pobj,NNP-NNP,NNP,2,0
1465,1464.0,44,said,5,1,3,2,0,40,4,-2,Transport,Chan Kong Choy,,per-per-per,PROPN,PROPN-PROPN-PROPN,compound,compound-compound-nsubj,NNP,NNP-NNP-NNP,2,0
1466,1465.0,14,teaches,2,1,11,10,0,2,1,9,He,Rio de Janeiro,org,--,PRON,PROPN-PROPN-PROPN,nsubj,compound-compound-dobj,PRP,NNP-NNP-NNP,2,0
1467,1466.0,40,hired,10,18,32,14,17,7,-8,22,Division I,FAU,-,org,PROPN-PROPN,PROPN,pobj-dep,compound,NNP-NNP,NNP,8,0
1468,1467.0,11,is,5,4,10,6,3,0,1,5,Nat Benchley,actor,per-per,,PROPN-PROPN,NOUN,compound-nsubj,conj,NNP-NNP,NN,3,0
1469,1468.0,29,gave,2,16,28,12,15,0,-14,26,Tim Watson,Dimboola,-,org,PROPN-PROPN,PROPN,compound-pobj,pobj,NNP-NNP,NNP,5,0
1470,1469.0,27,known,4,1,21,20,0,5,3,17,Archie Comics,Louis Silberkleit,-,per-per,PROPN-PROPN,PROPN-PROPN,compound-nsubjpass,compound-appos,NNP-NNP,NNP-NNP,9,0
1471,1470.0,95,In,0,36,47,11,35,47,-36,47,Rabid Records,Slaughter The Dogs,-,per-per-per,PROPN-PROPN,PROPN-DET-PROPN,compound-oprd,pobj-det-appos,NNP-NNPS,NNP-DT-NNP,10,0
1472,1471.0,45,said,4,14,9,-5,13,35,-10,5,David Levy Yulee,Florida,per-per-per,,PROPN-PROPN-PROPN,PROPN,compound-compound-pobj,pobj,NNP-NNP-NNP,NNP,6,0
1473,1472.0,37,said,24,12,14,2,11,22,12,-10,Masayoshi Son,Softbank,-,per,PROPN-PROPN,PROPN,compound-compound,poss,NNP-NNP,NNP,2,0
1474,1473.0,17,founded,2,1,5,4,0,11,1,3,Pound,Rodrigo Bascunan,per,-,NOUN,PROPN-PROPN,nsubjpass,compound-compound,NN,NNP-NNP,4,0
1475,1475.0,23,is,18,1,22,21,0,0,17,4,Sharpton,minister,per,,ADJ,NOUN,compound,attr,JJ,NN,3,0
1476,1476.0,25,opened,16,1,24,23,0,0,15,8,Northside High School,1960,per-per-per,,PROPN-PROPN-PROPN,NUM,compound-compound-nsubj,nummod,NNP-NNP-NNP,CD,3,0
1477,1477.0,16,encountered,1,1,11,10,0,4,0,10,Lollipop,band,org,,PROPN,NOUN,nsubj,dobj,NNP,NN,2,0
1478,1478.0,32,is,5,16,25,9,15,6,-11,20,United States,Dial Global,org-org,-,PROPN-PROPN,PROPN-PROPN,compound-pobj,compound-poss,NNP-NNP,NNP-NNP,7,0
1479,1479.0,28,appointed,4,3,27,24,2,0,1,23,he,Greece,per,,PRON,PROPN,nsubjpass,pobj,PRP,NNP,2,0
1480,1480.0,22,is,2,13,16,3,12,5,-11,14,Katalyst,Sydney,,org,PROPN,PROPN,pobj,npadvmod,NNP,NNP,5,0
1481,1481.0,34,described,8,1,12,11,0,21,7,4,Sergio Garcia,Ryder,org-org,,PROPN-PROPN,PROPN,compound-nsubjpass,compound,NNP-NNP,NNP,4,0
1482,1482.0,19,says,6,3,18,15,2,0,3,12,Muqtada al-Sadr,Baghdad,-,org,PROPN-PROPN,PROPN,compound-poss,pobj,NNP-NNP,NNP,9,0
1483,1483.0,8,Moonves,1,1,6,5,0,1,0,5,Leslie Moonves,CBS,per-per,,PROPN-PROPN,PROPN,compound-ROOT,pobj,NNP-NNP,NNP,1,0
1484,1484.0,13,owns,2,1,12,11,0,0,1,10,Brewer,Oklahoma,org,,PROPN,PROPN,nsubj,pobj,NNP,NNP,5,0
1485,1485.0,29,visited,4,18,20,2,17,8,-14,16,Philippines,Lani Misalucha,,org-org,PROPN,PROPN-PROPN,conj,compound-pobj,NNPS,NNP-NNP,5,0
1486,1486.0,32,merged,21,2,2,0,1,29,19,-19,Helsinki,Helsinki School of Economics,,org-org-org-org,PROPN,PROPN-PROPN-ADP-PROPN,pobj,compound-appos-prep-pobj,NNP,NNP-NNP-IN-NNP,0,0
1487,1487.0,25,making,16,11,13,2,10,11,5,-3,Owerri,FUTO,per,,PROPN,PROPN,pobj,appos,NNP,NNP,4,0
1488,1488.0,54,contested,15,1,18,17,0,35,14,3,Barisan Nasional,Sarawak National Party,per-per,--,PROPN-PROPN,PROPN-PROPN-PROPN,compound-nsubj,compound-compound-pobj,NNP-NNP,NNP-NNP-NNP,5,0
1489,1489.0,35,are,1,31,34,3,30,0,-30,33,COSATU,1985,,org,NOUN,NUM,conj,nummod,NNS,CD,3,0
1490,1490.0,30,released,3,7,24,17,6,5,-4,21,Beenie Man,Kingston,per-per,,PROPN-PROPN,PROPN,compound-dobj,compound,NNP-NNP,NNP,4,0
1491,1491.0,46,known,7,2,2,0,1,43,5,-5,Croatia,Croatia national football team,,org-org-org-org,PROPN,PROPN-ADJ-NOUN-NOUN,dobj,nmod-amod-compound-pobj,NNP,NNP-JJ-NN-NN,0,0
1492,1492.0,47,include,5,5,14,9,4,32,0,9,Rome,John Cabot University,per,--,PROPN,PROPN-PROPN-PROPN,pobj,compound-compound-conj,NNP,NNP-NNP-NNP,3,0
1493,1493.0,17,is,4,1,13,12,0,3,3,9,iQue,Wei Yen,,per-per,PROPN,PROPN-PROPN,compound,compound-appos,NNP,NNP-NNP,5,0
1494,1494.0,10,is,2,1,7,6,0,2,1,5,Sara Gazarek,musician,-,org,PROPN-PROPN,NOUN,compound-nsubj,attr,NNP-NNP,NN,3,0
1495,1495.0,43,announced,7,2,14,12,1,28,5,7,Department of Justice,National Security Division,--,org-org-org,PROPN-ADP-PROPN,PROPN-PROPN-PROPN,nsubj-prep-pobj,compound-compound-nsubj,NNP-IN-NNP,NNP-NNP-NNP,6,0
1496,1496.0,11,ordered,7,1,7,6,0,3,6,0,Nicolas Sarkozy,Interior,org-org,,PROPN-PROPN,PROPN,compound-nsubj,pobj,NNP-NNP,NNP,1,0
1497,1497.0,26,represented,7,3,10,7,2,15,4,3,South Carolina,University of South Carolina,org-org,---,PROPN-PROPN,PROPN-ADP-PROPN-PROPN,compound-compound,dobj-prep-compound-pobj,NNP-NNP,NNP-IN-NNP-NNP,5,0
1498,1498.0,17,moved,3,3,7,4,2,9,0,4,he,Vancouver,per,,PRON,PROPN,nsubj,pobj,PRP,NNP,1,0
1499,1499.0,39,is,1,1,6,5,0,32,0,5,She,Donor Sibling Registry,,org-org-org,PRON,PROPN-PROPN-PROPN,nsubj,compound-compound-pobj,PRP,NNP-NNP-NNP,4,0
1500,1500.0,56,won,13,16,40,24,15,15,-3,27,South Atlantic League,Augusta GreenJackets,--,org-org,PROPN-PROPN-PROPN,PROPN-PROPN,compound-compound-compound,compound-dobj,NNP-NNP-NNP,NNP-NNP,5,0
1501,1501.0,20,began,2,1,18,17,0,1,1,16,William Gladstone,Prime Minister,org-org,-,PROPN-PROPN,PROPN-PROPN,compound-nsubj,compound-attr,NNP-NNP,NNP-NNP,5,0
1502,1502.0,25,founded,2,1,12,11,0,12,1,10,Intelius,Naveen Jain,per,-,PROPN,PROPN-PROPN,nsubjpass,compound-compound,NNP,NNP-NNP,4,0
1503,1503.0,12,grew,1,6,8,2,5,3,-5,7,London,Camden School for Girls,org,---,PROPN,PROPN-PROPN-ADP-PROPN,pobj,compound-dobj-prep-pobj,NNP,NNP-NNP-IN-NNP,1,0
1504,1504.0,64,redeem,3,41,60,19,40,3,-38,57,Oneworld,Japan Airlines,per,-,PROPN,PROPN-PROPN,compound,compound-ROOT,NNP,NNP-NNP,-1,0
1505,1505.0,21,Despite,0,9,20,11,8,0,-9,20,NCAA,VMI,org,,PROPN,PROPN,compound,conj,NNP,NNP,3,0
0,0.0,26,included,5,1,4,3,0,21,4,-1,Thom Yorke,Radiohead,per-per,,PROPN-PROPN,PROPN,compound-nsubj,pobj,NNP-NNP,NNP,2,1
1,1.0,26,is,3,1,15,14,0,10,2,12,Leland High School,San Jose,org-org-org,-,PROPN-PROPN-PROPN,PROPN-PROPN,compound-compound-nsubj,compound-compound,NNP-NNP-NNP,NNP-NNP,9,1
2,2.0,19,represented,6,3,13,10,2,5,3,7,Ohio University,NCAA,-,org,PROPN-PROPN,PROPN,compound-dobj,compound,NNP-NNP,NNP,4,1
3,8700.0,19,represented,6,3,13,10,2,5,3,7,Ohio University,NCAA,-,per,PROPN-PROPN,PROPN,compound-dobj,compound,NNP-NNP,NNP,4,1
4,3.0,22,is,4,1,18,17,0,3,3,14,Holy Cross High School,Congregation of Holy Cross,org-org-org-org,---,PROPN-PROPN-PROPN-PROPN,PROPN-ADP-PROPN-PROPN,compound-compound-compound-nsubj,pobj-prep-compound-pobj,NNP-NNP-NNP-NNP,NNP-IN-NNP-NNP,7,1
5,13953.0,34,is,5,2,16,14,1,17,3,11,Holy Cross High School,Congregation of Holy Cross,---,per-per-per-per,PROPN-PROPN-PROPN-PROPN,PROPN-ADP-PROPN-PROPN,compound-compound-compound-nsubj,pobj-prep-compound-pobj,NNP-NNP-NNP-NNP,NNP-IN-NNP-NNP,7,1
6,4.0,19,was,1,14,17,3,13,1,-13,16,Democratic,Bill Gwatney,,per-per,PROPN,PROPN-PROPN,compound,compound-attr,NNP,NNP-NNP,4,1
7,5.0,37,scored,5,1,5,4,0,31,4,0,Tunisia,Tunisair,,org,PROPN,PROPN,poss,appos,NNP,NNP,3,1
8,6.0,39,losers,4,4,20,16,3,18,0,16,RTS,Gazprom,org,,PROPN,PROPN,pobj,nsubj,NNP,NNP,4,1
9,7.0,12,founded,6,2,10,8,1,1,4,4,La Salle High School,Christian Brothers,org-org-org-org,-,PROPN-PROPN-PROPN-PROPN,PROPN-PROPN,compound-compound-compound-nsubjpass,compound-pobj,NNP-NNP-NNP-NNP,NNP-NNPS,4,1
10,8.0,40,is,4,9,19,10,8,20,-5,15,University of Southern California,USC University Hospital,org-org-org-org,--,PROPN-ADP-PROPN-PROPN,PROPN-PROPN-PROPN,pobj-prep-compound-pobj,compound-compound-pobj,NNP-IN-NNP-NNP,NNP-NNP-NNP,4,1
11,9.0,25,were,8,21,24,3,20,0,-13,16,Mitch McConnell,Kentucky,per-per,,PROPN-PROPN,PROPN,compound-appos,pobj,NNP-NNP,NNP,7,1
12,302.0,16,'re,1,4,10,6,3,5,-3,9,Mitch McConnell,Kentucky,-,org,PROPN-PROPN,PROPN,compound-nsubj,pobj,NNP-NNP,NNP,4,1
13,1053.0,37,said,14,17,20,3,16,16,-3,6,Mitch McConnell,Kentucky,-,org,PROPN-PROPN,PROPN,compound-nsubj,pobj,NNP-NNP,NNP,3,1
14,1119.0,38,used,22,2,7,5,1,30,20,-15,Mitch McConnell,Kentucky,-,per,PROPN-PROPN,PROPN,compound-nsubj,pobj,NNP-NNP,NNP,2,1
15,1309.0,49,headlining,13,3,6,3,2,42,10,-7,Mitch McConnell,Kentucky,-,org,PROPN-PROPN,PROPN,compound-nsubj,pobj,NNP-NNP,NNP,1,1
16,1903.0,36,were,15,4,7,3,3,28,11,-8,Mitch McConnell,Kentucky,-,per,PROPN-PROPN,PROPN,compound-nsubj,pobj,NNP-NNP,NNP,1,1
17,2715.0,29,was,6,12,28,16,11,0,-6,22,Mitch McConnell,Kentucky,org-org,,PROPN-PROPN,PROPN,compound-pobj,pobj,NNP-NNP,NNP,4,1
18,2863.0,26,denounced,8,5,8,3,4,17,3,0,Mitch McConnell,Kentucky,org-org,,PROPN-PROPN,PROPN,compound-appos,pobj,NNP-NNP,NNP,2,1
19,3113.0,14,says,5,2,5,3,1,8,3,0,Mitch McConnell,Kentucky,org-org,,PROPN-PROPN,PROPN,compound-nsubj,pobj,NNP-NNP,NNP,1,1
20,3734.0,33,won,6,5,14,9,4,18,1,8,Mitch McConnell,Kentucky,org-org,,PROPN-PROPN,PROPN,compound-nsubj,pobj,NNP-NNP,NNP,4,1
21,5443.0,46,refused,6,12,15,3,11,30,-6,9,Mitch McConnell,Kentucky,-,org,PROPN-PROPN,PROPN,compound-nmod,pobj,NNP-NNP,NNP,2,1
22,6945.0,34,said,15,21,33,12,20,0,-6,18,Mitch McConnell,Kentucky,-,org,PROPN-PROPN,PROPN,compound-nsubj,pobj,NNP-NNP,NNP,5,1
23,8026.0,57,WASHINGTON,0,46,49,3,45,7,-46,49,Mitch McConnell,Kentucky,per-per,,PROPN-PROPN,PROPN,compound-appos,pobj,NNP-NNP,NNP,2,1
24,8310.0,20,worry,3,8,19,11,7,0,-5,16,Mitch McConnell,Kentucky,-,org,PROPN-PROPN,PROPN,compound-appos,pobj,NNP-NNP,NNP,5,1
25,8435.0,35,said,25,28,31,3,27,3,-3,6,Mitch McConnell,Kentucky,-,per,PROPN-PROPN,PROPN,compound-nsubj,pobj,NNP-NNP,NNP,3,1
26,8785.0,29,are,24,2,5,3,1,23,22,-19,Mitch McConnell,Kentucky,-,per,PROPN-PROPN,PROPN,compound-nsubj,pobj,NNP-NNP,NNP,2,1
27,9242.0,27,kept,21,5,8,3,4,18,16,-13,Mitch McConnell,Kentucky,-,org,PROPN-PROPN,PROPN,compound-appos,pobj,NNP-NNP,NNP,1,1
28,9677.0,29,said,20,25,28,3,24,0,-5,8,Mitch McConnell,Kentucky,per-per,,PROPN-PROPN,PROPN,compound-nsubj,pobj,NNP-NNP,NNP,2,1
29,9687.0,41,created,6,24,27,3,23,13,-18,21,Mitch McConnell,Kentucky,-,per,PROPN-PROPN,PROPN,compound-pobj,pobj,NNP-NNP,NNP,1,1
30,9781.0,17,said,8,13,16,3,12,0,-5,8,Mitch McConnell,Kentucky,-,org,PROPN-PROPN,PROPN,compound-nsubj,pobj,NNP-NNP,NNP,3,1
31,10588.0,27,came,3,14,17,3,13,9,-11,14,Mitch McConnell,Kentucky,per-per,,PROPN-PROPN,PROPN,compound-pobj,pobj,NNP-NNP,NNP,2,1
32,10923.0,23,say,10,7,10,3,6,12,3,0,Mitch McConnell,Kentucky,per-per,,PROPN-PROPN,PROPN,compound-pobj,pobj,NNP-NNP,NNP,4,1
33,11324.0,46,received,23,15,18,3,14,27,8,-5,Mitch McConnell,Kentucky,-,org,PROPN-PROPN,PROPN,compound-nmod,pobj,NNP-NNP,NNP,7,1
34,12242.0,31,done,2,24,27,3,23,3,-22,25,Mitch McConnell,Kentucky,-,org,PROPN-PROPN,PROPN,compound-nsubj,pobj,NNP-NNP,NNP,3,1
35,12472.0,43,After,0,18,21,3,17,21,-18,21,Mitch McConnell,Kentucky,-,per,PROPN-PROPN,PROPN,compound-appos,pobj,NNP-NNP,NNP,9,1
36,12532.0,38,Democrat,7,16,19,3,15,18,-9,12,Mitch McConnell,Kentucky,-,per,PROPN-PROPN,PROPN,compound-conj,pobj,NNP-NNP,NNP,5,1
37,12626.0,23,married,3,5,13,8,4,9,-2,10,Mitch McConnell,Kentucky,-,per,PROPN-PROPN,PROPN,compound-dobj,pobj,NNP-NNP,NNP,4,1
38,12657.0,26,predicts,9,6,9,3,5,16,3,0,Mitch McConnell,Kentucky,-,per,PROPN-PROPN,PROPN,compound-nsubj,pobj,NNP-NNP,NNP,3,1
39,13313.0,21,said,11,8,11,3,7,9,3,0,Mitch McConnell,Kentucky,per-per,,PROPN-PROPN,PROPN,compound-pobj,pobj,NNP-NNP,NNP,4,1
40,10.0,12,hotheaded,3,6,9,3,5,2,-3,6,Woods,Arizona,per,,PROPN,PROPN,nsubj,compound,NNP,NNP,2,1
41,11.0,32,questioned,8,3,6,3,2,25,5,-2,Guyana,Bharrat Jagdeo,,per-per,PROPN,PROPN-PROPN,poss,compound-nsubj,NNP,NNP-NNP,3,1
42,1928.0,30,said,7,2,4,2,1,25,5,-3,Guyana,Bharrat Jagdeo,,per-per,PROPN,PROPN-PROPN,compound,compound-poss,NNP,NNP-NNP,1,1
43,5328.0,36,determine,26,9,12,3,8,23,17,-14,Guyana,Bharrat Jagdeo,,org-org,PROPN,PROPN-PROPN,poss,compound-pobj,NNP,NNP-NNP,2,1
44,6120.0,47,said,37,17,36,19,16,10,20,-1,Guyana,Bharrat Jagdeo,per,-,PROPN,PROPN-PROPN,nsubj,compound-nsubj,NNP,NNP-NNP,5,1
45,10941.0,32,said,1,19,22,3,18,9,-18,21,Guyana,Bharrat Jagdeo,,per-per,PROPN,PROPN-PROPN,poss,compound-appos,NNP,NNP-NNP,3,1
46,13077.0,27,turned,10,22,25,3,21,1,-12,15,Guyana,Bharrat Jagdeo,org,-,PROPN,PROPN-PROPN,poss,compound-conj,NNP,NNP-NNP,3,1
47,13646.0,31,was,10,12,14,2,11,16,-2,4,Guyana,Bharrat Jagdeo,per,-,PROPN,PROPN-PROPN,compound,compound-nsubj,NNP,NNP-NNP,1,1
48,12.0,21,affect,16,11,13,2,10,7,5,-3,Navy,Donald C. Winter,,per-per-per,PROPN,PROPN-PROPN-PROPN,compound,compound-compound-pobj,NNP,NNP-NNP-NNP,2,1
49,2032.0,28,said,2,7,9,2,6,18,-5,7,Navy,Donald C. Winter,org,--,PROPN,PROPN-PROPN-PROPN,compound,compound-compound-dobj,NNP,NNP-NNP-NNP,3,1
50,2085.0,12,become,1,7,9,2,6,2,-6,8,Navy,Donald C. Winter,per,--,PROPN,PROPN-PROPN-PROPN,compound,compound-compound-dobj,NNP,NNP-NNP-NNP,3,1
51,2226.0,29,said,3,18,26,8,17,2,-15,23,Navy,Donald C. Winter,per,--,PROPN,PROPN-PROPN-PROPN,compound,compound-compound-pobj,NNP,NNP-NNP-NNP,6,1
52,2477.0,31,announced,12,9,10,1,8,20,3,-2,Navy,Donald C. Winter,org,--,PROPN,PROPN-PROPN-PROPN,pobj,compound-compound-nsubj,NNP,NNP-NNP-NNP,2,1
53,3289.0,13,succeeded,2,8,10,2,7,2,-6,8,Navy,Donald C. Winter,per,--,PROPN,PROPN-PROPN-PROPN,pobj,compound-compound-pobj,NNP,NNP-NNP-NNP,2,1
54,6948.0,33,continued,4,2,30,28,1,2,2,26,Navy,Donald C. Winter,per,--,PROPN,PROPN-PROPN-PROPN,pobj,compound-compound-appos,NNP,NNP-NNP-NNP,5,1
55,7020.0,25,is,9,20,22,2,19,2,-11,13,Navy,Donald C. Winter,,org-org-org,PROPN,PROPN-PROPN-PROPN,compound,compound-compound-pobj,NNP,NNP-NNP-NNP,2,1
56,7307.0,28,named,2,10,11,1,9,16,-8,9,Navy,Donald C. Winter,per,--,PROPN,PROPN-PROPN-PROPN,pobj,compound-compound-pobj,NNP,NNP-NNP-NNP,2,1
57,7368.0,25,launched,2,20,22,2,19,2,-18,20,Navy,Donald C. Winter,org,--,PROPN,PROPN-PROPN-PROPN,compound,compound-compound-pobj,NNP,NNP-NNP-NNP,2,1
58,8871.0,17,went,2,8,9,1,7,7,-6,7,Navy,Donald C. Winter,,org-org-org,PROPN,PROPN-PROPN-PROPN,pobj,compound-compound-pobj,NNP,NNP-NNP-NNP,2,1
59,9267.0,26,succeeded,2,22,23,1,21,2,-20,21,Navy,Donald C. Winter,,per-per-per,PROPN,PROPN-PROPN-PROPN,pobj,compound-compound-pobj,NNP,NNP-NNP-NNP,2,1
60,9715.0,54,reads,12,9,10,1,8,43,3,-2,Navy,Donald C. Winter,per,--,PROPN,PROPN-PROPN-PROPN,pobj,compound-compound-pobj,NNP,NNP-NNP-NNP,2,1
61,10011.0,34,say,14,5,7,2,4,26,9,-7,Navy,Donald C. Winter,,per-per-per,PROPN,PROPN-PROPN-PROPN,compound,compound-compound-nsubj,NNP,NNP-NNP-NNP,2,1
62,10557.0,17,announced,5,1,3,2,0,13,4,-2,Navy,Donald C. Winter,org,--,PROPN,PROPN-PROPN-PROPN,compound,compound-compound-nsubj,NNP,NNP-NNP-NNP,2,1
63,10946.0,24,announced,16,11,13,2,10,10,5,-3,Navy,Donald C. Winter,,org-org-org,PROPN,PROPN-PROPN-PROPN,compound,compound-compound-pobj,NNP,NNP-NNP-NNP,2,1
64,11732.0,50,bless,2,18,19,1,17,30,-16,17,Navy,Donald C. Winter,per,--,PROPN,PROPN-PROPN-PROPN,pobj,compound-compound-nsubj,NNP,NNP-NNP-NNP,2,1
65,12336.0,45,sent,11,8,9,1,7,35,3,-2,Navy,Donald C. Winter,per,--,PROPN,PROPN-PROPN-PROPN,pobj,compound-compound-nsubj,NNP,NNP-NNP-NNP,2,1
66,13.0,19,was,5,1,4,3,0,14,4,-1,Jean Charest,Sherbrooke,per-per,,PROPN-PROPN,PROPN,compound-nsubj,compound,NNP-NNP,NNP,2,1
67,14.0,22,include,5,11,14,3,10,7,-6,9,Devon Energy,Oklahoma City,per-per,-,PROPN-PROPN,PROPN-PROPN,compound-dobj,compound-pobj,NNP-NNP,NNP-NNP,2,1
68,15.0,12,was,2,4,8,4,3,3,-2,6,Marilyn Churley,Ontario,per-per,,PROPN-PROPN,PROPN,compound-attr,compound,NNP-NNP,NNP,3,1
69,3943.0,30,is,2,1,25,24,0,4,1,23,Marilyn Churley,Ontario,-,per,PROPN-PROPN,PROPN,compound-nsubj,pobj,NNP-NNP,NNP,6,1
70,4615.0,42,held,5,8,19,11,7,22,-3,14,Marilyn Churley,Ontario,per-per,,PROPN-PROPN,PROPN,compound-pobj,pobj,NNP-NNP,NNP,4,1
71,16.0,25,described,15,15,17,2,14,7,0,2,Australia,Callea,,per,PROPN,PROPN,pobj,dobj,NNP,NNP,1,1
72,17.0,41,reached,10,24,24,0,23,16,-14,14,Oklahoma,Oklahoma City Community College,,org-org-org-org,PROPN,PROPN-PROPN-PROPN-PROPN,nmod,compound-compound-compound-conj,NNP,NNP-NNP-NNP-NNP,0,1
73,3160.0,26,take,4,17,17,0,16,8,-13,13,Oklahoma,Oklahoma City Community College,per,---,PROPN,PROPN-PROPN-PROPN-PROPN,pobj,compound-compound-compound-conj,NNP,NNP-NNP-NNP-NNP,0,1
74,18.0,71,attracted,4,29,30,1,28,40,-25,26,State,William L. Marcy,,per-per-per,PROPN,PROPN-PROPN-PROPN,pobj,compound-compound-pobj,NNP,NNP-NNP-NNP,2,1
75,2033.0,78,wrote,10,15,16,1,14,61,-5,6,State,William L. Marcy,per,--,PROPN,PROPN-PROPN-PROPN,pobj,compound-compound-pobj,NNP,NNP-NNP-NNP,2,1
76,8183.0,40,met,19,5,33,28,4,6,14,14,State,William L. Marcy,per,--,PROPN,PROPN-PROPN-PROPN,compound,compound-compound-poss,NNP,NNP-NNP-NNP,7,1
77,9552.0,52,re-elected,5,9,33,24,8,18,-4,28,State,William L. Marcy,,per-per-per,PROPN,PROPN-PROPN-PROPN,compound,compound-compound-dobj,NNP,NNP-NNP-NNP,7,1
78,9574.0,27,received,6,12,13,1,11,13,-6,7,State,William L. Marcy,org,--,PROPN,PROPN-PROPN-PROPN,pobj,compound-compound-pobj,NNP,NNP-NNP-NNP,2,1
79,19.0,18,named,9,1,8,7,0,9,8,-1,Shahjalal University of Science and Technology,Sylhet,org-org-org-org-org-org,,PROPN-PROPN-ADP-PROPN-CCONJ-PROPN,PROPN,compound-nsubjpass-prep-pobj-cc-conj,pobj,NNP-NNP-IN-NNP-CC-NNP,NNP,2,1
80,20.0,41,married,1,12,30,18,11,10,-11,29,lyricist,Irving Berlin,,per-per,NOUN,PROPN-PROPN,compound,compound-poss,NN,NNP-NNP,8,1
81,21.0,33,recorded,9,17,31,14,16,1,-8,22,Columbia,Bob Dylan,,per-per,PROPN,PROPN-PROPN,poss,compound-appos,NNP,NNP-NNP,12,1
82,22.0,23,joined,4,4,6,2,3,16,0,2,he,Phonak,,org,PRON,PROPN,nsubj,dobj,PRP,NNP,2,1
83,23.0,21,say,4,1,11,10,0,9,3,7,Al Sharpton,minister,per-per,,PROPN-PROPN,NOUN,compound-poss,poss,NNP-NNP,NN,8,1
84,12811.0,22,is,4,7,16,9,6,5,-3,12,Al Sharpton,minister,-,per,PROPN-PROPN,NOUN,compound-attr,pobj,NNP-NNP,NN,5,1
85,24.0,26,Except,0,3,9,6,2,16,-3,9,Algeria,Ahmed Ben Bella,,per-per-per,PROPN,PROPN-PROPN-PROPN,poss,compound-compound-nsubj,NNP,NNP-NNP-NNP,4,1
86,10928.0,51,With,0,25,40,15,24,10,-25,40,Algeria,Ahmed Ben Bella,per,--,PROPN,PROPN-PROPN-PROPN,pobj,compound-compound-pobj,NNP,NNP-NNP-NNP,8,1
87,12875.0,14,gained,1,1,7,6,0,6,0,6,Algeria,Ahmed Ben Bella,org,--,PROPN,PROPN-PROPN-PROPN,nsubj,compound-compound-pobj,NNP,NNP-NNP-NNP,3,1
88,25.0,20,signed,4,2,7,5,1,12,2,3,Erik Segerstedt,Sony BMG,per-per,-,PROPN-PROPN,PROPN-PROPN,compound-nsubj,compound-pobj,NNP-NNP,NNP-NNP,3,1
89,26.0,39,formed,2,5,10,5,4,28,-3,8,Timeless Books,1978,org-org,,PROPN-PROPN,NUM,compound-compound,pobj,NNP-NNP,CD,4,1
90,27.0,29,is,11,2,10,8,1,18,9,-1,Southern African Clothing and Textile Workers Union,SACTWU,org-org-org-org-org-org-org,,ADJ-PROPN-PROPN-CCONJ-PROPN-PROPN-PROPN,PROPN,amod-compound-pobj-cc-compound-compound-conj,nsubj,JJ-NNP-NNP-CC-NNP-NNPS-NNP,NNP,3,1
91,28.0,23,moved,1,5,21,16,4,1,-4,20,USA,Liberty University,,org-org,PROPN,PROPN-PROPN,pobj,compound-pobj,NNP,NNP-NNP,4,1
92,29.0,20,told,4,1,3,2,0,16,3,-1,Interior,Giuliano Amato,,per-per,PROPN,PROPN-PROPN,compound,compound-nsubj,NNP,NNP-NNP,1,1
93,84.0,29,reported,2,6,8,2,5,20,-4,6,Interior,Giuliano Amato,,per-per,PROPN,PROPN-PROPN,compound,compound-nsubj,NNP,NNP-NNP,1,1
94,491.0,30,said,4,1,3,2,0,26,3,-1,Interior,Giuliano Amato,,per-per,PROPN,PROPN-PROPN,compound,compound-nsubj,NNP,NNP-NNP,1,1
95,905.0,28,congratulated,5,2,4,2,1,23,3,-1,Interior,Giuliano Amato,org,-,PROPN,PROPN-PROPN,compound,compound-nsubj,NNP,NNP-NNP,1,1
96,2570.0,32,expressed,4,1,3,2,0,28,3,-1,Interior,Giuliano Amato,,org-org,PROPN,PROPN-PROPN,compound,compound-nsubj,NNP,NNP-NNP,1,1
97,3386.0,20,trained,10,4,6,2,3,13,6,-4,Interior,Giuliano Amato,org,-,PROPN,PROPN-PROPN,compound,compound-pobj,NNP,NNP-NNP,1,1
98,3684.0,17,took,2,13,15,2,12,1,-11,13,Interior,Giuliano Amato,,org-org,PROPN,PROPN-PROPN,compound,compound-conj,NNP,NNP-NNP,4,1
99,4602.0,15,said,13,10,12,2,9,2,3,-1,Interior,Giuliano Amato,,org-org,PROPN,PROPN-PROPN,compound,compound-pobj,NNP,NNP-NNP,1,1
100,4673.0,18,slammed,4,1,3,2,0,14,3,-1,Interior,Giuliano Amato,,org-org,PROPN,PROPN-PROPN,compound,compound-nsubj,NNP,NNP-NNP,1,1
101,4902.0,27,said,4,1,3,2,0,23,3,-1,Interior,Giuliano Amato,per,-,PROPN,PROPN-PROPN,compound,compound-nsubj,NNP,NNP-NNP,1,1
102,6183.0,22,claimed,5,2,4,2,1,17,3,-1,Interior,Giuliano Amato,,org-org,PROPN,PROPN-PROPN,compound,compound-nsubj,NNP,NNP-NNP,1,1
103,7423.0,40,decapitated,5,30,32,2,29,7,-25,27,Interior,Giuliano Amato,per,-,PROPN,PROPN-PROPN,compound,compound-nsubj,NNP,NNP-NNP,1,1
104,10558.0,27,warned,18,15,17,2,14,9,3,-1,Interior,Giuliano Amato,,per-per,PROPN,PROPN-PROPN,compound,compound-nsubj,NNP,NNP-NNP,2,1
105,11037.0,38,met,4,1,3,2,0,34,3,-1,Interior,Giuliano Amato,,per-per,PROPN,PROPN-PROPN,compound,compound-nsubj,NNP,NNP-NNP,1,1
106,11645.0,37,said,34,31,33,2,30,3,3,-1,Interior,Giuliano Amato,per,-,PROPN,PROPN-PROPN,compound,compound-nsubj,NNP,NNP-NNP,9,1
107,11926.0,48,reported,5,2,4,2,1,43,3,-1,Interior,Giuliano Amato,,per-per,PROPN,PROPN-PROPN,compound,compound-nsubj,NNP,NNP-NNP,1,1
108,12076.0,36,been,2,32,34,2,31,1,-30,32,Interior,Giuliano Amato,per,-,PROPN,PROPN-PROPN,compound,compound-appos,NNP,NNP-NNP,1,1
109,12243.0,38,said,4,1,3,2,0,34,3,-1,Interior,Giuliano Amato,,per-per,PROPN,PROPN-PROPN,compound,compound-nsubj,NNP,NNP-NNP,1,1
110,13896.0,18,signed,3,8,10,2,7,7,-5,7,Interior,Giuliano Amato,org,-,PROPN,PROPN-PROPN,compound,compound-pobj,NNP,NNP-NNP,1,1
111,14020.0,29,indicated,5,2,4,2,1,24,3,-1,Interior,Giuliano Amato,per,-,PROPN,PROPN-PROPN,compound,compound-nsubj,NNP,NNP-NNP,1,1
112,30.0,46,lay,4,13,18,5,12,27,-9,14,Angola,Agostinho Neto,,per-per,PROPN,PROPN-PROPN,poss,compound-appos,NNP,NNP-NNP,3,1
113,11041.0,48,placed,1,11,16,5,10,31,-10,15,Angola,Agostinho Neto,org,-,PROPN,PROPN-PROPN,poss,compound-appos,NNP,NNP-NNP,3,1
114,31.0,24,done,4,18,22,4,17,1,-14,18,US Airways Group,PSA Airlines,org-org-org,-,PROPN-PROPN-PROPN,PROPN-PROPN,compound-compound-compound,compound-dobj,NNP-NNP-NNP,NNP-NNPS,3,1
115,32.0,20,was,1,7,11,4,6,8,-6,10,Smith College,Massachusetts,org-org,,PROPN-PROPN,PROPN,compound-pobj,pobj,NNP-NNP,NNP,4,1
116,5736.0,22,studied,2,13,17,4,12,4,-11,15,Smith College,Massachusetts,-,per,PROPN-PROPN,PROPN,compound-pobj,pobj,NNP-NNP,NNP,3,1
117,33.0,35,broadcast,3,23,26,3,22,8,-20,23,Kimberly Williams-Paisley,Brad Paisley,per-per,-,PROPN-PROPN,PROPN-PROPN,compound-conj,compound-poss,NNP-NNP,NNP-NNP,8,1
118,34.0,19,left,5,2,15,13,1,3,3,10,Ayaka,Japan,per,,PROPN,PROPN,nsubj,pobj,NNP,NNP,5,1
119,35.0,39,minister,4,2,9,7,1,29,2,5,Iceland,Geir Haarde,,per-per,PROPN,PROPN-PROPN,poss,compound-nsubj,NNP,NNP-NNP,6,1
120,1462.0,28,formed,7,6,17,11,5,10,1,10,Iceland,Geir Haarde,,per-per,PROPN,PROPN-PROPN,pobj,compound-pobj,NNP,NNP-NNP,5,1
121,2275.0,14,called,6,2,5,3,1,8,4,-1,Iceland,Geir Haarde,org,-,PROPN,PROPN-PROPN,compound,compound-nsubj,NNP,NNP-NNP,2,1
122,2619.0,35,determine,7,10,28,18,9,6,-3,21,Iceland,Geir Haarde,org,-,PROPN,PROPN-PROPN,poss,compound-pobj,NNP,NNP-NNP,9,1
123,2770.0,33,closed,2,5,13,8,4,19,-3,11,Iceland,Geir Haarde,per,-,PROPN,PROPN-PROPN,poss,compound-poss,NNP,NNP-NNP,7,1
124,3612.0,36,referred,9,1,6,5,0,29,8,-3,Iceland,Geir Haarde,,per-per,PROPN,PROPN-PROPN,poss,compound-nsubjpass,NNP,NNP-NNP,3,1
125,5552.0,38,In,0,11,16,5,10,21,-11,16,Iceland,Geir Haarde,,org-org,PROPN,PROPN-PROPN,pobj,compound-nsubj,NNP,NNP-NNP,4,1
126,7912.0,26,said,6,1,5,4,0,20,5,-1,Iceland,Geir Haarde,org,-,PROPN,PROPN-PROPN,poss,compound-nsubj,NNP,NNP-NNP,3,1
127,8775.0,42,visited,3,3,23,20,2,18,0,20,Iceland,Geir Haarde,,per-per,PROPN,PROPN-PROPN,pobj,compound-conj,NNP,NNP-NNP,5,1
128,8824.0,13,visited,8,6,7,1,5,5,2,-1,Iceland,Geir Haarde,per,-,PROPN,PROPN-PROPN,pobj,compound-nsubj,NNP,NNP-NNP,1,1
129,9324.0,12,defiant,5,1,4,3,0,7,4,-1,Iceland,Geir Haarde,org,-,PROPN,PROPN-PROPN,poss,compound-nsubj,NNP,NNP-NNP,4,1
130,9948.0,16,refers,3,1,6,5,0,9,2,3,Iceland,Geir Haarde,per,-,PROPN,PROPN-PROPN,poss,compound-dobj,NNP,NNP-NNP,5,1
131,10764.0,28,told,16,1,15,14,0,12,15,-1,Iceland,Geir Haarde,per,-,PROPN,PROPN-PROPN,poss,compound-nsubj,NNP,NNP-NNP,5,1
132,10938.0,33,threw,5,1,4,3,0,28,4,-1,Iceland,Geir Haarde,,org-org,PROPN,PROPN-PROPN,compound,compound-nsubj,NNP,NNP-NNP,2,1
133,11776.0,33,said,6,1,5,4,0,27,5,-1,Iceland,Geir Haarde,org,-,PROPN,PROPN-PROPN,poss,compound-nsubj,NNP,NNP-NNP,3,1
134,11932.0,28,met,3,11,12,1,10,15,-8,9,Iceland,Geir Haarde,per,-,PROPN,PROPN-PROPN,pobj,compound-pobj,NNP,NNP-NNP,1,1
135,12029.0,26,said,7,1,5,4,0,20,6,-2,Iceland,Geir Haarde,org,-,PROPN,PROPN-PROPN,poss,compound-appos,NNP,NNP-NNP,3,1
136,12280.0,63,said,14,1,5,4,0,57,13,-9,Iceland,Geir Haarde,org,-,PROPN,PROPN-PROPN,poss,compound-nsubj,NNP,NNP-NNP,3,1
137,12633.0,27,protested,6,1,5,4,0,21,5,-1,Iceland,Geir Haarde,org,-,PROPN,PROPN-PROPN,poss,compound-appos,NNP,NNP-NNP,3,1
138,13684.0,18,visited,8,4,7,3,3,10,4,-1,Iceland,Geir Haarde,org,-,PROPN,PROPN-PROPN,compound,compound-nsubj,NNP,NNP-NNP,2,1
139,36.0,15,represents,5,2,2,0,1,12,3,-3,Baylor Bears,Baylor University,-,org-org,PROPN-VERB,PROPN-PROPN,compound-compound,compound-nmod,NNP-VBZ,NNP-NNP,0,1
140,8966.0,18,represented,6,3,3,0,2,14,3,-3,Baylor Bears,Baylor University,per-per,-,PROPN-PROPN,PROPN-PROPN,compound-compound,compound-dobj,NNP-NNP,NNP-NNP,0,1
141,37.0,32,Droop-E,0,13,31,18,12,0,-13,31,California,E-40,,per,PROPN,PROPN,pobj,punct,NNP,NNP,8,1
142,38.0,21,led,9,1,5,4,0,15,8,-4,Moore,England,per,,PROPN,PROPN,poss,compound,NNP,NNP,4,1
143,6800.0,41,been,2,12,18,6,11,22,-10,16,Moore,England,per,,PROPN,PROPN,appos,pobj,NNP,NNP,3,1
144,39.0,112,thumb,2,28,44,16,27,67,-26,42,Thailand,Thammasat University,,org-org,PROPN,PROPN-PROPN,pobj,compound-pobj,NNP,NNP-NNP,6,1
145,40.0,29,made,5,1,9,8,0,19,4,4,Gome,Huang Guangyu,org,-,PROPN,PROPN-PROPN,poss,compound-appos,NNP,NNP-NNP,5,1
146,5690.0,46,appointed,3,6,28,22,5,17,-3,25,Gome,Huang Guangyu,org,-,PROPN,PROPN-PROPN,compound,compound-nsubjpass,NNP,NNP-NNP,6,1
147,41.0,34,provided,2,29,32,3,28,1,-27,30,Iran,Sadeq Hedayat,,per-per,PROPN,PROPN-PROPN,pobj,compound-appos,NNP,NNP-NNP,1,1
148,5980.0,76,said,21,7,12,5,6,63,14,-9,Iran,Sadeq Hedayat,,org-org,PROPN,PROPN-PROPN,poss,compound-compound,NNP,NNP-NNP,4,1
149,42.0,31,plagued,3,1,12,11,0,18,2,9,Ford,Henry,org,,PROPN,PROPN,nsubjpass,compound,NNP,NNP,5,1
150,43.0,49,nicknamed,7,2,2,0,1,46,5,-5,Trinidad and Tobago national football team,Trinidad and Tobago,org-org-org-org-org-org,--,PROPN-CCONJ-PROPN-ADJ-NOUN-NOUN,PROPN-CCONJ-PROPN,nsubj-cc-nmod-amod-compound-conj,pobj-cc-conj,NNP-CC-NNP-JJ-NN-NN,NNP-CC-NNP,0,1
151,44.0,28,founded,2,7,8,1,6,19,-5,6,Washington,Jefferson College,,org-org,PROPN,PROPN-PROPN,compound,compound-pobj,NNP,NNP-NNP,1,1
152,45.0,34,intended,8,2,3,1,1,30,6,-5,Kentucky,Mitch McConnell,,per-per,PROPN,PROPN-PROPN,pobj,compound-nmod,NNP,NNP-NNP,1,1
153,569.0,46,said,7,20,42,22,19,3,-13,35,Kentucky,Mitch McConnell,,org-org,PROPN,PROPN-PROPN,pobj,compound-pobj,NNP,NNP-NNP,10,1
154,1511.0,28,forget,3,8,22,14,7,5,-5,19,Kentucky,Mitch McConnell,org,-,PROPN,PROPN-PROPN,compound,compound-conj,NNP,NNP-NNP,9,1
155,3286.0,41,was,8,17,28,11,16,12,-9,20,Kentucky,Mitch McConnell,per,-,PROPN,PROPN-PROPN,pobj,compound-poss,NNP,NNP-NNP,-1,1
156,3329.0,26,routed,7,11,21,10,10,4,-4,14,Kentucky,Mitch McConnell,,org-org,PROPN,PROPN-PROPN,poss,compound-poss,NNP,NNP-NNP,5,1
157,3580.0,28,1A,1,15,24,9,14,3,-14,23,Kentucky,Mitch McConnell,per,-,PROPN,PROPN-PROPN,poss,compound-pobj,NNP,NNP-NNP,4,1
158,4416.0,28,hosted,11,2,8,6,1,19,9,-3,Kentucky,Mitch McConnell,per,-,PROPN,PROPN-PROPN,nsubj,compound-dobj,NNP,NNP-NNP,5,1
159,7979.0,25,was,1,7,17,10,6,7,-6,16,Kentucky,Mitch McConnell,org,-,PROPN,PROPN-PROPN,poss,compound-pobj,NNP,NNP-NNP,8,1
160,9352.0,55,suggested,34,28,52,24,27,2,6,18,Kentucky,Mitch McConnell,,per-per,PROPN,PROPN-PROPN,compound,compound-conj,NNP,NNP-NNP,11,1
161,12605.0,22,said,8,1,3,2,0,18,7,-5,Kentucky,Mitch McConnell,,org-org,PROPN,PROPN-PROPN,compound,compound-nsubj,NNP,NNP-NNP,1,1
162,13416.0,43,is,12,9,29,20,8,13,3,17,Kentucky,Mitch McConnell,,per-per,PROPN,PROPN-PROPN,poss,compound-pobj,NNP,NNP-NNP,8,1
163,13859.0,28,called,5,8,14,6,7,13,-3,9,Kentucky,Mitch McConnell,,per-per,PROPN,PROPN-PROPN,compound,compound-conj,NNP,NNP-NNP,1,1
164,46.0,20,is,2,1,11,10,0,8,1,9,NetObjects,Samir Arora,org,-,PROPN,PROPN-PROPN,compound,compound-compound,NNP,NNP-NNP,7,1
165,47.0,26,stated,15,18,24,6,17,1,-3,9,Young Buck,G-Unit,per-per,,PROPN-PROPN,PROPN,compound-nsubjpass,compound,NNP-NNP,NNP,4,1
166,209.0,16,addressed,3,1,10,9,0,5,2,7,Young Buck,G-Unit,-,org,PROPN-PROPN,PUNCT,compound-nsubj,punct,NNP-NNP,.,6,1
167,4469.0,69,released,5,27,44,17,26,24,-22,39,Young Buck,G-Unit,per-per,,PROPN-PROPN,PROPN,compound-nsubj,punct,NNP-NNP,NNP,11,1
168,5862.0,38,On,0,21,29,8,20,8,-21,29,Young Buck,G-Unit,-,org,PROPN-PROPN,PROPN,compound-nsubj,punct,NNP-NNP,NNP,6,1
169,8351.0,38,release,7,5,10,5,4,27,2,3,Young Buck,G-Unit,-,org,PROPN-PROPN,PROPN,compound-nsubj,punct,NNP-NNP,NNP,4,1
170,8539.0,27,assured,2,21,25,4,20,1,-19,23,Young Buck,G-Unit,org-org,,PROPN-PROPN,INTJ,compound-appos,punct,NNP-NNP,UH,3,1
171,8972.0,25,returned,4,10,16,6,9,8,-6,12,Young Buck,G-Unit,per-per,,PROPN-PROPN,PROPN,compound-dative,pobj,NNP-NNP,NNP,5,1
172,48.0,20,taught,2,9,13,4,8,6,-7,11,Metropolitan State College of Denver,Denver,org-org-org-org-org,,PROPN-PROPN-PROPN-ADP-PROPN,PROPN,compound-compound-pobj-prep-pobj,pobj,NNP-NNP-NNP-IN-NNP,NNP,2,1
173,4384.0,29,Title,0,12,16,4,11,12,-12,16,Metropolitan State College of Denver,Denver,per-per-per-per-per,,PROPN-PROPN-PROPN-ADP-PROPN,PROPN,compound-compound-ROOT-prep-pobj,compound,NNP-NNP-NNP-IN-NNP,NNP,4,1
174,49.0,21,is,10,1,16,15,0,4,9,6,Fernando Trueba,screenwriter,per-per,,PROPN-PROPN,NOUN,compound-nsubj,compound,NNP-NNP,NN,4,1
175,50.0,41,occurred,6,12,20,8,11,20,-6,14,Russell Investments,Tacoma,org-org,,PROPN-PROPN,PROPN,compound-nsubj,pobj,NNP-NNP,NNP,2,1
176,51.0,17,formed,4,2,7,5,1,9,2,3,2ZY Orchestra,1922,org-org,,NUM-PROPN,NUM,nummod-nsubjpass,pobj,CD-NNP,CD,2,1
177,52.0,53,know,6,19,36,17,18,16,-13,30,Tom Bradley,California,per-per,,PROPN-PROPN,PROPN,nsubj-advcl,compound,NNP-NNP,NNP,7,1
178,53.0,30,unveiled,16,4,12,8,3,17,12,-4,George Washington,Continental Army,per-per,-,PROPN-PROPN,PROPN-PROPN,compound-nsubj,compound-pobj,NNP-NNP,NNP-NNP,5,1
179,800.0,25,is,3,5,16,11,4,8,-2,13,George Washington,Continental Army,per-per,-,PROPN-PROPN,PROPN-PROPN,compound-attr,compound-pobj,NNP-NNP,NNP-NNP,5,1
180,1457.0,33,creates,5,4,26,22,3,6,1,21,George Washington,Continental Army,-,org-org,PROPN-PROPN,PROPN-PROPN,compound-nsubj,compound-pobj,NNP-NNP,NNP-NNP,7,1
181,1539.0,20,used,8,15,18,3,14,1,-7,10,George Washington,Continental Army,-,per-per,PROPN-PROPN,PROPN-PROPN,compound-poss,compound-pobj,NNP-NNP,NNP-NNP,1,1
182,2101.0,41,was,5,36,39,3,35,1,-31,34,George Washington,Continental Army,org-org,-,PROPN-PROPN,PROPN-PROPN,compound-poss,compound-pobj,NNP-NNP,NNP-NNP,3,1
183,2846.0,42,said,3,15,19,4,14,22,-12,16,George Washington,Continental Army,per-per,-,PROPN-PROPN,PROPN-PROPN,compound-pobj,compound-conj,NNP-NNP,NNP-NNP,1,1
184,3014.0,38,organized,6,21,25,4,20,12,-15,19,George Washington,Continental Army,-,org-org,PROPN-PROPN,PROPN-PROPN,compound-nsubj,compound-dobj,NNP-NNP,NNP-NNP,2,1
185,3165.0,22,traveled,3,7,11,4,6,10,-4,8,George Washington,Continental Army,-,per-per,PROPN-PROPN,PROPN-PROPN,compound-pobj,compound-conj,NNP-NNP,NNP-NNP,1,1
186,3971.0,19,is,4,13,17,4,12,1,-9,13,George Washington,Continental Army,per-per,-,PROPN-PROPN,PROPN-PROPN,compound-nsubj,compound-dobj,NNP-NNP,NNP-NNP,1,1
187,4064.0,32,hosts,2,24,29,5,23,2,-22,27,George Washington,Continental Army,org-org,-,PROPN-PROPN,PROPN-PROPN,compound-nsubj,compound-compound,NNP-NNP,NNP-NNP,2,1
188,4095.0,19,used,3,2,10,8,1,8,1,7,George Washington,Continental Army,-,per-per,PROPN-PROPN,PROPN-PROPN,compound-nsubj,compound-compound,NNP-NNP,NNP-NNP,4,1
189,4204.0,30,became,4,10,15,5,9,14,-6,11,George Washington,Continental Army,per-per,-,PROPN-PROPN,PROPN-PROPN,compound-compound,compound-pobj,NNP-NNP,NNP-NNP,3,1
190,5313.0,32,Washington,1,1,21,20,0,10,0,20,George Washington,Continental Army,-,org-org,PROPN-PROPN,PROPN-PROPN,compound-ROOT,compound-dobj,NNP-NNP,NNP-NNP,2,1
191,6553.0,43,_,8,23,30,7,22,12,-15,22,George Washington,Continental Army,-,per-per,PROPN-PROPN,PROPN-PROPN,compound-nsubj,compound-compound,NNP-NNP,NNP-NNP,5,1
192,6837.0,35,elected,17,3,11,8,2,23,14,-6,George Washington,Continental Army,-,org-org,PROPN-PROPN,PROPN-PROPN,compound-pobj,compound-pobj,NNP-NNP,NNP-NNP,3,1
193,8173.0,39,features,7,22,26,4,21,12,-15,19,George Washington,Continental Army,org-org,-,PROPN-PROPN,PROPN-PROPN,compound-nsubj,compound-conj,NNP-NNP,NNP-NNP,3,1
194,8376.0,16,unit,1,6,9,3,5,6,-5,8,George Washington,Continental Army,per-per,-,PROPN-PROPN,PROPN-PROPN,compound-poss,compound-compound,NNP-NNP,NNP-NNP,2,1
195,9131.0,38,covers,2,7,32,25,6,5,-5,30,George Washington,Continental Army,per-per,-,PROPN-PROPN,PROPN-PROPN,compound-pobj,compound-dobj,NNP-NNP,NNP-NNP,11,1
196,9455.0,15,Dec.,0,6,13,7,5,1,-6,13,George Washington,Continental Army,-,org-org,PROPN-PROPN,PROPN-PROPN,compound-nsubj,compound-pobj,NNP-NNP,NNP-NNP,4,1
197,9684.0,53,felt,37,2,17,15,1,35,35,-20,George Washington,Continental Army,-,per-per,PROPN-PROPN,PROPN-PROPN,compound-nsubj,compound-compound,NNP-NNP,NNP-NNP,7,1
198,11575.0,20,was,1,9,18,9,8,1,-8,17,George Washington,Continental Army,org-org,-,PROPN-PROPN,PROPN-PROPN,compound-nsubj,compound-pobj,NNP-NNP,NNP-NNP,7,1
199,11606.0,31,was,9,25,29,4,24,1,-16,20,George Washington,Continental Army,-,per-per,PROPN-PROPN,PROPN-PROPN,compound-pobj,compound-conj,NNP-NNP,NNP-NNP,1,1
200,12900.0,31,believed,2,8,21,13,7,9,-6,19,George Washington,Continental Army,-,org-org,PROPN-PROPN,PROPN-PROPN,compound-dobj,compound-dobj,NNP-NNP,NNP-NNP,5,1
201,14117.0,29,created,3,6,17,11,5,11,-3,14,George Washington,Continental Army,per-per,-,PROPN-PROPN,PROPN-PROPN,compound-pobj,compound-compound,NNP-NNP,NNP-NNP,6,1
202,54.0,41,requires,9,2,26,24,1,14,7,17,Australia,Australian Securities and Investments Commission,,org-org-org-org-org,PROPN,PROPN-PROPN-CCONJ-PROPN-PROPN,pobj,nmod-nmod-cc-conj-pobj,NNP,NNP-NNPS-CC-NNPS-NNP,11,1
203,55.0,48,included,4,13,15,2,12,32,-9,11,Zambia,Levy Mwanawasa,,per-per,PROPN,PROPN-PROPN,pobj,compound-ROOT,NNP,NNP-NNP,1,1
204,422.0,37,served,1,6,13,7,5,23,-5,12,Zambia,Levy Mwanawasa,,org-org,PROPN,PROPN-PROPN,pobj,compound-pobj,NNP,NNP-NNP,6,1
205,2105.0,19,held,5,1,15,14,0,3,4,10,Zambia,Levy Mwanawasa,per,-,PROPN,PROPN-PROPN,poss,compound-pobj,NNP,NNP-NNP,8,1
206,5475.0,27,opened,4,17,18,1,16,8,-13,14,Zambia,Levy Mwanawasa,org,-,PROPN,PROPN-PROPN,compound,compound-pobj,NNP,NNP-NNP,1,1
207,10543.0,32,founded,16,6,11,5,5,20,10,-5,Zambia,Levy Mwanawasa,,per-per,PROPN,PROPN-PROPN,pobj,compound-pobj,NNP,NNP-NNP,6,1
208,13606.0,55,said,1,41,50,9,40,4,-40,49,Zambia,Levy Mwanawasa,per,-,PROPN,PROPN-PROPN,nsubj,compound-nsubj,NNP,NNP-NNP,6,1
209,56.0,36,said,34,1,3,2,0,32,33,-31,Health,Chua Soi Lek,,per-per-per,PROPN,PROPN-PROPN-PROPN,compound,compound-compound-nsubj,NNP,NNP-NNP-NNP,2,1
210,740.0,35,told,6,2,4,2,1,30,4,-2,Health,Chua Soi Lek,,org-org-org,PROPN,PROPN-PROPN-PROPN,compound,compound-compound-nsubj,NNP,NNP-NNP-NNP,2,1
211,803.0,14,spread,4,8,10,2,7,3,-4,6,Health,Chua Soi Lek,per,--,PROPN,PROPN-PROPN-PROPN,compound,compound-compound-nsubj,NNP,NNP-NNP-NNP,2,1
212,1135.0,34,asked,6,1,3,2,0,30,5,-3,Health,Chua Soi Lek,,per-per-per,PROPN,PROPN-PROPN-PROPN,compound,compound-compound-nsubj,NNP,NNP-NNP-NNP,2,1
213,3008.0,30,tested,3,24,26,2,23,3,-21,23,Health,Chua Soi Lek,per,--,PROPN,PROPN-PROPN-PROPN,compound,compound-compound-nsubj,NNP,NNP-NNP-NNP,2,1
214,3644.0,42,said,32,37,39,2,36,2,-5,7,Health,Chua Soi Lek,,per-per-per,PROPN,PROPN-PROPN-PROPN,compound,compound-compound-pobj,NNP,NNP-NNP-NNP,2,1
215,4830.0,18,seen,6,1,3,2,0,14,5,-3,Health,Chua Soi Lek,org,--,PROPN,PROPN-PROPN-PROPN,compound,compound-compound-nsubjpass,NNP,NNP-NNP-NNP,2,1
216,5204.0,35,said,14,1,3,2,0,31,13,-11,Health,Chua Soi Lek,,per-per-per,PROPN,PROPN-PROPN-PROPN,compound,compound-compound-nsubj,NNP,NNP-NNP-NNP,2,1
217,5406.0,30,said,5,1,3,2,0,26,4,-2,Health,Chua Soi Lek,per,--,PROPN,PROPN-PROPN-PROPN,compound,compound-compound-nsubj,NNP,NNP-NNP-NNP,2,1
218,6327.0,34,quoted,3,6,8,2,5,25,-3,5,Health,Chua Soi Lek,per,--,PROPN,PROPN-PROPN-PROPN,compound,compound-compound-dobj,NNP,NNP-NNP-NNP,2,1
219,7679.0,22,proposed,8,4,6,2,3,15,4,-2,Health,Chua Soi Lek,per,--,PROPN,PROPN-PROPN-PROPN,compound,compound-compound-nsubj,NNP,NNP-NNP-NNP,2,1
220,9173.0,28,overtaken,3,19,21,2,18,6,-16,18,Health,Chua Soi Lek,org,--,PROPN,PROPN-PROPN-PROPN,compound,compound-compound-nsubj,NNP,NNP-NNP-NNP,2,1
221,9645.0,43,made,3,28,30,2,27,12,-25,27,Health,Chua Soi Lek,per,--,PROPN,PROPN-PROPN-PROPN,compound,compound-compound-nsubjpass,NNP,NNP-NNP-NNP,2,1
222,11029.0,43,looks,3,30,32,2,29,10,-27,29,Health,Chua Soi Lek,org,--,PROPN,PROPN-PROPN-PROPN,compound,compound-compound-nsubjpass,NNP,NNP-NNP-NNP,2,1
223,11045.0,26,advised,10,18,23,5,17,2,-8,13,Health,Chua Soi Lek,per,--,PROPN,PROPN-PROPN-PROPN,compound,compound-compound-pobj,NNP,NNP-NNP-NNP,3,1
224,11481.0,24,increasing,8,15,17,2,14,6,-7,9,Health,Chua Soi Lek,per,--,PROPN,PROPN-PROPN-PROPN,compound,compound-compound-nsubjpass,NNP,NNP-NNP-NNP,2,1
225,12901.0,32,said,6,2,4,2,1,27,4,-2,Health,Chua Soi Lek,per,--,PROPN,PROPN-PROPN-PROPN,compound,compound-compound-nsubj,NNP,NNP-NNP-NNP,2,1
226,13604.0,40,said,38,10,12,2,9,27,28,-26,Health,Chua Soi Lek,,per-per-per,PROPN,PROPN-PROPN-PROPN,compound,compound-compound-dobj,NNP,NNP-NNP-NNP,2,1
227,14181.0,29,said,5,1,3,2,0,25,4,-2,Health,Chua Soi Lek,per,--,PROPN,PROPN-PROPN-PROPN,compound,compound-compound-nsubj,NNP,NNP-NNP-NNP,2,1
228,57.0,31,was,1,1,7,6,0,23,0,6,He,Quebec,per,,PRON,PROPN,nsubj,pobj,PRP,NNP,1,1
229,7593.0,31,was,1,1,7,6,0,23,0,6,He,Quebec,per,,PRON,PROPN,nsubj,compound,PRP,NNP,1,1
230,58.0,35,said,31,6,8,2,5,26,25,-23,Bank of Canada,Canada,org-org-org,,PROPN-ADP-PROPN,PROPN,pobj-prep-pobj,nsubj,NNP-IN-NNP,NNP,2,1
231,1064.0,38,located,18,4,15,11,3,22,14,-3,Bank of Canada,Canada,--,org,PROPN-ADP-PROPN,PROPN,nmod-prep-pobj,pobj,NNP-IN-NNP,NNP,5,1
232,59.0,37,began,1,9,21,12,8,15,-8,20,Volkswagen,Wolfsburg,org,,PROPN,PROPN,poss,pobj,NNP,NNP,4,1
233,7284.0,15,located,6,5,13,8,4,1,1,7,Volkswagen,Wolfsburg,,per,PROPN,PROPN,pobj,compound,NNP,NNP,5,1
234,60.0,36,born,3,24,31,7,23,4,-21,28,Catherine of Valois,Henry,per-per-per,,PROPN-ADP-PROPN,PROPN,conj-prep-pobj,compound,NNP-IN-NNP,NNP,5,1
235,5981.0,61,was,1,19,30,11,18,30,-18,29,Catherine of Valois,Henry,--,org,PROPN-ADP-PROPN,PROPN,nsubj-prep-pobj,compound,NNP-IN-NNP,NNP,5,1
236,13422.0,32,was,6,4,20,16,3,11,2,14,Catherine of Valois,Henry,--,org,PROPN-ADP-PROPN,PROPN,nsubj-prep-pobj,compound,NNP-IN-NNP,NNP,7,1
237,61.0,32,set,15,3,11,8,2,20,12,-4,Dawn Hicks,University of South Alabama,-,org-org-org-org,PROPN-PROPN,PROPN-ADP-PROPN-PROPN,compound-compound,nmod-prep-compound-pobj,NNP-NNP,NNP-IN-NNP-NNP,5,1
238,62.0,20,ended,6,11,19,8,10,0,-5,13,Yasuo Fukuda,Japan,per-per,,PROPN-PROPN,PROPN,compound-nsubj,pobj,NNP-NNP,NNP,3,1
239,268.0,20,set,8,6,12,6,5,7,2,4,Yasuo Fukuda,Japan,-,org,PROPN-PROPN,PROPN,compound-nsubjpass,poss,NNP-NNP,NNP,6,1
240,63.0,30,moved,8,24,27,3,23,2,-16,19,Eduard Limonov,National Bolshevik Party,-,org-org-org,PROPN-PROPN,PROPN-PROPN-PROPN,compound-poss,compound-compound-pobj,NNP-NNP,NNP-NNP-NNP,2,1
241,4331.0,27,was,1,5,16,11,4,10,-4,15,Eduard Limonov,National Bolshevik Party,-,org-org-org,PROPN-PROPN,PROPN-PROPN-PROPN,compound-pobj,compound-compound-pobj,NNP-NNP,NNP-NNP-NNP,6,1
242,64.0,15,married,1,8,11,3,7,3,-7,10,Canadian Alliance,Stockwell Day,org-org,-,PROPN-PROPN,PROPN-PROPN,compound-compound,compound-pobj,NNP-NNP,NNP-NNP,2,1
243,3749.0,28,was,4,9,26,17,8,1,-5,22,Canadian Alliance,Stockwell Day,org-org,-,PROPN-PROPN,PROPN-PROPN,compound-dobj,compound-pobj,NNP-NNP,NNP-NNP,7,1
244,6086.0,15,married,1,8,11,3,7,3,-7,10,Canadian Alliance,Stockwell Day,org-org,-,PROPN-PROPN,PROPN-PROPN,compound-compound,compound-pobj,NNP-NNP,NNP-NNP,2,1
245,6946.0,40,declined,30,26,29,3,25,10,4,-1,Canadian Alliance,Stockwell Day,per-per,-,PROPN-PROPN,PROPN-PROPN,compound-compound,compound-nsubj,NNP-NNP,NNP-NNP,4,1
246,10421.0,32,report,1,15,18,3,14,13,-14,17,Canadian Alliance,Stockwell Day,-,per-per,PROPN-PROPN,PROPN-PROPN,compound-compound,compound-pobj,NNP-NNP,NNP-NNP,2,1
247,12047.0,29,reluctance,1,22,27,5,21,1,-21,26,Canadian Alliance,Stockwell Day,-,per-per,PROPN-PROPN,PROPN-PROPN,compound-pobj,compound-pobj,NNP-NNP,NNP-NNP,12,1
248,12519.0,26,appeared,8,21,24,3,20,1,-13,16,Canadian Alliance,Stockwell Day,org-org,-,PROPN-PROPN,PROPN-PROPN,compound-compound,compound-pobj,NNP-NNP,NNP-NNP,4,1
249,13692.0,31,joined,2,5,21,16,4,9,-3,19,Canadian Alliance,Stockwell Day,org-org,-,PROPN-PROPN,PROPN-PROPN,compound-dative,compound-pobj,NNP-NNP,NNP-NNP,6,1
250,14000.0,40,came,2,25,31,6,24,8,-23,29,Canadian Alliance,Stockwell Day,-,per-per,PROPN-PROPN,PROPN-PROPN,compound-appos,compound-pobj,NNP-NNP,NNP-NNP,3,1
251,65.0,27,Nordavia,1,8,25,17,7,1,-7,24,Aeroflot-Nord,Arkhangelsk,org,,PROPN,PROPN,pobj,compound,NNP,NNP,11,1
252,66.0,20,is,3,11,18,7,10,1,-8,15,Sri Lanka,Ceylinco Consolidated,-,org-org,PROPN-PROPN,PROPN-PROPN,compound-pobj,compound-pobj,NNP-NNP,NNP-NNP,5,1
253,67.0,26,said,24,3,4,1,2,21,21,-20,BMW,Mini,org,,PROPN,PROPN,compound,pobj,NNP,NNP,1,1
254,10480.0,33,said,1,1,9,8,0,23,0,8,BMW,Mini,,per,PROPN,PROPN,nsubj,dobj,NNP,NNP,7,1
255,68.0,23,is,2,10,16,6,9,6,-8,14,Bill Clinton,Hillary Rodham Clinton,-,per-per-per,PROPN-PROPN,PROPN-PROPN-PROPN,compound-appos,compound-compound-conj,NNP-NNP,NNP-NNP-NNP,2,1
256,4242.0,41,reports,3,13,21,8,12,19,-10,18,Bill Clinton,Hillary Rodham Clinton,-,org-org-org,PROPN-PROPN,PROPN-PROPN-PROPN,compound-nsubj,compound-compound-appos,NNP-NNP,NNP-NNP-NNP,2,1
257,69.0,19,Hall,1,7,12,5,6,6,-6,11,South Dakota State University,Brookings,org-org-org-org,,PROPN-PROPN-PROPN-PROPN,PROPN,compound-compound-compound-pobj,pobj,NNP-NNP-NNP-NNP,NNP,5,1
258,70.0,42,described,33,29,32,3,28,9,4,-1,Meherazad,Eruch Jessawala,,per-per,PROPN,PROPN-PROPN,pobj,compound-nsubj,NNP,NNP-NNP,8,1
259,71.0,25,Singh,1,1,24,23,0,0,0,23,Malkit Singh,Punjab,per-per,,PROPN-PROPN,PROPN,compound-ROOT,pobj,NNP-NNP,NNP,1,1
260,72.0,24,is,12,2,15,13,1,8,10,3,Ministry of Transport,e New Zealan,org-org-org,--,PROPN-ADP-PROPN,PROPN-PROPN-PROPN,nsubj-prep-pobj,det-nmod-subtok,NNP-IN-NNP,NNP-NNP-NNP,4,1
261,73.0,28,played,8,1,5,4,0,22,7,-3,Cambodia,Hun Sen,,per-per,PROPN,PROPN-PROPN,poss,compound-nsubj,NNP,NNP-NNP,3,1
262,969.0,18,accompany's,3,5,9,4,4,8,-2,6,Cambodia,Hun Sen,org,-,PROPN,PROPN-PROPN,poss,compound-dobj,NNP,NNP-NNP,2,1
263,2931.0,33,been,6,3,22,19,2,10,3,16,Cambodia,Hun Sen,per,-,PROPN,PROPN-PROPN,pobj,compound-nsubj,NNP,NNP-NNP,7,1
264,6561.0,47,threatened,29,10,25,15,9,21,19,-4,Cambodia,Hun Sen,,per-per,PROPN,PROPN-PROPN,pobj,compound-nsubj,NNP,NNP-NNP,3,1
265,7399.0,44,told,23,18,22,4,17,21,5,-1,Cambodia,Hun Sen,per,-,PROPN,PROPN-PROPN,poss,compound-pobj,NNP,NNP-NNP,2,1
266,8411.0,29,recognized,3,10,16,6,9,12,-7,13,Cambodia,Hun Sen,org,-,PROPN,PROPN-PROPN,pobj,compound-compound,NNP,NNP-NNP,3,1
267,9824.0,30,said,6,1,5,4,0,24,5,-1,Cambodia,Hun Sen,org,-,PROPN,PROPN-PROPN,poss,compound-nsubj,NNP,NNP-NNP,3,1
268,11979.0,26,said,23,1,15,14,0,10,22,-8,Cambodia,Hun Sen,org,-,PROPN,PROPN-PROPN,nsubj,compound-pobj,NNP,NNP-NNP,5,1
269,13078.0,38,chosen,5,15,21,6,14,16,-10,16,Cambodia,Hun Sen,per,-,PROPN,PROPN-PROPN,pobj,compound-nsubj,NNP,NNP-NNP,4,1
270,74.0,24,bailed,2,12,19,7,11,4,-10,17,Pakistan,Nawaz Sharif,,per-per,PROPN,PROPN-PROPN,poss,compound-dobj,NNP,NNP-NNP,9,1
271,114.0,37,Minister,3,8,14,6,7,22,-5,11,Pakistan,Nawaz Sharif,,per-per,PROPN,PROPN-PROPN,compound,compound-nsubj,NNP,NNP-NNP,4,1
272,1285.0,38,Pakistan,1,2,7,5,1,30,-1,6,Pakistan,Nawaz Sharif,per,-,PROPN,PROPN-PROPN,ROOT,compound-nsubj,NNP,NNP-NNP,3,1
273,3614.0,42,On,0,4,11,7,3,30,-4,11,Pakistan,Nawaz Sharif,per,-,PROPN,PROPN-PROPN,compound,compound-nsubj,NNP,NNP-NNP,4,1
274,4970.0,25,said,8,2,5,3,1,19,6,-3,Pakistan,Nawaz Sharif,,org-org,PROPN,PROPN-PROPN,amod,compound-nsubj,NNP,NNP-NNP,2,1
275,5031.0,130,advised,16,13,35,22,12,94,3,19,Pakistan,Nawaz Sharif,org,-,PROPN,PROPN-PROPN,pobj,compound-pobj,NNP,NNP-NNP,12,1
276,5085.0,60,consists,1,9,40,31,8,19,-8,39,Pakistan,Nawaz Sharif,,per-per,PROPN,PROPN-PROPN,compound,compound-compound,NNP,NNP-NNP,11,1
277,6653.0,49,Q,6,3,28,25,2,20,3,22,Pakistan,Nawaz Sharif,per,-,PROPN,PROPN-PROPN,compound,compound-pobj,NNP,NNP-NNP,9,1
278,8615.0,40,held,6,1,5,4,0,34,5,-1,Pakistan,Nawaz Sharif,org,-,PROPN,PROPN-PROPN,poss,compound-nsubj,NNP,NNP-NNP,3,1
279,9581.0,67,covered,2,9,29,20,8,37,-7,27,Pakistan,Nawaz Sharif,,org-org,PROPN,PROPN-PROPN,compound,compound-pobj,NNP,NNP-NNP,-1,1
280,9996.0,34,won,2,19,32,13,18,1,-17,30,Pakistan,Nawaz Sharif,per,-,PROPN,PROPN-PROPN,compound,compound-pobj,NNP,NNP-NNP,8,1
281,10137.0,28,started,18,6,17,11,5,10,12,-1,Pakistan,Nawaz Sharif,org,-,PROPN,PROPN-PROPN,poss,compound-nsubj,NNP,NNP-NNP,9,1
282,10610.0,17,urges,3,1,9,8,0,7,2,6,Pakistan,Nawaz Sharif,,per-per,PROPN,PROPN-PROPN,poss,compound-dobj,NNP,NNP-NNP,5,1
283,10769.0,45,wrote,14,9,4,-5,8,40,5,-10,Pakistan,Nawaz Sharif,,org-org,PROPN,PROPN-PROPN,compound,compound-conj,NNP,NNP-NNP,6,1
284,11801.0,36,founded,10,4,30,26,3,5,6,20,Pakistan,Nawaz Sharif,,per-per,PROPN,PROPN-PROPN,compound,compound-nsubj,NNP,NNP-NNP,5,1
285,13631.0,26,reported,24,7,8,1,6,17,17,-16,Pakistan,Nawaz Sharif,,per-per,PROPN,PROPN-PROPN,compound,compound-pobj,NNP,NNP-NNP,1,1
286,75.0,25,received,10,18,20,2,17,4,-8,10,Netscape,Marc Andreessen,org,-,PROPN,PROPN-PROPN,compound,compound-appos,NNP,NNP-NNP,1,1
287,76.0,31,is,12,1,29,28,0,1,11,17,UCL Medical School,United Kingdom,org-org-org,-,PROPN-PROPN-PROPN,PROPN-PROPN,compound-compound-nsubj,compound-pobj,NNP-NNP-NNP,NNP-NNP,5,1
288,77.0,19,moved,5,10,16,6,9,2,-5,11,Wisconsin,Nicolet High School,,org-org-org,PROPN,PROPN-PROPN-PROPN,compound,compound-compound-dobj,NNP,NNP-NNP-NNP,3,1
289,78.0,48,was,3,39,32,-7,38,15,-36,29,Bronx Community College,University Heights,org-org-org,-,PROPN-PROPN-PROPN,PROPN-PROPN,compound-compound-pobj,compound-compound,NNP-NNP-NNP,NNP-NNP,6,1
290,79.0,23,transferred,6,2,20,18,1,2,4,14,California State Normal School,San State University,---,org-org-org,PROPN-PROPN-PROPN-PROPN,PROPN-PROPN-PROPN,compound-compound-compound-nsubjpass,compound-compound-pobj,NNP-NNP-NNP-NNP,NNP-NNP-NNP,6,1
291,80.0,33,visited,3,5,25,20,4,7,-2,22,Sierra Leone,Samuel Sam-Sumana,-,per-per,PROPN-PROPN,PROPN-PROPN,compound-dobj,compound-conj,NNP-NNP,NNP-NNP,5,1
292,81.0,45,spent,25,30,38,8,29,6,-5,13,India,Osho,,per,PROPN,PROPN,pobj,nsubj,NNP,NNP,4,1
293,5505.0,23,took,7,11,17,6,10,5,-4,10,India,Osho,per,,PROPN,PROPN,pobj,compound,NNP,NNP,4,1
294,8226.0,33,offered,2,19,29,10,18,3,-17,27,India,Osho,org,,PROPN,PROPN,pobj,poss,NNP,NNP,6,1
295,8454.0,35,took,3,7,14,7,6,20,-4,11,India,Osho,per,,PROPN,PROPN,pobj,pobj,NNP,NNP,6,1
296,9628.0,16,learned,4,3,15,12,2,0,1,11,India,Osho,,per,PROPN,PROPN,compound,conj,NNP,NNP,4,1
297,12359.0,41,left,6,20,40,20,19,0,-14,34,India,Osho,,org,PROPN,PROPN,pobj,pobj,NNP,NNP,5,1
298,82.0,47,replaced,4,3,27,24,2,19,1,23,Go-Ahead Group,UK,org-org,,PROPN-PROPN,PROPN,punct-nsubj,compound,NNP-NNP,NNP,-1,1
299,83.0,32,expected,3,18,27,9,17,4,-15,24,his,Quebec,per,,DET,PROPN,poss,compound,PRP$,NNP,5,1
300,7567.0,16,returned,3,9,14,5,8,1,-6,11,his,Quebec,,per,DET,PROPN,poss,compound,PRP$,NNP,3,1
301,85.0,21,ferried,7,2,16,14,1,4,5,9,East African Safari Air,Kenya,org-org-org-org,,PROPN-PROPN-PROPN-PROPN,PROPN,compound-compound-compound-pobj,pobj,NNP-NNP-NNP-NNP,NNP,4,1
302,86.0,17,is,2,6,12,6,5,4,-4,10,Steven Van Zandt,E Street Band,per-per-per,--,PROPN-PROPN-PROPN,PROPN-PROPN-PROPN,compound-compound-pobj,compound-compound-compound,NNP-NNP-NNP,NNP-NNP-NNP,5,1
303,87.0,40,is,1,27,38,11,26,1,-26,37,Military of Uruguay,Uruguayan Army,org-org-org,-,PROPN-ADP-PROPN,PROPN-PROPN,pobj-prep-pobj,compound-pobj,NNP-IN-NNP,NNP-NNP,12,1
304,88.0,40,reorganized,10,3,3,0,2,36,7,-7,Bangladesh Bank,Bangladesh,org-org,,PROPN-PROPN,PROPN,compound-compound,pobj,NNP-NNP,NNP,0,1
305,9698.0,33,listed,4,8,8,0,7,24,-4,4,Bangladesh Bank,Bangladesh,-,org,PROPN-PROPN,PROPN,compound-poss,pobj,NNP-NNP,NNP,0,1
306,89.0,19,began,5,9,16,7,8,2,-4,11,Ray Brown,Oscar Peterson,per-per,-,PROPN-PROPN,PROPN-PROPN,compound-pobj,compound-compound,NNP-NNP,NNP-NNP,5,1
307,90.0,28,entered,24,10,22,12,9,5,14,-2,Education,Rod Paige,,per-per,PROPN,PROPN-PROPN,pobj,compound-nsubj,NNP,NNP-NNP,7,1
308,6868.0,25,Take,0,7,10,3,6,14,-7,10,Education,Rod Paige,,org-org,PROPN,PROPN-PROPN,pobj,compound-pobj,NNP,NNP-NNP,2,1
309,91.0,22,claimed,11,6,19,13,5,2,5,8,Parameswara,Palembang,per,,PROPN,PROPN,pobj,compound,NNP,NNP,10,1
310,507.0,35,styled,3,10,30,20,9,4,-7,27,Parameswara,Palembang,org,,PROPN,PROPN,compound,compound,NNP,NNP,9,1
311,2567.0,31,is,7,12,21,9,11,9,-5,14,Parameswara,Palembang,,per,PROPN,PROPN,poss,pobj,NNP,NNP,7,1
312,92.0,49,directed,2,42,47,5,41,1,-40,45,Roman Polanski,Sharon Tate,-,per-per,PROPN-PROPN,PROPN-PROPN,compound-appos,compound-appos,NNP-NNP,NNP-NNP,4,1
313,93.0,33,established,4,2,7,5,1,25,2,3,company,1937,org,,NOUN,NUM,nsubjpass,pobj,NN,CD,2,1
314,94.0,53,said,46,48,52,4,47,0,-2,6,Paul Fishbein,AVN,-,org,PROPN-PROPN,PROPN,compound-nsubj,pobj,NNP-NNP,NNP,6,1
315,2617.0,50,known,12,35,42,7,34,7,-23,30,Paul Fishbein,AVN,org-org,,PROPN-PROPN,PROPN,compound-pobj,compound,NNP-NNP,NNP,7,1
316,12726.0,40,estimated,12,1,6,5,0,33,11,-6,Paul Fishbein,AVN,per-per,,PROPN-PROPN,PROPN,compound-nsubj,compound,NNP-NNP,NNP,4,1
317,95.0,21,include,3,6,9,3,5,11,-3,6,Air New Zealand,ANZ,org-org-org,,PROPN-PROPN-PROPN,PROPN,compound-compound-compound,dobj,NNP-NNP-NNP,NNP,3,1
318,96.0,32,?ukasz,0,4,16,12,3,15,-4,16,as DeeJay Del,th Pola,org-org-org,-,ADP-PROPN-PROPN,PROPN-PROPN,prep-compound-compound,compound-pobj,IN-NNP-NNP,NNP-NNP,5,1
319,97.0,28,died,20,9,20,11,8,7,11,0,Indonesia,Suharto,,per,PROPN,PROPN,poss,nsubj,NNP,NNP,4,1
320,720.0,26,rated,3,1,23,22,0,2,2,20,Indonesia,Suharto,per,,PROPN,PROPN,nsubjpass,poss,NNP,NNP,6,1
321,2505.0,20,makes,8,2,8,6,1,11,6,0,Indonesia,Suharto,org,,PROPN,PROPN,nsubj,appos,NNP,NNP,3,1
322,3628.0,36,After,0,23,25,2,22,10,-23,25,Indonesia,Suharto,per,,PROPN,PROPN,pobj,nsubj,NNP,NNP,-1,1
323,5322.0,10,pay,2,6,9,3,5,0,-4,7,Indonesia,Suharto,org,,PROPN,PROPN,pobj,pobj,NNP,NNP,5,1
324,5537.0,29,awarded,8,5,10,5,4,18,3,2,Indonesia,Suharto,,org,PROPN,PROPN,poss,dative,NNP,NNP,4,1
325,5770.0,11,cover,1,3,5,2,2,5,-2,4,Indonesia,Suharto,per,,PROPN,PROPN,dobj,nmod,NNP,NNP,2,1
326,5986.0,21,1999,1,6,8,2,5,12,-5,7,Indonesia,Suharto,org,,PROPN,PROPN,pobj,poss,NNP,NNP,3,1
327,6306.0,27,resulted,4,7,18,11,6,8,-3,14,Indonesia,Suharto,per,,PROPN,PROPN,nsubj,dative,NNP,NNP,2,1
328,6735.0,22,had,1,5,17,12,4,4,-4,16,Indonesia,Suharto,,org,PROPN,PROPN,dobj,compound,NNP,NNP,5,1
329,7595.0,35,removed,5,29,34,5,28,0,-24,29,Indonesia,Suharto,,per,PROPN,PROPN,conj,attr,NNP,NNP,5,1
330,7637.0,11,Suharto,3,2,4,2,1,6,1,1,Indonesia,Suharto,,org,PROPN,PROPN,poss,ROOT,NNP,NNP,3,1
331,8758.0,31,WHAT,0,8,17,9,7,13,-8,17,Indonesia,Suharto,per,,PROPN,PROPN,nsubj,poss,NNP,NNP,7,1
332,8863.0,40,invaded,22,4,8,4,3,31,18,-14,Indonesia,Suharto,,org,PROPN,PROPN,nsubj,pobj,NNP,NNP,5,1
333,9865.0,30,Verhagen,3,10,15,5,9,14,-7,12,Indonesia,Suharto,org,,PROPN,PROPN,dobj,dobj,NNP,NNP,4,1
334,10008.0,25,held,6,2,11,9,1,13,4,5,Indonesia,Suharto,,per,PROPN,PROPN,pobj,pobj,NNP,NNP,6,1
335,10442.0,28,represent,3,5,9,4,4,18,-2,6,Indonesia,Suharto,,per,PROPN,PROPN,dobj,pobj,NNP,NNP,3,1
336,11077.0,10,s,2,1,4,3,0,5,1,2,Indonesia,Suharto,per,,PROPN,PROPN,nsubj,nsubj,NNP,NNP,3,1
337,13737.0,11,ailing,2,1,4,3,0,6,1,2,Indonesia,Suharto,per,,PROPN,PROPN,poss,nsubj,NNP,NNP,4,1
338,13817.0,31,supported,17,8,19,11,7,11,9,2,Indonesia,Suharto,per,,PROPN,PROPN,pobj,poss,NNP,NNP,8,1
339,14016.0,10,worsens,6,3,5,2,2,4,3,-1,Indonesia,Suharto,per,,PROPN,PROPN,poss,pobj,NNP,NNP,6,1
340,98.0,19,Faculty,5,2,2,0,1,16,3,-3,London South Bank University,London,org-org-org-org,,PROPN-PROPN-PROPN-PROPN,PROPN,compound-compound-compound-compound,compound,NNP-NNP-NNP-NNP,NNP,0,1
341,99.0,29,served,12,9,25,16,8,3,3,13,he,Saint Kitts and Nevis,per,---,PRON,PROPN-PROPN-CCONJ-PROPN,nsubj,compound-pobj-cc-conj,PRP,NNP-NNP-CC-NNP,7,1
342,100.0,24,was,10,17,23,6,16,0,-7,13,Edward the Confessor,England,per-per-per,,PROPN-DET-PROPN,PROPN,dobj-det-appos,pobj,NNP-DT-NNP,NNP,5,1
343,1650.0,29,is,10,19,24,5,18,4,-9,14,Edward the Confessor,England,--,per,PROPN-DET-PROPN,PROPN,pobj-det-compound,pobj,NNP-DT-NNP,NNP,2,1
344,101.0,27,owns,10,1,20,19,0,6,9,10,Dubai World,DP World,org-org,-,PROPN-PROPN,PROPN-PROPN,compound-nsubj,compound-pobj,NNP-NNP,NNP-NNP,6,1
345,102.0,36,represented,11,13,30,17,12,5,-2,19,Hawaii,Daniel Akaka,,per-per,PROPN,PROPN-PROPN,dobj,compound-pobj,NNP,NNP-NNP,9,1
346,5853.0,17,said,6,8,11,3,7,5,-2,5,Hawaii,Daniel Akaka,,per-per,PROPN,PROPN-PROPN,compound,compound-nsubj,NNP,NNP-NNP,2,1
347,8360.0,21,scorned,2,10,15,5,9,5,-8,13,Hawaii,Daniel Akaka,per,-,PROPN,PROPN-PROPN,poss,compound-pobj,NNP,NNP-NNP,2,1
348,9336.0,27,warmed,16,2,6,4,1,20,14,-10,Hawaii,Daniel Akaka,,org-org,PROPN,PROPN-PROPN,compound,compound-compound,NNP,NNP-NNP,2,1
349,9790.0,11,is,3,7,9,2,6,1,-4,6,Hawaii,Daniel Akaka,org,-,PROPN,PROPN-PROPN,compound,compound-ROOT,NNP,NNP-NNP,1,1
350,12004.0,27,is,10,23,25,2,22,1,-13,15,Hawaii,Daniel Akaka,per,-,PROPN,PROPN-PROPN,compound,compound-pobj,NNP,NNP-NNP,3,1
351,12964.0,23,more,2,8,10,2,7,12,-6,8,Hawaii,Daniel Akaka,,per-per,PROPN,PROPN-PROPN,compound,compound-pobj,NNP,NNP-NNP,1,1
352,103.0,22,taken,1,9,11,2,8,10,-8,10,Sharon,Kadima,per,,PROPN,PROPN,poss,compound,NNP,NNP,2,1
353,104.0,21,re-released,1,1,3,2,0,17,0,2,Records,Crow,,per,NOUN,PROPN,nsubj,poss,NNS,NNP,2,1
354,105.0,49,is,9,18,22,4,17,26,-9,13,Evan Bayh,politician,per-per,,PROPN-PROPN,NOUN,compound-pobj,appos,NNP-NNP,NN,5,1
355,106.0,55,invested,32,2,4,2,1,50,30,-28,Gunns,John,org,,PROPN,PROPN,compound,compound,NNP,NNP,1,1
356,107.0,44,elevated,2,12,17,5,11,26,-10,15,Havel,Czechoslovakia,per,,PROPN,PROPN,nsubj,pobj,NNP,NNP,1,1
357,108.0,26,make,13,1,3,2,0,22,12,-10,Estudiantes,Leonardo,,per,NOUN,PROPN,nsubj,compound,NNS,NNP,1,1
358,109.0,29,was,8,4,20,16,3,8,4,12,UCF Knights,University of Central Florida,-,org-org-org-org,PROPN-PROPN,PROPN-ADP-PROPN-PROPN,compound-compound,dobj-prep-compound-pobj,NNP-NNPS,NNP-IN-NNP-NNP,6,1
359,431.0,22,represented,6,3,9,6,2,12,3,3,UCF Knights,University of Central Florida,per-per,---,PROPN-PROPN,PROPN-ADP-PROPN-PROPN,compound-compound,dobj-prep-compound-pobj,NNP-NNPS,NNP-IN-NNP-NNP,4,1
360,6784.0,21,represented,6,3,9,6,2,11,3,3,UCF Knights,University of Central Florida,-,per-per-per-per,PROPN-PROPN,PROPN-ADP-PROPN-PROPN,compound-compound,dobj-prep-compound-pobj,NNP-NNPS,NNP-IN-NNP-NNP,4,1
361,110.0,23,represents,2,12,22,10,11,0,-10,20,Ali Hamza al-Bahlul,Yemen,per-per-per,,PROPN-PROPN-VERB,PROPN,compound-compound-pobj,pobj,NNP-NNP-VBD,NNP,4,1
362,111.0,19,merged,6,3,9,6,2,9,3,3,Beijing,Peking University,,org-org,PROPN,PROPN-PROPN,compound,compound-pobj,NNP,NNP-NNP,4,1
363,112.0,21,licensed,11,1,9,8,0,11,10,-2,Catalyst Game Labs,InMediaRes,--,org,PROPN-PROPN-PROPN,PROPN,compound-compound-nsubj,compound,NNP-NNP-NNPS,NNP,4,1
364,113.0,30,shared,3,1,15,14,0,14,2,12,Mel-Man,Aftermath,per,,PROPN,PROPN,nsubj,compound,NNP,NNP,4,1
365,115.0,69,announced,3,18,41,23,17,27,-15,38,Spyros Kyprianou,House,per-per,,PROPN-PROPN,PROPN,compound-poss,pobj,NNP-NNP,NNP,9,1
366,8898.0,7,elected,3,1,5,4,0,1,2,2,Spyros Kyprianou,House,-,org,PROPN-PROPN,PROPN,compound-nsubjpass,compound,NNP-NNP,NNP,2,1
367,116.0,16,recommended,7,3,5,2,2,10,4,-2,Chicago,William Hale Thompson,,per-per-per,PROPN,PROPN-PROPN-PROPN,compound,compound-compound-nsubj,NNP,NNP-NNP-NNP,2,1
368,7188.0,26,was,2,11,13,2,10,12,-9,11,Chicago,William Hale Thompson,per,--,PROPN,PROPN-PROPN-PROPN,compound,compound-compound-dobj,NNP,NNP-NNP-NNP,2,1
369,13910.0,31,fought,1,9,16,7,8,14,-8,15,Chicago,William Hale Thompson,,per-per-per,PROPN,PROPN-PROPN-PROPN,compound,compound-compound-dobj,NNP,NNP-NNP-NNP,4,1
370,117.0,29,was,7,12,28,16,11,0,-5,21,Karl Marx,London,per-per,,PROPN-PROPN,PROPN,compound-pobj,pobj,NNP-NNP,NNP,6,1
371,118.0,33,was,1,7,12,5,6,20,-6,11,Nomad Soul Records,Walder,--,per,PROPN-PROPN-PROPN,PROPN,compound-compound-pobj,nsubj,NNP-NNP-NNPS,NNP,4,1
372,119.0,35,followed,3,16,23,7,15,11,-13,20,Cuyo,de San,,per-per,PROPN,ADP-PROPN,pobj,nmod-appos,NNP,IN-NNP,4,1
373,120.0,72,Dam,4,32,56,24,31,15,-28,52,ar District,d Afghanistan during,-,per-per-per,DET-PROPN,ADJ-PROPN-ADP,compound-ROOT,amod-appos-prep,DT-NNP,JJ-NNP-IN,5,1
374,121.0,50,is,16,1,15,14,0,34,15,-1,Roberto Carlos,Brazil,per-per,,PROPN-PROPN,PROPN,compound-compound,pobj,NNP-NNP,NNP,3,1
375,5071.0,23,In,0,10,22,12,9,0,-10,22,Roberto Carlos,Brazil,per-per,,PROPN-PROPN,PROPN,compound-dobj,pobj,NNP-NNP,NNP,2,1
376,7557.0,20,scored,7,1,10,9,0,9,6,3,Roberto Carlos,Brazil,org-org,,PROPN-PROPN,PROPN,compound-compound,pobj,NNP-NNP,NNP,5,1
377,122.0,20,located,9,3,15,12,2,4,6,6,UNLV,Las Vegas,org,-,PROPN,PROPN-PROPN,poss,compound-poss,NNP,NNP-NNP,8,1
378,123.0,19,attended,1,3,8,5,2,10,-2,7,North Thurston High School,Lacey,org-org-org-org,,PROPN-PROPN-PROPN-PROPN,PROPN,compound-compound-compound-dobj,compound,NNP-NNP-NNP-NNP,NNP,4,1
379,124.0,16,founded,5,1,3,2,0,12,4,-2,Bexley,Capital University,,org-org,PROPN,PROPN-PROPN,compound,compound-nsubjpass,NNP,NNP-NNP,1,1
380,125.0,33,knew,13,4,24,20,3,8,9,11,Ultrabeat,Liverpool,per,,PROPN,PROPN,compound,pobj,NNP,NNP,5,1
381,126.0,31,established,9,2,13,11,1,17,7,4,April 1 1956,Bundesnachrichtendienst,org-org-org,,PROPN-NUM-NUM,PROPN,pobj-nummod-nummod,pobj,NNP-CD-CD,NNP,6,1
382,127.0,11,is,8,2,3,1,1,7,6,-5,singer,Emily Robison,,org-org,NOUN,PROPN-PROPN,compound,compound-nsubj,NN,NNP-NNP,1,1
383,12080.0,11,is,8,2,3,1,1,7,6,-5,singer,Emily Robison,per,-,NOUN,PROPN-PROPN,compound,compound-nsubj,NN,NNP-NNP,1,1
384,128.0,21,lost,13,18,19,1,17,1,-5,6,Governor,Dirk Kempthorne,,per-per,PROPN,PROPN-PROPN,compound,compound-pobj,NNP,NNP-NNP,1,1
385,7974.0,50,declared,12,10,11,1,9,38,2,-1,Governor,Dirk Kempthorne,,org-org,PROPN,PROPN-PROPN,compound,compound-pobj,NNP,NNP-NNP,1,1
386,129.0,59,said,47,53,56,3,52,2,-6,9,Brisbane,University of Queensland,,per-per-per,PROPN,PROPN-ADP-PROPN,pobj,pobj-prep-pobj,NNP,NNP-IN-NNP,2,1
387,130.0,44,is,2,14,24,10,13,19,-12,22,State of Alert,Henry Rollins.Cogan,--,org-org,PROPN-ADP-PROPN,PROPN-PROPN,pobj-prep-pobj,compound-subtok,NNP-IN-NNP,NNP-NNP,8,1
388,131.0,37,told,32,7,21,14,6,15,25,-11,Lebanon,Lebanese Armed Forces,,per-per-per,PROPN,ADJ-PROPN-PROPN,pobj,compound-compound-pobj,NNP,JJ-NNP-NNPS,9,1
389,2191.0,33,visited,12,11,27,16,10,5,1,15,Lebanon,Lebanese Armed Forces,org,--,PROPN,ADJ-PROPN-PROPN,compound,compound-compound-conj,NNP,JJ-NNP-NNPS,16,1
390,2921.0,38,noted,1,16,32,16,15,5,-15,31,Lebanon,Lebanese Armed Forces,per,--,PROPN,ADJ-PROPN-PROPN,nsubj,compound-compound-dobj,NNP,JJ-NNP-NNPS,8,1
391,4094.0,27,spread,5,15,18,3,14,8,-10,13,Lebanon,Lebanese Armed Forces,org,--,PROPN,ADJ-PROPN-PROPN,pobj,compound-compound-nsubj,NNP,JJ-NNP-NNPS,3,1
392,6257.0,85,called,16,35,44,9,34,40,-19,28,Lebanon,Lebanese Armed Forces,org,--,PROPN,ADJ-PROPN-PROPN,pobj,amod-compound-nmod,NNP,JJ-NNP-NNPS,4,1
393,7011.0,24,said,1,15,21,6,14,2,-14,20,Lebanon,Lebanese Armed Forces,per,--,PROPN,ADJ-PROPN-PROPN,pobj,compound-compound-pobj,NNP,JJ-NNP-NNPS,7,1
394,7267.0,28,stressed,4,8,14,6,7,13,-4,10,Lebanon,Lebanese Armed Forces,org,--,PROPN,ADJ-PROPN-PROPN,pobj,amod-compound-pobj,NNP,JJ-NNP-NNPS,5,1
395,13180.0,29,is,13,15,21,6,14,7,-2,8,Lebanon,Lebanese Armed Forces,,per-per-per,PROPN,ADJ-PROPN-PROPN,poss,compound-compound-pobj,NNP,JJ-NNP-NNPS,5,1
396,132.0,16,began,3,11,14,3,10,1,-8,11,Opposition,Lynda Haverstock,,org-org,PROPN,PROPN-PROPN,pobj,compound-pobj,NNP,NNP-NNP,2,1
397,133.0,66,signed,1,12,19,7,11,46,-11,18,FC Porto,Pinto da Costa,-,per-per-per,PROPN-PROPN,PROPN-PROPN-PROPN,compound-nmod,compound-compound-nsubj,NNP-NNP,NNP-NNP-NNP,2,1
398,134.0,32,performed,6,27,31,4,26,0,-21,25,Morten Harket,Norway,org-org,,PROPN-PROPN,PROPN,compound-pobj,pobj,NNP-NNP,NNP,3,1
399,135.0,38,began,6,5,6,1,4,31,1,0,Disney,ABC Kids,per,-,PROPN,PROPN-PROPN,poss,compound-oprd,NNP,NNP-NNPS,4,1
400,136.0,39,get,4,3,17,14,2,21,1,13,Canada,Alliance Atlantis,org,-,PROPN,PROPN-PROPN,pobj,compound-pobj,NNP,NNP-NNP,5,1
401,137.0,24,killed,5,10,14,4,9,9,-5,9,Franklin Pierce,New Hampshire,-,org-org,PROPN-PROPN,PROPN-PROPN,compound-pobj,compound-pobj,NNP-NNP,NNP-NNP,4,1
402,970.0,22,celebrates,4,14,20,6,13,1,-10,16,Franklin Pierce,New Hampshire,-,per-per,PROPN-PROPN,PROPN-PROPN,compound-compound,compound-pobj,NNP-NNP,NNP-NNP,3,1
403,1475.0,22,situated,13,6,20,14,5,1,7,7,Franklin Pierce,New Hampshire,org-org,-,PROPN-PROPN,PROPN-PROPN,compound-poss,compound-pobj,NNP-NNP,NNP-NNP,8,1
404,2744.0,13,gotten,2,7,11,4,6,1,-5,9,Franklin Pierce,New Hampshire,per-per,-,PROPN-PROPN,PROPN-PROPN,compound-compound,compound-pobj,NNP-NNP,NNP-NNP,3,1
405,4318.0,36,said,23,9,14,5,8,21,14,-9,Franklin Pierce,New Hampshire,org-org,-,PROPN-PROPN,PROPN-PROPN,compound-compound,compound-pobj,NNP-NNP,NNP-NNP,3,1
406,4446.0,20,is,3,1,14,13,0,5,2,11,Franklin Pierce,New Hampshire,-,per-per,PROPN-PROPN,PROPN-PROPN,compound-compound,compound-pobj,NNP-NNP,NNP-NNP,4,1
407,5103.0,18,earned,3,10,16,6,9,1,-7,13,Franklin Pierce,New Hampshire,-,org-org,PROPN-PROPN,PROPN-PROPN,compound-compound,compound-pobj,NNP-NNP,NNP-NNP,3,1
408,5617.0,23,said,0,16,21,5,15,1,-16,21,Franklin Pierce,New Hampshire,org-org,-,PROPN-PROPN,PROPN-PROPN,compound-compound,compound-pobj,NNP-NNP,NNP-NNP,3,1
409,6931.0,38,is,1,21,35,14,20,2,-20,34,Franklin Pierce,New Hampshire,per-per,-,PROPN-PROPN,PROPN-PROPN,compound-compound,compound-conj,NNP-NNP,NNP-NNP,7,1
410,7734.0,30,founded,3,8,28,20,7,1,-5,25,Franklin Pierce,New Hampshire,-,org-org,PROPN-PROPN,PROPN-PROPN,compound-compound,compound-pobj,NNP-NNP,NNP-NNP,8,1
411,8032.0,33,feels,1,27,31,4,26,1,-26,30,Franklin Pierce,New Hampshire,-,org-org,PROPN-PROPN,PROPN-PROPN,compound-compound,compound-pobj,NNP-NNP,NNP-NNP,5,1
412,12804.0,31,received,1,21,27,6,20,3,-20,26,Franklin Pierce,New Hampshire,per-per,-,PROPN-PROPN,PROPN-PROPN,compound-compound,compound-pobj,NNP-NNP,NNP-NNP,3,1
413,138.0,25,named,2,22,23,1,21,1,-20,21,State,John Hay,per,-,PROPN,PROPN-PROPN,pobj,compound-conj,NNP,NNP-NNP,6,1
414,581.0,28,NOTE,0,25,26,1,24,1,-25,26,State,John Hay,,per-per,PROPN,PROPN-PROPN,pobj,compound-pobj,NNP,NNP-NNP,2,1
415,957.0,28,was,1,15,16,1,14,11,-14,15,State,John Hay,,org-org,PROPN,PROPN-PROPN,pobj,compound-compound,NNP,NNP-NNP,10,1
416,8267.0,27,went,7,18,19,1,17,7,-11,12,State,John Hay,per,-,PROPN,PROPN-PROPN,pobj,compound-pobj,NNP,NNP-NNP,1,1
417,12802.0,17,announced,8,14,15,1,13,1,-6,7,State,John Hay,,per-per,PROPN,PROPN-PROPN,pobj,compound-pobj,NNP,NNP-NNP,1,1
418,13330.0,30,co-authored,3,15,16,1,14,13,-12,13,State,John Hay,org,-,PROPN,PROPN-PROPN,pobj,compound-conj,NNP,NNP-NNP,1,1
419,14165.0,23,succeeded,1,12,13,1,11,9,-11,12,State,John Hay,per,-,PROPN,PROPN-PROPN,pobj,compound-pobj,NNP,NNP-NNP,1,1
420,139.0,33,returned,3,3,26,23,2,6,0,23,she,WGCL-TV,,per,PRON,NOUN,nsubj,pobj,PRP,NN,7,1
421,140.0,30,Strikes,2,13,25,12,12,4,-11,23,a 1971 Hon,ei for Golden H,per-per-per,---,DET-NUM-PROPN,PROPN-ADP-PROPN-PROPN,det-nummod-nmod,relcl-prep-compound-pobj,DT-CD-NNP,NNP-IN-NNP-NNP,5,1
422,141.0,27,attended,1,7,23,16,6,3,-6,22,Jersey City,Thomas F. X. Smith,-,org-org-org-org,PROPN-PROPN,PROPN-PROPN-PROPN-PROPN,compound-pobj,compound-compound-compound-appos,NNP-NNP,NNP-NNP-NNP-NNP,9,1
423,2538.0,41,included,7,34,37,3,33,3,-27,30,Jersey City,Thomas F. X. Smith,-,per-per-per-per,PROPN-PROPN,PROPN-PROPN-PROPN-PROPN,compound-compound,compound-compound-compound-conj,NNP-NNP,NNP-NNP-NNP-NNP,3,1
424,142.0,23,is,11,1,10,9,0,12,10,-1,Nicole Ramalalanirina,Madagascar,-,per,PROPN-PROPN,PROPN,compound-nsubj,pobj,NNP-NNP,NNP,1,1
425,143.0,43,Division,3,4,13,9,3,29,-1,10,Division I,San Francisco Dons,org-org,--,PROPN-PRON,PROPN-PROPN-PROPN,ROOT-nsubj,compound-compound-attr,NNP-PRP,NNP-NNP-NNPS,4,1
426,144.0,23,was,2,1,22,21,0,0,1,20,Wahbi al-Bouri,Libya,per-per,,PROPN-PRON,PROPN,compound-nsubj,pobj,NNP-PRP,NNP,8,1
427,145.0,21,established,4,2,19,17,1,1,2,15,Imperial Japanese Army,Kwantung Army,org-org-org,-,PROPN-PROPN-PROPN,PROPN-PROPN,amod-compound-nsubj,compound-pobj,NNP-NNP-NNP,NNP-NNP,7,1
428,146.0,39,used,1,1,24,23,0,14,0,23,HP,VoodooPC,per,,PROPN,PROPN,nsubj,pobj,NNP,NNP,2,1
429,6344.0,32,assure,2,25,31,6,24,0,-23,29,HP,VoodooPC,per,,PROPN,NOUN,nmod,pobj,NNP,NNS,6,1
430,147.0,30,delivered,2,6,6,0,5,23,-4,4,Space and Missile Systems Center,Space,org-org-org-org-org,,PROPN-CCONJ-PROPN-PROPN-PROPN,PROPN,nmod-cc-compound-compound-poss,compound,NNP-CC-NNP-NNPS-NNP,NNP,0,1
431,148.0,28,was,1,7,8,1,6,19,-6,7,actor,Robert Wagner,org,-,NOUN,PROPN-PROPN,compound,compound-nsubj,NN,NNP-NNP,1,1
432,149.0,27,leading,9,4,7,3,3,19,5,-2,Prime Minister,Michael Somare,-,org-org,PROPN-PROPN,PROPN-PROPN,compound-compound,compound-nsubj,NNP-NNP,NNP-NNP,1,1
433,6262.0,24,visit,8,4,6,2,3,17,4,-2,Prime Minister,Michael Somare,per-per,-,PROPN-PROPN,PROPN-PROPN,compound-compound,compound-nsubj,NNP-NNP,NNP-NNP,1,1
434,13765.0,53,says,5,48,51,3,47,1,-43,46,Prime Minister,Michael Somare,-,per-per,PROPN-PROPN,PROPN-PROPN,compound-compound,compound-pobj,NNP-NNP,NNP-NNP,3,1
435,150.0,35,is,4,10,10,0,9,24,-6,6,George II of Great Britain,George,----,per,PROPN-PROPN-ADP-PROPN-PROPN,PROPN,compound-pobj-prep-compound-pobj,poss,NNP-NNP-IN-NNP-NNP,NNP,0,1
436,151.0,38,founded,2,1,13,12,0,24,1,11,BC,Bakersfield,,per,PROPN,PROPN,nsubjpass,compound,NNP,NNP,7,1
437,152.0,53,in,1,38,43,5,37,9,-37,42,Patriotic Union of Kurdistan,Jalal Talabani,per-per-per-per,-,PROPN-PROPN-ADP-PROPN,PROPN-PROPN,compound-conj-prep-poss,compound-pobj,NNP-NNP-IN-NNP,NNP-NNP,5,1
438,153.0,20,gives,5,1,15,14,0,4,4,10,South Korea,Lee Myung-bak,org-org,-,PROPN-PROPN,PROPN-PROPN,compound-poss,pobj-punct,NNP-NNP,NNP-NNP,8,1
439,11358.0,26,President-elect,3,1,5,4,0,20,2,2,South Korea,Lee Myung-bak,-,org-org,PROPN-PROPN,PROPN-PROPN,compound-poss,appos-punct,NNP-NNP,NNP-NNP,2,1
440,12087.0,29,sworn,8,1,6,5,0,22,7,-2,South Korea,Lee Myung-bak,-,per-per,PROPN-PROPN,PROPN-PROPN,compound-poss,appos-punct,NNP-NNP,NNP-NNP,3,1
441,154.0,22,is,7,2,15,13,1,6,5,8,International Federation Textile-Clothing,World Confederation of Labour,org-org-org,---,PROPN-PROPN-PROPN,PROPN-PROPN-ADP-PROPN,compound-nsubj-acl,compound-pobj-prep-pobj,NNP-NNP-NNP,NNP-NNP-IN-NNP,3,1
442,155.0,22,OSB,2,18,21,3,17,0,-16,19,San Beda College-Mendiola,Manila,--,per,PROPN-PROPN-PROPN,PROPN,compound-compound-compound,pobj,NNP-NNP-NNP,NNP,2,1
443,156.0,34,Ouyahia,1,1,20,19,0,13,0,19,Ahmed Ouyahia,Algeria,-,org,PROPN-PROPN,PROPN,compound-ROOT,pobj,NNP-NNP,NNP,4,1
444,2807.0,57,invited,8,5,22,17,4,34,3,14,Ahmed Ouyahia,Algeria,-,per,PROPN-PROPN,PROPN,compound-appos,pobj,NNP-NNP,NNP,5,1
445,4362.0,35,called,15,8,17,9,7,17,7,2,Ahmed Ouyahia,Algeria,org-org,,PROPN-PROPN,PROPN,compound-pobj,oprd,NNP-NNP,NNP,5,1
446,157.0,74,signed,12,3,4,1,2,69,9,-8,State,Edward Livingston,org,-,PROPN,PROPN-PROPN,pobj,compound-poss,NNP,NNP-NNP,1,1
447,158.0,45,resolve,38,30,34,4,29,10,8,-4,Jamil Mahuad,Ecuador,per-per,,PROPN-PROPN,PROPN,compound-compound,pobj,NNP-NNP,NNP,2,1
448,13778.0,23,asked,12,1,6,5,0,16,11,-6,Jamil Mahuad,Ecuador,-,per,PROPN-PROPN,PROPN,compound-nsubj,pobj,NNP-NNP,NNP,2,1
449,159.0,25,appointed,4,20,23,3,19,1,-16,19,Parti,Jacques Parizeau,,per-per,PROPN,PROPN-PROPN,compound,compound-pobj,NNP,NNP-NNP,2,1
450,160.0,54,concluded,25,15,23,8,14,30,10,-2,Herbert Coker,University of Lagos,per-per,--,PROPN-PROPN,PROPN-ADP-PROPN,compound-conj,pobj-prep-pobj,NNP-NNP,NNP-IN-NNP,4,1
451,922.0,64,indicated,27,17,25,8,16,38,10,-2,Herbert Coker,University of Lagos,per-per,--,PROPN-PROPN,PROPN-ADP-PROPN,compound-conj,pobj-prep-pobj,NNP-NNP,NNP-IN-NNP,3,1
452,161.0,22,located,7,2,21,19,1,0,5,14,Company,Thailand,,per,PROPN,PROPN,compound,pobj,NNP,NNP,3,1
453,162.0,28,thought,2,19,27,8,18,0,-17,25,she,singer,,org,PRON,NOUN,nsubj,pobj,PRP,NN,4,1
454,163.0,20,cofounded,8,1,10,9,0,9,7,2,Toxey Haas,Mossy Oak,org-org,-,PROPN-PROPN,PROPN-PROPN,compound-nsubj,nmod-nmod,NNP-NNP,NNP-NNP,4,1
455,164.0,30,established,4,7,18,11,6,11,-3,14,India,Morarji Desai,per,-,PROPN,PROPN-PROPN,pobj,compound-pobj,NNP,NNP-NNP,3,1
456,3041.0,37,Bhushan,1,18,34,16,17,2,-17,33,India,Morarji Desai,per,-,PROPN,PROPN-PROPN,pobj,compound-compound,NNP,NNP-NNP,6,1
457,6260.0,39,replied,1,28,37,9,27,1,-27,36,India,Morarji Desai,,org-org,PROPN,PROPN-PROPN,pobj,compound-pobj,NNP,NNP-NNP,6,1
458,11158.0,28,evoked,2,6,20,14,5,7,-4,18,India,Morarji Desai,,per-per,PROPN,PROPN-PROPN,poss,compound-conj,NNP,NNP-NNP,7,1
459,165.0,15,came,11,7,10,3,6,4,4,-1,Japan,Anna Tsuchiya,,org-org,PROPN,PROPN-PROPN,compound,compound-conj,NNP,NNP-NNP,1,1
460,1398.0,24,attended,5,13,22,9,12,1,-8,17,Japan,Anna Tsuchiya,per,-,PROPN,PROPN-PROPN,compound,compound-pobj,NNP,NNP-NNP,4,1
461,8507.0,23,participated,4,16,21,5,15,1,-12,17,Japan,Anna Tsuchiya,,per-per,PROPN,PROPN-PROPN,dobj,compound-conj,NNP,NNP-NNP,3,1
462,166.0,23,bought,4,3,10,7,2,12,1,6,ABC Records,Norman,-,per,PROPN-PROPN,PROPN,compound-nsubj,dobj,NNP-NNPS,NNP,3,1
463,167.0,40,flubbed,13,5,9,4,4,30,8,-4,West High School,Iowa,--,per,PROPN-PROPN-PROPN,PROPN,compound-compound-pobj,compound,NNP-NNP-NNP,NNP,3,1
464,168.0,47,owes,20,39,43,4,38,3,-19,23,actor,Wallace Beery,,per-per,NOUN,PROPN-PROPN,appos,compound-dobj,NN,NNP-NNP,2,1
465,169.0,20,stepped,14,7,10,3,6,9,7,-4,HSBC Bank USA,N.A.,org-org-org,,PROPN-PROPN-PROPN,PROPN,compound-compound-compound,pobj,NNP-NNP-NNP,NNP,2,1
466,170.0,50,broke,2,38,47,9,37,2,-36,45,Wales,Six Nations Championship,,per-per-per,PROPN,NUM-PROPN-PROPN,compound,nummod-compound-pobj,NNP,CD-NNPS-NNP,6,1
467,8466.0,27,agreed,15,4,7,3,3,19,11,-8,Wales,Six Nations Championship,per,--,PROPN,NUM-PROPN-PROPN,dobj,nummod-compound-nsubj,NNP,CD-NNPS-NNP,3,1
468,171.0,18,is,6,2,13,11,1,4,4,7,University of Palermo,Italy,--,org,PROPN-ADP-PROPN,PROPN,nsubj-prep-pobj,pobj,NNP-IN-NNP,NNP,5,1
469,172.0,38,is,15,1,18,17,0,19,14,3,Lloyd,American,,org,PROPN,ADJ,compound,amod,NNP,JJ,4,1
470,236.0,17,is,8,2,11,9,1,5,6,3,Lloyd,American,,per,PROPN,ADJ,nsubj,amod,NNP,JJ,3,1
471,838.0,18,is,11,1,15,14,0,2,10,4,Lloyd,American,,per,PROPN,ADJ,compound,amod,NNP,JJ,3,1
472,173.0,32,expected,1,20,25,5,19,6,-19,24,Ho Chi Minh,Vietnam,org-org-org,,PROPN-PROPN-PROPN,PROPN,compound-compound-compound,pobj,NNP-NNP-NNP,NNP,5,1
473,533.0,23,contested,3,12,16,4,11,6,-9,13,Ho Chi Minh,Vietnam,org-org-org,,PROPN-PROPN-PROPN,PROPN,compound-compound-compound,pobj,NNP-NNP-NNP,NNP,2,1
474,546.0,30,was,4,2,22,20,1,7,2,18,Ho Chi Minh,Vietnam,org-org-org,,PROPN-PROPN-PROPN,PROPN,compound-compound-compound,pobj,NNP-NNP-NNP,NNP,9,1
475,697.0,22,is,10,1,21,20,0,0,9,11,Ho Chi Minh,Vietnam,org-org-org,,PROPN-PROPN-PROPN,PROPN,compound-compound-compound,pobj,NNP-NNP-NNP,NNP,4,1
476,1072.0,22,is,0,6,10,4,5,11,-6,10,Ho Chi Minh,Vietnam,--,per,PROPN-PROPN-PROPN,PROPN,compound-compound-compound,pobj,NNP-NNP-NNP,NNP,7,1
477,1293.0,27,List,0,6,26,20,5,0,-6,26,Ho Chi Minh,Vietnam,--,per,PROPN-PROPN-PROPN,PROPN,compound-compound-compound,pobj,NNP-NNP-NNP,NNP,8,1
478,1295.0,21,Posts,0,7,20,13,6,0,-7,20,Ho Chi Minh,Vietnam,--,per,PROPN-PROPN-PROPN,PROPN,compound-compound-compound,pobj,NNP-NNP-NNP,NNP,7,1
479,1573.0,43,said,30,7,22,15,6,20,23,-8,Ho Chi Minh,Vietnam,per-per-per,,PROPN-PROPN-PROPN,PROPN,compound-compound-compound,pobj,NNP-NNP-NNP,NNP,8,1
480,2679.0,21,is,7,16,20,4,15,0,-9,13,Ho Chi Minh,Vietnam,per-per-per,,PROPN-PROPN-PROPN,PROPN,compound-compound-compound,pobj,NNP-NNP-NNP,NNP,8,1
481,2854.0,36,was,1,8,14,6,7,21,-7,13,Ho Chi Minh,Vietnam,--,per,PROPN-PROPN-PROPN,PROPN,compound-compound-compound,pobj,NNP-NNP-NNP,NNP,3,1
482,3638.0,21,announces,8,6,17,11,5,3,2,9,Ho Chi Minh,Vietnam,org-org-org,,PROPN-PROPN-PROPN,PROPN,compound-compound-nsubj,pobj,NNP-NNP-NNP,NNP,7,1
483,4096.0,55,is,22,4,1,-3,3,53,18,-21,Ho Chi Minh,Vietnam,org-org-org,,PROPN-PROPN-PROPN,PROPN,compound-compound-compound,pobj,NNP-NNP-NNP,NNP,4,1
484,4116.0,42,rose,4,2,32,30,1,9,2,28,Ho Chi Minh,Vietnam,--,org,PROPN-PROPN-PROPN,PROPN,compound-compound-nsubj,pobj,NNP-NNP-NNP,NNP,10,1
485,5594.0,48,said,45,1,17,16,0,30,44,-28,Ho Chi Minh,Vietnam,--,per,PROPN-PROPN-PROPN,PROPN,compound-compound-nsubj,pobj,NNP-NNP-NNP,NNP,3,1
486,6333.0,47,was,5,2,26,24,1,20,3,21,Ho Chi Minh,Vietnam,per-per-per,,PROPN-PROPN-PROPN,PROPN,compound-compound-compound,pobj,NNP-NNP-NNP,NNP,12,1
487,6811.0,17,located,3,12,16,4,11,0,-9,13,Ho Chi Minh,Vietnam,--,org,PROPN-PROPN-PROPN,PROPN,compound-compound-compound,pobj,NNP-NNP-NNP,NNP,5,1
488,7780.0,33,crowned,2,18,23,5,17,9,-16,21,Ho Chi Minh,Vietnam,--,per,PROPN-PROPN-PROPN,PROPN,compound-compound-compound,pobj,NNP-NNP-NNP,NNP,7,1
489,7924.0,20,named,3,6,19,13,5,0,-3,16,Ho Chi Minh,Vietnam,--,per,PROPN-PROPN-PROPN,PROPN,compound-compound-pobj,pobj,NNP-NNP-NNP,NNP,4,1
490,9016.0,75,was,5,29,15,-14,28,59,-24,10,Ho Chi Minh,Vietnam,--,per,PROPN-PROPN-PROPN,PROPN,compound-compound-compound,pobj,NNP-NNP-NNP,NNP,13,1
491,9346.0,27,is,13,1,26,25,0,0,12,13,Ho Chi Minh,Vietnam,--,per,PROPN-PROPN-PROPN,PROPN,compound-compound-compound,pobj,NNP-NNP-NNP,NNP,5,1
492,9536.0,45,decided,9,16,28,12,15,16,-7,19,Ho Chi Minh,Vietnam,org-org-org,,PROPN-PROPN-PROPN,PROPN,compound-compound-compound,dobj,NNP-NNP-NNP,NNP,6,1
493,9567.0,29,opened,18,2,23,21,1,5,16,5,Ho Chi Minh,Vietnam,--,per,PROPN-PROPN-PROPN,PROPN,compound-compound-compound,dobj,NNP-NNP-NNP,NNP,5,1
494,10322.0,19,is,5,14,18,4,13,0,-9,13,Ho Chi Minh,Vietnam,per-per-per,,PROPN-PROPN-PROPN,PROPN,compound-compound-compound,pobj,NNP-NNP-NNP,NNP,8,1
495,10420.0,43,said,31,9,28,19,8,14,22,-3,Ho Chi Minh,Vietnam,per-per-per,,PROPN-PROPN-PROPN,PROPN,compound-compound-compound,poss,NNP-NNP-NNP,NNP,14,1
496,10430.0,65,was,5,22,15,-7,21,49,-17,10,Ho Chi Minh,Vietnam,org-org-org,,PROPN-PROPN-PROPN,PROPN,compound-compound-compound,pobj,NNP-NNP-NNP,NNP,10,1
497,10474.0,21,provides,1,11,20,9,10,0,-10,19,Ho Chi Minh,Vietnam,per-per-per,,PROPN-PROPN-PROPN,PROPN,compound-compound-compound,pobj,NNP-NNP-NNP,NNP,8,1
498,11292.0,59,was,1,19,28,9,18,30,-18,27,Ho Chi Minh,Vietnam,--,org,PROPN-PROPN-PROPN,PROPN,compound-compound-compound,compound,NNP-NNP-NNP,NNP,9,1
499,11486.0,28,is,6,11,15,4,10,12,-5,9,Ho Chi Minh,Vietnam,org-org-org,,PROPN-PROPN-PROPN,PROPN,compound-compound-compound,pobj,NNP-NNP-NNP,NNP,9,1
500,11508.0,35,reported,32,22,27,5,21,7,10,-5,Ho Chi Minh,Vietnam,org-org-org,,PROPN-PROPN-PROPN,PROPN,compound-compound-compound,pobj,NNP-NNP-NNP,NNP,9,1
501,11553.0,35,found,5,21,34,13,20,0,-16,29,Ho Chi Minh,Vietnam,per-per-per,,PROPN-PROPN-PROPN,PROPN,compound-compound-poss,pobj,NNP-NNP-NNP,NNP,6,1
502,11809.0,36,located,2,18,35,17,17,0,-16,33,Ho Chi Minh,Vietnam,per-per-per,,PROPN-PROPN-PROPN,PROPN,compound-compound-nsubj,pobj,NNP-NNP-NNP,NNP,10,1
503,12051.0,34,is,22,11,33,22,10,0,11,11,Ho Chi Minh,Vietnam,--,per,PROPN-PROPN-PROPN,PROPN,compound-compound-compound,pobj,NNP-NNP-NNP,NNP,9,1
504,13842.0,19,has,2,11,18,7,10,0,-9,16,Ho Chi Minh,Vietnam,per-per-per,,PROPN-PROPN-PROPN,PROPN,compound-compound-compound,pobj,NNP-NNP-NNP,NNP,6,1
505,14003.0,24,used,18,1,14,13,0,9,17,-4,Ho Chi Minh,Vietnam,per-per-per,,PROPN-PROPN-PROPN,PROPN,compound-compound-nsubj,pobj,NNP-NNP-NNP,NNP,2,1
506,174.0,12,Property,1,8,10,2,7,1,-7,9,France,Isabelle Huppert,per,-,PROPN,PROPN-PROPN,pobj,compound-dobj,NNP,NNP-NNP,1,1
507,175.0,17,won,8,6,7,1,5,9,2,-1,Eagles,Frey,per,,PROPN,PROPN,compound,pobj,NNPS,NNP,5,1
508,176.0,29,Nu,6,13,20,7,12,8,-7,14,Union,Win Maung,,per-per,PROPN,PROPN-PROPN,pobj,compound-nsubj,NNP,NNP-NNP,4,1
509,177.0,25,announced,6,1,5,4,0,19,5,-1,Thailand,Thai Airways,,per-per,PROPN,PROPN-PROPN,poss,compound-appos,NNP,NNP-NNP,3,1
510,178.0,13,spends,2,7,12,5,6,0,-5,10,his,Canada,,per,DET,PROPN,poss,pobj,PRP$,NNP,4,1
511,7789.0,37,was,1,13,32,19,12,4,-12,31,his,Canada,,per,DET,PROPN,poss,pobj,PRP$,NNP,11,1
512,179.0,65,rejected,2,51,59,8,50,5,-49,57,London,Ian Hunter.David Buckley,,org-org-org,PROPN,PROPN-PROPN-PROPN,pobj,compound-compound-appos,NNP,NNP-NNP-NNP,13,1
513,180.0,8,Riazanova,1,4,6,2,3,1,-3,5,Jonathan Guerreiro,Russia,per-per,,PROPN-PROPN,PROPN,compound-conj,appos,NNP-NNP,NNP,3,1
514,181.0,25,claimed,1,11,15,4,10,9,-10,14,Conservative Party,Iain MacLeod,-,per-per,PROPN-PROPN,PROPN-PROPN,compound-pobj,compound-dobj,NNP-NNP,NNP-NNP,5,1
515,182.0,34,appointed,4,31,32,1,30,1,-27,28,Exchequer,Gordon Brown,per,-,PROPN,PROPN-PROPN,pobj,compound-pobj,NNP,NNP-NNP,1,1
516,1988.0,37,announced,1,22,23,1,21,13,-21,22,Exchequer,Gordon Brown,per,-,PROPN,PROPN-PROPN,pobj,compound-pobj,NNP,NNP-NNP,1,1
517,2299.0,19,condemned,8,6,7,1,5,11,2,-1,Exchequer,Gordon Brown,per,-,PROPN,PROPN-PROPN,pobj,compound-nsubj,NNP,NNP-NNP,1,1
518,5726.0,33,received,22,19,20,1,18,12,3,-2,Exchequer,Gordon Brown,,per-per,PROPN,PROPN-PROPN,pobj,compound-pobj,NNP,NNP-NNP,1,1
519,6999.0,23,announced,6,14,15,1,13,7,-8,9,Exchequer,Gordon Brown,per,-,PROPN,PROPN-PROPN,pobj,compound-pobj,NNP,NNP-NNP,1,1
520,8516.0,16,received,1,10,11,1,9,4,-9,10,Exchequer,Gordon Brown,org,-,PROPN,PROPN-PROPN,pobj,compound-pobj,NNP,NNP-NNP,1,1
521,10531.0,27,expected,3,16,17,1,15,9,-13,14,Exchequer,Gordon Brown,,org-org,PROPN,PROPN-PROPN,pobj,compound-appos,NNP,NNP-NNP,1,1
522,11783.0,29,said,27,5,6,1,4,22,22,-21,Exchequer,Gordon Brown,,per-per,PROPN,PROPN-PROPN,pobj,compound-nmod,NNP,NNP-NNP,4,1
523,12100.0,45,was,17,26,27,1,25,17,-9,10,Exchequer,Gordon Brown,per,-,PROPN,PROPN-PROPN,pobj,compound-pobj,NNP,NNP-NNP,1,1
524,13849.0,23,visited,10,8,9,1,7,13,2,-1,Exchequer,Gordon Brown,per,-,PROPN,PROPN-PROPN,pobj,compound-nsubj,NNP,NNP-NNP,1,1
525,14156.0,30,proposed,2,10,11,1,9,18,-8,9,Exchequer,Gordon Brown,per,-,PROPN,PROPN-PROPN,pobj,compound-pobj,NNP,NNP-NNP,1,1
526,183.0,19,purchased,5,3,8,5,2,10,2,3,La Senza,Limited Brands,-,per-per,PROPN-PROPN,PROPN-PROPN,compound-nsubjpass,compound-pobj,NNP-NNP,NNP-NNPS,3,1
527,184.0,32,include,2,4,10,6,3,21,-2,8,Jun Senoue,Crush 40,-,per-per,PROPN-PROPN,PROPN-NUM,compound-dobj,pobj-nummod,NNP-NNP,NNP-CD,2,1
528,185.0,16,acquired,3,6,9,3,5,6,-3,6,William M. Gwin,California,--,org,PROPN-PROPN-PROPN,PROPN,compound-compound-compound,poss,NNP-NNP-NNP,NNP,3,1
529,11124.0,58,set,14,46,13,-33,45,44,-32,-1,William M. Gwin,California,--,org,PROPN-PROPN-PROPN,PROPN,compound-compound-conj,poss,NNP-NNP-NNP,NNP,9,1
530,186.0,23,nominated,2,9,15,6,8,7,-7,13,Kuomintang,Ma Ying-jeou,per,-,PROPN,PROPN-PROPN,pobj,compound-pobj,NNP,NNP-NNP,4,1
531,250.0,27,decided,10,6,16,10,5,10,4,6,Kuomintang,Ma Ying-jeou,,org-org,PROPN,PROPN-PROPN,nsubj,compound-poss,NNP,NNP-NNP,7,1
532,634.0,28,named,11,8,17,9,7,10,3,6,Kuomintang,Ma Ying-jeou,,per-per,PROPN,PROPN-NOUN,nmod,compound-appos,NNP,NNP-NN,8,1
533,1641.0,25,participated,5,14,16,2,13,8,-9,11,Kuomintang,Ma Ying-jeou,per,-,PROPN,PROPN-VERB,compound,compound-conj,NNP,NNP-VBD,2,1
534,2383.0,19,were,3,12,17,5,11,1,-9,14,Kuomintang,Ma Ying-jeou,,per-per,PROPN,PROPN-PROPN,nmod,compound-conj,NNP,NNP-NNP,3,1
535,2612.0,40,KMT's,5,3,10,7,2,29,2,5,Kuomintang,Ma Ying-jeou,org,-,PROPN,PROPN-PROPN,poss,compound-nsubj,NNP,NNP-NNP,3,1
536,3111.0,36,Kuomintang,2,3,9,6,2,26,-1,7,Kuomintang,Ma Ying-jeou,,per-per,PROPN,PROPN-PROPN,ROOT,compound-poss,NNP,NNP-NNP,5,1
537,3230.0,24,Taiwan's,0,2,9,7,1,14,-2,9,Kuomintang,Ma Ying-jeou,per,-,PROPN,PROPN-PROPN,nsubj,compound-nsubj,NNP,NNP-NNP,5,1
538,3725.0,29,Taiwan's,0,5,24,19,4,4,-5,24,Kuomintang,Ma Ying-jeou,per,-,PROPN,PROPN-PROPN,appos,compound-appos,NNP,NNP-NNP,7,1
539,4216.0,27,was,1,14,18,4,13,8,-13,17,Kuomintang,Ma Ying-jeou,per,-,PROPN,PROPN-PROPN,appos,compound-nsubj,NNP,NNP-NNP,3,1
540,4257.0,23,established,5,2,13,11,1,9,3,8,Kuomintang,Ma Ying-jeou,org,-,PROPN,PROPN-PROPN,compound,nmod-nmod,NNP,NNP-NNP,5,1
541,4599.0,29,decided,2,13,23,10,12,5,-11,21,Kuomintang,Ma Ying-jeou,org,-,PROPN,PROPN-PROPN,compound,compound-pobj,NNP,NNP-NNP,11,1
542,5052.0,23,Kuomintang,0,1,6,5,0,16,-1,6,Kuomintang,Ma Ying-jeou,per,-,PROPN,PROPN-PROPN,ROOT,compound-nsubj,NNP,NNP-NNP,3,1
543,6132.0,25,In,0,2,4,2,1,20,-2,4,Kuomintang,Ma Ying-jeou,,per-per,PROPN,PROPN-PROPN,compound,compound-poss,NNP,NNP-NNP,2,1
544,6754.0,43,Hu,3,22,27,5,21,15,-19,24,Kuomintang,Ma Ying-jeou,per,-,PROPN,PROPN-PROPN,nmod,compound-pobj,NNP,NNP-NNP,2,1
545,6862.0,32,announced,8,19,25,6,18,6,-11,17,Kuomintang,Ma Ying-jeou,org,-,PROPN,PROPN-PROPN,nmod,compound-pobj,NNP,NNP-NNP,3,1
546,6995.0,31,Kuomintang,1,2,8,6,1,22,-1,7,Kuomintang,Ma Ying-jeou,org,-,PROPN,PROPN-PROPN,ROOT,compound-nsubj,NNP,NNP-NNP,4,1
547,7053.0,26,said,9,6,15,9,5,10,3,6,Kuomintang,Ma Ying-jeou,,per-per,PROPN,PROPN-ADJ,nsubj,compound-pobj,NNP,NNP-JJ,7,1
548,7667.0,35,came,1,18,22,4,17,12,-17,21,Kuomintang,Ma Ying-jeou,org,-,PROPN,PROPN-PROPN,poss,compound-nsubj,NNP,NNP-NNP,2,1
549,8161.0,35,Kuomintang,2,3,8,5,2,26,-1,6,Kuomintang,Ma Ying-jeou,,per-per,PROPN,PROPN-PROPN,ROOT,compound-nsubj,NNP,NNP-NNP,4,1
550,8248.0,22,lost,5,9,14,5,8,7,-4,9,Kuomintang,Ma Ying-jeou,org,-,PROPN,PROPN-PROPN,nmod,compound-pobj,NNP,NNP-NNP,4,1
551,8458.0,33,endorsed,6,2,8,6,1,24,4,2,Kuomintang,Ma Ying-jeou,per,-,PROPN,PROPN-PROPN,compound,compound-dobj,NNP,NNP-NNP,3,1
552,9140.0,30,opposed,5,12,22,10,11,7,-7,17,Kuomintang,Ma Ying-jeou,org,-,PROPN,PROPN-PROPN,poss,compound-nsubj,NNP,NNP-NNP,10,1
553,10659.0,33,created,5,2,13,11,1,19,3,8,Kuomintang,Ma Ying-jeou,,per-per,PROPN,PROPN-PROPN,compound,nmod-nmod,NNP,NNP-NNP,5,1
554,10699.0,28,is,9,16,24,8,15,3,-7,15,Kuomintang,Ma Ying-jeou,,org-org,PROPN,PROPN-PROPN,nmod,compound-nsubj,NNP,NNP-NNP,5,1
555,10870.0,38,reported,36,2,8,6,1,29,34,-28,Kuomintang,Ma Ying-jeou,,per-per,PROPN,PROPN-PROPN,nsubj,nmod-nmod,NNP,NNP-NNP,3,1
556,11716.0,35,said,4,14,23,9,13,11,-10,19,Kuomintang,Ma Ying-jeou,,org-org,PROPN,PROPN-VERB,nmod,compound-conj,NNP,NNP-VBD,4,1
557,12651.0,30,resolved,16,9,11,2,8,18,7,-5,Kuomintang,Ma Ying-jeou,per,-,PROPN,PROPN-VERB,compound,compound-nmod,NNP,NNP-VBD,2,1
558,13955.0,52,Kuomintang,2,3,8,5,2,43,-1,6,Kuomintang,Ma Ying-jeou,org,-,PROPN,PROPN-PROPN,ROOT,compound-nsubj,NNP,NNP-NNP,5,1
559,187.0,25,picked,4,1,12,11,0,12,3,8,The Stolen Minks,New Romance for Kids,per-per-per,---,DET-PROPN-PROPN,PROPN-PROPN-ADP-NOUN,det-compound-nsubjpass,compound-appos-prep-pobj,DT-NNP-NNPS,NNP-NNP-IN-NNS,4,1
560,188.0,51,is,1,25,42,17,24,8,-24,41,Australia,James Morrison,,per-per,PROPN,PROPN-PROPN,pobj,compound-compound,NNP,NNP-NNP,8,1
561,189.0,39,putting,5,17,27,10,16,11,-12,22,Truman,Kansas City,per,-,PROPN,PROPN-PROPN,compound,compound-pobj,NNP,NNP-NNP,11,1
562,190.0,31,said,8,1,4,3,0,26,7,-4,India,Oil and Natural Gas Corporation,,per-per-per-per-per,PROPN,PROPN-CCONJ-PROPN-PROPN-PROPN,poss,nmod-cc-compound-conj-nsubj,NNP,NNP-CC-NNP-NNP-NNP,3,1
563,191.0,21,is,10,2,7,5,1,13,8,-3,Trade Union Congress of the Philippines,Philippines,per-per-per-per-per-per,,PROPN-PROPN-PROPN-ADP-DET-PROPN,PROPN,compound-compound-nsubj-prep-det-pobj,pobj,NNP-NNP-NNP-IN-DT-NNP,NNP,3,1
564,192.0,22,came,15,6,13,7,5,8,9,-2,Kenya,Jomo Kenyatta,,org-org,PROPN,PROPN-PROPN,poss,compound-appos,NNP,NNP-NNP,5,1
565,1077.0,25,named,3,9,13,4,8,11,-6,10,Kenya,Jomo Kenyatta,per,-,PROPN,PROPN-PROPN,poss,compound-pobj,NNP,NNP-NNP,3,1
566,1340.0,27,is,10,16,20,4,15,6,-6,10,Kenya,Jomo Kenyatta,,per-per,PROPN,PROPN-PROPN,pobj,compound-compound,NNP,NNP-NNP,4,1
567,2363.0,29,feature,4,9,17,8,8,11,-5,13,Kenya,Jomo Kenyatta,per,-,PROPN,PROPN-PROPN,poss,compound-conj,NNP,NNP-NNP,3,1
568,2549.0,29,is,2,17,22,5,16,6,-15,20,Kenya,Jomo Kenyatta,per,-,PROPN,PROPN-PROPN,pobj,compound-compound,NNP,NNP-NNP,4,1
569,5136.0,28,said,9,7,21,14,6,6,2,12,Kenya,Jomo Kenyatta,,org-org,PROPN,PROPN-PROPN,compound,compound-compound,NNP,NNP-NNP,11,1
570,5558.0,28,positioned,4,7,15,8,6,12,-3,11,Kenya,Jomo Kenyatta,per,-,PROPN,PROPN-PROPN,pobj,compound-pobj,NNP,NNP-NNP,3,1
571,5606.0,56,is,3,37,49,12,36,6,-34,46,Kenya,Jomo Kenyatta,,per-per,PROPN,PROPN-PROPN,pobj,compound-compound,NNP,NNP-NNP,4,1
572,6832.0,51,seen,2,1,19,18,0,31,1,17,Kenya,Jomo Kenyatta,org,-,PROPN,PROPN-PROPN,nsubjpass,compound-compound,NNP,NNP-NNP,6,1
573,7048.0,34,adopted,18,2,17,15,1,16,16,-1,Kenya,Jomo Kenyatta,org,-,PROPN,PROPN-PROPN,poss,compound-pobj,NNP,NNP-NNP,7,1
574,7212.0,99,arrested,2,36,80,44,35,18,-34,78,Kenya,Jomo Kenyatta,,org-org,PROPN,PROPN-PROPN,pobj,compound-nsubj,NNP,NNP-NNP,-1,1
575,7347.0,53,alleged,2,6,18,12,5,34,-4,16,Kenya,Jomo Kenyatta,org,-,PROPN,PROPN-PROPN,poss,compound-compound,NNP,NNP-NNP,7,1
576,8402.0,47,was,11,14,22,8,13,24,-3,11,Kenya,Jomo Kenyatta,per,-,PROPN,PROPN-PROPN,compound,compound-pobj,NNP,NNP-NNP,3,1
577,8759.0,36,fallen,4,30,34,4,29,1,-26,30,Kenya,Jomo Kenyatta,,per-per,PROPN,PROPN-PROPN,poss,compound-appos,NNP,NNP-NNP,3,1
578,10270.0,56,said,8,17,21,4,16,34,-9,13,Kenya,Jomo Kenyatta,per,-,PROPN,PROPN-PROPN,poss,compound-compound,NNP,NNP-NNP,4,1
579,12935.0,30,arrived,11,2,26,24,1,3,9,15,Kenya,Jomo Kenyatta,per,-,PROPN,PROPN-PROPN,pobj,compound-compound,NNP,NNP-NNP,9,1
580,13470.0,22,appointed,6,1,5,4,0,16,5,-1,Kenya,Jomo Kenyatta,org,-,PROPN,PROPN-PROPN,poss,compound-appos,NNP,NNP-NNP,3,1
581,193.0,18,marked,5,1,10,9,0,7,4,5,Epstein,The Beatles,org,-,PROPN,DET-PROPN,poss,det-poss,NNP,DT-NNPS,7,1
582,194.0,25,is,8,2,2,0,1,22,6,-6,Israel national football team,Israel,---,per,PROPN-ADJ-NOUN-NOUN,PROPN,nmod-amod-compound-nsubj,pobj,NNP-JJ-NN-NN,NNP,0,1
583,195.0,34,signer,2,19,22,3,18,11,-17,20,Puerto Rico,Ricky Martin,per-per,-,PROPN-PROPN,PROPN-PROPN,compound-poss,compound-pobj,NNP-NNP,NNP-NNP,1,1
584,2117.0,12,Labels,0,8,10,2,7,1,-8,10,Puerto Rico,Ricky Martin,org-org,-,PROPN-PROPN,PROPN-PROPN,compound-compound,compound-appos,NNP-NNP,NNP-NNP,1,1
585,196.0,54,opened,8,5,26,21,4,27,3,18,New York City,Josh Hamilton,org-org-org,-,PROPN-PROPN-PROPN,PROPN-PROPN,compound-compound-pobj,compound-pobj,NNP-NNP-NNP,NNP-NNP,6,1
586,197.0,23,became,1,1,13,12,0,9,0,12,He,New York,,per-per,PRON,PROPN-PROPN,nsubj,compound-compound,PRP,NNP-NNP,5,1
587,8236.0,28,lived,1,1,9,8,0,18,0,8,He,New York,org,-,PRON,PROPN-PROPN,nsubj,compound-compound,PRP,NNP-NNP,5,1
588,10160.0,9,is,1,1,5,4,0,3,0,4,He,New York,org,-,PRON,PROPN-PROPN,nsubj,compound-compound,PRP,NNP-NNP,2,1
589,13002.0,23,toured,1,1,17,16,0,5,0,16,He,New York,,org-org,PRON,PROPN-PROPN,nsubj,compound-pobj,PRP,NNP-NNP,3,1
590,13304.0,33,moved,2,1,5,4,0,27,1,3,He,New York,,per-per,PRON,PROPN-PROPN,nsubj,compound-compound,PRP,NNP-NNP,5,1
591,198.0,22,refers,3,6,20,14,5,1,-3,17,Chuck Berry,Mercury,-,per,PROPN-PROPN,PROPN,compound-poss,compound,NNP-NNP,NNP,6,1
592,199.0,39,is,1,1,24,23,0,14,0,23,It,Saint Paul,per,-,PRON,PROPN-PROPN,nsubj,compound-pobj,PRP,NNP-NNP,6,1
593,200.0,39,represented,6,3,23,20,2,15,3,17,Purdue Boilermakers,Big Ten,per-per,-,PROPN-PROPN,PROPN-PROPN,compound-compound,compound-compound,NNP-NNP,NNP-NNP,-1,1
594,201.0,28,is,12,23,26,3,22,1,-11,14,1955,Alberto-Culver,per,,NUM,PROPN,pobj,compound,CD,NNP,3,1
595,202.0,38,was,1,8,36,28,7,1,-7,35,American Federation of Labor,AFL-CIO,---,org,PROPN-PROPN-ADP-PROPN,ADV,compound-pobj-prep-compound,appos,NNP-NNP-IN-NNP,RB,7,1
596,203.0,12,is,4,2,2,0,1,9,2,-2,Elon University,Elon,-,org,PROPN-PROPN,PROPN,compound-compound,compound,NNP-NNP,NNP,0,1
597,204.0,27,served,1,10,18,8,9,8,-9,17,Iran,Shapour Bakhtiar,,org-org,PROPN,PROPN-PROPN,poss,compound-appos,NNP,NNP-NNP,6,1
598,1431.0,36,made,5,13,20,7,12,15,-8,15,Iran,Shapour Bakhtiar,,org-org,PROPN,PROPN-PROPN,dobj,compound-pobj,NNP,NNP-NNP,3,1
599,14258.0,33,convicted,3,11,16,5,10,16,-8,13,Iran,Shapour Bakhtiar,,per-per,PROPN,PROPN-PROPN,poss,compound-pobj,NNP,NNP-NNP,2,1
600,205.0,27,formed,3,10,22,12,9,4,-7,19,Stax,Wilson Pickett,org,-,PROPN,PROPN-PROPN,compound,compound-pobj,NNP,NNP-NNP,11,1
601,206.0,20,Representing,0,6,14,8,5,5,-6,14,Los Angeles County Board,Zev Yaroslavsky,---,per-per,PROPN-PROPN-PROPN-PROPN,PROPN-PROPN,compound-compound-compound-pobj,compound-nsubj,NNP-NNP-NNP-NNP,NNP-NNP,-1,1
602,207.0,28,purchased,4,6,23,17,5,4,-2,19,Gazprom Media,bank,-,per,PROPN-PROPN,NOUN,compound-dative,poss,NNP-NNP,NN,8,1
603,208.0,20,moved,3,1,11,10,0,8,2,8,Ferrell North America,Ferrellgas,--,per,PROPN-PROPN-PROPN,PROPN,compound-compound-nsubj,nmod,NNP-NNP-NNP,NNP,5,1
604,210.0,45,are,1,6,20,14,5,24,-5,19,Suwon,Ajou University,,org-org,PROPN,PROPN-PROPN,pobj,compound-compound,NNP,NNP-NNP,10,1
605,211.0,37,opened,2,27,28,1,26,8,-25,26,Canada,Stephen Harper,per,-,PROPN,PROPN-PROPN,compound,compound-pobj,NNP,NNP-NNP,1,1
606,2156.0,31,posing,16,2,11,9,1,19,14,-5,Canada,Stephen Harper,per,-,PROPN,PROPN-PROPN,poss,compound-pobj,NNP,NNP-NNP,4,1
607,2272.0,7,Canada,0,1,5,4,0,1,-1,5,Canada,Stephen Harper,org,-,PROPN,PROPN-PROPN,ROOT,compound-appos,NNP,NNP-NNP,2,1
608,3378.0,88,written,2,54,56,2,53,31,-52,54,Canada,Stephen Harper,per,-,PROPN,PROPN-PROPN,conj,compound-dobj,NNP,NNP-NNP,5,1
609,3955.0,11,Profile,0,5,9,4,4,1,-5,9,Canada,Stephen Harper,per,-,PROPN,PROPN-PROPN,poss,compound-pobj,NNP,NNP-NNP,5,1
610,4042.0,41,become,2,4,26,22,3,14,-2,24,Canada,Stephen Harper,,org-org,PROPN,PROPN-PROPN,poss,compound-poss,NNP,NNP-NNP,11,1
611,5173.0,30,said,28,1,24,23,0,5,27,-4,Canada,Stephen Harper,per,-,PROPN,PROPN-PROPN,poss,compound-dobj,NNP,NNP-NNP,7,1
612,6926.0,21,calling,8,1,6,5,0,14,7,-2,Canada,Stephen Harper,,per-per,PROPN,PROPN-PROPN,poss,compound-nsubj,NNP,NNP-NNP,3,1
613,7076.0,21,blamed,8,1,5,4,0,15,7,-3,Canada,Stephen Harper,per,-,PROPN,PROPN-PROPN,poss,compound-nsubj,NNP,NNP-NNP,3,1
614,12397.0,27,said,24,1,23,22,0,3,23,-1,Canada,Stephen Harper,org,-,PROPN,PROPN-PROPN,nsubj,compound-nsubj,NNP,NNP-NNP,3,1
615,12765.0,20,visit,7,9,15,6,8,4,-2,8,Canada,Stephen Harper,,org-org,PROPN,PROPN-PROPN,dobj,compound-nsubj,NNP,NNP-NNP,4,1
616,13958.0,26,was,10,7,21,14,6,4,3,11,Canada,Stephen Harper,per,-,PROPN,PROPN-PROPN,poss,compound-poss,NNP,NNP-NNP,10,1
617,14260.0,26,appointed,2,8,14,6,7,11,-6,12,Canada,Stephen Harper,org,-,PROPN,PROPN-PROPN,pobj,compound-pobj,NNP,NNP-NNP,3,1
618,212.0,25,?Alas,2,1,4,3,0,20,1,2,Mihailo Petrovi?,( Serbia,-,org-org,NOUN-NOUN,PUNCT-PROPN,nmod-amod,punct-nmod,NNS-NN,-LRB--NNP,-1,1
619,10757.0,26,Petrovi?,1,1,4,3,0,21,0,3,Mihailo Petrovi?,( Serbia,-,per-per,NOUN-NOUN,PUNCT-PROPN,compound-ROOT,punct-nmod,NNS-NN,-LRB--NNP,-1,1
620,213.0,29,commended,2,15,28,13,14,0,-13,26,Lebanese Armed Forces,Lebanon,--,per,ADJ-PROPN-PROPN,PROPN,compound-compound-pobj,pobj,JJ-NNP-NNPS,NNP,9,1
621,363.0,56,passed,8,41,8,-33,40,47,-33,0,Lebanese Armed Forces,Lebanon,per-per-per,,ADJ-PROPN-PROPN,PROPN,compound-compound-nsubj,poss,JJ-NNP-NNPS,NNP,6,1
622,2660.0,43,became,17,22,28,6,21,14,-5,11,Lebanese Armed Forces,Lebanon,per-per-per,,ADJ-PROPN-PROPN,PROPN,compound-compound-pobj,nsubj,JJ-NNP-NNPS,NNP,5,1
623,5808.0,41,took,10,5,40,35,4,0,5,30,Lebanese Armed Forces,Lebanon,--,per,ADJ-PROPN-PROPN,PROPN,compound-compound-pobj,pobj,JJ-NNP-NNPS,NNP,6,1
624,7472.0,33,dissolved,14,18,27,9,17,5,-4,13,Lebanese Armed Forces,Lebanon,--,per,ADJ-PROPN-PROPN,PROPN,compound-compound-nsubj,poss,JJ-NNP-NNPS,NNP,7,1
625,7507.0,45,include,7,2,10,8,1,34,5,3,Lebanese Armed Forces,Lebanon,per-per-per,,ADJ-PROPN-PROPN,PROPN,compound-compound-poss,dobj,JJ-NNP-NNPS,NNP,6,1
626,7658.0,20,Suleiman,0,4,19,15,3,0,-4,19,Lebanese Armed Forces,Lebanon,org-org-org,,ADJ-PROPN-PROPN,PROPN,amod-compound-pobj,pobj,JJ-NNP-NNPS,NNP,7,1
627,7822.0,33,dissolved,14,18,27,9,17,5,-4,13,Lebanese Armed Forces,Lebanon,--,per,ADJ-PROPN-PROPN,PROPN,compound-compound-nsubj,poss,JJ-NNP-NNPS,NNP,7,1
628,12371.0,45,include,7,2,10,8,1,34,5,3,Lebanese Armed Forces,Lebanon,--,org,ADJ-PROPN-PROPN,PROPN,compound-compound-poss,dobj,JJ-NNP-NNPS,NNP,6,1
629,12602.0,37,are,1,12,31,19,11,5,-11,30,Lebanese Armed Forces,Lebanon,--,per,ADJ-PROPN-PROPN,PROPN,compound-compound-pobj,pobj,JJ-NNP-NNPS,NNP,12,1
630,14007.0,32,supplying,2,5,17,12,4,14,-3,15,Lebanese Armed Forces,Lebanon,per-per-per,,ADJ-PROPN-PROPN,PROPN,compound-compound-dobj,dobj,JJ-NNP-NNPS,NNP,5,1
631,214.0,28,are,20,9,12,3,8,15,11,-8,University,Texas,per,,PROPN,PROPN,pobj,pobj,NNP,NNP,2,1
632,215.0,59,was,4,10,23,13,9,35,-6,19,Nigeria,Sani Abacha,org,-,PROPN,PROPN-PROPN,pobj,compound-pobj,NNP,NNP-NNP,5,1
633,790.0,29,served,7,14,27,13,13,1,-7,20,Nigeria,Sani Abacha,per,-,PROPN,PROPN-PROPN,pobj,compound-pobj,NNP,NNP-NNP,5,1
634,1227.0,55,was,15,11,50,39,10,4,4,35,Nigeria,Sani Abacha,,per-per,PROPN,PROPN-PROPN,pobj,compound-pobj,NNP,NNP-NNP,9,1
635,2002.0,28,Commodore,1,13,26,13,12,1,-12,25,Nigeria,Sani Abacha,,per-per,PROPN,PROPN-PROPN,pobj,compound-pobj,NNP,NNP-NNP,5,1
636,2158.0,62,Colonel,0,14,27,13,13,34,-14,27,Nigeria,Sani Abacha,,org-org,PROPN,PROPN-PROPN,pobj,compound-pobj,NNP,NNP-NNP,9,1
637,2466.0,26,appointed,4,11,24,13,10,1,-7,20,Nigeria,Sani Abacha,org,-,PROPN,PROPN-PROPN,pobj,compound-pobj,NNP,NNP-NNP,5,1
638,4708.0,30,Commander,1,14,28,14,13,1,-13,27,Nigeria,Sani Abacha,per,-,PROPN,PROPN-PROPN,pobj,compound-pobj,NNP,NNP-NNP,5,1
639,6017.0,22,born,18,9,12,3,8,9,9,-6,Nigeria,Sani Abacha,per,-,PROPN,PROPN-PROPN,pobj,nmod-nmod,NNP,NNP-NNP,2,1
640,9218.0,29,Commodore,0,14,27,13,13,1,-14,27,Nigeria,Sani Abacha,org,-,PROPN,PROPN-PROPN,pobj,compound-pobj,NNP,NNP-NNP,5,1
641,9744.0,39,return,5,1,20,19,0,18,4,15,Nigeria,Sani Abacha,per,-,PROPN,PROPN-PROPN,poss,compound-compound,NNP,NNP-NNP,7,1
642,11929.0,25,played,1,12,23,11,11,1,-11,22,Nigeria,Sani Abacha,,org-org,PROPN,PROPN-PROPN,compound,compound-pobj,NNP,NNP-NNP,4,1
643,12308.0,28,acting,4,10,19,9,9,8,-6,15,Nigeria,Sani Abacha,org,-,PROPN,PROPN-PROPN,pobj,compound-nsubj,NNP,NNP-NNP,4,1
644,13543.0,35,fought,2,1,13,12,0,21,1,11,Nigeria,Sani Abacha,per,-,PROPN,PROPN-PROPN,nsubj,compound-pobj,NNP,NNP-NNP,6,1
645,216.0,34,Located,0,4,7,3,3,26,-4,7,Submarine,London,,org,PROPN,PROPN,compound,compound,NNP,NNP,2,1
646,217.0,38,refers,10,27,36,9,26,1,-17,26,American,Vivian Vance,,per-per,ADJ,PROPN-PROPN,amod,compound-conj,JJ,NNP-NNP,4,1
647,218.0,36,remaking,15,1,7,6,0,28,14,-8,Andrew Witty,GlaxoSmithKline,per-per,,PROPN-PROPN,PROPN,compound-nsubj,compound,NNP-NNP,NNP,4,1
648,219.0,29,was,4,12,17,5,11,11,-8,13,School of International Service,SIS,---,per,PROPN-ADP-PROPN-PROPN,PROPN,dobj-prep-compound-pobj,appos,NNP-IN-NNP-NNP,NNP,2,1
649,630.0,17,received,1,7,12,5,6,4,-6,11,School of International Service,SIS,---,per,PROPN-ADP-PROPN-PROPN,PROPN,pobj-prep-compound-pobj,appos,NNP-IN-NNP-NNP,NNP,2,1
650,12313.0,29,is,9,16,21,5,15,7,-7,12,School of International Service,SIS,per-per-per-per,,PROPN-ADP-PROPN-PROPN,PROPN,pobj-prep-compound-pobj,appos,NNP-IN-NNP-NNP,NNP,2,1
651,220.0,67,existed,6,42,1,-41,41,65,-36,-5,Imperial College London,Charing Cross Hospital,--,org-org-org,PROPN-PROPN-PROPN,PROPN-PROPN-PROPN,compound-compound-pobj,nmod-compound-compound,NNP-NNP-NNP,NNP-NNP-NNP,11,1
652,8500.0,29,was,3,10,17,7,9,11,-7,14,Imperial College London,Charing Cross Hospital,per-per-per,--,PROPN-PROPN-PROPN,PROPN-PROPN-PROPN,compound-compound-pobj,compound-compound-pobj,NNP-NNP-NNP,NNP-NNP-NNP,11,1
653,221.0,80,blamed,2,39,50,11,38,29,-37,48,Greece,Karolos Papoulias,org,-,PROPN,PROPN-PROPN,pobj,compound-pobj,NNP,NNP-NNP,11,1
654,2652.0,29,said,26,11,22,11,10,6,15,-4,Greece,Karolos Papoulias,per,-,PROPN,PROPN-PROPN,pobj,compound-compound,NNP,NNP-NNP,5,1
655,4261.0,20,appointed,4,17,18,1,16,1,-13,14,Greece,Karolos Papoulias,,org-org,PROPN,PROPN-PROPN,compound,compound-pobj,NNP,NNP-NNP,1,1
656,5196.0,26,came,10,8,9,1,7,16,2,-1,Greece,Karolos Papoulias,org,-,PROPN,PROPN-PROPN,compound,compound-pobj,NNP,NNP-NNP,1,1
657,222.0,52,died,25,1,1,0,0,50,24,-24,Baldwin II of Jerusalem,Baldwin,org-org-org-org,,PROPN-PROPN-ADP-PROPN,PROPN,compound-nsubj-prep-pobj,compound,NNP-NNP-IN-NNP,NNP,0,1
658,223.0,23,started,5,10,15,5,9,7,-5,10,Mogadishu,Aidid,,per,PROPN,PROPN,pobj,nsubj,NNP,NNP,5,1
659,224.0,22,telling,1,15,16,1,14,5,-14,15,Education,Margaret Spellings,per,-,PROPN,PROPN-PROPN,pobj,compound-nsubj,NNP,NNP-NNP,4,1
660,6089.0,17,fear,4,7,9,2,6,7,-3,5,Education,Margaret Spellings,per,-,PROPN,PROPN-PROPN,compound,compound-nsubj,NNP,NNP-NNP,1,1
661,6149.0,26,begun,14,11,12,1,10,13,3,-2,Education,Margaret Spellings,,per-per,PROPN,PROPN-PROPN,pobj,compound-dobj,NNP,NNP-NNP,1,1
662,6488.0,28,exhibited,3,24,26,2,23,1,-21,23,Education,Margaret Spellings,per,-,PROPN,PROPN-PROPN,compound,compound-conj,NNP,NNP-NNP,1,1
663,9134.0,15,credited,4,1,3,2,0,11,3,-1,Education,Margaret Spellings,org,-,PROPN,PROPN-PROPN,compound,compound-nsubj,NNP,NNP-NNP,1,1
664,9417.0,26,equipped,18,10,11,1,9,14,8,-7,Education,Margaret Spellings,,org-org,PROPN,PROPN-PROPN,pobj,compound-pobj,NNP,NNP-NNP,1,1
665,10562.0,35,ensured,9,31,33,2,30,1,-22,24,Education,Margaret Spellings,org,-,PROPN,PROPN-PROPN,compound,compound-pobj,NNP,NNP-NNP,3,1
666,13136.0,67,are,4,21,23,2,20,43,-17,19,Education,Margaret Spellings,org,-,PROPN,PROPN-VERB,compound,compound-ROOT,NNP,NNP-VBZ,1,1
667,13249.0,43,appeared,12,18,20,2,17,22,-6,8,Education,Margaret Spellings,,per-per,PROPN,PROPN-PROPN,compound,compound-nsubj,NNP,NNP-NNP,4,1
668,225.0,33,was,12,1,16,15,0,16,11,4,Ortega,Nicaragua,,per,VERB,PROPN,nmod,pobj,VB,NNP,3,1
669,2533.0,23,elected,3,1,16,15,0,6,2,13,Ortega,Nicaragua,per,,PROPN,PROPN,nsubjpass,poss,NNP,NNP,5,1
670,6644.0,11,born,2,1,10,9,0,0,1,8,Ortega,Nicaragua,org,,PROPN,PROPN,nsubjpass,pobj,NNP,NNP,2,1
671,13904.0,11,LD,1,4,8,4,3,2,-3,7,Ortega,Nicaragua,per,,PROPN,PROPN,nsubj,poss,NNP,NNP,4,1
672,226.0,25,Born,0,4,5,1,3,19,-4,5,Italy,Dario Marianelli,,per-per,PROPN,PROPN-PROPN,compound,compound-pobj,NNP,NNP-NNP,1,1
673,227.0,42,consists,7,29,34,5,28,7,-22,27,China,Wen Jiabao,per,-,PROPN,PROPN-PROPN,pobj,compound-dobj,NNP,NNP-NNP,5,1
674,5877.0,26,pay,7,13,24,11,12,1,-6,17,China,Wen Jiabao,,per-per,PROPN,PROPN-PROPN,pobj,compound-pobj,NNP,NNP-NNP,5,1
675,228.0,18,was,7,6,17,11,5,0,1,10,Hosokawa,Japan,,per,PROPN,PROPN,compound,pobj,NNP,NNP,2,1
676,229.0,26,referred,7,17,20,3,16,5,-10,13,Southern Illinois University Edwardsville,Edwardsville,---,per,PROPN-PROPN-PROPN-PROPN,PROPN,compound-compound-compound-pobj,compound,NNP-NNP-NNP-NNP,NNP,2,1
677,12482.0,19,is,4,10,13,3,9,5,-6,9,Southern Illinois University Edwardsville,Edwardsville,per-per-per-per,,PROPN-PROPN-PROPN-PROPN,PROPN,compound-compound-compound-pobj,compound,NNP-NNP-NNP-NNP,NNP,2,1
678,230.0,23,consists,1,17,17,0,16,5,-16,16,Gloucester High School,Gloucester,per-per-per,,PROPN-PROPN-PROPN,PROPN,compound-compound-conj,compound,NNP-NNP-NNP,NNP,0,1
679,9366.0,28,investigating,9,3,3,0,2,24,6,-6,Gloucester High School,Gloucester,--,per,PROPN-PROPN-PROPN,PROPN,compound-compound-pobj,compound,NNP-NNP-NNP,NNP,0,1
680,231.0,24,nominated,6,4,13,9,3,10,2,7,Chester A. Arthur,United States,org-org-org,-,PROPN-PROPN-PROPN,PROPN-PROPN,compound-compound-nsubj,compound-compound,NNP-NNP-NNP,NNP-NNP,7,1
681,232.0,25,worked,2,5,21,16,4,3,-3,19,STAR News,INDIA,org-org,,PROPN-PROPN,VERB,compound-compound,conj,NNP-NNP,VBP,8,1
682,233.0,17,is,1,10,16,6,9,0,-9,15,Finland,Valio,per,,PROPN,PROPN,pobj,appos,NNP,NNP,6,1
683,234.0,84,passed,2,10,21,11,9,62,-8,19,Mughal Emperor,Akbar Shah II,org-org,--,PROPN-PROPN,PROPN-PROPN-PROPN,compound-compound,compound-compound-appos,NNP-NNP,NNP-NNP-NNP,7,1
684,235.0,23,was,2,1,11,10,0,11,1,9,Meier Frank,Portland,-,org,PROPN-PROPN,PROPN,compound-nsubj,compound,NNP-NNP,NNP,7,1
685,237.0,27,served,2,14,15,1,13,11,-12,13,State,Lawrence Eagleburger,org,-,PROPN,PROPN-PROPN,pobj,compound-pobj,NNP,NNP-NNP,1,1
686,294.0,22,Eagleburger,5,4,5,1,3,16,1,0,State,Lawrence Eagleburger,,per-per,PROPN,PROPN-PROPN,pobj,compound-ROOT,NNP,NNP-NNP,1,1
687,996.0,29,fired,14,12,13,1,11,15,2,-1,State,Lawrence Eagleburger,org,-,PROPN,PROPN-PROPN,pobj,compound-nsubj,NNP,NNP-NNP,1,1
688,2601.0,41,strategists,15,34,35,1,33,5,-19,20,State,Lawrence Eagleburger,org,-,PROPN,PROPN-PROPN,pobj,compound-ROOT,NNP,NNP-NNP,1,1
689,3574.0,26,Yet,0,9,10,1,8,15,-9,10,State,Lawrence Eagleburger,per,-,PROPN,PROPN-PROPN,pobj,compound-nmod,NNP,NNP-NNP,1,1
690,3649.0,21,made,11,8,9,1,7,11,3,-2,State,Lawrence Eagleburger,,per-per,PROPN,PROPN-PROPN,pobj,compound-compound,NNP,NNP-NNP,2,1
691,6034.0,35,help,4,10,11,1,9,23,-6,7,State,Lawrence Eagleburger,,per-per,PROPN,PROPN-PROPN,pobj,compound-nsubjpass,NNP,NNP-NNP,1,1
692,9399.0,24,told,6,4,5,1,3,18,2,-1,State,Lawrence Eagleburger,,org-org,PROPN,PROPN-PROPN,pobj,compound-nsubj,NNP,NNP-NNP,1,1
693,9757.0,46,was,12,43,44,1,42,1,-31,32,State,Lawrence Eagleburger,org,-,PROPN,PROPN-PROPN,pobj,compound-pobj,NNP,NNP-NNP,1,1
694,13103.0,18,gave,1,6,7,1,5,10,-5,6,State,Lawrence Eagleburger,,org-org,PROPN,PROPN-PROPN,pobj,compound-dative,NNP,NNP-NNP,1,1
695,238.0,20,attended,1,10,13,3,9,6,-9,12,Kentucky,Southern Baptist Theological Seminary,per,---,PROPN,PROPN-PROPN-PROPN-PROPN,pobj,compound-compound-compound-conj,NNP,NNP-NNP-NNP-NNP,3,1
696,239.0,33,said,13,1,12,11,0,20,12,-1,Citigroup,Vikram Pandit,,per-per,PROPN,PROPN-PROPN,nsubj,compound-pobj,NNP,NNP-NNP,5,1
697,240.0,22,says,14,10,13,3,9,8,4,-1,Joseph Sitt,Thor Equities,-,org-org,PROPN-PROPN,PROPN-PROPN,compound-poss,compound-nsubj,NNP-NNP,NNP-NNP,1,1
698,241.0,21,was,3,8,15,7,7,5,-5,12,Cecily Neville,Richard Plantagenet,org-org,-,PROPN-PROPN,PROPN-PROPN,compound-compound,compound-compound,NNP-NNP,NNP-NNP,6,1
699,242.0,32,called,2,12,16,4,11,15,-10,14,Australia,Alexander Downer,,org-org,PROPN,PROPN-PROPN,poss,compound-conj,NNP,NNP-NNP,3,1
700,8379.0,26,signed,3,15,16,1,14,9,-12,13,Australia,Alexander Downer,,org-org,PROPN,PROPN-PROPN,pobj,compound-pobj,NNP,NNP-NNP,1,1
701,9138.0,7,Downer,5,1,5,4,0,1,4,0,Australia,Alexander Downer,,per-per,PROPN,PROPN-PROPN,poss,compound-ROOT,NNP,NNP-NNP,3,1
702,243.0,21,won,5,5,14,9,4,6,0,9,Hollande,Socialist Party,per,-,PROPN,PROPN-PROPN,appos,compound-compound,NNP,NNP-NNP,4,1
703,244.0,38,speaking,2,15,32,17,14,5,-13,30,Tehran,Ruhollah Khomeini,,per-per,PROPN,PROPN-PROPN,pobj,compound-appos,NNP,NNP-NNP,7,1
704,245.0,24,is,1,13,22,9,12,1,-12,21,Scorpions,Mercury,per,,PROPN,PROPN,pobj,compound,NNPS,NNP,3,1
705,246.0,34,departed,16,7,30,23,6,3,9,14,Grateful Dead,Garcia,-,per,PROPN-PROPN,PROPN,compound-pobj,nsubj,NNP-NNP,NNP,8,1
706,247.0,28,performed,1,8,12,4,7,15,-7,11,Okkervil River,Austin,per-per,,PROPN-PROPN,PROPN,compound-pobj,compound,NNP-NNP,NNP,6,1
707,248.0,35,began,5,5,17,12,4,17,0,12,Germany,IG Metall,,per-per,PROPN,PROPN-PROPN,pobj,compound-nsubj,NNP,NNP-NNP,5,1
708,249.0,32,graduated,1,15,1,-14,14,30,-14,0,Country Garden,Yang Guoqiang,per-per,-,PROPN-PROPN,PROPN-PROPN,compound-dobj,compound-appos,NNP-NNP,NNP-NNP,2,1
709,11161.0,66,are,1,37,40,3,36,25,-36,39,Country Garden,Yang Guoqiang,per-per,-,PROPN-PROPN,PROPN-PROPN,compound-poss,compound-conj,NNP-NNP,NNP-NNP,5,1
710,251.0,30,took,3,3,14,11,2,15,0,11,he,Damascus,org,,PRON,PROPN,nsubj,compound,PRP,NNP,3,1
711,252.0,13,developed,5,3,5,2,2,7,2,0,General Electric,he,-,per,PROPN-PROPN,PRON,compound-pobj,nsubj,NNP-NNP,PRP,2,1
712,253.0,11,served,6,2,5,3,1,5,4,-1,12 June 2008,News Now,per-per-per,-,NUM-PROPN-NUM,PROPN-ADV,nummod-pobj-nummod,pobj-advmod,CD-NNP-CD,NNP-RB,3,1
713,254.0,23,linked,3,7,15,8,6,7,-4,12,Ryan Phillippe,Reese Witherspoon,-,per-per,PROPN-PROPN,PROPN-PROPN,compound-pobj,compound-pobj,NNP-NNP,NNP-NNP,6,1
714,255.0,78,proposed,11,4,6,2,3,71,7,-5,Prime Minister,Fouad Siniora,-,org-org,PROPN-PROPN,PROPN-PROPN,compound-compound,compound-nsubj,NNP-NNP,NNP-NNP,1,1
715,256.0,29,served,2,1,22,21,0,6,1,20,He,Veterans Affairs,,per-per,PRON,PROPN-PROPN,nsubj,pobj-attr,PRP,NNP-NNPS,3,1
716,257.0,46,turned,1,1,15,14,0,30,0,14,Thanom,Thailand,,per,PROPN,PROPN,nsubj,dobj,NNP,NNP,6,1
717,7115.0,39,withdrew,3,20,27,7,19,11,-17,24,Thanom,Thailand,,per,PROPN,PROPN,nmod,compound,NNP,NNP,-1,1
718,258.0,44,found,8,1,7,6,0,36,7,-1,Alex Counts,Grameen Foundation,per-per,-,PROPN-PROPN,PROPN-PROPN,compound-compound,compound-pobj,NNP-NNP,NNP-NNP,3,1
719,13889.0,39,said,23,25,30,5,24,8,-2,7,Alex Counts,Grameen Foundation,-,per-per,PROPN-PROPN,PROPN-PROPN,compound-compound,compound-pobj,NNP-NNP,NNP-NNP,3,1
720,259.0,16,acquainted,5,4,12,8,3,3,1,7,he,Finland,per,,PRON,PROPN,nsubj,poss,PRP,NNP,8,1
721,260.0,37,was,1,28,36,8,27,0,-27,35,John Robinson,London,-,org,PROPN-PROPN,PROPN,compound-compound,pobj,NNP-NNP,NNP,12,1
722,11826.0,16,distinguished,7,2,6,4,1,9,5,-1,John Robinson,London,org-org,,PROPN-PROPN,PROPN,compound-compound,pobj,NNP-NNP,NNP,3,1
723,261.0,18,joined,2,4,16,12,3,1,-2,14,Star Alliance,United Airlines,per-per,-,PROPN-PROPN,PROPN-PROPN,compound-dobj,compound-pobj,NNP-NNP,NNP-NNP,6,1
724,262.0,17,built,10,7,10,3,6,6,3,0,Edwin Barclay,Liberia,per-per,,PROPN-PROPN,PROPN,compound-nsubj,pobj,NNP-NNP,NNP,3,1
725,263.0,35,fell,17,6,7,1,5,27,11,-10,Emperor,John VIII Palaiologos,org,--,PROPN,PROPN-PROPN-PROPN,compound,compound-compound-pobj,NNP,NNP-NNP-NNP,2,1
726,264.0,32,said,27,5,7,2,4,24,22,-20,Justice,Clemente Mastella,per,-,PROPN,PROPN-PROPN,compound,compound-nsubj,NNP,NNP-NNP,1,1
727,555.0,34,said,32,2,4,2,1,29,30,-28,Justice,Clemente Mastella,per,-,PROPN,PROPN-PROPN,compound,compound-nsubj,NNP,NNP-NNP,1,1
728,3288.0,36,scheduled,5,28,30,2,27,5,-23,25,Justice,Clemente Mastella,,org-org,PROPN,PROPN-PROPN,compound,compound-dobj,NNP,NNP-NNP,3,1
729,10532.0,23,hailed,7,2,4,2,1,18,5,-3,Justice,Clemente Mastella,per,-,PROPN,PROPN-PROPN,compound,compound-nsubj,NNP,NNP-NNP,1,1
730,265.0,15,visited,7,4,5,1,3,9,3,-2,Armenia,Serzh Sargsyan,,per-per,PROPN,PROPN-PROPN,compound,compound-pobj,NNP,NNP-NNP,1,1
731,1584.0,79,gave,2,42,43,1,41,35,-40,41,Armenia,Serzh Sargsyan,org,-,PROPN,PROPN-PROPN,compound,compound-pobj,NNP,NNP-NNP,1,1
732,4755.0,35,awarded,19,14,18,4,13,16,5,-1,Armenia,Serzh Sargsyan,,per-per,PROPN,PROPN-PROPN,poss,compound-nsubj,NNP,NNP-NNP,5,1
733,7249.0,26,was,1,17,20,3,16,5,-16,19,Armenia,Serzh Sargsyan,per,-,PROPN,PROPN-PROPN,pobj,compound-pobj,NNP,NNP-NNP,1,1
734,11423.0,97,rooted,7,4,51,47,3,45,3,44,Armenia,Serzh Sargsyan,per,-,PROPN,PROPN-PROPN,compound,compound-pobj,NNP,NNP-NNP,8,1
735,266.0,35,played,1,4,21,17,3,13,-3,20,England,Stroud College,,per-per,PROPN,PROPN-PROPN,compound,compound-conj,NNP,NNP-NNP,7,1
736,267.0,48,received,40,5,7,2,4,40,35,-33,Iranian,Ali Javan,,per-per,ADJ,PROPN-PROPN,amod,compound-appos,JJ,NNP-NNP,1,1
737,269.0,29,expressed,3,11,11,0,10,17,-8,8,Zimbabwe,Zimbabwe Congress of Trade Unions,,per-per-per-per-per,PROPN,PROPN-PROPN-ADP-PROPN-PROPN,pobj,compound-pobj-prep-compound-pobj,NNP,NNP-NNP-IN-NNP-NNPS,0,1
738,270.0,55,announced,23,12,22,10,11,32,11,-1,Bob Graham,Florida,per-per,,PROPN-PROPN,PROPN,compound-pobj,pobj,NNP-NNP,NNP,6,1
739,2895.0,32,amended,14,9,12,3,8,19,5,-2,Bob Graham,Florida,-,per,PROPN-PROPN,PROPN,compound-pobj,pobj,NNP-NNP,NNP,2,1
740,6055.0,28,were,3,11,15,4,10,12,-8,12,Bob Graham,Florida,per-per,,PROPN-PROPN,PROPN,compound-pobj,compound,NNP-NNP,NNP,1,1
741,8369.0,28,passed,9,8,15,7,7,12,1,6,Bob Graham,Florida,org-org,,PROPN-PROPN,PROPN,compound-pobj,compound,NNP-NNP,NNP,4,1
742,9949.0,29,Bridge,7,20,27,7,19,1,-13,20,Bob Graham,Florida,-,per,PROPN-PROPN,PROPN,compound-compound,compound,NNP-NNP,NNP,5,1
743,13749.0,41,focused,10,1,4,3,0,36,9,-6,Bob Graham,Florida,org-org,,PROPN-PROPN,PROPN,compound-nsubjpass,compound,NNP-NNP,NNP,2,1
744,271.0,59,think,20,35,43,8,34,15,-15,23,Abacha,Nigeria,,org,PROPN,PROPN,poss,pobj,NNP,NNP,5,1
745,3421.0,46,presided,22,22,26,4,21,19,0,4,Abacha,Nigeria,per,,PROPN,PROPN,conj,pobj,NNP,NNP,4,1
746,272.0,25,is,12,1,22,21,0,2,11,10,KAIST,Daejeon,per,,PROPN,PROPN,nsubj,compound,NNP,NNP,8,1
747,273.0,24,is,1,11,23,12,10,0,-10,22,Pharoah Sanders,Impulse,per-per,,PROPN-PROPN,PROPN,compound-conj,pobj,NNP-NNP,NNP,2,1
748,274.0,38,pointed,1,24,28,4,23,9,-23,27,Liberia,Charles Taylor,org,-,PROPN,PROPN-PROPN,pobj,compound-poss,NNP,NNP-NNP,3,1
749,927.0,21,headed,8,7,19,12,6,1,1,11,Liberia,Charles Taylor,per,-,PROPN,PROPN-PROPN,compound,compound-pobj,NNP,NNP-NNP,4,1
750,275.0,31,has,10,2,10,8,1,20,8,0,Colegio de San Juan de Letran,Manila,per-per-per-per-per-per,,PROPN-PROPN-PROPN-PROPN-X-PROPN,PROPN,compound-nmod-compound-compound-nmod-compound,nsubj,NNP-NNP-NNP-NNP-FW-NNP,NNP,2,1
751,276.0,36,bestowed,4,14,18,4,13,17,-10,14,Slovenia,Janez,,per,PROPN,PROPN,pobj,pobj,NNP,NNP,3,1
752,1873.0,25,served,5,12,24,12,11,0,-7,19,Slovenia,Janez,org,,PROPN,PROPN,pobj,pobj,NNP,NNP,4,1
753,277.0,36,said,16,1,4,3,0,31,15,-12,Jeremy Travis,John Jay College of Criminal Justice,org-org,-----,PROPN-PROPN,PROPN-PROPN-PROPN-ADP-PROPN-PROPN,compound-nsubj,compound-compound-nsubj-prep-compound-compound,NNP-NNP,NNP-NNP-NNP-IN-NNP-NNP,2,1
754,278.0,33,Infirmary,2,1,22,21,0,10,1,20,Leeds General Infirmary,England,--,per,PROPN-PROPN-PROPN,PROPN,compound-compound-ROOT,pobj,NNP-NNP-NNP,NNP,3,1
755,3213.0,62,G.H.Wooler,6,11,42,31,10,19,-5,36,Leeds General Infirmary,England,--,per,PROPN-PROPN-PROPN,PROPN,compound-compound-pobj,pobj,NNP-NNP-NNP,NNP,2,1
756,279.0,39,Schalchli,2,11,1,-10,10,37,-9,-1,Chile,Denise Rosenthal,,org-org,PROPN,PROPN-PROPN,pobj,compound-nsubj,NNP,NNP-NNP,2,1
757,280.0,19,depicted,15,3,13,10,2,5,12,-2,Boston,John Singleton Copley,org,--,PROPN,PROPN-PROPN-PROPN,compound,compound-compound-appos,NNP,NNP-NNP-NNP,4,1
758,6579.0,22,created,15,1,12,11,0,9,14,-3,Boston,John Singleton Copley,org,--,PROPN,PROPN-PROPN-PROPN,compound,compound-compound-appos,NNP,NNP-NNP-NNP,4,1
759,281.0,49,sponsored,25,24,46,22,23,2,1,21,Milwaukee,Golda Meir Library,,per-per-per,PROPN,PROPN-PROPN-PROPN,compound,compound-compound-pobj,NNP,NNP-NNP-NNP,17,1
760,282.0,24,held,3,6,21,15,5,2,-3,18,Portugal,de Oliveira Salazar,,per-per-per,PROPN,PROPN-PROPN-PROPN,pobj,compound-compound-pobj,NNP,NNP-NNP-NNP,7,1
761,3219.0,29,held,3,6,19,13,5,9,-3,16,Portugal,de Oliveira Salazar,,per-per-per,PROPN,PROPN-PROPN-PROPN,pobj,compound-compound-pobj,NNP,NNP-NNP-NNP,6,1
762,6093.0,72,was,22,33,42,9,32,29,-11,20,Portugal,de Oliveira Salazar,org,--,PROPN,PROPN-PROPN-PROPN,poss,compound-compound-pobj,NNP,NNP-NNP-NNP,5,1
763,283.0,32,served,1,8,8,0,7,23,-7,7,Chicago,Chicago and Eastern Illinois Railroad,org,----,PROPN,PROPN-CCONJ-PROPN-PROPN-PROPN,compound,pobj-cc-compound-compound-conj,NNP,NNP-CC-NNP-NNP-NNP,0,1
764,13440.0,59,situated,3,21,21,0,20,37,-18,18,Chicago,Chicago and Eastern Illinois Railroad,org,----,PROPN,PROPN-CCONJ-PROPN-PROPN-PROPN,pobj,appos-cc-compound-compound-conj,NNP,NNP-CC-NNP-NNP-NNP,0,1
765,284.0,40,abolished,16,19,30,11,18,9,-3,14,Italy,Benito Mussolini,,per-per,PROPN,PROPN-PROPN,pobj,compound-pobj,NNP,NNP-NNP,6,1
766,6808.0,26,claims,3,12,16,4,11,9,-9,13,Italy,Benito Mussolini,,per-per,PROPN,PROPN-PROPN,poss,compound-appos,NNP,NNP-NNP,3,1
767,8640.0,32,drew,4,2,24,22,1,7,2,20,Italy,Benito Mussolini,,org-org,PROPN,PROPN-PROPN,nsubj,compound-poss,NNP,NNP-NNP,10,1
768,285.0,27,was,1,12,24,12,11,2,-11,23,France,Marguerite of France,,org-org-org,PROPN,PROPN-ADP-PROPN,pobj,pobj-prep-pobj,NNP,NNP-IN-NNP,6,1
769,286.0,26,is,1,21,24,3,20,1,-20,23,United States,Millard Fillmore,-,per-per,PROPN-PROPN,PROPN-PROPN,compound-compound,compound-pobj,NNP-NNP,NNP-NNP,2,1
770,287.0,34,looking,2,20,27,7,19,6,-18,25,Creation,Gem Archer,,per-per,PROPN,PROPN-PROPN,compound,compound-compound,NNP,NNP-NNP,6,1
771,288.0,21,was,9,2,20,18,1,0,7,11,Hartford College for Women,Connecticut,---,per,PROPN-PROPN-ADP-PROPN,PROPN,compound-nsubj-prep-pobj,pobj,NNP-NNP-IN-NNP,NNP,8,1
772,7389.0,20,taught,5,9,15,6,8,4,-4,10,Hartford College for Women,Connecticut,per-per-per-per,,PROPN-PROPN-ADP-PROPN,PROPN,compound-pobj-prep-pobj,pobj,NNP-NNP-IN-NNPS,NNP,3,1
773,289.0,9,said,0,2,7,5,1,1,-2,7,Ray Muzyka,BioWare,-,per,PROPN-PROPN,PROPN,nmod-nmod,compound,NNP-NNP,NNP,2,1
774,290.0,33,accepted,19,11,18,7,10,14,8,-1,Creighton University,Nebraska,org-org,,PROPN-PROPN,PROPN,compound-compound,pobj,NNP-NNP,NNP,8,1
775,1635.0,31,lists,6,2,6,4,1,24,4,0,Creighton University,Nebraska,per-per,,PROPN-PROPN,PROPN,compound-nsubj,pobj,NNP-NNP,NNP,1,1
776,7987.0,14,located,4,1,13,12,0,0,3,9,Creighton University,Nebraska,-,org,PROPN-PROPN,PROPN,compound-compound,pobj,NNP-NNP,NNP,3,1
777,291.0,25,heard,2,2,23,21,1,1,0,21,Campbell,Arkansas,,org,PROPN,PROPN,nsubj,compound,NNP,NNP,9,1
778,292.0,47,signed,4,13,16,3,12,30,-9,12,Energy,Samuel Bodman,org,-,PROPN,PROPN-PROPN,pobj,compound-conj,NNP,NNP-NNP,2,1
779,299.0,28,inked,18,2,4,2,1,23,16,-14,Energy,Samuel Bodman,,org-org,PROPN,PROPN-PROPN,compound,compound-compound,NNP,NNP-NNP,1,1
780,756.0,18,scheduled,6,2,4,2,1,13,4,-2,Energy,Samuel Bodman,per,-,PROPN,PROPN-PROPN,compound,compound-nsubjpass,NNP,NNP-NNP,1,1
781,938.0,34,said,31,28,30,2,27,3,3,-1,Energy,Samuel Bodman,org,-,PROPN,PROPN-PROPN,compound,compound-nsubj,NNP,NNP-NNP,1,1
782,1374.0,28,announced,6,1,3,2,0,24,5,-3,Energy,Samuel Bodman,org,-,PROPN,PROPN-PROPN,compound,compound-nsubj,NNP,NNP-NNP,1,1
783,2041.0,30,said,27,24,26,2,23,3,3,-1,Energy,Samuel Bodman,per,-,PROPN,PROPN-PROPN,compound,compound-nsubj,NNP,NNP-NNP,1,1
784,2631.0,25,have,5,20,21,1,19,3,-15,16,Energy,Samuel Bodman,per,-,PROPN,PROPN-PROPN,pobj,compound-nsubj,NNP,NNP-NNP,1,1
785,3199.0,59,slated,3,14,16,2,13,42,-11,13,Energy,Samuel Bodman,org,-,PROPN,PROPN-PROPN,compound,compound-pobj,NNP,NNP-NNP,1,1
786,3255.0,25,announced,6,4,5,1,3,19,2,-1,Energy,Samuel Bodman,,org-org,PROPN,PROPN-PROPN,pobj,compound-nsubj,NNP,NNP-NNP,1,1
787,3307.0,22,remains,3,16,18,2,15,3,-13,15,Energy,Samuel Bodman,,org-org,PROPN,PROPN-PROPN,compound,compound-nsubj,NNP,NNP-NNP,1,1
788,4066.0,22,said,9,6,8,2,5,13,3,-1,Energy,Samuel Bodman,,org-org,PROPN,PROPN-PROPN,compound,compound-nsubj,NNP,NNP-NNP,1,1
789,6406.0,25,announced,5,1,3,2,0,21,4,-2,Energy,Samuel Bodman,org,-,PROPN,PROPN-PROPN,compound,compound-nsubj,NNP,NNP-NNP,1,1
790,6537.0,15,said,4,1,3,2,0,11,3,-1,Energy,Samuel Bodman,per,-,PROPN,PROPN-PROPN,compound,compound-nsubj,NNP,NNP-NNP,1,1
791,6981.0,15,cited,7,4,6,2,3,8,3,-1,Energy,Samuel Bodman,,per-per,PROPN,PROPN-PROPN,compound,compound-nsubj,NNP,NNP-NNP,1,1
792,8196.0,22,addressed,18,3,4,1,2,17,15,-14,Energy,Samuel Bodman,org,-,PROPN,PROPN-PROPN,pobj,compound-nmod,NNP,NNP-NNP,2,1
793,8371.0,12,said,10,7,9,2,6,2,3,-1,Energy,Samuel Bodman,per,-,PROPN,PROPN-PROPN,compound,compound-nsubj,NNP,NNP-NNP,1,1
794,9151.0,27,expected,10,23,25,2,22,1,-13,15,Energy,Samuel Bodman,,per-per,PROPN,PROPN-PROPN,compound,compound-pobj,NNP,NNP-NNP,1,1
795,9765.0,40,rejected,4,1,3,2,0,36,3,-1,Energy,Samuel Bodman,per,-,PROPN,PROPN-PROPN,compound,compound-nsubj,NNP,NNP-NNP,1,1
796,10103.0,17,said,14,11,13,2,10,3,3,-1,Energy,Samuel Bodman,per,-,PROPN,PROPN-PROPN,compound,compound-nsubj,NNP,NNP-NNP,1,1
797,10135.0,24,chosen,12,8,10,2,7,13,4,-2,Energy,Samuel Bodman,per,-,PROPN,PROPN-PROPN,compound,compound-pobj,NNP,NNP-NNP,1,1
798,10971.0,30,said,27,24,26,2,23,3,3,-1,Energy,Samuel Bodman,per,-,PROPN,PROPN-PROPN,compound,compound-nsubj,NNP,NNP-NNP,1,1
799,11524.0,27,said,8,5,7,2,4,19,3,-1,Energy,Samuel Bodman,org,-,PROPN,PROPN-PROPN,compound,compound-nsubj,NNP,NNP-NNP,1,1
800,12876.0,33,told,4,1,3,2,0,29,3,-1,Energy,Samuel Bodman,org,-,PROPN,PROPN-PROPN,compound,compound-nsubj,NNP,NNP-NNP,1,1
801,13309.0,81,included,11,27,28,1,26,52,-16,17,Energy,Samuel Bodman,org,-,PROPN,PROPN-PROPN,pobj,compound-nsubj,NNP,NNP-NNP,1,1
802,13363.0,38,called,5,2,4,2,1,33,3,-1,Energy,Samuel Bodman,org,-,PROPN,PROPN-PROPN,compound,compound-nsubj,NNP,NNP-NNP,1,1
803,13551.0,31,announced,8,5,7,2,4,23,3,-1,Energy,Samuel Bodman,,per-per,PROPN,PROPN-PROPN,compound,compound-nsubj,NNP,NNP-NNP,1,1
804,14031.0,37,issued,4,1,3,2,0,33,3,-1,Energy,Samuel Bodman,,org-org,PROPN,PROPN-PROPN,compound,compound-nsubj,NNP,NNP-NNP,1,1
805,293.0,24,was,11,1,15,14,0,8,10,4,Juan Sinforiano,Paraguayan,per-per,,PROPN-PROPN,PROPN,compound-nsubj,compound,NNP-NNP,NNP,2,1
806,295.0,9,is,6,2,5,3,1,3,4,-1,Caitlin Cary,Whiskeytown,per-per,,PROPN-PROPN,PROPN,compound-nsubj,appos,NNP-NNP,NNP,2,1
807,296.0,20,shot,4,15,9,-6,14,10,-11,5,Godard,Anna Karina,,per-per,PROPN,PROPN-PROPN,poss,compound-appos,NNP,NNP-NNP,7,1
808,297.0,47,In,0,24,34,10,23,12,-24,34,Chicago,Bell,per,,PROPN,PROPN,compound,poss,NNP,NNP,11,1
809,298.0,24,says,14,12,12,0,11,11,2,-2,Lawrence,Lawrence High School,per,--,PROPN,PROPN-PROPN-PROPN,compound,compound-compound-pobj,NNP,NNP-NNP-NNP,0,1
810,300.0,26,produced,1,15,24,9,14,1,-14,23,Todd McFarlane,Image Comics,org-org,-,PROPN-PROPN,PROPN-PROPN,compound-compound,compound-pobj,NNP-NNP,NNP-NNP,5,1
811,301.0,34,went,24,7,6,-1,6,27,17,-18,James II of Scotland,King,---,per,PROPN-PROPN-ADP-PROPN,PROPN,compound-pobj-prep-pobj,compound,NNP-NNP-IN-NNP,NNP,1,1
812,303.0,24,is,10,2,20,18,1,3,8,10,Guardian Life Insurance Company of America,New York,per-per-per-per-per-per,-,PROPN-PROPN-PROPN-PROPN-ADP-PROPN,PROPN-PROPN,compound-compound-compound-nsubj-prep-pobj,compound-compound,NNP-NNP-NNP-NNP-IN-NNP,NNP-NNP,8,1
813,304.0,11,attended,1,3,9,6,2,1,-2,8,George Walton Comprehensive High School,Marietta,per-per-per-per-per,,PROPN-PROPN-PROPN-PROPN-PROPN,PROPN,compound-compound-compound-compound-dobj,compound,NNP-NNP-NNP-NNP-NNP,NNP,3,1
814,305.0,34,set,3,1,21,20,0,12,2,18,Lethbridge School,Wiltshire,org-org,,PROPN-PROPN,PROPN,compound-nsubjpass,compound,NNP-NNP,NNP,5,1
815,306.0,18,said,4,6,14,8,5,3,-2,10,Alphonso Jackson,Housing and Urban Development,org-org,---,PROPN-PROPN,PROPN-CCONJ-PROPN-PROPN,compound-nsubj,pobj-cc-compound-conj,NNP-NNP,NNP-CC-NNP-NNP,6,1
816,10779.0,84,resigned,5,73,77,4,72,6,-68,72,Alphonso Jackson,Housing and Urban Development,org-org,---,PROPN-PROPN,PROPN-CCONJ-PROPN-PROPN,compound-compound,pobj-cc-compound-conj,NNP-NNP,NNP-CC-NNP-NNP,4,1
817,307.0,37,Catch,0,23,6,-17,22,30,-23,6,Meg White,The White Stripes,org-org,--,PROPN-PROPN,DET-PROPN-PROPN,compound-conj,det-compound-pobj,NNP-NNP,DT-NNP-NNPS,10,1
818,308.0,18,finished,3,9,16,7,8,1,-6,13,Jesus Good Shepherd School,Imus,per-per-per-per,,PROPN-PROPN-PROPN-PROPN,PROPN,compound-compound-compound-pobj,compound,NNP-NNP-NNP-NNP,NNP,3,1
819,309.0,32,was,6,5,14,9,4,17,1,8,United Kingdom,Tony Blair,per-per,-,PROPN-PROPN,PROPN-PROPN,compound-pobj,compound-pobj,NNP-NNP,NNP-NNP,6,1
820,310.0,51,sent,3,5,9,4,4,41,-2,6,Niger,Seyni Oumarou,org,-,PROPN,PROPN-PROPN,poss,compound-appos,NNP,NNP-NNP,3,1
821,5272.0,31,LOME,0,3,7,4,2,23,-3,7,Niger,Seyni Oumarou,per,-,PROPN,PROPN-PROPN,poss,compound-nsubj,NNP,NNP-NNP,3,1
822,13722.0,18,ruled,7,1,4,3,0,13,6,-3,Niger,Seyni Oumarou,,org-org,ADJ,PROPN-PROPN,compound,compound-nsubj,JJ,NNP-NNP,2,1
823,311.0,23,represents,7,2,21,19,1,1,5,14,East Carolina Pirates,Conference USA,--,per-per,PROPN-PROPN-PROPN,PROPN-PROPN,compound-compound-compound,compound-pobj,NNP-NNP-NNP,NNP-NNP,8,1
824,312.0,32,is,15,1,1,0,0,30,14,-14,Seoul Metropolitan Subway,Seoul,--,per,PROPN-PROPN-PROPN,PROPN,compound-compound-pobj,dobj,NNP-NNP-NNP,NNP,0,1
825,313.0,43,ended,3,2,5,3,1,37,1,2,Desai,India,,org,PROPN,PROPN,amod,poss,NNP,NNP,4,1
826,11941.0,34,served,1,1,11,10,0,22,0,10,Desai,India,,org,PROPN,PROPN,nsubj,pobj,NNP,NNP,1,1
827,314.0,20,merged,7,10,18,8,9,1,-3,11,Mandarin Airlines,China Airlines,org-org,-,PROPN-PROPN,PROPN-PROPN,compound-pobj,compound-pobj,NNP-NNP,NNP-NNP,6,1
828,2492.0,22,owned,3,1,6,5,0,15,2,3,Mandarin Airlines,China Airlines,-,per-per,PROPN-PROPN,PROPN-PROPN,compound-nsubjpass,compound-pobj,NNP-NNP,NNP-NNP,3,1
829,315.0,19,rose,3,9,13,4,8,5,-6,10,Mercedes-Benz,Germany,org,,PROPN,PROPN,nsubj,pobj,NNP,NNP,3,1
830,316.0,29,is,5,1,17,16,0,11,4,12,YTL Corporation,Dato,per-per,,PROPN-PROPN,PROPN,compound-compound,poss,NNP-NNP,NNP,8,1
831,317.0,38,is,5,16,30,14,15,7,-11,25,Taliban,Mehsud,,org,PROPN,PROPN,pobj,nsubj,NNP,NNP,9,1
832,318.0,34,has,28,6,17,11,5,16,22,-11,T-Mobile,Germany,org,,PROPN,PROPN,nsubj,pobj,NNP,NNP,5,1
833,319.0,40,followed,2,18,27,9,17,12,-16,25,Raila Odinga,Kenya,org-org,,PROPN-PROPN,PROPN,compound-conj,pobj,NNP-NNP,NNP,4,1
834,721.0,30,At,0,18,25,7,17,4,-18,25,Raila Odinga,Kenya,org-org,,PROPN-PROPN,PROPN,compound-conj,poss,NNP-NNP,NNP,8,1
835,3894.0,34,is,6,19,29,10,18,4,-13,23,Raila Odinga,Kenya,-,per,PROPN-PROPN,PROPN,compound-compound,compound,NNP-NNP,NNP,8,1
836,11664.0,33,brokered,4,17,30,13,16,2,-13,26,Raila Odinga,Kenya,per-per,,PROPN-PROPN,PROPN,compound-conj,poss,NNP-NNP,NNP,8,1
837,13275.0,16,orders,12,11,14,3,10,1,1,2,Raila Odinga,Kenya,-,org,PROPN-PROPN,PROPN,compound-nsubj,compound,NNP-NNP,NNP,4,1
838,320.0,25,born,2,1,7,6,0,17,1,5,Richards,London,,per,PROPN,PROPN,nsubjpass,pobj,NNP,NNP,3,1
839,321.0,27,plays,2,16,17,1,15,9,-14,15,singer,Brett Anderson,org,-,NOUN,PROPN-PROPN,compound,compound-pobj,NN,NNP-NNP,1,1
840,1272.0,19,healed,3,10,11,1,9,7,-7,8,singer,Brett Anderson,,per-per,NOUN,PROPN-PROPN,compound,compound-nsubj,NN,NNP-NNP,1,1
841,322.0,48,are,2,28,32,4,27,15,-26,30,Japan,Kakuei Tanaka,per,-,PROPN,PROPN-PROPN,pobj,compound-appos,NNP,NNP-NNP,3,1
842,323.0,22,named,6,9,20,11,8,1,-3,14,him,British Columbia,per,-,PRON,PROPN-PROPN,pobj,compound-pobj,PRP,NNP-NNP,4,1
843,324.0,33,engage,9,4,7,3,3,25,5,-2,Lebanon,LAF,,per,PROPN,PROPN,compound,nsubj,NNP,NNP,3,1
844,325.0,34,short-listed,3,12,14,2,11,19,-9,11,Bank of Japan,Japan,--,per,PROPN-ADP-PROPN,PROPN,pobj-prep-pobj,pobj,NNP-IN-NNP,NNP,2,1
845,326.0,20,is,16,9,14,5,8,5,7,-2,Japan,University of Tsukuba,per,--,PROPN,PROPN-ADP-PROPN,pobj,pobj-prep-pobj,NNP,NNP-IN-NNP,4,1
846,327.0,17,is,1,1,10,9,0,6,0,9,Metalucifer,Gezolucifer,,org,NOUN,PROPN,nsubj,pobj,NN,NNP,5,1
847,328.0,20,spin,16,3,8,5,2,11,13,-8,Holden,GM,org,,PROPN,PROPN,conj,nsubj,NNP,NNP,3,1
848,13577.0,29,taken,2,1,6,5,0,22,1,4,Holden,GM,org,,PROPN,PROPN,nsubj,poss,NNP,NNP,6,1
849,329.0,52,created,8,4,2,-2,3,49,4,-6,Core,New Jersey,,org-org,PROPN,PROPN-PROPN,compound,compound-compound,NNP,NNP-NNP,2,1
850,330.0,14,left,3,3,13,10,2,0,0,10,he,Germany,org,,PRON,PROPN,nsubj,pobj,PRP,NNP,1,1
851,331.0,17,ex-Chairman,1,8,10,2,7,6,-7,9,Repsol YPF,Spain,-,org,PROPN-PROPN,PROPN,pobj-compound,poss,NNP-NNP,NNP,2,1
852,332.0,33,fuelled,8,12,27,15,11,5,-4,19,Bhutto,Pakistan,org,,PROPN,PROPN,poss,compound,NNP,NNP,8,1
853,6564.0,54,stays,4,24,20,-4,23,33,-20,16,Bhutto,Pakistan,org,,PROPN,PROPN,poss,compound,NNP,NNP,5,1
854,6913.0,37,said,12,5,7,2,4,29,7,-5,Bhutto,Pakistan,org,,PROPN,PROPN,poss,compound,NNP,NNP,3,1
855,333.0,22,was,14,1,17,16,0,4,13,3,Bernard Mandeville,philosopher,per-per,,PROPN-PROPN,ADJ,compound-nsubj,amod,NNP-NNP,JJ,3,1
856,334.0,28,Yolande,1,4,23,19,3,4,-3,22,Austria,Archduke Carl Ludwig of Austria,org,----,PROPN,PROPN-PROPN-PROPN-ADP-PROPN,compound,compound-compound-pobj-prep-pobj,NNP,NNP-NNP-NNP-IN-NNP,8,1
857,6877.0,76,married,7,16,12,-4,15,63,-9,5,Austria,Archduke Carl Ludwig of Austria,org,----,PROPN,PROPN-PROPN-PROPN-ADP-PROPN,pobj,compound-compound-pobj-prep-pobj,NNP,NNP-NNP-NNP-IN-NNP,4,1
858,335.0,17,elected,2,1,9,8,0,7,1,7,He,Prince Edward Island,per,--,PRON,PROPN-PROPN-PROPN,nsubjpass,compound-compound-pobj,PRP,NNP-NNP-NNP,6,1
859,336.0,30,offered,9,6,9,3,5,20,3,0,Chicago,Nelson,per,,PROPN,PROPN,pobj,nsubj,NNP,NNP,1,1
860,2297.0,16,accused,5,4,7,3,3,8,1,2,Chicago,Nelson,per,,PROPN,PROPN,pobj,dobj,NNP,NNP,2,1
861,337.0,53,denied,24,8,22,14,7,30,16,-2,Khmer Rouge,Khieu Samphan,-,per-per,PROPN-PROPN,PROPN-PROPN,compound-compound,compound-nsubj,NNP-NNP,NNP-NNP,4,1
862,338.0,21,nicknamed,7,2,2,0,1,18,5,-5,United States national rugby league team,United States,per-per-per-per-per-per,-,PROPN-PROPN-ADJ-NOUN-NOUN-NOUN,PROPN-PROPN,nmod-nmod-amod-compound-compound-nsubj,compound-dobj,NNP-NNP-JJ-NN-NN-NN,NNP-NNP,0,1
863,339.0,10,attended,1,3,7,4,2,2,-2,6,Fenwick High School,Oak Park,--,per-per,PROPN-PROPN-PROPN,PROPN-PROPN,compound-compound-dobj,compound-compound,NNP-NNP-NNP,NNP-NNP,5,1
864,5869.0,20,born,2,12,16,4,11,3,-10,14,Fenwick High School,Oak Park,per-per-per,-,PROPN-PROPN-PROPN,PROPN-PROPN,compound-compound-pobj,compound-compound,NNP-NNP-NNP,NNP-NNP,3,1
865,340.0,15,shows,1,4,10,6,3,4,-3,9,Duceppe,Quebec,,per,PROPN,PROPN,nsubj,poss,NNP,NNP,6,1
866,341.0,35,directed,11,11,34,23,10,0,0,23,Prachanda,Nepal,org,,PROPN,PROPN,appos,conj,NNP,NNP,1,1
867,452.0,43,is,19,16,33,17,15,9,3,14,Prachanda,Nepal,org,,PROPN,PROPN,pobj,pobj,NNP,NNP,7,1
868,492.0,48,elected,2,1,14,13,0,33,1,12,Prachanda,Nepal,per,,PROPN,PROPN,nsubjpass,pobj,NNP,NNP,2,1
869,783.0,20,visited,14,9,14,5,8,5,5,0,Prachanda,Nepal,per,,PROPN,PROPN,pobj,pobj,NNP,NNP,2,1
870,1435.0,61,touched,3,1,17,16,0,43,2,14,Prachanda,Nepal,,org,PROPN,PROPN,nsubj,compound,NNP,NNP,9,1
871,1902.0,70,include,1,36,44,8,35,25,-35,43,Prachanda,Nepal,per,,PROPN,PROPN,compound,pobj,NNP,NNP,5,1
872,3747.0,50,elected,2,1,19,18,0,30,1,17,Prachanda,Nepal,per,,PROPN,PROPN,nsubjpass,pobj,NNP,NNP,7,1
873,3787.0,23,is,1,3,20,17,2,2,-2,19,Prachanda,Nepal,,per,PROPN,PROPN,poss,appos,NNP,NNP,6,1
874,4239.0,32,suggested,22,2,8,6,1,23,20,-14,Prachanda,Nepal,per,,PROPN,PROPN,nsubj,pobj,NNP,NNP,2,1
875,4458.0,19,born,2,1,15,14,0,3,1,13,Prachanda,Nepal,per,,PROPN,PROPN,nsubjpass,poss,NNP,NNP,7,1
876,4540.0,40,filed,12,11,23,12,10,16,1,11,Prachanda,Nepal,org,,PROPN,PROPN,pobj,pobj,NNP,NNP,6,1
877,5613.0,38,Prachanda,3,4,15,11,3,22,-1,12,Prachanda,Nepal,,per,PROPN,PROPN,ROOT,pobj,NNP,NNP,2,1
878,7257.0,29,affiliated,16,5,23,18,4,5,11,7,Prachanda,Nepal,org,,PROPN,PROPN,pobj,pobj,NNP,NNP,7,1
879,7763.0,39,appealed,4,3,23,20,2,15,1,19,Prachanda,Nepal,org,,PROPN,PROPN,nsubj,pobj,NNP,NNP,4,1
880,7858.0,30,been,6,1,24,23,0,5,5,18,Prachanda,Nepal,,per,PROPN,PROPN,poss,pobj,NNP,NNP,8,1
881,7893.0,10,garlanded,1,1,5,4,0,4,0,4,Prachanda,Nepal,per,,PROPN,PROPN,nsubj,compound,NNP,NNP,3,1
882,8239.0,31,According,0,10,8,-2,9,22,-10,8,Prachanda,Nepal,per,,PROPN,PROPN,dobj,poss,NNP,NNP,1,1
883,9126.0,35,appeared,3,3,29,26,2,5,0,26,Prachanda,Nepal,per,,PROPN,PROPN,appos,pobj,NNP,NNP,1,1
884,9965.0,42,said,6,6,22,16,5,19,0,16,Prachanda,Nepal,per,,PROPN,PROPN,pobj,pobj,NNP,NNP,2,1
885,10055.0,21,set,2,1,16,15,0,4,1,14,Prachanda,Nepal,org,,PROPN,PROPN,nsubj,pobj,NNP,NNP,6,1
886,11377.0,34,voting,2,5,33,28,4,0,-3,31,Prachanda,Nepal,per,,PROPN,PROPN,poss,pobj,NNP,NNP,10,1
887,11703.0,34,scheduled,3,18,24,6,17,9,-15,21,Prachanda,Nepal,per,,PROPN,PROPN,pobj,pobj,NNP,NNP,2,1
888,12903.0,41,agreed,1,1,21,20,0,19,0,20,Prachanda,Nepal,,org,PROPN,PROPN,nsubj,pobj,NNP,NNP,6,1
889,342.0,18,was,2,1,6,5,0,11,1,4,Richard Riley,South Carolina,org-org,-,PROPN-PROPN,PROPN-PROPN,compound-nsubj,compound-compound,NNP-NNP,NNP-NNP,3,1
890,4410.0,70,jpg,0,3,10,7,2,59,-3,10,Richard Riley,South Carolina,-,per-per,PROPN-PROPN,PROPN-PROPN,compound-compound,compound-pobj,NNP-NNP,NNP-NNP,4,1
891,343.0,26,went,1,6,16,10,5,9,-5,15,Cambridge,William Pitt the Younger,per,---,PROPN,PROPN-PROPN-DET-PROPN,pobj,compound-appos-det-appos,NNP,NNP-NNP-DT-NNP,6,1
892,344.0,28,known,8,4,4,0,3,23,4,-4,Andy Samuel Griffith,Andy Griffith,per-per-per,-,PROPN-PROPN-PROPN,PROPN-PROPN,compound-compound-appos,compound-compound,NNP-NNP-NNP,NNP-NNP,0,1
893,345.0,20,born,4,1,19,18,0,0,3,15,Pieter Sjoerds Gerbrandy,Netherlands,per-per-per,,PROPN-PROPN-PROPN,PROPN,compound-compound-nsubjpass,pobj,NNP-NNP-NNP,NNP,3,1
894,346.0,36,created,8,5,6,1,4,29,3,-2,Ontario,Ernest Charles Drury,,per-per-per,PROPN,PROPN-PROPN-PROPN,compound,compound-compound-pobj,NNP,NNP-NNP-NNP,2,1
895,347.0,38,son,1,25,32,7,24,5,-24,31,Georgetown Preparatory School,United States,--,per-per,PROPN-PROPN-PROPN,PROPN-PROPN,compound-compound-pobj,compound-compound,NNP-NNP-NNP,NNP-NNP,5,1
896,348.0,24,applied,1,1,23,22,0,0,0,22,He,France,per,,PRON,PROPN,nsubj,pobj,PRP,NNP,1,1
897,5959.0,12,born,2,1,7,6,0,4,1,5,He,France,,org,PRON,PROPN,nsubjpass,pobj,PRP,NNP,4,1
898,7357.0,10,served,1,1,7,6,0,2,0,6,He,France,per,,PRON,PROPN,nsubj,pobj,PRP,NNP,1,1
899,10238.0,23,forced,2,1,11,10,0,11,1,9,He,France,org,,PRON,PROPN,nsubjpass,pobj,PRP,NNP,3,1
900,349.0,25,claimed,6,4,20,16,3,4,2,14,Scotland,Gordonstoun,,per,PROPN,PROPN,compound,dobj,NNP,NNP,6,1
901,350.0,27,called,11,4,5,1,3,21,7,-6,1915,the Kentucky Kernel,org,--,NUM,DET-PROPN-PROPN,pobj,det-compound-attr,CD,DT-NNP-NNP,1,1
902,351.0,19,released,11,2,6,4,1,12,9,-5,2005,Hero,per,,NUM,NOUN,nummod,appos,CD,NN,2,1
903,352.0,23,is,10,1,22,21,0,0,9,12,UCSY,Burma,,org,PROPN,PROPN,compound,pobj,NNP,NNP,3,1
904,353.0,51,served,2,13,29,16,12,21,-11,27,Ireland,All Hallows College,,org-org-org,PROPN,DET-PROPN-PROPN,pobj,det-compound-pobj,NNP,DT-NNP-NNP,4,1
905,354.0,10,is,1,1,7,6,0,2,0,6,He,Agriculture and Industries,,org-org-org,PRON,PROPN-CCONJ-PROPN,nsubj,pobj-cc-conj,PRP,NNP-CC-NNPS,4,1
906,355.0,12,praised,2,4,11,7,3,0,-2,9,Metaxas,Greece,org,,PROPN,PROPN,dobj,pobj,NNP,NNP,2,1
907,4389.0,36,died,1,1,20,19,0,15,0,19,Metaxas,Greece,org,,PROPN,PROPN,nsubj,nsubj,NNP,NNP,3,1
908,13370.0,12,condemned,5,4,11,7,3,0,1,6,Metaxas,Greece,,org,PROPN,PROPN,nsubj,pobj,NNP,NNP,2,1
909,13780.0,24,held,4,9,20,11,8,3,-5,16,Metaxas,Greece,org,,PROPN,PROPN,pobj,pobj,NNP,NNP,3,1
910,356.0,54,is,1,13,31,18,12,22,-12,30,Benny Hinn,Daystar Television Network,-,org-org-org,PROPN-PROPN,PROPN-PROPN-PROPN,compound-pobj,compound-compound-compound,NNP-NNP,NNP-NNP-NNP,11,1
911,357.0,26,is,11,2,10,8,1,15,9,-1,278th Armored Cavalry Regiment,Tennessee,per-per-per-per,,NOUN-PROPN-PROPN-PROPN,PROPN,amod-compound-compound-nsubj,appos,NN-NNP-NNP-NNP,NNP,3,1
912,358.0,66,buried,13,9,27,18,8,38,4,14,United States,Lyndon B. Johnson,per-per,--,PROPN-PROPN,PROPN-PROPN-PROPN,compound-compound,compound-compound-compound,NNP-NNP,NNP-NNP-NNP,-1,1
913,359.0,30,is,11,1,9,8,0,20,10,-2,Lon Nol,Cambodia,-,org,PROPN-PROPN,PROPN,compound-appos,dobj,NNP-NNP,NNP,1,1
914,360.0,22,is,2,12,21,9,11,0,-10,19,Buford Pusser,Tennessee,org-org,,PROPN-PROPN,PROPN,compound-pobj,pobj,NNP-NNP,NNP,3,1
915,361.0,28,is,5,4,25,21,3,2,1,20,Sydney,University of Sydney,,per-per-per,PROPN,PROPN-ADP-PROPN,compound,pobj-prep-pobj,NNP,NNP-IN-NNP,10,1
916,362.0,40,featured,2,1,34,33,0,5,1,32,Nash,The Hollies,per,-,PROPN,DET-PROPN,nsubjpass,det-compound,NNP,DT-NNP,5,1
917,364.0,41,formed,2,6,12,6,5,28,-4,10,Burmese,Saw Maung,,org-org,PROPN,PROPN-PROPN,compound,compound-pobj,NNP,NNP-NNP,4,1
918,365.0,47,said,31,2,26,24,1,20,29,-5,China,Shenzhen Development Bank,per,--,PROPN,PROPN-PROPN-PROPN,compound,compound-compound-pobj,NNP,NNP-NNP-NNP,8,1
919,366.0,50,announced,24,13,18,5,12,31,11,-6,Lafayette College,Daniel Weiss,org-org,-,PROPN-PROPN,PROPN-PROPN,nmod-pobj,compound-conj,NNP-NNP,NNP-NNP,2,1
920,367.0,32,reported,6,1,3,2,0,28,5,-3,Belgium,KBC bank,,per-per,PROPN,PROPN-NOUN,poss,compound-nsubj,NNP,NNP-NN,2,1
921,368.0,32,is,5,4,4,0,3,27,1,-1,Georgia Department of Transportation,Georgia,---,org,PROPN-PROPN-ADP-PROPN,PROPN,compound-pobj-prep-pobj,conj,NNP-NNP-IN-NNP,NNP,0,1
922,9543.0,29,is,8,2,2,0,1,26,6,-6,Georgia Department of Transportation,Georgia,per-per-per-per,,PROPN-PROPN-ADP-PROPN,PROPN,compound-nsubj-prep-pobj,pobj,NNP-NNP-IN-NNP,NNP,0,1
923,369.0,30,advised,15,1,14,13,0,15,14,-1,Lorne Calvert,NDP,org-org,,PROPN-PROPN,PROPN,compound-compound,appos,NNP-NNP,NNP,5,1
924,370.0,22,was,6,1,5,4,0,16,5,-1,Sudan,Ismail al-Azhari,,org-org,PROPN,PROPN-PROPN,poss,compound-nsubj,NNP,NNP-NNP,4,1
925,371.0,55,become,4,43,46,3,42,8,-39,42,John Edwards,North Carolina,org-org,-,PROPN-PROPN,PROPN-PROPN,compound-dative,compound-compound,NNP-NNP,NNP-NNP,2,1
926,6710.0,20,is,2,1,8,7,0,11,1,6,John Edwards,North Carolina,per-per,-,PROPN-PROPN,PROPN-PROPN,compound-nsubj,compound-pobj,NNP-NNP,NNP-NNP,4,1
927,12321.0,34,running,8,3,6,3,2,27,5,-2,John Edwards,North Carolina,-,org-org,PROPN-PROPN,PROPN-PROPN,compound-nsubj,compound-pobj,NNP-NNP,NNP-NNP,2,1
928,372.0,22,obtained,2,12,18,6,11,3,-10,16,University of the West Indies,Mona,per-per-per-per-per,,PROPN-ADP-DET-PROPN-PROPN,PROPN,pobj-prep-det-compound-poss,compound,NNP-IN-DT-NNP-NNP,NNP,3,1
929,5270.0,24,heads,6,17,22,5,16,1,-11,16,University of the West Indies,Mona,org-org-org-org-org,,PROPN-ADP-DET-PROPN-PROPN,PROPN,pobj-prep-det-compound-compound,compound,NNP-IN-DT-NNP-NNP,NNP,1,1
930,373.0,26,was,6,1,17,16,0,8,5,11,Daladier,France,,per,PROPN,PROPN,nsubj,pobj,NNP,NNP,4,1
931,374.0,28,attracted,1,16,26,10,15,1,-15,25,Florida,Mel Martinez,per,-,PROPN,PROPN-PROPN,poss,compound-conj,NNP,NNP-NNP,6,1
932,1113.0,38,aided,8,15,17,2,14,20,-7,9,Florida,Mel Martinez,per,-,PROPN,PROPN-PROPN,compound,compound-pobj,NNP,NNP-NNP,1,1
933,3216.0,26,running,5,1,12,11,0,13,4,7,Florida,Mel Martinez,,per-per,PROPN,PROPN-PROPN,poss,compound-dobj,NNP,NNP-NNP,5,1
934,7153.0,62,include,1,16,18,2,15,43,-15,17,Florida,Mel Martinez,,per-per,PROPN,PROPN-PROPN,compound,compound-appos,NNP,NNP-NNP,1,1
935,9495.0,22,were,4,12,14,2,11,7,-8,10,Florida,Mel Martinez,,per-per,PROPN,PROPN-PROPN,compound,compound-conj,NNP,NNP-NNP,2,1
936,9802.0,32,become,6,10,25,15,9,6,-4,19,Florida,Mel Martinez,per,-,PROPN,PROPN-PROPN,compound,compound-pobj,NNP,NNP-NNP,8,1
937,375.0,26,had,14,1,22,21,0,3,13,8,Northern Rock,England,org-org,,PROPN-PROPN,PROPN,compound-nsubj,pobj,NNP-NNP,NNP,5,1
938,376.0,71,was,3,37,25,-12,36,45,-34,22,Ohio Wesleyan University,Delaware,per-per-per,,PROPN-PROPN-PROPN,PROPN,compound-compound-compound,pobj,NNP-NNP-NNP,NNP,8,1
939,377.0,15,received,2,1,11,10,0,3,1,9,Tomei,Actress,,per,PROPN,NOUN,nsubj,pobj,NNP,NN,5,1
940,378.0,10,deal,2,5,7,2,4,2,-3,5,Malaysia,DRB-HICOM,org,,PROPN,NOUN,poss,pobj,NNP,NN,3,1
941,379.0,25,joined,7,7,17,10,6,7,0,10,Solana,Socialist Workers ' Party,org,---,PROPN,PROPN-PROPN-PART-PROPN,nsubj,compound-poss-case-nmod,NNP,NNP-NNPS-POS-NNP,4,1
942,380.0,20,Ought,1,17,19,2,16,0,-16,18,Nelson,RCA,per,,PROPN,PROPN,nsubj,dobj,NNP,NNP,4,1
943,381.0,24,is,6,20,22,2,19,1,-14,16,Australia,Samantha Jade,,org-org,PROPN,PROPN-PROPN,nmod,compound-pobj,NNP,NNP-NNP,2,1
944,382.0,27,Schlafly,1,1,4,3,0,22,0,3,Phyllis Schlafly,s Eagle Foru,per-per,--,PROPN-PROPN,PUNCT-PROPN-PROPN,compound-ROOT,ROOT-compound-compound,NNP-NNP,LS-NNP-NNP,-1,1
945,383.0,56,expelled,14,11,26,15,10,29,3,12,Burhanuddin Rabbani,Afghanistan,per-per,,PROPN-PROPN,PROPN,compound-compound,pobj,NNP-NNP,NNP,-1,1
946,7766.0,39,In,0,12,22,10,11,16,-12,22,Burhanuddin Rabbani,Afghanistan,per-per,,PROPN-PROPN,PROPN,compound-pobj,pobj,NNP-NNP,NNP,11,1
947,384.0,52,studied,1,29,39,10,28,12,-28,38,Berkeley,Richard Diebenkorn,,per-per,PROPN,PROPN-PROPN,pobj,compound-conj,NNP,NNP-NNP,6,1
948,385.0,30,elected,2,16,20,4,15,9,-14,18,Viktor Yushchenko,Ukraine,-,org,PROPN-PROPN,PROPN,compound-compound,pobj,NNP-NNP,NNP,11,1
949,386.0,35,taught,1,7,16,9,6,18,-6,15,Ontario Agricultural College,University of Guelph,per-per-per,--,PROPN-PROPN-PROPN,PROPN-ADP-PROPN,compound-compound-pobj,pobj-prep-pobj,NNP-NNP-NNP,NNP-IN-NNP,12,1
950,1747.0,22,became,8,3,17,14,2,4,5,9,Ontario Agricultural College,University of Guelph,--,org-org-org,PROPN-PROPN-PROPN,PROPN-ADP-PROPN,compound-compound-nsubj,pobj-prep-pobj,NNP-NNP-NNP,NNP-IN-NNP,8,1
951,3366.0,27,born,2,6,21,15,5,5,-4,19,Ontario Agricultural College,University of Guelph,org-org-org,--,PROPN-PROPN-PROPN,PROPN-ADP-PROPN,compound-compound-pobj,ROOT-prep-pobj,NNP-NNP-NNP,NNP-IN-NNP,3,1
952,6751.0,24,born,2,6,21,15,5,2,-4,19,Ontario Agricultural College,University of Guelph,per-per-per,--,PROPN-PROPN-PROPN,PROPN-ADP-PROPN,compound-compound-pobj,pobj-prep-pobj,NNP-NNP-NNP,NNP-IN-NNP,5,1
953,11401.0,22,was,5,14,19,5,13,2,-9,14,Ontario Agricultural College,University of Guelph,org-org-org,--,PROPN-PROPN-PROPN,PROPN-ADP-PROPN,compound-compound-pobj,pobj-prep-pobj,NNP-NNP-NNP,NNP-IN-NNP,4,1
954,387.0,47,made,2,12,15,3,11,31,-10,13,1951,Canadian Association of University Teachers,,per-per-per-per-per,NUM,PROPN-PROPN-ADP-PROPN-PROPN,meta,compound-pobj-prep-compound-pobj,CD,NNP-NNP-IN-NNP-NNPS,1,1
955,388.0,19,is,3,1,11,10,0,7,2,8,Eastside High School,Taylors,per-per-per,,PROPN-PROPN-PROPN,PROPN,compound-compound-nsubj,pobj,NNP-NNP-NNP,NNPS,6,1
956,389.0,32,Washington,1,1,15,14,0,16,0,14,George Washington,United States,-,org-org,PROPN-PROPN,PROPN-PROPN,compound-ROOT,compound-compound,NNP-NNP,NNP-NNP,5,1
957,7693.0,29,appointed,16,20,26,6,19,2,-4,10,George Washington,United States,org-org,-,PROPN-PROPN,PROPN-PROPN,compound-pobj,compound-compound,NNP-NNP,NNP-NNP,5,1
958,12717.0,26,is,7,1,24,23,0,1,6,17,George Washington,United States,-,org-org,PROPN-PROPN,PROPN-PROPN,compound-compound,compound-pobj,NNP-NNP,NNP-NNP,8,1
959,13173.0,44,was,10,1,17,16,0,26,9,7,George Washington,United States,per-per,-,PROPN-PROPN,PROPN-PROPN,compound-nsubj,compound-pobj,NNP-NNP,NNP-NNP,4,1
960,390.0,54,is,16,39,42,3,38,11,-23,26,Adam Jones,Tool,-,org,PROPN-PROPN,PROPN,compound-ROOT,appos,NNP-NNP,NNP,2,1
961,391.0,43,is,9,28,42,14,27,0,-19,33,Salvador Allende,Chile,org-org,,PROPN-PROPN,PROPN,compound-compound,pobj,NNP-NNP,NNP,6,1
962,901.0,48,discussed,3,16,19,3,15,28,-13,16,Salvador Allende,Chile,per-per,,PROPN-PROPN,PROPN,compound-pobj,pobj,NNP-NNP,NNP,3,1
963,5731.0,20,results,4,8,19,11,7,0,-4,15,Salvador Allende,Chile,-,per,PROPN-PROPN,PROPN,compound-pobj,pobj,NNP-NNP,NNP,3,1
964,9004.0,7,became,2,1,6,5,0,0,1,4,Salvador Allende,Chile,org-org,,PROPN-PROPN,PROPN,compound-nsubj,pobj,NNP-NNP,NNP,2,1
965,10419.0,21,spoke,5,4,11,7,3,9,1,6,Salvador Allende,Chile,-,org,PROPN-PROPN,PROPN,compound-nsubj,pobj,NNP-NNP,NNP,2,1
966,10642.0,8,became,3,2,7,5,1,0,1,4,Salvador Allende,Chile,-,per,PROPN-PROPN,PROPN,compound-nsubj,pobj,NNP-NNP,NNP,2,1
967,392.0,51,elected,21,5,10,5,4,40,16,-11,George Papandreou,Panhellenic Socialist Movement,per-per,--,PROPN-PROPN,PROPN-PROPN-PROPN,compound-compound,compound-compound-compound,NNP-NNP,NNP-NNP-NNP,5,1
968,393.0,103,was,3,5,23,18,4,79,-2,20,George Cabot,Massachusetts,per-per,,PROPN-PROPN,PROPN,compound-attr,pobj,NNP-NNP,NNP,7,1
969,394.0,25,went,3,2,6,4,1,18,1,3,1987,Focus,per,,NUM,PROPN,pobj,pobj,CD,NNP,4,1
970,395.0,35,Born,0,18,32,14,17,2,-18,32,John Hassall,Constance Brooke Webb,-,org-org-org,PROPN-PROPN,PROPN-PROPN-PROPN,compound-appos,compound-compound-appos,NNP-NNP,NNP-NNP-NNP,8,1
971,396.0,39,Malaria,0,20,23,3,19,15,-20,23,News Corporation,Peter Chernin,per-per,-,PROPN-PROPN,PROPN-PROPN,compound-compound,compound-pobj,NNP-NNP,NNP-NNP,2,1
972,397.0,54,led,4,12,16,4,11,37,-8,12,Bovespa,Vale,,org,PROPN,PROPN,pobj,conj,NNP,NNP,6,1
973,398.0,72,are,17,34,41,7,33,30,-17,24,113th Wing,Air National Guard,per-per,--,PROPN-NOUN,PROPN-PROPN-PROPN,compound-pobj,compound-compound-pobj,NNP-NN,NNP-NNP-NNP,4,1
974,399.0,57,include,9,15,15,0,14,41,-6,6,Chicago State University,Chicago,org-org-org,,PROPN-PROPN-PROPN,PROPN,compound-compound-conj,compound,NNP-NNP-NNP,NNP,0,1
975,400.0,32,are,4,13,28,15,12,3,-9,24,Asif Ali Zardari,Karachi,org-org-org,,PROPN-PROPN-PROPN,PROPN,compound-compound-poss,nsubj,NNP-NNP-NNP,NNP,6,1
976,8434.0,16,made,3,11,15,4,10,0,-8,12,Asif Ali Zardari,Karachi,per-per-per,,PROPN-PROPN-PROPN,PROPN,compound-compound-pobj,pobj,NNP-NNP-NNP,NNP,5,1
977,401.0,39,submitted,8,2,33,31,1,5,6,25,II Corps,Omar Bradley,-,org-org,PROPN-PROPN,PROPN-PROPN,compound-compound,compound-compound,NNP-NNP,NNP-NNP,15,1
978,402.0,75,overthrown,2,57,73,16,56,1,-55,71,Venezuela,Betancourt,org,,PROPN,PROPN,pobj,pobj,NNP,NNP,10,1
979,8091.0,50,was,21,13,17,4,12,32,8,-4,Venezuela,Betancourt,per,,PROPN,PROPN,pobj,pobj,NNP,NNP,4,1
980,403.0,42,flared,15,28,30,2,27,11,-13,15,Canterbury,Ralph d'Escures,per,-,PROPN,PROPN-PROPN,pobj,compound-pobj,NNP,NNP-NNP,1,1
981,404.0,36,opted,2,25,28,3,24,7,-23,26,Fine,Tim Schafer,org,-,PROPN,PROPN-PROPN,poss,compound-appos,NNP,NNP-NNP,3,1
982,405.0,29,given,4,6,8,2,5,20,-2,4,Treasury,Robert Rubin,,per-per,PROPN,PROPN-PROPN,compound,compound-dobj,NNP,NNP-NNP,1,1
983,858.0,57,was,1,43,45,2,42,11,-42,44,Treasury,Robert Rubin,,org-org,PROPN,PROPN-PROPN,compound,compound-conj,NNP,NNP-NNP,1,1
984,1223.0,35,went,1,11,24,13,10,10,-10,23,Treasury,Robert Rubin,per,-,PROPN,PROPN-PROPN,pobj,compound-pobj,NNP,NNP-NNP,6,1
985,1319.0,16,appointed,7,4,6,2,3,9,3,-1,Treasury,Robert Rubin,,org-org,PROPN,PROPN-PROPN,compound,compound-nsubj,NNP,NNP-NNP,1,1
986,2546.0,35,was,7,6,16,10,5,18,1,9,Treasury,Robert Rubin,per,-,PROPN,PROPN-PROPN,pobj,compound-pobj,NNP,NNP-NNP,7,1
987,6263.0,21,Rubin,13,11,13,2,10,7,2,0,Treasury,Robert Rubin,per,-,PROPN,PROPN-PROPN,compound,compound-ROOT,NNP,NNP-NNP,1,1
988,6799.0,25,who's,10,21,23,2,20,1,-11,13,Treasury,Robert Rubin,per,-,PROPN,PROPN-PROPN,compound,compound-pobj,NNP,NNP-NNP,3,1
989,8770.0,46,tapped,2,24,44,20,23,1,-22,42,Treasury,Robert Rubin,per,-,PROPN,PROPN-PROPN,compound,compound-dobj,NNP,NNP-NNP,6,1
990,9583.0,34,replaced,1,21,23,2,20,10,-20,22,Treasury,Robert Rubin,,per-per,PROPN,PROPN-PROPN,compound,compound-pobj,NNP,NNP-NNP,3,1
991,12360.0,28,were,18,10,12,2,9,15,8,-6,Treasury,Robert Rubin,per,-,PROPN,PROPN-PROPN,compound,compound-pobj,NNP,NNP-NNP,1,1
992,13967.0,34,strained,16,3,5,2,2,28,13,-11,Treasury,Robert Rubin,org,-,PROPN,PROPN-PROPN,compound,compound-nsubj,NNP,NNP-NNP,1,1
993,406.0,40,BYU-Idaho,0,1,31,30,0,8,-1,31,BYU-Idaho,Rexburg,,per,PUNCT,PROPN,ROOT,compound,NFP,NNP,-1,1
994,407.0,32,am,1,13,14,1,12,17,-12,13,President,Daniel arap Moi,org,--,PROPN,PROPN-NOUN-PROPN,compound,compound-compound-nsubj,NNP,NNP-NN-NNP,1,1
995,408.0,17,launched,3,8,16,8,7,0,-5,13,Lorie,France,,per,PROPN,PROPN,dobj,pobj,NNP,NNP,2,1
996,409.0,22,was,5,3,21,18,2,0,2,16,Toronto-Dominion Bank,Toronto,org-org,,PROPN-PROPN,PROPN,compound-compound,pobj,NNP-NNP,NNP,8,1
997,410.0,17,left,1,1,16,15,0,0,0,15,Arnold,actress,,per,PROPN,NOUN,nsubj,attr,NNP,NN,1,1
998,411.0,19,became,2,2,11,9,1,7,0,9,he,North Carolina,per,-,PRON,PROPN-PROPN,nsubj,nmod-nmod,PRP,NNP-NNP,4,1
999,412.0,40,attended,21,7,15,8,6,24,14,-6,Alberta,Alison Redford,org,-,PROPN,PROPN-PROPN,poss,compound-appos,NNP,NNP-NNP,5,1
1000,3306.0,26,announced,1,22,24,2,21,1,-21,23,Alberta,Alison Redford,,per-per,PROPN,PROPN-PROPN,compound,compound-pobj,NNP,NNP-NNP,1,1
1001,413.0,30,undergraduate,15,2,6,4,1,23,13,-9,Bute Medical School,University of St Andrews,per-per-per,---,PROPN-PROPN-PROPN,PROPN-ADP-PROPN-PROPN,compound-compound-nsubj,nmod-prep-pobj-appos,NNP-NNP-NNP,NNP-IN-NNP-NNP,3,1
1002,2773.0,37,announced,21,4,9,5,3,27,17,-12,Bute Medical School,University of St Andrews,org-org-org,---,PROPN-PROPN-PROPN,PROPN-ADP-PROPN-PROPN,compound-compound-nsubj,pobj-prep-pobj-conj,NNP-NNP-NNP,NNP-IN-NNP-NNP,4,1
1003,414.0,23,At,0,7,11,4,6,11,-7,11,Billy Hughes,Sydney,per-per,,PROPN-PROPN,PROPN,compound-nsubj,compound,NNP-NNP,NNP,2,1
1004,415.0,20,Department,0,10,17,7,9,2,-10,17,Columbia University,New York,-,per-per,PROPN-PROPN,PROPN-PROPN,compound-compound,compound-compound,NNP-NNP,NNP-NNP,6,1
1005,416.0,31,was,3,17,20,3,16,10,-14,17,Simone Veil,France,org-org,,PROPN-PROPN,PROPN,compound-pobj,pobj,NNP-NNP,NNP,3,1
1006,417.0,33,were,9,1,27,26,0,5,8,18,Norfolk and Western Railway,Roanoke Virginia,per-per-per-per,-,PROPN-CCONJ-PROPN-PROPN,PROPN-PROPN,nsubj-cc-compound-poss,compound-pobj,NNP-CC-NNP-NNP,NNP-NNP,10,1
1007,2700.0,33,turned,10,7,25,18,6,7,3,15,Norfolk and Western Railway,Roanoke Virginia,per-per-per-per,-,PROPN-CCONJ-PROPN-PROPN,PROPN-PROPN,nsubj-cc-compound-conj,compound-pobj,NNP-CC-NNP-NNP,NNP-NNP,8,1
1008,418.0,45,Regarding,0,13,21,8,12,23,-13,21,artist,Craig,org,,NOUN,PROPN,compound,nsubj,NN,NNP,8,1
1009,419.0,34,accused,10,5,7,2,4,26,5,-3,Cairo,Al-Azhar University,per,-,PROPN,PROPN-PROPN,poss,compound-compound,NNP,NNP-NNP,4,1
1010,12300.0,30,rounded,8,15,17,2,14,12,-7,9,Cairo,Al-Azhar University,org,-,PROPN,PROPN-PROPN,poss,compound-pobj,NNP,NNP-NNP,4,1
1011,420.0,25,is,4,2,14,12,1,10,2,10,Memorial High School,Texas,org-org-org,,PROPN-PROPN-PROPN,PROPN,compound-compound-nsubj,compound,NNP-NNP-NNP,NNP,7,1
1012,8479.0,27,ran,5,14,20,6,13,6,-9,15,Memorial High School,Texas,org-org-org,,PROPN-PROPN-PROPN,PROPN,compound-compound-dobj,pobj,NNP-NNP-NNP,NNP,3,1
1013,421.0,24,was,3,20,23,3,19,0,-17,20,Barnsley,England,,per,PROPN,PROPN,compound,pobj,NNP,NNP,5,1
1014,423.0,40,said,35,26,34,8,25,5,9,-1,Italy,Giuliano Amato,org,-,PROPN,PROPN-PROPN,pobj,compound-nsubj,NNP,NNP-NNP,2,1
1015,13472.0,40,announced,7,2,6,4,1,33,5,-1,Italy,Giuliano Amato,org,-,PROPN,PROPN-PROPN,pobj,compound-nsubj,NNP,NNP-NNP,2,1
1016,424.0,29,released,7,1,20,19,0,8,6,13,Corrinne,Pink Armchair Records,org,--,PROPN,PROPN-PROPN-PROPN,poss,compound-compound-appos,NNP,NNP-NNP-NNPS,7,1
1017,425.0,24,said,22,10,22,12,9,1,12,0,Japan,Fujitsu,,per,PROPN,PROPN,pobj,nsubj,NNP,NNP,2,1
1018,2933.0,23,said,12,2,10,8,1,12,10,-2,Japan,Fujitsu,org,,PROPN,PROPN,poss,nsubj,NNP,NNP,6,1
1019,426.0,22,gave,4,1,2,1,0,19,3,-2,SOFs,Robert K. Brown,,per-per-per,PROPN,PROPN-PROPN-PROPN,compound,compound-compound-nsubj,NNP,NNP-NNP-NNP,2,1
1020,427.0,23,began,9,4,9,5,3,13,5,0,Virginia,Timbaland,per,,PROPN,PROPN,compound,conj,NNP,NNP,3,1
1021,428.0,21,is,10,1,19,18,0,1,9,9,Federico Solmi,New York,-,org-org,PROPN-PROPN,PROPN-PROPN,compound-nsubj,compound-pobj,NNP-NNP,NNP-NNP,2,1
1022,429.0,24,Look,0,5,15,10,4,8,-5,15,Texas,James Baker,org,-,PROPN,PROPN-PROPN,compound,compound-compound,NNP,NNP-NNP,5,1
1023,430.0,20,nominated,2,1,7,6,0,12,1,5,Wilkinson,actor,,per,PROPN,NOUN,nsubjpass,pobj,NNP,NN,4,1
1024,432.0,34,started,1,14,19,5,13,14,-13,18,Greenwood,California,,per,PROPN,PROPN,conj,pobj,NNP,NNP,8,1
1025,433.0,27,met,2,21,5,-16,20,21,-19,3,New Jersey,Barbato,per-per,,PROPN-PROPN,PROPN,compound-compound,poss,NNP-NNP,NNP,7,1
1026,434.0,15,compelled,4,8,14,6,7,0,-4,10,Abdul Qadir Khan Durrani,Afghanistan,---,org,PROPN-PROPN-PROPN-PROPN,PROPN,compound-compound-compound-appos,dobj,NNP-NNP-NNP-NNP,NNP,4,1
1027,435.0,24,renamed,13,13,21,8,12,2,0,8,California,Gracie Allen,per,-,PROPN,PROPN-PROPN,nsubj,compound-compound,NNP,NNP-NNP,4,1
1028,436.0,41,Participating,0,14,22,8,13,18,-14,22,Iowa,Hawkeyes,,per,PROPN,PROPN,nsubj,nsubj,NNP,NNP,4,1
1029,437.0,21,ranked,2,2,4,2,1,16,0,2,Japan,her,per,,PROPN,PRON,nsubj,poss,NNP,PRP,1,1
1030,438.0,45,re-erected,16,39,41,2,38,3,-23,25,Defense,Jaak Aaviksoo,,per-per,PROPN,PROPN-PROPN,compound,compound-pobj,NNP,NNP-NNP,3,1
1031,439.0,28,occupied,1,1,7,6,0,20,0,6,He,Western Maryland College,,org-org-org,PRON,PROPN-PROPN-PROPN,nsubj,compound-compound-compound,PRP,NNP-NNP-NNP,3,1
1032,440.0,16,been,6,11,14,3,10,1,-5,8,National Education,Fillon,-,per,PROPN-PROPN,PROPN,compound-pobj,compound,NNP-NNP,NNP,4,1
1033,441.0,46,is,43,8,27,19,7,18,35,-16,Martin Feldstein,Council of Economic Advisers,-,per-per-per-per,PROPN-PROPN,PROPN-ADP-PROPN-PROPN,compound-pobj,pobj-prep-compound-pobj,NNP-NNP,NNP-IN-NNP-NNPS,5,1
1034,10408.0,33,was,20,1,25,24,0,7,19,5,Martin Feldstein,Council of Economic Advisers,org-org,---,PROPN-PROPN,PROPN-ADP-PROPN-PROPN,compound-nsubj,pobj-prep-compound-pobj,NNP-NNP,NNP-IN-NNP-NNPS,5,1
1035,442.0,30,crossed,15,14,23,9,13,6,1,8,de San,Chile,per-per,,PROPN-PROPN,PROPN,compound-pobj,dobj,NNP-NNP,NNP,10,1
1036,443.0,58,enrolled,8,15,33,18,14,24,-7,25,LSU Tigers baseball,SEC,--,per,PROPN-PROPN-NOUN,PROPN,compound-compound-compound,appos,NNP-NNP-NN,NNP,6,1
1037,444.0,43,succeeded,5,18,22,4,17,20,-13,17,Daimler AG,Chrysler,per-per,,PROPN-PROPN,PROPN,compound-appos,poss,NNP-NNP,NNP,7,1
1038,445.0,26,is,13,2,6,4,1,19,11,-7,Indian Institute of Management Lucknow,Lucknow,per-per-per-per-per,,PROPN-PROPN-ADP-PROPN-PROPN,PROPN,compound-nsubj-prep-compound-pobj,dobj,NNP-NNP-IN-NNP-NNP,NNP,3,1
1039,446.0,19,was,4,14,18,4,13,0,-10,14,Pietro Badoglio,Italy,-,org,PROPN-PROPN,PROPN,compound-pobj,pobj,NNP-NNP,NNP,7,1
1040,1033.0,55,tried,29,14,26,12,13,28,15,-3,Pietro Badoglio,Italy,-,org,PROPN-PROPN,PROPN,compound-poss,pobj,NNP-NNP,NNP,7,1
1041,447.0,11,Labels,0,4,9,5,3,1,-4,9,New York,Thomas DiNapoli,org-org,-,PROPN-PROPN,PROPN-PROPN,compound-compound,compound-appos,NNP-NNP,NNP-NNP,3,1
1042,448.0,23,led,3,15,8,-7,14,14,-12,5,National Defence Commission,Kim Jong-Il,org-org-org,-,PROPN-PROPN-PROPN,PROPN-PROPN,compound-compound-pobj,compound-pobj,NNP-NNP-NNP,NNP-NNP,7,1
1043,5798.0,29,said,3,13,5,-8,12,23,-10,2,National Defence Commission,Kim Jong-Il,--,org-org,PROPN-PROPN-PROPN,PROPN-PROPN,compound-compound-pobj,compound-pobj,NNP-NNP-NNP,NNP-NNP,4,1
1044,9501.0,26,carried,6,14,19,5,13,6,-8,13,National Defence Commission,Kim Jong-Il,--,per-per,PROPN-PROPN-PROPN,PROPN-PROPN,compound-compound-pobj,compound-pobj,NNP-NNP-NNP,NNP-NNP,7,1
1045,449.0,42,earned,1,27,32,5,26,9,-26,31,Wesleyan University,CT,per-per,,PROPN-PROPN,PROPN,compound-pobj,appos,NNP-NNP,NNP,4,1
1046,450.0,26,studied,2,1,22,21,0,3,1,20,Troger,Italy,,per,PROPN,PROPN,nsubj,pobj,NNP,NNP,2,1
1047,451.0,32,was,11,4,10,6,3,21,7,-1,Sue Gardner,Wikimedia Foundation,-,per-per,PROPN-PROPN,PROPN-PROPN,compound-nmod,compound-pobj,NNP-NNP,NNP-NNP,3,1
1048,453.0,32,School,6,4,7,3,3,24,2,1,University of London,School of Oriental and African Studies,per-per-per,-----,PROPN-ADP-PROPN,PROPN-ADP-ADJ-CCONJ-PROPN-PROPN,nmod-prep-pobj,ROOT-prep-pobj-cc-conj-conj,NNP-IN-NNP,NNP-IN-JJ-CC-NNP-NNP,3,1
1049,454.0,38,attended,8,10,10,0,9,27,-2,2,Brighton,Brighton College,,org-org,PROPN,PROPN-PROPN,dobj,compound-pobj,NNP,NNP-NNP,0,1
1050,455.0,28,replaced,2,5,13,8,4,14,-3,11,Jason Truby,Living Sacrifice,per-per,-,PROPN-PROPN,PROPN-PROPN,nmod-nmod,compound-pobj,NNP-NNP,NNP-NNP,3,1
1051,456.0,17,landed,3,9,13,4,8,3,-6,10,Tony Shalhoub,USA,org-org,,PROPN-PROPN,PROPN,compound-pobj,compound,NNP-NNP,NNP,3,1
1052,457.0,35,was,1,5,16,11,4,18,-4,15,Abu Talib,his,-,org,PROPN-PROPN,DET,compound-poss,poss,NNP-NNP,PRP$,-1,1
1053,458.0,14,said,5,7,12,5,6,1,-2,7,Shaan,Armaan Shahid,per,-,PROPN,PROPN-PROPN,nsubj,compound-attr,NNP,NNP-NNP,3,1
1054,459.0,18,Limited,2,1,17,16,0,0,1,15,Bahamasair,Bahamas,per,,PROPN,PROPN,compound,pobj,NNP,NNPS,3,1
1055,460.0,28,moved,4,3,8,5,2,19,1,4,Chris Evans,BBC,-,per,PROPN-PROPN,PROPN,compound-nsubj,pobj,NNP-NNP,NNP,3,1
1056,461.0,22,said,6,2,5,3,1,16,4,-1,Prime Minister,Frank Bainimarama,per-per,-,PROPN-PROPN,PROPN-PROPN,compound-compound,compound-nsubj,NNP-NNP,NNP-NNP,1,1
1057,462.0,37,is,2,5,27,22,4,9,-3,25,Kevin Bishop,comedian,org-org,,PROPN-PROPN,NOUN,compound-attr,oprd,NNP-NNP,NN,-1,1
1058,463.0,37,stated,2,1,17,16,0,19,1,15,Rita Marley,Jamaica,per-per,,PROPN-PROPN,PROPN,compound-nsubj,pobj,NNP-NNP,NNP,4,1
1059,464.0,26,is,5,13,12,-1,12,13,-8,7,Iowa State,Ames,-,per,PROPN-PROPN,PROPN,compound-compound,dobj,NNP-NNP,NNP,1,1
1060,465.0,14,is,3,1,1,0,0,12,2,-2,Hampton High School,Hampton,per-per-per,,PROPN-PROPN-PROPN,PROPN,compound-compound-nsubj,compound,NNP-NNP-NNP,NNP,0,1
1061,466.0,52,served,2,14,29,15,13,22,-12,27,Philippines,Elpidio Quirino,per,-,PROPN,PROPN-PROPN,pobj,compound-pobj,NNPS,NNP-NNP,5,1
1062,467.0,29,appointed,4,11,12,1,10,16,-7,8,his,Oklahoma,org,,DET,PROPN,poss,compound,PRP$,NNP,1,1
1063,468.0,12,are,2,1,11,10,0,0,1,9,The Coasters,1955,org-org,,DET-PROPN,NUM,det-nsubj,nummod,DT-NNPS,CD,5,1
1064,469.0,23,grew,7,5,7,2,4,15,2,0,Montgomery County,Jeff,-,per,PROPN-PROPN,PROPN,compound-compound,pobj,NNP-NNP,NNP,4,1
1065,470.0,32,nominated,6,4,11,7,3,20,2,5,Seyni Oumarou,Prime Minister,per-per,-,PROPN-PROPN,PROPN-PROPN,compound-nsubjpass,compound-pobj,NNP-NNP,NNP-NNP,3,1
1066,471.0,23,stood,2,7,13,6,6,9,-5,11,he,United Russia,org,-,PRON,PROPN-PROPN,nsubj,compound-dobj,PRP,NNP-NNP,2,1
1067,472.0,32,followed,2,7,30,23,6,1,-5,28,Fiji,Josefa Iloilo,,per-per,PROPN,PROPN-PROPN,poss,compound-pobj,NNP,NNP-NNP,10,1
1068,1312.0,40,said,17,22,25,3,21,14,-5,8,Fiji,Josefa Iloilo,,per-per,PROPN,PROPN-PROPN,compound,compound-pobj,NNP,NNP-NNP,1,1
1069,2343.0,23,expressed,6,1,4,3,0,18,5,-2,Fiji,Josefa Iloilo,,per-per,PROPN,PROPN-PROPN,compound,compound-nsubj,NNP,NNP-NNP,1,1
1070,4543.0,24,announced,7,1,22,21,0,1,6,15,Fiji,Josefa Iloilo,,org-org,PROPN,PROPN-PROPN,poss,compound-pobj,NNP,NNP-NNP,6,1
1071,5900.0,26,include,5,7,12,5,6,13,-2,7,Fiji,Josefa Iloilo,per,-,PROPN,PROPN-PROPN,poss,compound-appos,NNP,NNP-NNP,3,1
1072,11300.0,27,said,7,1,6,5,0,20,6,-1,Fiji,Josefa Iloilo,,per-per,PROPN,PROPN-PROPN,poss,compound-nsubj,NNP,NNP-NNP,2,1
1073,473.0,14,is,4,1,12,11,0,1,3,8,The Thomas Hardye School,Dorset,per-per-per-per,,DET-PROPN-PROPN-PROPN,PROPN,det-compound-compound-nsubj,compound,DT-NNP-NNP-NNP,NNP,5,1
1074,474.0,43,was,11,27,29,2,26,13,-16,18,University of Oxford,Oxford University Press,per-per-per,--,PROPN-ADP-PROPN,PROPN-PROPN-PROPN,pobj-prep-pobj,compound-compound-pobj,NNP-IN-NNP,NNP-NNP-NNP,4,1
1075,475.0,23,loaned,8,2,12,10,1,10,6,4,his,Wakefield,,per,DET,PROPN,poss,compound,PRP$,NNP,5,1
1076,476.0,23,educated,2,5,8,3,4,14,-3,6,William Ellis School,London,org-org-org,,PROPN-PROPN-PROPN,PROPN,compound-compound-compound,pobj,NNP-NNP-NNP,NNP,3,1
1077,477.0,35,is,12,1,20,19,0,14,11,8,JD Sports,Bury,org-org,,PROPN-PROPN,PROPN,compound-compound,compound,NNP-NNPS,NNP,5,1
1078,478.0,37,born,4,8,13,5,7,23,-4,9,London,William Lloyd Webber,per,--,PROPN,PROPN-PROPN-PROPN,pobj,compound-compound-pobj,NNP,NNP-NNP-NNP,4,1
1079,7375.0,32,won,3,12,18,6,11,13,-9,15,London,William Lloyd Webber,per,--,PROPN,PROPN-PROPN-PROPN,pobj,compound-compound-appos,NNP,NNP-NNP-NNP,5,1
1080,479.0,52,Boonyaratglin,1,1,24,23,0,27,0,23,Sonthi Boonyaratglin,Council for National Security,org-org,---,PROPN-PROPN,PROPN-ADP-PROPN-PROPN,compound-ROOT,pobj-prep-compound-pobj,NNP-NNP,NNP-IN-NNP-NNP,3,1
1081,7478.0,22,downplayed,17,6,14,8,5,7,11,-3,Sonthi Boonyaratglin,Council for National Security,-,org-org-org-org,PROPN-PROPN,PROPN-ADP-PROPN-PROPN,compound-compound,pobj-prep-compound-pobj,NNP-NNP,NNP-IN-NNP-NNP,5,1
1082,8896.0,28,resigned,3,2,10,8,1,17,1,7,Sonthi Boonyaratglin,Council for National Security,per-per,---,PROPN-PROPN,PROPN-ADP-PROPN-PROPN,compound-nsubj,pobj-prep-compound-pobj,NNP-NNP,NNP-IN-NNP-NNP,6,1
1083,11907.0,44,said,41,28,35,7,27,8,13,-6,Sonthi Boonyaratglin,Council for National Security,-,per-per-per-per,PROPN-PROPN,PROPN-ADP-PROPN-PROPN,nmod-nmod,pobj-prep-compound-pobj,NNP-NNP,NNP-IN-NNP-NNP,4,1
1084,480.0,21,joined,1,3,20,17,2,0,-2,19,Brigham Young University,Provo,org-org-org,,PROPN-PROPN-PROPN,PROPN,compound-compound-poss,pobj,NNP-NNP-NNP,NNP,5,1
1085,481.0,43,admired,30,1,3,2,0,39,29,-27,Caltech,Kip Thorne,,per-per,ADJ,PROPN-PROPN,amod,compound-nsubj,JJ,NNP-NNP,1,1
1086,482.0,53,is,19,1,12,11,0,40,18,-7,Joseph Attieh,oun,per-per,,PROPN-PROPN,NOUN,compound-nsubj,pobj,NNP-NNP,NN,2,1
1087,483.0,20,co-operated,4,4,14,10,3,5,0,10,Curtin,Australia,org,,PROPN,PROPN,nsubj,dobj,NNP,NNP,3,1
1088,484.0,24,received,1,19,22,3,18,1,-18,21,Clark University,Worcester,-,per,PROPN-PROPN,PROPN,compound-pobj,compound,NNP-NNP,NNP,2,1
1089,485.0,56,established,4,41,50,9,40,5,-37,46,The Emotions,Stax,per-per,,DET-PROPN,PROPN,det-appos,compound,DT-NNPS,NNP,8,1
1090,486.0,17,missed,3,1,15,14,0,1,2,12,McGuinty,Ottawa,per,,PROPN,PROPN,nsubj,compound,NNP,NNP,3,1
1091,487.0,29,lives,2,19,27,8,18,1,-17,25,Fatah,Mahmoud Abbas,org,-,PROPN,PROPN-PROPN,pobj,compound-pobj,NNP,NNP-NNP,5,1
1092,3987.0,25,said,8,5,7,2,4,17,3,-1,Fatah,Mahmoud Abbas,per,-,PROPN,PROPN-PROPN,compound,compound-conj,NNP,NNP-NNP,1,1
1093,488.0,28,said,5,1,4,3,0,23,4,-1,France,Nicolas Sarkozy,,org-org,PROPN,PROPN-PROPN,poss,compound-nsubj,NNP,NNP-NNP,3,1
1094,3292.0,29,said,5,1,4,3,0,24,4,-1,France,Nicolas Sarkozy,per,-,PROPN,PROPN-PROPN,poss,compound-nsubj,NNP,NNP-NNP,3,1
1095,8736.0,24,said,14,1,13,12,0,10,13,-1,France,Nicolas Sarkozy,org,-,PROPN,PROPN-PROPN,nsubj,compound-pobj,NNP,NNP-NNP,5,1
1096,489.0,15,returned,7,4,6,2,3,8,3,-1,Mathieu,Benin,per,,PROPN,PROPN,pobj,compound,NNP,NNP,1,1
1097,490.0,41,founded,3,11,2,-9,10,38,-8,-1,1903,News-Miner,,per,NUM,PROPN,pobj,compound,CD,NNPS,5,1
1098,493.0,42,paid,2,16,22,6,15,19,-14,20,University of Phoenix,Arizona,--,org,PROPN-ADP-PROPN,PROPN,nmod-prep-compound,compound,NNP-IN-NNP,NNP,4,1
1099,934.0,30,was,4,22,28,6,21,1,-18,24,University of Phoenix,Arizona,--,org,PROPN-ADP-PROPN,PROPN,nmod-prep-compound,compound,NNP-IN-NNP,NNP,3,1
1100,494.0,36,founded,3,6,9,3,5,26,-3,6,2001,its,,per,NUM,DET,pobj,poss,CD,PRP$,4,1
1101,495.0,36,recorded,3,6,26,20,5,9,-3,23,Orlando,Chicago,per,,PROPN,PROPN,compound,nmod,NNP,NNP,-1,1
1102,496.0,42,served,1,6,6,0,5,35,-5,5,Israel,Israel Electric Corporation,org,--,PROPN,PROPN-PROPN-PROPN,compound,compound-compound-pobj,NNP,NNP-NNP-NNP,0,1
1103,497.0,47,is,1,20,23,3,19,23,-19,22,Ithaca,Cornell University,,org-org,PROPN,PROPN-PROPN,compound,compound-compound,NNP,NNP-NNP,3,1
1104,498.0,33,asking,10,2,8,6,1,24,8,-2,U.S. Securities and Exchange Commission,SEC,per-per-per-per-per,,PROPN-PROPN-CCONJ-PROPN-PROPN,PROPN,nmod-nmod-cc-conj-nsubj,appos,NNP-NNPS-CC-NNP-NNP,NNP,3,1
1105,499.0,36,oversaw,2,22,26,4,21,9,-20,24,David Ben-Gurion,Prime Minister,-,org-org,PROPN-PROPN,PROPN-PROPN,compound-pobj,compound-ROOT,NNP-NNP,NNP-NNP,2,1
1106,500.0,17,founded,4,1,16,15,0,0,3,12,Road Travel Magazine,Motorscene,--,org,PROPN-PROPN-PROPN,PROPN,compound-compound-nsubjpass,appos,NNP-NNP-NNP,NNP,3,1
1107,501.0,17,refers,2,1,16,15,0,0,1,14,Mahidol Adulyadej,Thailand,org-org,,PROPN-PROPN,PROPN,compound-pobj,pobj,NNP-NNP,NNP,2,1
1108,502.0,28,operates,4,7,14,7,6,13,-3,10,Bethel University,Arden Hills,per-per,-,PROPN-PROPN,PROPN-PROPN,conj-dobj,compound-pobj,NNP-NNP,NNP-NNP,4,1
1109,503.0,25,are,3,14,20,6,13,4,-11,17,University of Prince Edward Island,Charlottetown,org-org-org-org-org,,PROPN-ADP-PROPN-PROPN-PROPN,PROPN,nmod-prep-pobj-compound-dobj,compound,NNP-IN-NNP-NNP-NNP,NNP,4,1
1110,504.0,46,provide,5,10,32,22,9,13,-5,27,FIFA World Cup,United States,per-per-per,-,PROPN-PROPN-PROPN,PROPN-PROPN,compound-compound-pobj,compound-appos,NNP-NNP-NNP,NNP-NNP,6,1
1111,505.0,41,is,9,16,22,6,15,18,-7,13,musician,her,org,,ADJ,DET,amod,poss,JJ,PRP$,4,1
1112,506.0,24,criticized,9,2,8,6,1,15,7,-1,Albert Ho,Democratic Party,org-org,-,PROPN-PROPN,PROPN-PROPN,compound-nsubj,compound-pobj,NNP-NNP,NNP-NNP,4,1
1113,1492.0,52,said,6,1,5,4,0,46,5,-1,Albert Ho,Democratic Party,-,per-per,PROPN-PROPN,PROPN-PROPN,compound-compound,compound-pobj,NNP-NNP,NNP-NNP,2,1
1114,3441.0,42,results,4,6,12,6,5,29,-2,8,Albert Ho,Democratic Party,per-per,-,PROPN-PROPN,PROPN-PROPN,compound-dobj,compound-pobj,NNP-NNP,NNP-NNP,3,1
1115,3462.0,22,said,7,1,6,5,0,15,6,-1,Albert Ho,Democratic Party,per-per,-,PROPN-PROPN,PROPN-PROPN,compound-compound,compound-pobj,NNP-NNP,NNP-NNP,3,1
1116,4566.0,46,said,8,1,7,6,0,38,7,-1,Albert Ho,Democratic Party,-,org-org,PROPN-PROPN,PROPN-PROPN,compound-compound,compound-pobj,NNP-NNP,NNP-NNP,4,1
1117,5673.0,40,told,37,30,36,6,29,3,7,-1,Albert Ho,Democratic Party,per-per,-,PROPN-PROPN,PROPN-PROPN,compound-nsubj,compound-pobj,NNP-NNP,NNP-NNP,4,1
1118,11440.0,31,prompted,3,5,10,5,4,20,-2,7,Albert Ho,Democratic Party,org-org,-,PROPN-PROPN,PROPN-PROPN,compound-compound,compound-pobj,NNP-NNP,NNP-NNP,3,1
1119,13870.0,40,criticized,13,1,7,6,0,32,12,-6,Albert Ho,Democratic Party,-,org-org,PROPN-PROPN,PROPN-PROPN,compound-nsubj,compound-pobj,NNP-NNP,NNP-NNP,4,1
1120,508.0,15,founded,11,8,14,6,7,0,3,3,Irkutsk State University,1918,--,per,PROPN-PROPN-PROPN,NUM,compound-compound-pobj,pobj,NNP-NNP-NNP,CD,5,1
1121,509.0,21,is,11,2,4,2,1,16,9,-7,Republic of Singapore Air Force,Singapore Armed Forces,per-per-per-per-per,--,PROPN-ADP-PROPN-PROPN-PROPN,PROPN-PROPN-PROPN,nsubj-prep-compound-compound-pobj,compound-compound-pobj,NNP-IN-NNP-NNP-NNP,NNP-NNP-NNPS,3,1
1122,510.0,27,is,8,1,6,5,0,20,7,-2,Nutrisoda,airforce Nutrisoda,per,-,PROPN,NOUN-PROPN,nsubj,compound-pobj,NNP,NN-NNP,4,1
1123,511.0,38,released,8,8,15,7,7,22,0,7,Hicks,Island Records,org,-,PROPN,PROPN-PROPN,nsubj,compound-poss,NNP,NNP-NNPS,2,1
1124,512.0,30,represented,8,4,19,15,3,10,4,11,Louisville Cardinals,Division I,-,org-org,PROPN-PROPN,PROPN-PRON,compound-compound,pobj-nsubj,NNP-NNPS,NNP-PRP,5,1
1125,513.0,19,is,8,1,16,15,0,2,7,8,Ryan Davis,West Coast Eagles,-,org-org-org,PROPN-PROPN,PROPN-PROPN-PROPN,compound-nsubj,compound-compound-pobj,NNP-NNP,NNP-NNP-NNPS,5,1
1126,514.0,41,13,0,11,31,20,10,9,-11,31,Konstantinos Tsatsos,Greece,per-per,,PROPN-PROPN,PROPN,compound-pobj,pobj,NNP-NNP,NNP,4,1
1127,515.0,41,forced,31,1,13,12,0,27,30,-18,NCTU,Taiwan,,org,PROPN,PROPN,nsubjpass,pobj,NNP,NNP,4,1
1128,516.0,44,expanded,9,7,8,1,6,35,2,-1,1998,Braathens,per,,NUM,PROPN,pobj,pobj,CD,NNPS,2,1
1129,517.0,31,include,8,8,14,6,7,16,0,6,Losi,Team Losi,per,-,PROPN,PROPN-PROPN,pobj,compound-appos,NNP,NNP-NNP,2,1
1130,518.0,32,suspended,5,5,24,19,4,7,0,19,Betancourt,Venezuela,org,,PROPN,PROPN,nsubj,pobj,NNP,NNP,6,1
1131,13124.0,37,incensed,2,1,14,13,0,22,1,12,Betancourt,Venezuela,,per,PROPN,PROPN,nsubjpass,pobj,NNP,NNP,6,1
1132,519.0,75,became,7,58,33,-25,57,41,-51,26,Notre Dame Fighting Irish,Big East,---,org-org,PROPN-PROPN-PROPN-PROPN,PROPN-PROPN,compound-compound-compound-conj,compound-poss,NNP-NNP-NNP-NNP,NNP-NNP,3,1
1133,8497.0,29,The,0,4,26,22,3,2,-4,26,Notre Dame Fighting Irish,Big East,---,per-per,PROPN-PROPN-VERB-ADJ,PROPN-PROPN,compound-nsubj-acl-amod,compound-compound,NNP-NNP-VBG-JJ,NNP-NNP,6,1
1134,520.0,26,became,5,4,16,12,3,9,1,11,CBEC,Hampshire,,org,PROPN,PROPN,conj,pobj,NNP,NNP,5,1
1135,521.0,36,told,18,7,16,9,6,19,11,-2,Fernando da Piedade Dias dos Santos,Angola,per-per-per-per-per-per,,PROPN-PROPN-PROPN-PROPN-VERB-PROPN,PROPN,nmod-nmod-compound-appos-nmod-compound,pobj,NNP-NNP-NNP-NNP-VBZ-NNP,NNP,8,1
1136,11131.0,36,After,0,4,12,8,3,23,-4,12,Fernando da Piedade Dias dos Santos,Angola,org-org-org-org-org-org,,PROPN-PROPN-PROPN-PROPN-PROPN-PROPN,PROPN,pobj-compound-compound-appos-compound-compound,poss,NNP-NNP-NNP-NNP-NNP-NNP,NNP,10,1
1137,522.0,35,gathered,12,1,3,2,0,31,11,-9,Cyprus,Tassos Papadopoulos,,org-org,PROPN,PROPN-PROPN,compound,compound-nsubj,NNP,NNP-NNP,1,1
1138,12995.0,23,stolen,9,5,7,2,4,15,4,-2,Cyprus,Tassos Papadopoulos,org,-,PROPN,PROPN-PROPN,compound,compound-pobj,NNP,NNP-NNP,1,1
1139,523.0,22,detained,3,14,17,3,13,4,-11,14,Paraguay,Alfredo Stroessner,org,-,PROPN,PROPN-PROPN,poss,compound-pobj,NNP,NNP-NNP,2,1
1140,7861.0,22,apologized,3,9,20,11,8,1,-6,17,Paraguay,Alfredo Stroessner,per,-,PROPN,PROPN-PROPN,pobj,compound-pobj,NNP,NNP-NNP,6,1
1141,11888.0,27,ruled,8,7,12,5,6,14,1,4,Paraguay,Alfredo Stroessner,per,-,PROPN,PROPN-PROPN,nsubjpass,compound-pobj,NNP,NNP-NNP,7,1
1142,524.0,45,issued,1,1,29,28,0,15,0,28,Tebbit,United Kingdom,per,-,PROPN,PROPN-PROPN,nsubj,compound-nsubj,NNP,NNP-NNP,4,1
1143,525.0,16,founded,4,3,15,12,2,0,1,11,Charly Alberti,Argentina,-,per,PROPN-PROPN,PROPN,compound-nsubj,pobj,NNP-NNPS,NNP,2,1
1144,526.0,34,announced,20,10,15,5,9,18,10,-5,Jim Suptic,The Get Up Kids,-,per-per-per-per,PROPN-PROPN,DET-VERB-PART-PROPN,compound-poss,det-amod-prt-appos,NNP-NNP,DT-VB-RP-NNPS,5,1
1145,527.0,13,married,1,1,3,2,0,9,0,2,James,Margaret of Denmark,per,--,PROPN,PROPN-ADP-PROPN,nsubj,dobj-prep-pobj,NNP,NNP-IN-NNP,2,1
1146,1437.0,25,contemplated,3,11,19,8,10,5,-8,16,James,Margaret of Denmark,org,--,PROPN,PROPN-ADP-PROPN,compound,appos-prep-pobj,NNP,NNP-IN-NNP,4,1
1147,4151.0,26,was,12,18,23,5,17,2,-6,11,James,Margaret of Denmark,per,--,PROPN,PROPN-ADP-PROPN,compound,conj-prep-pobj,NNP,NNP-IN-NNP,3,1
1148,7077.0,40,married,4,1,10,9,0,29,3,6,James,Margaret of Denmark,per,--,PROPN,PROPN-ADP-PROPN,compound,appos-prep-pobj,NNP,NNP-IN-NNP,6,1
1149,11671.0,35,served,2,28,30,2,27,4,-26,28,James,Margaret of Denmark,,org-org-org,PROPN,PROPN-ADP-PROPN,pobj,conj-prep-pobj,NNP,NNP-IN-NNP,2,1
1150,528.0,45,carried,15,33,13,-20,32,31,-18,-2,KAL,Korean Air,per,-,PROPN,PROPN-PROPN,pobj,compound-compound,NNP,NNP-NNP,7,1
1151,529.0,18,emphasized,6,4,5,1,3,12,2,-1,Defense,Harold Brown,per,-,PROPN,PROPN-PROPN,pobj,compound-nsubj,NNP,NNP-NNP,4,1
1152,10260.0,21,set,12,6,8,2,5,12,6,-4,Defense,Harold Brown,org,-,PROPN,PROPN-PROPN,compound,compound-pobj,NNP,NNP-NNP,1,1
1153,530.0,40,established,6,2,27,25,1,12,4,21,Defence Services Technological Academy,Myanmar,---,per,PROPN-PROPN-PROPN-PROPN,PROPN,compound-compound-compound-nsubjpass,pobj,NNP-NNPS-NNP-NNP,NNP,4,1
1154,8067.0,25,Academy,4,2,14,12,1,10,2,10,Defence Services Technological Academy,Myanmar,---,per,PROPN-PROPN-PROPN-PROPN,PROPN,compound-compound-compound-ROOT,compound,NNP-NNPS-NNP-NNP,NNP,6,1
1155,9219.0,25,Academy,4,2,14,12,1,10,2,10,Defence Services Technological Academy,Myanmar,per-per-per-per,,PROPN-PROPN-PROPN-PROPN,PROPN,compound-compound-compound-ROOT,nsubj,NNP-NNPS-NNP-NNP,NNP,6,1
1156,531.0,34,merger,1,8,30,22,7,3,-7,29,Fuji Bank,Mizuho Trust Banking,-,org-org-org,PROPN-PROPN,PROPN-PROPN-PROPN,compound-nsubjpass,compound-compound-compound,NNP-NNP,NNP-NNP-NNP,9,1
1157,532.0,41,y,3,1,22,21,0,18,2,19,Manuel de la y,Mexico,---,per,PROPN-PROPN-PROPN-NOUN,PROPN,compound-compound-compound-ROOT,pobj,NNP-NNP-NNP-NN,NNP,4,1
1158,534.0,25,moved,3,3,7,4,2,17,0,4,he,Minnesota,,org,PRON,PROPN,nsubj,pobj,PRP,NNP,2,1
1159,1366.0,8,served,2,2,6,4,1,1,0,4,he,Minnesota,,org,PRON,PROPN,nsubj,compound,PRP,NNP,2,1
1160,535.0,19,founded,4,2,7,5,1,11,2,3,Spence School,1892,per-per,,PROPN-PROPN,NUM,compound-nsubjpass,pobj,NNP-NNP,CD,2,1
1161,536.0,27,is,11,1,15,14,0,11,10,4,Darlene Vogel,actress,per-per,,PROPN-PROPN,NOUN,compound-nsubj,attr,NNP-NNP,NN,4,1
1162,537.0,23,considered,6,1,21,20,0,1,5,15,He,Cultural Revolution,per,-,PRON,PROPN-PROPN,nsubjpass,compound-pobj,PRP,NNP-NNP,11,1
1163,538.0,32,ran,1,6,10,4,5,21,-5,9,Ma Ying-jeou,Kuomintang,org-org,,PROPN-NOUN,PROPN,compound-pobj,pobj,NNP-NN,NNP,4,1
1164,1085.0,27,hoping,3,14,19,5,13,7,-11,16,Ma Ying-jeou,Kuomintang,per-per,,PROPN-NOUN,PROPN,compound-nsubjpass,pobj,NNP-NN,NNP,2,1
1165,1389.0,48,was,7,20,31,11,19,16,-13,24,Ma Ying-jeou,Kuomintang,per-per,,PROPN-PROPN,PROPN,compound-ROOT,appos,NNP-NNP,NNP,9,1
1166,1809.0,19,defeated,2,6,10,4,5,8,-4,8,Ma Ying-jeou,Kuomintang,org-org,,PROPN-NOUN,PROPN,compound-pobj,pobj,NNP-NN,NNP,4,1
1167,2842.0,24,won,1,16,20,4,15,3,-15,19,Ma Ying-jeou,Kuomintang,-,org,PROPN-NOUN,PROPN,compound-appos,pobj,NNP-NN,NNP,4,1
1168,3861.0,34,suggested,11,9,15,6,8,18,2,4,Ma Ying-jeou,Kuomintang,per-per,,PROPN-PROPN,PROPN,compound-compound,nsubj,NNP-NNP,NNP,6,1
1169,3908.0,38,BEIJING,0,13,22,9,12,15,-13,22,Ma Ying-jeou,Kuomintang,-,per,PROPN-PROPN,PROPN,compound-nsubj,poss,NNP-NNP,NNP,5,1
1170,3965.0,29,seen,5,4,22,18,3,6,1,17,Ma Ying-jeou,Kuomintang,-,org,PROPN-NOUN,PROPN,compound-appos,compound,NNP-NN,NNP,4,1
1171,4030.0,36,elected,8,3,7,4,2,28,5,-1,Ma Ying-jeou,Kuomintang,per-per,,PROPN-NOUN,PROPN,npadvmod-nsubjpass,pobj,NNP-NN,NNP,4,1
1172,4259.0,19,seen,2,12,17,5,11,1,-10,15,Ma Ying-jeou,Kuomintang,-,per,PROPN-PROPN,PROPN,compound-nsubj,compound,NNP-NNP,NNP,2,1
1173,4958.0,31,told,28,3,7,4,2,23,25,-21,Ma Ying-jeou,Kuomintang,org-org,,PROPN-PROPN,PROPN,compound-nsubjpass,nmod,NNP-NNP,NNP,1,1
1174,5236.0,31,leader,1,8,19,11,7,11,-7,18,Ma Ying-jeou,Kuomintang,-,per,PROPN-PROPN,PROPN,compound-nsubj,pobj,NNP-NNP,NNP,9,1
1175,5649.0,42,said,40,22,30,8,21,11,18,-10,Ma Ying-jeou,Kuomintang,org-org,,PROPN-PROPN,PROPN,compound-pobj,nmod,NNP-NNP,NNP,4,1
1176,6898.0,26,consolidated,13,2,8,6,1,17,11,-5,Ma Ying-jeou,Kuomintang,-,org,PROPN-PROPN,PROPN,compound-nsubj,pobj,NNP-NNP,NNP,4,1
1177,7324.0,48,On,0,5,19,14,4,28,-5,19,Ma Ying-jeou,Kuomintang,-,per,PROPN-PROPN,PROPN,compound-nsubj,compound,NNP-NNP,NNP,10,1
1178,7805.0,43,said,40,2,8,6,1,34,38,-32,Ma Ying-jeou,Kuomintang,-,per,PROPN-PROPN,PROPN,compound-nsubj,compound,NNP-NNP,NNP,3,1
1179,8294.0,28,chosen,20,1,6,5,0,21,19,-14,Ma Ying-jeou,Kuomintang,-,org,PROPN-ADJ,PROPN,compound-compound,pobj,NNP-JJ,NNP,5,1
1180,8324.0,26,rebutted,5,10,16,6,9,9,-5,11,Ma Ying-jeou,Kuomintang,org-org,,PROPN-PROPN,PROPN,compound-pobj,compound,NNP-NNP,NNP,4,1
1181,8692.0,50,day,2,14,19,5,13,30,-12,17,Ma Ying-jeou,Kuomintang,-,per,PROPN-PROPN,PROPN,compound-appos,nmod,NNP-NNP,NNP,7,1
1182,9042.0,29,established,13,1,10,9,0,18,12,-3,Ma Ying-jeou,Kuomintang,org-org,,PROPN-ADJ,PROPN,nmod-nmod,appos,NNP-JJ,NNP,6,1
1183,9211.0,51,Event,0,5,35,30,4,15,-5,35,Ma Ying-jeou,Kuomintang,org-org,,PROPN-PROPN,PROPN,compound-poss,compound,NNP-NNP,NNP,13,1
1184,9516.0,37,warmed,3,6,11,5,5,25,-3,8,Ma Ying-jeou,Kuomintang,-,per,PROPN-NOUN,PROPN,compound-nsubj,pobj,NNP-NN,NNP,5,1
1185,9732.0,37,announced,7,22,26,4,21,10,-15,19,Ma Ying-jeou,Kuomintang,-,org,PROPN-NOUN,PROPN,compound-pobj,pobj,NNP-NN,NNP,4,1
1186,9846.0,37,are,25,2,25,23,1,11,23,0,Ma Ying-jeou,Kuomintang,per-per,,PROPN-PROPN,PROPN,compound-poss,pobj,NNP-NNP,NNP,7,1
1187,10528.0,31,elected,8,5,15,10,4,15,3,7,Ma Ying-jeou,Kuomintang,-,org,PROPN-PROPN,PROPN,compound-appos,pobj,NNP-NNP,NNP,7,1
1188,11146.0,24,assumed,5,3,17,14,2,6,2,12,Ma Ying-jeou,Kuomintang,org-org,,PROPN-PROPN,PROPN,compound-nsubj,poss,NNP-NNP,NNP,6,1
1189,11790.0,36,said,10,9,14,5,8,21,1,4,Ma Ying-jeou,Kuomintang,per-per,,PROPN-PROPN,PROPN,compound-pobj,nsubj,NNP-NNP,NNP,8,1
1190,11866.0,33,leader,2,4,12,8,3,20,-2,10,Ma Ying-jeou,Kuomintang,-,per,PROPN-PROPN,PROPN,compound-nsubj,nmod,NNP-NNP,NNP,5,1
1191,12126.0,26,been,6,13,17,4,12,8,-7,11,Ma Ying-jeou,Kuomintang,-,per,PROPN-NOUN,PROPN,compound-nsubj,compound,NNP-NN,NNP,4,1
1192,12140.0,31,said,5,4,18,14,3,12,1,13,Ma Ying-jeou,Kuomintang,-,org,PROPN-PROPN,PROPN,compound-appos,compound,NNP-NNP,NNP,7,1
1193,12498.0,25,went,13,1,10,9,0,14,12,-3,Ma Ying-jeou,Kuomintang,-,org,PROPN-ADJ,PROPN,nmod-nmod,appos,NNP-JJ,NNP,6,1
1194,13316.0,22,ruled,3,2,18,16,1,3,1,15,Ma Ying-jeou,Kuomintang,per-per,,PROPN-PROPN,PROPN,compound-nsubj,nmod,NNP-NNP,NNP,10,1
1195,13725.0,54,rejected,8,30,34,4,29,19,-22,26,Ma Ying-jeou,Kuomintang,-,per,PROPN-NOUN,PROPN,compound-appos,pobj,NNP-NN,NNP,2,1
1196,539.0,14,agreed,6,2,3,1,1,10,4,-3,1991,ABN AMRO,per,-,NUM,PROPN-PROPN,pobj,compound-dobj,CD,NNP-NNP,1,1
1197,540.0,21,is,14,1,14,13,0,6,13,0,Vasan Sitthiket,Thailand,per-per,,PROPN-PROPN,PROPN,compound-nsubj,pobj,NNP-NNP,NNP,-1,1
1198,541.0,26,were,10,1,4,3,0,21,9,-6,Arkane Studios,Colantonio,per-per,,PROPN-PROPN,PROPN,compound-compound,nsubj,NNP-NNPS,NNP,3,1
1199,542.0,14,employed,3,7,13,6,6,0,-4,10,Maxi,Quebec,,org,PROPN,PROPN,pobj,pobj,NNP,NNP,5,1
1200,543.0,17,is,1,1,13,12,0,3,0,12,Austrojet,Salzburg,per,,PROPN,PROPN,nsubj,compound,NNP,NNP,5,1
1201,544.0,40,releases,9,21,22,1,20,17,-12,13,Pennsylvania State University,State College,org-org-org,-,PROPN-PROPN-PROPN,PROPN-PROPN,compound-compound-compound,compound-compound,NNP-NNP-NNP,NNP-NNP,1,1
1202,545.0,25,PARIS,0,3,24,21,2,0,-3,24,Henri Salvador,France,org-org,,PROPN-PROPN,PROPN,compound-nsubjpass,pobj,NNP-NNP,NNP,5,1
1203,6680.0,31,said,29,1,18,17,0,12,28,-11,Henri Salvador,France,per-per,,PROPN-PROPN,PROPN,compound-nsubj,pobj,NNP-NNP,NNP,2,1
1204,10881.0,30,Salvador,2,2,19,17,1,10,0,17,Henri Salvador,France,-,org,PROPN-PROPN,PROPN,compound-ROOT,pobj,NNP-NNP,NNP,2,1
1205,547.0,13,grew,1,5,11,6,4,1,-4,10,Penarth,Stanwell School,org,-,PROPN,PROPN-PROPN,compound,compound-dobj,NNP,NNP-NNP,4,1
1206,548.0,24,accused,2,4,18,14,3,5,-2,16,Huerta,Mexico,per,,PROPN,PROPN,dobj,pobj,NNP,NNP,5,1
1207,12853.0,23,sent,5,1,19,18,0,3,4,14,Huerta,Mexico,per,,PROPN,PROPN,nsubj,poss,NNP,NNP,9,1
1208,549.0,13,was,6,8,11,3,7,1,-2,5,Open Doors,Brother Andrew,per-per,-,PROPN-PROPN,PROPN-PROPN,compound-compound,compound-nsubj,NNP-NNP,NNP-NNP,2,1
1209,1506.0,65,strives,3,1,45,44,0,19,2,42,Open Doors,Brother Andrew,per-per,-,PROPN-NOUN,PROPN-PROPN,compound-nsubj,compound-pobj,NNP-NNS,NNP-NNP,-1,1
1210,550.0,23,formed,15,2,2,0,1,20,13,-13,Israel,Israel Defense Forces,,org-org-org,PROPN,PROPN-PROPN-PROPN,poss,compound-compound-nsubjpass,NNP,NNP-NNP-NNPS,0,1
1211,2951.0,32,discovered,5,1,1,0,0,30,4,-4,Israel,Israel Defense Forces,,org-org-org,PROPN,PROPN-PROPN-PROPN,poss,compound-compound-nmod,NNP,NNP-NNP-NNPS,0,1
1212,4632.0,41,killed,9,23,23,0,22,17,-14,14,Israel,Israel Defense Forces,per,--,PROPN,PROPN-PROPN-PROPN,pobj,compound-compound-nsubj,NNP,NNP-NNP-NNPS,0,1
1213,8078.0,48,bought,24,12,12,0,11,35,12,-12,Israel,Israel Defense Forces,org,--,PROPN,PROPN-PROPN-PROPN,pobj,compound-compound-pobj,NNP,NNP-NNP-NNPS,0,1
1214,551.0,18,granted,3,10,12,2,9,5,-7,9,Germany,Joseph Goebbels,per,-,PROPN,PROPN-PROPN,pobj,compound-nsubj,NNP,NNP-NNP,2,1
1215,552.0,28,coincided,10,9,22,13,8,5,1,12,Valdas Adamkus,Lithuania,org-org,,PROPN-PROPN,PROPN,compound-pobj,nsubjpass,NNP-NNP,NNP,13,1
1216,3647.0,24,succeeds,1,3,16,13,2,7,-2,15,Valdas Adamkus,Lithuania,per-per,,PROPN-PROPN,PROPN,compound-dobj,dobj,NNP-NNP,NNP,7,1
1217,4745.0,8,Adamkus,2,2,7,5,1,0,0,5,Valdas Adamkus,Lithuania,-,org,PROPN-PROPN,PROPN,compound-ROOT,pobj,NNP-NNP,NNP,1,1
1218,10018.0,20,After,0,8,16,8,7,3,-8,16,Valdas Adamkus,Lithuania,per-per,,PROPN-PROPN,PROPN,compound-nsubj,poss,NNP-NNP,NNP,7,1
1219,553.0,18,is,1,1,17,16,0,0,0,16,Synovus,Georgia,,org,PROPN,PROPN,nsubj,pobj,NNP,NNP,1,1
1220,2062.0,16,is,3,3,11,8,2,4,0,8,Synovus,Georgia,org,,PROPN,PROPN,nsubj,pobj,NNP,NNP,3,1
1221,554.0,32,moved,3,11,21,10,10,10,-8,18,Montana,Russell,,per,PROPN,PROPN,pobj,nsubj,NNP,NNP,4,1
1222,556.0,59,signed,30,16,20,4,15,38,14,-10,Philippines,Apolinario Mabini,org,-,PROPN,PROPN-PROPN,pobj,compound-pobj,NNPS,NNP-NNP,5,1
1223,9186.0,38,Constitution,1,5,20,15,4,17,-4,19,Philippines,Apolinario Mabini,per,-,PROPN,PROPN-PROPN,pobj,compound-dobj,NNP,NNP-NNP,4,1
1224,557.0,22,series,1,17,21,4,16,0,-16,20,Manchester,Oasis,,per,PROPN,PROPN,pobj,pobj,NNP,NNP,3,1
1225,558.0,19,called,7,2,5,3,1,13,5,-2,his,India,,per,DET,PROPN,poss,pobj,PRP$,NNP,3,1
1226,2180.0,24,created,4,10,23,13,9,0,-6,19,his,India,,org,DET,PROPN,poss,pobj,PRP$,NNP,4,1
1227,559.0,23,started,2,1,15,14,0,7,1,13,Samoa Air,American Samoa,-,per-per,PROPN-PROPN,PROPN-PROPN,compound-nsubj,compound-pobj,NNP-NNP,NNP-NNP,5,1
1228,560.0,31,said,3,7,20,13,6,10,-4,17,Marcel Duchamp,France,-,per,PROPN-PROPN,PROPN,compound-nsubjpass,pobj,NNP-NNP,NNP,6,1
1229,561.0,62,links,2,1,16,15,0,45,1,14,Muqtada al-Sadr,Baghdad,per-per,,PROPN-PROPN,PROPN,compound-nsubj,pobj,NNP-NNP,NNP,6,1
1230,562.0,31,sentenced,9,1,7,6,0,23,8,-2,Gome Electrical Appliances,Huang Guangyu,org-org-org,-,PROPN-PROPN-PROPN,PROPN-PROPN,compound-compound-compound,compound-nsubjpass,NNP-NNP-NNPS,NNP-NNP,4,1
1231,13548.0,34,said,5,1,13,12,0,20,4,8,Gome Electrical Appliances,Huang Guangyu,org-org-org,-,PROPN-PROPN-PROPN,PROPN-PROPN,compound-compound-compound,compound-pobj,NNP-NNP-NNPS,NNP-NNP,6,1
1232,563.0,31,After,0,14,19,5,13,11,-14,19,Whitman College,Washington,per-per,,PROPN-PROPN,PROPN,compound-pobj,appos,NNP-NNP,NNP,7,1
1233,8663.0,33,attended,1,7,12,5,6,20,-6,11,Whitman College,Washington,-,per,PROPN-PROPN,PROPN,compound-conj,pobj,NNP-NNP,NNP,6,1
1234,564.0,28,said,26,3,9,6,2,18,23,-17,Kohl,Germany,per,,PROPN,PROPN,nsubj,pobj,NNP,NNP,5,1
1235,11090.0,30,said,28,3,9,6,2,20,25,-19,Kohl,Germany,,per,PROPN,PROPN,nsubj,pobj,NNP,NNP,5,1
1236,565.0,27,is,1,13,26,13,12,0,-12,25,Swedish University of Agricultural Sciences,Sweden,org-org-org-org-org,,PROPN-PROPN-ADP-PROPN-PROPN,PROPN,compound-pobj-prep-compound-pobj,pobj,NNP-NNP-IN-NNP-NNPS,NNP,7,1
1237,566.0,19,has,1,1,1,0,0,17,0,0,Portland,Portland Pilots,org,-,PROPN,PROPN-PROPN,nsubj,compound-pobj,NNP,NNP-NNPS,0,1
1238,567.0,29,wants,4,9,12,3,8,16,-5,8,its,Chicago,per,,DET,PROPN,poss,pobj,PRP$,NNP,2,1
1239,568.0,26,attended,8,15,23,8,14,2,-7,15,South Georgia College,Douglas,org-org-org,,PROPN-PROPN-PROPN,PROPN,compound-compound-compound,compound,NNP-NNP-NNP,NNP,7,1
1240,570.0,21,was,1,8,9,1,7,11,-7,8,West Texas University,Texas,per-per-per,,PROPN-PROPN-PROPN,PROPN,compound-compound-appos,pobj,NNP-NNP-NNP,NNP,2,1
1241,571.0,32,formed,1,7,22,15,6,9,-6,21,Macrosick,Mutemath,org,,PROPN,PROPN,oprd,compound,NNP,NNP,7,1
1242,572.0,23,lost,4,16,20,4,15,2,-12,16,Vicente Fox,National Action Party,-,per-per-per,PROPN-PROPN,PROPN-PROPN-PROPN,compound-pobj,compound-compound-conj,NNP-NNP,NNP-NNP-NNP,2,1
1243,573.0,40,is,4,3,38,35,2,1,1,34,Marriott International,United States,org-org,-,PROPN-PROPN,PROPN-PROPN,nmod-nmod,compound-pobj,NNP-NNP,NNP-NNP,8,1
1244,574.0,41,arrived,5,4,35,31,3,5,1,30,Shaukat Aziz,Pakistan,org-org,,PROPN-PROPN,PROPN,compound-nsubj,pobj,NNP-NNP,NNP,11,1
1245,3988.0,19,born,3,1,10,9,0,8,2,7,Shaukat Aziz,Pakistan,org-org,,PROPN-PROPN,PROPN,compound-nsubjpass,pobj,NNP-NNP,NNP,2,1
1246,7461.0,33,disclosed,2,18,29,11,17,3,-16,27,Shaukat Aziz,Pakistan,-,per,PROPN-PROPN,PROPN,compound-pobj,nmod,NNP-NNP,NNP,8,1
1247,575.0,27,led,3,8,11,3,7,15,-5,8,Mustafa Khalil,Egypt,per-per,,PROPN-PROPN,PROPN,compound-pobj,appos,NNP-NNP,NNP,1,1
1248,576.0,30,served,11,11,17,6,10,12,0,6,he,Delaware,org,,PRON,PROPN,nsubj,compound,PRP,NNP,5,1
1249,577.0,18,recounts,2,1,17,16,0,0,1,15,Eminem,Detroit,per,,NOUN,PROPN,nsubj,pobj,NN,NNP,2,1
1250,578.0,42,appointed,13,8,23,15,7,18,5,10,Germany,him,per,,PROPN,PRON,pobj,dobj,NNP,PRP,4,1
1251,579.0,37,attended,13,1,8,7,0,28,12,-5,He,Beckley,per,,PRON,PROPN,nsubj,compound,PRP,NNP,3,1
1252,580.0,38,completed,5,4,14,10,3,23,1,9,John Adams,United States,per-per,-,PROPN-PROPN,PROPN-PROPN,compound-nsubj,compound-compound,NNP-NNP,NNP-NNP,7,1
1253,1949.0,30,considered,4,21,26,5,20,3,-17,22,John Adams,United States,-,per-per,PROPN-PROPN,PROPN-PROPN,compound-dobj,nmod-nmod,NNP-NNP,NNP-NNP,4,1
1254,3128.0,21,named,9,12,19,7,11,1,-3,10,John Adams,United States,-,per-per,PROPN-PROPN,PROPN-PROPN,compound-pobj,compound-pobj,NNP-NNP,NNP-NNP,3,1
1255,5493.0,24,is,7,2,13,11,1,10,5,6,John Adams,United States,org-org,-,PROPN-PROPN,PROPN-PROPN,compound-compound,compound-compound,NNP-NNP,NNP-NNP,7,1
1256,6405.0,38,Image,0,10,19,9,9,18,-10,19,John Adams,United States,org-org,-,PROPN-PROPN,PROPN-PROPN,compound-pobj,compound-pobj,NNP-NNP,NNP-NNP,-1,1
1257,7381.0,27,Adams,2,10,17,7,9,9,-8,15,John Adams,United States,per-per,-,PROPN-PROPN,PROPN-PROPN,compound-pobj,compound-pobj,NNP-NNP,NNP-NNP,5,1
1258,582.0,26,represented,8,4,21,17,3,4,4,13,UCLA,Division I,per,-,PROPN,PROPN-PRON,compound,pobj-nsubj,NNP,NNP-PRP,5,1
1259,4152.0,26,represented,8,4,21,17,3,4,4,13,UCLA,Division I,per,-,PROPN,PROPN-PRON,compound,pobj-nsubj,NNP,NNP-PRP,5,1
1260,13992.0,26,represented,8,4,21,17,3,4,4,13,UCLA,Division I,,per-per,PROPN,PROPN-PRON,compound,pobj-nsubj,NNP,NNP-PRP,5,1
1261,583.0,15,was,4,2,14,12,1,0,2,10,Falstaff Brewing Corporation,Missouri,per-per-per,,PROPN-PROPN-PROPN,PROPN,compound-compound-nsubj,pobj,NNP-NNP-NNP,NNP,3,1
1262,584.0,22,turned,3,17,20,3,16,1,-14,17,The Dogg,Mshasho,-,per,DET-PROPN,PROPN,det-poss,compound,DT-NNP,NNP,1,1
1263,585.0,26,dates,7,4,25,21,3,0,3,18,De La Salle University,Philippines,---,org,PROPN-PROPN-PROPN-PROPN,PROPN,compound-compound-compound-pobj,pobj,NNP-NNP-NNP-NNP,NNP,5,1
1264,14084.0,63,are,21,7,15,8,6,47,14,-6,De La Salle University,Philippines,per-per-per-per,,PROPN-PROPN-PROPN-PROPN,PROPN,compound-compound-compound-nsubj,pobj,NNP-NNP-NNP-NNP,NNP,3,1
1265,586.0,16,recruited,2,1,7,6,0,8,1,5,Maxfield,Caulfield Grammar School,org,--,PROPN,PROPN-PROPN-PROPN,nsubjpass,compound-compound-pobj,NNP,NNP-NNP-NNP,4,1
1266,587.0,27,chosen,3,23,25,2,22,1,-20,22,DePauw University,Greencastle,-,org,PROPN-PROPN,PROPN,compound-compound,compound,NNP-NNP,NNP,1,1
1267,588.0,20,bought,9,1,1,0,0,18,8,-8,Tata Steel,Tata Group,org-org,-,PROPN-PROPN,PROPN-PROPN,compound-nsubj,compound-compound,NNP-NNP,NNP-NNP,0,1
1268,5687.0,29,catapulted,10,1,1,0,0,27,9,-9,Tata Steel,Tata Group,-,org-org,PROPN-PROPN,PROPN-PROPN,compound-nsubjpass,compound-compound,NNP-NNP,NNP-NNP,0,1
1269,589.0,41,Founded,0,5,15,10,4,25,-5,15,South Carolina,University of South Carolina System,per-per,----,PROPN-PROPN,PROPN-ADP-PROPN-PROPN-PROPN,compound-compound,pobj-prep-compound-compound-pobj,NNP-NNP,NNP-IN-NNP-NNP-NNP,7,1
1270,590.0,39,born,2,26,37,11,25,1,-24,35,Pennsylvania,Charles Grafly,org,-,PROPN,PROPN-PROPN,pobj,compound-pobj,NNP,NNP-NNP,5,1
1271,591.0,23,cast,3,10,11,1,9,11,-7,8,actor,Dennis Quaid,,org-org,NOUN,PROPN-PROPN,compound,compound-conj,NN,NNP-NNP,1,1
1272,592.0,12,moved,4,3,9,6,2,2,1,5,Richard Stahl,California,-,org,PROPN-PROPN,PROPN,compound-nsubj,pobj,NNP-NNP,NNP,3,1
1273,593.0,52,gave,1,3,26,23,2,25,-2,25,France,Piaf,,per,PROPN,PROPN,dative,compound,NNP,NNP,8,1
1274,594.0,28,said,11,1,15,14,0,12,10,4,El Salvador,Antonio Saca,-,per-per,PROPN-PROPN,PROPN-PROPN,compound-nsubj,compound-nsubj,NNP-NNP,NNP-NNP,3,1
1275,1328.0,38,wrapped,6,13,21,8,12,16,-7,15,El Salvador,Antonio Saca,-,per-per,PROPN-PROPN,PROPN-PROPN,compound-pobj,compound-pobj,NNP-NNP,NNP-NNP,5,1
1276,1481.0,44,made,23,14,30,16,13,13,9,7,El Salvador,Antonio Saca,-,per-per,PROPN-PROPN,PROPN-PROPN,compound-pobj,compound-nsubj,NNP-NNP,NNP-NNP,8,1
1277,4680.0,47,CITY,1,4,9,5,3,37,-3,8,El Salvador,Antonio Saca,per-per,-,PROPN-PROPN,PROPN-PROPN,compound-poss,compound-nsubj,NNP-NNP,NNP-NNP,2,1
1278,7426.0,29,suspected,3,19,22,3,18,6,-16,19,El Salvador,Antonio Saca,-,org-org,PROPN-PROPN,PROPN-PROPN,compound-compound,compound-pobj,NNP-NNP,NNP-NNP,6,1
1279,9918.0,35,attended,3,14,19,5,13,15,-11,16,El Salvador,Antonio Saca,org-org,-,PROPN-PROPN,PROPN-PROPN,compound-poss,compound-ROOT,NNP-NNP,NNP-NNP,4,1
1280,12440.0,32,were,5,10,14,4,9,17,-5,9,El Salvador,Antonio Saca,-,per-per,PROPN-PROPN,PROPN-PROPN,compound-ROOT,nmod-ccomp,NNP-NNP,NNP-NNP,5,1
1281,14148.0,29,said,27,3,23,20,2,5,24,-4,El Salvador,Antonio Saca,-,org-org,PROPN-PROPN,PROPN-PROPN,compound-conj,compound-compound,NNP-NNP,NNP-NNP,9,1
1282,595.0,41,live,30,5,13,8,4,27,25,-17,Benjamin Harrison,Indiana,per-per,,PROPN-PROPN,PROPN,compound-nsubj,pobj,NNP-NNP,NNP,4,1
1283,6998.0,55,leases,5,12,31,19,11,23,-7,26,Benjamin Harrison,Indiana,org-org,,PROPN-PROPN,PROPN,compound-compound,pobj,NNP-NNP,NNP,-1,1
1284,8608.0,27,was,13,2,13,11,1,13,11,0,Benjamin Harrison,Indiana,per-per,,PROPN-PROPN,PROPN,compound-compound,pobj,NNP-NNP,NNP,2,1
1285,596.0,26,was,1,13,21,8,12,4,-12,20,Marc Bureau,Gatineau,-,per,PROPN-PROPN,PROPN,compound-nsubj,pobj,NNP-NNP,NNP,2,1
1286,10466.0,20,reported,4,7,13,6,6,6,-3,9,Marc Bureau,Gatineau,per-per,,PROPN-PROPN,PROPN,compound-nsubj,pobj,NNP-NNP,NNP,2,1
1287,11193.0,19,is,8,1,17,16,0,1,7,9,Marc Bureau,Gatineau,-,per,PROPN-PROPN,PROPN,compound-nsubj,compound,NNP-NNP,NNP,6,1
1288,597.0,22,operates,4,2,3,1,1,18,2,-1,Air India,India,-,per,PROPN-PROPN,PROPN,compound-compound,pobj,NNP-NNP,NNP,1,1
1289,598.0,35,was,13,7,26,19,6,8,6,13,China,Chiang Kai-shek,per,-,PROPN,PROPN-PROPN,poss,compound-pobj,NNP,NNP-NNP,9,1
1290,6742.0,22,Operation,3,6,16,10,5,5,-3,13,China,Chiang Kai-shek,,per-per,PROPN,PROPN-PROPN,compound,compound-compound,NNP,NNP-NNP,7,1
1291,599.0,27,represented,7,3,20,17,2,6,4,13,Boston College Eagles,Division I-A,per-per-per,-,PROPN-PROPN-PROPN,PROPN-PROPN,compound-compound-compound,nmod-compound,NNP-NNP-NNP,NNP-NNP,-1,1
1292,600.0,31,DS,2,7,30,23,6,0,-5,28,Mana,Japan,org,,PROPN,PROPN,compound,pobj,NNP,NNP,5,1
1293,601.0,32,is,5,4,24,20,3,7,1,19,Jacques Chirac,Paris,-,per,PROPN-PROPN,PROPN,compound-nsubj,compound,NNP-NNP,NNP,10,1
1294,3004.0,33,opened,18,10,24,14,9,8,8,6,Jacques Chirac,Paris,-,org,PROPN-PROPN,PROPN,compound-pobj,pobj,NNP-NNP,NNP,4,1
1295,4518.0,32,sued,6,4,17,13,3,14,2,11,Jacques Chirac,Paris,-,per,PROPN-PROPN,PROPN,compound-nsubjpass,compound,NNP-NNP,NNP,6,1
1296,13128.0,29,questioning,2,7,24,17,6,4,-5,22,Jacques Chirac,Paris,per-per,,PROPN-PROPN,PROPN,compound-dobj,compound,NNP-NNP,NNP,4,1
1297,602.0,37,was,12,5,10,5,4,26,7,-2,Samy Vellu,Malaysian Indian Congress,-,org-org-org,PROPN-PROPN,ADJ-PROPN-PROPN,compound-compound,amod-compound-pobj,NNP-NNP,JJ-NNP-NNP,4,1
1298,747.0,32,ruled,3,1,6,5,0,25,2,3,Samy Vellu,Malaysian Indian Congress,per-per,--,PROPN-PROPN,ADJ-PROPN-PROPN,compound-nsubj,amod-compound-dobj,NNP-NNP,JJ-NNP-NNP,3,1
1299,2840.0,27,was,3,9,14,5,8,12,-6,11,Samy Vellu,Malaysian Indian Congress,-,org-org-org,PROPN-PROPN,ADJ-PROPN-PROPN,compound-nsubj,amod-compound-dobj,NNP-NNP,JJ-NNP-NNP,3,1
1300,5362.0,37,harangued,18,2,11,9,1,25,16,-7,Samy Vellu,Malaysian Indian Congress,-,per-per-per,PROPN-PROPN,ADJ-PROPN-PROPN,compound-nsubjpass,amod-compound-compound,NNP-NNP,JJ-NNP-NNP,6,1
1301,6267.0,33,led,5,2,8,6,1,24,3,3,Samy Vellu,Malaysian Indian Congress,per-per,--,PROPN-PROPN,ADJ-PROPN-PROPN,compound-nsubj,amod-compound-dobj,NNP-NNP,JJ-NNP-NNP,3,1
1302,10406.0,38,harangued,19,2,12,10,1,25,17,-7,Samy Vellu,Malaysian Indian Congress,-,org-org-org,PROPN-PROPN,ADJ-PROPN-PROPN,compound-nsubjpass,amod-compound-compound,NNP-NNP,JJ-NNP-NNP,6,1
1303,11611.0,42,called,7,25,31,6,24,10,-18,24,Samy Vellu,Malaysian Indian Congress,-,org-org-org,PROPN-PROPN,ADJ-PROPN-PROPN,compound-pobj,amod-compound-pobj,NNP-NNP,JJ-NNP-NNP,4,1
1304,11875.0,17,directed,5,8,13,5,7,3,-3,8,Samy Vellu,Malaysian Indian Congress,-,org-org-org,PROPN-PROPN,ADJ-PROPN-PROPN,compound-compound,amod-compound-compound,NNP-NNP,JJ-NNP-NNP,5,1
1305,603.0,47,announced,6,22,22,0,21,24,-16,16,Verizon Communications,Verizon Wireless,per-per,-,PROPN-PROPN,PROPN-PROPN,compound-compound,compound-pobj,NNP-NNP,NNP-NNP,0,1
1306,604.0,39,detailed,20,14,17,3,13,21,6,-3,Frank Church,Idaho,per-per,,PROPN-PROPN,PROPN,compound-pobj,pobj,NNP-NNP,NNP,3,1
1307,605.0,29,Londin,1,1,6,5,0,22,0,5,Larrie Londin,drummer,per-per,,PROPN-PROPN,NOUN,compound-ROOT,appos,NNP-NNP,NN,3,1
1308,606.0,32,produced,4,7,22,15,6,9,-3,18,its,United States,org,-,DET,PROPN-PROPN,poss,compound-pobj,PRP$,NNP-NNP,5,1
1309,607.0,16,is,2,2,10,8,1,5,0,8,bridge,New Jersey,org,-,NOUN,PROPN-PROPN,nsubj,compound-nmod,NN,NNP-NNP,6,1
1310,608.0,22,nominated,6,4,15,11,3,6,2,9,Brian Dennehy,Actor,per-per,,PROPN-PROPN,PROPN,compound-nsubjpass,pobj,NNP-NNP,NNP,4,1
1311,609.0,40,diagnosed,3,2,20,18,1,19,1,17,Lee,California,org,,PROPN,PROPN,nsubjpass,pobj,NNP,NNP,5,1
1312,610.0,18,Usha,0,11,17,6,10,0,-11,17,Singer Usha,singer,org-org,,PROPN-PROPN,NOUN,compound-nsubj,attr,NNP-NNP,NN,4,1
1313,611.0,34,began,3,25,26,1,24,7,-22,23,Mean,Gene Okerlund,per,-,PROPN,PROPN-PROPN,compound,compound-conj,NNP,NNP-NNP,1,1
1314,612.0,34,is,12,1,22,21,0,11,11,10,Phillip Chapman Lesh,Grateful Dead,per-per-per,-,PROPN-PROPN-PROPN,PROPN-PROPN,compound-compound-nsubj,compound-pobj,NNP-NNP-NNP,NNP-NNP,6,1
1315,613.0,28,played,2,6,10,4,5,17,-4,8,FC Civics,Namibia Premier League,per-per,--,PROPN-PROPN,PROPN-PROPN-PROPN,compound-pobj,compound-compound-pobj,NNP-NNPS,NNP-NNP-NNP,3,1
1316,614.0,9,is,2,1,7,6,0,1,1,5,Carol Mitchell,Ontario,-,per,PROPN-PROPN,PROPN,compound-nsubj,pobj,NNP-NNP,NNP,5,1
1317,615.0,31,administered,2,1,6,5,0,24,1,4,MARC,Maryland Transit Administration,,org-org-org,PROPN,PROPN-PROPN-PROPN,nsubjpass,compound-compound-nmod,NNP,NNP-NNP-NNP,4,1
1318,616.0,37,used,4,9,30,21,8,6,-5,26,Adams,Texas,,org,PROPN,PROPN,poss,pobj,NNP,NNP,7,1
1319,617.0,19,is,10,1,13,12,0,5,9,3,Escola Catolica Estrela do Mar,Cathol,per-per-per-per-per,,PROPN-PROPN-PROPN-VERB-PROPN,PROPN,compound-compound-nsubj-aux-pobj,attr,NNP-NNP-NNP-VB-NNP,NNP,5,1
1320,618.0,65,Canada's,0,32,37,5,31,27,-32,37,Vic Toews,Treasury Board,-,org-org,PROPN-PROPN,PROPN-PROPN,compound-compound,compound-pobj,NNP-NNP,NNP-NNP,5,1
1321,13522.0,20,named,7,12,18,6,11,1,-5,11,Vic Toews,Treasury Board,org-org,-,PROPN-PROPN,PROPN-PROPN,compound-dobj,compound-pobj,NNP-NNPS,NNP-NNP,5,1
1322,619.0,56,is,25,5,9,4,4,46,20,-16,New Orleans,Tulane School of Architecture,per-per,---,PROPN-PROPN,PROPN-PROPN-ADP-PROPN,compound-compound,compound-conj-prep-pobj,NNP-NNP,NNP-NNP-IN-NNP,2,1
1323,620.0,28,cursed,12,12,26,14,11,1,0,14,guitarist,Jarvis Cocker,org,-,NOUN,PROPN-PROPN,dobj,compound-pobj,NN,NNP-NNP,4,1
1324,621.0,38,In,0,6,23,17,5,14,-6,23,Texas,Rick Noriega,per,-,PROPN,PROPN-PROPN,compound,compound-compound,NNP,NNP-NNP,6,1
1325,5756.0,30,said,14,6,11,5,5,18,8,-3,Texas,Rick Noriega,,org-org,PROPN,PROPN-PROPN,pobj,compound-appos,NNP,NNP-NNP,3,1
1326,622.0,29,given,13,19,21,2,18,7,-6,8,Quebec City,Labeaume,-,org,PROPN-PROPN,PROPN,compound-compound,pobj,NNP-NNP,NNP,4,1
1327,2469.0,61,showed,4,31,38,7,30,22,-27,34,Quebec City,Labeaume,per-per,,PROPN-PROPN,PROPN,compound-compound,pobj,NNP-NNP,NNP,3,1
1328,623.0,38,forum,1,25,36,11,24,1,-24,35,Lebanon,Fouad Siniora,,per-per,PROPN,PROPN-PROPN,pobj,compound-pobj,NNP,NNP-NNP,7,1
1329,883.0,46,met,15,7,12,5,6,33,8,-3,Lebanon,Fouad Siniora,,org-org,PROPN,PROPN-PROPN,poss,compound-dobj,NNP,NNP-NNP,3,1
1330,1537.0,25,said,17,1,23,22,0,1,16,6,Lebanon,Fouad Siniora,,per-per,PROPN,PROPN-PROPN,nsubj,compound-dobj,NNP,NNP-NNP,5,1
1331,3699.0,29,is,1,13,19,6,12,9,-12,18,Lebanon,Fouad Siniora,per,-,PROPN,PROPN-PROPN,pobj,compound-pobj,NNP,NNP-NNP,3,1
1332,6042.0,41,said,37,12,29,17,11,11,25,-8,Lebanon,Fouad Siniora,,per-per,PROPN,PROPN-PROPN,pobj,compound-poss,NNP,NNP-NNP,6,1
1333,6827.0,31,made,19,16,29,13,15,1,3,10,Lebanon,Fouad Siniora,,org-org,PROPN,PROPN-PROPN,pobj,compound-pobj,NNP,NNP-NNP,8,1
1334,13690.0,26,began,10,13,24,11,12,1,-3,14,Lebanon,Fouad Siniora,,org-org,PROPN,PROPN-PROPN,pobj,compound-pobj,NNP,NNP-NNP,9,1
1335,624.0,48,received,5,27,32,5,26,15,-22,27,Jeff Merkley,Oregon,-,per,PROPN-PROPN,PROPN,compound-pobj,ROOT,NNP-NNP,NNP,2,1
1336,2467.0,25,opposed,2,6,12,6,5,12,-4,10,Jeff Merkley,Oregon,per-per,,PROPN-PROPN,PROPN,compound-pobj,pobj,NNP-NNP,NNP,3,1
1337,4305.0,48,received,5,27,32,5,26,15,-22,27,Jeff Merkley,Oregon,-,per,PROPN-PROPN,PROPN,compound-pobj,compound,NNP-NNP,NNP,2,1
1338,7723.0,25,opposed,2,6,12,6,5,12,-4,10,Jeff Merkley,Oregon,org-org,,PROPN-PROPN,PROPN,compound-pobj,pobj,NNP-NNP,NNP,3,1
1339,12285.0,25,treats,15,6,8,2,5,16,9,-7,Jeff Merkley,Oregon,org-org,,PROPN-PROPN,PROPN,compound-compound,compound,NNP-NNP,NNP,1,1
1340,625.0,14,acquired,4,2,13,11,1,0,2,9,his,Switzerland,,per,DET,PROPN,poss,pobj,PRP$,NNP,3,1
1341,626.0,29,is,9,18,27,9,17,1,-9,18,Florida,Bob Graham,,per-per,PROPN,PROPN-PROPN,poss,compound-conj,NNP,NNP-NNP,6,1
1342,1453.0,38,appointed,3,11,13,2,10,24,-8,10,Florida,Bob Graham,org,-,PROPN,PROPN-PROPN,compound,compound-nsubj,NNP,NNP-NNP,1,1
1343,5100.0,13,became,7,6,11,5,5,1,1,4,Florida,Bob Graham,per,-,PROPN,PROPN-PROPN,pobj,compound-pobj,NNP,NNP-NNP,4,1
1344,5418.0,29,cooked,11,7,9,2,6,19,4,-2,Florida,Bob Graham,per,-,PROPN,PROPN-PROPN,compound,compound-pobj,NNP,NNP-NNP,1,1
1345,5764.0,40,founded,14,8,13,5,7,26,6,-1,Florida,Bob Graham,per,-,PROPN,PROPN-PROPN,compound,compound-conj,NNP,NNP-NNP,4,1
1346,6446.0,49,is,16,41,43,2,40,5,-25,27,Florida,Bob Graham,,per-per,PROPN,PROPN-PROPN,pobj,compound-compound,NNP,NNP-NNP,3,1
1347,9928.0,34,is,6,23,25,2,22,8,-17,19,Florida,Bob Graham,,per-per,PROPN,PROPN-PROPN,compound,compound-nsubj,NNP,NNP-NNP,1,1
1348,12763.0,31,served,1,7,29,22,6,1,-6,28,Florida,Bob Graham,,org-org,PROPN,PROPN-PROPN,compound,compound-pobj,NNP,NNP-NNP,9,1
1349,13890.0,31,won,3,15,22,7,14,8,-12,19,Florida,Bob Graham,,per-per,PROPN,PROPN-PROPN,compound,compound-nsubj,NNP,NNP-NNP,4,1
1350,627.0,20,was,1,10,11,1,9,8,-9,10,President,James Michel,per,-,PROPN,PROPN-PROPN,compound,compound-pobj,NNP,NNP-NNP,1,1
1351,628.0,24,dipped,3,3,21,18,2,2,0,18,Burberry,London,per,,PROPN,PROPN,pobj,compound,NNP,NNP,3,1
1352,629.0,18,became,1,1,7,6,0,10,0,6,Drapht,Perth,,per,NOUN,PROPN,nsubj,poss,NNS,NNP,5,1
1353,631.0,17,is,2,1,15,14,0,1,1,13,Aftermath,Dr. Dre,org,-,PROPN,PROPN-PROPN,compound,compound-appos,NNP,NNP-NNP,6,1
1354,8172.0,29,came,5,5,21,16,4,7,0,16,Aftermath,Dr. Dre,org,-,PROPN,PROPN-PROPN,pobj,compound-nsubj,NNP,NNP-NNP,4,1
1355,11676.0,49,took,8,3,7,4,2,41,5,-1,Aftermath,Dr. Dre,org,-,PROPN,PROPN-PROPN,compound,compound-nsubj,NNP,NNP-NNP,4,1
1356,13390.0,23,signee,1,1,3,2,0,19,0,2,Aftermath,Dr. Dre,,per-per,PROPN,PROPN-PROPN,nsubj,compound-compound,NNP,NNP-NNP,2,1
1357,632.0,132,returned,19,12,17,5,11,114,7,-2,Frank Bainimarama,Fiji,per-per,,PROPN-PROPN,PROPN,compound-compound,compound,NNP-NNP,NNP,4,1
1358,1158.0,75,arrested,28,5,14,9,4,60,23,-14,Frank Bainimarama,Fiji,per-per,,PROPN-PROPN,PROPN,compound-appos,compound,NNP-NNP,NNP,7,1
1359,3029.0,30,said,7,6,12,6,5,17,1,5,Frank Bainimarama,Fiji,per-per,,PROPN-PROPN,PROPN,compound-nsubj,compound,NNP-NNP,NNP,7,1
1360,3146.0,61,Commander,5,17,23,6,16,37,-12,18,Frank Bainimarama,Fiji,org-org,,PROPN-PROPN,PROPN,compound-pobj,compound,NNP-NNP,NNP,4,1
1361,633.0,27,is,2,1,2,1,0,24,1,0,Wienerberger,AG,org,,PROPN,PROPN,compound,nsubj,NNP,NNP,1,1
1362,635.0,29,holds,1,23,23,0,22,5,-22,22,Kent State University,Kent,per-per-per,,PROPN-PROPN-PROPN,PROPN,compound-compound-pobj,compound,NNP-NNP-NNP,NNP,0,1
1363,636.0,39,are,1,7,7,0,6,31,-6,6,Sligo,Sligo Weekender,org,-,PROPN,PROPN-NOUN,pobj,compound-compound,NNP,NNP-NN,0,1
1364,637.0,40,contributes,2,31,34,3,30,5,-29,32,McGill University,Montreal,-,per,PROPN-PROPN,PROPN,compound-pobj,pobj,NNP-NNP,NNP,6,1
1365,2540.0,40,is,2,15,38,23,14,1,-13,36,McGill University,Montreal,org-org,,PROPN-PROPN,PROPN,compound-pobj,compound,NNP-NNP,NNP,11,1
1366,7243.0,46,say,25,22,25,3,21,20,3,0,McGill University,Montreal,org-org,,PROPN-PROPN,PROPN,compound-pobj,pobj,NNP-NNP,NNP,4,1
1367,13438.0,23,is,2,18,21,3,17,1,-16,19,McGill University,Montreal,-,per,PROPN-PROPN,PROPN,compound-pobj,compound,NNP-NNP,NNP,2,1
1368,638.0,26,includes,10,4,25,21,3,0,6,15,Maine West High School,Illinois,org-org-org-org,,PROPN-PROPN-PROPN-PROPN,PROPN,compound-compound-compound-compound,pobj,NNP-NNP-NNP-NNP,NNP,7,1
1369,639.0,57,pressured,33,16,29,13,15,27,17,-4,Japan,Princes Chichibu,,org-org,PROPN,PROPN-PROPN,pobj,compound-compound,NNP,NNP-NNP,10,1
1370,640.0,24,bought,14,17,22,5,16,1,-3,8,Andrew W.K.,Bulb,org-org,,PROPN-PROPN,PROPN,compound-poss,compound,NNP-NNP,NNP,3,1
1371,641.0,56,fell,7,48,54,6,47,1,-41,47,University of California,UCLA,org-org-org,,PROPN-ADP-PROPN,PROPN,pobj-prep-pobj,appos,NNP-IN-NNP,NNP,10,1
1372,642.0,18,returned,2,8,15,7,7,2,-6,13,Centre College,Colonels,-,org,PROPN-PROPN,PROPN,compound-appos,dobj,NNP-NNP,NNPS,2,1
1373,643.0,28,recognized,8,2,6,4,1,21,6,-2,Posse Foundation,Deborah Bial,per-per,-,PROPN-PROPN,PROPN-PROPN,compound-poss,compound-appos,NNP-NNP,NNP-NNP,2,1
1374,644.0,17,started,4,12,15,3,11,1,-8,11,Ford,Mercury,,org,PROPN,PROPN,compound,compound,NNP,NNP,1,1
1375,645.0,14,founded,4,2,9,7,1,4,2,5,Coleman Company,W. C. Coleman,org-org,--,PROPN-PROPN,PROPN-PROPN-PROPN,compound-nsubjpass,compound-compound-pobj,NNP-NNP,NNP-NNP-NNP,4,1
1376,646.0,41,dedicated,2,26,32,6,25,8,-24,30,he,Continental Army,org,-,PRON,PROPN-PROPN,nsubj,compound-pobj,PRP,NNP-NNP,6,1
1377,4667.0,21,know,2,4,7,3,3,13,-2,5,he,Continental Army,,per-per,PRON,PROPN-PROPN,nsubj,compound-dobj,PRP,NNP-NNP,1,1
1378,647.0,34,established,8,11,23,12,10,10,-3,15,City University of New York,Baruch College,org-org-org-org-org,-,PROPN-PROPN-ADP-PROPN-PROPN,PROPN-PROPN,compound-nmod-prep-compound-pobj,compound-nsubj,NNP-NNP-IN-NNP-NNP,NNP-NNP,3,1
1379,648.0,51,investigated,9,7,15,8,6,35,2,6,Canadian,Jaffer,org,,PROPN,PROPN,compound,dobj,NNP,NNP,6,1
1380,649.0,16,stressed,5,4,12,8,3,3,1,7,Ahtisaari,Finland,per,,PROPN,PROPN,pobj,nsubj,NNP,NNP,4,1
1381,13351.0,18,accepted,3,3,9,6,2,8,0,6,Ahtisaari,Finland,,per,PROPN,PROPN,nsubj,poss,NNP,NNP,5,1
1382,650.0,35,tend,2,15,19,4,14,15,-13,17,Olivier,actor,org,,PROPN,NOUN,pobj,nsubj,NNP,NN,1,1
1383,651.0,23,lived,1,1,7,6,0,15,0,6,He,Turkey,,per,PRON,PROPN,nsubj,pobj,PRP,NNP,5,1
1384,652.0,27,released,2,8,20,12,7,6,-6,18,Naive,Hammill,per,,PROPN,PROPN,compound,poss,NNP,NNP,11,1
1385,653.0,46,came,4,15,31,16,14,14,-11,27,he,Ohio,per,,PRON,PROPN,nsubj,pobj,PRP,NNP,5,1
1386,654.0,26,set,7,10,12,2,9,13,-3,5,costume designer,Tony Walton,per-per,-,VERB-NOUN,PROPN-PROPN,compound-dobj,compound-nsubj,VB-NN,NNP-NNP,1,1
1387,655.0,24,began,13,1,10,9,0,13,12,-3,Thailand,Thaksin Shinawatra,,per-per,PROPN,PROPN-PROPN,poss,compound-pobj,NNP,NNP-NNP,5,1
1388,656.0,20,was,5,4,16,12,3,3,1,11,Constantine Mitsotakis,Greece,per-per,,PROPN-PROPN,PROPN,compound-appos,poss,NNP-NNP,NNP,6,1
1389,657.0,28,produced,2,12,20,8,11,7,-10,18,Miami,Barrett,,per,PROPN,PROPN,poss,pobj,NNP,NNP,7,1
1390,658.0,18,is,10,1,16,15,0,1,9,6,Cairo University,Giza,-,per,PROPN-PROPN,PROPN,compound-nsubj,compound,NNP-NNP,NNP,4,1
1391,659.0,28,elected,17,3,5,2,2,22,14,-12,Mel Martinez,Florida,per-per,,PROPN-PROPN,PROPN,compound-compound,poss,NNP-NNP,NNP,2,1
1392,3180.0,40,2001,3,21,31,10,20,8,-18,28,Mel Martinez,Florida,-,org,PROPN-PROPN,PROPN,compound-appos,compound,NNP-NNP,NNP,4,1
1393,10623.0,30,employed,2,13,16,3,12,13,-11,14,Mel Martinez,Florida,per-per,,PROPN-PROPN,PROPN,compound-pobj,pobj,NNP-NNP,NNP,4,1
1394,10626.0,27,stepped,17,2,5,3,1,21,15,-12,Mel Martinez,Florida,org-org,,PROPN-PROPN,PROPN,compound-nsubj,compound,NNP-NNP,NNP,1,1
1395,12501.0,42,said,13,2,5,3,1,36,11,-8,Mel Martinez,Florida,per-per,,PROPN-PROPN,PROPN,compound-nsubj,pobj,NNP-NNP,NNP,2,1
1396,660.0,31,is,15,13,29,16,12,1,2,14,Aerial,United States,,per-per,PROPN,PROPN-PROPN,compound,compound-pobj,NNP,NNP-NNP,10,1
1397,661.0,17,League,2,1,14,13,0,2,1,12,Russian Premier League,FC Spartak Moscow,org-org-org,--,PROPN-PROPN-PROPN,PROPN-PROPN-PROPN,amod-compound-ROOT,compound-compound-pobj,NNP-NNP-NNP,NNP-NNP-NNP,5,1
1398,662.0,26,taught,3,10,7,-3,9,18,-7,4,Alexandria,his,per,,PROPN,DET,compound,poss,NNP,PRP$,3,1
1399,663.0,23,released,8,3,21,18,2,1,5,13,Lowe,Upstart Records,per,-,PROPN,PROPN-PROPN,pobj,compound-pobj,NNP,NNP-NNPS,8,1
1400,664.0,21,was,10,1,13,12,0,7,9,3,Mottley,Leader,org,,PROPN,PROPN,nsubj,attr,NNP,NNP,5,1
1401,665.0,17,was,11,6,10,4,5,6,5,-1,Singapore,his,,per,PROPN,DET,compound,poss,NNP,PRP$,5,1
1402,975.0,30,Born,0,3,22,19,2,7,-3,22,Singapore,his,org,,PROPN,DET,pobj,poss,NNP,PRP$,5,1
1403,666.0,31,provide,2,6,17,11,5,13,-4,15,Vietnam,Ho Chi Minh,per,--,PROPN,PROPN-PROPN-PROPN,pobj,compound-compound-compound,NNP,NNP-NNP-NNP,8,1
1404,773.0,32,said,5,11,23,12,10,8,-6,18,Vietnam,Ho Chi Minh,per,--,PROPN,PROPN-PROPN-PROPN,nsubj,compound-compound-compound,NNP,NNP-NNP-NNP,3,1
1405,1015.0,31,announced,2,14,17,3,13,13,-12,15,Vietnam,Ho Chi Minh,,org-org-org,PROPN,PROPN-PROPN-PROPN,poss,compound-compound-compound,NNP,NNP-NNP-NNP,4,1
1406,1159.0,35,detained,6,21,31,10,20,3,-15,25,Vietnam,Ho Chi Minh,per,--,PROPN,PROPN-PROPN-PROPN,poss,compound-compound-compound,NNP,NNP-NNP-NNP,-1,1
1407,1731.0,20,is,6,6,8,2,5,11,0,2,Vietnam,Ho Chi Minh,,per-per-per,PROPN,PROPN-PROPN-PROPN,pobj,compound-compound-compound,NNP,NNP-NNP-NNP,5,1
1408,2674.0,68,arrived,4,7,9,2,6,58,-3,5,Vietnam,Ho Chi Minh,,org-org-org,PROPN,PROPN-PROPN-PROPN,poss,compound-compound-compound,NNP,NNP-NNP-NNP,4,1
1409,2950.0,32,said,4,13,15,2,12,16,-9,11,Vietnam,Ho Chi Minh,,org-org-org,PROPN,PROPN-PROPN-PROPN,poss,compound-compound-compound,NNP,NNP-NNP-NNP,4,1
1410,3251.0,28,said,25,9,22,13,8,5,16,-3,Vietnam,Ho Chi Minh,per,--,PROPN,PROPN-PROPN-PROPN,pobj,compound-compound-compound,NNP,NNP-NNP-NNP,7,1
1411,3312.0,28,take,2,1,14,13,0,13,1,12,Vietnam,Ho Chi Minh,,per-per-per,PROPN,PROPN-PROPN-PROPN,nsubj,compound-compound-compound,NNP,NNP-NNP-NNP,6,1
1412,3925.0,25,found,5,13,15,2,12,9,-8,10,Vietnam,Ho Chi Minh,,per-per-per,PROPN,PROPN-PROPN-PROPN,poss,compound-compound-compound,NNP,NNP-NNP-NNP,5,1
1413,4666.0,10,visits,4,4,6,2,3,3,0,2,Vietnam,Ho Chi Minh,,per-per-per,PROPN,PROPN-PROPN-PROPN,pobj,compound-compound-compound,NNP,NNP-NNP-NNP,5,1
1414,5184.0,35,expected,16,9,12,3,8,22,7,-4,Vietnam,Ho Chi Minh,,org-org-org,PROPN,PROPN-PROPN-PROPN,poss,compound-compound-compound,NNP,NNP-NNP-NNP,4,1
1415,5306.0,23,proclaimed,10,7,8,1,6,14,3,-2,Vietnam,Ho Chi Minh,,per-per-per,PROPN,PROPN-PROPN-PROPN,compound,compound-compound-pobj,NNP,NNP-NNP-NNP,2,1
1416,5775.0,43,decided,22,10,13,3,9,29,12,-9,Vietnam,Ho Chi Minh,,org-org-org,PROPN,PROPN-PROPN-PROPN,pobj,compound-compound-compound,NNP,NNP-NNP-NNP,4,1
1417,6080.0,23,is,5,5,18,13,4,4,0,13,Vietnam,Ho Chi Minh,org,--,PROPN,PROPN-PROPN-PROPN,pobj,compound-compound-compound,NNP,NNP-NNP-NNP,5,1
1418,6114.0,67,clicked,23,14,19,5,13,47,9,-4,Vietnam,Ho Chi Minh,org,--,PROPN,PROPN-PROPN-PROPN,poss,compound-compound-compound,NNP,NNP-NNP-NNP,4,1
1419,6192.0,28,left,2,9,11,2,8,16,-7,9,Vietnam,Ho Chi Minh,,per-per-per,PROPN,PROPN-PROPN-PROPN,dobj,compound-compound-compound,NNP,NNP-NNP-NNP,4,1
1420,6220.0,20,houses,2,1,9,8,0,10,1,7,Vietnam,Ho Chi Minh,,per-per-per,PROPN,PROPN-PROPN-PROPN,nsubj,compound-compound-compound,NNP,NNP-NNP-NNP,5,1
1421,6390.0,27,became,14,5,24,19,4,2,9,10,Vietnam,Ho Chi Minh,per,--,PROPN,PROPN-PROPN-PROPN,pobj,compound-compound-pobj,NNP,NNP-NNP-NNP,7,1
1422,6486.0,18,formed,8,7,11,4,6,6,1,3,Vietnam,Ho Chi Minh,org,--,PROPN,PROPN-PROPN-PROPN,pobj,compound-compound-pobj,NNP,NNP-NNP-NNP,4,1
1423,6551.0,60,had,5,5,20,15,4,39,0,15,Vietnam,Ho Chi Minh,,org-org-org,PROPN,PROPN-PROPN-PROPN,nsubj,compound-compound-compound,NNP,NNP-NNP-NNP,11,1
1424,6575.0,47,intended,28,4,6,2,3,40,24,-22,Vietnam,Ho Chi Minh,per,--,PROPN,PROPN-PROPN-PROPN,pobj,compound-compound-poss,NNP,NNP-NNP-NNP,3,1
1425,6584.0,39,start,2,1,8,7,0,30,1,6,Vietnam,Ho Chi Minh,per,--,PROPN,PROPN-PROPN-PROPN,nsubj,compound-compound-compound,NNP,NNP-NNP-NNP,7,1
1426,7055.0,15,encounter,7,1,3,2,0,11,6,-4,Vietnam,Ho Chi Minh,,per-per-per,PROPN,PROPN-PROPN-PROPN,poss,compound-compound-compound,NNP,NNP-NNP-NNP,4,1
1427,7615.0,35,arrived,4,7,9,2,6,25,-3,5,Vietnam,Ho Chi Minh,,per-per-per,PROPN,PROPN-PROPN-PROPN,poss,compound-compound-compound,NNP,NNP-NNP-NNP,4,1
1428,7878.0,30,Taiwan's,0,5,9,4,4,20,-5,9,Vietnam,Ho Chi Minh,per,--,PROPN,PROPN-PROPN-PROPN,pobj,compound-compound-compound,NNP,NNP-NNP-NNP,7,1
1429,8006.0,37,said,4,13,31,18,12,5,-9,27,Vietnam,Ho Chi Minh,org,--,PROPN,PROPN-PROPN-PROPN,conj,compound-compound-conj,NNP,NNP-NNP-NNP,4,1
1430,8676.0,51,held,15,11,23,12,10,27,4,8,Vietnam,Ho Chi Minh,per,--,PROPN,PROPN-PROPN-PROPN,pobj,compound-compound-compound,NNP,NNP-NNP-NNP,10,1
1431,9427.0,10,meet,8,1,4,3,0,5,7,-4,Vietnam,Ho Chi Minh,org,--,PROPN,PROPN-PROPN-PROPN,nsubj,compound-compound-compound,NNP,NNP-NNP-NNP,5,1
1432,10058.0,35,reported,33,22,25,3,21,9,11,-8,Vietnam,Ho Chi Minh,,per-per-per,PROPN,PROPN-PROPN-PROPN,poss,compound-compound-compound,NNP,NNP-NNP-NNP,3,1
1433,10338.0,34,established,23,6,21,15,5,12,17,-2,Vietnam,Ho Chi Minh,org,--,PROPN,PROPN-PROPN-PROPN,compound,compound-compound-appos,NNP,NNP-NNP-NNP,8,1
1434,10641.0,69,said,37,3,20,17,2,48,34,-17,Vietnam,Ho Chi Minh,per,--,PROPN,PROPN-PROPN-PROPN,pobj,compound-compound-compound,NNP,NNP-NNP-NNP,8,1
1435,11309.0,35,With,0,6,11,5,5,23,-6,11,Vietnam,Ho Chi Minh,,org-org-org,PROPN,PROPN-PROPN-PROPN,compound,compound-compound-nsubj,NNP,NNP-NNP-NNP,6,1
1436,11803.0,28,said,25,7,20,13,6,7,18,-5,Vietnam,Ho Chi Minh,org,--,PROPN,PROPN-PROPN-PROPN,pobj,compound-compound-compound,NNP,NNP-NNP-NNP,5,1
1437,12083.0,56,coded,5,3,23,20,2,32,2,18,Vietnam,Ho Chi Minh,per,--,PROPN,PROPN-PROPN-PROPN,npadvmod,compound-compound-compound,NNP,NNP-NNP-NNP,6,1
1438,12394.0,26,said,10,5,7,2,4,18,5,-3,Vietnam,Ho Chi Minh,org,--,PROPN,PROPN-PROPN-PROPN,poss,compound-compound-compound,NNP,NNP-NNP-NNP,4,1
1439,12673.0,29,presented,7,18,20,2,17,8,-11,13,Vietnam,Ho Chi Minh,org,--,PROPN,PROPN-PROPN-PROPN,poss,compound-compound-pobj,NNP,NNP-NNP-NNP,4,1
1440,13492.0,21,is,1,7,15,8,6,5,-6,14,Vietnam,Ho Chi Minh,per,--,PROPN,PROPN-PROPN-PROPN,pobj,compound-compound-compound,NNP,NNP-NNP-NNP,8,1
1441,13754.0,57,met,32,15,35,20,14,21,17,3,Vietnam,Ho Chi Minh,,per-per-per,PROPN,PROPN-PROPN-PROPN,pobj,compound-compound-compound,NNP,NNP-NNP-NNP,8,1
1442,13792.0,25,said,22,1,13,12,0,11,21,-9,Vietnam,Ho Chi Minh,per,--,PROPN,PROPN-PROPN-PROPN,poss,compound-compound-compound,NNP,NNP-NNP-NNP,8,1
1443,13898.0,31,growing,5,1,22,21,0,8,4,17,Vietnam,Ho Chi Minh,per,--,PROPN,PROPN-PROPN-PROPN,poss,compound-compound-compound,NNP,NNP-NNP-NNP,9,1
1444,14107.0,45,said,1,10,26,16,9,18,-9,25,Vietnam,Ho Chi Minh,org,--,PROPN,PROPN-PROPN-PROPN,nsubj,compound-compound-pobj,NNP,NNP-NNP-NNP,8,1
1445,667.0,41,ZAMAN,0,18,24,6,17,16,-18,24,India,Pratibha Patil,per,-,PROPN,PROPN-PROPN,pobj,compound-pobj,NNP,NNP-NNP,3,1
1446,11849.0,48,travel,4,7,17,10,6,30,-3,13,India,Pratibha Patil,org,-,PROPN,PROPN-PROPN,pobj,compound-pobj,NNP,NNP-NNP,7,1
1447,668.0,30,is,7,6,12,6,5,17,1,5,The New York Times Company,New York,----,per-per,DET-PROPN-PROPN-PROPN-PROPN,PROPN-PROPN,det-compound-compound-compound-pobj,compound-compound,DT-NNP-NNP-NNP-NNP,NNP-NNP,6,1
1448,11754.0,25,Company,4,1,2,1,0,22,3,-2,The New York Times Company,New York,----,per-per,DET-PROPN-PROPN-PROPN-PROPN,PROPN-PROPN,det-compound-compound-compound-ROOT,compound-compound,DT-NNP-NNP-NNP-NNP,NNP-NNP,1,1
1449,669.0,21,approved,4,1,13,12,0,7,3,9,Macedonia,Nikola Gruevski,,per-per,PROPN,PROPN-PROPN,poss,compound-compound,NNP,NNP-NNP,8,1
1450,4355.0,32,said,8,1,6,5,0,25,7,-2,Macedonia,Nikola Gruevski,,per-per,PROPN,PROPN-PROPN,poss,compound-nsubj,NNP,NNP-NNP,3,1
1451,11567.0,30,warned,28,2,6,4,1,23,26,-22,Macedonia,Nikola Gruevski,,org-org,PROPN,PROPN-PROPN,poss,compound-nsubj,NNP,NNP-NNP,3,1
1452,12412.0,55,attended,3,9,19,10,8,35,-6,16,Macedonia,Nikola Gruevski,,per-per,PROPN,PROPN-PROPN,compound,compound-ccomp,NNP,NNP-NNP,-1,1
1453,12648.0,33,expressed,10,1,3,2,0,29,9,-7,Macedonia,Nikola Gruevski,,org-org,PROPN,PROPN-PROPN,poss,compound-nsubj,NNP,NNP-NNP,2,1
1454,670.0,31,criticised,5,1,3,2,0,27,4,-2,Education,Hishammuddin Hussein,,per-per,PROPN,PROPN-PROPN,compound,compound-nsubj,NNP,NNP-NNP,1,1
1455,9265.0,18,told,15,12,14,2,11,3,3,-1,Education,Hishammuddin Hussein,,per-per,PROPN,PROPN-PROPN,compound,compound-nsubj,NNP,NNP-NNP,3,1
1456,13657.0,38,create,3,29,31,2,28,6,-26,28,Education,Hishammuddin Hussein,,per-per,PROPN,PROPN-PROPN,compound,compound-nsubj,NNP,NNP-NNP,3,1
1457,671.0,13,said,7,2,11,9,1,1,5,4,SFO,Richard Alderman,org,-,PROPN,PROPN-PROPN,compound,compound-nsubj,NNP,NNP-NNP,3,1
1458,672.0,35,told,30,13,27,14,12,7,17,-3,Laurent Gbagbo,Ivory Coast,-,per-per,PROPN-PROPN,PROPN-PROPN,compound-compound,compound-compound,NNP-NNP,NNP-NNP,6,1
1459,673.0,40,started,6,2,21,19,1,18,4,15,INC,Iraq,,per,PROPN,PROPN,poss,pobj,NNP,NNP,7,1
1460,674.0,32,appeared,17,8,21,13,7,10,9,4,Bert Kaempfert,Polydor,org-org,,PROPN-PROPN,PROPN,compound-compound,compound,NNP-NNP,NNP,7,1
1461,675.0,50,Event,0,29,37,8,28,12,-29,37,Taipei,Chen Shui-bian,per,-,PROPN,PROPN-ADJ,compound,compound-amod,NNP,NNP-JJ,5,1
1462,3321.0,25,Host,8,7,15,8,6,9,1,7,Taipei,Chen Shui-bian,,org-org,PROPN,PROPN-ADJ,compound,compound-amod,NNP,NNP-JJ,5,1
1463,676.0,31,referred,3,6,20,14,5,10,-3,17,Mojofly,Kitchie Nadal,org,-,PROPN,PROPN-PROPN,compound,compound-nsubj,NNP,NNP-NNP,5,1
1464,677.0,29,insisted,8,3,7,4,2,21,5,-1,Free Patriotic Movement,Michel Aoun,per-per-per,-,PROPN-PROPN-PROPN,PROPN-PROPN,compound-compound-compound,compound-nsubj,NNP-NNP-NNP,NNP-NNP,3,1
1465,6480.0,36,was,2,12,18,6,11,17,-10,16,Free Patriotic Movement,Michel Aoun,--,per-per,PROPN-PROPN-PROPN,PROPN-PROPN,compound-compound-nsubjpass,compound-pobj,NNP-NNP-NNP,NNP-NNP,4,1
1466,14157.0,24,stressed,1,14,18,4,13,5,-13,17,Free Patriotic Movement,Michel Aoun,per-per-per,-,PROPN-PROPN-PROPN,PROPN-PROPN,compound-compound-compound,compound-dobj,NNP-NNP-NNP,NNP-NNP,3,1
1467,678.0,13,is,3,1,11,10,0,1,2,8,Holy Names University,Oakland,--,per,PROPN-PROPN-PROPN,PROPN,compound-compound-nsubj,compound,NNP-NNP-NNP,NNP,6,1
1468,679.0,49,is,8,1,14,13,0,34,7,6,Somchai Wongsawat,Prime Minister,-,per-per,PROPN-PROPN,PROPN-PROPN,compound-nsubj,compound-appos,NNP-NNP,NNP-NNP,3,1
1469,680.0,16,was,10,1,6,5,0,9,9,-4,Kallio,Finland,,per,PROPN,PROPN,nsubj,pobj,NNP,NNP,2,1
1470,5164.0,17,acted,1,1,9,8,0,7,0,8,Kallio,Finland,,per,PROPN,PROPN,nsubj,pobj,NNP,NNP,2,1
1471,7813.0,37,elected,13,6,23,17,5,13,7,10,Kallio,Finland,,org,PROPN,PROPN,pobj,pobj,NNP,NNP,6,1
1472,10830.0,13,was,4,1,12,11,0,0,3,8,Kallio,Finland,per,,PROPN,PROPN,poss,pobj,NNP,NNP,4,1
1473,10882.0,20,was,9,1,15,14,0,4,8,6,Kallio,Finland,,org,PROPN,PROPN,nsubj,pobj,NNP,NNP,5,1
1474,681.0,24,formed,6,3,20,17,2,3,3,14,Western,Canada,org,,PROPN,PROPN,compound,compound,NNP,NNP,8,1
1475,682.0,29,is,13,2,12,10,1,16,11,-1,36th Infantry Division,Texas,per-per-per,,ADJ-PROPN-PROPN,PROPN,nummod-compound-nsubj,compound,JJ-NNP-NNP,NNP,4,1
1476,683.0,50,release,2,20,27,7,19,22,-18,25,College of DuPage,Glen Ellyn,per-per-per,-,PROPN-ADP-PROPN,PROPN-PROPN,nmod-prep-pobj,compound-compound,NNP-IN-NNP,NNP-NNP,6,1
1477,684.0,22,expressed,5,1,13,12,0,8,4,8,British,John Major,org,-,PROPN,PROPN-PROPN,amod,compound-poss,NNP,NNP-NNP,7,1
1478,685.0,50,preparing,15,13,14,1,12,35,2,-1,England,Hackenschmidt,org,,PROPN,PROPN,compound,pobj,NNP,NNP,7,1
1479,686.0,26,was,1,1,10,9,0,15,0,9,Svinhufvud,Finland,org,,PROPN,PROPN,nsubj,pobj,NNP,NNP,1,1
1480,687.0,28,is,11,17,1,-16,16,26,-6,-10,singer,Jeffrey Steele,,per-per,NOUN,PROPN-PROPN,attr,compound-appos,NN,NNP-NNP,3,1
1481,688.0,36,said,5,1,4,3,0,31,4,-1,Ecuador,Rafael Correa,,per-per,PROPN,PROPN-PROPN,poss,compound-appos,NNP,NNP-NNP,3,1
1482,1217.0,31,said,28,9,19,10,8,11,19,-9,Ecuador,Rafael Correa,org,-,PROPN,PROPN-PROPN,pobj,compound-pobj,NNP,NNP-NNP,5,1
1483,1701.0,29,said,27,12,21,9,11,7,15,-6,Ecuador,Rafael Correa,,per-per,PROPN,PROPN-PROPN,poss,compound-dobj,NNP,NNP-NNP,6,1
1484,2315.0,23,given,4,1,3,2,0,19,3,-1,Ecuador,Rafael Correa,org,-,PROPN,PROPN-PROPN,compound,compound-nsubj,NNP,NNP-NNP,1,1
1485,3425.0,25,backtracking,4,1,20,19,0,4,3,16,Ecuador,Rafael Correa,org,-,PROPN,PROPN-PROPN,poss,compound-pobj,NNP,NNP-NNP,11,1
1486,3556.0,58,sworn,15,49,51,2,48,6,-34,36,Ecuador,Rafael Correa,per,-,PROPN,PROPN-PROPN,poss,compound-conj,NNP,NNP-NNP,1,1
1487,3601.0,21,stated,7,1,5,4,0,15,6,-2,Ecuador,Rafael Correa,,per-per,PROPN,PROPN-PROPN,poss,compound-appos,NNP,NNP-NNP,3,1
1488,5696.0,26,said,24,1,4,3,0,21,23,-20,Ecuador,Rafael Correa,per,-,PROPN,PROPN-PROPN,poss,compound-appos,NNP,NNP-NNP,3,1
1489,6133.0,47,visited,30,7,20,13,6,26,23,-10,Ecuador,Rafael Correa,,per-per,PROPN,PROPN-PROPN,conj,compound-pobj,NNP,NNP-NNP,4,1
1490,9130.0,10,File,6,3,4,1,2,5,3,-2,Ecuador,Rafael Correa,,org-org,PROPN,PROPN-PROPN,compound,compound-compound,NNP,NNP-NNP,1,1
1491,9300.0,45,interviewed,1,42,43,1,41,1,-41,42,Ecuador,Rafael Correa,per,-,PROPN,PROPN-PROPN,compound,compound-pobj,NNP,NNP-NNP,1,1
1492,10318.0,34,expelled,2,5,24,19,4,9,-3,22,Ecuador,Rafael Correa,per,-,PROPN,PROPN-PROPN,pobj,compound-nsubj,NNP,NNP-NNP,5,1
1493,10829.0,19,is,2,9,17,8,8,1,-7,15,Ecuador,Rafael Correa,per,-,PROPN,PROPN-PROPN,pobj,compound-pobj,NNP,NNP-NNP,4,1
1494,11016.0,29,said,4,1,23,22,0,5,3,19,Ecuador,Rafael Correa,per,-,PROPN,PROPN-PROPN,poss,compound-pobj,NNP,NNP-NNP,10,1
1495,11225.0,14,denounced,6,2,5,3,1,8,4,-1,Ecuador,Rafael Correa,per,-,PROPN,PROPN-PROPN,poss,compound-appos,NNP,NNP-NNP,3,1
1496,11444.0,16,show,2,7,14,7,6,1,-5,12,Ecuador,Rafael Correa,,per-per,PROPN,PROPN-PROPN,compound,compound-pobj,NNP,NNP-NNP,5,1
1497,12157.0,28,feels,1,4,26,22,3,1,-3,25,Ecuador,Rafael Correa,,per-per,PROPN,PROPN-PROPN,nsubj,compound-pobj,NNP,NNP-NNP,8,1
1498,13227.0,23,says,0,2,12,10,1,10,-2,12,Ecuador,Rafael Correa,org,-,PROPN,PROPN-PROPN,nsubj,compound-nsubj,NNP,NNP-NNP,3,1
1499,13383.0,14,pay,0,5,6,1,4,7,-5,6,Ecuador,Rafael Correa,org,-,PROPN,PROPN-PROPN,compound,compound-ROOT,NNP,NNP-NNP,1,1
1500,13476.0,23,breaking,5,19,21,2,18,1,-14,16,Ecuador,Rafael Correa,org,-,PROPN,PROPN-PROPN,poss,compound-appos,NNP,NNP-NNP,2,1
1501,689.0,19,began,1,8,11,3,7,7,-7,10,Lancing College,1848,per-per,,PROPN-PROPN,NUM,compound-pobj,pobj,NNP-NNP,CD,5,1
1502,993.0,45,owns,2,26,33,7,25,11,-24,31,Lancing College,1848,-,per,PROPN-PROPN,NUM,compound-attr,pobj,NNP-NNP,CD,3,1
1503,690.0,32,is,11,1,10,9,0,21,10,-1,Darren,England,,per,PROPN,PROPN,compound,pobj,NNP,NNP,4,1
1504,691.0,29,WASHINGTON,0,3,27,24,2,1,-3,27,National Football League,NFL Network,--,per-per,PROPN-PROPN-PROPN,PROPN-PROPN,compound-compound-compound,compound-dobj,NNP-NNP-NNP,NNP-NNP,12,1
1505,692.0,17,established,2,9,16,7,8,0,-7,14,Thomas More College of Liberal Arts,Merrimack,org-org-org-org-org-org,,PROPN-ADJ-PROPN-ADP-PROPN-PROPN,PROPN,compound-compound-conj-prep-compound-pobj,pobj,NNP-JJR-NNP-IN-NNP-NNP,NNP,4,1
1506,693.0,36,Texas,1,2,6,4,1,29,-1,5,Texas,Kay Bailey Hutchison,per,--,PROPN,PROPN-PROPN-PROPN,ROOT,compound-compound-nsubj,NNP,NNP-NNP-NNP,4,1
1507,694.0,22,is,4,1,12,11,0,9,3,8,Australian Ethical Investment,1986,org-org-org,,PROPN-PROPN-PROPN,NUM,compound-compound-compound,pobj,NNP-NNP-NNP,CD,5,1
1508,695.0,32,Associated,0,20,31,11,19,0,-20,31,George Martin,EMI,org-org,,PROPN-PROPN,PROPN,compound-pobj,pobj,NNP-NNP,NNP,3,1
1509,5320.0,17,joined,2,1,4,3,0,12,1,2,George Martin,EMI,-,per,PROPN-PROPN,PROPN,compound-nsubj,dobj,NNP-NNP,NNP,2,1
1510,696.0,30,served,5,13,20,7,12,9,-8,15,Mexico,Francisco I. Madero,,per-per-per,PROPN,PROPN-PROPN-PROPN,pobj,compound-compound-appos,NNP,NNP-NNP-NNP,4,1
1511,4856.0,15,born,11,7,8,1,6,6,4,-3,Mexico,Francisco I. Madero,org,--,PROPN,PROPN-PROPN-PROPN,compound,compound-compound-pobj,NNP,NNP-NNP-NNP,2,1
1512,698.0,28,is,12,1,7,6,0,20,11,-5,Boston College,Chestnut Hill,per-per,-,PROPN-PROPN,PROPN-PROPN,compound-poss,compound-compound,NNP-NNP,NNP-NNP,4,1
1513,699.0,27,denied,6,4,20,16,3,6,2,14,Alexander Downer,Australia,-,per,PROPN-PROPN,PROPN,compound-nsubj,compound,NNP-NNP,NNP,8,1
1514,7290.0,20,said,6,4,9,5,3,10,2,3,Alexander Downer,Australia,per-per,,PROPN-PROPN,PROPN,compound-nsubj,nsubj,NNP-NNP,NNP,3,1
1515,12751.0,15,criticized,1,6,14,8,5,0,-5,13,Alexander Downer,Australia,-,org,PROPN-PROPN,PROPN,compound-dobj,pobj,NNP-NNP,NNP,2,1
1516,14103.0,28,said,6,4,8,4,3,19,2,2,Alexander Downer,Australia,org-org,,PROPN-PROPN,PROPN,compound-nsubj,nsubj,NNP-NNP,NNP,3,1
1517,700.0,28,was,1,18,26,8,17,1,-17,25,Liberal Party of Canada,Alexander Mackenzie,org-org-org-org,-,PROPN-PROPN-ADP-PROPN,PROPN-PROPN,compound-nmod-prep-pobj,compound-pobj,NNP-NNP-IN-NNP,NNP-NNP,6,1
1518,701.0,16,included,3,12,14,2,11,1,-9,11,Winnipeg,Chantal Kreviazuk,org,-,PROPN,PROPN-PROPN,poss,compound-conj,NNP,NNP-NNP,2,1
1519,702.0,33,held,2,19,17,-2,18,15,-17,15,Forestry,Ministry of Agriculture and Forestry,per,----,PROPN,PROPN-ADP-PROPN-CCONJ-PROPN,pobj,appos-prep-pobj-cc-conj,NNP,NNP-IN-NNP-CC-NNP,3,1
1520,703.0,19,said,6,2,6,4,1,12,4,0,John Ensign,Nevada,-,per,PROPN-PROPN,PROPN,compound-nsubj,dobj,NNP-NNP,NNP,1,1
1521,8702.0,30,considered,15,4,7,3,3,22,11,-8,John Ensign,Nevada,org-org,,PROPN-PROPN,PROPN,compound-nsubj,pobj,NNP-NNP,NNP,2,1
1522,9564.0,25,remain,21,2,5,3,1,19,19,-16,John Ensign,Nevada,-,per,PROPN-PROPN,PROPN,compound-nsubj,pobj,NNP-NNP,NNP,2,1
1523,10680.0,34,chided,13,2,5,3,1,28,11,-8,John Ensign,Nevada,org-org,,PROPN-PROPN,PROPN,compound-nsubj,pobj,NNP-NNP,NNP,2,1
1524,13668.0,19,Republicans,1,6,9,3,5,9,-5,8,John Ensign,Nevada,-,org,PROPN-PROPN,PROPN,compound-appos,compound,NNP-NNP,NNP,3,1
1525,704.0,28,said,19,1,5,4,0,22,18,-14,Punjab,Amarinder Singh,,per-per,PROPN,PROPN-PROPN,compound,compound-nsubj,NNP,NNP-NNP,3,1
1526,1797.0,49,attended,3,10,12,2,9,36,-7,9,Punjab,Amarinder Singh,per,-,PROPN,PROPN-PROPN,compound,compound-pobj,NNP,NNP-NNP,-1,1
1527,2174.0,13,is,1,9,11,2,8,1,-8,10,Punjab,Amarinder Singh,,org-org,PROPN,PROPN-PROPN,compound,compound-pobj,NNP,NNP-NNP,1,1
1528,2206.0,28,said,5,1,4,3,0,23,4,-1,Punjab,Amarinder Singh,per,-,PROPN,PROPN-PROPN,compound,compound-nsubj,NNP,NNP-NNP,4,1
1529,2316.0,22,favored,4,19,20,1,18,1,-15,16,Punjab,Amarinder Singh,per,-,PROPN,PROPN-PROPN,compound,compound-pobj,NNP,NNP-NNP,1,1
1530,2961.0,18,know,2,12,16,4,11,1,-10,14,Punjab,Amarinder Singh,org,-,PROPN,PROPN-PROPN,compound,compound-pobj,NNP,NNP-NNP,2,1
1531,6765.0,30,said,18,1,4,3,0,25,17,-14,Punjab,Amarinder Singh,,org-org,PROPN,PROPN-PROPN,compound,compound-nsubj,NNP,NNP-NNP,-1,1
1532,10087.0,48,Singh,2,14,20,6,13,27,-12,18,Punjab,Amarinder Singh,,per-per,PROPN,PROPN-PROPN,compound,compound-pobj,NNP,NNP-NNP,3,1
1533,10743.0,11,stepped,5,1,4,3,0,6,4,-1,Punjab,Amarinder Singh,org,-,PROPN,PROPN-PROPN,compound,compound-nsubj,NNP,NNP-NNP,2,1
1534,10800.0,9,is,5,1,4,3,0,4,4,-1,Punjab,Amarinder Singh,per,-,PROPN,PROPN-PROPN,compound,compound-nsubj,NNP,NNP-NNP,-1,1
1535,13310.0,35,Considered,0,29,33,4,28,1,-29,33,Punjab,Amarinder Singh,org,-,PROPN,PROPN-PROPN,compound,compound-pobj,NNP,NNP-NNP,4,1
1536,14195.0,8,resigned,6,1,4,3,0,3,5,-2,Punjab,Amarinder Singh,org,-,PROPN,PROPN-PROPN,compound,compound-nsubj,NNP,NNP-NNP,4,1
1537,705.0,75,had,10,22,30,8,21,44,-12,20,Panathinaikos,A1 Ethniki,,org-org,PROPN,PROPN-PROPN,compound,compound-compound,NNPS,NNP-NNP,4,1
1538,706.0,22,renamed,3,7,11,4,6,10,-4,8,Thomas Hart Benton,Missouri,per-per-per,,PROPN-PROPN-PROPN,PROPN,compound-compound-pobj,pobj,NNP-NNP-NNP,NNP,4,1
1539,2537.0,19,located,11,2,18,16,1,0,9,7,Thomas Hart Benton,Missouri,--,org,PROPN-PROPN-PROPN,PROPN,compound-nmod-compound,pobj,NNP-NNP-NNP,NNP,4,1
1540,5076.0,30,Known,0,16,29,13,15,0,-16,29,Thomas Hart Benton,Missouri,org-org-org,,PROPN-PROPN-PROPN,PROPN,compound-compound-appos,pobj,NNP-NNP-NNP,NNP,5,1
1541,7551.0,16,was,1,9,15,6,8,0,-8,14,Thomas Hart Benton,Missouri,--,per,PROPN-PROPN-PROPN,PROPN,compound-compound-pobj,pobj,NNP-NNP-NNP,NNP,5,1
1542,707.0,41,met,1,34,39,5,33,1,-33,38,Khan,England,,per,PROPN,PROPN,poss,pobj,NNP,NNP,5,1
1543,1164.0,20,won,1,1,13,12,0,6,0,12,Khan,England,,per,PROPN,PROPN,nsubj,pobj,NNP,NNP,3,1
1544,2507.0,25,dominated,2,9,21,12,8,3,-7,19,Khan,England,per,,PROPN,PROPN,dobj,nmod,NNP,NNP,4,1
1545,3827.0,33,stopped,7,1,6,5,0,26,6,-1,Khan,England,per,,PROPN,PROPN,nsubj,pobj,NNP,NNP,4,1
1546,6435.0,39,leaves,4,1,10,9,0,28,3,6,Khan,England,,per,PROPN,PROPN,nsubj,pobj,NNP,NNP,4,1
1547,708.0,27,was,4,17,20,3,16,6,-13,16,Germany,Ludwig Erhard,,org-org,PROPN,PROPN-PROPN,pobj,compound-pobj,NNP,NNP-NNP,2,1
1548,709.0,22,renamed,16,2,19,17,1,2,14,3,December 31 1990,Norfolk Southern Railway,per-per-per,--,PROPN-NUM-NUM,PROPN-PROPN-PROPN,pobj-nummod-nummod,compound-compound-oprd,NNP-CD-CD,NNP-NNP-NNP,5,1
1549,710.0,21,represented,7,3,15,12,2,5,4,8,Georgia State University,NCAA,per-per-per,,PROPN-PROPN-PROPN,PROPN,compound-compound-dobj,compound,NNP-NNP-NNP,NNP,5,1
1550,711.0,14,was,1,1,9,8,0,4,0,8,NuFX,Hoffman Estates,,per-per,PROPN,PROPN-PROPN,nsubj,compound-compound,NNP,NNP-NNP,5,1
1551,712.0,24,allow,7,10,18,8,9,5,-3,11,Chrysler,Dodge,,org,PROPN,PROPN,compound,compound,NNP,NNP,4,1
1552,7560.0,37,were,11,1,10,9,0,26,10,-1,Chrysler,Dodge,per,,PROPN,PROPN,compound,conj,NNP,NNP,5,1
1553,713.0,35,influenced,10,23,33,10,22,1,-13,23,Doshisha University,Connecticut College,-,org-org,PROPN-PROPN,PROPN-PROPN,compound-pobj,compound-pobj,NNP-NNP,NNP-NNP,6,1
1554,714.0,24,headquartered,6,12,16,4,11,7,-6,10,Headquarters,its,org,,PROPN,DET,pobj,poss,NNPS,PRP$,5,1
1555,715.0,23,is,3,18,21,3,17,1,-15,18,Ken Peplowski,Arbors Records,org-org,-,PROPN-PROPN,PROPN-PROPN,compound-conj,compound-pobj,NNP-NNP,NNP-NNPS,2,1
1556,716.0,41,wore,35,6,17,11,5,23,29,-18,Madonna,Guy Ritchie,,org-org,PROPN,PROPN-PROPN,pobj,compound-nsubj,NNP,NNP-NNP,7,1
1557,717.0,30,is,20,8,14,6,7,15,12,-6,Dana International,Yaron Cohen,-,org-org,PROPN-PROPN,PROPN-PROPN,compound-pobj,compound-dobj,NNP-NNP,NNP-NNP,5,1
1558,718.0,26,graduated,1,5,11,6,4,14,-4,10,United States Coast Guard Academy,New London,per-per-per-per-per,-,PROPN-PROPN-PROPN-PROPN-PROPN,PROPN-PROPN,compound-compound-compound-compound-pobj,compound-compound,NNP-NNP-NNP-NNP-NNP,NNP-NNP,5,1
1559,9360.0,29,entered,9,20,26,6,19,2,-11,17,United States Coast Guard Academy,New London,org-org-org-org-org,-,PROPN-PROPN-PROPN-PROPN-PROPN,PROPN-PROPN,compound-compound-compound-compound-pobj,compound-compound,NNP-NNP-NNP-NNP-NNP,NNP-NNP,5,1
1560,719.0,27,intended,2,15,19,4,14,7,-13,17,Drawn and Quarterly,Chris Oliveros,--,per-per,PROPN-CCONJ-PROPN,PROPN-PROPN,pobj-cc-compound,compound-nsubj,NNP-CC-NNP,NNP-NNP,3,1
1561,722.0,21,was,1,12,17,5,11,3,-11,16,Glen Ellyn,Glenbard West High School,org-org,---,PROPN-PROPN,PROPN-PROPN-PROPN-PROPN,compound-compound,compound-compound-compound-pobj,NNP-NNP,NNP-NNP-NNP-NNP,7,1
1562,3594.0,18,grew,1,5,14,9,4,3,-4,13,Glen Ellyn,Glenbard West High School,per-per,---,PROPN-PROPN,PROPN-PROPN-PROPN-PROPN,compound-compound,compound-compound-compound-pobj,NNP-NNP,NNP-NNP-NNP-NNP,7,1
1563,723.0,41,wrote,13,2,5,3,1,35,11,-8,Conservancy Association,Hong Kong,-,per-per,PROPN-PROPN,PROPN-PROPN,compound-nsubj,compound-nmod,NNP-NNP,NNP-NNP,2,1
1564,724.0,34,praised,1,22,32,10,21,1,-21,31,Abraham Lincoln,United States,per-per,-,PROPN-PROPN,PROPN-PROPN,compound-poss,compound-pobj,NNP-NNP,NNP-NNP,5,1
1565,3721.0,25,read,7,14,23,9,13,1,-7,16,Abraham Lincoln,United States,per-per,-,PROPN-PROPN,PROPN-PROPN,compound-pobj,compound-pobj,NNP-NNP,NNP-NNP,7,1
1566,5670.0,64,seem,34,9,19,10,8,44,25,-15,Abraham Lincoln,United States,-,per-per,PROPN-PROPN,PROPN-PROPN,compound-appos,compound-pobj,NNP-NNP,NNP-NNP,7,1
1567,5855.0,33,end,13,10,28,18,9,4,3,15,Abraham Lincoln,United States,per-per,-,PROPN-PROPN,PROPN-PROPN,compound-poss,compound-pobj,NNP-NNP,NNP-NNP,9,1
1568,725.0,31,spent,5,19,9,-10,18,21,-14,4,Bel Air,their,-,org,PROPN-PROPN,DET,compound-compound,poss,NNP-NNP,PRP$,10,1
1569,726.0,22,represented,6,3,12,9,2,9,3,6,Montana Grizzlies,Missoula,org-org,,PROPN-PROPN,PROPN,compound-compound,dobj,NNP-NNP,NNP,3,1
1570,727.0,18,was,6,4,17,13,3,0,2,11,National Basketball League,1979,per-per-per,,PROPN-PROPN-PROPN,NUM,compound-compound-nsubj,pobj,NNP-NNP-NNP,CD,6,1
1571,728.0,27,decided,1,1,8,7,0,18,0,7,Tom,New York,,per-per,PROPN,PROPN-PROPN,nsubj,compound-compound,NNP,NNP-NNP,5,1
1572,729.0,37,began,2,1,7,6,0,29,1,5,He,India,org,,PRON,PROPN,nsubj,pobj,PRP,NNP,3,1
1573,7513.0,30,began,1,1,8,7,0,21,0,7,He,India,per,,PRON,PROPN,nsubj,pobj,PRP,NNP,2,1
1574,730.0,28,was,11,7,16,9,6,11,4,5,Roman Republic,Lucius Cornelius Sulla,org-org,--,PROPN-PROPN,PROPN-PROPN-PROPN,compound-pobj,compound-compound-nsubj,NNP-NNP,NNP-NNP-NNP,5,1
1575,7775.0,29,were,2,14,20,6,13,8,-12,18,Roman Republic,Lucius Cornelius Sulla,-,org-org-org,PROPN-PROPN,PROPN-PROPN-PROPN,compound-compound,compound-compound-pobj,NNP-NNP,NNP-NNP-NNP,6,1
1576,731.0,12,worked,2,5,8,3,4,3,-3,6,Purchase,PepsiCo,per,,PROPN,PROPN,compound,pobj,NNP,NNP,2,1
1577,732.0,24,persuaded,4,4,6,2,3,17,0,2,EMI,Bush,per,,PROPN,PROPN,nsubj,dobj,NNP,NNP,2,1
1578,733.0,57,denounced,3,34,43,9,33,13,-31,40,e Republika Srpsk,; Radovan Karad?,--,per-per-per,PROPN-PROPN-PROPN,PUNCT-PROPN-VERB,compound-compound-pobj,punct-compound-nsubj,NNP-NNP-NNP,:-NNP-VBZ,7,1
1579,734.0,25,starts,1,4,23,19,3,1,-3,22,Henry Vaccaro,Kramer Guitars,-,org-org,PROPN-PROPN,PROPN-PROPN,compound-pobj,compound-oprd,NNP-NNP,NNP-NNP,8,1
1580,735.0,18,started,4,1,3,2,0,14,3,-1,Vancouver,Bryan Adams,,per-per,PROPN,PROPN-PROPN,compound,compound-nsubj,NNP,NNP-NNP,2,1
1581,736.0,39,known,3,11,22,11,10,16,-8,19,musician,John Mellencamp,,per-per,NOUN,PROPN-PROPN,pobj,compound-compound,NN,NNP-NNP,8,1
1582,737.0,83,GMANews.TV,0,20,26,6,19,56,-20,26,Philippines,Mindanao State University,,org-org-org,PROPN,PROPN-PROPN-PROPN,compound,nmod-nmod-nmod,NNP,NNP-NNP-NNP,6,1
1583,738.0,32,is,1,26,30,4,25,1,-25,29,Dallas Wind Symphony,USA,--,per,PROPN-PROPN-PROPN,PROPN,compound-compound-pobj,appos,NNP-NNP-NNP,NNP,2,1
1584,739.0,21,helped,4,13,20,7,12,0,-9,16,George H. Pendleton,Ohio,--,per,PROPN-PROPN-PROPN,PROPN,compound-compound-pobj,pobj,NNP-NNP-NNP,NNP,6,1
1585,1961.0,22,sponsored,12,17,21,4,16,0,-5,9,George H. Pendleton,Ohio,per-per-per,,PROPN-PROPN-PROPN,PROPN,compound-compound-pobj,pobj,NNP-NNP-NNP,NNP,4,1
1586,3463.0,27,Pendleton,2,1,7,6,0,19,1,5,George H. Pendleton,Ohio,per-per-per,,PROPN-PROPN-PROPN,PROPN,compound-compound-ROOT,pobj,NNP-NNP-NNP,NNP,2,1
1587,741.0,27,said,5,7,12,5,6,14,-2,7,Trip Hawkins,Electronic Arts,per-per,-,NOUN-VERB,PROPN-PROPN,compound-dative,compound-pobj,NN-VBZ,NNP-NNPS,3,1
1588,742.0,26,testing,16,4,9,5,3,16,12,-7,Masten Space Systems,California,per-per-per,,PROPN-PROPN-PROPN,PROPN,compound-compound-pobj,pobj,NNP-NNP-NNPS,NNP,4,1
1589,743.0,41,listed,6,2,15,13,1,25,4,9,Florida Fish and Wildlife Conservation Commission,Fish,-----,per,PROPN-PROPN-CCONJ-PROPN-PROPN-PROPN,PROPN,nmod-pobj-cc-compound-compound-conj,nmod,NNP-NNP-CC-NNP-NNP-NNP,NNP,7,1
1590,744.0,38,failed,4,13,24,11,12,13,-9,20,Reagan,California,,org,PROPN,PROPN,nsubj,pobj,NNP,NNP,3,1
1591,745.0,33,was,5,22,28,6,21,4,-17,23,Ghibli,Isao Takahata,org,-,PROPN,PROPN-PROPN,poss,compound-conj,NNP,NNP-NNP,5,1
1592,746.0,32,moved,17,14,25,11,13,6,3,8,College campus,Kuala Lumpur,-,org-org,PROPN-NOUN,PROPN-PROPN,compound-compound,compound-pobj,NNP-NN,NNP-NNP,11,1
1593,748.0,16,said,4,1,3,2,0,12,3,-1,RSL,Jason Kreis,org,-,PROPN,PROPN-PROPN,compound,compound-nsubj,NNP,NNP-NNP,1,1
1594,749.0,9,grew,2,1,7,6,0,1,1,5,John Thune,South Dakota,per-per,-,PROPN-PROPN,PROPN-PROPN,compound-nsubj,compound-pobj,NNP-NNP,NNP-NNP,3,1
1595,1385.0,52,think,1,47,50,3,46,1,-46,49,John Thune,South Dakota,per-per,-,PROPN-PROPN,PROPN-PROPN,compound-nsubj,compound-pobj,NNP-NNP,NNP-NNP,2,1
1596,750.0,66,University,4,23,9,-14,22,56,-19,5,Iran University of Science and Technology,Tehran,per-per-per-per-per-per,,PROPN-PROPN-ADP-PROPN-CCONJ-PROPN,PROPN,compound-ROOT-prep-pobj-cc-conj,compound,NNP-NNP-IN-NNP-CC-NNP,NNP,-1,1
1597,751.0,52,include,4,14,23,9,13,28,-10,19,Elon Musk,SpaceX,org-org,,PROPN-PROPN,PROPN,compound-ROOT,conj,NNP-NNP,NNPS,-1,1
1598,752.0,16,named,5,10,10,0,9,5,-5,5,Newberry College,Newberry,per-per,,PROPN-PROPN,PROPN,compound-pobj,compound,NNP-NNP,NNP,0,1
1599,753.0,28,dissolved,3,2,9,7,1,18,1,6,Masaharu Homma,Philippines,org-org,,PROPN-PROPN,PROPN,compound-nsubj,pobj,NNP-NNP,NNPS,2,1
1600,754.0,60,hinted,7,3,6,3,2,53,4,-1,drummer,Joel Quartermain,,org-org,NOUN,PROPN-PROPN,nmod,compound-nsubj,NN,NNP-NNP,2,1
1601,755.0,18,represented,6,3,9,6,2,8,3,3,Tampa,University of Tampa,org,--,PROPN,PROPN-ADP-PROPN,compound,dobj-prep-pobj,NNP,NNP-IN-NNP,4,1
1602,14149.0,18,represented,6,3,9,6,2,8,3,3,Tampa,University of Tampa,,per-per-per,PROPN,PROPN-ADP-PROPN,compound,dobj-prep-pobj,NNP,NNP-IN-NNP,4,1
1603,757.0,17,is,6,2,2,0,1,14,4,-4,Gastonia Transit,Gastonia,-,per,PROPN-PROPN,PROPN,compound-compound,compound,NNP-NNP,NNP,0,1
1604,758.0,22,was,1,14,19,5,13,2,-13,18,Kereyid,Wang Khan,,org-org,PROPN,PROPN-PROPN,compound,compound-appos,NNP,NNP-NNP,-1,1
1605,759.0,22,started,2,8,13,5,7,8,-6,11,Jacques Parizeau,Quebec,-,per,PROPN-PROPN,PROPN,compound-pobj,compound,NNP-NNP,NNP,2,1
1606,760.0,17,included,6,14,16,2,13,0,-8,10,Venezuela,Hugo,org,,PROPN,PROPN,poss,conj,NNP,NNP,5,1
1607,870.0,7,addressing,2,4,6,2,3,0,-2,4,Venezuela,Hugo,per,,PROPN,PROPN,compound,dobj,NNP,NNP,3,1
1608,2052.0,34,grew,13,8,9,1,7,24,5,-4,Venezuela,Hugo,org,,PROPN,PROPN,compound,pobj,NNP,NNP,2,1
1609,2077.0,43,In,0,14,37,23,13,5,-14,37,Venezuela,Hugo,,org,PROPN,PROPN,pobj,poss,NNP,NNP,-1,1
1610,2399.0,27,embarrassed,18,23,26,3,22,0,-5,8,Venezuela,Hugo,,per,PROPN,PROPN,poss,conj,NNP,NNP,3,1
1611,3435.0,29,desecrated,9,1,21,20,0,7,8,12,Venezuela,Hugo,per,,PROPN,PROPN,nsubj,dobj,NNP,NNP,-1,1
1612,7464.0,30,been,6,1,4,3,0,25,5,-2,Venezuela,Hugo,,per,PROPN,PROPN,poss,appos,NNP,NNP,4,1
1613,8491.0,28,described,16,4,10,6,3,17,12,-6,Venezuela,Hugo,,per,PROPN,PROPN,pobj,pobj,NNP,NNP,6,1
1614,8639.0,32,warned,5,1,4,3,0,27,4,-1,Venezuela,Hugo,org,,PROPN,PROPN,poss,appos,NNP,NNP,4,1
1615,9175.0,34,wrote,19,1,5,4,0,28,18,-14,Venezuela,Hugo,org,,PROPN,PROPN,poss,appos,NNP,NNP,4,1
1616,9294.0,24,had,3,9,13,4,8,10,-6,10,Venezuela,Hugo,org,,PROPN,PROPN,poss,appos,NNP,NNP,2,1
1617,10933.0,14,improved,7,5,13,8,4,0,2,6,Venezuela,Hugo,per,,PROPN,PROPN,conj,pobj,NNP,NNP,2,1
1618,13567.0,49,Venezuela,1,2,7,5,1,41,-1,6,Venezuela,Hugo,,per,PROPN,PROPN,ROOT,nsubj,NNP,NNP,-1,1
1619,13570.0,23,is,8,5,22,17,4,0,3,14,Venezuela,Hugo,,org,PROPN,PROPN,nsubj,pobj,NNP,NNP,5,1
1620,761.0,17,is,8,1,1,0,0,15,7,-7,Maastricht University,Maastricht,-,per,PROPN-PROPN,PROPN,compound-nsubj,pobj,NNP-NNP,NNP,0,1
1621,762.0,27,started,5,2,7,5,1,19,3,2,Flea,Red Hot Chili Peppers,per,---,PROPN,PROPN-PROPN-PROPN-PROPN,compound,compound-compound-compound-dobj,NNP,NNP-NNP-NNP-NNPS,4,1
1622,13755.0,26,was,6,8,13,5,7,12,-2,7,Flea,Red Hot Chili Peppers,,per-per-per-per,PROPN,PROPN-PROPN-PROPN-PROPN,attr,compound-compound-compound-pobj,NNP,NNP-NNP-NNP-NNPS,5,1
1623,763.0,30,founded,3,7,17,10,6,12,-4,14,Beatles,Ringo Starr,,per-per,PROPN,PROPN-PROPN,pobj,compound-pobj,NNPS,NNP-NNP,4,1
1624,764.0,18,included,4,7,14,7,6,3,-3,10,HolyHell,Magic Circle Music,org,--,PROPN,PROPN-PROPN-PROPN,poss,compound-compound-appos,NNP,NNP-NNP-NNP,7,1
1625,765.0,24,joined,5,4,4,0,3,19,1,-1,Oklahoma,Oklahoma City Police Department,per,---,PROPN,PROPN-PROPN-PROPN-PROPN,compound,compound-compound-compound-dobj,NNP,NNP-NNP-NNP-NNP,0,1
1626,766.0,32,said,30,2,28,26,1,3,28,-2,Ministry of National Defense,Minister,---,per,PROPN-ADP-PROPN-PROPN,PROPN,nsubj-prep-compound-pobj,compound,NNP-IN-NNP-NNP,NNP,5,1
1627,767.0,41,began,27,32,39,7,31,1,-5,12,Stockwell Day,Canadian Alliance,per-per,-,PROPN-PROPN,PROPN-PROPN,compound-poss,compound-pobj,NNP-NNP,NNP-NNP,3,1
1628,1881.0,20,expected,3,1,12,11,0,7,2,9,Stockwell Day,Canadian Alliance,per-per,-,PROPN-PROPN,PROPN-PROPN,compound-nsubjpass,compound-pobj,NNP-NNP,NNP-NNP,6,1
1629,2482.0,24,lost,6,13,21,8,12,2,-7,15,Stockwell Day,Canadian Alliance,-,per-per,PROPN-PROPN,PROPN-PROPN,compound-pobj,compound-compound,NNP-NNP,NNP-NNP,7,1
1630,8175.0,9,elected,3,1,7,6,0,1,2,4,Stockwell Day,Canadian Alliance,org-org,-,PROPN-PROPN,PROPN-PROPN,compound-nsubjpass,compound-pobj,NNP-NNP,NNP-NNP,3,1
1631,10100.0,78,gone,6,44,68,24,43,9,-38,62,Stockwell Day,Canadian Alliance,per-per,-,PROPN-PROPN,PROPN-PROPN,compound-poss,compound-compound,NNP-NNP,NNP-NNP,9,1
1632,10994.0,30,replaced,6,4,12,8,3,17,2,6,Stockwell Day,Canadian Alliance,per-per,-,PROPN-PROPN,PROPN-PROPN,compound-nsubjpass,compound-pobj,NNP-NNP,NNP-NNP,5,1
1633,12467.0,29,members,1,14,27,13,13,1,-13,26,Stockwell Day,Canadian Alliance,org-org,-,PROPN-PROPN,PROPN-PROPN,compound-pobj,amod-pobj,NNP-NNP,NNP-NNP,11,1
1634,768.0,26,excelled,1,16,21,5,15,4,-15,20,Netherlands,Rembrandt,,org,PROPN,PROPN,pobj,nsubj,NNP,NNP,8,1
1635,9322.0,17,see,11,6,10,4,5,6,5,-1,Netherlands,Rembrandt,,per,PROPN,PROPN,pobj,pobj,NNP,NNP,2,1
1636,769.0,29,was,6,5,27,22,4,1,1,21,Australian,Ashley Mallett,org,-,ADJ,PROPN-PROPN,amod,compound-pobj,JJ,NNP-NNP,8,1
1637,770.0,31,marked,2,11,24,13,10,6,-9,22,Manuel Roxas,Philippines,org-org,,PROPN-PROPN,PROPN,compound-pobj,nsubj,NNP-NNP,NNP,6,1
1638,771.0,22,graduated,1,1,7,6,0,14,0,6,Zane,New York,,per-per,PROPN,PROPN-PROPN,nsubj,compound-pobj,NNP,NNP-NNP,4,1
1639,772.0,18,share,11,1,9,8,0,8,10,-2,Morehouse College,Atlanta,-,per,PROPN-PROPN,PROPN,compound-nsubj,compound,NNP-NNP,NNP,6,1
1640,774.0,16,graduated,3,8,15,7,7,0,-5,12,Chaminade College Preparatory School,California,per-per-per-per,,PROPN-PROPN-PROPN-PROPN,PROPN,compound-compound-compound-pobj,pobj,NNP-NNP-NNP-NNP,NNP,6,1
1641,775.0,32,won,6,9,20,11,8,11,-3,14,Toronto,Michael Ignatieff,,org-org,PROPN,PROPN-PROPN,compound,compound-pobj,NNP,NNP-NNP,4,1
1642,776.0,40,refers,8,22,38,16,21,1,-14,30,Khieu Samphan,Democratic Kampuchea,-,per-per,PROPN-PROPN,PROPN-PROPN,compound-pobj,compound-pobj,NNP-NNP,NNP-NNP,4,1
1643,7146.0,20,led,3,6,16,10,5,3,-3,13,Khieu Samphan,Democratic Kampuchea,per-per,-,PROPN-PROPN,PROPN-PROPN,compound-pobj,compound-pobj,NNP-NNP,NNP-NNP,6,1
1644,10629.0,26,was,8,1,17,16,0,8,7,9,Khieu Samphan,Democratic Kampuchea,-,per-per,PROPN-PROPN,ADJ-PROPN,compound-nsubj,compound-pobj,NNP-NNP,JJ-NNP,6,1
1645,11125.0,58,were,1,14,23,9,13,34,-13,22,Khieu Samphan,Democratic Kampuchea,per-per,-,PROPN-PROPN,ADJ-PROPN,nmod-nmod,compound-pobj,NNP-NNP,JJ-NNP,5,1
1646,12434.0,42,arrived,13,1,9,8,0,32,12,-4,Khieu Samphan,Democratic Kampuchea,-,per-per,PROPN-PROPN,ADJ-PROPN,compound-nsubj,compound-pobj,NNP-NNP,JJ-NNP,6,1
1647,777.0,38,said,9,1,9,8,0,28,8,0,Japan,KDDI,org,,PROPN,PROPN,poss,conj,NNP,NNP,3,1
1648,12210.0,34,reported,9,1,7,6,0,26,8,-2,Japan,KDDI,,per,PROPN,PROPN,poss,appos,NNP,NNP,3,1
1649,778.0,35,By,0,7,12,5,6,22,-7,12,Will.i.am,Black Eyed Peas,,per-per-per,PROPN,PROPN-PROPN-PROPN,advmod,compound-compound-pobj,NNP,NNP-NNP-NNPS,4,1
1650,9689.0,84,*,0,2,71,69,1,12,-2,71,Will.i.am,Black Eyed Peas,,per-per-per,NOUN,PROPN-PROPN-PROPN,nsubj,compound-compound-nsubj,NN,NNP-NNP-NNPS,-1,1
1651,779.0,57,Michaelides,1,30,52,22,29,4,-29,51,Mick Karn,Japan,per-per,,PROPN-PROPN,PROPN,compound-pobj,appos,NNP-NNP,NNP,6,1
1652,780.0,22,was,12,1,16,15,0,5,11,4,Shankar,hi wri,,org-org,PROPN,INTJ-VERB,compound,intj-compound,NNP,UH-VB,4,1
1653,781.0,24,was,1,18,23,5,17,0,-17,22,University of New Brunswick,Fredericton,per-per-per-per,,PROPN-ADP-PROPN-PROPN,PROPN,pobj-prep-compound-pobj,pobj,NNP-IN-NNP-NNP,NNP,4,1
1654,782.0,24,made,1,1,8,7,0,15,0,7,Dartmouth,NCAA,per,,PROPN,PROPN,nsubj,compound,NNP,NNP,3,1
1655,784.0,23,appointed,3,9,19,10,8,3,-6,16,Mali,Amadou Toumani,org,-,PROPN,PROPN-PROPN,poss,compound-pobj,NNP,NNP-NNP,4,1
1656,1684.0,39,In,0,13,14,1,12,24,-13,14,Mali,Amadou Toumani,org,-,PROPN,PROPN-PROPN,pobj,compound-nsubj,NNP,NNP-NNP,10,1
1657,2974.0,24,is,1,9,17,8,8,6,-8,16,Mali,Amadou Toumani,,per-per,PROPN,PROPN-PROPN,pobj,compound-poss,NNP,NNP-NNP,3,1
1658,785.0,26,MOSCOW,0,13,20,7,12,5,-13,20,Mikhail Fradkov,foreign intelligence service,-,org-org-org,PROPN-PROPN,ADJ-NOUN-NOUN,compound-dobj,amod-compound-pobj,NNP-NNP,JJ-NN-NN,8,1
1659,786.0,95,said,2,77,82,5,76,12,-75,80,Vector Group,Liggett Group,per-per,-,PROPN-PROPN,PROPN-PROPN,compound-compound,compound-compound,NNP-NNP,NNP-NNP,5,1
1660,787.0,22,said,10,6,9,3,5,12,4,-1,Divine,United States,,per-per,PROPN,PROPN-PROPN,pobj,compound-pobj,NNP,NNP-NNP,1,1
1661,7596.0,31,crowded,3,13,29,16,12,1,-10,26,Divine,United States,,org-org,PROPN,PROPN-PROPN,compound,compound-pobj,NNP,NNP-NNP,13,1
1662,788.0,14,served,2,1,9,8,0,4,1,7,Mr. Brewster,Maryland,-,org,PROPN-PROPN,PROPN,compound-nsubj,pobj,NNP-NNP,NNP,2,1
1663,789.0,43,said,16,18,30,12,17,12,-2,14,Zhu Yicai,Yurun Group,-,org-org,PROPN-PROPN,PROPN-PROPN,compound-nsubj,compound-pobj,NNP-NNP,NNP-NNP,6,1
1664,791.0,47,were,7,33,41,8,32,5,-26,34,Andrius Baltuska,Technical University of Vienna,per-per,---,PROPN-PROPN,PROPN-PROPN-ADP-PROPN,compound-nsubj,compound-pobj-prep-pobj,NNP-NNP,NNP-NNP-IN-NNP,3,1
1665,792.0,16,played,2,1,9,8,0,6,1,7,Dean Rioli,Essendon Football Club,-,org-org-org,PROPN-PROPN,PROPN-PROPN-PROPN,compound-nsubj,compound-compound-pobj,NNP-NNP,NNP-NNP-NNP,5,1
1666,793.0,35,formed,7,23,17,-6,22,17,-16,10,Royal Canadians,the Royal Canadian Regiment,-,per-per-per-per,PROPN-PROPN,DET-PROPN-PROPN-PROPN,compound-appos,det-compound-compound-pobj,NNP-NNPS,DT-NNP-NNP-NNP,3,1
1667,794.0,21,was,1,8,11,3,7,9,-7,10,Greece,Ioannis Metaxas,per,-,PROPN,PROPN-PROPN,poss,compound-appos,NNP,NNP-NNP,3,1
1668,2459.0,22,arrested,4,19,20,1,18,1,-15,16,Greece,Ioannis Metaxas,org,-,PROPN,PROPN-PROPN,compound,compound-pobj,NNP,NNP-NNP,1,1
1669,12358.0,49,was,19,7,18,11,6,30,12,-1,Greece,Ioannis Metaxas,org,-,PROPN,PROPN-PROPN,pobj,compound-pobj,NNP,NNP-NNP,9,1
1670,795.0,42,dispatched,2,8,12,4,7,29,-6,10,Togo,Gilbert Houngbo,per,-,PROPN,PROPN-PROPN,poss,compound-nsubj,NNP,NNP-NNP,3,1
1671,3856.0,34,said,6,1,5,4,0,28,5,-1,Togo,Gilbert Houngbo,,org-org,PROPN,PROPN-PROPN,poss,compound-nsubj,NNP,NNP-NNP,3,1
1672,9527.0,35,said,6,1,5,4,0,29,5,-1,Togo,Gilbert Houngbo,,org-org,PROPN,PROPN-PROPN,poss,compound-nsubj,NNP,NNP-NNP,3,1
1673,796.0,23,helped,10,4,22,18,3,0,6,12,Neudorf,Canada,,org,PROPN,PROPN,nsubj,pobj,NNP,NNP,6,1
1674,797.0,33,begins,1,9,27,18,8,5,-8,26,Giovanni Lajolo,Governorate,-,per,PROPN-PROPN,PROPN,compound-pobj,pobj,NNP-NNP,NNP,6,1
1675,798.0,17,is,7,1,1,0,0,15,6,-6,Patuakhali Science and Technology University,Patuakhali,----,per,PROPN-PROPN-CCONJ-PROPN-PROPN,PROPN,nmod-nmod-cc-conj-nsubj,compound,NNP-NNP-CC-NNP-NNP,NNP,0,1
1676,799.0,51,includes,6,18,12,-6,17,38,-12,6,David Gilmour,Pink Floyd,per-per,-,PROPN-PROPN,PROPN-PROPN,compound-compound,compound-compound,NNP-NNP,NNP-NNP,7,1
1677,801.0,20,refers,1,7,13,6,6,6,-6,12,Roberto Formigoni,Forza Italia,org-org,-,PROPN-PROPN,PROPN-PROPN,compound-pobj,compound-pobj,NNP-NNP,NNP-NNP,7,1
1678,802.0,36,reiterated,19,18,35,17,17,0,1,16,Gilles Duceppe,Quebec,per-per,,PROPN-PROPN,PROPN,compound-pobj,pobj,NNP-NNP,NNP,16,1
1679,1004.0,24,helped,2,1,10,9,0,13,1,8,Gilles Duceppe,Quebec,per-per,,PROPN-PROPN,PROPN,compound-nsubj,nmod,NNP-NNP,NNP,5,1
1680,5723.0,45,say,15,4,44,40,3,0,11,29,Gilles Duceppe,Quebec,per-per,,PROPN-PROPN,PROPN,compound-nsubj,pobj,NNP-NNP,NNP,6,1
1681,6632.0,29,said,4,3,6,3,2,22,1,2,Gilles Duceppe,Quebec,org-org,,PROPN-PROPN,PROPN,compound-nsubj,nsubj,NNP-NNP,NNP,2,1
1682,10382.0,17,interjected,6,5,12,7,4,4,1,6,Gilles Duceppe,Quebec,-,org,PROPN-PROPN,PROPN,compound-nsubj,nsubj,NNP-NNP,NNP,5,1
1683,12330.0,25,says,4,3,8,5,2,16,1,4,Gilles Duceppe,Quebec,-,org,PROPN-PROPN,PROPN,compound-nsubj,nsubj,NNP-NNP,NNP,3,1
1684,804.0,13,married,8,3,6,3,2,6,5,-2,Elizabeth Taylor,Eddie Fisher,-,org-org,PROPN-PROPN,PROPN-PROPN,compound-nsubj,compound-conj,NNP-NNP,NNP-NNP,1,1
1685,805.0,21,is,9,1,9,8,0,11,8,0,China,CFGC,per,,PROPN,PROPN,compound,pobj,NNP,NNP,3,1
1686,806.0,16,instituted,11,7,9,2,6,6,4,-2,Interior,Dominique de Villepin,,per-per-per,PROPN,PROPN-X-PROPN,compound,compound-compound-nsubj,NNP,NNP-FW-NNP,2,1
1687,10203.0,29,Hotly-tipped,0,6,8,2,5,20,-6,8,Interior,Dominique de Villepin,,org-org-org,PROPN,PROPN-X-PROPN,compound,compound-compound-npadvmod,NNP,NNP-FW-NNP,1,1
1688,807.0,47,announced,7,11,5,-6,10,41,-4,-2,Eastbourne,Sussex Downs College,per,--,PROPN,PROPN-PROPN-PROPN,compound,compound-compound-appos,NNP,NNP-NNP-NNP,6,1
1689,808.0,33,LEADER,2,11,26,15,10,6,-9,24,Robert Zoellick,State,-,org,PROPN-PROPN,PROPN,compound-dative,compound,NNP-NNP,NNP,6,1
1690,1755.0,25,is,2,1,11,10,0,13,1,9,Robert Zoellick,State,org-org,,PROPN-PROPN,PROPN,compound-nsubj,compound,NNP-NNP,NNP,4,1
1691,6871.0,34,said,31,7,21,14,6,12,24,-10,Robert Zoellick,State,per-per,,PROPN-PROPN,PROPN,compound-dative,compound,NNP-NNP,NNP,4,1
1692,10220.0,31,said,28,6,14,8,5,16,22,-14,Robert Zoellick,State,per-per,,PROPN-PROPN,PROPN,compound-dative,compound,NNP-NNP,NNP,3,1
1693,12743.0,41,signed,26,13,16,3,12,24,13,-10,Robert Zoellick,State,per-per,,PROPN-PROPN,PROPN,compound-conj,compound,NNP-NNP,NNP,2,1
1694,809.0,19,told,16,5,14,9,4,4,11,-2,Vladimir Putin,United Russia,-,per-per,PROPN-PROPN,PROPN-PROPN,compound-pobj,compound-compound,NNP-NNP,NNP-NNP,7,1
1695,8558.0,24,called,3,2,15,13,1,8,1,12,Vladimir Putin,United Russia,org-org,-,PROPN-PROPN,PROPN-PROPN,compound-nsubj,compound-compound,NNP-NNP,NNP-NNP,7,1
1696,9196.0,23,MOSCOW,0,6,9,3,5,13,-6,9,Vladimir Putin,United Russia,org-org,-,PROPN-PROPN,PROPN-PROPN,compound-poss,compound-compound,NNP-NNP,NNP-NNP,2,1
1697,11207.0,34,read,13,26,10,-16,25,23,-13,-3,Vladimir Putin,United Russia,-,per-per,PROPN-PROPN,PROPN-PROPN,compound-pobj,compound-pobj,NNP-NNP,NNP-NNP,9,1
1698,11718.0,32,alleged,5,13,17,4,12,14,-8,12,Vladimir Putin,United Russia,-,org-org,PROPN-PROPN,PROPN-PROPN,compound-poss,compound-compound,NNP-NNP,NNP-NNP,4,1
1699,13605.0,35,read,9,7,16,9,6,18,2,7,Vladimir Putin,United Russia,-,per-per,PROPN-PROPN,PROPN-PROPN,compound-pobj,compound-compound,NNP-NNP,NNP-NNP,8,1
1700,810.0,33,impressed,8,6,19,13,5,13,2,11,United Kingdom,Fleet Air Arm,-,org-org-org,PROPN-PROPN,PROPN-PROPN-PROPN,compound-pobj,compound-compound-conj,NNP-NNP,NNP-NNP-NNP,11,1
1701,811.0,29,graduated,4,2,12,10,1,16,2,8,Courtney,California,per,,PROPN,PROPN,nsubj,pobj,NNP,NNP,6,1
1702,812.0,27,Transportation,1,1,8,7,0,18,0,7,Veolia Transportation,Metrolink,per-per,,PROPN-PROPN,PROPN,compound-ROOT,nsubj,NNP-NNP,NNP,4,1
1703,813.0,17,renamed,11,3,9,6,2,7,8,-2,Ministry of Education,Republic of China,--,org-org-org,PROPN-ADP-PROPN,PROPN-ADP-PROPN,nsubj-prep-pobj,pobj-prep-pobj,NNP-IN-NNP,NNP-IN-NNP,3,1
1704,2717.0,45,is,4,19,25,6,18,19,-15,21,Ministry of Education,Republic of China,--,per-per-per,PROPN-ADP-PROPN,PROPN-ADP-PROPN,pobj-prep-pobj,pobj-prep-pobj,NNP-IN-NNP,NNP-IN-NNP,3,1
1705,814.0,18,announced,6,4,17,13,3,0,2,11,BoltBus,2008,per,,PROPN,NUM,appos,nummod,NNP,CD,4,1
1706,815.0,34,assumed,1,11,12,1,10,21,-10,11,Malta,H.E. Dr.George Abela,,org-org-org,PROPN,PROPN-PROPN-PROPN,compound,subtok-pobj-pobj,NNP,NNP-NNP-NNP,1,1
1707,816.0,39,set,1,14,30,16,13,8,-13,29,University of Navarra,Opus Dei,--,org-org,PROPN-ADP-PROPN,PROPN-PROPN,pobj-prep-pobj,compound-pobj,NNP-IN-NNP,NNP-NNP,10,1
1708,817.0,26,induces,12,2,12,10,1,13,10,0,his,Aberdeen,org,,DET,PROPN,poss,pobj,PRP$,NNP,2,1
1709,818.0,25,set,3,2,9,7,1,15,1,6,2002,Bmibaby,,per,NUM,PROPN,pobj,appos,CD,NNP,3,1
1710,819.0,30,Works,0,5,26,21,4,3,-5,26,David Alfaro Siqueiros,Mexico,--,org,PROPN-PROPN-PROPN,PROPN,compound-compound-ROOT,poss,NNP-NNP-NNP,NNP,12,1
1711,820.0,25,showed,5,10,13,3,9,11,-5,8,Fitzgerald,Capitol,per,,PROPN,PROPN,dobj,compound,NNP,NNP,2,1
1712,821.0,31,led,3,18,22,4,17,8,-15,19,Lars von Trier,Zentropa,--,org,PROPN-PROPN-PROPN,PROPN,compound-compound-poss,pobj,NNP-NNP-NNP,NNP,5,1
1713,822.0,21,became,3,3,19,16,2,1,0,16,she,United States,per,-,PRON,PROPN-PROPN,nsubj,compound-pobj,PRP,NNP-NNP,6,1
1714,823.0,40,met,19,5,33,28,4,6,14,14,State,William H. Seward,per,--,PROPN,PROPN-PROPN-PROPN,compound,compound-compound-poss,NNP,NNP-NNP-NNP,7,1
1715,3156.0,40,met,19,5,33,28,4,6,14,14,State,William H. Seward,,org-org-org,PROPN,PROPN-PROPN-PROPN,compound,compound-compound-poss,NNP,NNP-NNP-NNP,7,1
1716,824.0,36,turn,4,16,25,9,15,10,-12,21,Karolos Papoulias,Greece,-,org,PROPN-PROPN,PROPN,compound-pobj,pobj,NNP-NNP,NNP,3,1
1717,3851.0,26,believes,4,3,10,7,2,15,1,6,Karolos Papoulias,Greece,-,per,PROPN-PROPN,PROPN,compound-nsubj,conj,NNP-NNP,NNP,3,1
1718,4119.0,29,met,4,3,17,14,2,11,1,13,Karolos Papoulias,Greece,org-org,,PROPN-PROPN,PROPN,compound-nsubj,nsubj,NNP-NNP,NNP,3,1
1719,6915.0,19,been,11,2,16,14,1,2,9,5,Karolos Papoulias,Greece,org-org,,PROPN-PROPN,PROPN,compound-nsubj,pobj,NNP-NNP,NNP,2,1
1720,11361.0,27,Visiting,0,10,26,16,9,0,-10,26,Karolos Papoulias,Greece,-,org,PROPN-PROPN,PROPN,compound-appos,conj,NNP-NNP,NNP,3,1
1721,11759.0,58,is,27,23,33,10,22,24,4,6,Karolos Papoulias,Greece,per-per,,PROPN-PROPN,PROPN,compound-pobj,pobj,NNP-NNP,NNP,11,1
1722,825.0,37,named,4,8,19,11,7,17,-4,15,California State University,San Francisco State University,per-per-per,---,PROPN-PROPN-PROPN,PROPN-PROPN-PROPN-PROPN,compound-compound-compound,compound-compound-compound-pobj,NNP-NNP-NNP,NNP-NNP-NNP-NNP,10,1
1723,826.0,18,named,3,6,13,7,5,4,-3,10,Ernest Charles Drury,Ontario,--,per,PROPN-PROPN-PROPN,PROPN,compound-compound-pobj,pobj,NNP-NNP-NNP,NNP,3,1
1724,6431.0,28,have,4,14,27,13,13,0,-10,23,Ernest Charles Drury,Ontario,per-per-per,,PROPN-PROPN-PROPN,PROPN,compound-compound-nsubjpass,pobj,NNP-NNP-NNP,NNP,7,1
1725,13396.0,39,created,20,5,15,10,4,23,15,-5,Ernest Charles Drury,Ontario,org-org-org,,PROPN-PROPN-PROPN,PROPN,compound-compound-nsubjpass,pobj,NNP-NNP-NNP,NNP,3,1
1726,827.0,20,features,3,5,10,5,4,9,-2,7,Houston,Slim Thug,per,-,PROPN,PROPN-PROPN,compound,compound-conj,NNP,NNP-NNP,2,1
1727,828.0,28,was,3,2,7,5,1,20,1,4,1985,The Crowd,org,-,NUM,DET-PROPN,pobj,det-pobj,CD,DT-NNP,4,1
1728,829.0,36,arrived,30,3,17,14,2,18,27,-13,Geir Haarde,Iceland,per-per,,PROPN-PROPN,PROPN,compound-nsubj,nsubjpass,NNP-NNP,NNP,3,1
1729,1702.0,40,met,7,13,27,14,12,12,-6,20,Geir Haarde,Iceland,-,org,PROPN-PROPN,PROPN,compound-appos,poss,NNP-NNP,NNP,9,1
1730,2192.0,50,arrived,30,3,17,14,2,32,27,-13,Geir Haarde,Iceland,-,per,PROPN-PROPN,PROPN,compound-nsubj,nsubjpass,NNP-NNP,NNP,3,1
1731,2857.0,24,requested,4,3,7,4,2,16,1,3,Geir Haarde,Iceland,-,per,PROPN-PROPN,PROPN,compound-nsubj,poss,NNP-NNP,NNP,5,1
1732,4429.0,40,broke,5,28,38,10,27,1,-23,33,Geir Haarde,Iceland,-,org,PROPN-PROPN,PROPN,compound-nsubj,compound,NNP-NNP,NNP,14,1
1733,4523.0,25,voted,3,10,21,11,9,3,-7,18,Geir Haarde,Iceland,per-per,,PROPN-PROPN,PROPN,compound-dobj,poss,NNP-NNP,NNP,7,1
1734,9234.0,34,voted,1,11,18,7,10,15,-10,17,Geir Haarde,Iceland,-,org,PROPN-PROPN,PROPN,compound-pobj,poss,NNP-NNP,NNP,7,1
1735,9298.0,20,says,11,13,15,2,12,4,-2,4,Geir Haarde,Iceland,per-per,,PROPN-PROPN,PROPN,compound-compound,poss,NNP-NNP,NNP,2,1
1736,12724.0,31,says,3,11,28,17,10,2,-8,25,Geir Haarde,Iceland,-,per,PROPN-PROPN,PROPN,compound-pobj,poss,NNP-NNP,NNP,11,1
1737,830.0,23,described,7,2,10,8,1,12,5,3,Google,Sergey Brin,,per-per,PROPN,PROPN-PROPN,compound,compound-pobj,NNP,NNP-NNP,3,1
1738,1698.0,40,be,36,19,24,5,18,15,17,-12,Google,Sergey Brin,,org-org,PROPN,PROPN-PROPN,compound,compound-conj,NNP,NNP-NNP,4,1
1739,3953.0,49,includes,19,5,16,11,4,32,14,-3,Google,Sergey Brin,per,-,PROPN,PROPN-PROPN,compound,compound-conj,NNP,NNP-NNP,4,1
1740,8070.0,36,alt,1,4,22,18,3,13,-3,21,Google,Sergey Brin,,per-per,PROPN,PROPN-PROPN,poss,compound-conj,NNP,NNP-NNP,8,1
1741,8235.0,27,is,9,23,25,2,22,1,-14,16,Google,Sergey Brin,,org-org,PROPN,PROPN-PROPN,pobj,compound-pobj,NNP,NNP-NNP,2,1
1742,8459.0,33,is,1,6,10,4,5,22,-5,9,Google,Sergey Brin,,per-per,PROPN,PROPN-PROPN,poss,compound-appos,NNP,NNP-NNP,7,1
1743,831.0,41,founded,2,1,12,11,0,28,1,10,NIDA,King,,org,PROPN,PROPN,nsubjpass,compound,NNP,NNP,6,1
1744,832.0,27,said,2,4,15,11,3,11,-2,13,Iran,Kish Air,per,-,PROPN,ADJ-PROPN,nsubj,compound-appos,NNP,JJ-NNP,4,1
1745,833.0,39,was,1,5,17,12,4,21,-4,16,Fiorello H. LaGuardia High School of Music Art and Performing Arts,New York,org-org-org-org-org-org-org-org-org-org-org,-,PROPN-PROPN-PROPN-PROPN-PROPN-ADP-PROPN-PROPN-CCONJ-PROPN-PROPN,PROPN-PROPN,compound-compound-compound-compound-pobj-prep-pobj-appos-cc-compound-conj,compound-compound,NNP-NNP-NNP-NNP-NNP-IN-NNP-NNP-CC-NNP-NNP,NNP-NNP,4,1
1746,8687.0,26,taught,1,11,23,12,10,2,-10,22,Fiorello H. LaGuardia High School of Music Art and Performing Arts,New York,per-per-per-per-per-per-per-per-per-per-per,-,PROPN-PROPN-PROPN-PROPN-PROPN-ADP-PROPN-PROPN-CCONJ-PROPN-PROPN,PROPN-PROPN,compound-compound-compound-compound-pobj-prep-pobj-conj-cc-compound-conj,compound-compound,NNP-NNP-NNP-NNP-NNP-IN-NNP-NNP-CC-NNP-NNP,NNP-NNP,4,1
1747,10173.0,29,attended,1,3,15,12,2,13,-2,14,Fiorello H. LaGuardia High School of Music Art and Performing Arts,New York,org-org-org-org-org-org-org-org-org-org-org,-,PROPN-PROPN-PROPN-PROPN-PROPN-ADP-PROPN-PROPN-CCONJ-PROPN-PROPN,PROPN-PROPN,compound-compound-compound-compound-dobj-prep-pobj-conj-cc-compound-conj,compound-compound,NNP-NNP-NNP-NNP-NNP-IN-NNP-NNP-CC-NNP-NNP,NNP-NNP,4,1
1748,834.0,26,intervened,7,20,25,5,19,0,-13,18,Democratic Republic,Kabila,org-org,,PROPN-PROPN,PROPN,compound-nmod,pobj,NNP-NNP,NNP,1,1
1749,835.0,31,was,5,14,16,2,13,14,-9,11,England,Philippa of Hainault,,org-org-org,PROPN,PROPN-ADP-PROPN,pobj,conj-prep-pobj,NNP,NNP-IN-NNP,2,1
1750,11528.0,27,came,14,4,12,8,3,14,10,-2,England,Philippa of Hainault,per,--,PROPN,PROPN-ADP-PROPN,pobj,appos-prep-pobj,NNP,NNP-IN-NNP,6,1
1751,12671.0,16,was,2,11,13,2,10,2,-9,11,England,Philippa of Hainault,per,--,PROPN,PROPN-ADP-PROPN,pobj,conj-prep-pobj,NNP,NNP-IN-NNP,2,1
1752,836.0,27,says,3,1,25,24,0,1,2,22,General Motors,Chevrolet,org-org,,PROPN-PROPN,PROPN,compound-compound,conj,NNP-NNPS,NNP,7,1
1753,7931.0,19,recalling,4,1,8,7,0,10,3,4,General Motors,Chevrolet,org-org,,PROPN-PROPN,PROPN,compound-compound,compound,NNP-NNPS,NNP,5,1
1754,837.0,61,included,44,46,50,4,45,10,-2,6,Blackjack Mulligan,Big Machine,-,per-per,PROPN-PROPN,PROPN-PROPN,compound-dobj,compound-pobj,NNP-NNP,NNP-NNP,5,1
1755,839.0,41,was,11,1,21,20,0,19,10,10,Michael Phillip Anderson,astronaut,org-org-org,,PROPN-PROPN-PROPN,NOUN,compound-compound-nsubj,conj,NNP-NNP-NNP,NN,6,1
1756,840.0,17,is,10,1,14,13,0,2,9,4,Debelah Morgan,singer,per-per,,PROPN-PROPN,NOUN,compound-nsubj,attr,NNP-NNP,NN,3,1
1757,841.0,37,Frustrated,0,12,25,13,11,11,-12,25,Sat?,r Japa,per,-,VERB,NOUN-PROPN,advcl,meta-nmod,VBZ,NN-NNP,-1,1
1758,842.0,23,said,12,14,22,8,13,0,-2,10,Carlos Ghosn,Renault,per-per,,PROPN-PROPN,PROPN,compound-compound,pobj,NNP-NNP,NNP,2,1
1759,843.0,15,conducted,3,8,6,-2,7,8,-5,3,Department of Labour,New Zealand,per-per-per,-,PROPN-ADP-PROPN,PROPN-PROPN,pobj-prep-pobj,compound-conj,NNP-IN-NNP,NNP-NNP,2,1
1760,844.0,14,urges,5,4,11,7,3,2,1,6,Nawaz Sharif,Pakistan,per-per,,PROPN-PROPN,PROPN,compound-nsubj,poss,NNP-NNP,NNP,5,1
1761,3523.0,26,called,4,10,22,12,9,3,-6,18,Nawaz Sharif,Pakistan,org-org,,PROPN-PROPN,PROPN,compound-poss,pobj,NNP-NNP,NNP,5,1
1762,4975.0,35,ISLAMABAD,0,14,19,5,13,15,-14,19,Nawaz Sharif,Pakistan,per-per,,PROPN-PROPN,PROPN,compound-nsubj,pobj,NNP-NNP,NNP,4,1
1763,5509.0,26,is,10,7,25,18,6,0,3,15,Nawaz Sharif,Pakistan,per-per,,PROPN-PROPN,PROPN,compound-compound,pobj,NNP-NNP,NNP,4,1
1764,6217.0,28,established,5,2,20,18,1,7,3,15,Nawaz Sharif,Pakistan,-,per,PROPN-PROPN,PROPN,compound-compound,pobj,NNP-NNP,NNP,4,1
1765,7410.0,19,referred,2,8,18,10,7,0,-6,16,Nawaz Sharif,Pakistan,org-org,,PROPN-PROPN,PROPN,compound-pobj,pobj,NNP-NNP,NNP,6,1
1766,8584.0,21,says,5,4,18,14,3,2,1,13,Nawaz Sharif,Pakistan,per-per,,PROPN-PROPN,PROPN,compound-nsubj,poss,NNP-NNP,NNP,6,1
1767,9676.0,39,claimed,9,11,18,7,10,20,-2,9,Nawaz Sharif,Pakistan,-,per,PROPN-PROPN,PROPN,compound-nsubj,pobj,NNP-NNP,NNP,4,1
1768,10723.0,12,is,1,6,11,5,5,0,-5,10,Nawaz Sharif,Pakistan,-,per,PROPN-PROPN,PROPN,compound-compound,pobj,NNP-NNP,NNP,5,1
1769,10978.0,29,involved,2,9,28,19,8,0,-7,26,Nawaz Sharif,Pakistan,-,per,PROPN-PROPN,PROPN,compound-appos,pobj,NNP-NNP,NNP,4,1
1770,12186.0,12,announces,3,2,10,8,1,1,1,7,Nawaz Sharif,Pakistan,-,per,PROPN-PROPN,PROPN,compound-nsubj,compound,NNP-NNP,NNP,4,1
1771,13003.0,29,served,2,1,10,9,0,18,1,8,Nawaz Sharif,Pakistan,per-per,,PROPN-PROPN,PROPN,compound-nsubj,pobj,NNP-NNP,NNP,4,1
1772,845.0,21,saw,4,12,20,8,11,0,-8,16,Hypo Real Estate,Germany,--,org,PROPN-PROPN-PROPN,PROPN,compound-compound-compound,pobj,NNP-NNP-NNP,NNP,6,1
1773,846.0,16,was,2,8,11,3,7,4,-6,9,Philippe,France,org,,PROPN,PROPN,compound,pobj,NNP,NNP,3,1
1774,847.0,23,is,9,16,21,5,15,1,-7,12,DJ,Wax Tailor,per,-,NOUN,PROPN-PROPN,compound,compound-conj,NN,NNP-NNP,2,1
1775,848.0,21,served,8,5,16,11,4,4,3,8,United States,University of Maryland University College,org-org,----,PROPN-PROPN,PROPN-ADP-PROPN-PROPN-PROPN,compound-compound,nmod-prep-pobj-compound-pobj,NNP-NNP,NNP-IN-NNP-NNP-NNP,9,1
1776,849.0,24,released,18,9,12,3,8,11,9,-6,Nick Lowe,England,per-per,,PROPN-PROPN,PROPN,compound-pobj,pobj,NNP-NNP,NNP,5,1
1777,850.0,25,featured,2,1,19,18,0,5,1,17,EasyJet,Luton,,per,PROPN,PROPN,nsubjpass,pobj,NNP,NNP,10,1
1778,6009.0,48,follows,1,6,8,2,5,39,-5,7,EasyJet,Luton,org,,PROPN,PROPN,pobj,pobj,NNP,NNP,2,1
1779,851.0,37,created,6,10,15,5,9,21,-4,9,Tom Harkin,Iowa,-,org,PROPN-PROPN,PROPN,compound-pobj,appos,NNP-NNP,NNP,3,1
1780,1705.0,45,pushed,16,9,2,-7,8,42,7,-14,Tom Harkin,Iowa,per-per,,PROPN-PROPN,PROPN,compound-conj,nmod,NNP-NNP,NNP,2,1
1781,2890.0,40,Grassley,3,6,8,2,5,31,-3,5,Tom Harkin,Iowa,per-per,,PROPN-PROPN,PROPN,compound-conj,compound,NNP-NNP,NNP,5,1
1782,3956.0,46,interrupted,12,8,11,3,7,34,4,-1,Tom Harkin,Iowa,org-org,,PROPN-PROPN,PROPN,compound-pobj,pobj,NNP-NNP,NNP,5,1
1783,5547.0,12,was,1,8,11,3,7,0,-7,10,Tom Harkin,Iowa,org-org,,PROPN-PROPN,PROPN,compound-pobj,pobj,NNP-NNP,NNP,4,1
1784,6393.0,37,is,10,7,10,3,6,26,3,0,Tom Harkin,Iowa,org-org,,PROPN-PROPN,PROPN,compound-pobj,compound,NNP-NNP,NNP,3,1
1785,6544.0,7,Harkin,3,3,6,3,2,0,0,3,Tom Harkin,Iowa,per-per,,PROPN-PROPN,PROPN,compound-ROOT,pobj,NNP-NNP,NNP,1,1
1786,11487.0,26,chairman,1,10,13,3,9,12,-9,12,Tom Harkin,Iowa,-,per,PROPN-PROPN,PROPN,compound-nsubj,pobj,NNP-NNP,NNP,4,1
1787,11652.0,36,sought,7,6,31,25,5,4,1,24,Tom Harkin,Iowa,-,per,PROPN-PROPN,PROPN,compound-nsubj,poss,NNP-NNP,NNP,5,1
1788,12337.0,33,said,13,9,12,3,8,20,4,-1,Tom Harkin,Iowa,per-per,,PROPN-PROPN,PROPN,compound-nsubj,appos,NNP-NNP,NNP,1,1
1789,852.0,19,represented,6,3,9,6,2,9,3,3,USC Trojans,University of Southern California,per-per,---,PROPN-PROPN,PROPN-ADP-PROPN-PROPN,compound-compound,dobj-prep-compound-pobj,NNP-NNPS,NNP-IN-NNP-NNP,4,1
1790,853.0,118,USA,1,74,9,-65,73,108,-73,8,Megabus,New York City,org,--,PROPN,PROPN-PROPN-PROPN,pobj,compound-nmod-compound,NNP,NNP-NNP-NNP,-1,1
1791,854.0,23,won,7,1,7,6,0,15,6,0,Fujitsu,Japan,per,,PROPN,PROPN,poss,pobj,NNP,NNP,3,1
1792,855.0,39,says,13,20,23,3,19,15,-7,10,student,Royal Institute of Technology,,org-org-org-org,NOUN,PROPN-PROPN-ADP-PROPN,nsubj,compound-pobj-prep-pobj,NN,NNP-NNP-IN-NNP,4,1
1793,856.0,31,Perrett,1,12,16,4,11,14,-11,15,Malyshev Factory,Ukraine,org-org,,PROPN-PROPN,PROPN,compound-pobj,pobj,NNP-NNP,NNP,3,1
1794,857.0,24,named,3,8,9,1,7,14,-5,6,astronaut,Michael J. Smith,org,--,NOUN,PROPN-PROPN-PROPN,compound,compound-compound-pobj,NN,NNP-NNP-NNP,2,1
1795,859.0,27,put,1,1,3,2,0,23,0,2,Afshin,Iran,org,,PROPN,PROPN,nsubj,dobj,NNP,NNP,1,1
1796,860.0,33,is,2,1,10,9,0,22,1,8,Muni Metro,California,-,per,PROPN-PROPN,PROPN,compound-nsubj,dobj,NNP-NNP,NNP,3,1
1797,861.0,40,met,19,3,33,30,2,6,16,14,New York,Edwin D. Morgan,-,per-per-per,PROPN-PROPN,PROPN-PROPN-PROPN,compound-compound,compound-compound-poss,NNP-NNP,NNP-NNP-NNP,8,1
1798,862.0,33,posted,10,2,10,8,1,22,8,0,Marathon,Houston,per,,PROPN,PROPN,nsubj,pobj,NNP,NNP,3,1
1799,863.0,26,was,1,8,17,9,7,8,-7,16,El Sistema,National Network of Youth,org-org,---,PROPN-PROPN,PROPN-PROPN-ADP-PROPN,compound-dobj,compound-pobj-prep-pobj,NNP-NNP,NNP-NNP-IN-NNP,5,1
1800,864.0,67,included,47,1,38,37,0,28,46,-9,SIFE,Egypt,,per,NOUN,PROPN,nsubj,pobj,NNS,NNP,4,1
1801,865.0,77,had,14,47,47,0,46,29,-33,33,Allen,Allen High School,org,--,PROPN,PROPN-PROPN-PROPN,amod,compound-compound-pobj,NNP,NNP-NNP-NNP,0,1
1802,866.0,16,signed,3,1,6,5,0,9,2,3,Apocalypse,Musea,org,,NOUN,PROPN,nsubjpass,pobj,NN,NNP,3,1
1803,867.0,26,Gaston,0,1,4,3,0,21,-1,4,Gaston Tong Sang,French Polynesia,org-org-org,-,PROPN-PROPN-PROPN,PROPN-PROPN,ROOT-compound-ROOT,compound-poss,NNP-NNP-NNP,NNP-NNP,2,1
1804,2349.0,30,greeted,2,15,12,-3,14,17,-13,10,Gaston Tong Sang,French Polynesia,per-per-per,-,PROPN-PROPN-PROPN,PROPN-PROPN,compound-compound-compound,compound-pobj,NNP-NNP-NNP,NNP-NNP,9,1
1805,3708.0,33,doubted,2,10,27,17,9,5,-8,25,Gaston Tong Sang,French Polynesia,--,org-org,PROPN-PROPN-PROPN,PROPN-PROPN,compound-compound-dobj,amod-pobj,NNP-NNP-NNP,NNP-NNP,7,1
1806,11551.0,29,hailed,6,4,1,-3,3,27,2,-5,Gaston Tong Sang,French Polynesia,org-org-org,-,PROPN-PROPN-PROPN,PROPN-PROPN,compound-compound-nsubj,compound-pobj,NNP-NNP-NNP,NNP-NNP,3,1
1807,868.0,36,made,1,7,20,13,6,15,-6,19,Finland,Kallio,,org,PROPN,PROPN,pobj,pobj,NNP,NNP,7,1
1808,869.0,25,is,6,1,23,22,0,1,5,17,William Howard Taft,United States,--,org-org,PROPN-PROPN-PROPN,PROPN-PROPN,compound-compound-compound,compound-pobj,NNP-NNP-NNP,NNP-NNP,8,1
1809,1215.0,81,was,71,3,12,9,2,68,68,-59,William Howard Taft,United States,--,per-per,PROPN-PROPN-PROPN,PROPN-PROPN,compound-compound-appos,compound-pobj,NNP-NNP-NNP,NNP-NNP,6,1
1810,2184.0,45,was,3,15,22,7,14,22,-12,19,William Howard Taft,United States,--,per-per,PROPN-PROPN-PROPN,PROPN-PROPN,compound-compound-dobj,compound-pobj,NNP-NNP-NNP,NNP-NNP,6,1
1811,2526.0,29,inauguration,1,4,13,9,3,15,-3,12,William Howard Taft,United States,per-per-per,-,PROPN-PROPN-PROPN,PROPN-PROPN,compound-compound-pobj,compound-pobj,NNP-NNP-NNP,NNP-NNP,7,1
1812,9105.0,25,anchored,1,12,20,8,11,4,-11,19,William Howard Taft,United States,per-per-per,-,PROPN-PROPN-PROPN,PROPN-PROPN,compound-compound-poss,compound-pobj,NNP-NNP-NNP,NNP-NNP,6,1
1813,871.0,31,revealed,10,1,13,12,0,17,9,3,The Carphone Warehouse,TalkTalk,--,per,DET-PROPN-PROPN,PROPN,det-compound-poss,compound,DT-NNP-NNP,NNP,6,1
1814,872.0,13,was,1,10,11,1,9,1,-9,10,JNU,New Delhi,per,-,PROPN,PROPN-PROPN,compound,compound-pobj,NNP,NNP-NNP,1,1
1815,4293.0,15,was,1,12,13,1,11,1,-11,12,JNU,New Delhi,org,-,PROPN,PROPN-PROPN,compound,compound-pobj,NNP,NNP-NNP,1,1
1816,873.0,15,selected,3,5,9,4,4,5,-2,6,South African Airways,SAA,--,per,PROPN-PROPN-PROPN,PROPN,compound-compound-dobj,appos,NNP-NNP-NNP,NNP,2,1
1817,8218.0,26,was,6,1,5,4,0,20,5,-1,South African Airways,SAA,--,org,PROPN-PROPN-PROPN,PROPN,compound-compound-nsubj,appos,NNP-NNP-NNP,NNP,3,1
1818,874.0,37,signed,3,6,9,3,5,27,-3,6,Dizzee Rascal,Dirtee Stank,org-org,-,PROPN-PROPN,PROPN-PROPN,compound-poss,compound-compound,NNP-NNP,NNP-NNP,2,1
1819,875.0,30,spent,1,9,23,14,8,6,-8,22,England,Jack Hylton,org,-,PROPN,PROPN-PROPN,compound,compound-compound,NNP,NNP-NNP,8,1
1820,876.0,33,picked,7,4,23,19,3,9,3,16,Abubakar,Nigeria,org,,PROPN,PROPN,nsubj,nsubj,NNP,NNP,7,1
1821,10767.0,56,POLICY,2,22,39,17,21,16,-20,37,Abubakar,Nigeria,org,,PROPN,PROPN,poss,pobj,NNP,NNP,7,1
1822,877.0,17,was,12,7,2,-5,6,14,5,-10,Louis-Alexandre Taschereau,Quebec,per-per,,PROPN-PROPN,PROPN,amod-pobj,pobj,NNP-NNP,NNP,6,1
1823,11872.0,58,wrote,30,11,22,11,10,35,19,-8,Louis-Alexandre Taschereau,Quebec,-,org,ADJ-PROPN,PROPN,amod-pobj,nmod,JJ-NNP,NNP,10,1
1824,878.0,28,flew,9,1,3,2,0,24,8,-6,Prime Minister,Hun Sen,-,per-per,PROPN-PROPN,PROPN-PROPN,compound-compound,compound-nsubj,NNP-NNP,NNP-NNP,1,1
1825,8408.0,23,promised,5,2,4,2,1,18,3,-1,Prime Minister,Hun Sen,-,per-per,PROPN-PROPN,PROPN-PROPN,compound-compound,compound-nsubj,NNP-NNP,NNP-NNP,1,1
1826,11157.0,23,opened,1,14,16,2,13,6,-13,15,Prime Minister,Hun Sen,per-per,-,PROPN-PROPN,PROPN-PROPN,compound-compound,compound-poss,NNP-NNP,NNP-NNP,1,1
1827,879.0,24,organized,6,6,15,9,5,8,0,9,NDProgress,Alexa McDonough,per,-,PROPN,PROPN-PROPN,nsubj,compound-nsubj,NNP,NNP-NNP,3,1
1828,880.0,20,feuding,2,8,18,10,7,1,-6,16,1998,Dancing Fools,per,-,NUM,PROPN-PROPN,pobj,compound-oprd,CD,NNP-NNPS,6,1
1829,881.0,30,was,1,7,17,10,6,12,-6,16,Godred Crovan,Isle of Man,-,per-per-per,PROPN-PROPN,PROPN-ADP-PROPN,compound-compound,dobj-prep-pobj,NNP-NNP,NNP-IN-NNP,5,1
1830,882.0,35,stood,1,1,12,11,0,22,0,11,He,Cospicua,,per,PRON,PROPN,nsubj,appos,PRP,NNP,1,1
1831,884.0,20,say,2,1,16,15,0,3,1,14,Nottinghamshire Police,England,per-per,,PROPN-NOUN,PROPN,compound-nsubj,compound,NNP-NNS,NNP,7,1
1832,885.0,63,Said,0,2,25,23,1,37,-2,25,John Mauceri,University of North Carolina School of the Arts,per-per,-------,PROPN-PROPN,PROPN-ADP-PROPN-PROPN-PROPN-ADP-DET-NOUN,compound-nsubj,pobj-prep-compound-compound-pobj-prep-det-pobj,NNP-NNP,NNP-IN-NNP-NNP-NNP-IN-DT-NNS,9,1
1833,886.0,81,gained,6,8,26,18,7,54,-2,20,Georgia,Johnny Isakson,,per-per,PROPN,PROPN-PROPN,poss,compound-poss,NNP,NNP-NNP,6,1
1834,6547.0,29,amp,3,13,23,10,12,5,-10,20,Georgia,Johnny Isakson,per,-,PROPN,PROPN-PROPN,compound,compound-pobj,NNP,NNP-NNP,5,1
1835,887.0,31,visited,15,2,7,5,1,23,13,-8,Jacksonville,Everbank,org,,PROPN,PROPN,compound,compound,NNP,NNP,2,1
1836,888.0,28,is,8,1,25,24,0,2,7,17,Xie Shaoguang,MediaCorp,-,org,PROPN-PROPN,PROPN,compound-nsubj,compound,NNP-NNP,NNP,9,1
1837,889.0,18,broadcast,3,8,12,4,7,5,-5,9,GCap Media,Network,-,per,PROPN-PROPN,PROPN,compound-poss,compound,NNP-NNP,NNP,1,1
1838,890.0,68,include,5,7,11,4,6,56,-2,6,Shi Zhengrong,Suntech Power,-,org-org,PROPN-PROPN,PROPN-PROPN,compound-compound,compound-compound,NNP-NNP,NNP-NNP,4,1
1839,891.0,12,founded,3,2,6,4,1,5,1,3,university,1942,per,,NOUN,NUM,nsubjpass,pobj,NN,CD,2,1
1840,892.0,38,am,1,31,35,4,30,2,-30,34,Chief,Sheikh Abdul Halim,org,--,PROPN,PROPN-PROPN-PROPN,compound,compound-compound-dobj,NNP,NNP-NNP-NNP,3,1
1841,893.0,16,portrayed,1,1,14,13,0,1,0,13,Corker,Tennessee,,org,NOUN,PROPN,nsubj,compound,NN,NNP,3,1
1842,894.0,33,attended,2,5,14,9,4,18,-3,12,Virginia Military Institute,Division I,org-org-org,-,PROPN-PROPN-PROPN,PROPN-PRON,compound-compound-dobj,pobj-nsubj,NNP-NNP-NNP,NNP-PRP,4,1
1843,6844.0,29,represented,6,9,16,7,8,12,-3,10,Virginia Military Institute,Division I,per-per-per,-,PROPN-PROPN-PROPN,PROPN-PROPN,compound-compound-dobj,compound-compound,NNP-NNP-NNP,NNP-NNP,6,1
1844,7969.0,23,represents,7,10,18,8,9,4,-3,11,Virginia Military Institute,Division I,--,org-org,PROPN-PROPN-PROPN,PROPN-PRON,compound-compound-dobj,pobj-nsubj,NNP-NNP-NNP,NNP-PRP,7,1
1845,895.0,32,were,3,25,27,2,24,4,-22,24,Army,XIII Corps,,per-per,PROPN,PROPN-PROPN,poss,compound-pobj,NNP,NNP-NNP,2,1
1846,896.0,11,is,8,1,2,1,0,8,7,-6,Actor,Jared Padalecki,per,-,PROPN,PROPN-PROPN,compound,compound-nsubj,NNP,NNP-NNP,1,1
1847,897.0,33,It's,0,23,27,4,22,5,-23,27,University of Aberdeen,Scotland,--,org,PROPN-ADP-PROPN,PROPN,pobj-prep-pobj,pobj,NNP-IN-NNP,NNP,2,1
1848,1079.0,30,suggests,17,13,17,4,12,12,4,0,University of Aberdeen,Scotland,per-per-per,,PROPN-ADP-PROPN,PROPN,pobj-prep-pobj,pobj,NNP-IN-NNP,NNP,8,1
1849,1305.0,26,surveyed,4,15,18,3,14,7,-11,14,University of Aberdeen,Scotland,--,per,PROPN-ADP-PROPN,PROPN,pobj-prep-pobj,pobj,NNP-IN-NNP,NNP,6,1
1850,3552.0,37,showed,16,7,11,4,6,25,9,-5,University of Aberdeen,Scotland,org-org-org,,PROPN-ADP-PROPN,PROPN,pobj-prep-pobj,pobj,NNP-IN-NNP,NNP,5,1
1851,10871.0,33,found,7,2,7,5,1,25,5,0,University of Aberdeen,Scotland,--,per,PROPN-ADP-PROPN,PROPN,nmod-prep-pobj,pobj,NNP-IN-NNP,NNP,2,1
1852,898.0,22,played,4,1,17,16,0,4,3,13,Dave Navarro,Jane's Addiction,org-org,-,PROPN-PROPN,PROPN-NOUN,compound-nsubj,compound-dobj,NNP-NNP,NNP-NN,6,1
1853,899.0,49,was,14,24,37,13,23,11,-10,23,Talyshinskaya,Baku,,per,PROPN,PROPN,nsubj,pobj,NNP,NNP,4,1
1854,900.0,18,became,8,8,15,7,7,2,0,7,university,Big 12 Conference,org,--,NOUN,PROPN-NUM-PROPN,nsubj,amod-nummod-pobj,NN,NNP-CD-NNP,5,1
1855,902.0,40,are,1,9,30,21,8,9,-8,29,KIMEP,Luca Accounting Club,per,--,PROPN,PROPN-PROPN-PROPN,pobj,compound-compound-compound,NNP,NNP-NNP-NNP,4,1
1856,903.0,28,founded,3,1,6,5,0,21,2,3,Incarnate Word,1881,-,org,PROPN-PROPN,NUM,compound-nsubjpass,pobj,NNP-NNP,CD,2,1
1857,904.0,33,served,27,15,32,17,14,0,12,5,Carlos Manuel de y Quesada,Cuba,per-per-per-per-per,,PROPN-PROPN-PROPN-PROPN-PROPN,PROPN,compound-compound-nmod-compound-nsubj,pobj,NNP-NNP-NNP-NNP-NNP,NNP,3,1
1858,906.0,27,entered,8,1,4,3,0,22,7,-4,Enron,United States,per,-,PROPN,PROPN-PROPN,nsubj,compound-poss,NNP,NNP-NNP,3,1
1859,907.0,12,was,2,1,9,8,0,2,1,7,Holgate School,South Yorkshire,org-org,-,PROPN-PROPN,PROPN-PROPN,compound-nsubj,compound-compound,NNP-NNP,NNP-NNP,5,1
1860,908.0,17,leases,6,9,13,4,8,3,-3,7,Salem,Oregon Department of Transportation,per,---,PROPN,PROPN-PROPN-ADP-PROPN,compound,compound-pobj-prep-pobj,NNP,NNP-NNP-IN-NNP,2,1
1861,909.0,12,is,1,8,10,2,7,1,-7,9,Whig,Zachary Taylor,,per-per,PROPN,PROPN-PROPN,compound,compound-conj,NNP,NNP-NNP,2,1
1862,910.0,17,said,7,5,9,4,4,7,2,2,Alfred Gusenbauer,Austria,org-org,,PROPN-PROPN,PROPN,compound-nsubj,nsubj,NNP-NNP,NNP,2,1
1863,3613.0,37,renamed,13,8,27,19,7,9,5,14,Alfred Gusenbauer,Austria,org-org,,PROPN-PROPN,PROPN,compound-pobj,poss,NNP-NNP,NNP,12,1
1864,911.0,51,was,8,28,46,18,27,4,-20,38,Air Force Space Command,Peterson Air Force Base,org-org-org-org,---,PROPN-PROPN-PROPN-PROPN,PROPN-PROPN-PROPN-PROPN,compound-compound-compound-pobj,compound-compound-compound-compound,NNP-NNP-NNP-NNP,NNP-NNP-NNP-NNP,11,1
1865,912.0,59,began,3,8,12,4,7,46,-5,9,Fire Brigades Union,FBU,--,org,PROPN-PROPN-PROPN,PROPN,compound-compound-pobj,appos,NNP-NNP-NNP,NNP,3,1
1866,913.0,15,is,2,1,10,9,0,4,1,8,Lost Tribe,Matt Darey,-,per-per,PROPN-PROPN,PROPN-PROPN,compound-nsubj,compound-pobj,NNP-NNP,NNP-NNP,5,1
1867,914.0,23,had,2,1,20,19,0,2,1,18,Taj Mahal,Jesse Ed Davis,per-per,--,PROPN-PROPN,PROPN-PROPN-PROPN,compound-nsubj,compound-compound-conj,NNP-NNP,NNP-NNP-NNP,6,1
1868,915.0,36,grew,18,11,16,5,10,19,7,-2,France,Vivendi,org,,PROPN,PROPN,compound,compound,NNP,NNP,6,1
1869,916.0,66,was,3,54,60,6,53,5,-51,57,Mary of Teck,George V of the United Kingdom,org-org-org,-----,PROPN-ADP-PROPN,PROPN-PROPN-ADP-DET-PROPN-PROPN,nmod-prep-compound,compound-pobj-prep-det-compound-pobj,NNP-IN-NNP,NNP-NNP-IN-DT-NNP-NNP,3,1
1870,5037.0,55,Alexandra,0,16,25,9,15,29,-16,25,Mary of Teck,George V of the United Kingdom,per-per-per,-----,PROPN-ADP-PROPN,PROPN-PROPN-ADP-DET-PROPN-PROPN,ROOT-prep-pobj,compound-pobj-prep-det-compound-pobj,NNP-IN-NNP,NNP-NNP-IN-DT-NNP-NNP,4,1
1871,9678.0,31,considered,8,15,21,6,14,9,-7,13,Mary of Teck,George V of the United Kingdom,per-per-per,-----,PROPN-ADP-PROPN,PROPN-PROPN-ADP-DET-PROPN-PROPN,nmod-prep-compound,compound-pobj-prep-det-compound-pobj,NNP-IN-NNP,NNP-NNP-IN-DT-NNP-NNP,6,1
1872,917.0,17,is,4,1,15,14,0,1,3,11,John Marshall,Virginia,org-org,,PROPN-PROPN,PROPN,compound-compound,compound,NNP-NNP,NNP,6,1
1873,918.0,21,was,9,1,13,12,0,7,8,4,Serj Tankian,Serjical Strike,-,per-per,PROPN-PROPN,PROPN-PROPN,compound-poss,compound-compound,NNP-NNP,NNP-NNP,5,1
1874,919.0,33,is,2,1,14,13,0,18,1,12,Sunstate,QantasLink,,org,PROPN,PROPN,compound,compound,NNP,NNP,6,1
1875,920.0,22,is,1,9,20,11,8,1,-8,19,Histeria,Super Crazy,,per-per,PROPN,PROPN-PROPN,nsubj,compound-pobj,NNP,NNP-NNP,5,1
1876,921.0,62,emerging,4,15,25,10,14,36,-11,21,Italy,Giorgione,org,,PROPN,PROPN,pobj,nsubj,NNP,NNP,3,1
1877,923.0,23,shifted,1,1,22,21,0,0,0,21,He,DJ,,org,PRON,NOUN,nsubj,pobj,PRP,NN,1,1
1878,924.0,27,reported,7,10,24,14,9,2,-3,17,Thune,South Dakota,,per-per,PROPN,PROPN-PROPN,compound,compound-compound,NNP,NNP-NNP,2,1
1879,925.0,49,been,2,6,17,11,5,31,-4,15,BBC News,1997,-,per,PROPN-PROPN,NUM,compound-compound,pobj,NNP-NNP,CD,5,1
1880,926.0,41,be,3,16,16,0,15,24,-13,13,British Forces Cyprus,British,--,org,ADJ-PROPN-PROPN,ADJ,compound-compound-pobj,amod,JJ-NNPS-NNP,JJ,0,1
1881,928.0,30,married,4,12,7,-5,11,22,-8,3,Philippines,Adamson University,per,-,PROPN,PROPN-PROPN,pobj,compound-pobj,NNPS,NNP-NNP,4,1
1882,929.0,24,investigating,2,13,13,0,12,10,-11,11,California National Guard,California,org-org-org,,PROPN-PROPN-PROPN,PROPN,compound-compound-pobj,compound,NNP-NNP-NNP,NNP,0,1
1883,5175.0,48,includes,24,11,11,0,10,36,13,-13,California National Guard,California,per-per-per,,PROPN-PROPN-PROPN,PROPN,compound-compound-appos,compound,NNP-NNP-NNP,NNP,0,1
1884,930.0,35,replaced,5,7,20,13,6,14,-2,15,Steinar Eikum,TNT,per-per,,PROPN-PROPN,PROPN,compound-dobj,poss,NNP-NNP,NNP,5,1
1885,931.0,28,has,2,2,7,5,1,20,0,5,University,Matsumoto,,per,PROPN,PROPN,nsubj,compound,NNP,NNP,3,1
1886,932.0,29,was,1,1,12,11,0,16,0,11,JALways,Japan Airlines,,org-org,NOUN,PROPN-PROPN,nsubj,compound-pobj,NNS,NNP-NNP,5,1
1887,933.0,28,identified,3,21,22,1,20,5,-18,19,President,Omar Bongo,,org-org,PROPN,PROPN-PROPN,compound,compound-pobj,NNP,NNP-NNP,1,1
1888,7796.0,34,said,1,24,25,1,23,8,-23,24,President,Omar Bongo,,org-org,PROPN,PROPN-PROPN,compound,compound-poss,NNP,NNP-NNP,1,1
1889,935.0,60,received,3,41,54,13,40,5,-38,51,Actor,Damian Lewis,org,-,PROPN,PROPN-PROPN,pobj,compound-pobj,NNP,NNP-NNP,5,1
1890,936.0,67,With,0,2,11,9,1,55,-2,11,Australia,Joseph Lyons,,org-org,PROPN,PROPN-PROPN,nsubj,compound-nsubj,NNP,NNP-NNP,4,1
1891,6372.0,25,led,5,16,20,4,15,4,-11,15,Australia,Joseph Lyons,org,-,PROPN,PROPN-PROPN,compound,compound-pobj,NNP,NNP-NNP,3,1
1892,9160.0,64,contested,35,18,31,13,17,32,17,-4,Australia,Joseph Lyons,per,-,PROPN,PROPN-PROPN,compound,compound-pobj,NNP,NNP-NNP,12,1
1893,937.0,27,became,4,1,3,2,0,23,3,-1,Bolton,Amir Khan,,per-per,PROPN,PROPN-PROPN,nsubj,compound-dobj,NNP,NNP-NNP,2,1
1894,939.0,24,given,5,13,15,2,12,8,-8,10,Tokyo,Kiyohara Tama,,per-per,PROPN,PROPN-PROPN,pobj,compound-pobj,NNP,NNP-NNP,7,1
1895,940.0,23,Ambassador,3,6,15,9,5,7,-3,12,Nicaragua,Daniel Ortega,,per-per,PROPN,PROPN-PROPN,pobj,compound-pobj,NNP,NNP-NNP,8,1
1896,4651.0,26,established,4,3,19,16,2,6,1,15,Nicaragua,Daniel Ortega,per,-,PROPN,PROPN-PROPN,conj,compound-pobj,NNP,NNP-NNP,4,1
1897,5122.0,34,said,25,1,14,13,0,19,24,-11,Nicaragua,Daniel Ortega,org,-,PROPN,PROPN-PROPN,nsubj,compound-poss,NNP,NNP-NNP,6,1
1898,5461.0,15,called,2,5,8,3,4,6,-3,6,Nicaragua,Daniel Ortega,,org-org,PROPN,PROPN-PROPN,poss,compound-dobj,NNP,NNP-NNP,3,1
1899,6536.0,42,criticized,9,4,23,19,3,18,5,14,Nicaragua,Daniel Ortega,org,-,PROPN,PROPN-PROPN,pobj,compound-dobj,NNP,NNP-NNP,9,1
1900,7524.0,30,claimed,6,3,4,1,2,25,3,-2,Nicaragua,Daniel Ortega,,per-per,PROPN,PROPN-PROPN,compound,compound-pobj,NNP,NNP-NNP,1,1
1901,8949.0,32,said,5,5,30,25,4,1,0,25,Nicaragua,Daniel Ortega,per,-,PROPN,PROPN-PROPN,pobj,compound-pobj,NNP,NNP-NNP,13,1
1902,10114.0,22,require,4,11,14,3,10,7,-7,10,Nicaragua,Daniel Ortega,per,-,PROPN,PROPN-PROPN,poss,compound-compound,NNP,NNP-NNP,4,1
1903,11170.0,27,founded,11,9,10,1,8,16,2,-1,Nicaragua,Daniel Ortega,org,-,PROPN,PROPN-PROPN,compound,compound-pobj,NNP,NNP-NNP,1,1
1904,11318.0,29,said,4,1,3,2,0,25,3,-1,Nicaragua,Daniel Ortega,org,-,PROPN,PROPN-PROPN,compound,compound-nsubj,NNP,NNP-NNP,1,1
1905,13004.0,31,vowed,7,11,17,6,10,13,-4,10,Nicaragua,Daniel Ortega,per,-,PROPN,PROPN-PROPN,nsubj,compound-pobj,NNP,NNP-NNP,2,1
1906,13840.0,29,presented,5,10,27,17,9,1,-5,22,Nicaragua,Daniel Ortega,,per-per,PROPN,PROPN-PROPN,poss,compound-pobj,NNP,NNP-NNP,8,1
1907,941.0,26,is,4,1,1,0,0,24,3,-3,Cheyenne East High School,Cheyenne,---,per,PROPN-PROPN-PROPN-PROPN,PROPN,compound-compound-compound-nsubj,compound,NNP-NNP-NNP-NNP,NNP,0,1
1908,942.0,38,said,12,7,8,1,6,29,5,-4,MediaCorp,News,,per,PROPN,PROPN,compound,pobj,NNP,NNP,2,1
1909,943.0,36,include,7,5,18,13,4,17,2,11,New York Air,National Guard,--,per-per,PROPN-PROPN-PROPN,PROPN-PROPN,compound-compound-compound,compound-conj,NNP-NNP-NNP,NNP-NNP,7,1
1910,944.0,37,were,16,28,34,6,27,2,-12,18,Casimir IV Jagiellon,Elisabeth of Austria,--,per-per-per,PROPN-PROPN-PROPN,PROPN-ADP-PROPN,compound-compound-pobj,conj-prep-pobj,NNP-NNP-NNP,NNP-IN-NNP,4,1
1911,945.0,57,was,8,7,29,22,6,27,1,21,Little Pattie,Australia,org-org,,PROPN-PROPN,PROPN,compound-nsubj,compound,NNP-NNP,NNP,9,1
1912,11988.0,39,received,2,1,10,9,0,28,1,8,Little Pattie,Australia,org-org,,PROPN-PROPN,PROPN,compound-nsubj,pobj,NNP-NNP,NNP,2,1
1913,946.0,23,1745,0,3,18,15,2,4,-3,18,Robert Walpole,Exchequer,org-org,,PROPN-PROPN,PROPN,compound-compound,pobj,NNP-NNP,NNP,2,1
1914,947.0,43,shared,1,20,23,3,19,19,-19,22,Carlos Prieto,cellist,org-org,,PROPN-PROPN,NOUN,compound-dep,ROOT,NNP-NNP,NN,1,1
1915,948.0,20,spent,1,6,13,7,5,6,-5,12,1981,Washington Diplomats,per,-,NUM,PROPN-PROPN,pobj,compound-pobj,CD,NNP-NNPS,2,1
1916,949.0,15,Minister,5,2,9,7,1,5,3,4,Edward Heath,United Kingdom,per-per,-,PROPN-PROPN,PROPN-PROPN,compound-compound,compound-pobj,NNP-NNP,NNP-NNP,4,1
1917,950.0,29,have,4,10,26,16,9,2,-6,22,North London,Arsenal,per-per,,PROPN-PROPN,PROPN,compound-pobj,pobj,NNP-NNP,NNP,9,1
1918,951.0,29,forced,9,11,28,17,10,0,-2,19,Honda,Tokyo,per,,PROPN,PROPN,dobj,pobj,NNP,NNP,4,1
1919,952.0,27,declined,21,3,6,3,2,20,18,-15,National Intelligence,John Negroponte,-,org-org,PROPN-PROPN,PROPN-PROPN,compound-compound,compound-pobj,NNP-NNP,NNP-NNP,2,1
1920,2485.0,37,came,3,9,12,3,8,24,-6,9,National Intelligence,John Negroponte,-,per-per,PROPN-PROPN,PROPN-PROPN,compound-compound,compound-nsubj,NNP-NNP,NNP-NNP,2,1
1921,4558.0,31,played,8,13,25,12,12,5,-5,17,National Intelligence,John Negroponte,org-org,-,PROPN-PROPN,PROPN-PROPN,compound-compound,compound-pobj,NNP-NNP,NNP-NNP,9,1
1922,12070.0,55,participated,8,27,35,8,26,19,-19,27,National Intelligence,John Negroponte,org-org,-,PROPN-PROPN,PROPN-PROPN,compound-compound,compound-pobj,NNP-NNP,NNP-NNP,5,1
1923,953.0,30,is,17,15,24,9,14,5,2,7,South Park Mexican,Dope House Records,per-per-per,--,PROPN-PROPN-PROPN,PROPN-PROPN-PROPN,compound-compound-pobj,compound-compound-pobj,NNP-NNP-NNP,NNP-NNP-NNPS,10,1
1924,954.0,34,is,9,12,32,20,11,1,-3,23,New Zealand,Heartland Championship,-,per-per,PROPN-PROPN,PROPN-PROPN,compound-compound,compound-pobj,NNP-NNP,NNP-NNP,4,1
1925,955.0,29,criticized,6,2,4,2,1,24,4,-2,Finance,Wouter Bos,org,-,PROPN,PROPN-PROPN,compound,compound-nsubj,NNP,NNP-NNP,1,1
1926,3377.0,31,called,7,5,6,1,4,24,2,-1,Finance,Wouter Bos,,org-org,PROPN,PROPN-PROPN,pobj,compound-nsubj,NNP,NNP-NNP,1,1
1927,4310.0,32,sounded,6,2,4,2,1,27,4,-2,Finance,Wouter Bos,,per-per,PROPN,PROPN-PROPN,compound,compound-nsubj,NNP,NNP-NNP,1,1
1928,8478.0,13,announced,4,1,3,2,0,9,3,-1,Finance,Wouter Bos,per,-,PROPN,PROPN-PROPN,compound,compound-nsubj,NNP,NNP-NNP,1,1
1929,10535.0,24,facing,5,10,12,2,9,11,-5,7,Finance,Wouter Bos,,per-per,PROPN,PROPN-PROPN,compound,compound-nsubj,NNP,NNP-NNP,1,1
1930,10920.0,29,announced,10,7,9,2,6,19,3,-1,Finance,Wouter Bos,,per-per,PROPN,PROPN-PROPN,compound,compound-nsubj,NNP,NNP-NNP,1,1
1931,12209.0,24,said,13,10,12,2,9,11,3,-1,Finance,Wouter Bos,per,-,PROPN,PROPN-PROPN,compound,compound-nsubj,NNP,NNP-NNP,1,1
1932,12401.0,18,says,4,1,3,2,0,14,3,-1,Finance,Wouter Bos,org,-,PROPN,PROPN-PROPN,compound,compound-nsubj,NNP,NNP-NNP,1,1
1933,12411.0,22,said,10,7,9,2,6,12,3,-1,Finance,Wouter Bos,per,-,PROPN,PROPN-PROPN,compound,compound-nsubj,NNP,NNP-NNP,1,1
1934,14035.0,27,said,5,2,4,2,1,22,3,-1,Finance,Wouter Bos,,per-per,PROPN,PROPN-PROPN,compound,compound-nsubj,NNP,NNP-NNP,1,1
1935,956.0,21,announced,2,1,19,18,0,1,1,17,Oscar Temaru,French Polynesia,-,per-per,PROPN-PROPN,PROPN-PROPN,compound-nsubj,amod-pobj,NNP-NNP,NNP-NNP,7,1
1936,5233.0,28,had,3,1,12,11,0,15,2,9,Oscar Temaru,French Polynesia,-,per-per,PROPN-PROPN,PROPN-PROPN,compound-nsubj,amod-pobj,NNP-NNP,NNP-NNP,6,1
1937,5968.0,17,was,7,1,15,14,0,1,6,8,Oscar Temaru,French Polynesia,org-org,-,PROPN-PROPN,PROPN-PROPN,compound-nsubj,amod-pobj,NNP-NNP,NNP-NNP,4,1
1938,7483.0,21,elected,6,3,10,7,2,10,3,4,Oscar Temaru,French Polynesia,-,org-org,PROPN-PROPN,PROPN-PROPN,compound-nsubjpass,amod-pobj,NNP-NNP,NNP-NNP,4,1
1939,958.0,21,joined,1,4,12,8,3,8,-3,11,Union,2nd Wisconsin Volunteer Infantry Regiment,,org-org-org-org-org,PROPN,ADJ-PROPN-PROPN-PROPN-PROPN,compound,compound-compound-compound-compound-pobj,NNP,JJ-NNP-NNP-NNP-NNP,6,1
1940,959.0,30,have,5,4,24,20,3,5,1,19,Unibanco,Brazil,,per,PROPN,PROPN,conj,poss,NNP,NNP,8,1
1941,960.0,12,led,1,1,7,6,0,4,0,6,Stetsenko,Ukraine,per,,PROPN,PROPN,nsubj,dobj,NNP,NNP,4,1
1942,961.0,39,insured,6,1,5,4,0,33,5,-1,Bank,Netherlands,,per,NOUN,PROPN,compound,pobj,NN,NNP,2,1
1943,962.0,17,be,11,13,15,2,12,1,-2,4,President,Hosni Mubarak,org,-,PROPN,PROPN-PROPN,compound,compound-attr,NNP,NNP-NNP,1,1
1944,5416.0,23,ordered,4,2,3,1,1,19,2,-1,President,Hosni Mubarak,org,-,PROPN,PROPN-PROPN,compound,compound-nsubj,NNP,NNP-NNP,1,1
1945,5667.0,28,ordered,6,2,3,1,1,24,4,-3,President,Hosni Mubarak,org,-,PROPN,PROPN-PROPN,compound,compound-nsubj,NNP,NNP-NNP,1,1
1946,7606.0,26,Kifaya,0,20,21,1,19,4,-20,21,President,Hosni Mubarak,per,-,PROPN,PROPN-PROPN,compound,compound-pobj,NNP,NNP-NNP,1,1
1947,13857.0,20,Continue,1,8,9,1,7,10,-7,8,President,Hosni Mubarak,,per-per,PROPN,PROPN-PROPN,compound,compound-nsubj,NNP,NNP-NNP,1,1
1948,14216.0,27,opened,10,7,8,1,6,18,3,-2,President,Hosni Mubarak,org,-,PROPN,PROPN-PROPN,compound,compound-appos,NNP,NNP-NNP,1,1
1949,963.0,23,released,1,1,22,21,0,0,0,21,He,Vandit,org,,PRON,PROPN,nsubj,appos,PRP,NNP,1,1
1950,964.0,19,said,7,1,3,2,0,15,6,-4,Byron Grote,BP,per-per,,PROPN-PROPN,PROPN,compound-compound,poss,NNP-NNP,NNP,2,1
1951,965.0,27,signed,8,7,26,19,6,0,1,18,Cummins,China,org,,PROPN,PROPN,compound,appos,NNP,NNP,8,1
1952,966.0,16,',0,11,8,-3,10,7,-11,8,New Zealand,Bic Runga,-,per-per,PROPN-PROPN,PROPN-PROPN,compound-compound,compound-nsubj,NNP-NNP,NNP-NNP,6,1
1953,967.0,42,is,8,1,11,10,0,30,7,3,Jewel,United States,per,-,PROPN,PROPN-PROPN,nsubj,compound-compound,NNP,NNP-NNP,4,1
1954,2639.0,35,Born,0,5,18,13,4,16,-5,18,Jewel,United States,org,-,PROPN,PROPN-PROPN,compound,compound-compound,NNP,NNP-NNP,10,1
1955,7830.0,16,is,3,1,14,13,0,1,2,11,Jewel,United States,per,-,PROPN,PROPN-PROPN,poss,compound-pobj,NNP,NNP-NNP,8,1
1956,968.0,23,said,13,8,12,4,7,10,5,-1,Australian Federal Police,AFP,--,org,PROPN-PROPN-PROPN,PROPN,compound-compound-pobj,appos,NNP-NNP-NNP,NNP,5,1
1957,12124.0,37,began,9,15,19,4,14,17,-6,10,Australian Federal Police,AFP,--,org,PROPN-PROPN-PROPN,PROPN,compound-compound-pobj,appos,NNP-NNP-NNP,NNP,3,1
1958,971.0,37,known,2,19,21,2,18,15,-17,19,INXS,Michael Hutchence,per,-,PROPN,PROPN-PROPN,compound,compound-pobj,NNP,NNP-NNP,1,1
1959,972.0,27,was,9,6,7,1,5,19,3,-2,guitarist,Scotty Moore,org,-,NOUN,PROPN-PROPN,pobj,compound-compound,NN,NNP-NNP,1,1
1960,5282.0,14,began,3,11,12,1,10,1,-8,9,guitarist,Scotty Moore,per,-,NOUN,PROPN-PROPN,compound,compound-pobj,NN,NNP-NNP,1,1
1961,5602.0,24,recorded,5,13,14,1,12,9,-8,9,guitarist,Scotty Moore,org,-,NOUN,PROPN-PROPN,compound,compound-compound,NN,NNP-NNP,1,1
1962,973.0,30,is,3,5,19,14,4,10,-2,16,Psyclon Nine,Metropolis,org-org,,PROPN-PROPN,PROPN,compound-poss,compound,NNP-NNP,NNP,4,1
1963,974.0,39,appeared,25,21,32,11,20,6,4,7,Andrew W.K.,Wolf Eyes,-,per-per,PROPN-PROPN,PROPN-PROPN,compound-compound,compound-compound,NNP-NNP,NNP-NNPS,10,1
1964,976.0,25,chosen,2,5,19,14,4,5,-3,17,Greece,Elena Paparizou,,per-per,PROPN,PROPN-PROPN,nmod,compound-pobj,NNP,NNP-NNP,6,1
1965,977.0,26,named,17,4,13,9,3,12,13,-4,Metropolitan Savings Bank of Brooklyn,HSBC,----,per,PROPN-PROPN-PROPN-ADP-PROPN,PROPN,compound-compound-nsubjpass-prep-pobj,compound,NNP-NNP-NNP-IN-NNP,NNP,5,1
1966,978.0,24,is,1,13,16,3,12,7,-12,15,Vancouver,Jeff Wall,per,-,PROPN,PROPN-PROPN,pobj,compound-nsubj,NNP,NNP-NNP,3,1
1967,979.0,30,was,7,4,19,15,3,10,3,12,Major Soccer League,San Diego Sockers,per-per-per,--,PROPN-PROPN-PROPN,PROPN-PROPN-PROPN,compound-compound-compound,compound-compound-nsubj,NNP-NNP-NNP,NNP-NNP-NNPS,8,1
1968,980.0,41,told,19,14,18,4,13,22,5,-1,India,Shankar,,per,PROPN,PROPN,nmod,compound,NNP,NNP,2,1
1969,981.0,43,pitted,5,34,40,6,33,2,-29,35,New Hampshire,Louis C. Wyman,-,per-per-per,PROPN-PROPN,PROPN-PROPN-PROPN,compound-poss,compound-compound-pobj,NNP-NNP,NNP-NNP-NNP,4,1
1970,982.0,27,recruited,19,2,18,16,1,8,17,-1,Sonny,Kapp,,org,PROPN,PROPN,poss,compound,NNP,NNP,4,1
1971,983.0,71,became,30,26,29,3,25,41,4,-1,Reserve Bank of New Zealand,New Zealand,----,per-per,PROPN-PROPN-ADP-PROPN-PROPN,PROPN-PROPN,compound-pobj-prep-compound-pobj,compound-compound,NNP-NNP-IN-NNP-NNP,NNP-NNP,2,1
1972,4316.0,32,went,9,2,5,3,1,26,7,-4,Reserve Bank of New Zealand,New Zealand,----,org-org,PROPN-PROPN-ADP-PROPN-PROPN,PROPN-PROPN,compound-nsubj-prep-compound-compound,compound-compound,NNP-NNP-IN-NNP-NNP,NNP-NNP,2,1
1973,984.0,34,agreed,1,7,19,12,6,14,-6,18,he,Mauritius,org,,PRON,PROPN,nsubj,pobj,PRP,NNP,3,1
1974,985.0,19,are,3,1,8,7,0,10,2,5,Its,Ohio,,per,DET,PROPN,poss,pobj,PRP$,NNP,5,1
1975,986.0,18,became,1,1,11,10,0,6,0,10,Haiti,Henri Christophe,,per-per,PROPN,PROPN-PROPN,nsubj,compound-nsubj,NNP,NNP-NNP,3,1
1976,4285.0,32,went,5,8,25,17,7,6,-3,20,Haiti,Henri Christophe,,per-per,PROPN,PROPN-PROPN,pobj,compound-pobj,NNP,NNP-NNP,9,1
1977,5084.0,15,talked,2,8,13,5,7,1,-6,11,Haiti,Henri Christophe,per,-,PROPN,PROPN-PROPN,pobj,compound-dobj,NNP,NNP-NNP,3,1
1978,987.0,36,talking,11,2,9,7,1,26,9,-2,Party of Regions,Viktor Yanukovych,per-per-per,-,PROPN-ADP-PROPN,PROPN-PROPN,nsubj-prep-pobj,compound-pobj,NNP-IN-NNPS,NNP-NNP,4,1
1979,988.0,48,graduated,3,39,45,6,38,2,-36,42,Pasadena,Roscoe G. Dickinson,org,--,PROPN,PROPN-PROPN-PROPN,compound,compound-compound-pobj,NNP,NNP-NNP-NNP,7,1
1980,989.0,32,bands,13,1,15,14,0,16,12,2,Cunneen,Final Warning,per,-,PROPN,PROPN-PROPN,nsubjpass,compound-dobj,NNP,NNP-NNP,3,1
1981,990.0,56,consulted,5,41,42,1,40,13,-36,37,Romania,C?lin Popescu-T?ricea,org,-,PROPN,NOUN-PROPN,pobj,nmod-compound,NNP,NN-NNP,2,1
1982,991.0,31,built,7,1,19,18,0,11,6,12,Tate Lyle,Henry Tate,-,per-per,PROPN-PROPN,PROPN-PROPN,compound-poss,compound-appos,NNP-NNP,NNP-NNP,5,1
1983,992.0,28,returned,8,2,4,2,1,23,6,-4,Trojan,Renee,,per,PROPN,PROPN,compound,nmod,NNP,NNP,2,1
1984,994.0,17,met,4,8,15,7,7,1,-4,11,the McGuire Sisters,Phyllis McGuire,per-per-per,-,DET-PROPN-PROPN,PROPN-PROPN,det-compound-pobj,compound-oprd,DT-NNP-NNPS,NNP-NNP,4,1
1985,995.0,16,sentenced,8,1,4,3,0,11,7,-4,Chen,Wu Shu-chen,,per-per,PROPN,PROPN-PROPN,poss,compound-appos,NNP,NNP-NNP,5,1
1986,997.0,51,said,11,13,21,8,12,29,-2,10,Mortimer Zuckerman,Boston Properties,org-org,-,PROPN-PROPN,PROPN-PROPN,compound-nsubj,compound-pobj,NNP-NNP,NNP-NNPS,3,1
1987,998.0,39,arrested,4,1,25,24,0,13,3,21,Brazil,Banco do Brasil,org,--,PROPN,PROPN-VERB-PROPN,poss,nsubj-ROOT-dobj,NNP,NNP-VBP-NNP,4,1
1988,999.0,24,Want,3,14,18,4,13,5,-11,15,Eamon,United States,,org-org,PROPN,PROPN-PROPN,pobj,compound-pobj,NNP,NNP-NNP,2,1
1989,1000.0,42,Service,9,4,7,3,3,34,5,-2,Department of Agriculture,Natural Resources Conservation Service,per-per-per,---,PROPN-ADP-PROPN,PROPN-PROPN-PROPN-PROPN,nmod-prep-compound,compound-pobj-compound-ROOT,NNP-IN-NNP,NNP-NNPS-NNP-NNP,2,1
1990,1001.0,18,lived,8,7,13,6,6,4,1,5,Jan Smuts,South Africa,-,per-per,PROPN-PROPN,PROPN-PROPN,compound-nsubj,compound-poss,NNP-NNP,NNP-NNP,4,1
1991,1002.0,51,discovers,27,2,5,3,1,45,25,-22,Lisbon,de Oliveira Salazar,,org-org-org,PROPN,PROPN-PROPN-PROPN,pobj,compound-compound-poss,NNP,NNP-NNP-NNP,4,1
1992,1003.0,22,Pawe?,0,1,11,10,0,10,-1,11,Pawe? Ma?aszy,44; Pol,-,org-org,PROPN-PROPN,NUM-PROPN,ROOT-compound,nummod-pobj,NNP-NNP,CD-NNP,-1,1
1993,1005.0,24,became,1,5,12,7,4,11,-4,11,producer,he,org,,NOUN,PRON,attr,nsubj,NN,PRP,3,1
1994,1006.0,37,became,6,12,35,23,11,1,-6,29,Foreign Affairs,Elpidio Quirino,per-per,-,PROPN-PROPN,PROPN-PROPN,compound-pobj,compound-pobj,NNP-NNPS,NNP-NNP,8,1
1995,1007.0,35,said,12,16,34,18,15,0,-4,22,Max Baucus,Montana,-,per,PROPN-PROPN,PROPN,compound-compound,pobj,NNP-NNP,NNP,3,1
1996,1174.0,19,said,6,3,6,3,2,12,3,0,Max Baucus,Montana,org-org,,PROPN-PROPN,PROPN,compound-nsubj,pobj,NNP-NNP,NNP,1,1
1997,1656.0,28,ran,3,13,21,8,12,6,-10,18,Max Baucus,Montana,org-org,,PROPN-PROPN,PROPN,compound-pobj,poss,NNP-NNP,NNP,7,1
1998,2787.0,50,blocked,10,46,49,3,45,0,-36,39,Max Baucus,Montana,org-org,,PROPN-PROPN,PROPN,compound-conj,pobj,NNP-NNP,NNP,3,1
1999,2853.0,56,said,23,2,5,3,1,50,21,-18,Max Baucus,Montana,-,per,PROPN-PROPN,PROPN,compound-nsubj,pobj,NNP-NNP,NNP,2,1
2000,3700.0,37,joined,20,5,8,3,4,28,15,-12,Max Baucus,Montana,org-org,,PROPN-PROPN,PROPN,compound-appos,compound,NNP-NNP,NNP,2,1
2001,4203.0,19,joined,5,2,5,3,1,13,3,0,Max Baucus,Montana,-,per,PROPN-PROPN,PROPN,compound-nsubj,pobj,NNP-NNP,NNP,1,1
2002,6507.0,43,was,22,19,22,3,18,20,3,0,Max Baucus,Montana,-,org,PROPN-PROPN,PROPN,compound-nsubj,pobj,NNP-NNP,NNP,1,1
2003,8098.0,54,said,30,3,21,18,2,32,27,-9,Max Baucus,Montana,-,org,PROPN-PROPN,PROPN,compound-compound,pobj,NNP-NNP,NNP,9,1
2004,9311.0,40,Joining,0,11,14,3,10,25,-11,14,Max Baucus,Montana,-,per,PROPN-PROPN,PROPN,compound-dep,pobj,NNP-NNP,NNP,1,1
2005,9379.0,44,said,12,2,5,3,1,38,10,-7,Max Baucus,Montana,-,per,PROPN-PROPN,PROPN,compound-nsubj,compound,NNP-NNP,NNP,1,1
2006,9487.0,27,said,10,2,5,3,1,21,8,-5,Max Baucus,Montana,-,per,PROPN-PROPN,PROPN,compound-nsubj,pobj,NNP-NNP,NNP,1,1
2007,9683.0,28,spoke,2,22,25,3,21,2,-20,23,Max Baucus,Montana,per-per,,PROPN-PROPN,PROPN,compound-conj,pobj,NNP-NNP,NNP,7,1
2008,10026.0,26,were,13,5,8,3,4,17,8,-5,Max Baucus,Montana,-,per,PROPN-PROPN,PROPN,compound-nsubj,pobj,NNP-NNP,NNP,3,1
2009,11372.0,31,includes,3,8,13,5,7,17,-5,10,Max Baucus,Montana,per-per,,PROPN-PROPN,PROPN,compound-pobj,pobj,NNP-NNP,NNP,3,1
2010,11999.0,29,announced,3,8,11,3,7,17,-5,8,Max Baucus,Montana,per-per,,PROPN-PROPN,PROPN,compound-pobj,compound,NNP-NNP,NNP,1,1
2011,1008.0,19,Hooray,5,1,4,3,0,14,4,-1,Wavell School,Hampshire,per-per,,PROPN-PROPN,PROPN,compound-compound,compound,NNP-NNP,NNP,2,1
2012,1009.0,30,hosted,6,25,28,3,24,1,-19,22,Elton John,David Furnish,per-per,-,PROPN-PROPN,PROPN-PROPN,compound-pobj,compound-conj,NNP-NNP,NNP-NNP,1,1
2013,1010.0,23,is,4,2,20,18,1,2,2,16,Blohm + Voss,ThyssenKrupp Marine Systems,--,per-per-per,PROPN-SYM-PROPN,PROPN-PROPN-PROPN,nsubj-cc-conj,compound-compound-pobj,NNP-SYM-NNP,NNP-NNP-NNPS,6,1
2014,1011.0,31,is,5,2,17,15,1,13,3,12,School of Physical Sciences,UCI,---,per,PROPN-ADP-PROPN-PROPN,PROPN,nsubj-prep-compound-pobj,appos,NNP-IN-NNP-NNPS,NNP,7,1
2015,1012.0,30,earmarked,3,6,16,10,5,13,-3,13,Whatman,Maidstone,per,,PROPN,PROPN,compound,pobj,NNP,NNP,2,1
2016,1013.0,20,gained,4,3,15,12,2,4,1,11,Nieto,Mexico,org,,PROPN,PROPN,nsubj,pobj,NNP,NNP,4,1
2017,1014.0,22,launched,3,1,8,7,0,13,2,5,iN Demand,1985,-,per,ADP-PROPN,NUM,prep-pobj,nummod,IN-NNP,CD,3,1
2018,1016.0,20,arranged,1,4,18,14,3,1,-3,17,Bennington,Linkin Park,,org-org,PROPN,PROPN-PROPN,nsubj,compound-pobj,NNP,NNP-NNP,5,1
2019,1017.0,23,agreed,5,15,15,0,14,7,-10,10,Boots Group,Boots,per-per,,PROPN-PROPN,PROPN,compound-compound,compound,NNPS-NNP,NNPS,0,1
2020,1018.0,19,had,7,6,9,3,5,9,1,2,Toronto,him,per,,PROPN,PRON,compound,nsubj,NNP,PRP,4,1
2021,1019.0,31,said,4,1,3,2,0,27,3,-1,Botswana,Ian Khama,org,-,PROPN,PROPN-PROPN,compound,compound-nsubj,NNP,NNP-NNP,1,1
2022,1262.0,13,inaugurated,7,2,6,4,1,6,5,-1,Botswana,Ian Khama,per,-,PROPN,PROPN-PROPN,nsubj,compound-appos,NNP,NNP-NNP,3,1
2023,3570.0,30,promised,6,1,3,2,0,26,5,-3,Botswana,Ian Khama,org,-,PROPN,PROPN-PROPN,compound,compound-nsubj,NNP,NNP-NNP,1,1
2024,8054.0,33,aims,19,6,14,8,5,18,13,-5,Botswana,Ian Khama,,per-per,PROPN,PROPN-PROPN,pobj,compound-poss,NNP,NNP-NNP,6,1
2025,8961.0,18,said,14,11,13,2,10,4,3,-1,Botswana,Ian Khama,per,-,PROPN,PROPN-PROPN,compound,compound-nsubj,NNP,NNP-NNP,1,1
2026,10959.0,33,was,3,13,15,2,12,17,-10,12,Botswana,Ian Khama,,per-per,PROPN,PROPN-PROPN,compound,compound-poss,NNP,NNP-NNP,1,1
2027,1020.0,18,indicates,6,5,10,5,4,7,1,4,Mikhail Gorbachev,Communist Party,-,per-per,PROPN-PROPN,PROPN-PROPN,compound-nsubj,compound-nsubj,NNP-NNP,NNP-NNP,3,1
2028,3877.0,20,named,11,8,18,10,7,1,3,7,Mikhail Gorbachev,Communist Party,-,per-per,PROPN-PROPN,PROPN-PROPN,compound-compound,compound-pobj,NNP-NNP,NNP-NNP,7,1
2029,3881.0,30,brought,2,1,20,19,0,9,1,18,Mikhail Gorbachev,Communist Party,org-org,-,PROPN-PROPN,PROPN-PROPN,compound-nsubj,compound-pobj,NNP-NNP,NNP-NNP,7,1
2030,9755.0,29,held,3,10,16,6,9,12,-7,13,Mikhail Gorbachev,Communist Party,-,per-per,PROPN-PROPN,PROPN-PROPN,compound-nsubj,compound-poss,NNP-NNP,NNP-NNP,5,1
2031,13552.0,29,announced,26,17,25,8,16,3,9,-1,Mikhail Gorbachev,Communist Party,per-per,-,PROPN-PROPN,PROPN-PROPN,compound-nsubj,compound-nsubj,NNP-NNP,NNP-NNP,10,1
2032,1021.0,40,confirmed,4,2,18,16,1,21,2,14,Philippine Navy,Rear Admiral,per-per,-,PROPN-PROPN,PROPN-PROPN,compound-nsubj,compound-compound,NNP-NNP,NNP-NNP,7,1
2033,1022.0,34,had,6,27,30,3,26,3,-21,24,Territorial Enterprise,Virginia City,org-org,-,PROPN-PROPN,PROPN-PROPN,compound-pobj,compound-compound,NNP-NNP,NNP-NNP,3,1
2034,1023.0,39,am,1,18,32,14,17,6,-17,31,Hans Blix,International Atomic Energy Agency,-,per-per-per-per,PROPN-PROPN,PROPN-PROPN-PROPN-PROPN,compound-compound,compound-compound-compound-ROOT,NNP-NNP,NNP-NNP-NNP-NNP,6,1
2035,4160.0,37,said,19,1,7,6,0,29,18,-12,Hans Blix,International Atomic Energy Agency,-,org-org-org-org,PROPN-PROPN,PROPN-PROPN-PROPN-PROPN,nsubj-nsubj,compound-compound-compound-pobj,NNP-NNP,NNP-NNP-NNP-NNP,5,1
2036,6296.0,40,said,16,1,7,6,0,32,15,-9,Hans Blix,International Atomic Energy Agency,-,org-org-org-org,PROPN-PROPN,PROPN-PROPN-PROPN-PROPN,nsubj-nsubj,compound-compound-compound-pobj,NNP-NNP,NNP-NNP-NNP-NNP,5,1
2037,6518.0,60,are,2,29,40,11,28,19,-27,38,Hans Blix,International Atomic Energy Agency,-,org-org-org-org,PROPN-PROPN,PROPN-PROPN-PROPN-PROPN,compound-appos,compound-compound-compound-pobj,NNP-NNP,NNP-NNP-NNP-NNP,7,1
2038,8911.0,88,attended,3,68,32,-36,67,55,-65,29,Hans Blix,International Atomic Energy Agency,-,per-per-per-per,PROPN-PROPN,PROPN-PROPN-PROPN-PROPN,compound-conj,compound-compound-compound-pobj,NNP-NNP,NNP-NNP-NNP-NNP,-1,1
2039,10817.0,50,included,2,16,18,2,15,31,-14,16,Hans Blix,International Atomic Energy Agency,-,org-org-org-org,PROPN-PROPN,PROPN-PROPN-PROPN-PROPN,compound-compound,compound-compound-compound-compound,NNP-NNP,NNP-NNP-NNP-NNP,3,1
2040,1024.0,50,Haffenberg,1,7,12,5,6,37,-6,11,CME Group,Chicago Board of Trade,-,per-per-per-per,PROPN-PROPN,PROPN-PROPN-ADP-PROPN,compound-pobj,compound-dobj-prep-pobj,NNP-NNP,NNP-NNP-IN-NNP,2,1
2041,1025.0,33,Title,0,13,24,11,12,8,-13,24,Southern Cross University,Lismore,per-per-per,,PROPN-PROPN-PROPN,PROPN,compound-compound-compound,compound,NNP-NNP-NNP,NNP,3,1
2042,3281.0,52,moved,24,10,13,3,9,38,14,-11,Southern Cross University,Lismore,org-org-org,,PROPN-PROPN-PROPN,PROPN,compound-compound-compound,compound,NNP-NNP-NNP,NNP,6,1
2043,1026.0,22,held,6,14,15,1,13,6,-8,9,Leipzig,Felix Mendelssohn College of Music and Theatre,org,------,PROPN,PROPN-PROPN-PROPN-ADP-PROPN-CCONJ-PROPN,compound,compound-compound-pobj-prep-pobj-cc-conj,NNP,NNP-NNP-NNP-IN-NNP-CC-NNP,2,1
2044,1027.0,15,released,7,3,13,10,2,1,4,6,her,Capitol,org,,DET,PROPN,poss,compound,PRP$,NNP,5,1
2045,1028.0,25,represent,6,2,12,10,1,12,4,6,Missouri State Bears,Springfield,per-per-per,,PROPN-PROPN-PROPN,PROPN,compound-compound-compound,pobj,NNP-NNP-NNPS,NNP,5,1
2046,1029.0,27,Sight-seeing,0,4,8,4,3,18,-4,8,Woody Harrelson,Laura Louie,org-org,-,PROPN-PROPN,PROPN-PROPN,compound-ROOT,compound-compound,NNP-NNP,NNP-NNP,3,1
2047,1030.0,13,has,4,1,3,2,0,9,3,-1,Williams Lake,British Columbia,org-org,-,PROPN-PROPN,PROPN-PROPN,compound-compound,compound-nsubj,NNP-NNP,NNP-NNP,1,1
2048,1031.0,32,initiated,7,23,30,7,22,1,-16,23,Israel,Yitzhak Rabin,,org-org,PROPN,PROPN-PROPN,poss,compound-pobj,NNP,NNP-NNP,6,1
2049,7118.0,32,calls,17,8,27,19,7,4,9,10,Israel,Yitzhak Rabin,per,-,PROPN,PROPN-PROPN,compound,compound-pobj,NNP,NNP-NNP,8,1
2050,9220.0,40,is,1,3,24,21,2,15,-2,23,Israel,Yitzhak Rabin,,org-org,PROPN,PROPN-PROPN,poss,compound-pobj,NNP,NNP-NNP,7,1
2051,12764.0,25,says,4,1,12,11,0,12,3,8,Israel,Yitzhak Rabin,org,-,PROPN,PROPN-PROPN,poss,compound-appos,NNP,NNP-NNP,7,1
2052,1032.0,41,excellent,1,11,15,4,10,25,-10,14,Elvis Presley,USA,per-per,,PROPN-PROPN,PROPN,compound-nsubj,pobj,NNP-NNP,NNP,2,1
2053,1034.0,28,selected,11,1,20,19,0,7,10,9,Koh,Penang,per,,PROPN,PROPN,nsubjpass,pobj,NNP,NNP,4,1
2054,1790.0,22,encouraged,3,5,8,3,4,13,-2,5,Koh,Penang,org,,PROPN,PROPN,dobj,dobj,NNP,NNP,3,1
2055,1035.0,46,renamed,14,1,23,22,0,22,13,9,No. 14 Squadron,Tiedustelulentolaivue,org-org-org,,NOUN-NUM-PROPN,PROPN,nmod-nummod-nsubj,npadvmod,NN-CD-NNP,NNP,-1,1
2056,1036.0,62,Joe,1,50,51,1,49,10,-49,50,Hacksaw,Jim Duggan,,per-per,PROPN,PROPN-PROPN,compound,compound-conj,NNP,NNP-NNP,1,1
2057,1037.0,24,attended,1,18,22,4,17,1,-17,21,Mount Union College,Alliance,per-per-per,,PROPN-PROPN-PROPN,PROPN,compound-compound-pobj,compound,NNP-NNP-NNP,NNP,2,1
2058,1038.0,23,had,12,6,11,5,5,11,6,-1,Chinatown,SVCMC,per,,PROPN,PROPN,compound,nsubj,NNP,NNP,5,1
2059,1039.0,35,served,6,5,18,13,4,16,1,12,Judge,United States,per,-,PROPN,PROPN-PROPN,compound,compound-compound,NNP,NNP-NNP,4,1
2060,1040.0,17,was,4,9,16,7,8,0,-5,12,David Peterson,Ontario,org-org,,PROPN-PROPN,PROPN,compound-attr,pobj,NNP-NNP,NNP,2,1
2061,6492.0,43,says,11,13,19,6,12,23,-2,8,David Peterson,Ontario,per-per,,PROPN-PROPN,PROPN,compound-nsubj,pobj,NNP-NNP,NNP,2,1
2062,1041.0,45,was,1,10,29,19,9,15,-9,28,High Court,Edmund Barton,-,per-per,PROPN-PROPN,PROPN-PROPN,compound-pobj,compound-compound,NNP-NNP,NNP-NNP,15,1
2063,1442.0,44,were,26,10,28,18,9,15,16,2,High Court,Edmund Barton,-,per-per,PROPN-PROPN,PROPN-PROPN,compound-pobj,compound-compound,NNP-NNP,NNP-NNP,10,1
2064,3228.0,24,were,8,7,17,10,6,6,1,9,High Court,Edmund Barton,per-per,-,PROPN-PROPN,PROPN-PROPN,compound-pobj,compound-appos,NNP-NNP,NNP-NNP,4,1
2065,4955.0,35,was,1,9,23,14,8,11,-8,22,High Court,Edmund Barton,-,per-per,PROPN-PROPN,PROPN-PROPN,compound-pobj,compound-compound,NNP-NNP,NNP-NNP,10,1
2066,9933.0,39,developed,1,10,30,20,9,8,-9,29,High Court,Edmund Barton,org-org,-,PROPN-PROPN,PROPN-PROPN,compound-pobj,compound-conj,NNP-NNP,NNP-NNP,7,1
2067,1042.0,45,consists,2,9,9,0,8,35,-7,7,University of Alaska,University of Alaska Anchorage,org-org-org,---,PROPN-ADP-PROPN,PROPN-ADP-PROPN-PROPN,nmod-prep-pobj,nmod-prep-pobj-conj,NNP-IN-NNP,NNP-IN-NNP-NNP,0,1
2068,1043.0,34,has,9,20,32,12,19,1,-11,23,France,nationale d'administration,,org-org,PROPN,ADJ-NOUN,poss,amod-conj,NNP,JJ-NN,9,1
2069,1044.0,27,started,3,21,25,4,20,1,-18,22,Ritz Newspaper,David Bailey,per-per,-,PROPN-PROPN,PROPN-PROPN,compound-pobj,compound-pobj,NNP-NNP,NNP-NNP,3,1
2070,1045.0,20,located,15,2,9,7,1,10,13,-6,Vesey,Sutton Coldfield Grammar School for Girls,per,-----,PROPN,PROPN-PROPN-PROPN-PROPN-ADP-NOUN,poss,compound-compound-compound-conj-prep-pobj,NNP,NNP-NNP-NNP-NNP-IN-NNS,5,1
2071,1046.0,18,is,5,1,16,15,0,1,4,11,John F. Kennedy High School,United States,----,per-per,PROPN-PROPN-PROPN-PROPN-PROPN,PROPN-PROPN,compound-compound-compound-compound-nsubj,compound-pobj,NNP-NNP-NNP-NNP-NNP,NNP-NNP,6,1
2072,1047.0,32,spelled,4,19,22,3,18,9,-15,18,Continental Army,George Washington,org-org,-,PROPN-PROPN,PROPN-PROPN,compound-pobj,compound-pobj,NNP-NNP,NNP-NNP,4,1
2073,8270.0,54,was,6,17,26,9,16,27,-11,20,Continental Army,George Washington,org-org,-,PROPN-PROPN,PROPN-PROPN,compound-pobj,compound-pobj,NNP-NNP,NNP-NNP,8,1
2074,11099.0,16,supplied,1,4,14,10,3,1,-3,13,Continental Army,George Washington,-,org-org,PROPN-PROPN,PROPN-PROPN,compound-compound,compound-pobj,NNP-NNP,NNP-NNP,5,1
2075,12046.0,46,is,1,20,32,12,19,13,-19,31,Continental Army,George Washington,per-per,-,PROPN-PROPN,PROPN-PROPN,compound-pobj,compound-pobj,NNP-NNP,NNP-NNP,8,1
2076,12544.0,37,had,1,7,17,10,6,19,-6,16,Continental Army,George Washington,-,per-per,PROPN-PROPN,PROPN-PROPN,compound-pobj,compound-compound,NNP-NNP,NNP-NNP,6,1
2077,1048.0,35,Born,0,4,22,18,3,12,-4,22,Nova Scotia,Acadia University,-,org-org,PROPN-PROPN,PROPN-PROPN,compound-pobj,nmod-nmod,NNP-NNP,NNP-NNP,-1,1
2078,1049.0,25,joined,4,6,17,11,5,7,-2,13,Guns N ' Roses,Izzy Stradlin,org-org-org-org,-,PROPN-PROPN-PUNCT-NOUN,PROPN-PROPN,compound-poss-case-dobj,compound-pobj,NNP-NNP-''-NNS,NNP-NNP,4,1
2079,3277.0,24,is,4,13,18,5,12,5,-9,14,Guns N ' Roses,Izzy Stradlin,org-org-org-org,-,PROPN-PROPN-PART-PROPN,PROPN-PROPN,compound-poss-punct-compound,compound-pobj,NNP-NNP-POS-NNPS,NNP-NNP,3,1
2080,5484.0,43,is,2,8,16,8,7,26,-6,14,Guns N ' Roses,Izzy Stradlin,per-per-per-per,-,PROPN-PROPN-PART-PROPN,PROPN-PROPN,compound-subtok-pobj-compound,compound-pobj,NNPS-NNP-POS-NNP,NNP-NNP,4,1
2081,1050.0,43,was,10,1,14,13,0,28,9,4,Glenn Corbett,actor,-,org,PROPN-PROPN,NOUN,compound-nsubj,attr,NNP-NNP,NN,4,1
2082,1051.0,25,announced,1,7,17,10,6,7,-6,16,United States,Major League Baseball,org-org,--,PROPN-PROPN,PROPN-PROPN-PROPN,compound-pobj,compound-compound-compound,NNP-NNP,NNP-NNP-NNP,7,1
2083,1052.0,19,is,3,1,8,7,0,10,2,5,Wirreanda High School,South Australia,--,per-per,PROPN-PROPN-PROPN,PROPN-PROPN,compound-compound-nsubj,nmod-nmod,NNP-NNP-NNP,NNP-NNP,5,1
2084,12611.0,20,is,3,1,12,11,0,7,2,9,Wirreanda High School,South Australia,--,per-per,PROPN-PROPN-PROPN,PROPN-PROPN,compound-compound-nsubj,compound-pobj,NNP-NNP-NNP,NNP-NNP,7,1
2085,1054.0,39,told,7,1,6,5,0,32,6,-1,RIM,Mike Lazaridis,,per-per,NOUN,PROPN-PROPN,compound,compound-appos,NN,NNP-NNP,1,1
2086,1055.0,23,met,16,1,6,5,0,16,15,-10,Xiao Yang,Supreme People's Court,per-per,--,PROPN-PROPN,PROPN-PROPN-PROPN,compound-nsubj,compound-compound-pobj,NNP-NNP,NNP-NNP-NNP,4,1
2087,1842.0,23,was,11,1,18,17,0,4,10,7,Xiao Yang,Supreme People's Court,per-per,--,PROPN-PROPN,PROPN-PROPN-PROPN,compound-nsubj,compound-compound-pobj,NNP-NNP,NNP-NNP-NNP,5,1
2088,1056.0,21,featured,2,18,19,1,17,1,-16,17,Quebec,Jacques Parizeau,,org-org,PROPN,PROPN-PROPN,compound,compound-pobj,NNP,NNP-NNP,1,1
2089,1057.0,38,said,28,16,19,3,15,18,12,-9,Ben Cardin,Maryland,org-org,,PROPN-PROPN,PROPN,compound-nmod,pobj,NNP-NNP,NNP,2,1
2090,1058.0,53,included,9,25,28,3,24,24,-16,19,Kelly Ripa,Mark Consuelos,per-per,-,PROPN-PROPN,PROPN-PROPN,compound-appos,compound-conj,NNP-NNP,NNP-NNP,2,1
2091,1059.0,21,is,6,6,12,6,5,8,0,6,Vertu,Nokia,org,,PROPN,PROPN,nsubj,pobj,NNP,NNP,1,1
2092,1060.0,54,attended,12,18,35,17,17,18,-6,23,State Peace and Development Council,Maung Aye,per-per-per-per-per,-,PROPN-PROPN-CCONJ-PROPN-PROPN,PROPN-PROPN,nmod-nmod-cc-conj-pobj,compound-compound,NNP-NNP-CC-NNP-NNP,NNP-NNP,7,1
2093,1061.0,25,worked,2,6,23,17,5,1,-4,21,Andrew Bonar Law,United Kingdom,--,per-per,PROPN-PROPN-PROPN,PROPN-PROPN,compound-compound-nsubj,compound-pobj,NNP-NNP-NNP,NNP-NNP,7,1
2094,12643.0,65,appear,13,39,63,24,38,1,-26,50,Andrew Bonar Law,United Kingdom,--,org-org,PROPN-PROPN-PROPN,PROPN-PROPN,compound-compound-pobj,compound-pobj,NNP-NNP-NNP,NNP-NNP,11,1
2095,1062.0,26,is,1,1,22,21,0,3,0,21,Linksys,Cisco Systems,per,-,PROPN,PROPN-PROPN,nsubj,compound-pobj,NNP,NNP-NNP,5,1
2096,8349.0,14,marketed,3,7,10,3,6,3,-4,7,Linksys,Cisco Systems,per,-,PROPN,PROPN-PROPN,compound,compound-pobj,NNP,NNP-NNP,2,1
2097,1063.0,25,favors,4,1,3,2,0,21,3,-1,Allard,Loveland,per,,PROPN,PROPN,advmod,compound,NNP,NNP,1,1
2098,1065.0,25,caused,8,4,19,15,3,5,4,11,his,England,,per,DET,PROPN,poss,pobj,PRP$,NNP,3,1
2099,9497.0,18,returned,4,2,7,5,1,10,2,3,his,England,per,,DET,PROPN,poss,pobj,PRP$,NNP,3,1
2100,1066.0,44,consists,20,17,18,1,16,25,3,-2,Interior,Stanley K. Hathaway,per,--,PROPN,PROPN-PROPN-PROPN,pobj,compound-compound-conj,NNP,NNP-NNP-NNP,2,1
2101,1067.0,23,said,21,3,21,18,2,1,18,0,Abkhazia,Tsugba,,org,PROPN,PROPN,poss,nsubj,NNP,NNP,6,1
2102,1068.0,42,BP,0,7,10,3,6,31,-7,10,Mikhail Fridman,Alfa Group,per-per,-,PROPN-PROPN,PROPN-PROPN,compound-appos,nmod-nmod,NNP-NNP,NNP-NNP,2,1
2103,4620.0,37,say,1,18,21,3,17,15,-17,20,Mikhail Fridman,Alfa Group,-,per-per,PROPN-PROPN,PROPN-PROPN,compound-poss,compound-conj,NNP-NNP,NNP-NNP,3,1
2104,5010.0,26,swirling,3,21,24,3,20,1,-18,21,Mikhail Fridman,Alfa Group,-,org-org,PROPN-PROPN,PROPN-PROPN,compound-poss,compound-pobj,NNP-NNP,NNP-NNP,3,1
2105,6794.0,24,include,1,12,15,3,11,8,-11,14,Mikhail Fridman,Alfa Group,-,org-org,PROPN-PROPN,PROPN-PROPN,compound-conj,compound-pobj,NNP-NNP,NNP-NNP,2,1
2106,11174.0,25,are,2,14,18,4,13,6,-12,16,Mikhail Fridman,Alfa Group,org-org,-,PROPN-PROPN,PROPN-PROPN,compound-pobj,compound-pobj,NNP-NNP,NNP-NNP,4,1
2107,13479.0,41,comprising,3,5,8,3,4,32,-2,5,Mikhail Fridman,Alfa Group,-,per-per,PROPN-PROPN,PROPN-PROPN,compound-poss,compound-compound,NNP-NNP,NNP-NNP,2,1
2108,13662.0,26,owned,3,14,17,3,13,8,-11,14,Mikhail Fridman,Alfa Group,-,org-org,PROPN-PROPN,PROPN-PROPN,compound-poss,nmod-nmod,NNP-NNP,NNP-NNP,4,1
2109,1069.0,19,is,4,1,1,0,0,17,3,-3,Middlebury College,Middlebury,org-org,,PROPN-PROPN,PROPN,compound-compound,compound,NNP-NNP,NNP,0,1
2110,1070.0,29,STUBBS,1,4,20,16,3,8,-3,19,Levi Stubbs,Motown,per-per,,PROPN-PROPN,PROPN,compound-nsubj,compound,NNP-NNP,NNP,6,1
2111,8043.0,43,were,40,20,34,14,19,8,20,-6,Levi Stubbs,Motown,-,org,PROPN-PROPN,PROPN,compound-conj,compound,NNP-NNP,NNP,8,1
2112,1071.0,18,born,3,1,17,16,0,0,2,14,Sanya Dharmasakti,Thailand,org-org,,PROPN-PROPN,PROPN,compound-nsubjpass,pobj,NNP-NNP,NNP,2,1
2113,1073.0,45,consisted,9,8,9,1,7,35,1,0,President,Bachelet,,org,PROPN,PROPN,compound,pobj,NNP,NNP,4,1
2114,1074.0,25,appears,2,1,12,11,0,12,1,10,He,Uppsala University,org,-,PRON,PROPN-PROPN,nsubj,compound-pobj,PRP,NNP-NNP,5,1
2115,1075.0,32,carried,12,8,11,3,7,20,4,-1,Hindustan Aeronautics Limited,Bangalore,per-per-per,,PROPN-PROPN-PROPN,PROPN,compound-compound-compound,pobj,NNP-NNP-NNP,NNP,8,1
2116,1076.0,28,?ento,0,13,17,4,12,10,-13,17,to Macedon,nd Lazar,per-per,-,ADP-PROPN,PROPN-PROPN,prep-pobj,compound-dobj,IN-NNP,NNP-NNP,6,1
2117,1078.0,17,was,3,11,15,4,10,1,-8,12,Texas,H-E-B,,per,PROPN,ADJ,compound,compound,NNP,JJ,5,1
2118,1080.0,22,succeeded,2,4,11,7,3,10,-2,9,Rugova,Kosovo,org,,PROPN,PROPN,dobj,pobj,NNP,NNP,4,1
2119,1081.0,12,founded,2,1,8,7,0,3,1,6,Gristedes,Diedrich,,per,NOUN,PROPN,nsubjpass,pobj,NNS,NNP,4,1
2120,1082.0,14,was,5,8,13,5,7,0,-3,8,Uruguayan,Torres,,per,ADJ,PROPN,amod,pobj,JJ,NNP,2,1
2121,1083.0,82,got,34,8,19,11,7,62,26,-15,Sierra Leone,Solomon Berewa,-,org-org,PROPN-PROPN,PROPN-PROPN,compound-compound,compound-pobj,NNP-NNP,NNP-NNP,4,1
2122,1084.0,13,is,2,1,10,9,0,2,1,8,Bison B.C.,British Columbia,org-org,-,PROPN-PROPN,PROPN-PROPN,compound-nsubj,compound-compound,NNP-NNP,NNP-NNP,5,1
2123,1086.0,21,founded,2,17,20,3,16,0,-15,18,Celtel,1998,org,,PROPN,NUM,compound,pobj,NNP,CD,6,1
2124,1087.0,30,carrying,8,4,6,2,3,23,4,-2,1949,college,,per,NUM,NOUN,nummod,nsubj,CD,NN,3,1
2125,1088.0,21,From,0,6,9,3,5,11,-6,9,Runa Laila,Bangladesh,-,per,PROPN-PROPN,PROPN,compound-pobj,compound,NNP-NNP,NNP,3,1
2126,1089.0,20,launched,9,1,7,6,0,12,8,-2,Turkey,Turksat,per,,PROPN,PROPN,poss,compound,NNP,NNP,3,1
2127,1090.0,37,ruled,3,1,12,11,0,24,2,9,Mauritania,Ely Ould Mohamed Vall,per,---,PROPN,PROPN-PROPN-PROPN-PROPN,nsubjpass,compound-compound-compound-pobj,NNP,NNP-NNP-NNP-NNP,5,1
2128,1091.0,27,fighting,4,14,25,11,13,1,-10,21,Afghanistan,Mohammad Najibullah,org,-,PROPN,PROPN-PROPN,pobj,compound-pobj,NNP,NNP-NNP,7,1
2129,6927.0,28,was,1,25,26,1,24,1,-24,25,Afghanistan,Mohammad Najibullah,org,-,PROPN,PROPN-PROPN,pobj,compound-pobj,NNP,NNP-NNP,1,1
2130,7488.0,30,taken,23,8,15,7,7,14,15,-8,Afghanistan,Mohammad Najibullah,,per-per,PROPN,PROPN-PROPN,pobj,compound-poss,NNP,NNP-NNP,5,1
2131,1092.0,41,are,9,9,32,23,8,8,0,23,Cameroon,Paul Biya,,org-org,PROPN,PROPN-PROPN,pobj,nmod-nmod,NNP,NNP-NNP,4,1
2132,7306.0,27,said,25,3,5,2,2,21,22,-20,Cameroon,Paul Biya,,org-org,NOUN,PROPN-PROPN,compound,compound-appos,NN,NNP-NNP,1,1
2133,9350.0,51,expected,23,17,35,18,16,15,6,12,Cameroon,Paul Biya,,org-org,PROPN,PROPN-PROPN,poss,compound-appos,NNP,NNP-NNP,15,1
2134,1093.0,36,expresses,6,12,32,20,11,3,-6,26,Ruth Hassell-Thompson,New York,per-per,-,PROPN-PROPN,PROPN-PROPN,compound-pobj,compound-compound,NNP-NNP,NNP-NNP,13,1
2135,1094.0,81,founded,3,1,11,10,0,69,2,8,Incheon,University of Incheon,,org-org-org,PROPN,PROPN-ADP-PROPN,compound,appos-prep-pobj,NNP,NNP-IN-NNP,6,1
2136,1095.0,50,During,0,24,30,6,23,19,-24,30,Papua New Guinea,Air Niugini,--,per-per,PROPN-PROPN-PROPN,PROPN-PROPN,compound-compound-conj,compound-nsubj,NNP-NNP-NNP,NNP-NNP,5,1
2137,1096.0,20,was,1,11,17,6,10,2,-10,16,Republican,Eisenhower,,per,PROPN,PROPN,compound,poss,NNP,NNP,9,1
2138,1097.0,20,is,3,13,19,6,12,0,-10,16,Daniel,Audiogram,,per,PROPN,PROPN,nsubj,pobj,NNP,NNP,3,1
2139,1098.0,27,joined,1,1,22,21,0,4,0,21,Ludlam,New York,per,-,PROPN,PROPN-PROPN,nsubj,compound-compound,NNP,NNP-NNP,4,1
2140,1099.0,24,is,8,16,21,5,15,2,-8,13,Canada,Jean,,org,PROPN,PROPN,pobj,pobj,NNP,NNP,1,1
2141,1100.0,36,criticized,15,30,31,1,29,4,-15,16,President,Daniel Ortega,,org-org,PROPN,PROPN-PROPN,compound,compound-dobj,NNP,NNP-NNP,1,1
2142,1101.0,25,owned,2,5,5,0,4,19,-3,3,Bristol,Bristol Broadcasting Company,,per-per-per,PROPN,PROPN-PROPN-PROPN,compound,compound-compound-pobj,NNP,NNP-NNP-NNP,0,1
2143,1102.0,26,is,6,2,6,4,1,19,4,0,Illinois Zephyr,1971,per-per,,PROPN-PROPN,NUM,compound-nsubj,pobj,NNP-NNP,CD,1,1
2144,1103.0,19,is,4,7,9,2,6,9,-3,5,Yes,Rick Wakeman,org,-,INTJ,PROPN-PROPN,det,compound-nsubj,UH,NNP-NNP,1,1
2145,1104.0,41,quoted,2,19,36,17,18,4,-17,34,Nepal,Prachanda,per,,PROPN,PROPN,pobj,appos,NNP,NNP,6,1
2146,1602.0,43,elected,4,3,24,21,2,18,1,20,Nepal,Prachanda,org,,PROPN,PROPN,pobj,nsubj,NNP,NNP,2,1
2147,2025.0,38,party,3,1,17,16,0,20,2,14,Nepal,Prachanda,,org,PROPN,PROPN,poss,nsubjpass,NNP,NNP,3,1
2148,2132.0,10,chairman,3,1,5,4,0,4,2,2,Nepal,Prachanda,org,,PROPN,PROPN,poss,appos,NNP,NNP,2,1
2149,2440.0,55,Nepal-Unified,45,20,37,17,19,17,25,-8,Nepal,Prachanda,per,,PROPN,PROPN,pobj,compound,NNP,NNP,8,1
2150,3739.0,50,made,1,18,25,7,17,24,-17,24,Nepal,Prachanda,,per,PROPN,PROPN,pobj,ROOT,NNP,NNP,6,1
2151,4440.0,37,UCPN-M,11,7,14,7,6,22,4,3,Nepal,Prachanda,,per,PROPN,PROPN,pobj,nsubj,NNP,NNP,4,1
2152,4805.0,31,became,1,6,14,8,5,16,-5,13,Nepal,Prachanda,,per,PROPN,PROPN,pobj,appos,NNP,NNP,2,1
2153,5705.0,50,withdrew,19,11,27,16,10,22,8,8,Nepal,Prachanda,,org,PROPN,PROPN,pobj,appos,NNP,NNP,5,1
2154,6173.0,25,said,6,2,5,3,1,19,4,-1,Nepal,Prachanda,org,,PROPN,PROPN,compound,nsubj,NNP,NNP,4,1
2155,6186.0,30,deplore,8,7,17,10,6,12,1,9,Nepal,Prachanda,per,,PROPN,PROPN,pobj,nsubj,NNP,NNP,3,1
2156,7703.0,52,failed,2,21,29,8,20,22,-19,27,Nepal,Prachanda,,per,PROPN,PROPN,pobj,nmod,NNP,NNP,5,1
2157,8872.0,35,wrote,8,6,28,22,5,6,2,20,Nepal,Prachanda,org,,PROPN,PROPN,nsubj,nsubj,NNP,NNP,5,1
2158,11374.0,30,Congress,1,16,24,8,15,5,-15,23,Nepal,Prachanda,per,,PROPN,PROPN,pobj,nsubj,NNP,NNP,4,1
2159,11379.0,23,said,10,10,15,5,9,7,0,5,Nepal,Prachanda,org,,PROPN,PROPN,pobj,dobj,NNP,NNP,3,1
2160,11591.0,30,Congress,1,16,24,8,15,5,-15,23,Nepal,Prachanda,,per,PROPN,PROPN,pobj,nsubj,NNP,NNP,3,1
2161,11971.0,26,sworn,8,4,7,3,3,18,4,-1,Nepal,Prachanda,per,,PROPN,PROPN,poss,pobj,NNP,NNP,5,1
2162,13513.0,16,is,1,8,15,7,7,0,-7,14,Nepal,Prachanda,per,,PROPN,PROPN,pobj,pobj,NNP,NNP,6,1
2163,13933.0,22,said,12,10,12,2,9,9,2,0,Nepal,Prachanda,,per,PROPN,PROPN,pobj,pobj,NNP,NNP,2,1
2164,14077.0,41,said,9,26,29,3,25,11,-17,20,Nepal,Prachanda,,per,PROPN,PROPN,pobj,dobj,NNP,NNP,2,1
2165,14110.0,52,sworn,8,4,7,3,3,44,4,-1,Nepal,Prachanda,org,,PROPN,PROPN,poss,pobj,NNP,NNP,5,1
2166,1105.0,30,represented,6,3,17,14,2,12,3,11,UMass Minutemen,Division I,-,per-per,PROPN-PROPN,PROPN-PROPN,compound-compound,pobj-compound,NNP-NNP,NNP-NNP,6,1
2167,3933.0,30,represented,6,3,17,14,2,12,3,11,UMass Minutemen,Division I,org-org,-,PROPN-PROPN,PROPN-PROPN,compound-compound,pobj-compound,NNP-NNP,NNP-NNP,6,1
2168,4550.0,30,represented,6,3,17,14,2,12,3,11,UMass Minutemen,Division I,-,org-org,PROPN-PROPN,PROPN-PROPN,compound-compound,compound-compound,NNP-NNP,NNP-NNP,6,1
2169,11903.0,25,represents,6,2,21,19,1,3,4,15,UMass Minutemen,Division I,per-per,-,PROPN-PROPN,PROPN-PRON,compound-compound,pobj-nsubj,NNP-NNP,NNP-PRP,-1,1
2170,1106.0,28,represented,4,18,23,5,17,4,-14,19,AGF,France,,per,PROPN,PROPN,compound,pobj,NNP,NNP,10,1
2171,1107.0,27,convicted,10,4,8,4,3,18,6,-2,Thomas J. Whelan,Jersey City,--,org-org,PROPN-PROPN-PROPN,PROPN-PROPN,compound-compound-nsubjpass,compound-pobj,NNP-NNP-NNP,NNP-NNP,3,1
2172,1108.0,28,accepted,1,10,12,2,9,15,-9,11,Connecticut,Abraham A. Ribicoff,org,--,PROPN,PROPN-PROPN-PROPN,compound,compound-compound-compound,NNP,NNP-NNP-NNP,3,1
2173,1109.0,19,grew,1,1,9,8,0,9,0,8,Cyrus,Tennessee,,per,PROPN,PROPN,nsubj,pobj,NNP,NNP,2,1
2174,11586.0,22,features,3,17,21,4,16,0,-14,18,Cyrus,Tennessee,per,,PROPN,PROPN,nsubj,pobj,NNP,NNP,4,1
2175,1110.0,73,taught,14,6,11,5,5,61,8,-3,Nagano,Shinshu University,,per-per,PROPN,PROPN-PROPN,compound,compound-appos,NNP,NNP-NNP,2,1
2176,1111.0,35,told,29,4,10,6,3,24,25,-19,Carrefour,France,,org,PROPN,PROPN,compound,compound,NNP,NNP,2,1
2177,10509.0,23,ordered,6,8,22,14,7,0,-2,16,Carrefour,France,per,,PROPN,PROPN,dobj,pobj,NNP,NNP,3,1
2178,1112.0,46,is,4,10,15,5,9,30,-6,11,Peter Cetera,Chicago,org-org,,PROPN-PROPN,PROPN,compound-pobj,appos,NNP-NNP,NNP,5,1
2179,3442.0,44,is,3,16,38,22,15,5,-13,35,Peter Cetera,Chicago,per-per,,PROPN-PROPN,PROPN,compound-compound,appos,NNP-NNP,NNP,6,1
2180,3751.0,25,Recorded,0,11,24,13,10,0,-11,24,Peter Cetera,Chicago,-,org,PROPN-PROPN,PROPN,compound-pobj,pobj,NNP-NNP,NNP,3,1
2181,1114.0,42,is,6,2,2,0,1,39,4,-4,Brazilian Navy,Brazilian Naval Aviation,-,per-per-per,ADJ-PROPN,PROPN-PROPN-PROPN,amod-appos,compound-compound-conj,JJ-NNP,NNP-NNP-NNP,0,1
2182,1115.0,9,Ontario,1,2,4,2,1,4,-1,3,Ontario,Wilfrid Laurier,per,-,PROPN,PROPN-PROPN,ROOT,compound-compound,NNP,NNP-NNP,4,1
2183,1116.0,20,said,13,5,11,6,4,8,8,-2,Boston College,William P. Leahy,-,org-org-org,PROPN-PROPN,PROPN-PROPN-PROPN,compound-poss,compound-compound-nsubj,NNP-NNP,NNP-NNP-NNP,3,1
2184,1117.0,14,is,4,1,13,12,0,0,3,9,US Airways,Arizona,org-org,,PROPN-PROPN,PROPN,compound-compound,pobj,NNP-NNP,NNP,3,1
2185,1118.0,36,served,1,8,25,17,7,10,-7,24,Louisiana State University,LSU Tigers,per-per-per,-,PROPN-PROPN-PROPN,PROPN-PROPN,compound-compound-pobj,compound-nmod,NNP-NNP-NNP,NNP-NNP,10,1
2186,1120.0,28,scheduled,4,16,23,7,15,4,-12,19,Equity,Johnson,org,,PROPN,PROPN,compound,nsubj,NNP,NNP,5,1
2187,1121.0,20,is,2,11,18,7,10,1,-9,16,Peter Jackson,Fran Walsh,-,org-org,PROPN-PROPN,PROPN-PROPN,compound-pobj,compound-appos,NNP-NNP,NNP-NNP,6,1
2188,1122.0,28,reported,22,1,20,19,0,7,21,-2,Josef Mikl,Austria,org-org,,PROPN-PROPN,PROPN,compound-nsubj,compound,NNP-NNP,NNP,2,1
2189,1123.0,42,After,0,31,39,8,30,2,-31,39,Provisional Government,Ignacy Daszysk,org-org,-,PROPN-PROPN,PROPN-PROPN,compound-pobj,compound-compound,NNP-NNP,NNP-NNP,5,1
2190,12190.0,29,formed,18,10,26,16,9,2,8,8,Provisional Government,Ignacy Daszysk,-,per-per,PROPN-PROPN,PROPN-PROPN,compound-nsubjpass,compound-compound,NNP-NNP,NNP-NNP,6,1
2191,1124.0,57,was,2,12,35,23,11,21,-10,33,BMC,British Motor Holdings,org,--,PROPN,PROPN-PROPN-PROPN,compound,compound-nmod-dobj,NNP,NNP-NNP-NNPS,12,1
2192,4594.0,24,changed,11,11,16,5,10,7,0,5,BMC,British Motor Holdings,per,--,PROPN,PROPN-PROPN-PROPN,conj,compound-compound-pobj,NNP,NNP-NNP-NNPS,3,1
2193,1125.0,26,won,1,1,9,8,0,16,0,8,Boucher,Swan Districts Football Club,per,---,PROPN,PROPN-PROPN-PROPN-PROPN,nsubj,compound-compound-compound-pobj,NNP,NNP-NNPS-NNP-NNP,4,1
2194,1126.0,18,graduate,10,7,9,2,6,8,3,-1,Osmania University,Hyderabad,-,per,PROPN-PROPN,PROPN,compound-compound,compound,NNP-NNP,NNP,1,1
2195,1127.0,42,signed,12,11,25,14,10,16,1,13,Baku,Ilham Aliyev,,per-per,PROPN,PROPN-PROPN,pobj,compound-pobj,NNP,NNP-NNP,5,1
2196,1128.0,24,Centre,10,16,23,7,15,0,-6,13,University of Western Sydney,Australia,per-per-per-per,,PROPN-ADP-PROPN-PROPN,PROPN,pobj-prep-compound-compound,pobj,NNP-IN-NNP-NNP,NNP,4,1
2197,1129.0,20,began,2,6,13,7,5,6,-4,11,Windsor,Scott D'Amore,,per-per,PROPN,PROPN-PROPN,compound,compound-pobj,NNP,NNP-NNP,5,1
2198,1130.0,29,built,10,2,17,15,1,11,8,7,1832,Gettysburg College,org,-,NUM,PROPN-PROPN,nummod,compound-appos,CD,NNP-NNP,5,1
2199,1131.0,10,is,4,3,6,3,2,3,1,2,Third-Level Institute is,Tipperary Institute,per-per-per,-,PROPN-PROPN-VERB,PROPN-PROPN,compound-nsubj-ROOT,compound-attr,NNP-NNP-VBZ,NNP-NNP,3,1
2200,1132.0,36,said,10,5,9,4,4,26,5,-1,Democratic Party,Albert Ho,org-org,-,PROPN-PROPN,PROPN-PROPN,compound-poss,compound-appos,NNP-NNP,NNP-NNP,2,1
2201,5562.0,28,said,5,1,4,3,0,23,4,-1,Democratic Party,Albert Ho,org-org,-,PROPN-PROPN,PROPN-PROPN,compound-compound,compound-nsubj,NNP-NNP,NNP-NNP,2,1
2202,5889.0,102,Gang,1,27,38,11,26,63,-26,37,Democratic Party,Albert Ho,-,org-org,PROPN-PROPN,PROPN-PROPN,compound-compound,compound-nsubj,NNP-NNP,NNP-NNP,9,1
2203,7419.0,24,said,7,2,6,4,1,17,5,-1,Democratic Party,Albert Ho,per-per,-,PROPN-PROPN,PROPN-PROPN,compound-poss,compound-appos,NNP-NNP,NNP-NNP,2,1
2204,10813.0,28,fear,1,16,19,3,15,8,-15,18,Democratic Party,Albert Ho,-,per-per,PROPN-PROPN,PROPN-PROPN,compound-compound,compound-nsubj,NNP-NNP,NNP-NNP,4,1
2205,11059.0,33,said,5,1,4,3,0,28,4,-1,Democratic Party,Albert Ho,per-per,-,PROPN-PROPN,PROPN-PROPN,compound-compound,compound-nsubj,NNP-NNP,NNP-NNP,2,1
2206,12237.0,23,said,1,18,21,3,17,1,-17,20,Democratic Party,Albert Ho,per-per,-,PROPN-PROPN,PROPN-PROPN,compound-compound,compound-conj,NNP-NNP,NNP-NNP,3,1
2207,1133.0,21,is,2,1,20,19,0,0,1,18,Diana Hayden,India,-,per,PROPN-PROPN,PROPN,compound-nsubj,pobj,NNP-NNP,NNP,2,1
2208,1134.0,25,is,1,1,11,10,0,13,0,10,Scapegoat,Charlotte,org,,PROPN,PROPN,nsubj,compound,NNP,NNP,5,1
2209,1136.0,62,is,3,16,24,8,15,37,-13,21,Savoy,Hank Jones,,org-org,PROPN,PROPN-PROPN,compound,compound-compound,NNP,NNP-NNP,8,1
2210,1137.0,45,competes,7,2,20,18,1,24,5,13,Alabama Crimson Tide,Division I,--,org-org,PROPN-PROPN-PROPN,PROPN-NUM,compound-compound-compound,appos-appos,NNP-NNP-NNP,NNP-CD,-1,1
2211,1138.0,30,is,2,1,29,28,0,0,1,27,University of Mississippi,Oxford,--,per,PROPN-ADP-PROPN,PROPN,nmod-prep-pobj,pobj,NNP-IN-NNP,NNP,2,1
2212,4371.0,18,located,11,8,17,9,7,0,3,6,University of Mississippi,Oxford,per-per-per,,PROPN-ADP-PROPN,PROPN,nsubjpass-prep-pobj,pobj,NNP-IN-NNP,NNP,8,1
2213,1139.0,32,Host,3,6,10,4,5,21,-3,7,Harding University,AR,per-per,,PROPN-PROPN,PROPN,compound-ROOT,parataxis,NNP-NNP,NNP,2,1
2214,1140.0,50,referenced,29,32,45,13,31,4,-3,16,Jimmy Little,Australia,per-per,,PROPN-PROPN,PROPN,compound-compound,poss,NNP-NNP,NNP,-1,1
2215,1141.0,13,was,3,1,12,11,0,0,2,9,Dubrovnik Airline,Croatia,-,per,PROPN-PROPN,PROPN,compound-compound,pobj,NNP-NNP,NNP,3,1
2216,1142.0,22,trading,4,1,19,18,0,2,3,15,FactSet Research Systems,CT,--,per,PROPN-PROPN-PROPN,PROPN,compound-compound-compound,compound,NNP-NNP-NNPS,NNP,8,1
2217,1143.0,26,holds,2,19,24,5,18,1,-17,22,Tulane University,New Orleans,-,org-org,PROPN-PROPN,PROPN-PROPN,compound-compound,compound-pobj,NNP-NNP,NNP-NNP,3,1
2218,1144.0,46,is,1,1,4,3,0,41,0,3,Danko,writer,org,,PROPN,NOUN,nsubj,attr,NNP,NN,2,1
2219,1145.0,16,led,5,8,15,7,7,0,-3,10,Guy Verhofstadt,Belgium,org-org,,PROPN-PROPN,PROPN,compound-pobj,pobj,NNP-NNP,NNP,3,1
2220,1562.0,40,said,38,4,25,21,3,14,34,-13,Guy Verhofstadt,Belgium,-,per,PROPN-PROPN,PROPN,compound-nsubj,dobj,NNP-NNP,NNP,7,1
2221,8796.0,60,resulted,7,44,57,13,43,2,-37,50,Guy Verhofstadt,Belgium,per-per,,PROPN-PROPN,PROPN,compound-pobj,pobj,NNP-NNP,NNP,13,1
2222,1146.0,40,was,5,24,29,5,23,10,-19,24,Chali 2na,Jurassic 5,per-per,-,PROPN-NOUN,PROPN-NUM,compound-pobj,pobj-nummod,NNP-NN,NNP-CD,3,1
2223,5019.0,63,joined,3,57,60,3,56,2,-54,57,Chali 2na,Jurassic 5,-,org-org,PROPN-NOUN,PROPN-NUM,compound-ROOT,appos-nummod,NNP-NN,NNP-CD,-1,1
2224,9388.0,61,is,2,11,14,3,10,46,-9,12,Chali 2na,Jurassic 5,-,org-org,PROPN-NOUN,PROPN-NUM,compound-dobj,pobj-nummod,NNP-NN,NNP-CD,4,1
2225,1147.0,49,argued,2,10,48,38,9,0,-8,46,CPSU,Comintern,org,,PROPN,PROPN,pobj,pobj,NNP,NNP,2,1
2226,1148.0,32,lobbied,17,6,16,10,5,15,11,-1,Phyllis Schlafly,Eagle Forum,org-org,-,PROPN-PROPN,PROPN-PROPN,compound-pobj,compound-pobj,NNP-NNP,NNP-NNP,7,1
2227,1301.0,26,is,2,11,14,3,10,11,-9,12,Phyllis Schlafly,Eagle Forum,per-per,-,PROPN-PROPN,PROPN-PROPN,compound-poss,compound-pobj,NNP-NNP,NNP-NNP,1,1
2228,2037.0,19,carries,6,11,14,3,10,4,-5,8,Phyllis Schlafly,Eagle Forum,-,org-org,PROPN-PROPN,PROPN-PROPN,compound-poss,nmod-nmod,NNP-NNP,NNP-NNP,2,1
2229,2081.0,37,secured,1,8,11,3,7,25,-7,10,Phyllis Schlafly,Eagle Forum,-,org-org,PROPN-PROPN,PROPN-PROPN,compound-poss,compound-pobj,NNP-NNP,NNP-NNP,1,1
2230,2154.0,38,said,9,1,8,7,0,29,8,-1,Phyllis Schlafly,Eagle Forum,per-per,-,PROPN-PROPN,PROPN-PROPN,compound-nsubj,compound-pobj,NNP-NNP,NNP-NNP,3,1
2231,2338.0,20,said,13,15,17,2,14,2,-2,4,Phyllis Schlafly,Eagle Forum,-,org-org,PROPN-PROPN,PROPN-PROPN,compound-compound,compound-compound,NNP-NNP,NNP-NNP,2,1
2232,2589.0,34,said,14,9,13,4,8,20,5,-1,Phyllis Schlafly,Eagle Forum,-,per-per,PROPN-PROPN,PROPN-PROPN,compound-poss,compound-pobj,NNP-NNP,NNP-NNP,1,1
2233,3116.0,20,rated,9,3,6,3,2,13,6,-3,Phyllis Schlafly,Eagle Forum,-,per-per,PROPN-PROPN,PROPN-PROPN,compound-poss,compound-nsubj,NNP-NNP,NNP-NNP,1,1
2234,4157.0,61,included,5,7,12,5,6,48,-2,7,Phyllis Schlafly,Eagle Forum,per-per,-,PROPN-PROPN,PROPN-PROPN,compound-compound,compound-pobj,NNP-NNP,NNP-NNP,3,1
2235,4625.0,101,named,2,27,30,3,26,70,-25,28,Phyllis Schlafly,Eagle Forum,org-org,-,PROPN-PROPN,PROPN-PROPN,compound-poss,compound-conj,NNP-NNP,NNP-NNP,1,1
2236,6859.0,21,supported,6,11,14,3,10,6,-5,8,Phyllis Schlafly,Eagle Forum,org-org,-,PROPN-PROPN,PROPN-PROPN,compound-poss,compound-pobj,NNP-NNP,NNP-NNP,1,1
2237,7112.0,7,Forum,5,2,5,3,1,1,3,0,Phyllis Schlafly,Eagle Forum,org-org,-,PROPN-PROPN,PROPN-PROPN,compound-compound,compound-ROOT,NNP-NNP,NNP-NNP,2,1
2238,7459.0,14,endorsed,3,6,9,3,5,4,-3,6,Phyllis Schlafly,Eagle Forum,org-org,-,PROPN-PROPN,PROPN-PROPN,compound-poss,nmod-nmod,NNP-NNP,NNP-NNP,2,1
2239,8587.0,15,carried,2,7,10,3,6,4,-5,8,Phyllis Schlafly,Eagle Forum,per-per,-,PROPN-PROPN,PROPN-PROPN,compound-poss,nmod-nmod,NNP-NNP,NNP-NNP,2,1
2240,10242.0,63,included,6,8,13,5,7,49,-2,7,Phyllis Schlafly,Eagle Forum,org-org,-,PROPN-PROPN,PROPN-PROPN,compound-compound,compound-pobj,NNP-NNP,NNP-NNP,3,1
2241,10749.0,39,said,17,1,6,5,0,32,16,-11,Phyllis Schlafly,Eagle Forum,per-per,-,PROPN-PROPN,PROPN-PROPN,compound-nsubj,compound-pobj,NNP-NNP,NNP-NNP,3,1
2242,11742.0,54,spoke,8,23,28,5,22,25,-15,20,Phyllis Schlafly,Eagle Forum,per-per,-,PROPN-PROPN,PROPN-PROPN,compound-compound,compound-pobj,NNP-NNP,NNP-NNP,3,1
2243,12676.0,22,is,2,4,20,16,3,1,-2,18,Phyllis Schlafly,Eagle Forum,-,per-per,PROPN-PROPN,PROPN-PROPN,compound-attr,compound-appos,NNP-NNP,NNP-NNP,6,1
2244,1149.0,16,confused,4,12,9,-3,11,6,-8,5,Kirklees,College,org,,PROPN,PROPN,compound,attr,NNP,NNP,2,1
2245,1150.0,35,said,22,8,17,9,7,17,14,-5,Abu Sayyaf,Jolo,per-per,,PROPN-PROPN,PROPN,compound-pobj,pobj,NNP-NNP,NNP,6,1
2246,1151.0,16,became,6,5,14,9,4,1,1,8,Northrop Grumman,Scaled Composites,per-per,-,PROPN-PROPN,PROPN-PROPN,compound-nsubj,compound-pobj,NNP-NNP,NNP-NNPS,5,1
2247,1152.0,11,is,2,1,10,9,0,0,1,8,Rubin,Treasury,per,,PROPN,PROPN,nsubj,pobj,NNP,NNP,3,1
2248,11689.0,35,named,10,1,4,3,0,30,9,-6,Rubin,Treasury,,per,VERB,PROPN,nsubjpass,compound,VB,NNP,1,1
2249,1153.0,34,raises,16,11,11,0,10,22,5,-5,Alfred State College,Alfred,--,org,PROPN-PROPN-PROPN,PROPN,compound-compound-conj,poss,NNP-NNP-NNP,NNP,0,1
2250,1154.0,81,hailed,15,1,22,21,0,58,14,7,Neves,New Republic,,org-org,NOUN,PROPN-PROPN,poss,nmod-nmod,NNS,NNP-NNP,8,1
2251,1155.0,29,were,6,18,25,7,17,3,-12,19,Arthur Eve,New York,-,org-org,PROPN-PROPN,PROPN-PROPN,compound-dobj,compound-compound,NNP-NNP,NNP-NNP,5,1
2252,1156.0,12,was,4,4,8,4,3,3,0,4,Leahy,attorney,per,,PROPN,NOUN,nsubj,attr,NNP,NN,1,1
2253,1157.0,30,stated,9,1,7,6,0,22,8,-2,United States,William Howard Taft,org-org,--,PROPN-PROPN,PROPN-PROPN-PROPN,compound-compound,compound-compound-nsubj,NNP-NNP,NNP-NNP-NNP,4,1
2254,1160.0,32,said,8,11,5,-6,10,26,-3,-3,Smith,South Africa,org,-,PROPN,PROPN-PROPN,nsubj,compound-pobj,NNP,NNP-NNP,4,1
2255,5677.0,22,enrolled,1,1,8,7,0,13,0,7,Smith,South Africa,,per-per,PROPN,PROPN-PROPN,nsubj,compound-pobj,NNP,NNP-NNP,4,1
2256,6876.0,22,suspended,7,9,16,7,8,5,-2,9,Smith,South Africa,,org-org,PROPN,PROPN-PROPN,dobj,compound-pobj,NNP,NNP-NNP,6,1
2257,13869.0,12,turn,5,4,10,6,3,1,1,5,Smith,South Africa,,per-per,PROPN,PROPN-PROPN,nsubj,compound-attr,NNP,NNP-NNP,3,1
2258,1161.0,41,is,19,31,38,7,30,2,-12,19,Buffalo Airways,Northwest Territories,per-per,-,PROPN-PROPN,PROPN-PROPN,compound-dobj,compound-compound,NNP-NNP,NNP-NNPS,5,1
2259,4402.0,25,is,2,1,11,10,0,13,1,9,Buffalo Airways,Northwest Territories,org-org,-,PROPN-PROPN,PROPN-PROPN,compound-nsubj,compound-compound,NNP-NNP,NNP-NNPS,6,1
2260,1162.0,41,reported,39,6,18,12,5,22,33,-21,Benazir Bhutto,Pakistan,per-per,,PROPN-PROPN,PROPN,compound-poss,compound,NNP-NNP,NNP,7,1
2261,8780.0,32,Although,0,17,29,12,16,2,-17,29,Benazir Bhutto,Pakistan,org-org,,PROPN-PROPN,PROPN,compound-pobj,compound,NNP-NNP,NNP,5,1
2262,1163.0,28,.,0,15,21,6,14,6,-15,21,DMX,Ruff Ryders Entertainment,per,--,PROPN,PROPN-PROPN-PROPN,pobj,compound-compound-pobj,NNP,NNP-NNPS-NNP,3,1
2263,1165.0,27,was,3,5,13,8,4,13,-2,10,Woodrow Wilson,Princeton University,per-per,-,PROPN-PROPN,PROPN-PROPN,compound-attr,compound-pobj,NNP-NNP,NNP-NNP,6,1
2264,1166.0,28,module,2,1,20,19,0,7,1,18,ESA,Italy,,per,PROPN,PROPN,compound,pobj,NNP,NNP,7,1
2265,1167.0,20,is,1,1,8,7,0,11,0,7,ELAC,Monterey Park,per,-,PROPN,PROPN-PROPN,nsubj,compound-pobj,NNP,NNP-NNP,4,1
2266,1168.0,23,held,3,8,18,10,7,4,-5,15,Von Erich,Texas,org-org,,PROPN-PROPN,PROPN,compound-poss,pobj,NNP-NNP,NNP,5,1
2267,7266.0,28,refused,2,1,12,11,0,15,1,10,Von Erich,Texas,per-per,,PROPN-PROPN,PROPN,compound-nsubj,compound,NNP-NNP,NNP,3,1
2268,1169.0,28,activated,12,6,10,4,5,17,6,-2,Lewis H. Brereton,Ninth Air Force,per-per-per,--,PROPN-PROPN-PROPN,PROPN-PROPN-PROPN,compound-compound-poss,compound-compound-nsubj,NNP-NNP-NNP,NNP-NNP-NNP,3,1
2269,1170.0,36,reported,6,20,21,1,19,14,-14,15,LAB,Flying Service,,org-org,PROPN,PROPN-PROPN,compound,compound-nsubj,NNP,NNP-NNP,2,1
2270,1171.0,27,inspired,3,1,2,1,0,24,2,-1,Director,Peter Jackson,per,-,PROPN,PROPN-PROPN,compound,compound-nsubj,NNP,NNP-NNP,1,1
2271,1172.0,12,agrees,1,1,5,4,0,6,0,4,France,Yasser Arafat,per,-,NOUN,PROPN-PROPN,nsubj,compound-dobj,NN,NNP-NNP,2,1
2272,1927.0,32,included,6,5,14,9,4,17,1,8,France,Yasser Arafat,org,-,PROPN,PROPN-PROPN,pobj,compound-pobj,NNP,NNP-NNP,4,1
2273,1173.0,33,concluded,2,11,15,4,10,17,-9,13,Costas Simitis,Greece,org-org,,PROPN-PROPN,PROPN,compound-conj,poss,NNP-NNP,NNP,5,1
2274,1175.0,30,released,2,24,27,3,23,2,-22,25,his,Secret Sun,per,-,DET,PROPN-PROPN,poss,compound-compound,PRP$,NNP-NNP,3,1
2275,1176.0,19,is,9,2,2,0,1,16,7,-7,Philadelphia High School for Creative and Performing Arts,Philadelphia,-------,org,PROPN-PROPN-PROPN-ADP-PROPN-CCONJ-PROPN-PROPN,PROPN,compound-compound-nsubj-prep-nmod-cc-conj-pobj,compound,NNP-NNP-NNP-IN-NNP-CC-NNP-NNP,NNP,0,1
2276,1177.0,43,helped,1,10,10,0,9,32,-9,9,Chester College of New England,Chester New Hampshire,----,org-org-org,PROPN-PROPN-ADP-PROPN-PROPN,PROPN-PROPN-PROPN,compound-pobj-prep-compound-pobj,compound-compound-compound,NNP-NNP-IN-NNP-NNP,NNP-NNP-NNP,0,1
2277,1178.0,20,said,18,1,8,7,0,11,17,-10,Liberty University,Lynchburg Baptist College,-,per-per-per,PROPN-PROPN,PROPN-PROPN-PROPN,compound-nsubj,compound-compound-pobj,NNP-NNP,NNP-NNP-NNP,4,1
2278,1179.0,11,graduated,1,4,10,6,3,0,-3,9,Helpmekaar Kollege,Johannesburg,-,per,PROPN-PROPN,PROPN,compound-pobj,pobj,NNP-NNP,NNP,3,1
2279,1180.0,39,was,1,12,29,17,11,9,-11,28,George Canning,Exchequer,per-per,,PROPN-PROPN,PROPN,compound-compound,pobj,NNP-NNP,NNP,7,1
2280,1181.0,43,elected,10,17,23,6,16,19,-7,13,New South Wales,Reid,per-per-per,,PROPN-PROPN-PROPN,PROPN,compound-compound-pobj,compound,NNP-NNP-NNP,NNP,9,1
2281,1182.0,19,is,1,12,16,4,11,2,-11,15,Massachusetts Institute of Technology,Cambridge,org-org-org-org,,PROPN-PROPN-ADP-PROPN,PROPN,nmod-nmod-prep-pobj,compound,NNP-NNP-IN-NNP,NNP,2,1
2282,1183.0,22,married,2,9,17,8,8,4,-7,15,Kfarshima,Majida,org,,PROPN,PROPN,pobj,conj,NNP,NNP,4,1
2283,1184.0,47,questioned,12,5,10,5,4,36,7,-2,Health and Human Services,Tommy Thompson,org-org-org-org,-,PROPN-CCONJ-PROPN-PROPN,PROPN-PROPN,nmod-cc-compound-compound,compound-compound,NNP-CC-NNP-NNPS,NNP-NNP,4,1
2284,2400.0,27,confirmed,3,7,12,5,6,14,-4,9,Health and Human Services,Tommy Thompson,---,per-per,PROPN-CCONJ-PROPN-PROPN,PROPN-PROPN,nmod-cc-compound-conj,compound-nsubj,NNP-CC-NNP-NNPS,NNP-NNP,3,1
2285,3784.0,25,seen,3,13,18,5,12,6,-10,15,Health and Human Services,Tommy Thompson,---,org-org,PROPN-CCONJ-PROPN-PROPN,PROPN-PROPN,nmod-cc-compound-compound,compound-nsubjpass,NNP-CC-NNP-NNPS,NNP-NNP,3,1
2286,3793.0,48,is,6,37,42,5,36,5,-31,36,Health and Human Services,Tommy Thompson,per-per-per-per,-,PROPN-CCONJ-PROPN-PROPN,PROPN-PROPN,nmod-cc-compound-conj,compound-pobj,NNP-CC-NNP-NNP,NNP-NNP,3,1
2287,4356.0,21,rest,3,14,19,5,13,1,-11,16,Health and Human Services,Tommy Thompson,---,org-org,PROPN-CCONJ-PROPN-PROPN,PROPN-PROPN,conj-cc-compound-conj,compound-pobj,NNP-CC-NNP-NNPS,NNP-NNP,6,1
2288,4691.0,88,wrote,1,3,11,8,2,76,-2,10,Health and Human Services,Tommy Thompson,---,per-per,PROPN-CCONJ-PROPN-PROPN,PROPN-PROPN,nmod-cc-compound-conj,compound-nsubj,NNP-CC-NNP-NNP,NNP-NNP,4,1
2289,5293.0,31,worked,10,2,7,5,1,23,8,-3,Health and Human Services,Tommy Thompson,---,per-per,PROPN-CCONJ-PROPN-PROPN,PROPN-PROPN,nmod-cc-compound-conj,compound-nsubj,NNP-CC-NNP-NNPS,NNP-NNP,3,1
2290,9675.0,25,headed,6,2,23,21,1,1,4,17,Health and Human Services,Tommy Thompson,org-org-org-org,-,PROPN-CCONJ-PROPN-PROPN,PROPN-PROPN,pobj-cc-compound-conj,compound-pobj,NNP-CC-NNP-NNPS,NNP-NNP,9,1
2291,9980.0,33,said,10,5,9,4,4,23,5,-1,Health and Human Services,Tommy Thompson,org-org-org-org,-,PROPN-CCONJ-PROPN-PROPN,PROPN-PROPN,pobj-cc-compound-conj,compound-nsubj,NNP-CC-NNP-NNPS,NNP-NNP,4,1
2292,13096.0,40,confirmed,33,28,32,4,27,7,5,-1,Health and Human Services,Tommy Thompson,---,org-org,PROPN-CCONJ-PROPN-PROPN,PROPN-PROPN,pobj-cc-compound-compound,compound-conj,NNP-CC-NNP-NNPS,NNP-NNP,4,1
2293,1185.0,16,attended,1,9,15,6,8,0,-8,14,Florida Southern College,Lakeland,org-org-org,,PROPN-PROPN-PROPN,PROPN,compound-compound-conj,pobj,NNP-NNP-NNP,NNP,4,1
2294,1186.0,40,replaced,14,14,26,12,13,13,0,12,Gorbachev,Communist Party,org,-,PROPN,PROPN-PROPN,nsubj,compound-pobj,NNP,NNP-NNP,3,1
2295,3765.0,25,said,1,1,11,10,0,13,0,10,Gorbachev,Communist Party,org,-,PROPN,PROPN-PROPN,nsubj,compound-pobj,NNP,NNP-NNP,6,1
2296,6972.0,30,was,1,1,9,8,0,20,0,8,Gorbachev,Communist Party,per,-,PROPN,PROPN-PROPN,nsubj,compound-pobj,NNP,NNP-NNP,3,1
2297,1187.0,30,became,4,24,25,1,23,4,-20,21,England,Edgar the Peaceful,per,--,PROPN,PROPN-DET-PROPN,compound,pobj-det-appos,NNP,NNP-DT-NNP,2,1
2298,1188.0,36,was,2,7,11,4,6,24,-5,9,Salmon P. Chase,Treasury,--,per,PROPN-PROPN-PROPN,PROPN,compound-compound-pobj,compound,NNP-NNP-NNP,NNP,2,1
2299,2023.0,23,incorporated,3,10,22,12,9,0,-7,19,Salmon P. Chase,Treasury,--,org,PROPN-PROPN-PROPN,PROPN,compound-compound-compound,pobj,NNP-NNP-NNP,NNP,5,1
2300,2828.0,21,elected,15,3,13,10,2,7,12,-2,Salmon P. Chase,Treasury,per-per-per,,PROPN-PROPN-PROPN,PROPN,compound-compound-nsubj,compound,NNP-NNP-NNP,NNP,7,1
2301,5704.0,59,appointed,1,10,32,22,9,26,-9,31,Salmon P. Chase,Treasury,per-per-per,,PROPN-PROPN-PROPN,PROPN,compound-compound-appos,pobj,NNP-NNP-NNP,NNP,13,1
2302,1189.0,14,is,3,1,11,10,0,2,2,8,Middlesboro High School,Kentucky,org-org-org,,PROPN-PROPN-PROPN,PROPN,compound-compound-nsubj,compound,NNP-NNP-NNP,NNP,6,1
2303,1190.0,30,is,8,1,29,28,0,0,7,21,Dennis Knight,Mideon,-,per,PROPN-PROPN,PROPN,compound-nsubj,conj,NNP-NNP,NNP,2,1
2304,1191.0,24,began,9,7,8,1,6,15,2,-1,singer,Namie Amuro,,per-per,NOUN,PROPN-PROPN,compound,compound-nsubj,NN,NNP-NNP,1,1
2305,1192.0,22,married,4,1,8,7,0,13,3,4,Jovovich,Shawn Andrews,org,-,PROPN,PROPN-PROPN,nsubjpass,compound-pobj,NNP,NNP-NNP,5,1
2306,1193.0,26,approved,16,4,14,10,3,11,12,-2,Bolivia,Evo Morales,per,-,PROPN,PROPN-PROPN,poss,compound-pobj,NNP,NNP-NNPS,9,1
2307,1720.0,29,continues,1,22,26,4,21,2,-21,25,Bolivia,Evo Morales,,per-per,PROPN,PROPN-PROPN,pobj,compound-compound,NNP,NNP-NNPS,3,1
2308,7682.0,25,closed,1,11,23,12,10,1,-10,22,Bolivia,Evo Morales,,per-per,PROPN,PROPN-PROPN,pobj,compound-dobj,NNP,NNP-NNPS,5,1
2309,9401.0,28,asked,10,8,9,1,7,18,2,-1,Bolivia,Evo Morales,org,-,PROPN,PROPN-PROPN,compound,compound-pobj,NNP,NNP-NNPS,1,1
2310,9834.0,30,said,28,5,19,14,4,10,23,-9,Bolivia,Evo Morales,per,-,PROPN,PROPN-PROPN,pobj,compound-pobj,NNP,NNP-NNPS,7,1
2311,11967.0,12,had,4,1,3,2,0,8,3,-1,Bolivia,Evo Morales,,per-per,PROPN,PROPN-PROPN,poss,compound-nsubj,NNP,NNP-NNPS,2,1
2312,12296.0,10,claims,4,1,3,2,0,6,3,-1,Bolivia,Evo Morales,,per-per,PROPN,PROPN-PROPN,poss,compound-nsubj,NNP,NNP-NNPS,2,1
2313,12515.0,17,strengthened,6,5,12,7,4,4,1,6,Bolivia,Evo Morales,,per-per,PROPN,PROPN-PROPN,conj,compound-pobj,NNP,NNP-NNPS,5,1
2314,1194.0,12,owned,2,6,10,4,5,1,-4,8,Illinois Railway Museum,Union Illinois,--,per-per,PROPN-PROPN-PROPN,PROPN-PROPN,compound-compound-pobj,compound-pobj,NNP-NNP-NNP,NNP-NNP,3,1
2315,1195.0,76,was,1,9,27,18,8,48,-8,26,GKN,UK,per,,PROPN,PROPN,pobj,compound,NNP,NNP,7,1
2316,1196.0,19,worked,9,8,17,9,7,1,1,8,Fischer,Munich,org,,PROPN,PROPN,nsubj,compound,NNP,NNP,10,1
2317,1197.0,13,came,5,1,12,11,0,0,4,7,His,Eskaton,per,,DET,PROPN,poss,appos,PRP$,NNP,3,1
2318,1198.0,79,affiliated,13,17,25,8,16,53,-4,12,University of Calicut,Vidya Academy of Science and Technology,--,per-per-per-per-per-per,PROPN-ADP-PROPN,PROPN-PROPN-ADP-PROPN-CCONJ-PROPN,pobj-prep-pobj,compound-pobj-prep-pobj-cc-conj,NNP-IN-NNP,NNP-NNP-IN-NNP-CC-NNP,3,1
2319,1199.0,34,sent,5,13,16,3,12,17,-8,11,Paul-Henri Spaak,Belgium,per-per,,PROPN-PROPN,PROPN,amod-appos,appos,NNP-NNP,NNP,3,1
2320,4193.0,17,born,3,1,11,10,0,5,2,8,Paul-Henri Spaak,Belgium,org-org,,PROPN-PROPN,PROPN,amod-nsubjpass,pobj,NNP-NNP,NNP,6,1
2321,12778.0,36,founded,15,2,13,11,1,22,13,-2,Paul-Henri Spaak,Belgium,org-org,,PROPN-PROPN,PROPN,amod-compound,appos,NNP-NNP,NNP,5,1
2322,14066.0,31,was,1,7,22,15,6,8,-6,21,Paul-Henri Spaak,Belgium,per-per,,PROPN-PROPN,PROPN,compound-pobj,pobj,NNP-NNP,NNP,8,1
2323,1200.0,39,told,20,9,18,9,8,20,11,-2,Professor,Punjabi University,,per-per,PROPN,PROPN-PROPN,nmod,compound-compound,NNP,NNP-NNP,4,1
2324,1201.0,29,took,9,4,26,22,3,2,5,17,Peter G. Peterson,its,--,org,PROPN-PROPN-PROPN,DET,compound-compound-conj,poss,NNP-NNP-NNP,PRP$,7,1
2325,1202.0,65,was,9,26,37,11,25,27,-17,28,Grupo Continental,1964,org-org,,PROPN-PROPN,NUM,compound-pobj,pobj,NNP-NNP,CD,6,1
2326,1203.0,32,finished,1,6,24,18,5,7,-5,23,Moray House School of Education,University of Edinburgh,per-per-per-per-per,--,PROPN-PROPN-PROPN-ADP-PROPN,PROPN-ADP-PROPN,compound-compound-appos-prep-pobj,pobj-prep-pobj,NNP-NNP-NNP-IN-NNP,NNP-IN-NNP,5,1
2327,1204.0,16,attended,1,3,15,12,2,0,-2,14,Beverley Grammar School,700,per-per-per,,PROPN-PROPN-PROPN,NUM,compound-compound-dative,nummod,NNP-NNP-NNP,CD,3,1
2328,1205.0,23,released,3,7,9,2,6,13,-4,6,RCA,he,org,,PROPN,PRON,compound,nsubj,NNP,PRP,1,1
2329,1206.0,28,was,11,19,24,5,18,3,-8,13,1897,United States Copyright Office,per,---,NUM,PROPN-PROPN-PROPN-PROPN,nummod,compound-compound-compound-pobj,CD,NNP-NNP-NNP-NNP,7,1
2330,1207.0,26,appointed,6,10,23,13,9,2,-4,17,lieutenant,Northamptonshire Regiment,,org-org,NOUN,PROPN-PROPN,oprd,compound-appos,NN,NNP-NNP,4,1
2331,1208.0,24,went,1,10,11,1,9,12,-9,10,Emperor,Justin I,,org-org,PROPN,PROPN-PRON,compound,pobj-nsubj,NNP,NNP-PRP,7,1
2332,1209.0,25,served,4,3,8,5,2,16,1,4,VICA,San Fernando Valley,org,--,PROPN,PROPN-PROPN-PROPN,nsubj,compound-compound-poss,NNP,NNP-NNP-NNP,5,1
2333,1210.0,32,Europe,1,1,1,0,0,30,0,0,STX,STX Corporation,,org-org,PROPN,PROPN-PROPN,compound,compound-pobj,NNP,NNP-NNP,0,1
2334,1211.0,31,retrieved,15,1,28,27,0,2,14,13,Brooks,Queens,org,,PROPN,PROPN,compound,compound,NNP,NNP,-1,1
2335,1212.0,30,advised,15,1,5,4,0,24,14,-10,Lorne Calvert,Saskatchewan,-,per,PROPN-PROPN,PROPN,compound-compound,pobj,NNP-NNP,NNP,2,1
2336,1213.0,19,became,11,5,15,10,4,3,6,4,Yusuf Bey,Your Black Muslim Bakery,-,org-org-org-org,PROPN-PROPN,DET-PROPN-PROPN-PROPN,compound-pobj,poss-compound-compound-pobj,NNP-NNP,PRP$-NNP-NNP-NNP,8,1
2337,1214.0,20,said,18,14,17,3,13,2,4,-1,Kansas City,Mark Funkhouser,-,org-org,PROPN-PROPN,PROPN-PROPN,compound-compound,compound-nsubj,NNP-NNP,NNP-NNP,2,1
2338,1216.0,39,coming,2,24,26,2,23,12,-22,24,his,London,org,,DET,PROPN,poss,pobj,PRP$,NNP,1,1
2339,11740.0,38,hit,31,18,37,19,17,0,13,6,his,London,per,,DET,PROPN,poss,pobj,PRP$,NNP,-1,1
2340,1218.0,21,wrote,4,1,7,6,0,13,3,3,His,Minnesota,per,,DET,PROPN,poss,pobj,PRP$,NNP,2,1
2341,1219.0,59,Players,1,7,7,0,6,51,-6,6,Kutztown,Kutztown University,per,-,PROPN,PROPN-PROPN,pobj,compound-compound,NNP,NNP-NNP,0,1
2342,1220.0,27,established,7,4,6,2,3,20,3,-1,Interior,Wilhelm Frick,,org-org,PROPN,PROPN-PROPN,compound,compound-nsubj,NNP,NNP-NNP,1,1
2343,2289.0,29,tried,1,26,27,1,25,1,-25,26,Interior,Wilhelm Frick,,per-per,PROPN,PROPN-PROPN,compound,compound-pobj,NNP,NNP-NNP,1,1
2344,4577.0,6,Frick,3,1,3,2,0,2,2,0,Interior,Wilhelm Frick,,org-org,PROPN,PROPN-PROPN,compound,compound-ROOT,NNP,NNP-NNP,1,1
2345,5899.0,25,switched,7,15,17,2,14,7,-8,10,Interior,Wilhelm Frick,per,-,PROPN,PROPN-PROPN,pobj,compound-pobj,NNP,NNP-NNP,7,1
2346,8109.0,37,became,2,29,30,1,28,6,-27,28,Interior,Wilhelm Frick,per,-,PROPN,PROPN-PROPN,compound,compound-pobj,NNP,NNP-NNP,2,1
2347,8826.0,31,were,17,9,11,2,8,19,8,-6,Interior,Wilhelm Frick,,per-per,PROPN,PROPN-PROPN,compound,compound-pobj,NNP,NNP-NNP,1,1
2348,11119.0,21,was,3,8,10,2,7,10,-5,7,Interior,Wilhelm Frick,,per-per,PROPN,PROPN-PROPN,compound,compound-pobj,NNP,NNP-NNP,1,1
2349,11503.0,40,were,25,1,3,2,0,36,24,-22,Interior,Wilhelm Frick,per,-,PROPN,PROPN-PROPN,compound,compound-nsubj,NNP,NNP-NNP,1,1
2350,11940.0,30,appointed,5,27,28,1,26,1,-22,23,Interior,Wilhelm Frick,,per-per,PROPN,PROPN-PROPN,compound,compound-pobj,NNP,NNP-NNP,1,1
2351,13490.0,13,was,4,9,11,2,8,1,-5,7,Interior,Wilhelm Frick,per,-,PROPN,PROPN-PROPN,compound,compound-pobj,NNP,NNP-NNP,1,1
2352,14050.0,19,issued,11,9,10,1,8,8,2,-1,Interior,Wilhelm Frick,per,-,PROPN,PROPN-PROPN,compound,compound-pobj,NNP,NNP-NNP,1,1
2353,14074.0,32,threatened,10,6,9,3,5,22,4,-1,Interior,Wilhelm Frick,org,-,PROPN,PROPN-PROPN,compound,compound-appos,NNP,NNP-NNP,1,1
2354,1221.0,31,is,14,2,11,9,1,19,12,-3,U.S. Army Medical Research Institute of Infectious Diseases,USAMRIID,-------,per,PROPN-PROPN-PROPN-PROPN-PROPN-ADP-PROPN-PROPN,PROPN,compound-compound-compound-compound-nsubj-prep-compound-pobj,nsubj,NNP-NNP-NNP-NNP-NNP-IN-NNP-NNPS,NNP,3,1
2355,1222.0,25,get,8,16,23,7,15,1,-8,15,Liberty Tax Service,John Hewitt,per-per-per,-,PROPN-PROPN-PROPN,PROPN-PROPN,compound-compound-pobj,compound-pobj,NNP-NNP-NNP,NNP-NNP,8,1
2356,1224.0,31,rose,17,5,25,20,4,5,12,8,Amarinder singh,Punjab,-,per,PROPN-ADJ,PROPN,compound-compound,pobj,NNP-JJ,NNP,7,1
2357,1225.0,50,brought,6,11,34,23,10,15,-5,28,Japanese,Mamoru Oshii,per,-,ADJ,PROPN-PROPN,amod,compound-pobj,JJ,NNP-NNP,6,1
2358,1226.0,34,hosted,2,10,11,1,9,22,-8,9,Chile,Federico Echaurren,,org-org,PROPN,PROPN-PROPN,compound,compound-pobj,NNP,NNP-NNP,1,1
2359,1228.0,8,acquired,4,3,7,4,2,0,1,3,Medior,AOL,,org,PROPN,PROPN,nsubjpass,pobj,NNP,NNP,2,1
2360,1229.0,23,Hosting,0,11,20,9,10,2,-11,20,Warrington College of Business Administration,Florida,org-org-org-org-org,,PROPN-PROPN-ADP-PROPN-PROPN,PROPN,compound-nmod-prep-compound-pobj,pobj,NNP-NNP-IN-NNP-NNP,NNP,4,1
2361,1230.0,14,taught,6,4,11,7,3,2,2,5,UTSA,Texas,,per,PROPN,PROPN,compound,compound,NNP,NNP,7,1
2362,1231.0,29,In,0,16,23,7,15,5,-16,23,Company,Avro,per,,PROPN,PROPN,nsubj,compound,NNP,NNP,2,1
2363,1232.0,34,won,1,1,10,9,0,23,0,9,Shaw,Georgia,,per,PROPN,PROPN,nsubj,compound,NNP,NNP,6,1
2364,1233.0,44,serves,1,1,9,8,0,34,0,8,He,Baltimore,,per,PRON,PROPN,nsubj,compound,PRP,NNP,5,1
2365,14143.0,27,represents,1,1,8,7,0,18,0,7,He,Baltimore,per,,PRON,PROPN,nsubj,compound,PRP,NNP,2,1
2366,1234.0,22,dated,4,11,11,0,10,10,-7,7,John Hennigan,John Morrison,-,per-per,PROPN-PROPN,PROPN-PROPN,compound-appos,compound-appos,NNP-NNP,NNP-NNP,0,1
2367,1235.0,33,left,1,1,12,11,0,20,0,11,He,Knoxville,,org,PRON,PROPN,nsubj,poss,PRP,NNP,6,1
2368,1236.0,31,formed,9,4,21,17,3,9,5,12,Sony,George Michael,org,-,PROPN,PROPN-PROPN,compound,compound-compound,NNP,NNP-NNP,5,1
2369,10340.0,35,brought,9,4,14,10,3,20,5,5,Sony,George Michael,,org-org,PROPN,PROPN-PROPN,compound,compound-compound,NNP,NNP-NNP,6,1
2370,1237.0,28,named,2,6,8,2,5,19,-4,6,Quebec,Paul,org,,PROPN,PROPN,compound,pobj,NNP,NNP,3,1
2371,1238.0,15,join,3,5,12,7,4,2,-2,9,Cetera,drummer,org,,PROPN,NOUN,poss,compound,NNP,NN,5,1
2372,1239.0,24,introduced,2,7,18,11,6,5,-5,16,Bob Dylan,Columbia,per-per,,PROPN-PROPN,PROPN,compound-compound,pobj,NNP-NNP,NNP,9,1
2373,5662.0,22,is,3,10,20,10,9,1,-7,17,Bob Dylan,Columbia,org-org,,PROPN-PROPN,PROPN,compound-pobj,compound,NNP-NNP,NNP,5,1
2374,8005.0,19,is,2,1,17,16,0,1,1,15,Bob Dylan,Columbia,per-per,,PROPN-PROPN,PROPN,compound-nsubj,compound,NNP-NNP,NNP,4,1
2375,1240.0,27,batted,1,7,9,2,6,17,-6,8,Appalachian League,Elizabethton Twins,per-per,-,PROPN-PROPN,PROPN-PROPN,compound-compound,compound-pobj,NNP-NNP,NNP-NNP,2,1
2376,1241.0,22,coordinated,5,9,10,1,8,11,-4,5,Pakistan,Army,per,,PROPN,PROPN,compound,nsubj,NNP,NNP,1,1
2377,3319.0,25,was,20,8,9,1,7,15,12,-11,Pakistan,Army,per,,PROPN,PROPN,compound,pobj,NNP,NNP,3,1
2378,1242.0,47,said,2,34,45,11,33,1,-32,43,NATO,Javier Solana,per,-,PROPN,PROPN-PROPN,compound,compound-oprd,NNP,NNP-NNP,13,1
2379,1243.0,41,enjoys,15,1,8,7,0,32,14,-7,Christofias,Cyprus,,per,PROPN,PROPN,nsubj,poss,NNP,NNP,4,1
2380,1244.0,48,serve,4,14,17,3,13,30,-10,13,Christopher Dodd,Connecticut,-,per,PROPN-PROPN,PROPN,compound-pobj,pobj,NNP-NNP,NNP,2,1
2381,6049.0,21,is,8,4,7,3,3,13,4,-1,Christopher Dodd,Connecticut,-,org,PROPN-PROPN,PROPN,compound-appos,compound,NNP-NNP,NNP,3,1
2382,13687.0,55,set,5,19,22,3,18,32,-14,17,Christopher Dodd,Connecticut,-,org,PROPN-PROPN,PROPN,compound-appos,compound,NNP-NNP,NNP,1,1
2383,1245.0,20,followed,1,3,16,13,2,3,-2,15,Thomas Chalmers,Free Church of Scotland,per-per,---,PROPN-PROPN,PROPN-PROPN-ADP-PROPN,compound-dobj,compound-dobj-prep-pobj,NNP-NNP,NNP-NNP-IN-NNP,5,1
2384,1246.0,20,Reprints,0,15,17,2,14,2,-15,17,Design,CCAD,per,,PROPN,PROPN,pobj,nmod,NNP,NNP,2,1
2385,1247.0,36,was,1,5,27,22,4,8,-4,26,I,Columbia,org,,PRON,PROPN,nsubjpass,poss,PRP,NNP,8,1
2386,1248.0,41,established,12,2,7,5,1,33,10,-5,Common Market for Eastern and Southern Africa,Southern Africa,------,org-org,PROPN-PROPN-ADP-PROPN-CCONJ-PROPN-PROPN,PROPN-PROPN,compound-nsubjpass-prep-pobj-cc-compound-conj,compound-conj,NNP-NNP-IN-NNP-CC-NNP-NNP,NNP-NNP,2,1
2387,1249.0,25,bears,2,8,19,11,7,5,-6,17,Alabama,his,,per,PROPN,DET,compound,poss,NNP,PRP$,4,1
2388,2866.0,39,began,19,4,11,7,3,27,15,-8,Alabama,his,per,,PROPN,DET,pobj,poss,NNP,PRP$,4,1
2389,1250.0,13,told,2,1,4,3,0,8,1,2,Cappato,Italy,per,,PROPN,PROPN,nsubj,poss,NNP,NNP,4,1
2390,1251.0,32,said,13,1,3,2,0,28,12,-10,Yuriy Yekhanurov,Ukraine,per-per,,PROPN-PROPN,PROPN,compound-compound,poss,NNP-NNP,NNP,2,1
2391,1252.0,21,includes,7,18,19,1,17,1,-11,12,President,Mahmoud Abbas,,org-org,PROPN,PROPN-PROPN,compound,compound-conj,NNP,NNP-NNP,2,1
2392,3341.0,34,Mail,1,6,7,1,5,26,-5,6,President,Mahmoud Abbas,,per-per,PROPN,PROPN-PROPN,compound,compound-nsubj,NNP,NNP-NNP,1,1
2393,4421.0,33,overran,4,24,25,1,23,7,-20,21,President,Mahmoud Abbas,per,-,PROPN,PROPN-PROPN,compound,compound-dobj,NNP,NNP-NNP,1,1
2394,5799.0,64,posed,2,17,36,19,16,27,-15,34,President,Mahmoud Abbas,,per-per,PROPN,PROPN-PROPN,compound,compound-compound,NNP,NNP-NNP,8,1
2395,1253.0,38,noted,22,13,5,-8,12,32,9,-17,Otto,his,,org,PROPN,DET,nsubj,poss,NNP,PRP$,3,1
2396,1254.0,13,is,2,1,11,10,0,1,1,9,Aspen MLT,Michael Turner,per-per,-,PROPN-PROPN,PROPN-PROPN,compound-nsubj,compound-pobj,NNP-NNP,NNP-NNP,5,1
2397,1255.0,22,adapted,3,11,17,6,10,4,-8,14,Mamoru Oshii,Japanese,org-org,,PROPN-PROPN,ADJ,compound-pobj,amod,NNP-NNP,JJ,3,1
2398,1256.0,28,said,5,1,4,3,0,23,4,-1,Luxembourg,Jean-Claude Juncker,,per-per,PROPN,PROPN-PROPN,compound,compound-nsubj,NNP,NNP-NNP,3,1
2399,1547.0,35,said,32,27,31,4,26,3,5,-1,Luxembourg,Jean-Claude Juncker,per,-,PROPN,PROPN-PROPN,poss,compound-appos,NNP,NNP-NNP,3,1
2400,2161.0,12,is,1,6,10,4,5,1,-5,9,Luxembourg,Jean-Claude Juncker,per,-,PROPN,PROPN-PROPN,poss,compound-pobj,NNP,NNP-NNP,4,1
2401,5355.0,31,are,1,26,29,3,25,1,-25,28,Luxembourg,Jean-Claude Juncker,,per-per,PROPN,PROPN-PROPN,compound,compound-pobj,NNP,NNP-NNP,5,1
2402,7088.0,38,member,1,5,19,14,4,18,-4,18,Luxembourg,Jean-Claude Juncker,per,-,PROPN,PROPN-PROPN,compound,compound-conj,NNP,NNP-NNP,10,1
2403,7251.0,27,said,23,19,22,3,18,4,4,-1,Luxembourg,Jean-Claude Juncker,,per-per,PROPN,PROPN-PROPN,compound,compound-nsubj,NNP,NNP-NNP,3,1
2404,7279.0,38,bring,5,26,15,-11,25,22,-21,10,Luxembourg,Jean-Claude Juncker,org,-,PROPN,PROPN-PROPN,compound,compound-pobj,NNP,NNP-NNP,9,1
2405,7289.0,36,was,8,4,7,3,3,28,4,-1,Luxembourg,Jean-Claude Juncker,org,-,PROPN,PROPN-PROPN,compound,compound-nsubj,NNP,NNP-NNP,4,1
2406,8613.0,22,was,10,5,20,15,4,1,5,10,Luxembourg,Jean-Claude Juncker,,org-org,PROPN,PROPN-PROPN,compound,compound-pobj,NNP,NNP-NNP,9,1
2407,12117.0,28,pledged,10,4,7,3,3,20,6,-3,Luxembourg,Jean-Claude Juncker,per,-,PROPN,PROPN-PROPN,compound,compound-compound,NNP,NNP-NNP,4,1
2408,1257.0,27,shows,1,8,18,10,7,8,-7,17,United States,Abraham Lincoln,per-per,-,PROPN-PROPN,PROPN-PROPN,compound-pobj,compound-nsubj,NNP-NNP,NNP-NNP,7,1
2409,10200.0,20,labeled,12,4,7,3,3,12,8,-5,United States,Abraham Lincoln,-,per-per,PROPN-PROPN,PROPN-PROPN,compound-pobj,compound-compound,NNP-NNP,NNP-NNP,6,1
2410,11841.0,24,offered,4,8,18,10,7,5,-4,14,United States,Abraham Lincoln,-,org-org,PROPN-PROPN,PROPN-PROPN,compound-compound,compound-compound,NNP-NNP,NNP-NNP,7,1
2411,1258.0,10,lived,1,1,5,4,0,4,0,4,He,California,per,,PRON,PROPN,nsubj,pobj,PRP,NNP,1,1
2412,1478.0,8,attended,1,1,7,6,0,0,0,6,He,California,org,,PRON,PROPN,nsubj,pobj,PRP,NNP,1,1
2413,5340.0,24,www.frostythebook.com,0,2,10,8,1,13,-2,10,He,California,org,,PRON,PROPN,nsubj,pobj,PRP,NNP,2,1
2414,6417.0,24,was,1,1,21,20,0,2,0,20,He,California,,org,PRON,PROPN,nsubj,compound,PRP,NNP,6,1
2415,7398.0,16,organized,1,1,4,3,0,11,0,3,He,California,per,,PRON,PROPN,nsubj,compound,PRP,NNP,3,1
2416,7953.0,18,appointed,2,1,12,11,0,5,1,10,He,California,org,,PRON,PROPN,nsubjpass,compound,PRP,NNP,6,1
2417,11661.0,13,had,1,1,9,8,0,3,0,8,He,California,,per,PRON,PROPN,nsubj,pobj,PRP,NNP,3,1
2418,1259.0,23,supported,2,12,16,4,11,6,-10,14,Susan Collins,Maine,-,per,PROPN-PROPN,PROPN,compound-conj,pobj,NNP-NNP,NNP,6,1
2419,2020.0,51,sworn,11,26,34,8,25,16,-15,23,Susan Collins,Maine,per-per,,PROPN-PROPN,PROPN,compound-pobj,compound,NNP-NNP,NNP,5,1
2420,6528.0,20,spoke,12,9,12,3,8,7,3,0,Susan Collins,Maine,-,per,PROPN-PROPN,PROPN,compound-conj,pobj,NNP-NNP,NNP,2,1
2421,9572.0,33,said,28,22,24,2,21,8,6,-4,Susan Collins,Maine,per-per,,PROPN-PROPN,PROPN,compound-compound,dobj,NNP-NNP,NNP,2,1
2422,10944.0,27,defied,19,3,5,2,2,21,16,-14,Susan Collins,Maine,per-per,,PROPN-PROPN,PROPN,compound-compound,compound,NNP-NNP,NNP,3,1
2423,11853.0,25,trying,3,12,15,3,11,9,-9,12,Susan Collins,Maine,-,per,PROPN-PROPN,PROPN,compound-conj,pobj,NNP-NNP,NNP,3,1
2424,12556.0,49,voted,2,18,21,3,17,27,-16,19,Susan Collins,Maine,org-org,,PROPN-PROPN,PROPN,compound-ROOT,appos,NNP-NNP,NNP,2,1
2425,1260.0,25,During,0,5,8,3,4,16,-5,8,Rhode Island,1st Rhode Island Regiment,-,per-per-per-per,PROPN-PROPN,ADJ-PROPN-PROPN-PROPN,compound-pobj,amod-compound-compound-appos,NNP-NNP,JJ-NNP-NNP-NNP,7,1
2426,1261.0,36,written,9,6,26,20,5,9,3,17,Republic,Yen Chia-kan,org,-,PROPN,PROPN-PROPN,pobj,compound-pobj,NNP,NNP-NNP,12,1
2427,3865.0,15,appoints,8,3,10,7,2,4,5,2,Republic,Yen Chia-kan,per,-,PROPN,PROPN-NOUN,nmod,compound-compound,NNP,NNP-NN,4,1
2428,9381.0,30,became,2,11,23,12,10,6,-9,21,Republic,Yen Chia-kan,,per-per,PROPN,PROPN-PROPN,pobj,compound-compound,NNP,NNP-NNP,3,1
2429,1263.0,30,signed,13,17,20,3,16,9,-4,7,Sherrod Brown,Ohio,-,per,PROPN-PROPN,PROPN,compound-pobj,compound,NNP-NNP,NNP,3,1
2430,1349.0,66,is,11,35,38,3,34,27,-24,27,Sherrod Brown,Ohio,-,org,PROPN-PROPN,PROPN,compound-pobj,pobj,NNP-NNP,NNP,1,1
2431,2701.0,12,is,1,8,11,3,7,0,-7,10,Sherrod Brown,Ohio,per-per,,PROPN-PROPN,PROPN,compound-pobj,pobj,NNP-NNP,NNP,4,1
2432,4279.0,8,said,0,3,6,3,2,1,-3,6,Sherrod Brown,Ohio,-,org,PROPN-PROPN,PROPN,compound-nsubj,compound,NNP-NNP,NNP,1,1
2433,1264.0,25,is,0,14,18,4,13,6,-14,18,Hayao Miyazaki,Studio Ghibli,-,per-per,PROPN-PROPN,PROPN-PROPN,compound-pobj,compound-pobj,NNP-NNP,NNP-NNP,3,1
2434,4759.0,28,gone,5,11,14,3,10,13,-6,9,Hayao Miyazaki,Studio Ghibli,org-org,-,PROPN-PROPN,PROPN-PROPN,compound-pobj,compound-conj,NNP-NNP,NNP-NNP,1,1
2435,9338.0,58,led,6,18,40,22,17,17,-12,34,Hayao Miyazaki,Studio Ghibli,org-org,-,PROPN-PROPN,PROPN-PROPN,compound-poss,compound-appos,NNP-NNP,NNP-NNP,4,1
2436,10138.0,11,is,5,1,4,3,0,6,4,-1,Hayao Miyazaki,Studio Ghibli,-,org-org,PROPN-PROPN,PROPN-PROPN,compound-nsubj,compound-pobj,NNP-NNP,NNP-NNP,2,1
2437,10655.0,69,find,4,37,40,3,36,28,-33,36,Hayao Miyazaki,Studio Ghibli,per-per,-,PROPN-PROPN,PROPN-PROPN,compound-pobj,compound-nsubj,NNP-NNP,NNP-NNP,6,1
2438,1265.0,25,represented,5,16,23,7,15,1,-11,18,Calgary-East,Moe Amery,per,-,PROPN,PROPN-PROPN,conj,compound-dobj,NNP,NNP-NNP,7,1
2439,1266.0,28,degree,0,6,6,0,5,21,-6,6,Michigan College of Mining,Michigan Technological University,per-per-per-per,--,PROPN-PROPN-ADP-PROPN,PROPN-PROPN-PROPN,compound-pobj-prep-pobj,compound-compound-nmod,NNP-NNP-IN-NNP,NNP-NNP-NNP,0,1
2440,1267.0,19,won,5,4,12,8,3,6,1,7,he,Singer,,org,PRON,PROPN,nsubj,pobj,PRP,NNP,2,1
2441,1268.0,49,staged,17,13,32,19,12,16,4,15,Mad,United States,,per-per,PROPN,PROPN-PROPN,compound,compound-pobj,NNP,NNP-NNP,7,1
2442,1269.0,21,ended,3,8,12,4,7,8,-5,9,Pakistan International Airlines,PIA,--,per,PROPN-PROPN-PROPN,PROPN,compound-compound-pobj,appos,NNP-NNP-NNPS,NNP,2,1
2443,1270.0,29,are,9,1,18,17,0,10,8,9,The Oaks,Orlando,per-per,,DET-PROPN,PROPN,det-nsubj,compound,DT-NNPS,NNP,6,1
2444,1271.0,40,know,1,35,38,3,34,1,-34,37,Bob Corker,Tennessee,-,org,PROPN-PROPN,PROPN,compound-nsubj,compound,NNP-NNP,NNP,1,1
2445,4622.0,14,sought,2,10,13,3,9,0,-8,11,Bob Corker,Tennessee,per-per,,PROPN-PROPN,PROPN,compound-appos,pobj,NNP-NNP,NNP,2,1
2446,11183.0,27,emerged,2,19,22,3,18,4,-17,20,Bob Corker,Tennessee,-,per,PROPN-PROPN,PROPN,compound-conj,compound,NNP-NNP,NNP,1,1
2447,1273.0,129,began,3,26,67,41,25,61,-23,64,NYSE,Time Warner,,org-org,PROPN,PROPN-PROPN,appos,compound-compound,NNP,NNP-NNP,8,1
2448,1274.0,40,retired,1,9,13,4,8,26,-8,12,Indiana,Bayh,per,,PROPN,PROPN,pobj,pobj,NNP,NNP,7,1
2449,1275.0,30,created,5,4,5,1,3,24,1,0,2006,Frontier Airlines Holdings,org,--,NUM,PROPN-PROPN-PROPN,npadvmod,compound-compound-compound,CD,NNP-NNPS-NNPS,1,1
2450,1276.0,11,won,7,1,6,5,0,4,6,-1,Tsai Ing-wen,DPP,org-org,,PROPN-PROPN,PROPN,compound-compound,pobj,NNP-NNP,NNP,5,1
2451,1277.0,33,is,8,13,18,5,12,14,-5,10,United States,934th Airlift Wing,per-per,--,PROPN-PROPN,PROPN-PROPN-PROPN,compound-compound,amod-compound-pobj,NNP-NNP,NNP-NNP-NNP,3,1
2452,1278.0,24,was,6,5,9,4,4,14,1,3,Osho,India,per,,PROPN,PROPN,appos,pobj,NNP,NNP,4,1
2453,1626.0,33,met,1,12,16,4,11,16,-11,15,Osho,India,,org,PROPN,PROPN,compound,pobj,NNP,NNP,6,1
2454,13329.0,36,commented,2,11,22,11,10,13,-9,20,Osho,India,per,,PROPN,PROPN,compound,pobj,NNP,NNP,9,1
2455,1279.0,28,is,5,2,24,22,1,3,3,19,Rutgers University,New Brunswick,-,per-per,PROPN-PROPN,PROPN-PROPN,compound-compound,compound-compound,NNP-NNP,NNP-NNP,12,1
2456,13047.0,18,holds,1,8,14,6,7,3,-7,13,Rutgers University,New Brunswick,-,org-org,PROPN-PROPN,PROPN-PROPN,compound-pobj,compound-compound,NNP-NNP,NNP-NNP,5,1
2457,1280.0,20,says,5,14,18,4,13,1,-9,13,Pakistan,Pervez Musharraf,org,-,PROPN,PROPN-PROPN,poss,compound-pobj,NNP,NNP-NNP,2,1
2458,1598.0,37,returned,11,5,21,16,4,15,6,10,Pakistan,Pervez Musharraf,,org-org,PROPN,PROPN-PROPN,pobj,compound-pobj,NNP,NNP-NNP,7,1
2459,2122.0,48,seen,5,18,34,16,17,13,-13,29,Pakistan,Pervez Musharraf,per,-,PROPN,PROPN-PROPN,compound,compound-pobj,NNP,NNP-NNP,8,1
2460,2636.0,22,established,2,5,9,4,4,12,-3,7,Pakistan,Pervez Musharraf,,per-per,PROPN,PROPN-PROPN,poss,compound-pobj,NNP,NNP-NNP,2,1
2461,4081.0,21,said,6,1,5,4,0,15,5,-1,Pakistan,Pervez Musharraf,per,-,PROPN,PROPN-PROPN,poss,compound-appos,NNP,NNP-NNP,3,1
2462,8468.0,20,included,5,14,18,4,13,1,-9,13,Pakistan,Pervez Musharraf,,per-per,PROPN,PROPN-PROPN,poss,compound-conj,NNP,NNP-NNP,2,1
2463,9580.0,34,houses,1,31,32,1,30,1,-30,31,Pakistan,Pervez Musharraf,org,-,PROPN,PROPN-PROPN,compound,compound-pobj,NNP,NNP-NNP,1,1
2464,10132.0,39,received,1,20,35,15,19,3,-19,34,Pakistan,Pervez Musharraf,org,-,PROPN,PROPN-PROPN,pobj,compound-dobj,NNP,NNP-NNP,7,1
2465,12007.0,20,says,2,12,18,6,11,1,-10,16,Pakistan,Pervez Musharraf,,org-org,PROPN,PROPN-PROPN,pobj,compound-pobj,NNP,NNP-NNP,3,1
2466,13814.0,23,inaugurated,7,19,21,2,18,1,-12,14,Pakistan,Pervez Musharraf,,org-org,PROPN,PROPN-PROPN,compound,compound-pobj,NNP,NNP-NNP,1,1
2467,1281.0,29,was,5,12,28,16,11,0,-7,23,Americas Society,1965,-,per,PROPN-PROPN,NUM,compound-compound,pobj,NNP-NNP,CD,6,1
2468,1282.0,41,created,2,7,39,32,6,1,-5,37,Guardian Industries Corp.,William Davidson,--,org-org,PROPN-PROPN-PROPN,PROPN-PROPN,compound-compound-nsubj,compound-conj,NNP-NNPS-NNP,NNP-NNP,9,1
2469,9791.0,41,Corp.,5,4,9,5,3,31,1,4,Guardian Industries Corp.,William Davidson,--,org-org,PROPN-PROPN-PROPN,PROPN-PROPN,compound-compound-ROOT,compound-appos,NNP-NNPS-NNP,NNP-NNP,2,1
2470,1283.0,20,is,2,7,13,6,6,6,-5,11,Health and Human Services,Thompson,---,org,PROPN-CCONJ-PROPN-PROPN,PROPN,nmod-cc-compound-conj,nsubj,NNP-CC-NNP-NNPS,NNP,3,1
2471,1284.0,27,is,1,1,6,5,0,20,0,5,Blueys,Australia,org,,PROPN,PROPN,nsubj,compound,NNP,NNP,2,1
2472,1286.0,17,is,10,1,13,12,0,3,9,3,Julie Payette,Canadian,org-org,,PROPN-PROPN,ADJ,compound-compound,amod,NNP-NNP,JJ,3,1
2473,1287.0,26,became,11,8,10,2,7,15,3,-1,South Africa,Mr. Smith,-,per-per,PROPN-PROPN,PROPN-PROPN,compound-compound,compound-pobj,NNP-NNP,NNP-NNP,6,1
2474,11882.0,33,said,17,15,27,12,14,5,2,10,South Africa,Mr. Smith,-,org-org,PROPN-PROPN,PROPN-PROPN,compound-appos,compound-poss,NNP-NNP,NNP-NNP,13,1
2475,1288.0,32,announced,5,10,25,15,9,6,-5,20,University of Wales,Swansea Metropolitan University,org-org-org,--,PROPN-ADP-PROPN,PROPN-PROPN-PROPN,dobj-prep-pobj,compound-compound-dobj,NNP-IN-NNP,NNP-NNP-NNP,7,1
2476,1289.0,39,born,2,1,7,6,0,31,1,5,Steadman,England,org,,PROPN,PROPN,nsubjpass,pobj,NNP,NNP,3,1
2477,1290.0,50,terminated,12,26,31,5,25,18,-14,19,High Council,Abdel Aziz,per-per,-,PROPN-PROPN,PROPN-PROPN,compound-pobj,compound-pobj,NNP-NNP,NNP-NNP,4,1
2478,1291.0,32,store,5,4,26,22,3,5,1,21,Uniqlo,Tadashi Yanai,,per-per,PROPN,PROPN-PROPN,compound,compound-appos,NNP,NNP-NNP,-1,1
2479,1292.0,89,imagined,6,62,66,4,61,22,-56,60,Ingrid Newkirk,People for the Ethical Treatment of Animals,per-per,------,PROPN-PROPN,PROPN-ADP-DET-PROPN-PROPN-ADP-PROPN,compound-compound,pobj-prep-det-compound-pobj-prep-pobj,NNP-NNP,NNPS-IN-DT-NNP-NNP-IN-NNPS,2,1
2480,3402.0,71,Notice,0,34,38,4,33,32,-34,38,Ingrid Newkirk,People for the Ethical Treatment of Animals,-,org-org-org-org-org-org-org,PROPN-PROPN,PROPN-ADP-DET-PROPN-PROPN-ADP-PROPN,compound-compound,pobj-prep-det-compound-pobj-prep-pobj,NNP-NNP,NNPS-IN-DT-NNP-NNP-IN-NNPS,2,1
2481,1294.0,8,based,2,1,5,4,0,2,1,3,It,Shouguang,per,,PRON,PROPN,nsubjpass,compound,PRP,NNP,4,1
2482,1296.0,33,accepted,5,16,23,7,15,9,-11,18,Lado Gurgenidze,Georgia,-,org,PROPN-PROPN,PROPN,compound-compound,poss,NNP-NNP,NNP,7,1
2483,7710.0,26,said,10,9,23,14,8,2,1,13,Lado Gurgenidze,Georgia,org-org,,PROPN-PROPN,PROPN,compound-nsubj,pobj,NNP-NNP,NNP,9,1
2484,13097.0,59,has,5,32,35,3,31,23,-27,30,Lado Gurgenidze,Georgia,org-org,,PROPN-PROPN,PROPN,compound-pobj,nmod,NNP-NNP,NNP,3,1
2485,1297.0,18,becomes,5,10,16,6,9,1,-5,11,Guyana,Cheddi Jagan,per,-,PROPN,PROPN-PROPN,pobj,compound-appos,NNP,NNP-NNP,4,1
2486,1515.0,25,recalled,4,7,13,6,6,11,-3,9,Guyana,Cheddi Jagan,org,-,PROPN,PROPN-PROPN,pobj,compound-appos,NNP,NNP-NNP,2,1
2487,2498.0,25,unveiled,11,8,10,2,7,14,3,-1,Guyana,Cheddi Jagan,,org-org,PROPN,PROPN-PROPN,compound,compound-pobj,NNP,NNP-NNP,1,1
2488,4070.0,30,was,1,3,26,23,2,3,-2,25,Guyana,Cheddi Jagan,org,-,PROPN,PROPN-PROPN,poss,compound-pobj,NNP,NNP-NNP,8,1
2489,7816.0,18,designated,11,5,9,4,4,8,6,-2,Guyana,Cheddi Jagan,,org-org,PROPN,PROPN-PROPN,poss,compound-nsubj,NNP,NNP-NNP,3,1
2490,10186.0,34,was,17,30,32,2,29,1,-13,15,Guyana,Cheddi Jagan,per,-,PROPN,PROPN-PROPN,compound,compound-pobj,NNP,NNP-NNP,4,1
2491,10452.0,44,said,2,8,10,2,7,33,-6,8,Guyana,Cheddi Jagan,,per-per,PROPN,PROPN-PROPN,poss,compound-compound,NNP,NNP-NNP,4,1
2492,10658.0,39,is,13,1,5,4,0,33,12,-8,Guyana,Cheddi Jagan,org,-,PROPN,PROPN-PROPN,poss,compound-compound,NNP,NNP-NNP,5,1
2493,10706.0,28,had,3,16,18,2,15,9,-13,15,Guyana,Cheddi Jagan,,per-per,PROPN,PROPN-PROPN,pobj,compound-compound,NNP,NNP-NNP,4,1
2494,1298.0,12,attended,1,3,7,4,2,4,-2,6,Beal High School,Redbridge,--,per,PROPN-PROPN-PROPN,PROPN,compound-compound-dobj,pobj,NNP-NNP-NNP,NNP,3,1
2495,1299.0,44,retrieved,4,1,2,1,0,41,3,-2,Sidney,Myer,org,,PROPN,PROPN,compound,compound,NNP,NNP,2,1
2496,1300.0,26,was,12,17,22,5,16,3,-5,10,William III of England,Mary II of England,---,org-org-org-org,PROPN-PROPN-ADP-PROPN,PROPN-PROPN-ADP-PROPN,compound-pobj-prep-pobj,compound-conj-prep-pobj,NNP-NNP-IN-NNP,NNP-NNP-IN-NNP,4,1
2497,1302.0,27,studied,1,4,8,4,3,18,-3,7,Bablake School,Coventry,per-per,,PROPN-PROPN,PROPN,compound-pobj,pobj,NNP-NNP,NNP,4,1
2498,1303.0,15,Time,3,1,12,11,0,2,2,9,The Libertines,Rough Trade,per-per,-,DET-PROPN,PROPN-PROPN,det-compound,compound-pobj,DT-NNP,NNP-NNP,3,1
2499,4500.0,16,signed,2,4,13,9,3,2,-2,11,The Libertines,Rough Trade,per-per,-,DET-PROPN,PROPN-PROPN,det-conj,compound-compound,DT-NNPS,NNP-NNP,5,1
2500,12174.0,17,released,2,1,14,13,0,2,1,12,The Libertines,Rough Trade,per-per,-,DET-PROPN,PROPN-PROPN,det-nsubj,compound-compound,DT-NNPS,NNP-NNP,5,1
2501,1304.0,30,made,5,13,15,2,12,14,-8,10,Agriculture,Dan Glickman,per,-,PROPN,PROPN-PROPN,compound,compound-conj,NNP,NNP-NNP,1,1
2502,2525.0,32,reported,15,13,14,1,12,17,2,-1,Agriculture,Dan Glickman,org,-,PROPN,PROPN-PROPN,pobj,compound-conj,NNP,NNP-NNP,1,1
2503,6983.0,43,worked,2,29,30,1,28,12,-27,28,Agriculture,Dan Glickman,per,-,PROPN,PROPN-PROPN,pobj,compound-pobj,NNP,NNP-NNP,1,1
2504,7643.0,16,designated,7,5,6,1,4,9,2,-1,Agriculture,Dan Glickman,per,-,PROPN,PROPN-PROPN,pobj,compound-nsubj,NNP,NNP-NNP,1,1
2505,10637.0,46,wrote,11,5,7,2,4,38,6,-4,Agriculture,Dan Glickman,,org-org,PROPN,PROPN-PROPN,compound,compound-pobj,NNP,NNP-NNP,1,1
2506,1306.0,22,released,4,4,11,7,3,10,0,7,Smither,Signature Sounds Recordings,org,--,PROPN,NOUN-VERB-PROPN,nsubj,compound-compound-pobj,NNP,NN-VBZ-NNPS,4,1
2507,7298.0,19,released,1,1,12,11,0,6,0,11,Smither,Signature Sounds Recordings,,org-org-org,PROPN,NOUN-VERB-PROPN,nsubj,compound-compound-appos,NNP,NN-VBZ-NNPS,5,1
2508,1307.0,10,Ex-deputy,0,3,8,5,2,1,-3,8,Wyclef Jean,Haiti,-,org,PROPN-PROPN,PROPN,compound-nsubj,compound,NNP-NNP,NNP,2,1
2509,1308.0,13,written,3,6,12,6,5,0,-3,9,Hank Williams,Alabama,per-per,,PROPN-PROPN,PROPN,compound-pobj,pobj,NNP-NNP,NNP,3,1
2510,9663.0,21,met,8,7,20,13,6,0,1,12,Hank Williams,Alabama,org-org,,PROPN-PROPN,PROPN,compound-pobj,pobj,NNP-NNP,NNP,5,1
2511,1310.0,34,provided,10,19,24,5,18,9,-9,14,Kim Jong-Il,National Defence Commission,org-org,--,PROPN-PROPN,PROPN-PROPN-PROPN,compound-compound,compound-compound-pobj,NNP-NNP,NNP-NNP-NNP,5,1
2512,5873.0,23,attended,3,2,20,18,1,2,1,17,Kim Jong-Il,National Defence Commission,-,per-per-per,PROPN-PROPN,PROPN-PROPN-PROPN,compound-nsubj,compound-compound-pobj,NNP-NNP,NNP-NNP-NNP,6,1
2513,10399.0,40,said,27,19,24,5,18,15,8,-3,Kim Jong-Il,National Defence Commission,org-org,--,PROPN-PROPN,PROPN-PROPN-PROPN,compound-compound,compound-compound-pobj,NNP-NNP,NNP-NNP-NNP,5,1
2514,13201.0,31,reshuffled,6,4,9,5,3,21,2,3,Kim Jong-Il,National Defence Commission,org-org,--,PROPN-PROPN,PROPN-PROPN-PROPN,compound-nsubj,compound-compound-dobj,NNP-NNP,NNP-NNP-NNP,4,1
2515,1311.0,37,performed,3,6,28,22,5,8,-3,25,Kathleen Lynch,Butthole Surfers,-,org-org,PROPN-PROPN,PROPN-PROPN,compound-pobj,compound-nmod,NNP-NNP,NNP-NNPS,-1,1
2516,1313.0,34,said,28,26,27,1,25,6,2,-1,Minister,Alexandr Vondra,org,-,PROPN,PROPN-PROPN,compound,compound-pobj,NNP,NNP-NNP,2,1
2517,1314.0,22,became,3,2,18,16,1,3,1,15,2004,New Zealand Football Championship,per,---,NUM,PROPN-PROPN-PROPN-PROPN,pobj,compound-compound-compound-pobj,CD,NNP-NNP-NNP-NNP,9,1
2518,1315.0,37,killed,12,2,2,0,1,34,10,-10,Israel Defense Forces,Israel,per-per-per,,PROPN-PROPN-PROPN,PROPN,compound-compound-nmod,pobj,NNP-NNP-NNPS,NNP,0,1
2519,1379.0,36,told,6,3,3,0,2,32,3,-3,Israel Defense Forces,Israel,--,org,PROPN-PROPN-PROPN,PROPN,compound-compound-compound,pobj,NNP-NNP-NNPS,NNP,0,1
2520,7853.0,32,confirmed,9,2,2,0,1,29,7,-7,Israel Defense Forces,Israel,per-per-per,,PROPN-PROPN-PROPN,PROPN,compound-compound-nsubj,pobj,NNP-NNP-NNPS,NNP,0,1
2521,11919.0,30,said,3,1,1,0,0,28,2,-2,Israel Defense Forces,Israel,org-org-org,,PROPN-PROPN-PROPN,PROPN,compound-compound-nsubj,dobj,NNP-NNP-NNPS,NNP,0,1
2522,13486.0,33,told,10,5,5,0,4,27,5,-5,Israel Defense Forces,Israel,--,org,PROPN-PROPN-PROPN,PROPN,compound-compound-pobj,poss,NNP-NNP-NNPS,NNP,0,1
2523,1316.0,7,signed,2,1,5,4,0,1,1,3,Andrews,Word Records,per,-,PROPN,PROPN-PROPN,nsubjpass,compound-pobj,NNP,NNP-NNPS,3,1
2524,1317.0,15,is,1,1,10,9,0,4,0,9,Zubaydah,Zayn Al Abidin Muhammad Husayn,per,----,PROPN,PROPN-PROPN-PROPN-PROPN-PROPN,nsubj,compound-compound-compound-compound-attr,NNP,NNP-NNP-NNP-NNP-NNP,2,1
2525,1318.0,29,defeated,8,11,17,6,10,11,-3,9,Havana,Rocky Romero,per,-,PROPN,PROPN-PROPN,compound,compound-conj,NNP,NNP-NNP,2,1
2526,9815.0,39,teamed,7,17,25,8,16,13,-10,18,Havana,Rocky Romero,,org-org,PROPN,PROPN-PROPN,compound,compound-conj,NNP,NNP-NNP,2,1
2527,1320.0,42,received,2,11,14,3,10,27,-9,12,Gustav Stresemann,Germany,-,per,PROPN-PROPN,PROPN,compound-pobj,pobj,NNP-NNP,NNP,1,1
2528,1321.0,29,was,2,15,24,9,14,4,-13,22,Ireland,Planxty,,per,PROPN,PROPN,compound,pobj,NNP,NNP,7,1
2529,1322.0,49,won,3,1,19,18,0,29,2,16,Arthur R. Gould,Maine,--,org,PROPN-PROPN-PROPN,PROPN,compound-compound-nsubj,compound,NNP-NNP-NNP,NNP,8,1
2530,1323.0,15,born,3,1,8,7,0,6,2,5,Pierre-Auguste Renoir,France,-,org,PROPN-PROPN,PROPN,amod-nsubjpass,ROOT,NNP-NNP,NNP,7,1
2531,1324.0,41,facing,14,10,2,-8,9,38,4,-12,Colorado,Salazar,org,,PROPN,PROPN,poss,pobj,NNP,NNP,4,1
2532,1325.0,20,said,15,2,14,12,1,5,13,-1,United States,Joe,per-per,,PROPN-PROPN,PROPN,compound-nsubj,compound,NNP-NNP,NNP,4,1
2533,3905.0,32,supports,3,2,11,9,1,20,1,8,United States,Joe,-,org,PROPN-PROPN,PROPN,compound-nsubj,compound,NNP-NNP,NNP,3,1
2534,1326.0,31,nominated,8,6,17,11,5,13,2,9,Lyndon B. Johnson,United States,per-per-per,-,PROPN-PROPN-PROPN,PROPN-PROPN,compound-compound-nsubj,compound-compound,NNP-NNP-NNP,NNP-NNP,7,1
2535,8150.0,34,nominated,6,10,19,9,9,14,-4,13,Lyndon B. Johnson,United States,org-org-org,-,PROPN-PROPN-PROPN,PROPN-PROPN,compound-compound-pobj,compound-compound,NNP-NNP-NNP,NNP-NNP,8,1
2536,12842.0,48,enunciated,3,8,13,5,7,34,-5,10,Lyndon B. Johnson,United States,org-org-org,-,PROPN-PROPN-PROPN,PROPN-PROPN,compound-compound-pobj,compound-poss,NNP-NNP-NNP,NNP-NNP,6,1
2537,1327.0,32,issued,2,21,24,3,20,7,-19,22,Jon Kyl,Arizona,-,per,PROPN-PROPN,PROPN,compound-conj,pobj,NNP-NNP,NNP,3,1
2538,2403.0,24,stated,6,3,6,3,2,17,3,0,Jon Kyl,Arizona,per-per,,PROPN-PROPN,PROPN,compound-nsubj,pobj,NNP-NNP,NNP,1,1
2539,9454.0,36,gave,5,17,20,3,16,15,-12,15,Jon Kyl,Arizona,-,per,PROPN-PROPN,PROPN,compound-pobj,pobj,NNP-NNP,NNP,3,1
2540,1329.0,21,attended,1,3,10,7,2,10,-2,9,Rutherford B. Hayes,Ohio,per-per-per,,PROPN-PROPN-PROPN,PROPN,compound-compound-compound,appos,NNP-NNP-NNP,NNP,3,1
2541,6914.0,20,appointed,3,12,16,4,11,3,-9,13,Rutherford B. Hayes,Ohio,per-per-per,,PROPN-PROPN-PROPN,PROPN,compound-compound-pobj,compound,NNP-NNP-NNP,NNP,6,1
2542,10007.0,16,displayed,4,8,15,7,7,0,-4,11,Rutherford B. Hayes,Ohio,org-org-org,,PROPN-PROPN-PROPN,PROPN,compound-compound-compound,pobj,NNP-NNP-NNP,NNP,4,1
2543,12555.0,21,resigned,8,6,13,7,5,7,2,5,Rutherford B. Hayes,Ohio,org-org-org,,PROPN-PROPN-PROPN,PROPN,compound-compound-nsubj,pobj,NNP-NNP-NNP,NNP,4,1
2544,1330.0,33,is,1,1,14,13,0,18,0,13,Orange,Telekomunikacja Polska,,per-per,PROPN,PROPN-PROPN,nsubj,compound-pobj,NNP,NNP-NNP,4,1
2545,1331.0,24,single,2,12,16,4,11,7,-10,14,Sony Music Japan,Yui,per-per-per,,PROPN-PROPN-PROPN,PROPN,compound-compound-compound,pobj,NNP-NNP-NNP,NNP,7,1
2546,1332.0,54,Using,0,20,23,3,19,30,-20,23,University of Leicester,UK,per-per-per,,PROPN-ADP-PROPN,PROPN,pobj-prep-compound,pobj,NNP-IN-NNP,NNP,6,1
2547,5287.0,14,is,2,10,13,3,9,0,-8,11,University of Leicester,UK,--,org,PROPN-ADP-PROPN,PROPN,nmod-prep-pobj,pobj,NNP-IN-NNP,NNP,6,1
2548,1333.0,14,introduced,7,2,5,3,1,8,5,-2,Daniel Akaka,Hawaii,-,per,PROPN-PROPN,PROPN,compound-nsubj,compound,NNP-NNP,NNP,1,1
2549,1857.0,56,eulogized,14,8,13,5,7,42,6,-1,Daniel Akaka,Hawaii,per-per,,PROPN-PROPN,PROPN,compound-nsubj,appos,NNP-NNP,NNP,2,1
2550,2871.0,46,include,8,35,38,3,34,7,-27,30,Daniel Akaka,Hawaii,per-per,,PROPN-PROPN,PROPN,compound-appos,appos,NNP-NNP,NNP,2,1
2551,3132.0,53,shown,9,3,8,5,2,44,6,-1,Daniel Akaka,Hawaii,-,org,PROPN-PROPN,PROPN,compound-compound,pobj,NNP-NNP,NNP,3,1
2552,5524.0,53,were,2,9,12,3,8,40,-7,10,Daniel Akaka,Hawaii,-,per,PROPN-PROPN,PROPN,compound-appos,compound,NNP-NNP,NNP,2,1
2553,6887.0,39,have,11,2,5,3,1,33,9,-6,Daniel Akaka,Hawaii,-,org,PROPN-PROPN,PROPN,compound-nsubj,pobj,NNP-NNP,NNP,1,1
2554,8751.0,20,responded,5,2,5,3,1,14,3,0,Daniel Akaka,Hawaii,-,org,PROPN-PROPN,PROPN,compound-nsubj,pobj,NNP-NNP,NNP,1,1
2555,8941.0,54,were,15,17,20,3,16,33,-2,5,Daniel Akaka,Hawaii,-,org,PROPN-PROPN,PROPN,compound-attr,pobj,NNP-NNP,NNP,2,1
2556,10190.0,35,was,1,14,34,20,13,0,-13,33,Daniel Akaka,Hawaii,per-per,,PROPN-PROPN,PROPN,compound-conj,pobj,NNP-NNP,NNP,7,1
2557,10422.0,27,continued,9,17,20,3,16,6,-8,11,Daniel Akaka,Hawaii,-,org,PROPN-PROPN,PROPN,compound-pobj,pobj,NNP-NNP,NNP,1,1
2558,12825.0,24,sponsored,2,12,23,11,11,0,-10,21,Daniel Akaka,Hawaii,per-per,,PROPN-PROPN,PROPN,compound-pobj,pobj,NNP-NNP,NNP,6,1
2559,13429.0,28,passed,13,6,12,6,5,15,7,-1,Daniel Akaka,Hawaii,per-per,,PROPN-PROPN,PROPN,compound-conj,compound,NNP-NNP,NNP,3,1
2560,1334.0,14,was,5,2,8,6,1,5,3,3,IX Troop Carrier Command,United States Army Air Forces,---,per-per-per-per-per,PROPN-PROPN-PROPN-PROPN,PROPN-PROPN-PROPN-PROPN-PROPN,compound-compound-compound-nsubj,compound-compound-compound-compound-compound,NNP-NNP-NNP-NNP,NNP-NNP-NNP-NNP-NNPS,6,1
2561,1335.0,24,is,3,2,22,20,1,1,1,19,Bros,Dan Dunn,per,-,PROPN,PROPN-PROPN,compound,compound-conj,NNP,NNP-NNP,8,1
2562,1336.0,19,given,5,4,16,12,3,2,1,11,college,Delhi,per,,NOUN,PROPN,nsubjpass,compound,NN,NNP,6,1
2563,1337.0,22,Sat?,0,1,17,16,0,4,-1,17,Sat?,hat Ja,,per-per,PROPN,NOUN-PROPN,ROOT,attr-compound,NNP,NN-NNP,5,1
2564,1338.0,21,constructed,8,2,4,2,1,16,6,-4,1872,Intercolonial Railway,org,-,NUM,PROPN-PROPN,pobj,compound-nsubjpass,CD,NNP-NNP,1,1
2565,1339.0,13,moved,3,6,8,2,5,4,-3,5,Vancouver,his,org,,PROPN,DET,pobj,poss,NNP,PRP$,1,1
2566,1341.0,26,appointed,6,5,14,9,4,11,1,8,Peter Lougheed,Alberta,org-org,,PROPN-PROPN,PROPN,compound-nsubj,pobj,NNP-NNP,NNP,3,1
2567,9109.0,40,appointed,10,9,18,9,8,21,1,8,Peter Lougheed,Alberta,per-per,,PROPN-PROPN,PROPN,compound-pobj,pobj,NNP-NNP,NNP,5,1
2568,1342.0,15,lives,10,1,9,8,0,5,9,-1,Johnette Napolitano,Concrete Blonde,per-per,-,PROPN-PROPN,PROPN-PROPN,compound-compound,compound-pobj,NNP-NNP,NNP-NNP,5,1
2569,1343.0,22,is,1,8,18,10,7,3,-7,17,Fu Jen Catholic University,Taiwan,---,org,PROPN-PROPN-PROPN-PROPN,PROPN,compound-compound-compound-compound,compound,NNP-NNP-NNP-NNP,NNP,3,1
2570,1344.0,26,graduated,1,9,13,4,8,12,-8,12,National Autonomous University of Honduras,Honduras,org-org-org-org-org,,PROPN-PROPN-PROPN-ADP-PROPN,PROPN,compound-compound-pobj-prep-pobj,ROOT,NNP-NNP-NNP-IN-NNP,NNP,3,1
2571,1345.0,36,responded,22,21,22,1,20,13,1,0,Michigan,Eminem,org,,PROPN,PROPN,compound,pobj,NNP,NNP,2,1
2572,8442.0,29,opened,7,18,28,10,17,0,-11,21,Michigan,Eminem,,per,PROPN,PROPN,pobj,pobj,NNP,NNP,12,1
2573,1346.0,32,recorded,17,14,15,1,13,16,3,-2,Argentina,Mercedes Sosa,per,-,PROPN,PROPN-PROPN,compound,compound-pobj,NNP,NNP-NNP,1,1
2574,1347.0,35,born,2,19,25,6,18,9,-17,23,Diocesan College,Rondebosch,-,org,PROPN-PROPN,PROPN,compound-pobj,compound,NNP-NNP,NNP,2,1
2575,1348.0,32,was,11,24,30,6,23,1,-13,19,Appalachian State Mountaineers,North Carolina,--,per-per,PROPN-PROPN-PROPN,PROPN-PROPN,compound-compound-pobj,compound-pobj,NNP-NNP-NNPS,NNP-NNP,4,1
2576,1350.0,32,flown,3,7,29,22,6,2,-4,26,England,Barnet General Hospital,per,--,PROPN,PROPN-PROPN-PROPN,pobj,compound-compound-pobj,NNP,NNP-NNP-NNP,9,1
2577,1351.0,14,founded,4,2,11,9,1,2,2,7,Jazzercise,Judi Sheppard Missett,per,--,PROPN,PROPN-PROPN-PROPN,compound,compound-compound-pobj,NNP,NNP-NNP-NNP,4,1
2578,1352.0,19,was,2,1,14,13,0,4,1,12,Dream Street,1999,org-org,,PROPN-PROPN,NUM,compound-nsubj,nummod,NNP-NNP,CD,6,1
2579,1353.0,18,created,2,1,12,11,0,5,1,10,Atari Games,Tengen,org-org,,PROPN-PROPN,PROPN,compound-nsubj,appos,NNP-NNPS,NNP,2,1
2580,4839.0,33,bought,5,11,14,3,10,18,-6,9,Atari Games,Tengen,org-org,,PROPN-PROPN,PROPN,compound-pobj,compound,NNP-NNPS,NNP,4,1
2581,1354.0,15,is,5,9,14,5,8,0,-4,9,Minneapolis Police Department,Minnesota,--,per,PROPN-PROPN-PROPN,PROPN,compound-compound-pobj,pobj,NNP-NNP-NNP,NNP,4,1
2582,1355.0,36,be,3,13,17,4,12,18,-10,14,Dirk Kempthorne,Idaho,-,org,PROPN-PROPN,PROPN,compound-pobj,compound,NNP-NNP,NNP,1,1
2583,1356.0,29,is,17,2,10,8,1,18,15,-7,Open University of Cyprus,in Cyp,org-org-org-org,-,PROPN-PROPN-ADP-PROPN,ADP-PROPN,compound-nmod-prep-pobj,prep-pobj,NNP-NNP-IN-NNP,IN-NNP,2,1
2584,1357.0,36,earned,9,18,30,12,17,5,-9,21,Howard University,NCAA,org-org,,PROPN-PROPN,PROPN,compound-pobj,compound,NNP-NNP,NNP,7,1
2585,11190.0,19,represented,6,3,13,10,2,5,3,7,Howard University,NCAA,-,per,PROPN-PROPN,PROPN,compound-dobj,compound,NNP-NNP,NNP,4,1
2586,1358.0,25,produced,5,5,10,5,4,14,0,5,he,Malta,per,,PRON,PROPN,nsubj,poss,PRP,NNP,4,1
2587,1359.0,16,headed,5,4,13,9,3,2,1,8,Council,Abubakar Tafawa Balewa,,org-org-org,PROPN,PROPN-PROPN-PROPN,nsubjpass,compound-compound-pobj,NNP,NNP-NNP-NNP,5,1
2588,1360.0,24,got,2,11,19,8,10,4,-9,17,Metro Manila,San Beda College,org-org,--,PROPN-PROPN,PROPN-PROPN-PROPN,compound-pobj,compound-compound-compound,NNP-NNP,NNP-NNP-NNP,7,1
2589,1361.0,20,approved,15,7,12,5,6,7,8,-3,Bradford,Yorkshire Building Society,org,--,PROPN,PROPN-PROPN-PROPN,pobj,compound-compound-compound,NNP,NNP-NNP-NNP,6,1
2590,1362.0,40,delivered,8,1,37,36,0,2,7,29,Embraer,dos Campos,org,-,PROPN,X-PROPN,compound,compound-compound,NNP,FW-NNP,7,1
2591,1363.0,44,released,23,34,39,5,33,4,-11,16,Cliff Richard,Rocket,org-org,,PROPN-PROPN,PROPN,compound-pobj,compound,NNP-NNP,NNP,5,1
2592,1364.0,33,announced,9,2,4,2,1,28,7,-5,Robert Kuok,Shangri-La Hotels and Resorts,per-per,---,PROPN-PROPN,NOUN-PROPN-CCONJ-PROPN,compound-nmod,compound-nmod-cc-conj,NNP-NNP,NN-NNP-CC-NNP,3,1
2593,1365.0,22,was,8,17,21,4,16,0,-9,13,Canadian Forces,Canada,org-org,,PROPN-PROPN,PROPN,compound-pobj,pobj,NNP-NNPS,NNP,4,1
2594,2516.0,49,placed,27,20,27,7,19,21,7,0,Canadian Forces,Canada,org-org,,PROPN-PROPN,PROPN,amod-compound,pobj,NNP-NNPS,NNP,9,1
2595,2945.0,35,continued,5,11,22,11,10,12,-6,17,Canadian Forces,Canada,-,org,PROPN-PROPN,PROPN,compound-nsubj,pobj,NNP-NNPS,NNP,6,1
2596,7458.0,37,praised,1,4,23,19,3,13,-3,22,Canadian Forces,Canada,per-per,,PROPN-PROPN,PROPN,compound-compound,poss,NNP-NNPS,NNP,6,1
2597,11322.0,37,trains,15,3,28,25,2,8,12,13,Canadian Forces,Canada,per-per,,ADJ-NOUN,PROPN,amod-compound,nmod,JJ-NNS,NNP,7,1
2598,12881.0,21,is,1,11,16,5,10,4,-10,15,Canadian Forces,Canada,org-org,,PROPN-PROPN,PROPN,compound-compound,poss,NNP-NNPS,NNP,5,1
2599,13163.0,17,knows,6,2,16,14,1,0,4,10,Canadian Forces,Canada,-,per,ADJ-PROPN,PROPN,amod-dep,dobj,JJ-NNPS,NNP,2,1
2600,1367.0,30,made,5,13,13,0,12,16,-8,8,Cleveland,Cleveland Orchestra,per,-,PROPN,PROPN-PROPN,compound,compound-pobj,NNP,NNP-NNP,0,1
2601,1368.0,27,purchased,5,7,24,17,6,2,-2,19,Regional Newspapers,Maitland Mercury,-,per-per,PROPN-PROPN,PROPN-PROPN,compound-poss,compound-compound,NNP-NNPS,NNP-NNP,6,1
2602,1369.0,17,contribution,4,8,16,8,7,0,-4,12,Apocalypse,Brazil,,org,ADJ,PROPN,compound,pobj,JJ,NNP,3,1
2603,1370.0,29,agreed,16,22,14,-8,21,14,-6,-2,2007,Thomas Cook Group,,org-org-org,NUM,PROPN-PROPN-PROPN,nummod,compound-compound-compound,CD,NNP-NNP-NNP,5,1
2604,1371.0,17,housed,4,1,10,9,0,6,3,6,Mt Maria College,Mitchelton,org-org-org,,PROPN-PROPN-PROPN,PROPN,compound-compound-nsubjpass,pobj,NNP-NNP-NNP,NNP,5,1
2605,1372.0,47,toured,2,11,13,2,10,33,-9,11,Spain,Raphael,per,,PROPN,PROPN,pobj,compound,NNP,NNP,2,1
2606,4769.0,15,recorded,3,11,14,3,10,0,-8,11,Spain,Raphael,per,,PROPN,PROPN,pobj,pobj,NNP,NNP,4,1
2607,1373.0,67,See,0,4,19,15,3,47,-4,19,Eminem,Aftermath,,org,NOUN,PROPN,compound,compound,NN,NNP,7,1
2608,9258.0,42,known,3,10,28,18,9,13,-7,25,Eminem,Aftermath,per,,PROPN,PROPN,compound,compound,NNP,NNP,10,1
2609,11463.0,44,helped,6,8,32,24,7,11,-2,26,Eminem,Aftermath,per,,PROPN,PROPN,nsubj,compound,NNP,NNP,9,1
2610,13912.0,30,lost,2,2,29,27,1,0,0,27,Eminem,Aftermath,,per,PROPN,PROPN,nsubj,appos,NNP,NNP,9,1
2611,1375.0,22,nominated,2,8,18,10,7,3,-6,16,United Abkhazia,his,per-per,,PROPN-PROPN,DET,compound-pobj,poss,NNP-NNP,PRP$,8,1
2612,1376.0,48,proved,7,5,17,12,4,30,2,10,Dogg,Mshasho,,per,PROPN,PROPN,pobj,pobj,NNP,NNP,9,1
2613,1377.0,32,founded,10,2,13,11,1,18,8,3,Yale School of Public Health,1915,org-org-org-org-org,,PROPN-PROPN-ADP-PROPN-PROPN,NUM,compound-nsubjpass-prep-compound-pobj,pobj,NNP-NNP-IN-NNP-NNP,CD,2,1
2614,1378.0,41,mahasiswa,3,1,6,5,0,34,2,3,Fatima Jafri,Trinity College,per-per,-,PROPN-PROPN,PROPN-PROPN,compound-nsubj,compound-compound,NNP-NNP,NNP-NNP,7,1
2615,1380.0,45,received,15,31,39,8,30,5,-16,24,Fatos Nano,Albania,org-org,,PROPN-PROPN,PROPN,compound-conj,poss,NNP-NNP,NNP,-1,1
2616,6400.0,41,were,5,7,15,8,6,25,-2,10,Fatos Nano,Albania,per-per,,PROPN-PROPN,PROPN,compound-compound,pobj,NNP-NNP,NNP,3,1
2617,8037.0,33,resigned,13,19,32,13,18,0,-6,19,Fatos Nano,Albania,org-org,,PROPN-PROPN,PROPN,compound-dobj,pobj,NNP-NNP,NNP,6,1
2618,1381.0,30,Centre,4,2,22,20,1,7,2,18,Scotland,University of Edinburgh,,per-per-per,PROPN,PROPN-ADP-PROPN,compound,pobj-prep-pobj,NNP,NNP-IN-NNP,8,1
2619,1382.0,57,is,9,1,19,18,0,37,8,10,Richard Manning Karp,University of California Berkeley,per-per-per,---,PROPN-PROPN-PROPN,PROPN-ADP-PROPN-PROPN,compound-compound-nsubj,nmod-prep-pobj-pobj,NNP-NNP-NNP,NNP-IN-NNP-NNP,7,1
2620,1383.0,24,inducted,3,2,7,5,1,16,1,4,Newman,Connecticut,,per,PROPN,PROPN,nsubjpass,compound,NNP,NNP,3,1
2621,4278.0,22,hangs,3,6,9,3,5,12,-3,6,Newman,Connecticut,per,,PROPN,PROPN,poss,compound,NNP,NNP,2,1
2622,4935.0,44,continue,10,15,36,21,14,7,-5,26,Newman,Connecticut,org,,PROPN,PROPN,poss,nmod,NNP,NNP,7,1
2623,13143.0,26,spent,7,7,18,11,6,7,0,11,Newman,Connecticut,per,,PROPN,PROPN,pobj,pobj,NNP,NNP,3,1
2624,1384.0,23,is,3,1,14,13,0,8,2,11,Chace Community School,Enfield,--,per,PROPN-PROPN-PROPN,PROPN,compound-compound-nsubj,compound,NNP-NNP-NNP,NNP,6,1
2625,1386.0,32,said,8,1,8,7,0,23,7,0,Russia,Lukoil,org,,PROPN,PROPN,poss,appos,NNP,NNP,3,1
2626,1387.0,32,opened,5,5,5,0,4,26,0,0,DGSE,DGSE Companies,,org-org,PROPN,PROPN-PROPN,nsubj,compound-nsubj,NNP,NNP-NNPS,0,1
2627,1388.0,21,released,3,17,19,2,16,1,-14,16,Cher,Geffen,org,,PROPN,PROPN,pobj,compound,NNP,NNP,1,1
2628,1390.0,16,entered,4,1,7,6,0,8,3,3,John Sidney McCain III,United States Naval Academy,---,org-org-org-org,PROPN-PROPN-PROPN-PROPN,PROPN-PROPN-PROPN-PROPN,compound-compound-compound-nsubj,compound-compound-compound-dobj,NNP-NNP-NNP-NNP,NNP-NNP-NNP-NNP,4,1
2629,1391.0,19,after,2,12,17,5,11,1,-10,15,New Orleans University,Dillard University,per-per-per,-,PROPN-PROPN-PROPN,PROPN-PROPN,compound-compound-pobj,compound-dobj,NNP-NNP-NNP,NNP-NNP,5,1
2630,1392.0,23,believed,2,1,8,7,0,14,1,6,Siddiqui,Pakistan,per,,NOUN,PROPN,nsubjpass,pobj,NN,NNP,4,1
2631,1393.0,86,signed,2,27,37,10,26,48,-25,35,Hollywood Undead,/ Octone Records,org-org,--,PROPN-PROPN,SYM-PROPN-PROPN,compound-dobj,punct-compound-pobj,NNP-NNP,SYM-NNP-NNPS,5,1
2632,1394.0,8,makes,4,1,2,1,0,5,3,-2,Producer,Butch Walker,per,-,PROPN,PROPN-PROPN,compound,compound-nsubj,NNP,NNP-NNP,1,1
2633,1395.0,40,issued,2,5,22,17,4,17,-3,20,Mute Records,Erasure,-,org,PROPN-PROPN,PROPN,compound-pobj,poss,NNP-NNPS,NNP,8,1
2634,7172.0,40,released,2,1,22,21,0,17,1,20,Mute Records,Erasure,org-org,,PROPN-PROPN,PROPN,compound-nsubj,poss,NNP-NNPS,NNP,9,1
2635,13337.0,30,released,2,1,23,22,0,6,1,21,Mute Records,Erasure,per-per,,PROPN-PROPN,PROPN,compound-nsubj,poss,NNP-NNPS,NNP,12,1
2636,1396.0,25,began,10,19,22,3,18,2,-9,12,Kadokawa Shoten,Comp Ace,-,org-org,PROPN-PROPN,PROPN-PROPN,compound-poss,compound-compound,NNP-NNP,NNP-NNP,2,1
2637,7378.0,29,serialized,8,11,17,6,10,11,-3,9,Kadokawa Shoten,Comp Ace,-,per-per,PROPN-PROPN,PROPN-PROPN,compound-poss,compound-pobj,NNP-NNP,NNP-NNP,2,1
2638,1397.0,27,jpg,0,4,5,1,3,21,-4,5,Governor,Tommy Thompson,per,-,PROPN,PROPN-PROPN,compound,compound-npadvmod,NNP,NNP-NNP,1,1
2639,1399.0,45,began,1,10,17,7,9,27,-9,16,Japan,Tetsuya Komuro,per,-,PROPN,PROPN-PROPN,pobj,compound-pobj,NNP,NNP-NNP,5,1
2640,1400.0,17,preeminent,4,2,8,6,1,8,2,4,South Africa,Athol Fugard,org-org,-,PROPN-PROPN,PROPN-PROPN,compound-poss,compound-compound,NNP-NNP,NNP-NNP,4,1
2641,1401.0,16,born,2,5,9,4,4,6,-3,7,Logierait,Alexander Mackenzie,per,-,PROPN,PROPN-PROPN,compound,compound-compound,NNP,NNP-NNP,5,1
2642,1402.0,17,is,3,9,15,6,8,1,-6,12,Ian Dury,Polydor,-,org,PROPN-PROPN,PROPN,compound-pobj,compound,NNP-NNP,NNP,-1,1
2643,1403.0,42,rose,2,1,12,11,0,29,1,10,Shiseido,Japan,,per,PROPN,PROPN,compound,poss,NNP,NNP,5,1
2644,1404.0,39,------------------------,0,14,25,11,13,13,-14,25,Ohio University,Athens,-,per,PROPN-PROPN,PROPN,compound-compound,compound,NNP-NNP,NNP,2,1
2645,1405.0,42,took,4,3,24,21,2,17,1,20,Iajuddin Ahmed,Bangladesh,-,org,PROPN-PROPN,PROPN,compound-nsubj,compound,NNP-NNP,NNP,4,1
2646,9833.0,35,declared,6,4,23,19,3,11,2,17,Iajuddin Ahmed,Bangladesh,-,org,PROPN-PROPN,PROPN,compound-appos,compound,NNP-NNP,NNP,5,1
2647,1406.0,31,is,1,21,21,0,20,9,-20,20,California,California Community Colleges System,,per-per-per-per,PROPN,PROPN-PROPN-PROPN-PROPN,pobj,compound-compound-compound-pobj,NNP,NNP-NNP-NNPS-NNP,0,1
2648,1407.0,23,is,8,7,14,7,6,8,1,6,Paul Zed,New Brunswick,-,per-per,PROPN-PROPN,PROPN-PROPN,compound-nsubj,compound-compound,NNP-NNP,NNP-NNP,7,1
2649,1408.0,19,represented,7,3,12,9,2,6,4,5,California Golden Bears,Berkeley,--,per,PROPN-PROPN-PROPN,PROPN,compound-compound-compound,dobj,NNP-NNP-NNP,NNP,4,1
2650,2119.0,30,represented,9,4,15,11,3,14,5,6,California Golden Bears,Berkeley,--,per,PROPN-PROPN-PROPN,PROPN,compound-compound-compound,dobj,NNP-NNP-NNP,NNP,5,1
2651,7518.0,20,represented,7,3,13,10,2,6,4,6,California Golden Bears,Berkeley,--,org,PROPN-PROPN-PROPN,PROPN,compound-compound-compound,dobj,NNP-NNP-NNP,NNP,4,1
2652,11670.0,21,represented,7,3,14,11,2,6,4,7,California Golden Bears,Berkeley,org-org-org,,PROPN-PROPN-PROPN,PROPN,compound-compound-compound,pobj,NNP-NNP-NNP,NNP,4,1
2653,12585.0,22,represented,7,3,13,10,2,8,4,6,California Golden Bears,Berkeley,per-per-per,,PROPN-PROPN-PROPN,PROPN,compound-compound-compound,dobj,NNP-NNP-NNP,NNP,4,1
2654,13831.0,20,represented,7,3,13,10,2,6,4,6,California Golden Bears,Berkeley,--,per,PROPN-PROPN-PROPN,PROPN,compound-compound-compound,dobj,NNP-NNP-NNP,NNP,4,1
2655,1409.0,21,contributed,1,1,5,4,0,15,0,4,He,Boston,,per,PRON,PROPN,nsubj,compound,PRP,NNP,3,1
2656,1410.0,16,is,3,1,15,14,0,0,2,12,Houari,Algeria,,per,PROPN,PROPN,nsubj,pobj,NNP,NNP,2,1
2657,1411.0,22,owned,13,11,17,6,10,4,2,4,Country Energy,Government of New South Wales,per-per,----,PROPN-PROPN,PROPN-ADP-PROPN-PROPN-PROPN,compound-nsubjpass,pobj-prep-compound-compound-pobj,NNP-NNP,NNP-IN-NNP-NNP-NNP,4,1
2658,1412.0,46,said,6,5,20,15,4,25,1,14,EPA,Stephen L. Johnson,org,--,PROPN,PROPN-PROPN-PROPN,compound,compound-compound-appos,NNP,NNP-NNP-NNP,7,1
2659,2643.0,28,meant,9,22,24,2,21,3,-13,15,EPA,Stephen L. Johnson,per,--,PROPN,PROPN-PROPN-PROPN,compound,compound-compound-nsubj,NNP,NNP-NNP-NNP,2,1
2660,9477.0,32,wrote,21,24,26,2,23,5,-3,5,EPA,Stephen L. Johnson,,per-per-per,PROPN,PROPN-PROPN-PROPN,compound,compound-compound-pobj,NNP,NNP-NNP-NNP,2,1
2661,13091.0,19,made,12,4,6,2,3,12,8,-6,EPA,Stephen L. Johnson,org,--,PROPN,PROPN-PROPN-PROPN,compound,compound-compound-pobj,NNP,NNP-NNP-NNP,2,1
2662,1413.0,38,contained,2,19,24,5,18,13,-17,22,Red Hot Chili Peppers,John Frusciante,org-org-org-org,-,PROPN-PROPN-PROPN-PROPN,PROPN-PROPN,compound-compound-compound-compound,compound-dobj,NNP-NNP-NNP-NNPS,NNP-NNP,3,1
2663,1414.0,38,has,3,2,16,14,1,21,1,13,SSC,Barangay North Poblacion,per,--,PROPN,PROPN-PROPN-PROPN,compound,compound-compound-pobj,NNP,NNP-NNP-NNP,5,1
2664,1415.0,11,starred,5,1,4,3,0,6,4,-1,Korda,Maria Corda,,org-org,PROPN,PROPN-PROPN,poss,compound-appos,NNP,NNP-NNP,3,1
2665,1416.0,33,challenged,5,3,13,10,2,19,2,8,Rupiah Banda,Zambia,per-per,,PROPN-PROPN,PROPN,compound-nsubj,compound,NNP-NNP,NNP,7,1
2666,3223.0,44,LUSAKA,0,22,41,19,21,2,-22,41,Rupiah Banda,Zambia,per-per,,PROPN-PROPN,PROPN,compound-pobj,pobj,NNP-NNP,NNP,14,1
2667,10572.0,61,gets,3,39,58,19,38,2,-36,55,Rupiah Banda,Zambia,per-per,,PROPN-PROPN,PROPN,compound-pobj,pobj,NNP-NNP,NNP,10,1
2668,11051.0,40,said,38,3,19,16,2,20,35,-19,Rupiah Banda,Zambia,per-per,,PROPN-PROPN,PROPN,compound-nsubj,compound,NNP-NNP,NNP,6,1
2669,1417.0,20,joined,4,9,14,5,8,5,-5,10,Rio de Janeiro,Federal University of Rio de Janeiro,org-org-org,-----,PROPN-PROPN-PROPN,PROPN-PROPN-ADP-PROPN-PROPN-PROPN,compound-compound-pobj,compound-appos-prep-compound-compound-pobj,NNP-NNP-NNP,NNP-NNP-IN-NNP-NNP-NNP,5,1
2670,1418.0,40,went,3,24,39,15,23,0,-21,36,Lebanese armed forces,Lebanon,per-per-per,,ADJ-ADJ-NOUN,PROPN,amod-amod-pobj,pobj,JJ-JJ-NNS,NNP,8,1
2671,1419.0,29,been,15,21,27,6,20,1,-6,12,G-Unit,Tony Yayo,per,-,PROPN,PROPN-PROPN,compound,compound-conj,NNP,NNP-NNP,3,1
2672,2329.0,45,announced,8,21,39,18,20,5,-13,31,G-Unit,Tony Yayo,,per-per,PUNCT,PROPN-PROPN,punct,compound-poss,.,NNP-NNP,9,1
2673,2476.0,25,G-Unit,0,1,3,2,0,21,-1,3,G-Unit,Tony Yayo,org,-,NOUN,PROPN-PROPN,ROOT,compound-nsubjpass,NNS,NNP-NNP,1,1
2674,3534.0,18,arrested,12,5,7,2,4,10,7,-5,G-Unit,Tony Yayo,per,-,PROPN,PROPN-PROPN,punct,compound-nsubjpass,NNP,NNP-NNP,1,1
2675,6444.0,33,confirmed,4,1,3,2,0,29,3,-1,G-Unit,Tony Yayo,,per-per,PROPN,PROPN-PROPN,intj,compound-nsubj,NNP,NNP-NNP,1,1
2676,8393.0,15,Based,0,5,13,8,4,1,-5,13,G-Unit,Tony Yayo,per,-,PROPN,PROPN-PROPN,punct,compound-pobj,NNP,NNP-NNP,9,1
2677,10133.0,13,features,2,5,7,2,4,5,-3,5,G-Unit,Tony Yayo,,org-org,PROPN,PROPN-PROPN,compound,compound-dobj,NNP,NNP-NNP,1,1
2678,12245.0,24,founded,3,9,22,13,8,1,-6,19,G-Unit,Tony Yayo,org,-,PROPN,PROPN-PROPN,punct,compound-conj,NNP,NNP-NNP,6,1
2679,13118.0,25,G-Unit,0,1,7,6,0,17,-1,7,G-Unit,Tony Yayo,per,-,PROPN,PROPN-PROPN,ROOT,compound-nsubjpass,NNP,NNP-NNP,4,1
2680,13259.0,28,features,1,7,13,6,6,14,-6,12,G-Unit,Tony Yayo,,per-per,PROPN,PROPN-PROPN,punct,compound-compound,NNP,NNP-NNP,7,1
2681,1420.0,10,is,2,1,1,0,0,8,1,-1,China Mobile,China,-,org,PROPN-PROPN,PROPN,compound-nsubj,poss,NNP-NNP,NNP,0,1
2682,1421.0,31,was,1,6,18,12,5,12,-5,17,NCAA,Carnegie Mellon,,per-per,PROPN,PROPN-PROPN,compound,compound-poss,NNP,NNP-NNP,5,1
2683,1422.0,19,compete,12,7,9,2,6,9,5,-3,Spain,de Honor de Rugby,,per-per-per-per,PROPN,PROPN-PROPN-PROPN-PROPN,poss,nmod-compound-compound-pobj,NNP,NNP-NNP-NNP-NNP,3,1
2684,1423.0,27,represented,6,3,22,19,2,4,3,16,Buffalo Bulls,Division I,org-org,-,PROPN-PROPN,PROPN-PRON,compound-compound,compound-compound,NNP-NNP,NNP-PRP,5,1
2685,2703.0,28,represent,7,3,23,20,2,4,4,16,Buffalo Bulls,Division I,org-org,-,PROPN-PROPN,PROPN-PRON,compound-compound,compound-compound,NNP-NNP,NNP-PRP,6,1
2686,8396.0,17,is,2,7,13,6,6,3,-5,11,Buffalo Bulls,Division I,per-per,-,PROPN-PROPN,PROPN-PRON,compound-compound,pobj-nmod,NNP-NNP,NNP-PRP,5,1
2687,9177.0,22,represented,6,3,16,13,2,5,3,10,Buffalo Bulls,Division I,-,org-org,PROPN-PROPN,PROPN-PRON,compound-compound,nmod-compound,NNP-NNP,NNP-PRP,-1,1
2688,11402.0,21,represented,6,3,16,13,2,4,3,10,Buffalo Bulls,Division I,org-org,-,PROPN-PROPN,PROPN-PRON,compound-compound,compound-compound,NNP-NNP,NNP-PRP,5,1
2689,1424.0,47,Covay,1,1,5,4,0,41,0,4,Don Covay,Donald Randolph,per-per,-,PROPN-PROPN,PROPN-PROPN,compound-ROOT,compound-dobj,NNP-NNP,NNP-NNP,2,1
2690,1425.0,29,Karad?i,1,1,7,6,0,21,0,6,Radovan Karad?i,of Republika Srps,per-per,--,PROPN-NUM,ADP-PROPN-PROPN,nsubj-ROOT,prep-compound-compound,NNP-CD,IN-NNP-NNP,-1,1
2691,7229.0,31,referred,4,21,13,-8,20,17,-17,9,Radovan Karad?i,of Republika Srps,per-per,--,PROPN-NUM,ADP-PROPN-PROPN,compound-pobj,prep-compound-pobj,NNP-CD,IN-NNP-NNP,8,1
2692,11992.0,22,testified,2,12,11,-1,11,10,-10,9,Radovan Karad?i,of Republika Srps,org-org,--,PROPN-NUM,ADP-PROPN-PROPN,pobj-advcl,prep-compound-compound,NNP-CD,IN-NNP-NNP,8,1
2693,1426.0,37,proceeded,31,24,28,4,23,8,7,-3,Iran,Iranian Space Agency,,org-org-org,PROPN,PROPN-PROPN-PROPN,pobj,compound-compound-conj,NNP,NNP-NNP-NNP,14,1
2694,1427.0,21,represents,5,2,8,6,1,12,3,3,Maryland Terrapins,University of Maryland,org-org,--,PROPN-PROPN,PROPN-ADP-PROPN,compound-compound,dobj-prep-pobj,NNP-NNP,NNP-IN-NNP,4,1
2695,1643.0,36,represented,8,4,11,7,3,24,4,3,Maryland Terrapins,University of Maryland,per-per,--,PROPN-PROPN,PROPN-ADP-PROPN,compound-compound,nmod-prep-pobj,NNP-NNP,NNP-IN-NNP,5,1
2696,1428.0,19,have,14,5,14,9,4,4,9,0,United Nations,IRIN,-,per,PROPN-PROPN,PROPN,compound-compound,pobj,NNP-NNP,NNP,4,1
2697,7370.0,23,reported,10,6,8,2,5,14,4,-2,United Nations,IRIN,per-per,,PROPN-PROPN,PROPN,compound-compound,compound,NNP-NNP,NNP,3,1
2698,1429.0,23,Tip,0,10,13,3,9,9,-10,13,Kit Bond,Missouri,org-org,,PROPN-PROPN,PROPN,compound-nsubj,pobj,NNP-NNP,NNP,2,1
2699,1719.0,26,Feinstein,0,10,13,3,9,12,-10,13,Kit Bond,Missouri,per-per,,PROPN-PROPN,PROPN,compound-nsubj,pobj,NNP-NNP,NNP,2,1
2700,2555.0,24,became,5,2,5,3,1,18,3,0,Kit Bond,Missouri,org-org,,PROPN-PROPN,PROPN,compound-nsubj,pobj,NNP-NNP,NNP,1,1
2701,1430.0,16,In,0,2,5,3,1,10,-2,5,Oregon,Jeff Merkley,org,-,PROPN,PROPN-PROPN,nmod,compound-poss,NNP,NNP-NNP,2,1
2702,1620.0,31,conceded,16,8,25,17,7,5,8,9,Oregon,Jeff Merkley,,per-per,PROPN,PROPN-PROPN,pobj,compound-appos,NNP,NNP-NNP,5,1
2703,7273.0,29,held,6,2,13,11,1,15,4,7,Oregon,Jeff Merkley,,per-per,PROPN,PROPN-PROPN,compound,compound-pobj,NNP,NNP-NNP,6,1
2704,11787.0,15,faced,6,2,13,11,1,1,4,7,Oregon,Jeff Merkley,per,-,PROPN,PROPN-PROPN,compound,compound-pobj,NNP,NNP-NNP,6,1
2705,1432.0,47,dropped,8,27,38,11,26,8,-19,30,ABC Kids,Disney,-,org,PROPN-PROPN,PROPN,compound-pobj,poss,NNP-NNP,NNP,9,1
2706,1433.0,63,included,20,44,46,2,43,16,-24,26,French,Henri Gaudier-Brzeska,per,-,ADJ,PROPN-PROPN,amod,compound-compound,JJ,NNP-NNP,2,1
2707,1434.0,31,descended,5,1,16,15,0,14,4,11,Bell Baxter High School,1889,per-per-per-per,,PROPN-PROPN-PROPN-PROPN,NUM,compound-compound-compound-nsubjpass,pobj,NNP-NNP-NNP-NNP,CD,7,1
2708,1436.0,18,has,8,4,7,3,3,10,4,-1,Sheldon Whitehouse,Rhode Island,-,org-org,PROPN-PROPN,PROPN-PROPN,compound-nsubj,compound-pobj,NNP-NNP,NNP-NNP,2,1
2709,5570.0,29,sponsored,2,12,15,3,11,13,-10,13,Sheldon Whitehouse,Rhode Island,-,org-org,PROPN-PROPN,PROPN-PROPN,compound-pobj,compound-pobj,NNP-NNP,NNP-NNP,2,1
2710,11442.0,35,signed,27,2,5,3,1,29,25,-22,Sheldon Whitehouse,Rhode Island,org-org,-,PROPN-PROPN,PROPN-PROPN,compound-nsubj,compound-compound,NNP-NNP,NNP-NNP,3,1
2711,1438.0,20,joined,4,3,11,8,2,8,1,7,Walsall F.C.,he,per-per,,PROPN-PROPN,PRON,compound-dobj,nsubj,NNP-NNP,PRP,4,1
2712,1439.0,32,is,9,1,15,14,0,16,8,6,Meta Linhas,Boa Vista,-,per-per,PROPN-PROPN,PROPN-PROPN,compound-nsubj,compound-compound,NNP-NNP,NNP-NNP,6,1
2713,1440.0,22,formed,7,2,4,2,1,17,5,-3,1998,Metropolitan Basketball Association,,per-per-per,NUM,PROPN-PROPN-PROPN,pobj,compound-compound-nsubjpass,CD,NNP-NNP-NNP,2,1
2714,1441.0,25,met,13,11,12,1,10,12,2,-1,Ukraine,Mykola Azarov,,org-org,PROPN,PROPN-PROPN,compound,compound-pobj,NNP,NNP-NNP,1,1
2715,4357.0,25,said,22,4,21,17,3,3,18,-1,Ukraine,Mykola Azarov,org,-,PROPN,PROPN-PROPN,pobj,compound-pobj,NNP,NNP-NNP,4,1
2716,7968.0,73,held,6,42,51,9,41,21,-36,45,Ukraine,Mykola Azarov,,org-org,PROPN,PROPN-PROPN,pobj,compound-compound,NNP,NNP-NNP,8,1
2717,9502.0,18,met,5,1,4,3,0,13,4,-1,Ukraine,Mykola Azarov,per,-,PROPN,PROPN-PROPN,amod,compound-nsubj,NNP,NNP-NNP,2,1
2718,1443.0,13,grew,1,8,12,4,7,0,-7,11,Tufts University,Medford,org-org,,PROPN-PROPN,PROPN,compound-dobj,pobj,NNP-NNP,NNP,3,1
2719,1444.0,22,earned,1,8,12,4,7,9,-7,11,Vytautas Magnus University,Kaunas,per-per-per,,PROPN-PROPN-PROPN,PROPN,compound-compound-pobj,compound,NNP-NNP-NNP,NNP,3,1
2720,1445.0,20,nominate,8,6,18,12,5,1,2,10,Latvia,they,per,,PROPN,PRON,pobj,nsubj,NNP,PRP,6,1
2721,1446.0,27,was,3,1,22,21,0,4,2,19,Judah P. Benjamin,State,--,per,PROPN-PROPN-PROPN,PROPN,compound-compound-nsubj,pobj,NNP-NNP-NNP,NNP,4,1
2722,1447.0,53,focuses,2,40,47,7,39,5,-38,45,Heather O'Rourke,California,org-org,,PROPN-PROPN,PROPN,compound-appos,compound,NNP-NNP,NNP,5,1
2723,1448.0,24,went,1,1,7,6,0,16,0,6,JSS,United Democratic Front,org,--,PROPN,PROPN-PROPN-PROPN,nsubj,compound-compound-dobj,NNP,NNP-NNP-NNP,3,1
2724,1449.0,27,became,5,5,16,11,4,10,0,11,he,Pakistan,,org,PRON,PROPN,nsubj,pobj,PRP,NNP,1,1
2725,6188.0,30,Convicted,0,9,23,14,8,6,-9,23,he,Pakistan,per,,PRON,PROPN,nsubj,pobj,PRP,NNP,4,1
2726,1450.0,14,is,9,1,13,12,0,0,8,4,Amy Van Nostrand,actress,--,per,PROPN-PROPN-PROPN,NOUN,compound-compound-nsubj,attr,NNP-NNP-NNP,NN,3,1
2727,1451.0,18,In,0,5,8,3,4,9,-5,8,Guardian Media Group,The Guardian,--,per-per,PROPN-PROPN-PROPN,DET-PROPN,compound-compound-appos,det-poss,NNP-NNP-NNP,DT-NNP,-1,1
2728,1452.0,47,were,29,19,31,12,18,15,10,2,Australia,Edmund Barton,org,-,PROPN,PROPN-PROPN,pobj,compound-compound,NNP,NNP-NNP,9,1
2729,5539.0,30,was,2,7,13,6,6,16,-5,11,Australia,Edmund Barton,,per-per,PROPN,PROPN-PROPN,poss,compound-pobj,NNP,NNP-NNP,3,1
2730,13774.0,49,clashed,3,38,47,9,37,1,-35,44,Australia,Edmund Barton,org,-,PROPN,PROPN-PROPN,poss,compound-appos,NNP,NNP-NNP,-1,1
2731,1454.0,29,became,4,23,28,5,22,0,-19,24,NXP Semiconductors,2006,-,per,PROPN-PROPN,NUM,compound-pobj,nummod,NNP-NNPS,CD,4,1
2732,1455.0,38,decided,7,11,26,15,10,11,-4,19,The CW Television Network,UPN,per-per-per-per,,DET-PROPN-PROPN-PROPN,PROPN,det-compound-compound-dative,pobj,DT-NNP-NNP-NNP,NNP,8,1
2733,1456.0,36,wrote,4,7,11,4,6,24,-3,7,Disney,Robert Iger,per,-,PROPN,PROPN-PROPN,compound,compound-nsubj,NNP,NNP-NNP,3,1
2734,1458.0,41,designated,27,25,26,1,24,14,2,-1,Michigan,Northern,per,,PROPN,PROPN,compound,pobj,NNP,NNP,8,1
2735,1459.0,32,credited,9,1,12,11,0,19,8,3,Jayne Eastwood,Jane Eastwood,per-per,-,PROPN-PROPN,PROPN-PROPN,compound-nsubj,compound-conj,NNP-NNP,NNP-NNP,3,1
2736,1460.0,28,sworn,4,8,18,10,7,9,-4,14,Houston,United States,org,-,PROPN,PROPN-PROPN,compound,compound-pobj,NNP,NNP-NNP,4,1
2737,6821.0,12,Municipal,6,1,3,2,0,8,5,-3,Houston,United States,org,-,PROPN,PROPN-PROPN,poss,compound-appos,NNP,NNP-NNP,1,1
2738,7584.0,26,is,7,3,10,7,2,15,4,3,Houston,United States,per,-,PROPN,PROPN-PROPN,nsubj,compound-compound,NNP,NNP-NNP,5,1
2739,7916.0,42,is,10,20,40,20,19,1,-10,30,Houston,United States,per,-,PROPN,PROPN-PROPN,nsubj,compound-pobj,NNP,NNP-NNP,8,1
2740,11600.0,37,became,6,4,14,10,3,22,2,8,Houston,United States,,per-per,PROPN,PROPN-PROPN,pobj,compound-pobj,NNP,NNP-NNP,6,1
2741,1461.0,43,gave,6,2,5,3,1,37,4,-1,South Korean,Kim Dae-jung,-,per-per,ADJ-ADJ,PROPN-PROPN,amod-amod,compound-nsubj,JJ-JJ,NNP-NNP,3,1
2742,7305.0,25,paid,9,5,8,3,4,16,4,-1,South Korean,Kim Dae-jung,-,org-org,ADJ-ADJ,PROPN-PROPN,amod-amod,compound-nsubj,JJ-JJ,NNP-NNP,3,1
2743,8779.0,22,says,2,6,9,3,5,12,-4,7,South Korean,Kim Dae-jung,-,org-org,ADJ-ADJ,PROPN-PROPN,amod-amod,compound-nsubjpass,JJ-JJ,NNP-NNP,3,1
2744,1463.0,18,charged,4,6,11,5,5,6,-2,7,Guatemala,Alfonso Portillo,org,-,PROPN,PROPN-PROPN,poss,compound-appos,NNP,NNP-NNP,3,1
2745,1464.0,22,is,1,8,10,2,7,11,-7,9,Greek,Marianta Pieridi,,org-org,ADJ,PROPN-PROPN,amod,compound-pobj,JJ,NNP-NNP,1,1
2746,2434.0,24,is,3,10,12,2,9,11,-7,9,Greek,Marianta Pieridi,,per-per,ADJ,PROPN-PROPN,amod,compound-pobj,JJ,NNP-NNP,1,1
2747,1465.0,19,is,5,2,2,0,1,16,3,-3,Cameroon national cricket team,Cameroon,org-org-org-org,,PROPN-ADJ-NOUN-NOUN,PROPN,nmod-amod-compound-nsubj,pobj,NNP-JJ-NN-NN,NNP,0,1
2748,1466.0,35,said,1,8,18,10,7,16,-7,17,Tri Nations,New Zealand,per-per,-,PROPN-PROPN,PROPN-PROPN,compound-nsubj,compound-compound,NNP-NNP,NNP-NNP,5,1
2749,1467.0,46,said,22,38,45,7,37,0,-16,23,Logo,Viacom,,org,PROPN,PROPN,conj,pobj,NNP,NNP,5,1
2750,1468.0,38,Network,5,3,3,0,2,34,2,-2,Public Health Laboratory Network,Public Health Agency of Canada,per-per-per-per,----,PROPN-PROPN-PROPN-PROPN,PROPN-PROPN-PROPN-ADP-PROPN,compound-compound-compound-ROOT,compound-compound-pobj-prep-pobj,NNP-NNP-NNP-NNP,NNP-NNP-NNP-IN-NNP,0,1
2751,1469.0,31,was,1,9,14,5,8,16,-8,13,College,University College London,per,--,PROPN,PROPN-PROPN-PROPN,nsubj,compound-compound-pobj,NNP,NNP-NNP-NNP,4,1
2752,1470.0,17,is,2,4,15,11,3,1,-2,13,Unsane,Relapse Records,,per-per,PROPN,PROPN-PROPN,poss,compound-pobj,NNP,NNP-NNPS,5,1
2753,11392.0,15,is,2,4,13,9,3,1,-2,11,Unsane,Relapse Records,,org-org,PROPN,PROPN-PROPN,poss,compound-pobj,NNP,NNP-NNPS,5,1
2754,1471.0,70,educated,2,5,26,21,4,43,-3,24,Bedales School,England,-,per,PROPN-PROPN,PROPN,compound-pobj,pobj,NNP-NNP,NNP,4,1
2755,1832.0,34,Badley,2,17,31,14,16,2,-15,29,Bedales School,England,org-org,,PROPN-PROPN,PROPN,compound-pobj,pobj,NNP-NNP,NNP,6,1
2756,8198.0,11,educated,3,6,10,4,5,0,-3,7,Bedales School,England,per-per,,PROPN-PROPN,PROPN,compound-pobj,pobj,NNP-NNP,NNP,3,1
2757,1472.0,17,reversed,1,11,15,4,10,1,-10,14,Ohio,Sherrod Brown,,per-per,PROPN,PROPN-PROPN,poss,compound-appos,NNP,NNP-NNP,3,1
2758,5456.0,17,elected,4,8,15,7,7,1,-4,11,Ohio,Sherrod Brown,org,-,PROPN,PROPN-PROPN,nmod,compound-dobj,NNP,NNP-NNP,2,1
2759,7439.0,27,supports,5,1,4,3,0,22,4,-1,Ohio,Sherrod Brown,,org-org,PROPN,PROPN-PROPN,compound,compound-nsubj,NNP,NNP-NNP,2,1
2760,7755.0,20,was,3,12,18,6,11,1,-9,15,Ohio,Sherrod Brown,,per-per,PROPN,PROPN-PROPN,compound,compound-pobj,NNP,NNP-NNP,7,1
2761,9030.0,47,led,2,14,35,21,13,11,-12,33,Ohio,Sherrod Brown,,org-org,PROPN,PROPN-PROPN,compound,compound-nsubj,NNP,NNP-NNP,7,1
2762,11472.0,45,were,5,18,39,21,17,5,-13,34,Ohio,Sherrod Brown,,per-per,PROPN,PROPN-PROPN,pobj,compound-ROOT,NNP,NNP-NNP,-1,1
2763,14124.0,40,said,9,4,8,4,3,31,5,-1,Ohio,Sherrod Brown,per,-,PROPN,PROPN-PROPN,nsubj,compound-appos,NNP,NNP-NNP,1,1
2764,1473.0,55,was,11,5,13,8,4,41,6,2,American,Chuck Hagel,,per-per,PROPN,PROPN-PROPN,compound,compound-attr,NNP,NNP-NNP,5,1
2765,1474.0,37,Hayat,1,17,32,15,16,4,-16,31,nt of the,ty leader Benaz,org-org-org,--,ADV-ADP-DET,NOUN-NOUN-PROPN,advmod-prep-det,prep-compound-pobj,RB-IN-DT,NN-NN-NNP,9,1
2766,1476.0,17,is,1,6,12,6,5,4,-5,11,Kennesaw State Owls,Division I,--,org-org,PROPN-PROPN-PROPN,PROPN-PROPN,compound-compound-pobj,pobj-nmod,NNP-NNP-NNP,NNP-NNP,5,1
2767,1477.0,10,presses,3,1,8,7,0,1,2,5,Israel,Rabin,,org,PROPN,PROPN,nsubj,compound,NNP,NNP,6,1
2768,10286.0,18,marked,2,1,8,7,0,9,1,6,Israel,Rabin,org,,PROPN,PROPN,nsubj,poss,NNP,NNP,6,1
2769,1479.0,40,said,24,35,36,1,34,3,-11,12,Denver,Sturm College of Law,per,---,PROPN,PROPN-PROPN-ADP-PROPN,pobj,compound-ROOT-prep-pobj,NNP,NNP-NNP-IN-NNP,1,1
2770,1480.0,32,Founded,0,7,18,11,6,13,-7,18,Frances Mary Buss,Camden School for Girls,org-org-org,---,PROPN-PROPN-PROPN,PROPN-PROPN-ADP-PROPN,compound-compound-pobj,compound-appos-prep-pobj,NNPS-NNP-NNP,NNP-NNP-IN-NNP,4,1
2771,1482.0,14,served,1,1,7,6,0,6,0,6,He,New Hampshire,,per-per,PRON,PROPN-PROPN,nsubj,compound-compound,PRP,NNP-NNP,5,1
2772,1483.0,34,swears,25,18,19,1,17,14,7,-6,director,Terry Gilliam,,per-per,NOUN,PROPN-PROPN,compound,compound-conj,NN,NNP-NNP,1,1
2773,1484.0,19,played,2,5,5,0,4,13,-3,3,Bangladesh,Bangladesh Cricket Board,per,--,PROPN,PROPN-PROPN-PROPN,compound,compound-compound-compound,NNP,NNP-NNP-NNP,0,1
2774,1485.0,20,gave,7,5,19,14,4,0,2,12,Petrelis,Greece,,org,PROPN,PROPN,poss,pobj,NNP,NNP,4,1
2775,1486.0,30,is,9,1,19,18,0,10,8,10,Ivor Sigmund Tiefenbrun,Glasgow,--,per,PROPN-PROPN-PROPN,PROPN,compound-compound-compound,pobj,NNP-NNP-NNP,NNP,8,1
2776,1487.0,21,founded,2,7,9,2,6,11,-5,7,Getronics,CompuCom Systems,per,-,NOUN,PROPN-PROPN,compound,compound-compound,NNS,NNP-NNPS,4,1
2777,1488.0,22,debuted,4,3,16,13,2,5,1,12,Terror Squad,Fat Joe,-,org-org,PROPN-PROPN,PROPN-PROPN,compound-nsubj,compound-poss,NNP-NNP,NNP-NNP,7,1
2778,1489.0,18,School,4,14,17,3,13,0,-10,13,University of Wollongong,Australia,--,org,PROPN-ADP-PROPN,PROPN,conj-prep-compound,pobj,NNP-IN-NNP,NNP,3,1
2779,1490.0,29,resigned,3,17,22,5,16,6,-14,19,23rd Ohio Infantry,Union,--,per,NOUN-PROPN-PROPN,PROPN,compound-compound-pobj,compound,NN-NNP-NNP,NNP,3,1
2780,1491.0,12,is,1,1,3,2,0,8,0,2,Fox8,Foxtel,per,,PROPN,PROPN,nsubj,poss,NNP,NNP,3,1
2781,2039.0,42,held,3,23,26,3,22,15,-20,23,Fox8,Foxtel,per,,PROPN,PROPN,conj,compound,NNP,NNP,3,1
2782,1493.0,36,thumb,0,3,19,16,2,16,-3,19,FDR,Warm Springs,,org-org,PROPN,PROPN-PROPN,nsubj,compound-compound,NNP,NNP-NNP,-1,1
2783,1494.0,15,exonerated,9,5,7,2,4,7,4,-2,Interior,Harold L. Ickes,per,--,PROPN,PROPN-PROPN-PROPN,compound,compound-compound-nsubj,NNP,NNP-NNP-NNP,3,1
2784,7386.0,12,repealed,8,4,6,2,3,5,4,-2,Interior,Harold L. Ickes,,org-org-org,PROPN,PROPN-PROPN-PROPN,compound,compound-compound-nsubj,NNP,NNP-NNP-NNP,2,1
2785,7841.0,20,left,3,15,17,2,14,2,-12,14,Interior,Harold L. Ickes,,per-per-per,PROPN,PROPN-PROPN-PROPN,pobj,compound-compound-pobj,NNP,NNP-NNP-NNP,2,1
2786,10801.0,43,proposed,12,8,10,2,7,32,4,-2,Interior,Harold L. Ickes,per,--,PROPN,PROPN-PROPN-PROPN,compound,compound-compound-pobj,NNP,NNP-NNP-NNP,2,1
2787,14018.0,39,erupted,5,20,21,1,19,17,-15,16,Interior,Harold L. Ickes,,org-org-org,PROPN,PROPN-PROPN-PROPN,pobj,compound-compound-pobj,NNP,NNP-NNP-NNP,5,1
2788,1495.0,30,peaked,2,17,29,12,16,0,-15,27,Cher,US,per,,PROPN,PROPN,poss,pobj,NNP,NNP,5,1
2789,5796.0,59,Reiner,12,9,31,22,8,27,3,19,Cher,US,,org,PROPN,PROPN,compound,compound,NNP,NNP,7,1
2790,7624.0,43,is,1,1,9,8,0,33,0,8,Cher,US,org,,PROPN,PROPN,nsubj,dobj,NNP,NNP,5,1
2791,8690.0,42,was,3,1,11,10,0,30,2,8,Cher,US,,per,PROPN,PROPN,poss,pobj,NNP,NNP,5,1
2792,1496.0,50,Jiabao,6,11,32,21,10,17,-5,26,Zeng Qinghong,Communist Party of China,org-org,---,PROPN-PROPN,PROPN-PROPN-ADP-PROPN,compound-compound,compound-pobj-prep-pobj,NNP-NNP,NNP-NNP-IN-NNP,11,1
2793,1497.0,11,was,1,1,8,7,0,2,0,7,Manson,Goodbye Mr. Mackenzie,,per-per-per,PROPN,PROPN-PROPN-PROPN,nsubj,compound-compound-pobj,NNP,NNP-NNP-NNP,4,1
2794,1498.0,40,encouraged,3,8,9,1,7,30,-5,6,Lithuania,Valdas Adamkus,org,-,PROPN,PROPN-PROPN,compound,compound-compound,NNP,NNP-NNP,1,1
2795,2658.0,27,signed,9,5,8,3,4,18,4,-1,Lithuania,Valdas Adamkus,,per-per,PROPN,PROPN-PROPN,poss,compound-appos,NNP,NNP-NNP,3,1
2796,3526.0,19,met,8,5,7,2,4,11,3,-1,Lithuania,Valdas Adamkus,org,-,PROPN,PROPN-PROPN,poss,compound-conj,NNP,NNP-NNP,2,1
2797,5814.0,29,said,27,1,4,3,0,24,26,-23,Lithuania,Valdas Adamkus,org,-,PROPN,PROPN-PROPN,poss,compound-nsubjpass,NNP,NNP-NNP,3,1
2798,5898.0,39,decided,12,21,23,2,20,15,-9,11,Lithuania,Valdas Adamkus,,per-per,PROPN,PROPN-PROPN,poss,compound-nsubj,NNP,NNP-NNP,2,1
2799,9354.0,32,condemned,7,1,4,3,0,27,6,-3,Lithuania,Valdas Adamkus,,org-org,PROPN,PROPN-PROPN,poss,compound-nsubj,NNP,NNP-NNP,3,1
2800,9907.0,22,signed,10,8,9,1,7,12,2,-1,Lithuania,Valdas Adamkus,per,-,PROPN,PROPN-PROPN,compound,compound-pobj,NNP,NNP-NNP,1,1
2801,1499.0,6,Brooklyn,3,1,4,3,0,1,2,1,MC Lyte,Brooklyn,-,org,PROPN-PROPN,PROPN,compound-compound,ROOT,NNP-NNP,NNP,2,1
2802,1500.0,40,renamed,23,6,12,6,5,27,17,-11,Chen Shui-bian,Taipei,org-org,,PROPN-NOUN,PROPN,compound-nsubj,compound,NNP-NN,NNP,4,1
2803,6368.0,18,serving,6,3,13,10,2,4,3,7,Chen Shui-bian,Taipei,-,org,PROPN-PROPN,PROPN,compound-nsubj,compound,NNP-NNP,NNP,3,1
2804,1501.0,31,Ickes,4,3,16,13,2,14,1,12,Harold L. Ickes,Interior,per-per-per,,PROPN-PROPN-PROPN,PROPN,compound-compound-ROOT,pobj,NNP-NNP-NNP,NNP,7,1
2805,1502.0,32,is,14,1,28,27,0,3,13,14,New Balance,United States of America,per-per,---,PROPN-PROPN,PROPN-PROPN-ADP-PROPN,compound-compound,compound-pobj-prep-pobj,NNP-NNP,NNP-NNP-IN-NNP,10,1
2806,1503.0,25,was,1,7,19,12,6,5,-6,18,Rhode Island,Samuel G. Arnold,-,per-per-per,PROPN-PROPN,PROPN-PROPN-PROPN,compound-poss,compound-compound-conj,NNP-NNP,NNP-NNP-NNP,6,1
2807,1504.0,20,was,11,5,9,4,4,10,6,-2,William Tubman,True Whig,per-per,-,PROPN-PROPN,PROPN-PROPN,compound-nsubj,compound-compound,NNP-NNP,NNP-NNP,3,1
2808,1505.0,23,had,5,7,9,2,6,13,-2,4,California,Clair Engle,per,-,PROPN,PROPN-PROPN,compound,compound-dobj,NNP,NNP-NNP,1,1
2809,1507.0,13,named,1,1,8,7,0,4,0,7,Sharif,Pakistan,,per,PROPN,PROPN,nsubj,compound,NNP,NNP,5,1
2810,5228.0,52,started,22,3,16,13,2,35,19,-6,Sharif,Pakistan,,per,PROPN,PROPN,poss,compound,NNP,NNP,6,1
2811,10720.0,36,marked,7,2,16,14,1,19,5,9,Sharif,Pakistan,,per,PROPN,PROPN,nsubj,pobj,NNP,NNP,4,1
2812,10865.0,33,boycotting,2,6,27,21,5,5,-4,25,Sharif,Pakistan,,per,PROPN,PROPN,nsubj,compound,NNP,NNP,8,1
2813,1508.0,24,is,7,11,18,7,10,5,-4,11,Washington,Calvin Johnson,org,-,PROPN,PROPN-PROPN,attr,compound-pobj,NNP,NNP-NNP,3,1
2814,1509.0,28,became,4,3,3,0,2,24,1,-1,BC Electric,BC Hydro,per-per,-,PROPN-PROPN,PROPN-PROPN,compound-nsubj,compound-pobj,NNP-NNP,NNP-NNP,0,1
2815,1510.0,37,consists,6,2,2,0,1,34,4,-4,Temple City Unified School District,Temple City High School,per-per-per-per-per,---,PROPN-PROPN-PROPN-PROPN-PROPN,PROPN-PROPN-PROPN-PROPN,compound-compound-compound-compound-nsubj,compound-compound-compound-conj,NNP-NNP-NNP-NNP-NNP,NNP-NNP-NNP-NNP,0,1
2816,1512.0,63,offers,21,1,9,8,0,53,20,-12,UMK,Kelantan,,per,PROPN,PROPN,nsubj,pobj,NNP,NNP,2,1
2817,1513.0,27,sent,4,7,17,10,6,9,-3,13,Ethiopia,Ethiopian Air Force,per,--,PROPN,PROPN-PROPN-PROPN,pobj,compound-compound-pobj,NNP,NNP-NNP-NNP,6,1
2818,1514.0,40,exists,2,1,1,0,0,38,1,-1,Kmart,Kmart Australia,,per-per,PROPN,PROPN-PROPN,nsubj,compound-dobj,NNP,NNP-NNP,0,1
2819,1516.0,17,re-elected,5,4,7,3,3,9,1,2,Mathieu,President,per,,PROPN,PROPN,pobj,oprd,NNP,NNP,2,1
2820,1517.0,56,holds,1,44,50,6,43,5,-43,49,e European University Institut,n Florenc,---,per-per,PUNCT-PROPN-PROPN-PROPN,CCONJ-PROPN,compound-compound-appos-compound,punct-compound,LS-NNP-NNP-NNP,CC-NNP,7,1
2821,1518.0,13,hosted,4,1,11,10,0,1,3,7,Lyndon B. Johnson,Texas,--,org,PROPN-PROPN-PROPN,PROPN,compound-compound-nsubj,compound,NNP-NNP-NNP,NNP,4,1
2822,10581.0,34,carried,16,20,24,4,19,9,-4,8,Lyndon B. Johnson,Texas,org-org-org,,PROPN-PROPN-PROPN,PROPN,compound-compound-poss,dobj,NNP-NNP-NNP,NNP,4,1
2823,1519.0,18,was,7,1,3,2,0,14,6,-4,Alexander Ramsey,Minnesota,org-org,,PROPN-PROPN,PROPN,compound-compound,poss,NNP-NNP,NNP,2,1
2824,1520.0,21,married,4,1,3,2,0,17,3,-1,Catherine,Henry,,per,PROPN,PROPN,nsubj,conj,NNP,NNP,3,1
2825,1521.0,59,July,0,5,12,7,4,46,-5,12,1st Cavalry Division,Texas,org-org-org,,PROPN-PROPN-PROPN,PROPN,compound-compound-compound,ROOT,NNP-NNP-NNP,NNP,5,1
2826,1522.0,61,funded,11,1,11,10,0,49,10,0,Thomas Wolsey,England,-,org,PROPN-PROPN,PROPN,compound-compound,pobj,NNP-NNP,NNP,2,1
2827,7159.0,13,appoints,5,7,12,5,6,0,-2,7,Thomas Wolsey,England,org-org,,PROPN-PROPN,PROPN,compound-dobj,pobj,NNP-NNP,NNP,2,1
2828,10215.0,29,b,4,2,14,12,1,14,2,10,Thomas Wolsey,England,org-org,,PROPN-PROPN,PROPN,compound-compound,compound,NNP-NNP,NNP,3,1
2829,1523.0,22,is,11,1,18,17,0,3,10,7,Skerik,Seattle,org,,PROPN,PROPN,poss,compound,NNP,NNP,7,1
2830,1524.0,13,was,2,1,11,10,0,1,1,9,Acadian Lines,New Brunswick,-,per-per,PROPN-PROPN,PROPN-PROPN,compound-nsubj,compound-pobj,NNP-NNP,NNP-NNP,5,1
2831,1525.0,15,were,7,1,13,12,0,1,6,6,M. G. Ramachandran,Tamil Nadu,per-per-per,-,PROPN-PROPN-PROPN,PROPN-PROPN,compound-compound-conj,compound-pobj,NNP-NNP-NNP,NNP-NNP,5,1
2832,1526.0,45,went,6,6,8,2,5,36,0,2,France,Sarkozy,org,,PROPN,PROPN,pobj,poss,NNP,NNP,3,1
2833,1527.0,26,was,10,17,25,8,16,0,-7,15,Eighth Air Force,Louisiana,per-per-per,,PROPN-PROPN-PROPN,PROPN,compound-compound-pobj,pobj,NNP-NNP-NNP,NNP,3,1
2834,1528.0,32,announced,8,7,17,10,6,14,1,9,Oasis,Gem Archer,per,-,PROPN,PROPN-PROPN,compound,compound-compound,NNP,NNP-NNP,5,1
2835,1529.0,21,is,8,1,15,14,0,5,7,7,Patricio Manns,novelist,per-per,,PROPN-PROPN,NOUN,compound-nsubj,amod,NNP-NNP,NN,3,1
2836,1530.0,56,With,0,10,13,3,9,42,-10,13,England,Ambrose,org,,PROPN,PROPN,pobj,nsubj,NNP,NNP,5,1
2837,1531.0,32,was,1,14,24,10,13,7,-13,23,Rufino Tamayo,Mexico,per-per,,PROPN-PROPN,PROPN,compound-pobj,pobj,NNP-NNP,NNP,9,1
2838,1532.0,25,consisted,1,7,9,2,6,15,-6,8,Club Deportivo Guadalajara,Guadalajara,per-per-per,,PROPN-PROPN-PROPN,PROPN,compound-compound-compound,compound,NNP-NNPS-NNP,NNP,3,1
2839,1533.0,13,was,1,1,5,4,0,7,0,4,Hahn,Los Angeles,org,-,PROPN,PROPN-PROPN,nsubj,compound-compound,NNP,NNP-NNP,3,1
2840,4882.0,19,unseated,1,1,11,10,0,7,0,10,Hahn,Los Angeles,org,-,PROPN,PROPN-PROPN,nsubj,compound-compound,NNP,NNP-NNP,5,1
2841,1534.0,66,elected,3,17,20,3,16,45,-14,17,European Parliament,Simone Veil,per-per,-,PROPN-PROPN,PROPN-PROPN,compound-pobj,compound-conj,NNP-NNP,NNP-NNP,6,1
2842,1535.0,67,is,2,15,24,9,14,42,-13,22,RTV Pink,Serbia,-,per,PROPN-PROPN,PROPN,compound-conj,pobj,NNP-NNP,NNP,5,1
2843,1536.0,26,announced,4,3,9,6,2,16,1,5,Hosni Mubarak,Egypt,org-org,,PROPN-PROPN,PROPN,compound-nsubj,nsubj,NNP-NNP,NNP,3,1
2844,5914.0,36,said,32,2,12,10,1,23,30,-20,Hosni Mubarak,Egypt,per-per,,PROPN-PROPN,PROPN,compound-nsubj,pobj,NNP-NNP,NNP,5,1
2845,1538.0,32,co-founded,6,9,3,-6,8,28,-3,-3,Alicia Alonso,Cuba,per-per,,PROPN-PROPN,PROPN,compound-appos,attr,NNP-NNP,NNP,4,1
2846,1540.0,63,was,20,31,44,13,30,18,-11,24,Miguel de Legazpi,Spain,per-per-per,,PROPN-PROPN-PROPN,PROPN,nmod-compound-pobj,pobj,NNP-NNP-NNP,NNP,11,1
2847,11221.0,44,arrived,3,1,16,15,0,27,2,13,Miguel de Legazpi,Spain,per-per-per,,PROPN-PROPN-PROPN,PROPN,compound-compound-nsubj,pobj,NNP-NNP-NNP,NNP,4,1
2848,1541.0,14,became,1,7,11,4,6,2,-6,10,Chicago,Benjamin Wright Raymond,,org-org-org,PROPN,PROPN-PROPN-PROPN,pobj,compound-compound-dobj,NNP,NNP-NNP-NNP,4,1
2849,1542.0,19,is,12,2,2,0,1,16,10,-10,TAM Airlines,TAM,per-per,,PROPN-PROPN,PROPN,compound-compound,appos,NNP-NNPS,NNP,0,1
2850,1543.0,30,honor,3,5,10,5,4,19,-2,7,John Adams,Abigail Smith Adams,-,per-per-per,PROPN-PROPN,PROPN-PROPN-PROPN,compound-dobj,compound-compound-appos,NNP-NNP,NNP-NNP-NNP,4,1
2851,1544.0,31,were,3,1,27,26,0,3,2,24,Taylor,Liberia,org,,PROPN,PROPN,nsubj,pobj,NNP,NNP,9,1
2852,2991.0,23,From,0,5,13,8,4,9,-5,13,Taylor,Liberia,,per,PROPN,PROPN,nsubj,pobj,NNP,NNP,4,1
2853,9635.0,37,were,2,10,16,6,9,20,-8,14,Taylor,Liberia,,per,PROPN,PROPN,poss,pobj,NNP,NNP,6,1
2854,1545.0,34,launched,5,8,20,12,7,13,-3,15,G-Unit,Lloyd Banks,per,-,PROPN,PROPN-PROPN,nmod,compound-pobj,NNP,NNP-NNPS,7,1
2855,9339.0,19,started,3,8,17,9,7,1,-5,14,G-Unit,Lloyd Banks,org,-,PROPN,PROPN-PROPN,punct,compound-conj,NNP,NNP-NNPS,5,1
2856,9505.0,25,features,9,15,20,5,14,4,-6,11,G-Unit,Lloyd Banks,per,-,PROPN,PROPN-PROPN,punct,compound-pobj,NNP,NNP-NNPS,5,1
2857,14152.0,28,features,1,7,11,4,6,16,-6,10,G-Unit,Lloyd Banks,per,-,PROPN,PROPN-PROPN,punct,compound-compound,NNP,NNP-NNP,9,1
2858,1546.0,25,opposed,2,5,6,1,4,18,-3,4,Democrat,Jeff Merkley,,per-per,PROPN,PROPN-PROPN,compound,compound-pobj,NNP,NNP-NNP,1,1
2859,1548.0,35,was,1,8,15,7,7,19,-7,14,Houston Police Department,Charles R. McClelland,per-per-per,--,PROPN-PROPN-PROPN,PROPN-PROPN-PROPN,compound-compound-compound,compound-compound-appos,NNP-NNP-NNP,NNP-NNP-NNP,4,1
2860,1549.0,41,Leekpai,1,1,22,21,0,18,0,21,Chuan Leekpai,Thailand,per-per,,PROPN-PROPN,PROPN,compound-ROOT,pobj,NNP-NNP,NNP,2,1
2861,4382.0,16,included,8,10,15,5,9,0,-2,7,Chuan Leekpai,Thailand,-,per,PROPN-PROPN,PROPN,nmod-nmod,pobj,NNP-NNP,NNP,2,1
2862,8034.0,28,became,20,8,17,9,7,10,12,-3,Chuan Leekpai,Thailand,per-per,,PROPN-PROPN,PROPN,compound-pobj,pobj,NNP-NNP,NNP,7,1
2863,1550.0,46,bought,1,1,32,31,0,13,0,31,Kroenke,Colorado Rapids,,per-per,PROPN,PROPN-PROPN,nsubj,compound-conj,NNP,NNP-NNPS,7,1
2864,3567.0,44,become,25,6,13,7,5,30,19,-12,Kroenke,Colorado Rapids,per,-,PROPN,PROPN-PROPN,dobj,compound-compound,NNP,NNP-NNP,5,1
2865,10012.0,24,controls,6,2,14,12,1,9,4,8,Kroenke,Colorado Rapids,,per-per,PROPN,PROPN-PROPN,nsubj,compound-conj,NNP,NNP-NNPS,7,1
2866,10860.0,14,owns,2,1,5,4,0,8,1,3,Kroenke,Colorado Rapids,per,-,PROPN,PROPN-PROPN,nsubj,nmod-nmod,NNP,NNP-NNPS,2,1
2867,1551.0,20,is,4,2,15,13,1,4,2,11,Plaxton,1907,org,,PROPN,NUM,nsubj,pobj,NNP,CD,7,1
2868,1552.0,17,has,1,13,15,2,12,1,-12,14,Daimler,Stuttgart,per,,PROPN,PROPN,poss,compound,NNP,NNP,3,1
2869,1553.0,17,attending,3,9,12,3,8,4,-6,9,Japan,Crystal Kay,per,-,PROPN,PROPN-PROPN,pobj,compound-pobj,NNP,NNP-NNP,2,1
2870,1554.0,23,was,3,3,11,8,2,11,0,8,Howard,Atlantic,org,,PROPN,PROPN,nsubj,pobj,NNP,NNP,2,1
2871,1555.0,30,identified,9,5,24,19,4,5,4,15,Ministry of Defense,4th Division,--,per-per,PROPN-ADP-PROPN,ADJ-PROPN,nmod-prep-pobj,amod-pobj,NNP-IN-NNP,JJ-NNP,4,1
2872,1556.0,5,Romania,2,1,3,2,0,1,1,1,Roxana Luca,Romania,-,per,PROPN-PROPN,PROPN,compound-compound,ROOT,NNP-NNP,NNP,2,1
2873,1557.0,35,has,17,14,32,18,13,2,3,15,Jehovah,Charles Taze Russell,org,--,PROPN,PROPN-PROPN-PROPN,poss,compound-compound-appos,NNP,NNP-NNP-NNP,12,1
2874,1558.0,20,says,8,1,3,2,0,16,7,-5,Joshua Greene,Wine Spirits,per-per,-,PROPN-PROPN,PROPN-PROPN,compound-compound,compound-compound,NNP-NNP,NNP-NNPS,2,1
2875,14246.0,31,received,4,15,13,-2,14,17,-11,9,Joshua Greene,Wine Spirits,per-per,-,PROPN-PROPN,PROPN-PROPN,compound-pobj,compound-pobj,NNP-NNP,NNP-NNPS,1,1
2876,1559.0,29,was,1,12,27,15,11,1,-11,26,Ontario,Frank Miller,,org-org,PROPN,PROPN-PROPN,pobj,compound-pobj,NNP,NNP-NNP,8,1
2877,3931.0,25,served,1,8,23,15,7,1,-7,22,Ontario,Frank Miller,,per-per,PROPN,PROPN-PROPN,pobj,compound-pobj,NNP,NNP-NNP,7,1
2878,5663.0,27,served,1,8,25,17,7,1,-7,24,Ontario,Frank Miller,,org-org,PROPN,PROPN-PROPN,pobj,compound-conj,NNP,NNP-NNP,8,1
2879,12954.0,31,served,1,8,29,21,7,1,-7,28,Ontario,Frank Miller,,org-org,PROPN,PROPN-PROPN,pobj,compound-conj,NNP,NNP-NNP,8,1
2880,1560.0,21,chosen,8,1,16,15,0,4,7,8,Zhai,Chinese,org,,PROPN,ADJ,nsubjpass,amod,NNP,JJ,6,1
2881,1561.0,22,has,4,1,16,15,0,5,3,12,Canadian Junior Football League,Saskatoon Hilltops,org-org-org-org,-,PROPN-PROPN-PROPN-PROPN,PROPN-PROPN,compound-compound-compound-nsubj,compound-appos,NNP-NNP-NNP-NNP,NNP-NNP,4,1
2882,1563.0,32,built,12,6,20,14,5,11,6,8,Jin,novelist,per,,PROPN,NOUN,nsubj,pobj,NNP,NN,9,1
2883,1564.0,42,used,22,5,19,14,4,22,17,-3,Santiago,Venezuela,org,,PROPN,PROPN,nsubj,pobj,NNP,NNP,6,1
2884,1565.0,57,is,5,4,26,22,3,30,1,21,Shankar,ha ) -,per,--,PROPN,PROPN-PUNCT-PUNCT,compound,intj-punct-punct,NNP,NNP--RRB--:,3,1
2885,1566.0,25,is,9,14,20,6,13,4,-5,11,Sani Abacha,Nigeria,org-org,,PROPN-PROPN,PROPN,compound-nmod,pobj,NNP-NNP,NNP,4,1
2886,13356.0,28,found,5,10,13,3,9,14,-5,8,Sani Abacha,Nigeria,per-per,,PROPN-PROPN,PROPN,compound-dobj,poss,NNP-NNP,NNP,4,1
2887,1567.0,25,became,1,11,17,6,10,7,-10,16,1088,University of Bologna,,org-org-org,NUM,PROPN-ADP-PROPN,pobj,pobj-prep-pobj,CD,NNP-IN-NNP,4,1
2888,1568.0,22,held,3,7,20,13,6,1,-4,17,United Kingdom,Harold Wilson,-,per-per,PROPN-PROPN,PROPN-PROPN,compound-pobj,compound-pobj,NNP-NNP,NNP-NNP,9,1
2889,5333.0,52,was,27,14,37,23,13,14,13,10,United Kingdom,Harold Wilson,per-per,-,PROPN-PROPN,PROPN-PROPN,compound-pobj,compound-pobj,NNP-NNP,NNP-NNP,10,1
2890,1569.0,14,married,2,4,6,2,3,7,-2,4,Olive Palmer,his,per-per,,PROPN-PROPN,DET,compound-dobj,poss,NNP-NNP,PRP$,1,1
2891,1570.0,30,indicated,10,1,7,6,0,22,9,-3,Reserve Bank of New Zealand,Alan Bollard,org-org-org-org-org,-,PROPN-PROPN-ADP-PROPN-PROPN,PROPN-PROPN,compound-nsubj-prep-compound-compound,compound-pobj,NNP-NNP-IN-NNP-NNP,NNP-NNP,1,1
2892,1571.0,23,',0,8,11,3,7,11,-8,11,England,Nigel Lythgoe,per,-,PROPN,PROPN-PROPN,pobj,compound-dobj,NNP,NNP-NNP,1,1
2893,1572.0,21,returns,15,12,10,-2,11,10,3,-5,Mikhail Gorbachev,Soviet Union,per-per,-,PROPN-PROPN,PROPN-PROPN,compound-pobj,compound-pobj,NNP-NNP,NNP-NNP,1,1
2894,2036.0,42,ignored,1,9,7,-2,8,34,-8,6,Mikhail Gorbachev,Soviet Union,per-per,-,PROPN-PROPN,PROPN-PROPN,compound-pobj,compound-poss,NNP-NNP,NNP-NNP,1,1
2895,1574.0,91,argues,4,24,52,28,23,38,-20,48,r Gheorghe Gheorghiu-De,in Roman,per-per-per,-,NOUN-PROPN-NOUN,ADP-PROPN,pobj-compound-ROOT,prep-pobj,NN-NNP-NN,IN-NNP,16,1
2896,1575.0,30,was,0,24,28,4,23,1,-24,28,All Nippon Airways,ANA,per-per-per,,DET-PROPN-PROPN,PROPN,det-compound-pobj,appos,DT-NNP-NNPS,NNP,4,1
2897,2148.0,31,code-shared,17,14,29,15,13,1,3,12,All Nippon Airways,ANA,per-per-per,,DET-PROPN-PROPN,PROPN,det-compound-pobj,compound,DT-NNP-NNPS,NNP,6,1
2898,1576.0,17,is,1,1,15,14,0,1,0,14,SpeakerCraft,Riverside,,org,PROPN,PROPN,nsubj,compound,NNP,NNP,3,1
2899,1577.0,43,said,35,23,34,11,22,8,12,-1,China Airlines,Mandarin Airlines,-,per-per,PROPN-PROPN,PROPN-PROPN,compound-compound,compound-pobj,NNP-NNPS,NNP-NNP,7,1
2900,1578.0,34,produced,5,9,22,13,8,11,-4,17,UCSF,University of California,,per-per-per,PROPN,PROPN-ADP-PROPN,compound,pobj-prep-pobj,NNP,NNP-IN-NNP,5,1
2901,8277.0,17,is,7,2,12,10,1,4,5,5,UCSF,University of California,per,--,PROPN,PROPN-ADP-PROPN,compound,pobj-prep-pobj,NNP,NNP-IN-NNP,7,1
2902,1579.0,17,was,1,7,12,5,6,4,-6,11,Forbes Burnham,Guyana,org-org,,PROPN-PROPN,PROPN,compound-pobj,pobj,NNP-NNP,NNP,3,1
2903,1580.0,27,re-elected,6,2,3,1,1,23,4,-3,President,Hifikepunye Pohamba,,per-per,PROPN,PROPN-PROPN,compound,compound-nsubjpass,NNP,NNP-NNP,1,1
2904,3671.0,22,appointed,2,12,13,1,11,8,-10,11,President,Hifikepunye Pohamba,org,-,PROPN,PROPN-PROPN,compound,compound-poss,NNP,NNP-NNP,1,1
2905,3791.0,45,visited,10,37,43,6,36,1,-27,33,President,Hifikepunye Pohamba,per,-,PROPN,PROPN-PROPN,compound,compound-conj,NNP,NNP-NNP,2,1
2906,10965.0,32,re-elected,6,2,3,1,1,28,4,-3,President,Hifikepunye Pohamba,,per-per,PROPN,PROPN-PROPN,compound,compound-nsubjpass,NNP,NNP-NNP,1,1
2907,1581.0,59,got,8,18,24,6,17,34,-10,16,Seattle,University of Washington,per,--,PROPN,PROPN-ADP-PROPN,compound,pobj-prep-pobj,NNP,NNP-IN-NNP,5,1
2908,1582.0,42,served,7,15,19,4,14,22,-8,12,Kitchener Spirit,Canadian Soccer League,per-per,--,PROPN-PROPN,PROPN-PROPN-PROPN,compound-pobj,compound-compound-pobj,NNP-NNP,NNP-NNP-NNP,3,1
2909,1583.0,51,founded,2,12,21,9,11,29,-10,19,Stephen A. Schwarzman,Blackstone Group,per-per-per,-,PROPN-PROPN-PROPN,PROPN-PROPN,compound-compound-conj,compound-dobj,NNP-NNP-NNP,NNP-NNP,6,1
2910,11778.0,37,donated,13,7,12,5,6,24,6,-1,Stephen A. Schwarzman,Blackstone Group,--,org-org,PROPN-PROPN-PROPN,PROPN-PROPN,compound-compound-appos,compound-pobj,NNP-NNP-NNP,NNP-NNP,3,1
2911,1585.0,32,said,28,23,25,2,22,6,5,-3,Carl Linnaeus,Sweden,org-org,,PROPN-PROPN,PROPN,compound-compound,poss,NNP-NNP,NNP,2,1
2912,1586.0,28,continued,7,10,19,9,9,8,-3,12,Bolivia,Luis Adolfo Siles Salinas,org,---,PROPN,PROPN-PROPN-PROPN-PROPN,poss,compound-compound-compound-pobj,NNP,NNP-NNP-NNP-NNP,7,1
2913,1587.0,52,In,0,31,35,4,30,16,-31,35,Rick Moranis,Canadian,org-org,,PROPN-PROPN,PROPN,compound-conj,compound,NNP-NNP,NNP,5,1
2914,1588.0,32,is,11,6,28,22,5,3,5,17,Lebanon,Sporting Al Riyadi Beirut,per,---,PROPN,VERB-PROPN-PROPN-PROPN,pobj,compound-compound-compound-appos,NNP,VBG-NNP-NNP-NNP,9,1
2915,1589.0,54,adopted,6,21,21,0,20,32,-15,15,Iran,Iran Air,,per-per,PROPN,PROPN-PROPN,pobj,compound-compound,NNP,NNP-NNP,0,1
2916,6720.0,35,operated,16,29,29,0,28,5,-13,13,Iran,Iran Air,org,-,PROPN,PROPN-PROPN,poss,compound-appos,NNP,NNP-NNP,0,1
2917,1590.0,28,claimed,3,2,13,11,1,14,1,10,United States,volleyball World League,-,org-org-org,PROPN-PROPN,PROPN-PROPN-PROPN,compound-nsubj,compound-compound-pobj,NNP-NNP,NNP-NNP-NNP,6,1
2918,1591.0,26,worked,7,7,24,17,6,1,0,17,he,Syracuse Orange,,org-org,PRON,PROPN-PROPN,nsubj,compound-conj,PRP,NNP-NNP,5,1
2919,1592.0,21,is,4,2,19,17,1,1,2,15,Grey Coat Hospital,London,--,org,PROPN-PROPN-PROPN,PROPN,compound-compound-nsubj,compound,NNP-NNP-NNP,NNP,7,1
2920,13589.0,16,attended,2,5,11,6,4,4,-3,9,Grey Coat Hospital,London,per-per-per,,PROPN-PROPN-PROPN,PROPN,compound-compound-compound,pobj,NNP-NNP-NNP,NNP,4,1
2921,1593.0,34,received,8,16,19,3,15,14,-8,11,Hampshire College,Amherst,-,per,PROPN-PROPN,PROPN,compound-pobj,compound,NNP-NNP,NNP,4,1
2922,1594.0,19,gave,5,2,3,1,1,15,3,-2,UK,Official Nintendo Magazine,per,--,PROPN,PROPN-PROPN-PROPN,compound,compound-compound-nsubj,NNP,NNP-NNP-NNP,2,1
2923,1595.0,45,says,9,11,20,9,10,24,-2,11,Jolie,Billy Bob Thornton,,per-per-per,PROPN,PROPN-PROPN-PROPN,nsubj,compound-compound-poss,NNP,NNP-NNP-NNP,9,1
2924,1596.0,8,is,5,2,5,3,1,2,3,0,Mark Barry,BBMak,per-per,,PROPN-PROPN,PROPN,compound-nsubj,pobj,NNP-NNP,NNP,1,1
2925,1597.0,12,is,9,2,6,4,1,5,7,-3,John Frusciante,Red Hot Chili Peppers,-,org-org-org-org,PROPN-PROPN,PROPN-PROPN-PROPN-PROPN,compound-nsubj,compound-compound-compound-pobj,NNP-NNP,NNP-NNP-NNP-NNPS,3,1
2926,1599.0,30,named,3,6,18,12,5,11,-3,15,Samuel Cate Prescott,Massachusetts Institute of Technology,--,org-org-org-org,PROPN-PROPN-PROPN,PROPN-PROPN-ADP-PROPN,compound-compound-pobj,compound-pobj-prep-pobj,NNP-NNP-NNP,NNP-NNP-IN-NNP,5,1
2927,12572.0,32,was,1,10,15,5,9,16,-9,14,Samuel Cate Prescott,Massachusetts Institute of Technology,per-per-per,---,PROPN-PROPN-PROPN,PROPN-PROPN-ADP-PROPN,compound-compound-pobj,compound-nmod-prep-pobj,NNP-NNP-NNP,NNP-NNP-IN-NNP,3,1
2928,1600.0,45,sparred,11,9,26,17,8,18,2,15,Yousaf Raza Gillani,Pakistan,--,org,PROPN-PROPN-PROPN,PROPN,compound-compound-nsubj,nsubjpass,NNP-NNP-NNP,NNP,10,1
2929,1601.0,29,left,3,2,2,0,1,26,1,-1,Juventud,Juventud Guerrera,org,-,PROPN,PROPN-PROPN,nsubj,compound-pobj,NNP,NNP-NNP,0,1
2930,1603.0,51,bought,22,40,15,-25,39,35,-18,-7,British Columbia,BC Hydro,-,org-org,PROPN-PROPN,PROPN-PROPN,compound-nmod,compound-pobj,NNP-NNP,NNP-NNP,10,1
2931,1604.0,31,said,20,7,18,11,6,12,13,-2,Pakistan,Shah Mehmood Qureshi,per,--,PROPN,PROPN-PROPN-PROPN,conj,compound-compound-nsubj,NNP,NNP-NNP-NNP,3,1
2932,4074.0,27,said,25,7,12,5,6,14,18,-13,Pakistan,Shah Mehmood Qureshi,,org-org-org,PROPN,PROPN-PROPN-PROPN,poss,compound-compound-compound,NNP,NNP-NNP-NNP,5,1
2933,4309.0,32,told,7,1,5,4,0,26,6,-2,Pakistan,Shah Mehmood Qureshi,,per-per-per,PROPN,PROPN-PROPN-PROPN,poss,compound-compound-nsubj,NNP,NNP-NNP-NNP,4,1
2934,7754.0,29,YORK,1,13,18,5,12,10,-12,17,Pakistan,Shah Mehmood Qureshi,per,--,PROPN,PROPN-PROPN-PROPN,conj,compound-compound-dobj,NNP,NNP-NNP-NNP,2,1
2935,1605.0,40,elected,7,14,29,15,13,10,-7,22,Worcestershire,Stanley Baldwin,per,-,PROPN,PROPN-PROPN,pobj,compound-pobj,NNP,NNP-NNP,4,1
2936,1606.0,22,credited,7,3,9,6,2,12,4,2,American,Murphy,per,,ADJ,PROPN,amod,dobj,JJ,NNP,2,1
2937,1607.0,11,Strausbaugh,1,4,6,2,3,4,-3,5,Joe,United States,,per-per,PROPN,PROPN-PROPN,compound,compound-conj,NNP,NNP-NNP,1,1
2938,1608.0,27,was,5,18,25,7,17,1,-13,20,Hans Hedtoft,Social Democrats,per-per,-,PROPN-PROPN,PROPN-PROPN,compound-compound,compound-pobj,NNP-NNP,NNP-NNPS,7,1
2939,1609.0,23,graduated,1,4,7,3,3,15,-3,6,Dartmouth College,New Hampshire,per-per,-,PROPN-PROPN,PROPN-PROPN,compound-compound,compound-pobj,NNP-NNP,NNP-NNP,1,1
2940,1610.0,40,is,9,2,2,0,1,37,7,-7,Kim Il-sung,Kim Jong-suk,-,per-per,PROPN-PROPN,PROPN-PROPN,compound-pobj,compound-appos,NNP-NNP,NNP-NNP,0,1
2941,1611.0,46,discussed,36,18,19,1,17,26,18,-17,Interior,Juan Camilo,,per-per,PROPN,PROPN-PROPN,pobj,compound-pobj,NNP,NNP-NNP,4,1
2942,1612.0,47,took,8,7,15,8,6,31,1,7,Cele Goldsmith,Fantastic,-,org,PROPN-PROPN,ADJ,compound-pobj,pobj,NNP-NNP,JJ,9,1
2943,1613.0,32,competes,8,19,2,-17,18,29,-11,-6,Division I,Florida Gulf Coast University,-,per-per-per-per,PROPN-PRON,PROPN-PROPN-PROPN-PROPN,appos-nsubj,compound-compound-compound-dobj,NNP-PRP,NNP-NNP-NNP-NNP,-1,1
2944,1614.0,88,~,0,67,82,15,66,5,-67,82,University of Wisconsin-Madison,WI,--,per,PROPN-ADP-PROPN,PROPN,ROOT-prep-pobj,appos,NNP-IN-NNP,NNP,7,1
2945,1615.0,19,are,2,2,8,6,1,10,0,6,club,Northern Counties East League,,per-per-per-per,NOUN,PROPN-PROPN-PROPN-PROPN,nsubj,compound-compound-compound-compound,NN,NNP-NNPS-NNP-NNP,5,1
2946,1616.0,14,is,2,9,11,2,8,2,-7,9,Athens,The Method Actors,per,--,PROPN,DET-PROPN-PROPN,pobj,det-compound-npadvmod,NNP,DT-NNP-NNPS,2,1
2947,1617.0,44,launched,8,12,6,-6,11,37,-4,-2,1989,Saab Automobile,per,-,NUM,PROPN-PROPN,pobj,compound-compound,CD,NNP-NNP,5,1
2948,1618.0,26,asked,2,16,18,2,15,7,-14,16,her,Desi Arnaz,org,-,DET,PROPN-PROPN,poss,compound-appos,PRP$,NNP-NNP,1,1
2949,1619.0,16,is,2,1,5,4,0,10,1,3,Interserve,UK,per,,PROPN,PROPN,compound,npadvmod,NNP,NNP,3,1
2950,1621.0,21,demanding,12,4,10,6,3,10,8,-2,Democratic Progressive Party,Chai Trong-rong,--,org-org,PROPN-PROPN-PROPN,PROPN-PROPN,compound-compound-compound,compound-pobj,NNP-NNP-NNP,NNP-NNP,6,1
2951,1622.0,37,seen,22,19,33,14,18,3,3,11,Finland,Ryti,org,,PROPN,PROPN,pobj,compound,NNP,NNP,7,1
2952,1623.0,72,ceremonies,12,65,70,5,64,1,-53,58,India,DD National,org,-,PROPN,PROPN-PROPN,pobj,compound-pobj,NNP,NNP-NNP,5,1
2953,1624.0,25,knew,5,1,4,3,0,20,4,-1,Khmer Rouge,Pol Pot,-,org-org,PROPN-PROPN,PROPN-PROPN,compound-compound,compound-nsubj,NNP-NNP,NNP-NNP,2,1
2954,2699.0,35,was,18,5,17,12,4,17,13,-1,Khmer Rouge,Pol Pot,-,org-org,PROPN-PROPN,PROPN-PROPN,compound-pobj,compound-pobj,NNP-NNP,NNP-NNP,6,1
2955,3339.0,35,marked,3,12,15,3,11,19,-9,12,Khmer Rouge,Pol Pot,-,org-org,PROPN-PROPN,PROPN-PROPN,compound-compound,compound-pobj,NNP-NNP,NNP-NNP,6,1
2956,4865.0,35,is,4,10,13,3,9,21,-6,9,Khmer Rouge,Pol Pot,-,per-per,PROPN-PROPN,PROPN-PROPN,compound-compound,compound-nsubj,NNP-NNP,NNP-NNP,2,1
2957,4915.0,71,marked,4,10,13,3,9,57,-6,9,Khmer Rouge,Pol Pot,-,per-per,PROPN-PROPN,PROPN-PROPN,compound-compound,compound-poss,NNP-NNP,NNP-NNP,3,1
2958,12828.0,39,emptied,10,2,9,7,1,29,8,-1,Khmer Rouge,Pol Pot,-,per-per,PROPN-PROPN,PROPN-PROPN,compound-nsubj,compound-pobj,NNP-NNP,NNP-NNP,3,1
2959,1625.0,41,edged,25,3,19,16,2,21,22,-6,Ambrose,Londoners,,per,PROPN,PROPN,nsubj,nsubj,NNP,NNPS,9,1
2960,1627.0,26,found,5,8,23,15,7,2,-3,18,Christian Argenti,Invertigo,per-per,,PROPN-PROPN,PROPN,compound-dobj,pobj,NNP-NNP,NNP,3,1
2961,1628.0,22,are,8,15,20,5,14,1,-7,12,Guns N ' Roses,Robin Finck,org-org-org-org,-,PROPN-PROPN-PART-PROPN,PROPN-PROPN,compound-conj-punct-compound,compound-pobj,NNP-NNP-POS-NNPS,NNP-NNP,5,1
2962,1629.0,50,area,3,16,28,12,15,21,-13,25,Ontario,Sheila Copps,,per-per,PROPN,PROPN-PROPN,pobj,compound-pobj,NNP,NNP-NNP,6,1
2963,1630.0,13,told,1,1,7,6,0,5,0,6,He,London,,per,PRON,PROPN,nsubj,pobj,PRP,NNP,2,1
2964,4341.0,15,shows,13,1,13,12,0,1,12,0,He,London,per,,PRON,PROPN,nsubj,appos,PRP,NNP,5,1
2965,6829.0,9,returned,1,1,4,3,0,4,0,3,He,London,,per,PRON,PROPN,nsubj,pobj,PRP,NNP,1,1
2966,7264.0,12,was,1,1,7,6,0,4,0,6,He,London,,org,PRON,PROPN,nsubj,compound,PRP,NNP,3,1
2967,13102.0,20,made,1,1,10,9,0,9,0,9,He,London,,per,PRON,PROPN,nsubj,pobj,PRP,NNP,1,1
2968,1631.0,28,is,2,7,11,4,6,16,-5,9,University of Tsukuba,Japan,--,per,PROPN-ADP-PROPN,PROPN,pobj-prep-pobj,compound,NNP-IN-NNP,NNP,6,1
2969,1632.0,21,born,2,1,15,14,0,5,1,13,Tamayo,Mexico,,org,PROPN,PROPN,nsubjpass,poss,NNP,NNP,6,1
2970,1633.0,25,is,2,1,24,23,0,0,1,22,Mani Ratnam,India,-,per,PROPN-PROPN,PROPN,compound-nsubj,pobj,NNP-NNP,NNP,2,1
2971,1634.0,29,guarding,2,6,13,7,5,15,-4,11,Kurupt,Death Row,per,-,PROPN,PROPN-PROPN,nmod,compound-compound,NNP,NNP-NNP,4,1
2972,1636.0,22,represented,8,4,17,13,3,4,4,9,Bryant Bulldogs,Division I,-,org-org,PROPN-PROPN,PROPN-PRON,compound-compound,pobj-nsubj,NNP-NNPS,NNP-PRP,4,1
2973,1637.0,23,looked,8,1,7,6,0,15,7,-1,Chad Michael Murray,Sophia Bush,--,per-per,PROPN-PROPN-PROPN,PROPN-PROPN,compound-compound-nsubj,compound-conj,NNP-NNP-NNP,NNP-NNP,2,1
2974,11881.0,35,abounded,28,5,24,19,4,10,23,-4,Chad Michael Murray,Sophia Bush,per-per-per,-,PROPN-PROPN-PROPN,PROPN-PROPN,compound-compound-poss,compound-dobj,NNP-NNP-NNP,NNP-NNP,8,1
2975,1638.0,23,established,2,18,21,3,17,1,-16,19,Minhaj-ul-Quran,Lahore,,per,PROPN,PROPN,compound,compound,NNP,NNP,4,1
2976,1639.0,25,began,1,1,5,4,0,19,0,4,APESMA,Association of Professional Engineers,per,---,PROPN,PROPN-ADP-PROPN-PROPN,nsubj,pobj-prep-compound-compound,NNP,NNP-IN-NNP-NNPS,3,1
2977,1640.0,31,done,9,24,28,4,23,2,-15,19,Evans Sutherland,Salt Lake City,org-org,--,PROPN-PROPN,PROPN-PROPN-PROPN,compound-compound,compound-compound-pobj,NNP-NNP,NNP-NNP-NNP,6,1
2978,1642.0,27,had,11,1,7,6,0,19,10,-4,Dubai World,Istithmar World,per-per,-,PROPN-PROPN,PROPN-PROPN,compound-poss,compound-nsubj,NNP-NNP,NNP-NNP,2,1
2979,8247.0,40,spearheaded,9,3,8,5,2,31,6,-1,Dubai World,Istithmar World,per-per,-,PROPN-PROPN,PROPN-PROPN,compound-poss,compound-appos,NNP-NNP,NNP-NNP,5,1
2980,1644.0,40,referred,11,2,30,28,1,9,9,19,Cooper Union,New York,org-org,-,PROPN-PROPN,PROPN-PROPN,compound-nsubj,compound-compound,NNP-NNP,NNP-NNP,8,1
2981,9592.0,34,invented,28,1,15,14,0,18,27,-13,Cooper Union,New York,-,org-org,PROPN-PROPN,PROPN-PROPN,compound-poss,compound-compound,NNP-NNP,NNP-NNP,7,1
2982,9859.0,27,dropped,1,10,15,5,9,11,-9,14,Cooper Union,New York,org-org,-,PROPN-PROPN,PROPN-PROPN,compound-pobj,compound-compound,NNP-NNP,NNP-NNP,8,1
2983,11628.0,20,left,3,15,18,3,14,1,-12,15,Cooper Union,New York,org-org,-,PROPN-PROPN,PROPN-PROPN,compound-pobj,compound-pobj,NNP-NNP,NNP-NNP,2,1
2984,1645.0,20,is,14,1,17,16,0,2,13,3,Dimitri Kirilov,Russian,-,org,PROPN-PROPN,ADJ,compound-nsubj,amod,NNP-NNP,JJ,3,1
2985,1646.0,32,cut,9,1,7,6,0,24,8,-2,India,Bank of India,per,--,PROPN,PROPN-ADP-PROPN,poss,nsubj-prep-pobj,NNP,NNP-IN-NNP,5,1
2986,1647.0,28,Sr.,3,19,21,2,18,6,-16,18,Boston University,Terriers,org-org,,PROPN-PROPN,PROPN,compound-compound,compound,NNP-NNP,NNP,1,1
2987,1648.0,48,brought,23,1,5,4,0,42,22,-18,Dole,Kansas,org,,PROPN,PROPN,nsubj,pobj,NNP,NNP,3,1
2988,1649.0,16,is,2,1,14,13,0,1,1,12,Tommy Stewart,Birmingham,org-org,,PROPN-PROPN,PROPN,compound-nsubj,compound,NNP-NNP,NNP,5,1
2989,1651.0,16,left,7,5,9,4,4,6,2,2,Stafford,Capitol,org,,PROPN,PROPN,nsubj,dobj,NNP,NNP,3,1
2990,1652.0,41,signalled,13,1,10,9,0,30,12,-3,Tesco,Sir Terry Leahy,org,--,PROPN,PROPN-PROPN-PROPN,nsubj,compound-compound-appos,NNP,NNP-NNP-NNP,4,1
2991,12452.0,23,fell,2,1,14,13,0,8,1,12,Tesco,Sir Terry Leahy,per,--,NOUN,PROPN-PROPN-PROPN,compound,compound-compound-appos,NN,NNP-NNP-NNP,5,1
2992,1653.0,23,is,8,1,12,11,0,10,7,4,RBA,Brunei,org,,PROPN,PROPN,compound,compound,NNP,NNP,4,1
2993,1654.0,21,welcomed,6,1,3,2,0,17,5,-3,Tijuana,Jorge Hank Rhon,per,--,PROPN,PROPN-PROPN-PROPN,compound,compound-compound-nsubj,NNP,NNP-NNP-NNP,2,1
2994,1655.0,79,was,47,11,33,22,10,45,36,-14,World Council on Economic Development,Gro Harlem Brundtland,----,org-org-org,PROPN-PROPN-ADP-PROPN-PROPN,PROPN-PROPN-PROPN,compound-pobj-prep-compound-poss,compound-compound-pobj,NNP-NNP-IN-NNP-NNP,NNP-NNP-NNP,7,1
2995,1657.0,26,served,2,18,25,7,17,0,-16,23,FIBA World Championship for Women,Australia,per-per-per-per-per,,PROPN-PROPN-PROPN-ADP-PROPN,PROPN,compound-compound-pobj-prep-pobj,pobj,NNP-NNP-NNP-IN-NNPS,NNP,9,1
2996,1658.0,28,KELSO-COLUMN,0,10,16,6,9,11,-10,16,Whole Foods Market,John Mackey,per-per-per,-,PROPN-PROPN-PROPN,PROPN-PROPN,compound-compound-compound,compound-nsubj,NNP-NNPS-NNP,NNP-NNP,5,1
2997,1659.0,33,accepted,1,13,11,-2,12,21,-12,10,Gainesville,Florida Gators,per,-,PROPN,PROPN-PROPN,pobj,compound-compound,NNP,NNP-NNP,1,1
2998,1660.0,38,felt,8,3,7,4,2,30,5,-1,Bob Rusch,Cadence Magazine,per-per,-,PROPN-PROPN,PROPN-PROPN,compound-nsubj,compound-pobj,NNP-NNP,NNP-NNP,3,1
2999,1661.0,38,was,9,19,28,9,18,9,-10,19,Jane Seymour,England,org-org,,PROPN-PROPN,PROPN,compound-appos,pobj,NNP-NNP,NNP,8,1
3000,1662.0,22,formed,1,12,16,4,11,5,-11,15,the Libertines,Rough Trade,org-org,-,DET-PROPN,PROPN-PROPN,det-nsubj,compound-compound,DT-NNPS,NNP-NNP,4,1
3001,1663.0,44,become,13,11,31,20,10,12,2,18,Burma,Ne Win,,per-per,PROPN,PROPN-PROPN,nsubj,compound-poss,NNP,NNP-NNP,5,1
3002,1664.0,21,called,7,9,19,10,8,1,-2,12,Enskilda,Danske Bank,,per-per,PROPN,PROPN-PROPN,compound,compound-pobj,NNP,NNP-NNP,4,1
3003,1665.0,18,represented,7,3,3,0,2,14,4,-4,Florida State Seminoles,Florida State University,per-per-per,--,PROPN-PROPN-PROPN,PROPN-PROPN-PROPN,compound-compound-compound,compound-compound-dobj,NNP-NNP-NNP,NNP-NNP-NNP,0,1
3004,1666.0,39,plans,20,4,15,11,3,23,16,-5,Dairy Queen,Warren Buffett,org-org,-,PROPN-PROPN,PROPN-PROPN,compound-compound,compound-poss,NNP-NNP,NNP-NNP,-1,1
3005,1667.0,24,served,14,8,14,6,7,9,6,0,State,he,org,,PROPN,PRON,pobj,nsubj,NNP,PRP,2,1
3006,1668.0,33,awarded,7,5,6,1,4,26,2,-1,Defence,Jaak Aaviksoo,,org-org,PROPN,PROPN-PROPN,pobj,compound-nsubj,NNP,NNP-NNP,1,1
3007,9962.0,42,said,4,1,3,2,0,38,3,-1,Defence,Jaak Aaviksoo,,per-per,PROPN,PROPN-PROPN,compound,compound-nsubj,NNP,NNP-NNP,1,1
3008,1669.0,36,Stojiljkovi?,1,13,13,0,12,22,-12,12,f Yugoslavi,f Slobodan,-,org-org,X-PROPN,X-PROPN,det-nsubj,det-pobj,XX-NNP,XX-NNP,0,1
3009,1670.0,34,News,5,7,4,-3,6,29,-2,-1,Canada,Canadian Forces,per,-,PROPN,PROPN-PROPN,dobj,compound-pobj,NNP,NNP-NNPS,4,1
3010,6481.0,27,unified,3,3,12,9,2,14,0,9,Canada,Canadian Forces,org,-,PROPN,PROPN-PROPN,nsubj,compound-dobj,NNP,NNP-NNPS,3,1
3011,13828.0,48,is,3,32,46,14,31,1,-29,43,Canada,Canadian Forces,per,-,PROPN,PROPN-PROPN,pobj,compound-pobj,NNP,NNP-NNPS,9,1
3012,1671.0,42,Leyte,2,36,2,-34,35,39,-34,0,Philippines,Southern Leyte,per,-,PROPN,PROPN-PROPN,pobj,compound-pobj,NNPS,NNP-NNP,-1,1
3013,1672.0,40,became,12,11,19,8,10,20,1,7,Serbia,Zoran ?in?,,per-per,PROPN,PROPN-PUNCT,pobj,pobj-punct,NNP,NNP-.,4,1
3014,1673.0,19,spent,7,15,17,2,14,1,-8,10,Church,Princeton University,,org-org,PROPN,PROPN-PROPN,pobj,compound-pobj,NNP,NNP-NNP,1,1
3015,1674.0,30,returned,1,1,18,17,0,11,0,17,Iceland,Paul Oscar,,org-org,NOUN,PROPN-PROPN,nsubj,compound-nsubj,NN,NNP-NNP,2,1
3016,1675.0,91,think,47,11,12,1,10,78,36,-35,Navy,William Jones,org,-,PROPN,PROPN-PROPN,pobj,compound-pobj,NNP,NNP-NNP,1,1
3017,6411.0,38,forced,18,12,14,2,11,23,6,-4,Navy,William Jones,,per-per,PROPN,PROPN-PROPN,compound,compound-appos,NNP,NNP-NNP,6,1
3018,11719.0,31,estimated,14,10,11,1,9,19,4,-3,Navy,William Jones,org,-,PROPN,PROPN-PROPN,pobj,compound-compound,NNP,NNP-NNP,1,1
3019,12703.0,60,By,0,8,9,1,7,50,-8,9,Navy,William Jones,org,-,PROPN,PROPN-PROPN,pobj,compound-pobj,NNP,NNP-NNP,1,1
3020,1676.0,65,began,12,12,19,7,11,45,0,7,Manhattan,Marvel Comics,,per-per,PROPN,PROPN-PROPN,pobj,compound-nsubj,NNP,NNP-NNP,4,1
3021,1677.0,21,released,4,4,18,14,3,2,0,14,KOVAS,Ghetto Beat,,per-per,PROPN,PROPN-PROPN,nsubj,compound-compound,NNP,NNP-NNP,4,1
3022,1678.0,23,is,15,1,19,18,0,3,14,4,Calyampudi Radhakrishna Rao,American,--,per,PROPN-PROPN-PROPN,ADJ,compound-compound-compound,amod,NNP-NNP-NNP,JJ,4,1
3023,1679.0,25,Ireland-based,20,2,7,5,1,17,18,-13,Herald,APN News Media,,org-org-org,PROPN,PROPN-PROPN-PROPN,nsubjpass,compound-compound-pobj,NNP,NNP-NNP-NNP,4,1
3024,1680.0,24,was,1,19,22,3,18,1,-18,21,she,Sire,,org,PRON,PROPN,nsubj,compound,PRP,NNP,2,1
3025,1681.0,34,said,14,16,23,7,15,10,-2,9,European Central Bank,Jean-Claude Trichet,--,per-per,PROPN-PROPN-PROPN,PROPN-PROPN,compound-compound-nsubj,compound-ROOT,NNP-NNP-NNP,NNP-NNP,-1,1
3026,1876.0,37,said,21,2,31,29,1,5,19,10,European Central Bank,Jean-Claude Trichet,per-per-per,-,PROPN-PROPN-PROPN,PROPN-PROPN,compound-compound-nsubj,compound-pobj,NNP-NNP-NNP,NNP-NNP,10,1
3027,8610.0,31,held,1,16,20,4,15,10,-15,19,European Central Bank,Jean-Claude Trichet,--,org-org,PROPN-PROPN-PROPN,PROPN-PROPN,compound-compound-compound,compound-conj,NNP-NNP-NNP,NNP-NNP,5,1
3028,13836.0,31,are,3,23,26,3,22,4,-20,23,European Central Bank,Jean-Claude Trichet,org-org-org,-,PROPN-PROPN-PROPN,PROPN-PROPN,compound-compound-pobj,compound-appos,NNP-NNP-NNP,NNP-NNP,4,1
3029,1682.0,33,mixed,14,10,17,7,9,15,4,3,Los Angeles,Manny Marroquin,per-per,-,PROPN-PROPN,PROPN-PROPN,compound-compound,compound-pobj,NNP-NNP,NNP-NNP,10,1
3030,1683.0,23,is,15,2,14,12,1,8,13,-1,Confederation of Workers of Colombia,CTC,----,per,PROPN-ADP-PROPN-ADP-PROPN,PROPN,nsubj-prep-pobj-prep-pobj,appos,NNP-IN-NNPS-IN-NNP,NNP,3,1
3031,1685.0,36,been,3,11,19,8,10,16,-8,16,Italian,Mario Draghi,,per-per,ADJ,PROPN-PROPN,amod,compound-nsubj,JJ,NNP-NNP,8,1
3032,1686.0,42,opposed,5,1,4,3,0,37,4,-1,Oregon,Ron Wyden,,org-org,PROPN,PROPN-PROPN,compound,compound-nsubj,NNP,NNP-NNP,2,1
3033,5467.0,31,won,6,1,4,3,0,26,5,-2,Oregon,Ron Wyden,org,-,PROPN,PROPN-PROPN,compound,compound-nsubj,NNP,NNP-NNP,2,1
3034,1687.0,46,Flash,2,11,21,10,10,24,-9,19,French Polynesia,Oscar Temaru,per-per,-,PROPN-PROPN,PROPN-PROPN,amod-pobj,compound-poss,NNP-NNP,NNP-NNP,8,1
3035,4764.0,31,Flash,2,21,26,5,20,4,-19,24,French Polynesia,Oscar Temaru,-,per-per,PROPN-PROPN,PROPN-PROPN,amod-pobj,compound-pobj,NNP-NNP,NNP-NNP,6,1
3036,13367.0,69,targeted,14,11,26,15,10,42,3,12,French Polynesia,Oscar Temaru,-,org-org,PROPN-PROPN,PROPN-PROPN,amod-pobj,compound-conj,NNP-NNP,NNP-NNP,8,1
3037,14207.0,50,elected,4,8,27,19,7,22,-4,23,French Polynesia,Oscar Temaru,per-per,-,PROPN-PROPN,PROPN-PROPN,amod-pobj,compound-pobj,NNP-NNP,NNP-NNP,9,1
3038,1688.0,20,joined,3,5,10,5,4,9,-2,7,Halcones UV Xalapa,Liga Nacional de Baloncesto Profesional,per-per-per,----,PROPN-PROPN-PROPN,PROPN-PROPN-PROPN-PROPN-PROPN,compound-compound-dobj,compound-compound-compound-compound-pobj,NNPS-NNP-NNP,NNP-NNP-NNP-NNP-NNP,4,1
3039,1689.0,19,is,3,1,17,16,0,1,2,14,The Peninsula School,Victoria,--,org,DET-PROPN-PROPN,PROPN,det-compound-nsubj,compound,DT-NNP-NNP,NNP,8,1
3040,1690.0,14,is,2,1,11,10,0,2,1,9,Hombres G,Spain,per-per,,NOUN-PROPN,PROPN,compound-nsubj,pobj,NNS-NNP,NNP,4,1
3041,1691.0,58,did,35,22,52,30,21,5,13,17,European Commission,Jose Manuel Barroso,-,per-per-per,PROPN-PROPN,PROPN-PROPN-PROPN,compound-pobj,compound-compound-appos,NNP-NNP,NNP-NNP-NNP,13,1
3042,1692.0,34,moved,6,11,11,0,10,22,-5,5,Florida,Florida School for the Deaf and Blind,,per-per-per-per-per-per-per,PROPN,PROPN-PROPN-ADP-DET-PROPN-CCONJ-PROPN,pobj,compound-dobj-prep-det-pobj-cc-conj,NNP,NNP-NNP-IN-DT-NNP-CC-NNP,0,1
3043,1693.0,41,focused,3,24,39,15,23,1,-21,36,General Systems,Anatol Rapoport,org-org,-,PROPN-PROPN,PROPN-PROPN,compound-compound,compound-conj,NNP-NNPS,NNP-NNP,16,1
3044,1694.0,37,included,12,25,25,0,24,11,-13,13,Elizabeth Bowes-Lyon,Elizabeth,-,per,PROPN-PROPN,PROPN,conj-ROOT,appos,NNP-NNP,NNP,0,1
3045,11779.0,32,married,8,7,7,0,6,24,1,-1,Elizabeth Bowes-Lyon,Elizabeth,org-org,,PROPN-PROPN,PROPN,compound-appos,attr,NNP-NNP,NNP,0,1
3046,1695.0,27,participated,17,11,26,15,10,0,6,9,Reinfeldt,Sweden,,per,PROPN,PROPN,pobj,pobj,NNP,NNP,12,1
3047,8231.0,23,said,1,1,7,6,0,15,0,6,Reinfeldt,Sweden,,per,PROPN,PROPN,nsubj,nsubj,NNP,NNP,2,1
3048,1696.0,31,comes,3,14,18,4,13,12,-11,15,Nokia,Finland,,per,PROPN,PROPN,pobj,pobj,NNP,NNP,3,1
3049,3393.0,12,produces,6,2,6,4,1,5,4,0,Nokia,Finland,,org,PROPN,PROPN,nsubj,pobj,NNP,NNP,2,1
3050,5383.0,12,headquarters,1,4,9,5,3,2,-3,8,Nokia,Finland,,per,PROPN,PROPN,compound,pobj,NNP,NNP,3,1
3051,11822.0,38,announced,3,3,20,17,2,17,0,17,Nokia,Finland,org,,PROPN,PROPN,nsubj,pobj,NNP,NNP,6,1
3052,12953.0,20,twinned,10,13,19,6,12,0,-3,9,Nokia,Finland,per,,PROPN,PROPN,poss,pobj,NNP,NNP,2,1
3053,1697.0,25,hoped,4,1,3,2,0,21,3,-1,CBS,Warner Bros.,,per-per,PROPN,PROPN-PROPN,nsubj,compound-conj,NNP,NNP-NNPS,2,1
3054,1699.0,47,include,9,16,45,29,15,1,-7,36,Prime Minister,Nader al-Dahabi,org-org,-,PROPN-PROPN,PROPN-PROPN,compound-compound,compound-conj,NNP-NNP,NNP-NNP,-1,1
3055,1700.0,18,record,2,1,11,10,0,6,1,9,Her,Liz Anderson,per,-,DET,PROPN-PROPN,poss,compound-compound,PRP$,NNP-NNP,4,1
3056,1703.0,27,is,10,1,19,18,0,7,9,9,Tarja Kaarina Halonen,President,org-org-org,,PROPN-PROPN-PROPN,PROPN,compound-compound-nsubj,attr,NNP-NNP-NNP,NNP,6,1
3057,1704.0,28,born,4,17,26,9,16,1,-13,22,Thomas Jefferson,United States,per-per,-,PROPN-PROPN,PROPN-PROPN,compound-pobj,compound-pobj,NNP-NNP,NNP-NNP,6,1
3058,3445.0,34,received,5,12,19,7,11,14,-7,14,Thomas Jefferson,United States,-,org-org,PROPN-PROPN,PROPN-PROPN,compound-pobj,compound-compound,NNP-NNP,NNP-NNP,8,1
3059,6848.0,17,is,1,6,15,9,5,1,-5,14,Thomas Jefferson,United States,org-org,-,PROPN-PROPN,PROPN-PROPN,compound-poss,compound-pobj,NNP-NNP,NNP-NNP,3,1
3060,10184.0,21,represented,11,1,18,17,0,2,10,7,Thomas Jefferson,United States,per-per,-,PROPN-PROPN,PROPN-PROPN,compound-compound,compound-compound,NNP-NNP,NNP-NNP,5,1
3061,10571.0,30,nominated,2,6,17,11,5,12,-4,15,Thomas Jefferson,United States,per-per,-,PROPN-PROPN,PROPN-PROPN,compound-pobj,compound-compound,NNP-NNP,NNP-NNP,7,1
3062,12597.0,64,was,1,35,54,19,34,9,-34,53,Thomas Jefferson,United States,-,per-per,PROPN-PROPN,PROPN-PROPN,compound-compound,compound-compound,NNP-NNP,NNP-NNP,7,1
3063,1706.0,36,was,1,1,15,14,0,20,0,14,Ryti,Finland,org,,PROPN,PROPN,nsubj,dobj,NNP,NNP,5,1
3064,4694.0,42,read,9,11,18,7,10,23,-2,9,Ryti,Finland,per,,PROPN,PROPN,poss,poss,NNP,NNP,7,1
3065,5317.0,29,credited,6,1,12,11,0,16,5,6,Ryti,Finland,,per,PROPN,PROPN,poss,nsubj,NNP,NNP,6,1
3066,1707.0,24,attacked,8,1,3,2,0,20,7,-5,Jean-Claude Juncker,Luxembourg,org-org,,PROPN-PROPN,PROPN,nmod-nmod,compound,NNP-NNP,NNP,3,1
3067,1708.0,19,asked,8,10,18,8,9,0,-2,10,Alistair Taylor,Apple,org-org,,PROPN-PROPN,PROPN,compound-dobj,pobj,NNP-NNP,NNP,5,1
3068,1709.0,24,is,2,9,14,5,8,9,-7,12,Death Cab for Cutie,Chris Walla,---,per-per,PROPN-PROPN-ADP-PROPN,PROPN-PROPN,compound-pobj-prep-compound,compound-conj,NNP-NNP-IN-NNP,NNP-NNP,3,1
3069,1710.0,22,wants,6,1,20,19,0,1,5,14,Jai,United States,per,-,PROPN,PROPN-PROPN,nsubj,compound-pobj,NNP,NNP-NNP,5,1
3070,1711.0,28,listed,13,4,11,7,3,16,9,-2,International Union for Conservation of Nature,IUCN,-----,per,PROPN-PROPN-ADP-PROPN-ADP-PROPN,PROPN,compound-nsubj-prep-pobj-prep-pobj,appos,NNP-NNP-IN-NNP-IN-NNP,NNP,2,1
3071,1712.0,24,denied,2,8,10,2,7,13,-6,8,Agriculture,Mike Johanns,per,-,PROPN,PROPN-PROPN,compound,compound-pobj,NNP,NNP-NNP,1,1
3072,3131.0,75,announced,33,6,8,2,5,66,27,-25,Agriculture,Mike Johanns,,per-per,PROPN,PROPN-PROPN,compound,compound-pobj,NNP,NNP-NNP,1,1
3073,4228.0,32,be,5,10,12,2,9,19,-5,7,Agriculture,Mike Johanns,per,-,PROPN,PROPN-PROPN,compound,compound-nsubj,NNP,NNP-NNP,3,1
3074,4654.0,39,attended,5,28,30,2,27,8,-23,25,Agriculture,Mike Johanns,per,-,PROPN,PROPN-PROPN,compound,compound-conj,NNP,NNP-NNP,6,1
3075,5147.0,28,scheduled,5,21,23,2,20,4,-16,18,Agriculture,Mike Johanns,,per-per,PROPN,PROPN-PROPN,compound,compound-nsubj,NNP,NNP-NNP,1,1
3076,8084.0,31,said,29,26,28,2,25,2,3,-1,Agriculture,Mike Johanns,org,-,PROPN,PROPN-PROPN,compound,compound-nsubj,NNP,NNP-NNP,3,1
3077,9769.0,64,participate,58,10,12,2,9,51,48,-46,Agriculture,Mike Johanns,,per-per,PROPN,PROPN-PROPN,compound,compound-compound,NNP,NNP-NNP,2,1
3078,13782.0,25,met,2,16,18,2,15,6,-14,16,Agriculture,Mike Johanns,per,-,PROPN,PROPN-PROPN,compound,compound-conj,NNP,NNP-NNP,1,1
3079,14001.0,33,said,31,16,18,2,15,14,15,-13,Agriculture,Mike Johanns,org,-,PROPN,PROPN-PROPN,compound,compound-conj,NNP,NNP-NNP,1,1
3080,14144.0,27,announced,7,4,6,2,3,20,3,-1,Agriculture,Mike Johanns,,per-per,PROPN,PROPN-PROPN,compound,compound-pobj,NNP,NNP-NNP,1,1
3081,1713.0,23,is,12,15,21,6,14,1,-3,9,Rochester Institute of Technology,NY,per-per-per-per,,PROPN-PROPN-ADP-PROPN,PROPN,compound-pobj-prep-pobj,appos,NNP-NNP-IN-NNP,NNP,3,1
3082,5034.0,31,Title,0,17,24,7,16,6,-17,24,Rochester Institute of Technology,NY,per-per-per-per,,PROPN-PROPN-ADP-PROPN,PROPN,compound-ROOT-prep-pobj,compound,NNP-NNP-IN-NNP,NNP,5,1
3083,1714.0,32,taught,1,1,10,9,0,21,0,9,Jones,Nashville,per,,PROPN,PROPN,nsubj,pobj,NNP,NNP,3,1
3084,1715.0,45,promised,6,6,22,16,5,22,0,16,Kekkonen,Finland,per,,PROPN,PROPN,appos,nmod,NNP,NNP,-1,1
3085,10256.0,29,soared,7,5,24,19,4,4,2,17,Kekkonen,Finland,per,,PROPN,PROPN,poss,poss,NNP,NNP,13,1
3086,1716.0,26,is,2,10,10,0,9,15,-8,8,Toyah,Toyah Willcox,per,-,PROPN,PROPN-PROPN,nsubj,compound-pobj,NNP,NNP-NNP,0,1
3087,1717.0,37,is,10,27,30,3,26,6,-17,20,Universidad de,University of,per-per,-,PROPN-PROPN,PROPN-ADP,compound-pobj,nmod-prep,NNP-NNP,NNP-IN,2,1
3088,1718.0,16,graduated,1,7,7,0,6,8,-6,6,Savannah College of Art and Design,Savannah,per-per-per-per-per-per,,PROPN-PROPN-ADP-PROPN-CCONJ-PROPN,PROPN,compound-pobj-prep-pobj-cc-conj,compound,NNP-NNP-IN-NNP-CC-NNP,NNP,0,1
3089,1721.0,36,pay,15,21,34,13,20,1,-6,19,China,Yang Jiechi,per,-,PROPN,PROPN-PROPN,pobj,compound-pobj,NNP,NNP-NNP,8,1
3090,13311.0,26,said,20,4,18,14,3,7,16,-2,China,Yang Jiechi,org,-,PROPN,PROPN-PROPN,dobj,compound-compound,NNP,NNP-NNP,4,1
3091,1722.0,12,owned,2,5,9,4,4,2,-3,7,Quebecor,Groupe TVA,org,-,PROPN,PROPN-PROPN,compound,compound-compound,NNP,NNP-NNP,5,1
3092,13393.0,31,approved,6,11,20,9,10,10,-5,14,Quebecor,Groupe TVA,per,-,PROPN,PROPN-PROPN,compound,compound-nsubj,NNP,NNP-NNP,6,1
3093,1723.0,19,appointed,4,15,17,2,14,1,-11,13,State Security,Erich Mielke,-,per-per,PROPN-PROPN,PROPN-PROPN,pobj-compound,compound-pobj,NNP-NNP,NNP-NNP,1,1
3094,1724.0,25,is,9,1,17,16,0,7,8,8,Al Jadeed,Lebanon,org-org,,PROPN-PROPN,PROPN,compound-nsubj,pobj,NNP-NNP,NNP,3,1
3095,1725.0,35,scheduled,2,7,14,7,6,20,-5,12,Turkey,Ahmet Necdet Sezer,per,--,PROPN,PROPN-PROPN-PROPN,pobj,compound-compound-nsubj,NNP,NNP-NNP-NNP,4,1
3096,4110.0,22,expected,8,5,14,9,4,7,3,6,Turkey,Ahmet Necdet Sezer,,org-org-org,PROPN,PROPN-PROPN-PROPN,compound,compound-compound-dobj,NNP,NNP-NNP-NNP,8,1
3097,1726.0,15,was,10,1,13,12,0,1,9,3,Leon Askin,Austrian,per-per,,PROPN-PROPN,ADJ,compound-nsubj,amod,NNP-NNP,JJ,2,1
3098,1727.0,41,exceeds,8,2,21,19,1,19,6,13,her,Jubilee,,per,DET,PROPN,poss,nmod,PRP$,NNP,8,1
3099,1728.0,17,expected,6,2,4,2,1,12,4,-2,Candlemass,Messiah Marcolin,,org-org,PROPN,PROPN-PROPN,compound,compound-nsubjpass,NNP,NNP-NNP,1,1
3100,1729.0,44,gave,6,4,5,1,3,38,2,-1,Italy,Antonio Segni,org,-,PROPN,PROPN-PROPN,compound,compound-pobj,NNP,NNP-NNP,1,1
3101,1730.0,78,became,1,1,10,9,0,67,0,9,Kenya,Moi,per,,PROPN,PROPN,nsubj,pobj,NNP,NNP,4,1
3102,11550.0,18,crisscrossing,4,6,17,11,5,0,-2,13,Kenya,Moi,org,,PROPN,PROPN,dobj,pobj,NNP,NNP,2,1
3103,1732.0,20,introduced,10,14,19,5,13,0,-4,9,Curt Anderson,Baltimore,-,per,PROPN-PROPN,PROPN,compound-pobj,pobj,NNP-NNP,NNP,3,1
3104,1733.0,53,Karad?i,11,8,11,3,7,41,3,0,Republika Srpska,Radovan Karad?i,org-org,-,PROPN-PROPN,PROPN-NUM,compound-pobj,pobj-ROOT,NNP-NNP,NNP-CD,4,1
3105,4324.0,47,convicted,7,4,24,20,3,22,3,17,Republika Srpska,Radovan Karad?i,-,per-per,PROPN-PROPN,PROPN-NUM,compound-compound,nsubj-conj,NNP-NNP,NNP-CD,10,1
3106,5784.0,38,banned,6,12,14,2,11,23,-6,8,Republika Srpska,Radovan Karad?i,-,org-org,PROPN-PROPN,PROPN-NUM,pobj-compound,nsubj-ROOT,NNP-NNP,NNP-CD,5,1
3107,1734.0,45,reported,7,2,4,2,1,40,5,-3,New York,City Department of Corrections,-,per-per-per-per,PROPN-PROPN,PROPN-PROPN-ADP-PROPN,compound-compound,compound-nsubj-prep-pobj,NNP-NNP,NNP-NNP-IN-NNPS,2,1
3108,1735.0,27,is,1,11,22,11,10,4,-10,21,John Christy,University of Alabama in Huntsville,org-org,----,PROPN-PROPN,PROPN-ADP-PROPN-ADP-PROPN,compound-compound,pobj-prep-pobj-prep-pobj,NNP-NNP,NNP-IN-NNP-IN-NNP,4,1
3109,1736.0,28,signed,1,5,10,5,4,17,-4,9,La New Bears,Chinese Professional Baseball League,--,per-per-per-per,PROPN-PROPN-PROPN,PROPN-PROPN-PROPN-PROPN,compound-compound-pobj,compound-compound-compound-pobj,NNP-NNP-NNP,NNP-NNP-NNP-NNP,4,1
3110,1737.0,26,make,3,21,25,4,20,0,-18,22,Bob Moore,artist,per-per,,PROPN-PROPN,NOUN,compound-compound,pobj,NNP-NNP,NN,7,1
3111,1738.0,51,held,1,1,16,15,0,34,0,15,Ambrose,New York,per,-,NOUN,PROPN-PROPN,nsubj,compound-compound,NN,NNP-NNP,3,1
3112,2614.0,20,began,2,14,17,3,13,2,-12,15,Ambrose,New York,,org-org,PROPN,PROPN-PROPN,compound,compound-compound,NNP,NNP-NNP,3,1
3113,4346.0,13,began,2,7,10,3,6,2,-5,8,Ambrose,New York,per,-,PROPN,PROPN-PROPN,compound,compound-compound,NNP,NNP-NNP,3,1
3114,1739.0,22,Smith,1,1,21,20,0,0,0,20,Paul Smith,Park,-,per,PROPN-PROPN,PROPN,compound-ROOT,appos,NNP-NNP,NNP,5,1
3115,1740.0,51,helped,39,6,14,8,5,36,33,-25,Boston,Liberty,,per,PROPN,PROPN,compound,compound,NNP,NNP,5,1
3116,10661.0,34,known,7,6,13,7,5,20,1,6,Boston,Liberty,org,,PROPN,PROPN,nsubjpass,pobj,NNP,NNP,4,1
3117,1741.0,32,competes,2,14,30,16,13,1,-12,28,National Collegiate Athletic Association,Murray,---,per,PROPN-PROPN-PROPN-PROPN,PROPN,compound-compound-compound-pobj,compound,NNP-NNP-NNP-NNP,NNP,10,1
3118,1742.0,46,is,16,2,5,3,1,40,14,-11,Diplomatic Academy of Vienna,Vienna,---,per,PROPN-PROPN-ADP-PROPN,PROPN,compound-nsubj-prep-pobj,compound,NNP-NNP-IN-NNP,NNP,1,1
3119,1743.0,14,alias,2,5,13,8,4,0,-3,11,Prince,Minnesota,per,,PROPN,PROPN,nsubj,pobj,NNP,NNP,1,1
3120,1744.0,29,operating,3,2,8,6,1,20,1,5,Air Aruba,Aruba,-,per,PROPN-PROPN,PROPN,compound-nsubj,pobj,NNP-NNP,NNP,1,1
3121,1745.0,13,is,6,2,4,2,1,8,4,-2,University of Tampere,Tampere,org-org-org,,PROPN-ADP-PROPN,PROPN,nsubj-prep-pobj,compound,NNP-IN-NNP,NNP,3,1
3122,1746.0,35,have,18,2,6,4,1,28,16,-12,Minsk,Belarus State University,per,--,PROPN,PROPN-PROPN-PROPN,pobj,compound-compound-compound,NNP,NNP-NNP-NNP,4,1
3123,1748.0,37,Hospital,2,2,30,28,1,6,0,28,National Hospital for Neurology and Neurosurgery,University College London Hospitals NHS Foundation Trust,per-per-per-per-per-per,------,PROPN-PROPN-ADP-PROPN-CCONJ-PROPN,PROPN-PROPN-PROPN-PROPN-PROPN-PROPN-PROPN,compound-ROOT-prep-pobj-cc-conj,compound-compound-compound-compound-compound-compound-pobj,NNP-NNP-IN-NNP-CC-NNP,NNP-NNP-NNP-NNPS-NNP-NNP-NNP,7,1
3124,1749.0,92,spoke,3,28,21,-7,27,70,-25,18,SPACEHAB,James Baker,per,-,PROPN,PROPN-PROPN,pobj,compound-pobj,NNP,NNP-NNP,2,1
3125,1750.0,22,was,1,9,9,0,8,12,-8,8,Orange Romania,Orange,per-per,,PROPN-PROPN,PROPN,compound-pobj,compound,NNP-NNP,NNP,0,1
3126,1751.0,31,said,20,1,5,4,0,25,19,-15,Johanns,Nebraska,,org,PROPN,PROPN,nsubj,pobj,NNP,NNP,6,1
3127,1752.0,14,was,3,1,8,7,0,5,2,5,Catherine J. Melchert,Bartlett Illinois,org-org-org,-,PROPN-PROPN-PROPN,PROPN-PROPN,compound-compound-nsubj,pobj-appos,NNP-NNP-NNP,NNP-NNP,4,1
3128,1753.0,45,decided,2,17,32,15,16,12,-15,30,National Theatre School of Canada,1960,org-org-org-org-org,,PROPN-PROPN-PROPN-ADP-PROPN,NUM,compound-compound-nmod-prep-pobj,nummod,NNP-NNP-NNP-IN-NNP,CD,6,1
3129,1754.0,37,re-elected,6,5,20,15,4,16,1,14,Koroma,Sierra Leone,per,-,PROPN,PROPN-PROPN,nsubjpass,nmod-nmod,NNP,NNP-NNP,3,1
3130,1756.0,22,launched,13,12,21,9,11,0,1,8,Setanta Sports News,2007,org-org-org,,PROPN-PROPN-PROPN,NUM,compound-compound-dobj,npadvmod,NNP-NNPS-NNP,CD,6,1
3131,1757.0,45,worked,4,24,39,15,23,5,-20,35,Minister,Dion,,org,PROPN,PROPN,appos,pobj,NNP,NNP,5,1
3132,1758.0,28,is,1,1,23,22,0,4,0,22,Glittertind,Sandvik,org,,NOUN,PROPN,nsubj,dobj,NN,NNP,4,1
3133,1759.0,18,became,1,1,8,7,0,9,0,7,He,Serbian Royal Academy,,org-org-org,PRON,PROPN-PROPN-PROPN,nsubj,compound-compound-pobj,PRP,NNP-NNP-NNP,4,1
3134,1760.0,45,raised,8,3,15,12,2,29,5,7,George Canning,United Kingdom,-,per-per,PROPN-PROPN,PROPN-PROPN,compound-poss,compound-pobj,NNP-NNP,NNP-NNP,7,1
3135,1761.0,31,caps,2,10,24,14,9,6,-8,22,Indonesia,Megawati Sukarnoputri,,org-org,PROPN,PROPN-PROPN,pobj,compound-nsubj,NNP,NNP-NNP,6,1
3136,13718.0,31,said,28,1,6,5,0,24,27,-22,Indonesia,Megawati Sukarnoputri,,per-per,PROPN,PROPN-PROPN,poss,compound-appos,NNP,NNP-NNP,3,1
3137,1762.0,22,is,2,1,20,19,0,1,1,18,Joe Griffo,Rome,per-per,,PROPN-PROPN,PROPN,compound-nsubj,compound,NNP-NNP,NNP,4,1
3138,1763.0,22,carried,9,8,8,0,7,13,1,-1,Alabama,Alabama Army National Guard,per,---,PROPN,PROPN-PROPN-PROPN-PROPN,pobj,compound-compound-compound-pobj,NNP,NNP-NNP-NNP-NNP,0,1
3139,1764.0,18,lived,13,3,10,7,2,7,10,-3,Norman,California,org,,PROPN,PROPN,poss,pobj,NNP,NNP,5,1
3140,1765.0,91,Truccolo,34,54,58,4,53,32,-20,24,German Aerospace Center,DLR,per-per-per,,PROPN-PROPN-PROPN,PROPN,nmod-nmod-nmod,conj,NNP-NNP-NNP,NNP,6,1
3141,7569.0,33,provided,16,11,15,4,10,17,5,-1,German Aerospace Center,DLR,per-per-per,,PROPN-PROPN-PROPN,PROPN,compound-compound-conj,appos,NNP-NNP-NNP,NNP,2,1
3142,1766.0,22,continues,1,3,9,6,2,12,-2,8,Merzbow,Important,per,,PROPN,PROPN,poss,compound,NNP,NNP,4,1
3143,1767.0,46,Isakov,2,19,30,11,18,15,-17,28,Soviet Navy,USSR,org-org,,PROPN-PROPN,PROPN,compound-compound,compound,NNP-NNP,NNP,3,1
3144,1768.0,26,began,3,12,19,7,11,6,-9,16,Melbourne,Roy Grounds,,per-per,PROPN,PROPN-PROPN,pobj,compound-pobj,NNP,NNP-NNP,5,1
3145,1769.0,29,signed,6,9,27,18,8,1,-3,21,ABC,James Gang,,org-org,PROPN,PROPN-PROPN,compound,compound-conj,NNP,NNP-NNP,4,1
3146,1770.0,15,H?,0,1,8,7,0,6,-1,8,H? Mi,of Vietn,org-org,-,NOUN-PROPN,ADP-PROPN,ROOT-aux,prep-pobj,NN-NNP,IN-NNP,-1,1
3147,1771.0,36,said,12,1,5,4,0,30,11,-7,Safaricom,Michael Joseph,per,-,PROPN,PROPN-PROPN,compound,compound-nsubj,NNP,NNP-NNP,2,1
3148,1772.0,41,bought,9,1,7,6,0,33,8,-2,Joseph Hardy,84 Lumber,per-per,-,PROPN-PROPN,NUM-PROPN,compound-compound,nummod-compound,NNP-NNP,CD-NNP,5,1
3149,1773.0,45,reported,30,40,41,1,39,3,-10,11,Senthil,Pandayan C.,,per-per,PROPN,PROPN-PROPN,compound,compound-dobj,NNP,NNP-NNP,1,1
3150,1774.0,36,was,3,1,6,5,0,29,2,3,Robert Lees,United States,per-per,-,PROPN-PROPN,PROPN-PROPN,compound-compound,nmod-nmod,NNP-NNP,NNP-NNP,4,1
3151,7829.0,32,included,2,4,29,25,3,2,-2,27,Robert Lees,United States,org-org,-,PROPN-PROPN,PROPN-PROPN,compound-dobj,compound-compound,NNP-NNP,NNP-NNP,10,1
3152,1775.0,37,held,7,7,16,9,6,20,0,9,Clark,Opposition,,org,PROPN,PROPN,nsubj,compound,NNP,NNP,6,1
3153,1889.0,38,challenged,16,16,33,17,15,4,0,17,Clark,Opposition,org,,PROPN,PROPN,nsubj,pobj,NNP,NNP,2,1
3154,7449.0,25,challenged,9,9,24,15,8,0,0,15,Clark,Opposition,org,,PROPN,PROPN,pobj,pobj,NNP,NNP,6,1
3155,1776.0,25,said,7,5,18,13,4,6,2,11,Liaquat Ali Khan,Pakistan,per-per-per,,PROPN-PROPN-PROPN,PROPN,compound-compound-appos,compound,NNP-NNP-NNP,NNP,6,1
3156,2560.0,21,buried,17,2,10,8,1,10,15,-7,Liaquat Ali Khan,Pakistan,--,org,PROPN-PROPN-PROPN,PROPN,compound-compound-nsubjpass,pobj,NNP-NNP-NNP,NNP,5,1
3157,11406.0,21,situated,10,2,20,18,1,0,8,10,Liaquat Ali Khan,Pakistan,per-per-per,,PROPN-PROPN-PROPN,PROPN,compound-compound-compound,pobj,NNP-NNP-NNP,NNP,8,1
3158,1777.0,33,is,13,11,28,17,10,4,2,15,Helsinki,University of Helsinki,org,--,PROPN,PROPN-ADP-PROPN,compound,pobj-prep-pobj,NNP,NNP-IN-NNP,11,1
3159,1778.0,42,obtained,1,16,21,5,15,20,-15,20,National Technical University of Athens,Greece,per-per-per-per-per,,PROPN-PROPN-PROPN-ADP-PROPN,PROPN,compound-nmod-nmod-prep-pobj,poss,NNP-NNP-NNP-IN-NNP,NNP,2,1
3160,1779.0,35,After,0,16,34,18,15,0,-16,34,Streamline Pictures,1988,-,org,PROPN-PROPN,NUM,compound-pobj,pobj,NNP-NNP,CD,6,1
3161,1780.0,28,Attack,2,9,1,-8,8,26,-7,-1,HMLAT-303,Marine Corps Base Camp Pendleton,,per-per-per-per-per,NUM,PROPN-PROPN-PROPN-PROPN-PROPN,appos,compound-compound-compound-compound-compound,CD,NNP-NNP-NNP-NNP-NNP,5,1
3162,1781.0,22,is,2,16,18,2,15,3,-14,16,Missouri,David Rice Atchison,,per-per-per,PROPN,PROPN-PROPN-PROPN,compound,compound-compound-pobj,NNP,NNP-NNP-NNP,2,1
3163,1782.0,38,controls,2,12,28,16,11,9,-10,26,1727,its,per,,NUM,DET,pobj,poss,CD,PRP$,6,1
3164,1783.0,16,retrieved,11,7,8,1,6,7,4,-3,Qantas,Sydney,org,,PROPN,PROPN,compound,compound,NNP,NNP,1,1
3165,3028.0,35,said,1,3,21,18,2,13,-2,20,Qantas,Sydney,,per,PROPN,PROPN,nsubj,dobj,NNP,NNP,4,1
3166,1784.0,28,In,0,6,11,5,5,16,-6,11,Holy Cross High School,Flushing,---,org,PROPN-PROPN-PROPN-PROPN,VERB,compound-compound-compound-pobj,compound,NNP-NNP-NNP-NNP,VBG,7,1
3167,1785.0,33,Veritas,0,1,18,17,0,14,-1,18,Veritas,2005,per,,PROPN,NUM,ROOT,nummod,NNP,CD,5,1
3168,1786.0,26,citing,7,2,19,17,1,6,5,12,American Federation of Government Employees,AFL-CIO,per-per-per-per-per,,PROPN-PROPN-ADP-PROPN-PROPN,NOUN,compound-nsubj-prep-compound-pobj,pobj,NNP-NNP-IN-NNP-NNP,NN,4,1
3169,1787.0,24,blistered,4,1,3,2,0,20,3,-1,Viacom,Sumner Redstone,per,-,PROPN,PROPN-PROPN,compound,compound-nsubj,NNP,NNP-NNP,1,1
3170,1788.0,26,is,13,1,20,19,0,5,12,7,Amanda Lear,painter,per-per,,PROPN-PROPN,NOUN,compound-nsubj,compound,NNP-NNP,NN,3,1
3171,1789.0,29,was,1,22,25,3,21,3,-21,24,Jeff Bingaman,New Mexico,-,org-org,PROPN-PROPN,PROPN-PROPN,compound-pobj,compound-pobj,NNP-NNP,NNP-NNP,2,1
3172,6908.0,24,are,10,6,9,3,5,14,4,-1,Jeff Bingaman,New Mexico,-,per-per,PROPN-PROPN,PROPN-PROPN,compound-conj,compound-pobj,NNP-NNP,NNP-NNP,2,1
3173,1791.0,37,worked,16,10,27,17,9,9,6,11,Food,Dubstar,org,,PROPN,PROPN,nmod,compound,NNP,NNP,13,1
3174,6113.0,27,continued,2,5,22,17,4,4,-3,20,Food,Dubstar,,per,PROPN,PROPN,dobj,compound,NNP,NNP,7,1
3175,1792.0,50,include,4,10,14,4,9,35,-6,10,composer,Ennio Morricone,,org-org,NOUN,PROPN-PROPN,pobj,compound-conj,NN,NNP-NNP,2,1
3176,6815.0,16,won,9,2,3,1,1,12,7,-6,composer,Ennio Morricone,,per-per,NOUN,PROPN-PROPN,compound,compound-nsubj,NN,NNP-NNP,1,1
3177,1793.0,16,is,3,1,14,13,0,1,2,11,Williamson,United States,,per-per,PROPN,PROPN-PROPN,compound,compound-pobj,NNP,NNP-NNP,5,1
3178,13585.0,22,is,9,9,15,6,8,6,0,6,Williamson,United States,per,-,PROPN,PROPN-PROPN,pobj,compound-compound,NNP,NNP-NNP,2,1
3179,1794.0,45,owned,3,16,33,17,15,11,-13,30,Alticor,Gurwitch Products,,org-org,PROPN,PROPN-PROPN,pobj,compound-compound,NNP,NNP-NNPS,8,1
3180,1795.0,18,born,2,7,13,6,6,4,-5,11,England,Sybil Thorndike,org,-,PROPN,PROPN-PROPN,pobj,compound-appos,NNP,NNP-NNP,2,1
3181,1796.0,45,heard,7,27,32,5,26,12,-20,25,36th Division,Army,org-org,,ADJ-PROPN,PROPN,amod-appos,appos,JJ-NNP,NNP,1,1
3182,1798.0,34,said,4,8,10,2,7,23,-4,6,Chile,LAN Airlines,org,-,PROPN,PROPN-PROPN,poss,compound-nsubj,NNP,NNP-NNPS,2,1
3183,1799.0,46,announced,5,3,7,4,2,38,2,2,Alberto R. Gonzales,his,org-org-org,,PROPN-PROPN-PROPN,DET,compound-compound-nsubj,poss,NNP-NNP-NNP,PRP$,3,1
3184,13506.0,40,said,2,19,38,19,18,1,-17,36,Alberto R. Gonzales,his,--,org,PROPN-PROPN-PROPN,DET,compound-compound-pobj,poss,NNP-NNP-NNP,PRP$,11,1
3185,1800.0,93,jpg,0,85,87,2,84,5,-85,87,Philip Schuyler,Albany,org-org,,PROPN-PROPN,PROPN,compound-compound,compound,NNP-NNP,NNP,4,1
3186,1801.0,14,attended,9,5,7,2,4,6,4,-2,Rwanda,Bernard Makuza,per,-,PROPN,PROPN-PROPN,pobj,compound-nsubj,NNP,NNP-NNP,1,1
3187,6395.0,15,was,8,6,7,1,5,7,2,-1,Rwanda,Bernard Makuza,,per-per,PROPN,PROPN-PROPN,compound,compound-pobj,NNP,NNP-NNP,1,1
3188,8774.0,49,attended,23,28,31,3,27,17,-5,8,Rwanda,Bernard Makuza,org,-,PROPN,PROPN-PROPN,compound,compound-nsubj,NNP,NNP-NNP,2,1
3189,1802.0,24,conducted,1,13,18,5,12,5,-12,17,Treasury,Donald Regan,per,-,PROPN,PROPN-PROPN,pobj,compound-appos,NNP,NNP-NNP,5,1
3190,8085.0,48,joined,1,15,24,9,14,23,-14,23,Treasury,Donald Regan,per,-,PROPN,PROPN-PROPN,pobj,compound-poss,NNP,NNP-NNP,4,1
3191,8762.0,38,shook,5,23,28,5,22,9,-18,23,Treasury,Donald Regan,,per-per,PROPN,PROPN-PROPN,pobj,compound-dobj,NNP,NNP-NNP,3,1
3192,1803.0,40,had,14,2,8,6,1,31,12,-6,Larry Page,Google,per-per,,PROPN-PROPN,PROPN,compound-nsubj,compound,NNP-NNP,NNP,2,1
3193,7705.0,48,help,37,2,17,15,1,30,35,-20,Larry Page,Google,per-per,,PROPN-PROPN,PROPN,compound-nsubj,dobj,NNP-NNP,NNP,3,1
3194,1804.0,31,told,8,5,7,2,4,23,3,-1,Colorado,Gary Smith,,per-per,PROPN,PROPN-PROPN,compound,compound-nsubj,NNP,NNP-NNP,3,1
3195,1805.0,30,laid,4,13,27,14,12,2,-9,23,New Jersey,Standard Oil,-,per-per,PROPN-PROPN,PROPN-PROPN,compound-pobj,compound-compound,NNP-NNP,NNP-NNP,7,1
3196,1806.0,32,was,7,15,22,7,14,9,-8,15,Billy Hughes,Australia,per-per,,PROPN-PROPN,PROPN,compound-pobj,pobj,NNP-NNP,NNP,2,1
3197,1952.0,28,was,1,12,19,7,11,8,-11,18,Billy Hughes,Australia,-,per,PROPN-PROPN,PROPN,compound-pobj,pobj,NNP-NNP,NNP,2,1
3198,1807.0,30,left,1,15,18,3,14,11,-14,17,McMaster University,Hamilton,org-org,,PROPN-PROPN,PROPN,compound-pobj,compound,NNP-NNP,NNP,2,1
3199,10787.0,19,graduated,3,6,9,3,5,9,-3,6,McMaster University,Hamilton,-,org,PROPN-PROPN,PROPN,compound-pobj,compound,NNP-NNP,NNP,2,1
3200,1808.0,19,is,5,8,13,5,7,5,-3,8,Bogdan Raczynski,Rephlex,-,per,PROPN-PROPN,PROPN,compound-compound,pobj,NNP-NNP,NNP,1,1
3201,1810.0,35,inspired,6,9,21,12,8,13,-3,15,Vega,New York,,per-per,PROPN,PROPN-PROPN,poss,compound-compound,NNP,NNP-NNP,8,1
3202,1811.0,28,is,15,2,15,13,1,12,13,0,Michael,Lal,,org,PROPN,PROPN,nsubj,nsubj,NNP,NNP,3,1
3203,1812.0,34,Dr,5,14,15,1,13,18,-9,10,Maldives,Maumoon Abdul Gayoom,,per-per-per,PROPN,PROPN-PROPN-PROPN,compound,compound-compound-pobj,NNP,NNP-NNP-NNP,2,1
3204,3532.0,19,visited,8,11,16,5,10,2,-3,8,Maldives,Maumoon Abdul Gayoom,org,--,PROPN,PROPN-PROPN-PROPN,dobj,compound-compound-pobj,NNPS,NNP-NNP-NNP,5,1
3205,4763.0,35,signed,7,7,24,17,6,10,0,17,Maldives,Maumoon Abdul Gayoom,,org-org-org,PROPN,PROPN-PROPN-PROPN,conj,compound-compound-pobj,NNP,NNP-NNP-NNP,4,1
3206,6922.0,32,goes,7,7,26,19,6,5,0,19,Maldives,Maumoon Abdul Gayoom,per,--,PROPN,PROPN-PROPN-PROPN,pobj,compound-compound-pobj,NNPS,NNP-NNP-NNP,4,1
3207,7008.0,28,became,10,9,25,16,8,2,1,15,Maldives,Maumoon Abdul Gayoom,,org-org-org,PROPN,PROPN-PROPN-PROPN,compound,compound-compound-pobj,NNP,NNP-NNP-NNP,10,1
3208,10097.0,37,sworn,10,15,23,8,14,13,-5,13,Maldives,Maumoon Abdul Gayoom,per,--,PROPN,PROPN-PROPN-PROPN,poss,compound-compound-dobj,NNPS,NNP-NNP-NNP,8,1
3209,10739.0,25,signed,6,1,3,2,0,21,5,-3,Maldives,Maumoon Abdul Gayoom,per,--,PROPN,PROPN-PROPN-PROPN,compound,compound-compound-nsubj,NNP,NNP-NNP-NNP,2,1
3210,12384.0,42,MALE,0,23,30,7,22,11,-23,30,Maldives,Maumoon Abdul Gayoom,,per-per-per,PROPN,PROPN-PROPN-PROPN,pobj,compound-compound-appos,NNPS,NNP-NNP-NNP,7,1
3211,12781.0,38,said,34,2,18,16,1,19,32,-16,Maldives,Maumoon Abdul Gayoom,org,--,PROPN,PROPN-PROPN-PROPN,nsubj,compound-compound-nsubj,NNPS,NNP-NNP-NNP,6,1
3212,13156.0,43,declared,26,21,24,3,20,18,5,-2,Maldives,Maumoon Abdul Gayoom,,org-org-org,PROPN,PROPN-PROPN-PROPN,compound,compound-compound-nsubj,NNP,NNP-NNP-NNP,3,1
3213,1813.0,32,Opening,0,16,28,12,15,3,-16,28,Derek Bailey,England,per-per,,PROPN-PROPN,PROPN,compound-appos,conj,NNP-NNP,NNP,-1,1
3214,1814.0,34,had,3,18,20,2,17,13,-15,17,Slovenia,Adria Airways,,per-per,PROPN,PROPN-PROPN,poss,compound-compound,NNP,NNP-NNP,3,1
3215,1815.0,27,was,6,3,5,2,2,21,3,-1,General Manager,Theo Epstein,-,per-per,PROPN-PROPN,PROPN-PROPN,compound-compound,compound-nsubj,NNP-NNP,NNP-NNP,1,1
3216,4162.0,28,lauded,6,3,5,2,2,22,3,-1,General Manager,Theo Epstein,-,org-org,PROPN-PROPN,PROPN-PROPN,compound-compound,compound-nsubj,NNP-NNP,NNP-NNP,1,1
3217,7757.0,20,said,18,15,17,2,14,2,3,-1,General Manager,Theo Epstein,-,org-org,PROPN-PROPN,PROPN-PROPN,compound-compound,compound-nsubj,NNP-NNP,NNP-NNP,1,1
3218,8669.0,26,said,24,21,23,2,20,2,3,-1,General Manager,Theo Epstein,org-org,-,PROPN-PROPN,PROPN-PROPN,compound-compound,compound-nsubj,NNP-NNP,NNP-NNP,3,1
3219,1816.0,23,is,3,2,16,14,1,6,1,13,Kitty Girls,Manila,-,org,PROPN-PROPN,PROPN,compound-nsubj,pobj,NNP-NNP,NNP,4,1
3220,1817.0,66,Hosted,0,42,62,20,41,3,-42,62,o Randy Jackso,e United State,org-org-org,--,X-PROPN-PROPN,PROPN-PROPN-PROPN,intj-compound-compound,compound-compound-compound,XX-NNP-NNP,NNP-NNP-NNP,6,1
3221,1818.0,26,is,10,2,6,4,1,19,8,-4,Maharaja Sayajirao University of Baroda,Baroda,----,org,PROPN-PROPN-PROPN-ADP-PROPN,PROPN,compound-compound-nsubj-prep-pobj,appos,NNP-NNP-NNP-IN-NNP,NNP,3,1
3222,1819.0,38,is,3,25,36,11,24,1,-22,33,United States Naval Special Warfare Development Group,DEVGRU,per-per-per-per-per-per-per,,PROPN-PROPN-PROPN-PROPN-PROPN-PROPN-PROPN,PROPN,compound-compound-compound-compound-compound-compound-conj,appos,NNP-NNP-NNP-NNP-NNP-NNP-NNP,NNP,2,1
3223,1820.0,50,making,1,38,41,3,37,8,-37,40,Hume Cronyn,Jessica Tandy,org-org,-,PROPN-PROPN,PROPN-PROPN,compound-conj,compound-compound,NNP-NNP,NNP-NNP,-1,1
3224,3651.0,85,presented,8,28,31,3,27,53,-20,23,Hume Cronyn,Jessica Tandy,-,org-org,PROPN-PROPN,PROPN-PROPN,compound-appos,compound-conj,NNP-NNP,NNP-NNP,1,1
3225,1821.0,34,ran,1,22,23,1,21,10,-21,22,comedian,Roy Walker,per,-,NOUN,PROPN-PROPN,compound,compound-pobj,NN,NNP-NNP,1,1
3226,1822.0,21,continued,5,4,14,10,3,6,1,9,Canada,Schulich School of Music,per,---,PROPN,PROPN-PROPN-ADP-PROPN,compound,compound-pobj-prep-pobj,NNP,NNP-NNP-IN-NNP,6,1
3227,1823.0,35,are,1,10,25,15,9,9,-9,24,Pakatan Rakyat,Malaysia,per-per,,PROPN-PROPN,PROPN,compound-pobj,pobj,NNP-NNP,NNP,2,1
3228,3072.0,69,vows,3,2,47,45,1,21,1,44,Pakatan Rakyat,Malaysia,org-org,,PROPN-PROPN,PROPN,compound-nsubj,poss,NNP-NNP,NNP,6,1
3229,1824.0,32,became,19,6,21,15,5,10,13,2,Twisted Sister,Atlantic,-,per,PROPN-PROPN,PROPN,compound-compound,poss,NNP-NNP,NNP,12,1
3230,1825.0,20,is,13,1,17,16,0,2,12,4,Ivan Roudyk,Russian,-,per,PROPN-PROPN,ADJ,compound-nsubj,amod,NNP-NNP,JJ,3,1
3231,1826.0,39,put,17,7,16,9,6,22,10,-1,Iran,Qazi Muhammad,per,-,PROPN,PROPN-PROPN,nmod,compound-pobj,NNP,NNP-NNP,5,1
3232,1827.0,33,broke,6,5,26,21,4,6,1,20,Solomon Bandaranaike,Sri Lanka Freedom Party,-,org-org-org-org,PROPN-PROPN,PROPN-PROPN-PROPN-PROPN,compound-nsubj,compound-compound-compound-appos,NNP-NNP,NNP-NNP-NNP-NNP,5,1
3233,1828.0,46,proved,1,13,21,8,12,24,-12,20,William,Charlotte of Mecklenburg-Strelitz,,per-per-per,PROPN,PROPN-ADP-PROPN,compound,dobj-prep-pobj,NNP,NNP-IN-NNP,7,1
3234,1829.0,34,belong,27,19,33,14,18,0,8,6,Gerhard Richter,Dresden,per-per,,PROPN-PROPN,PROPN,compound-compound,pobj,NNP-NNP,NNP,6,1
3235,1830.0,39,has,23,2,13,11,1,25,21,-10,University of Chicago,1890,per-per-per,,PROPN-ADP-PROPN,NUM,nsubj-prep-pobj,pobj,NNP-IN-NNP,CD,6,1
3236,1831.0,77,grew,5,14,25,11,13,51,-9,20,Patrick Loubert,Nelvana,org-org,,PROPN-PROPN,PROPN,compound-nsubj,nsubj,NNP-NNP,NNP,1,1
3237,1833.0,33,Records,0,12,18,6,11,14,-12,18,National Archives and Records Administration,NARA,----,per,PROPN-PROPN-CCONJ-PROPN-PROPN,PROPN,nmod-conj-cc-compound-conj,parataxis,NNP-NNPS-CC-NNPS-NNP,NNP,2,1
3238,1834.0,28,returned,16,14,15,1,13,12,2,-1,Macedonia,Branko Crvenkovski,,per-per,PROPN,PROPN-PROPN,compound,compound-pobj,NNP,NNP-NNP,1,1
3239,1908.0,64,are,16,30,31,1,29,32,-14,15,Macedonia,Branko Crvenkovski,,per-per,PROPN,PROPN-PROPN,compound,compound-pobj,NNP,NNP-NNP,1,1
3240,6835.0,80,President,2,8,14,6,7,65,-6,12,Macedonia,Branko Crvenkovski,,org-org,PROPN,PROPN-PROPN,pobj,compound-nsubj,NNP,NNP-NNP,3,1
3241,14259.0,49,asked,26,5,6,1,4,42,21,-20,Macedonia,Branko Crvenkovski,,per-per,PROPN,PROPN-PROPN,compound,compound-pobj,NNP,NNP-NNP,1,1
3242,1835.0,36,supports,14,1,5,4,0,30,13,-9,Jim DeMint,South Carolina,-,org-org,PROPN-PROPN,PROPN-PROPN,compound-nsubj,compound-poss,NNP-NNP,NNP-NNP,4,1
3243,7294.0,32,endorsed,16,12,15,3,11,16,4,-1,Jim DeMint,South Carolina,org-org,-,PROPN-PROPN,PROPN-PROPN,compound-conj,compound-pobj,NNP-NNP,NNP-NNP,4,1
3244,7397.0,42,blocked,23,13,16,3,12,25,10,-7,Jim DeMint,South Carolina,-,org-org,PROPN-PROPN,PROPN-PROPN,compound-pobj,compound-pobj,NNP-NNP,NNP-NNP,2,1
3245,13248.0,18,ask,1,4,7,3,3,10,-3,6,Jim DeMint,South Carolina,per-per,-,PROPN-PROPN,PROPN-PROPN,compound-dobj,compound-pobj,NNP-NNP,NNP-NNP,2,1
3246,1836.0,39,debut,8,7,11,4,6,27,1,3,Liga I,Steaua,-,org,PROPN-PRON,PROPN,pobj-nsubj,pobj,NNP-PRP,NNP,2,1
3247,1837.0,40,is,9,1,18,17,0,21,8,9,Craig L. Rice,Montgomery County,--,org-org,PROPN-PROPN-PROPN,PROPN-PROPN,compound-compound-nsubj,compound-compound,NNP-NNP-NNP,NNP-NNP,7,1
3248,1838.0,37,told,12,27,29,2,26,7,-15,17,Prime Minister,Pakalitha Mosisili,per-per,-,PROPN-PROPN,PROPN-PROPN,compound-compound,compound-pobj,NNP-NNP,NNP-NNP,2,1
3249,3731.0,41,conveyed,6,14,16,2,13,24,-8,10,Prime Minister,Pakalitha Mosisili,-,org-org,PROPN-PROPN,PROPN-PROPN,compound-compound,compound-pobj,NNP-NNP,NNP-NNP,2,1
3250,1839.0,18,attended,1,3,3,0,2,14,-2,2,Warrensburg High School,Warrensburg,--,per,PROPN-PROPN-PROPN,PROPN,compound-compound-dobj,compound,NNP-NNP-NNP,NNP,0,1
3251,1840.0,26,Markham,2,6,24,18,5,1,-4,22,Florida International University College of Law,United States,per-per-per-per-per-per,-,PROPN-PROPN-PROPN-PROPN-ADP-PROPN,PROPN-PROPN,compound-compound-compound-pobj-prep-pobj,compound-pobj,NNP-NNP-NNP-NNP-IN-NNP,NNP-NNP,9,1
3252,1841.0,29,is,1,5,7,2,4,21,-4,6,AFGE,John Gage,,per-per,PROPN,PROPN-PROPN,compound,compound-nsubj,NNP,NNP-NNP,1,1
3253,1843.0,84,established,3,2,17,15,1,66,1,14,GCRTA,Cleveland Transit System,org,--,PROPN,PROPN-PROPN-PROPN,nsubjpass,compound-compound-pobj,NNP,NNP-NNP-NNP,6,1
3254,1844.0,46,plans,10,1,3,2,0,42,9,-7,Dodd,Connecticut,,org,VERB,PROPN,nsubj,compound,VB,NNP,1,1
3255,1845.0,39,drafted,16,18,22,4,17,16,-2,6,O'Keefe,The Dee Jays,org,--,PROPN,DET-PROPN-PROPN,dobj,det-compound-appos,NNP,DT-NNP-NNPS,4,1
3256,1846.0,77,Examiner,2,1,34,33,0,42,1,32,The Washington Examiner,2005,org-org-org,,DET-PROPN-PROPN,NUM,det-compound-ROOT,nummod,DT-NNP-NNP,CD,-1,1
3257,1847.0,33,was,18,13,18,5,12,14,5,0,University of St Andrews,Scotland,---,per,PROPN-ADP-PROPN-PROPN,PROPN,nmod-prep-pobj-pobj,pobj,NNP-IN-NNP-NNP,NNP,10,1
3258,1848.0,32,became,16,3,14,11,2,17,13,-2,Cummins,Indiana,per,,PROPN,PROPN,nsubj,compound,NNP,NNP,2,1
3259,1849.0,19,moved,5,8,15,7,7,3,-3,10,San Francisco,Academy of Art University,per-per,---,PROPN-PROPN,PROPN-ADP-PROPN-PROPN,compound-compound,dobj-prep-compound-pobj,NNP-NNP,NNP-IN-NNP-NNP,4,1
3260,1850.0,18,broken,2,1,8,7,0,9,1,6,GDOT,Georgia,per,,PROPN,PROPN,nsubj,pobj,NNP,NNP,2,1
3261,1851.0,31,is,14,27,29,2,26,1,-13,15,Louisiana,Clifton Chenier,,per-per,PROPN,PROPN-PROPN,compound,compound-pobj,NNP,NNP-NNP,1,1
3262,1852.0,43,was,11,23,35,12,22,7,-12,24,Rashtriya Indian Military College,Prince of Wales,org-org-org-org,--,PROPN-PROPN-PROPN-PROPN,PROPN-ADP-PROPN,compound-compound-compound-pobj,nmod-prep-pobj,NNP-NNP-NNP-NNP,NNP-IN-NNP,9,1
3263,1853.0,43,joined,3,22,36,14,21,6,-19,33,Reprise,Bing Crosby,org,-,PROPN,PROPN-PROPN,compound,compound-compound,NNP,NNP-NNP,6,1
3264,1854.0,24,is,2,6,21,15,5,2,-4,19,Kenya,Daniel arap Moi,org,--,PROPN,PROPN-NOUN-PROPN,nsubj,compound-compound-appos,NNP,NNP-NN-NNP,6,1
3265,1855.0,22,Watson,6,1,6,5,0,15,5,0,Scott,Sandy Watson,per,-,PROPN,PROPN-PROPN,nsubj,compound-ROOT,NNP,NNP-NNP,3,1
3266,1856.0,44,was,8,1,18,17,0,25,7,10,Len Smith,Melbourne,org-org,,PROPN-PROPN,PROPN,compound-nsubj,compound,NNP-NNP,NNP,6,1
3267,1858.0,19,founded,4,2,7,5,1,11,2,3,Creditanstalt,1855,per,,PROPN,NUM,nsubjpass,pobj,NNP,CD,3,1
3268,1859.0,27,was,4,17,16,-1,16,10,-13,12,Blackstone Group,the Weather Channel,org-org,--,PROPN-PROPN,DET-PROPN-PROPN,compound-conj,det-compound-pobj,NNP-NNP,DT-NNP-NNP,2,1
3269,1860.0,26,overseen,2,8,14,6,7,11,-6,12,GM,Buick,org,,PROPN,PROPN,compound,nmod,NNP,NNP,2,1
3270,1861.0,44,seen,2,5,20,15,4,23,-3,18,British National Party,Nick Griffin,per-per-per,-,PROPN-PROPN-PROPN,PROPN-PROPN,compound-compound-nsubj,compound-compound,NNP-NNP-NNP,NNP-NNP,5,1
3271,1862.0,22,held,4,1,12,11,0,9,3,8,Fujimori,Lima,,org,PROPN,PROPN,nsubjpass,pobj,NNP,NNP,4,1
3272,1863.0,43,Friedrich,1,2,33,31,1,9,-1,32,Friedrich Kaufmann,Orange Free State,org-org,--,PROPN-PROPN,PROPN-PROPN-PROPN,compound-nmod,compound-compound-pobj,NNP-NNP,NNP-NNP-NNP,5,1
3273,1864.0,39,was,8,11,2,-9,10,36,-3,-6,U.S. Army Tank-Automotive and Armaments Command,Stratford,-----,per,PROPN-PROPN-PROPN-CCONJ-PROPN-PROPN,PROPN,nmod-compound-nmod-cc-compound-conj,compound,NNP-NNP-NNP-CC-NNPS-NNP,NNP,5,1
3274,1865.0,30,Kirakosyan,0,13,15,2,12,14,-13,15,British,Carl Johanneson,org,-,ADJ,PROPN-PROPN,amod,compound-nsubj,JJ,NNP-NNP,1,1
3275,1866.0,29,made,4,14,20,6,13,8,-10,16,Daphne Oram,BBC Radiophonic Workshop,-,per-per-per,PROPN-PROPN,PROPN-PROPN-PROPN,compound-pobj,compound-compound-pobj,NNP-NNP,NNP-NNP-NNP,4,1
3276,1867.0,35,purchased,9,12,34,22,11,0,-3,25,Golden West Network,Albany,--,per,PROPN-PROPN-PROPN,PROPN,compound-compound-dative,conj,NNP-NNP-NNP,NNP,5,1
3277,1868.0,36,appointed,2,9,31,22,8,4,-7,29,Rafael Correa,Ecuador,per-per,,PROPN-PROPN,PROPN,compound-pobj,poss,NNP-NNP,NNP,13,1
3278,2920.0,42,stated,8,7,23,16,6,18,1,15,Rafael Correa,Ecuador,per-per,,PROPN-PROPN,PROPN,compound-appos,nsubj,NNP-NNP,NNP,5,1
3279,5276.0,29,is,6,5,19,14,4,9,1,13,Rafael Correa,Ecuador,-,per,PROPN-PROPN,PROPN,compound-pobj,pobj,NNP-NNP,NNP,5,1
3280,5347.0,39,blamed,13,12,15,3,11,23,1,2,Rafael Correa,Ecuador,-,org,PROPN-PROPN,PROPN,compound-nsubj,poss,NNP-NNP,NNP,4,1
3281,7084.0,30,came,2,7,11,4,6,18,-5,9,Rafael Correa,Ecuador,per-per,,PROPN-PROPN,PROPN,compound-nsubj,dobj,NNP-NNP,NNP,4,1
3282,8544.0,16,says,3,2,5,3,1,10,1,2,Rafael Correa,Ecuador,per-per,,PROPN-PROPN,PROPN,compound-nsubj,nsubj,NNP-NNP,NNP,3,1
3283,8756.0,11,sworn,4,2,10,8,1,0,2,6,Rafael Correa,Ecuador,per-per,,PROPN-PROPN,PROPN,compound-nsubjpass,pobj,NNP-NNP,NNP,2,1
3284,8837.0,29,says,3,2,5,3,1,23,1,2,Rafael Correa,Ecuador,per-per,,PROPN-PROPN,PROPN,compound-nsubj,nsubj,NNP-NNP,NNP,3,1
3285,8885.0,53,passed,17,37,45,8,36,7,-20,28,Rafael Correa,Ecuador,-,org,PROPN-PROPN,PROPN,compound-pobj,compound,NNP-NNP,NNP,9,1
3286,9813.0,30,meet,8,13,26,13,12,3,-5,18,Rafael Correa,Ecuador,-,org,PROPN-PROPN,PROPN,compound-appos,compound,NNP-NNP,NNP,11,1
3287,11136.0,26,staying,21,6,9,3,5,16,15,-12,Rafael Correa,Ecuador,org-org,,PROPN-PROPN,PROPN,compound-pobj,pobj,NNP-NNP,NNP,1,1
3288,11821.0,19,says,3,2,5,3,1,13,1,2,Rafael Correa,Ecuador,-,org,PROPN-PROPN,PROPN,compound-nsubj,nsubj,NNP-NNP,NNP,3,1
3289,11995.0,28,advised,19,1,7,6,0,20,18,-12,Rafael Correa,Ecuador,-,per,PROPN-PROPN,PROPN,compound-nsubjpass,pobj,NNP-NNP,NNP,4,1
3290,12106.0,13,sworn,3,1,7,6,0,5,2,4,Rafael Correa,Ecuador,-,org,PROPN-PROPN,PROPN,compound-nsubjpass,poss,NNP-NNP,NNP,5,1
3291,12196.0,31,said,3,9,20,11,8,10,-6,17,Rafael Correa,Ecuador,per-per,,PROPN-PROPN,PROPN,compound-nsubj,poss,NNP-NNP,NNP,8,1
3292,1869.0,31,remains,2,9,20,11,8,10,-7,18,United States Air Force,96th Air Base Wing,per-per-per-per,---,PROPN-PROPN-PROPN-PROPN,ADJ-PROPN-PROPN-PROPN,compound-compound-compound-pobj,amod-compound-compound-pobj,NNP-NNP-NNP-NNP,JJ-NNP-NNP-NNP,12,1
3293,1870.0,20,dismay,2,1,18,17,0,1,1,16,Williams,American,per,,PROPN,ADJ,nsubj,amod,NNP,JJ,3,1
3294,6210.0,29,caught,3,5,12,7,4,16,-2,9,Williams,American,org,,PROPN,ADJ,dobj,amod,NNP,JJ,3,1
3295,1871.0,39,nearing,7,5,18,13,4,20,2,11,Vivendi,NBC Universal,org,-,PROPN,PROPN-PROPN,compound,compound-pobj,NNP,NNP-NNP,7,1
3296,1872.0,42,are,1,10,13,3,9,28,-9,12,Sydney,University of Western Sydney,org,---,PROPN,PROPN-ADP-PROPN-PROPN,pobj,appos-prep-compound-pobj,NNP,NNP-IN-NNP-NNP,4,1
3297,1874.0,51,is,30,1,20,19,0,30,29,-10,Boston Camera Club,amateur photographer,--,per-per,PROPN-PROPN-PROPN,NOUN-NOUN,nmod-nmod-nmod,amod-appos,NNP-NNP-NNP,NN-NN,5,1
3298,1875.0,27,used,8,20,24,4,19,2,-12,16,Reis,Swami Records,per,-,PROPN,PROPN-PROPN,nmod,compound-compound,NNP,NNP-NNP,3,1
3299,6100.0,31,conducted,6,22,28,6,21,2,-16,22,Reis,Swami Records,,org-org,PROPN,PROPN-PROPN,nsubj,compound-compound,NNP,NNP-NNPS,5,1
3300,8361.0,26,focused,5,5,11,6,4,14,0,6,Reis,Swami Records,per,-,PROPN,PROPN-PROPN,pobj,compound-dobj,NNP,NNP-NNPS,5,1
3301,1877.0,39,included,2,4,10,6,3,28,-2,8,Alexander Bustamante,Jamaica,org-org,,PROPN-PROPN,PROPN,compound-dobj,compound,NNP-NNP,NNP,2,1
3302,4536.0,29,asked,6,20,28,8,19,0,-14,22,Alexander Bustamante,Jamaica,org-org,,PROPN-PROPN,PROPN,compound-pobj,pobj,NNP-NNP,NNP,7,1
3303,8480.0,21,known,5,8,15,7,7,5,-3,10,Alexander Bustamante,Jamaica,per-per,,PROPN-PROPN,PROPN,compound-oprd,nsubjpass,NNP-NNP,NNP,3,1
3304,1878.0,36,was,2,7,14,7,6,21,-5,12,West Publishing,Thomson Reuters,-,per-per,PROPN-PROPN,PROPN-PROPN,compound-compound,compound-pobj,NNP-NNP,NNP-NNP,6,1
3305,1879.0,26,chosen,2,21,18,-3,20,7,-19,16,Julian Casablancas,The Strokes,per-per,-,PROPN-PROPN,DET-PROPN,compound-conj,det-pobj,NNP-NNPS,DT-NNPS,2,1
3306,1880.0,21,held,1,1,8,7,0,12,0,7,Goodrem,Sydney,org,,PROPN,PROPN,nsubj,compound,NNP,NNP,3,1
3307,1882.0,23,represented,8,4,18,14,3,4,4,10,Connecticut Huskies,NCAA,org-org,,PROPN-PROPN,PROPN,nmod-nmod,compound,NNP-NNPS,NNP,5,1
3308,4053.0,23,represented,8,4,18,14,3,4,4,10,Connecticut Huskies,NCAA,org-org,,PROPN-PROPN,PROPN,compound-nmod,compound,NNP-NNP,NNP,6,1
3309,1883.0,63,involves,6,10,2,-8,9,60,-4,-4,Australia,Coles Supermarkets,per,-,PROPN,PROPN-PROPN,ROOT,compound-pobj,NNP,NNP-NNPS,6,1
3310,1884.0,25,include,2,6,11,5,5,13,-4,9,1st Brigade,Army,org-org,,NOUN-PROPN,PROPN,dobj-nmod,ROOT,NN-NNP,NNP,3,1
3311,9039.0,31,is,12,7,23,16,6,7,5,11,1st Brigade,Army,-,org,ADJ-PROPN,PROPN,amod-dobj,compound,JJ-NNP,NNP,-1,1
3312,1885.0,18,is,9,2,4,2,1,13,7,-5,Association of Vatican Lay Workers,Vatican City,----,org-org,PROPN-ADP-PROPN-PROPN-PROPN,PROPN-PROPN,nsubj-prep-compound-compound-pobj,compound-pobj,NNP-IN-NNP-NNP-NNPS,NNP-NNP,2,1
3313,1886.0,62,shortened,27,2,2,0,1,59,25,-25,Monterrey Institute of Technology and Higher Education,Monterrey,------,per,PROPN-PROPN-ADP-PROPN-CCONJ-PROPN-PROPN,PROPN,compound-nsubj-prep-pobj-cc-compound-conj,compound,NNP-NNP-IN-NNP-CC-NNP-NNP,NNP,0,1
3314,8123.0,48,shortened,25,2,2,0,1,45,23,-23,Monterrey Institute of Technology and Higher Education,Monterrey,org-org-org-org-org-org-org,,PROPN-PROPN-ADP-PROPN-CCONJ-PROPN-PROPN,PROPN,compound-nsubj-prep-pobj-cc-compound-conj,compound,NNP-NNP-IN-NNP-CC-NNP-NNP,NNP,0,1
3315,1887.0,28,appears,4,20,25,5,19,2,-16,21,Northwestern Memorial Hospital,Illinois,org-org-org,,PROPN-PROPN-PROPN,PROPN,compound-compound-pobj,compound,NNP-NNP-NNP,NNP,4,1
3316,1888.0,13,was,2,2,12,10,1,0,0,10,winner,Ontario,per,,NOUN,PROPN,nsubj,pobj,NN,NNP,1,1
3317,5682.0,13,was,2,2,12,10,1,0,0,10,winner,Ontario,per,,NOUN,PROPN,nsubj,pobj,NN,NNP,1,1
3318,11342.0,11,was,2,2,8,6,1,2,0,6,winner,Ontario,,per,NOUN,PROPN,nsubj,compound,NN,NNP,4,1
3319,11494.0,11,was,2,2,8,6,1,2,0,6,winner,Ontario,org,,NOUN,PROPN,nsubj,compound,NN,NNP,4,1
3320,1890.0,35,founded,4,1,9,8,0,25,3,5,Rising Son Records,Arlo Guthrie,per-per-per,-,VERB-PROPN-PROPN,PROPN-PROPN,amod-compound-nsubjpass,compound-pobj,VBG-NNP-NNPS,NNP-NNP,4,1
3321,1891.0,26,began,1,1,10,9,0,15,0,9,Underwater,Darren,,org,PROPN,PROPN,nsubj,poss,NNP,NNP,4,1
3322,1892.0,41,Weiller,1,8,10,2,7,30,-7,9,State,Thomas DiNapoli,per,-,PROPN,PROPN-PROPN,compound,compound-pobj,NNP,NNP-NNP,1,1
3323,4420.0,45,tumbled,2,41,43,2,40,1,-39,41,State,Thomas DiNapoli,,per-per,PROPN,PROPN-PROPN,compound,compound-pobj,NNP,NNP-NNP,2,1
3324,11613.0,32,asked,5,10,12,2,9,19,-5,7,State,Thomas DiNapoli,,per-per,PROPN,PROPN-PROPN,compound,compound-nsubj,NNP,NNP-NNP,1,1
3325,14201.0,36,released,15,12,14,2,11,21,3,-1,State,Thomas DiNapoli,org,-,PROPN,PROPN-PROPN,compound,compound-pobj,NNP,NNP-NNP,1,1
3326,1893.0,39,served,3,1,12,11,0,26,2,9,Prem Watsa,Fairfax Financial,per-per,-,PROPN-PROPN,PROPN-PROPN,compound-nsubj,compound-compound,NNP-NNP,NNP-NNP,6,1
3327,1894.0,41,has,2,2,28,26,1,12,0,26,union,Alberta,,org,NOUN,PROPN,nsubj,pobj,NN,NNP,10,1
3328,1895.0,30,said,14,11,13,2,10,16,3,-1,Justice,Angelino Alfano,,org-org,PROPN,PROPN-PROPN,compound,compound-nsubj,NNP,NNP-NNP,1,1
3329,10653.0,28,arrested,2,23,25,2,22,2,-21,23,Justice,Angelino Alfano,org,-,PROPN,PROPN-PROPN,compound,compound-nsubj,NNP,NNP-NNP,1,1
3330,13661.0,30,spoke,4,17,19,2,16,10,-13,15,Justice,Angelino Alfano,,per-per,PROPN,PROPN-PROPN,compound,compound-nsubj,NNP,NNP-NNP,1,1
3331,1896.0,36,began,1,21,8,-13,20,27,-20,7,South Australia,ACD,org-org,,PROPN-PROPN,PROPN,compound-pobj,pobj,NNP-NNP,NNP,5,1
3332,1897.0,56,northwest,3,6,10,4,5,45,-3,7,London,Alan Turing,,org-org,PROPN,PROPN-PROPN,pobj,compound-nsubj,NNP,NNP-NNP,2,1
3333,1898.0,16,stated,2,1,15,14,0,0,1,13,Lisa Gerrard,Australia,org-org,,PROPN-PROPN,PROPN,compound-nsubj,pobj,NNP-NNP,NNP,2,1
3334,7050.0,28,won,6,12,27,15,11,0,-6,21,Lisa Gerrard,Australia,-,org,PROPN-PROPN,PROPN,compound-pobj,pobj,NNP-NNP,NNP,4,1
3335,1899.0,35,testified,13,18,19,1,17,15,-5,6,Minister,Shane Gibson,org,-,PROPN,PROPN-PROPN,compound,compound-nsubj,NNP,NNP-NNP,1,1
3336,1900.0,30,married,18,14,18,4,13,11,4,0,Northfield,Wheaton,org,,PROPN,PROPN,compound,nsubj,NNP,NNP,5,1
3337,1901.0,44,Established,0,18,19,1,17,24,-18,19,Walt Disney Studios,Disney,org-org-org,,PROPN-PROPN-VERB,PROPN,compound-compound-pobj,poss,NNP-NNP-VBZ,NNP,1,1
3338,4542.0,14,is,3,1,2,1,0,11,2,-1,Walt Disney Studios,Disney,org-org-org,,PROPN-PROPN-PROPN,PROPN,compound-compound-nsubj,poss,NNP-NNP-NNPS,NNP,1,1
3339,7922.0,48,is,23,1,2,1,0,45,22,-21,Walt Disney Studios,Disney,per-per-per,,PROPN-PROPN-VERB,PROPN,compound-compound-compound,nsubj,NNP-NNP-VBZ,NNP,2,1
3340,1904.0,26,adopted,18,6,11,5,5,14,12,-7,Charles,Henrietta Maria of France,,per-per-per-per,PROPN,PROPN-PROPN-ADP-PROPN,pobj,compound-pobj-prep-pobj,NNP,NNP-NNP-IN-NNP,5,1
3341,6985.0,27,was,11,17,23,6,16,3,-6,12,Charles,Henrietta Maria of France,,org-org-org-org,PROPN,PROPN-PROPN-ADP-PROPN,compound,compound-conj-prep-pobj,NNP,NNP-NNP-IN-NNP,2,1
3342,11722.0,22,was,1,8,18,10,7,3,-7,17,Charles,Henrietta Maria of France,,org-org-org-org,PROPN,PROPN-PROPN-ADP-PROPN,pobj,compound-appos-prep-pobj,NNP,NNP-NNP-IN-NNP,2,1
3343,13206.0,71,required,17,34,60,26,33,10,-17,43,Charles,Henrietta Maria of France,per,---,PROPN,PROPN-PROPN-ADP-PROPN,nsubjpass,compound-appos-prep-pobj,NNP,NNP-NNP-IN-NNP,12,1
3344,1905.0,39,said,23,1,7,6,0,31,22,-16,Roy Beck,NumbersUSA,-,per,PROPN-PROPN,PROPN,compound-nsubj,pobj,NNP-NNP,NNP,2,1
3345,1906.0,36,worked,16,4,8,4,3,27,12,-8,his,producer,,org,DET,NOUN,poss,pobj,PRP$,NN,3,1
3346,1907.0,24,confirm,14,4,9,5,3,14,10,-5,International Atomic Energy Agency,Mohamed ElBaradei,org-org-org-org,-,PROPN-PROPN-PROPN-PROPN,PROPN-PROPN,nmod-compound-compound-compound,compound-pobj,NNP-NNP-NNP-NNP,NNP-NNP,4,1
3347,1909.0,23,served,2,6,12,6,5,10,-4,10,institute,Technical University of Berlin,,org-org-org-org,NOUN,PROPN-PROPN-ADP-PROPN,pobj,compound-pobj-prep-pobj,NN,NNP-NNP-IN-NNP,5,1
3348,1910.0,21,include,1,11,15,4,10,5,-10,14,Robert Rubin,Treasury,-,per,PROPN-PROPN,PROPN,compound-conj,compound,NNP-NNP,NNP,2,1
3349,2106.0,31,go,3,6,11,5,5,19,-3,8,Robert Rubin,Treasury,per-per,,PROPN-PROPN,PROPN,compound-compound,pobj,NNP-NNP,NNP,4,1
3350,10955.0,13,was,6,5,11,6,4,1,1,5,Robert Rubin,Treasury,per-per,,PROPN-PROPN,PROPN,compound-nsubj,compound,NNP-NNP,NNP,4,1
3351,1911.0,23,is,4,1,4,3,0,18,3,0,HRE,2003,per,,PROPN,NUM,nsubj,pobj,NNP,CD,2,1
3352,1912.0,27,With,0,12,16,4,11,10,-12,16,Alessandri,Liberal,,per,PROPN,PROPN,pobj,compound,NNP,NNP,2,1
3353,1913.0,11,left,1,1,10,9,0,0,0,9,Benton,Missouri,,per,PROPN,PROPN,nsubj,pobj,NNP,NNP,1,1
3354,10478.0,34,made,19,3,11,8,2,22,16,-8,Benton,Missouri,,per,PROPN,PROPN,nsubjpass,compound,NNP,NNP,3,1
3355,1914.0,17,established,6,1,9,8,0,7,5,3,Saint James School of Medicine,Bonaire,----,org,PROPN-PROPN-PROPN-ADP-PROPN,PROPN,compound-compound-nsubjpass-prep-pobj,pobj,NNP-NNP-NNP-IN-NNP,NNP,3,1
3356,1915.0,37,included,2,11,12,1,10,24,-9,10,France,Herriot,per,,PROPN,PROPN,compound,pobj,NNP,NNP,3,1
3357,12079.0,34,was,1,5,24,19,4,9,-4,23,France,Herriot,per,,PROPN,PROPN,pobj,appos,NNP,NNP,5,1
3358,1916.0,58,dominate,15,5,7,2,4,50,10,-8,Dirty Deeds,Darren Wyse,per-per,-,PROPN-PROPN,PROPN-PROPN,compound-compound,compound-pobj,NNP-NNP,NNP-NNP,1,1
3359,1917.0,15,was,1,1,7,6,0,7,0,6,Welles,Navy,,per,PROPN,PROPN,nsubj,poss,NNP,NNP,4,1
3360,12883.0,18,Despite,0,4,10,6,3,7,-4,10,Welles,Navy,,org,PROPN,PROPN,poss,dobj,NNP,NNP,4,1
3361,1918.0,32,are,24,9,26,17,8,5,15,2,Brisbane,Dan,,org,PROPN,PROPN,pobj,compound,NNP,NNP,-1,1
3362,1919.0,45,was,15,21,33,12,20,11,-6,18,Tasmania,Bundesliga,per,,PROPN,PROPN,appos,pobj,NNP,NNP,9,1
3363,1920.0,43,has,1,13,35,22,12,7,-12,34,Inverclyde Academy,Scotland,-,per,PROPN-PROPN,PROPN,compound-appos,poss,NNP-NNP,NNP,12,1
3364,3024.0,20,is,2,1,9,8,0,10,1,7,Inverclyde Academy,Scotland,org-org,,PROPN-PROPN,PROPN,compound-nsubj,pobj,NNP-NNP,NNP,4,1
3365,1921.0,29,urged,7,1,5,4,0,23,6,-2,Lockheed Martin,Robert J. Stevens,-,per-per-per,PROPN-PROPN,PROPN-PROPN-PROPN,compound-compound,compound-compound-nsubj,NNP-NNP,NNP-NNP-NNP,4,1
3366,1922.0,32,were,20,6,26,20,5,5,14,6,Paul Weller,The Jam,-,org-org,PROPN-PROPN,DET-PROPN,compound-appos,det-poss,NNP-NNP,DT-NNP,8,1
3367,1923.0,25,chose,17,2,8,6,1,16,15,-9,Tom Petersson,Cheap Trick,per-per,-,PROPN-PROPN,PROPN-PROPN,compound-nsubj,compound-pobj,NNP-NNP,NNP-NNP,3,1
3368,1924.0,24,is,1,1,21,20,0,2,0,20,NewsX,TAM,org,,PROPN,PROPN,nsubj,pobj,NNP,NNP,3,1
3369,1925.0,25,said,17,19,23,4,18,1,-2,6,Mahmoud Zahar,Hamas,per-per,,PROPN-PROPN,PROPN,compound-nsubj,compound,NNP-NNP,NNP,2,1
3370,1926.0,18,finalized,9,1,7,6,0,10,8,-2,Actress Kate,Chris Robinson,per-per,-,PROPN-PROPN,PROPN-PROPN,compound-poss,compound-pobj,NNP-NNP,NNP-NNP,3,1
3371,1929.0,39,are,19,12,38,26,11,0,7,19,Yitzhak Rabin,Israel,-,per,PROPN-PROPN,PROPN,compound-nsubj,pobj,NNP-NNP,NNP,4,1
3372,2752.0,28,are,16,7,25,18,6,2,9,9,Yitzhak Rabin,Israel,per-per,,PROPN-PROPN,PROPN,compound-compound,compound,NNP-NNP,NNP,8,1
3373,3799.0,55,Rabin,1,1,21,20,0,33,0,20,Yitzhak Rabin,Israel,org-org,,PROPN-PROPN,PROPN,compound-ROOT,pobj,NNP-NNP,NNP,6,1
3374,4488.0,33,revealed,10,19,29,10,18,3,-9,19,Yitzhak Rabin,Israel,-,per,PROPN-PROPN,PROPN,compound-pobj,pobj,NNP-NNP,NNP,5,1
3375,5093.0,46,is,4,35,45,10,34,0,-31,41,Yitzhak Rabin,Israel,org-org,,PROPN-PROPN,PROPN,compound-pobj,pobj,NNP-NNP,NNP,10,1
3376,6956.0,27,punished,4,6,23,17,5,3,-2,19,Yitzhak Rabin,Israel,per-per,,PROPN-PROPN,PROPN,compound-poss,poss,NNP-NNP,NNP,10,1
3377,9222.0,70,said,24,14,34,20,13,35,10,10,Yitzhak Rabin,Israel,-,per,PROPN-PROPN,PROPN,compound-pobj,dobj,NNP-NNP,NNP,-1,1
3378,1930.0,30,was,10,1,23,22,0,6,9,13,His,Tangerine Dream,per,-,DET,PROPN-PROPN,poss,compound-nsubj,PRP$,NNP-NNP,9,1
3379,1931.0,26,plays,6,5,10,5,4,15,1,4,club,Northern League,,per-per,NOUN,PROPN-PROPN,nsubj,compound-compound,NN,NNP-NNP,5,1
3380,1932.0,55,were,5,5,8,3,4,46,0,3,Candlebox,Seattle,org,,PROPN,PROPN,pobj,pobj,NNP,NNP,3,1
3381,1933.0,36,founded,4,22,31,9,21,4,-18,27,Queens,Ja Rule,org,-,PROPN,PROPN-PROPN,compound,compound-pobj,NNP,NNP-NNP,5,1
3382,1934.0,13,are,5,1,10,9,0,2,4,5,Marine Atlantic,Newfoundland,org-org,,PROPN-PROPN,PROPN,compound-poss,pobj,NNP-NNP,NNP,4,1
3383,1935.0,34,said,22,22,31,9,21,2,0,9,India,Jawaharlal Nehru,,org-org,PROPN,PROPN-PROPN,conj,compound-compound,NNP,NNP-NNP,12,1
3384,1936.0,21,said,18,14,16,2,13,4,4,-2,Prime Minister,Anders Fogh Rasmussen,per-per,--,PROPN-PROPN,PROPN-PROPN-PROPN,compound-compound,compound-compound-pobj,NNP-NNP,NNP-NNP-NNP,2,1
3385,1937.0,18,sponsored,6,5,14,9,4,3,1,8,Jack Evans,Washington,-,org,PROPN-PROPN,PROPN,compound-nsubj,poss,NNP-NNP,NNP,7,1
3386,9888.0,18,is,10,1,16,15,0,1,9,6,Jack Evans,Washington,-,per,PROPN-PROPN,PROPN,compound-nsubj,compound,NNP-NNP,NNP,4,1
3387,1938.0,22,represented,9,4,12,8,3,9,5,3,Ole Miss Rebels,University of Mississippi,--,org-org-org,PROPN-PROPN-PROPN,PROPN-ADP-PROPN,compound-compound-compound,dobj-prep-pobj,NNP-NNP-NNP,NNP-IN-NNP,5,1
3388,3275.0,22,represented,9,4,12,8,3,9,5,3,Ole Miss Rebels,University of Mississippi,--,per-per-per,PROPN-PROPN-PROPN,PROPN-ADP-PROPN,compound-compound-compound,dobj-prep-pobj,NNP-NNP-NNP,NNP-IN-NNP,5,1
3389,1939.0,17,include,6,4,10,6,3,6,2,4,Hollywood,Eugene Levy,per,-,PROPN,PROPN-PROPN,pobj,compound-compound,NNP,NNP-NNP,4,1
3390,1940.0,34,banned,8,4,7,3,3,26,4,-1,Italian,Paolo Gentiloni,,per-per,PROPN,PROPN-PROPN,amod,compound-nsubj,NNP,NNP-NNP,2,1
3391,1941.0,38,is,5,1,4,3,0,33,4,-1,ADM,Decatur,,per,PROPN,PROPN,nsubj,compound,NNP,NNP,1,1
3392,1942.0,41,Unconvinced,0,9,12,3,8,28,-9,12,Buchanan,United States,per,-,PROPN,PROPN-PROPN,nsubj,compound-compound,NNP,NNP-NNP,2,1
3393,1943.0,34,is,2,31,33,2,30,0,-29,31,New Orleans,Louisiana,per-per,,PROPN-PROPN,PROPN,compound-compound,pobj,NNP-NNP,NNP,2,1
3394,1944.0,15,lettered,1,9,9,0,8,5,-8,8,Middleton High School,Middleton,--,org,PROPN-PROPN-PROPN,PROPN,compound-compound-pobj,compound,NNP-NNP-NNP,NNP,0,1
3395,1945.0,43,traveled,4,29,30,1,28,12,-25,26,State,Robert Zoellick,org,-,PROPN,PROPN-PROPN,pobj,nmod-nmod,NNP,NNP-NNP,2,1
3396,2060.0,38,issues,21,10,11,1,9,26,11,-10,State,Robert Zoellick,per,-,PROPN,PROPN-PROPN,pobj,compound-pobj,NNP,NNP-NNP,1,1
3397,4351.0,23,emerged,14,5,6,1,4,16,9,-8,State,Robert Zoellick,,per-per,PROPN,PROPN-PROPN,pobj,compound-nsubj,NNP,NNP-NNP,1,1
3398,5569.0,36,told,15,7,8,1,6,27,8,-7,State,Robert Zoellick,per,-,PROPN,PROPN-PROPN,pobj,compound-nsubj,NNP,NNP-NNP,1,1
3399,6329.0,17,met,1,14,15,1,13,1,-13,14,State,Robert Zoellick,per,-,PROPN,PROPN-PROPN,pobj,compound-pobj,NNP,NNP-NNP,1,1
3400,7035.0,23,was,1,9,10,1,8,12,-8,9,State,Robert Zoellick,org,-,PROPN,PROPN-PROPN,pobj,compound-nsubj,NNP,NNP-NNP,1,1
3401,9821.0,20,approved,6,13,14,1,12,5,-7,8,State,Robert Zoellick,,per-per,PROPN,PROPN-PROPN,pobj,compound-dobj,NNP,NNP-NNP,1,1
3402,9963.0,24,resigned,6,4,5,1,3,18,2,-1,State,Robert Zoellick,,org-org,PROPN,PROPN-PROPN,pobj,compound-nsubj,NNP,NNP-NNP,1,1
3403,10776.0,32,stated,8,6,7,1,5,24,2,-1,State,Robert Zoellick,per,-,PROPN,PROPN-PROPN,pobj,compound-nsubj,NNP,NNP-NNP,1,1
3404,1946.0,33,began,3,6,32,26,5,0,-3,29,Tony Kanal,California,-,per,PROPN-PROPN,PROPN,compound-nsubj,pobj,NNP-NNP,NNP,3,1
3405,1947.0,25,received,1,9,10,1,8,14,-8,9,Mexico,Antonio de Santa Anna,org,---,PROPN,PROPN-ADP-PROPN-PROPN,compound,nmod-compound-compound-pobj,NNP,NNP-IN-NNP-NNP,2,1
3406,1948.0,18,is,9,2,17,15,1,0,7,8,Saxby Chambliss,Georgia,-,org,PROPN-PROPN,PROPN,compound-nsubj,pobj,NNP-NNP,NNP,2,1
3407,1950.0,29,found,4,3,25,22,2,3,1,21,he,Indonesia,per,,PRON,PROPN,nsubjpass,pobj,PRP,NNP,12,1
3408,1951.0,38,said,7,11,13,2,10,24,-4,6,Australian,Mike Rann,,org-org,ADJ,PROPN-PROPN,amod,compound-nsubj,JJ,NNP-NNP,1,1
3409,1953.0,18,acquired,1,7,7,0,6,10,-6,6,Malheur Home Telephone Company,Malheur Bell,---,per-per,PROPN-PROPN-PROPN-PROPN,PROPN-PROPN,compound-compound-compound-pobj,compound-pobj,NNP-NNP-NNP-NNP,NNP-NNP,0,1
3410,1954.0,14,turned,9,3,7,4,2,6,6,-2,Harkin,Iowa,org,,PROPN,PROPN,nsubj,compound,NNP,NNP,3,1
3411,1955.0,61,program,8,2,15,13,1,45,6,7,University of Central Florida,UCF Knights,per-per-per-per,-,PROPN-ADP-PROPN-PROPN,PROPN-PROPN,nmod-prep-pobj-compound,compound-nsubj,NNP-IN-NNP-NNP,NNP-NNP,6,1
3412,3112.0,59,program,8,2,15,13,1,43,6,7,University of Central Florida,UCF Knights,---,org-org,PROPN-ADP-PROPN-PROPN,PROPN-PROPN,nmod-prep-pobj-nmod,compound-nsubj,NNP-IN-NNP-NNP,NNP-NNP,6,1
3413,1956.0,49,born,10,18,30,12,17,18,-8,20,Mike Mansfield,Montana,org-org,,PROPN-PROPN,PROPN,compound-nsubj,poss,NNP-NNP,NNP,2,1
3414,4156.0,29,ran,16,6,9,3,5,19,10,-7,Mike Mansfield,Montana,-,org,PROPN-PROPN,PROPN,compound-pobj,pobj,NNP-NNP,NNP,2,1
3415,1957.0,31,become,2,1,24,23,0,6,1,22,She,United States,org,-,PRON,PROPN-PROPN,nsubj,compound-pobj,PRP,NNP-NNP,7,1
3416,1958.0,52,made,3,14,26,12,13,25,-11,23,Parti Keadilan Rakyat,Pakatan Rakyat,--,per-per,PROPN-PROPN-PROPN,PROPN-PROPN,pobj-compound-appos,compound-pobj,NNP-NNP-NNP,NNP-NNP,7,1
3417,1959.0,21,said,15,17,19,2,16,1,-2,4,UNP,Ranil Wickremesinghe,per,-,PROPN,PROPN-PROPN,compound,compound-ccomp,NNP,NNP-NNP,1,1
3418,1960.0,38,stated,12,3,5,2,2,32,9,-7,Brad Duguid,Ontario,-,per,PROPN-PROPN,PROPN,compound-compound,poss,NNP-NNP,NNP,2,1
3419,1962.0,25,distributes,11,4,9,5,3,15,7,-2,Emerson Electric Company,1890,per-per-per,,PROPN-PROPN-PROPN,NUM,compound-compound-pobj,pobj,NNP-NNP-NNP,CD,7,1
3420,1963.0,55,Texas,1,5,7,2,4,47,-4,6,r Treasur,y Paul O'Neil,per-per,--,NOUN-NOUN,NOUN-PROPN-PROPN,ROOT-compound,appos-compound-compound,NN-NN,NN-NNP-NNP,-1,1
3421,1964.0,32,changed,4,9,12,3,8,19,-5,8,Bill Thomas,Halo Burger,-,per-per,PROPN-PROPN,PROPN-PROPN,compound-poss,compound-pobj,NNP-NNP,NNP-NNP,1,1
3422,1965.0,40,moved,3,30,33,3,29,6,-27,30,UCLA,Saul Winstein,per,-,PROPN,PROPN-PROPN,pobj,compound-compound,NNP,NNP-NNP,2,1
3423,2011.0,26,completed,1,20,22,2,19,3,-19,21,UCLA,Saul Winstein,org,-,PROPN,PROPN-PROPN,pobj,compound-pobj,NNP,NNP-NNP,1,1
3424,1966.0,36,laid,15,2,7,5,1,28,13,-8,President,Ilham Aliyev,,org-org,PROPN,PROPN-PROPN,compound,compound-nsubj,NNP,NNP-NNP,3,1
3425,3820.0,17,attended,12,9,10,1,8,6,3,-2,President,Ilham Aliyev,per,-,PROPN,PROPN-PROPN,compound,compound-conj,NNP,NNP-NNP,2,1
3426,6512.0,25,took,3,16,20,4,15,4,-13,17,President,Ilham Aliyev,,org-org,PROPN,PROPN-PROPN,pobj,compound-compound,NNP,NNP-NNP,2,1
3427,7103.0,13,had,4,10,11,1,9,1,-6,7,President,Ilham Aliyev,,per-per,PROPN,PROPN-PROPN,compound,compound-pobj,NNP,NNP-NNP,1,1
3428,7486.0,39,operate,4,29,30,1,28,8,-25,26,President,Ilham Aliyev,,per-per,PROPN,PROPN-PROPN,compound,compound-poss,NNP,NNP-NNP,1,1
3429,13427.0,32,quoted,5,7,8,1,6,23,-2,3,President,Ilham Aliyev,,per-per,PROPN,PROPN-PROPN,compound,compound-dobj,NNP,NNP-NNP,1,1
3430,1967.0,58,said,28,43,57,14,42,0,-15,29,McGill University,Canada,per-per,,PROPN-PROPN,PROPN,compound-pobj,pobj,NNP-NNP,NNP,8,1
3431,1968.0,21,represented,7,3,15,12,2,5,4,8,Savannah State University,NCAA Division I,--,org-org-org,PROPN-PROPN-PROPN,PROPN-PROPN-PROPN,compound-compound-dobj,compound-compound-compound,NNP-NNP-NNP,NNP-NNP-NNP,5,1
3432,1969.0,33,Students,0,6,10,4,5,22,-6,10,Macalester College,MN,per-per,,PROPN-PROPN,PROPN,compound-compound,compound,NNP-NNP,NNP,2,1
3433,1970.0,20,Jenkins,5,4,13,9,3,6,1,8,Albert G. Jenkins,Cabell County,per-per-per,-,PROPN-PROPN-PROPN,PROPN-PROPN,compound-compound-ROOT,compound-pobj,NNP-NNP-NNP,NNP-NNP,7,1
3434,1971.0,12,grew,1,6,9,3,5,2,-5,8,Nova Scotia,his,-,org,PROPN-PROPN,DET,compound-pobj,poss,NNP-NNP,PRP$,5,1
3435,1972.0,52,followed,2,12,21,9,11,30,-10,19,Mozambique,Joaquim Chissano,org,-,PROPN,PROPN-PROPN,pobj,compound-pobj,NNP,NNP-NNP,4,1
3436,2632.0,39,identified,18,24,31,7,23,7,-6,13,Mozambique,Joaquim Chissano,org,-,PROPN,PROPN-PROPN,pobj,compound-poss,NNP,NNP-NNP,2,1
3437,10054.0,25,ANTANANARIVO,0,8,12,4,7,12,-8,12,Mozambique,Joaquim Chissano,per,-,PROPN,PROPN-PROPN,poss,compound-appos,NNP,NNP-NNP,3,1
3438,1973.0,34,played,10,5,20,15,4,13,5,10,England,Ray Williams,per,-,PROPN,PROPN-PROPN,compound,compound-nsubj,NNP,NNP-NNP,6,1
3439,1974.0,32,received,1,8,19,11,7,12,-7,18,Zachary Taylor,United States,per-per,-,PROPN-PROPN,PROPN-PROPN,compound-pobj,compound-compound,NNP-NNP,NNP-NNP,8,1
3440,1975.0,25,sent,5,4,13,9,3,11,1,8,Gagarin,Pilot,org,,PROPN,PROPN,nsubjpass,poss,NNP,NNP,5,1
3441,1976.0,26,repeated,12,6,10,4,5,15,6,-2,Currie Cup,1889,-,per,PROPN-PROPN,NUM,compound-compound,pobj,NNP-NNP,CD,4,1
3442,1977.0,17,was,5,3,16,13,2,0,2,11,Littleton Waller Tazewell,Virginia,--,per,PROPN-PROPN-PROPN,PROPN,compound-compound-appos,pobj,NNP-NNP-NNP,NNP,4,1
3443,2577.0,36,voted,17,20,24,4,19,11,-3,7,Littleton Waller Tazewell,Virginia,--,org,PROPN-PROPN-PROPN,PROPN,compound-compound-pobj,pobj,NNP-NNP-NNP,NNP,2,1
3444,5365.0,27,was,1,7,17,10,6,9,-6,16,Littleton Waller Tazewell,Virginia,--,per,PROPN-PROPN-PROPN,PROPN,compound-compound-compound,compound,NNP-NNP-NNP,NNP,2,1
3445,13187.0,21,was,8,1,11,10,0,9,7,3,Littleton Waller Tazewell,Virginia,org-org-org,,PROPN-PROPN-PROPN,PROPN,compound-compound-compound,compound,NNP-NNP-NNP,NNP,3,1
3446,1978.0,98,is,2,78,15,-63,77,82,-76,13,O'Neill,Northern Ireland,,per-per,PROPN,PROPN-PROPN,nsubj,compound-pobj,NNP,NNP-NNP,-1,1
3447,1979.0,32,made,11,23,31,8,22,0,-12,20,Detroit,Esham,,per,PROPN,PROPN,pobj,pobj,NNP,NNP,2,1
3448,1980.0,42,opened,7,27,6,-21,26,35,-20,-1,Ashford,Reculver,org,,PROPN,PROPN,pobj,nmod,NNP,NNP,6,1
3449,1981.0,25,At,0,13,20,7,12,4,-13,20,Actress,Paquin,,org,NOUN,PROPN,appos,pobj,NN,NNP,4,1
3450,1982.0,48,been,11,16,16,0,15,31,-5,5,Taiwan,Taiwan Television,org,-,PROPN,PROPN-PROPN,pobj,compound-nmod,NNP,NNP-NNP,0,1
3451,1983.0,22,is,8,1,18,17,0,3,7,10,Terry Bright,Geelong,per-per,,PROPN-PROPN,PROPN,compound-nsubj,pobj,NNP-NNP,NNP,6,1
3452,1984.0,31,convinced,4,10,19,9,9,11,-6,15,Plaek Pibulsonggram,Thailand,-,per,PROPN-PROPN,PROPN,compound-pobj,pobj,NNP-NNP,NNP,5,1
3453,1985.0,18,walks,4,3,10,7,2,7,1,6,Jerry Garcia,Grateful Dead,-,per-per,PROPN-PROPN,PROPN-PROPN,compound-nsubj,nmod-nmod,NNP-NNP,NNP-NNP,4,1
3454,1986.0,29,is,18,17,28,11,16,0,1,10,Karl Wolf,Canada,-,per,PROPN-PROPN,PROPN,compound-nsubj,pobj,NNP-NNP,NNP,7,1
3455,1987.0,26,are,6,2,6,4,1,19,4,0,Jacksonville Axemen,2006,per-per,,PROPN-PROPN,NUM,compound-nsubj,pobj,NNP-NNP,CD,2,1
3456,1989.0,24,stated,3,1,2,1,0,21,2,-1,Producer,Frank Darabont,org,-,PROPN,PROPN-PROPN,compound,compound-nsubj,NNP,NNP-NNP,1,1
3457,1990.0,20,is,1,17,18,1,16,1,-16,17,Agriculture,Ann Veneman,per,-,PROPN,PROPN-PROPN,pobj,compound-conj,NNP,NNP-NNP,1,1
3458,9171.0,14,said,12,9,11,2,8,2,3,-1,Agriculture,Ann Veneman,org,-,PROPN,PROPN-PROPN,compound,compound-nsubj,NNP,NNP-NNP,1,1
3459,9462.0,33,said,31,28,30,2,27,2,3,-1,Agriculture,Ann Veneman,per,-,PROPN,PROPN-PROPN,compound,compound-nsubj,NNP,NNP-NNP,1,1
3460,12177.0,12,opposed,6,4,5,1,3,6,2,-1,Agriculture,Ann Veneman,,per-per,PROPN,PROPN-PROPN,pobj,compound-nsubj,NNP,NNP-NNP,1,1
3461,1991.0,29,born,13,2,4,2,1,24,11,-9,French,Edgar,per,,ADJ,PROPN,amod,nsubjpass,JJ,NNP,2,1
3462,1992.0,26,led,3,6,10,4,5,15,-3,7,UAW,AFL-CIO,,per,PROPN,NOUN,dobj,pobj,NNP,NN,3,1
3463,1993.0,40,said,1,4,6,2,3,33,-3,5,Qantas,Jetstar Airways,,org-org,PROPN,PROPN-PROPN,nsubj,compound-compound,NNP,NNP-NNP,2,1
3464,2277.0,13,appointed,2,6,8,2,5,4,-4,6,Qantas,Jetstar Airways,per,-,PROPN,PROPN-PROPN,compound,compound-pobj,NNP,NNP-NNP,1,1
3465,3662.0,21,announced,9,7,19,12,6,1,2,10,Qantas,Jetstar Airways,org,-,PROPN,PROPN-PROPN,compound,compound-pobj,NNP,NNP-NNP,5,1
3466,1994.0,13,owed,7,7,9,2,6,3,0,2,Fogerty,Fantasy,,per,PROPN,PROPN,nsubj,dobj,NNP,NNP,2,1
3467,2997.0,9,returned,4,4,7,3,3,1,0,3,Fogerty,Fantasy,,per,PROPN,PROPN,nsubj,compound,NNP,NNP,2,1
3468,1995.0,15,releasing,5,3,11,8,2,3,2,6,Columbia,Dylan,,org,PROPN,PROPN,compound,poss,NNP,NNP,3,1
3469,1996.0,24,worked,14,4,12,8,3,11,10,-2,Richard Riordan,Los Angeles,per-per,-,PROPN-PROPN,PROPN-PROPN,compound-poss,compound-pobj,NNP-NNP,NNP-NNP,5,1
3470,1997.0,29,shortened,1,14,18,4,13,10,-13,17,Don Owen,Oregon,per-per,,PROPN-PROPN,PROPN,compound-poss,pobj,NNP-NNP,NNP,2,1
3471,5168.0,26,promoted,4,3,17,14,2,8,1,13,Don Owen,Oregon,per-per,,PROPN-PROPN,PROPN,compound-nsubj,pobj,NNP-NNP,NNP,3,1
3472,8767.0,31,owned,4,21,30,9,20,0,-17,26,Don Owen,Oregon,-,per,PROPN-PROPN,PROPN,compound-compound,pobj,NNP-NNP,NNP,6,1
3473,1998.0,21,said,13,16,19,3,15,1,-3,6,bank,Duvvuri Subbarao,per,-,NOUN,PROPN-PROPN,poss,compound-appos,NN,NNP-NNP,3,1
3474,1999.0,28,followed,3,11,22,11,10,5,-8,19,OFC Nations Cup,New Zealand,per-per-per,-,PROPN-PROPN-PROPN,PROPN-PROPN,compound-compound-pobj,compound-conj,NNP-NNPS-NNP,NNP-NNP,9,1
3475,2000.0,28,said,26,4,8,4,3,19,22,-18,Aldo Moro,Italian,org-org,,PROPN-PROPN,ADJ,compound-pobj,amod,NNP-NNP,JJ,2,1
3476,2001.0,25,short,1,16,19,3,15,5,-15,18,Chrysler,Division,,per,PROPN,PROPN,poss,pobj,NNP,NNP,4,1
3477,2479.0,18,produced,8,11,17,6,10,0,-3,9,Chrysler,Division,,org,PROPN,PROPN,compound,conj,NNP,NNP,4,1
3478,5249.0,29,designated,5,1,9,8,0,19,4,4,Chrysler,Division,,org,PROPN,PROPN,poss,nsubj,NNP,NNP,4,1
3479,2003.0,19,confirmed,3,7,11,4,6,7,-4,8,Giulio Andreotti,Italy,-,per,PROPN-PROPN,PROPN,compound-pobj,poss,NNP-NNP,NNP,5,1
3480,2004.0,34,attended,21,23,27,4,22,6,-2,6,Normandale Community College,Bloomington,--,per,PROPN-PROPN-PROPN,PROPN,compound-compound-dobj,pobj,NNP-NNP-NNP,NNP,1,1
3481,2005.0,41,got,22,13,35,22,12,5,9,13,Stockholm,Royal Institute of Technology,,org-org-org-org,PROPN,PROPN-PROPN-ADP-PROPN,compound,compound-pobj-prep-pobj,NNP,NNP-NNP-IN-NNP,14,1
3482,2006.0,29,reported,4,9,15,6,8,13,-5,11,Michael J. Hogan,University of Connecticut,--,org-org-org,PROPN-PROPN-PROPN,PROPN-ADP-PROPN,compound-compound-pobj,pobj-prep-pobj,NNP-NNP-NNP,NNP-IN-NNP,5,1
3483,2007.0,42,returned,20,18,23,5,17,18,2,3,Abdul Majid al-Khoei,Iraq,per-per-per,,PROPN-PROPN-PROPN,PROPN,compound-appos-nsubj,pobj,NNP-NNP-NNP,NNP,6,1
3484,2008.0,74,Cairo,0,1,24,23,0,49,-1,24,Cairo,Fuad I of Egypt,,per-per-per-per,NOUN,PROPN-PRON-ADP-PROPN,ROOT,compound-pobj-prep-pobj,NN,NNP-PRP-IN-NNP,-1,1
3485,2009.0,27,announced,13,8,5,-3,7,21,5,-8,Mesaba Airlines,Northwest Airlines,per-per,-,PROPN-PROPN,PROPN-PROPN,compound-nsubj,compound-nsubj,NNP-NNPS,NNP-NNPS,3,1
3486,9361.0,15,suspended,6,1,4,3,0,10,5,-2,Mesaba Airlines,Northwest Airlines,org-org,-,PROPN-PROPN,PROPN-PROPN,compound-nsubj,compound-compound,NNP-NNPS,NNP-NNP,3,1
3487,11122.0,18,emerged,6,5,16,11,4,1,1,10,Mesaba Airlines,Northwest Airlines,-,org-org,PROPN-PROPN,PROPN-PROPN,compound-nsubj,compound-pobj,NNP-NNPS,NNP-NNPS,4,1
3488,2010.0,17,created,5,2,3,1,1,13,3,-2,1999,Telus,per,,NUM,PROPN,pobj,compound,CD,NNP,1,1
3489,2012.0,17,played,2,6,14,8,5,2,-4,12,Brisbane Broncos,National Rugby League,org-org,--,PROPN-PROPN,PROPN-PROPN-PROPN,compound-pobj,compound-compound-pobj,NNP-NNPS,NNP-NNP-NNP,4,1
3490,2013.0,18,on,1,13,17,4,12,0,-12,16,Indian Overseas Bank,India,per-per-per,,PROPN-PROPN-PROPN,PROPN,compound-compound-pobj,pobj,NNP-NNP-NNP,NNP,9,1
3491,2014.0,9,is,0,2,7,5,1,1,-2,7,Mell,Geneon,org,,PROPN,PROPN,poss,compound,NNP,NNP,4,1
3492,2015.0,23,spent,1,1,22,21,0,0,0,21,He,Virginia,,per,PRON,PROPN,nsubj,pobj,PRP,NNP,1,1
3493,7957.0,31,served,1,1,20,19,0,10,0,19,He,Virginia,org,,PRON,PROPN,nsubj,pobj,PRP,NNP,7,1
3494,9053.0,20,said,2,1,19,18,0,0,1,17,He,Virginia,org,,PRON,PROPN,nsubjpass,pobj,PRP,NNP,2,1
3495,2016.0,52,were,10,5,23,18,4,28,5,13,Albany,State University of New York,per,----,PROPN,PROPN-PROPN-ADP-PROPN-PROPN,pobj,compound-pobj-prep-compound-pobj,NNP,NNP-NNP-IN-NNP-NNP,9,1
3496,2017.0,27,agreed,18,9,18,9,8,8,9,0,Germany,Hermann,org,,PROPN,PROPN,pobj,pobj,NNP,NNP,4,1
3497,12814.0,39,adopted,18,9,18,9,8,20,9,0,Germany,Hermann,,per,PROPN,PROPN,pobj,pobj,NNP,NNP,3,1
3498,2018.0,30,formed,10,2,13,11,1,16,8,3,Richard Ivey School of Business,1922,org-org-org-org-org,,PROPN-PROPN-PROPN-ADP-PROPN,NUM,compound-compound-nmod-prep-pobj,pobj,NNP-NNP-NNP-IN-NNP,CD,3,1
3499,2019.0,34,is,3,1,1,0,0,32,2,-2,Livingston High School,Livingston,--,org,PROPN-PROPN-PROPN,PROPN,compound-compound-nsubj,pobj,NNP-NNP-NNP,NNP,0,1
3500,2021.0,42,discloses,2,6,22,16,5,19,-4,20,2007,First American,,per-per,NUM,PROPN-PROPN,nummod,compound-compound,CD,NNP-NNP,5,1
3501,2022.0,21,was,1,4,16,12,3,4,-3,15,Tigers,Southeastern Conference,,org-org,PROPN,PROPN-PROPN,poss,compound-pobj,NNPS,NNP-NNP,8,1
3502,2024.0,26,said,3,6,20,14,5,5,-3,17,SFR,Neuf Cegetel,,per-per,PROPN,PROPN-PROPN,nmod,compound-pobj,NNP,NNP-NNP,7,1
3503,2026.0,34,It's,0,21,33,12,20,0,-21,33,Vanessa Paradis,France,org-org,,PROPN-PROPN,PROPN,compound-dative,pobj,NNP-NNP,NNP,10,1
3504,8224.0,13,born,3,1,6,5,0,6,2,3,Vanessa Paradis,France,per-per,,PROPN-PROPN,PROPN,compound-nsubjpass,pobj,NNP-NNP,NNP,2,1
3505,2027.0,60,found,11,49,57,8,48,2,-38,46,Def Jam,Redman,per-per,,PROPN-PROPN,PROPN,compound-compound,pobj,NNP-NNP,NNP,8,1
3506,3091.0,24,got,10,6,9,3,5,14,4,-1,Def Jam,Redman,-,per,PROPN-PROPN,PROPN,compound-compound,compound,NNP-NNP,NNP,1,1
3507,2028.0,19,released,4,3,18,15,2,0,1,14,Olga Souza,Brazil,per-per,,PROPN-PROPN,PROPN,compound-nsubj,pobj,NNP-NNP,NNP,2,1
3508,2029.0,23,was,15,1,5,4,0,17,14,-10,Judy Garland,Frances Ethel Gumm,-,org-org-org,PROPN-PROPN,PROPN-PROPN-PROPN,compound-nsubj,compound-compound-dobj,NNP-NNP,NNP-NNP-NNP,2,1
3509,2030.0,24,According,0,5,12,7,4,11,-5,12,Eric Burdon,musician,-,per,PROPN-PROPN,NOUN,compound-compound,nsubjpass,NNP-NNP,NN,5,1
3510,2031.0,21,told,1,9,14,5,8,6,-8,13,Sabah,Musa Aman,org,-,PROPN,PROPN-PROPN,compound,compound-pobj,NNP,NNP-NNP,2,1
3511,2034.0,24,served,1,7,10,3,6,13,-6,9,Roanoke Virginia,Norfolk and Western Railway,-,org-org-org-org,PROPN-PROPN,PROPN-CCONJ-PROPN-PROPN,compound-pobj,dobj-cc-compound-conj,NNP-NNP,NNP-CC-NNP-NNP,7,1
3512,2035.0,18,disagreed,4,1,1,0,0,16,3,-3,US Airways,US,-,org,PROPN-PROPN,PROPN,compound-nsubj,compound,NNP-NNP,NNP,0,1
3513,2038.0,24,orchestrated,3,8,23,15,7,0,-5,20,Virgin Mobile Canada,2005,--,per,PROPN-PROPN-PROPN,NUM,compound-compound-dobj,nummod,NNP-NNP-NNP,CD,3,1
3514,2040.0,32,released,8,1,11,10,0,20,7,3,Kenny Rogers,RCA Records,-,per-per,PROPN-PROPN,PROPN-PROPN,compound-poss,compound-pobj,NNP-NNP,NNP-NNPS,5,1
3515,2042.0,21,is,3,6,14,8,5,6,-3,11,Finley Hospital,Iowa Health System,per-per,--,PROPN-PROPN,PROPN-PROPN-PROPN,compound-attr,compound-compound-poss,NNP-NNP,NNP-NNP-NNP,7,1
3516,2043.0,45,was,13,1,17,16,0,27,12,4,Larry Levan,DJ,per-per,,PROPN-PROPN,PROPN,compound-nsubj,attr,NNP-NNP,NNP,4,1
3517,2044.0,17,completed,1,1,9,8,0,7,0,8,FGCU,Division I,,per-per,PROPN,PROPN-PRON,nsubj,pobj-appos,NNP,NNP-PRP,3,1
3518,2045.0,28,entered,1,1,3,2,0,24,0,2,Robyn,Sweden,,per,PROPN,PROPN,nsubj,poss,NNP,NNP,3,1
3519,14048.0,21,peaked,2,8,11,3,7,9,-6,9,Robyn,Sweden,org,,PROPN,PROPN,poss,pobj,NNP,NNP,5,1
3520,2046.0,40,is,10,1,31,30,0,8,9,21,Pratibha Patil,Jalgaon,-,per,PROPN-PROPN,PROPN,compound-pobj,pobj,NNP-NNP,NNP,5,1
3521,2047.0,29,educated,2,6,9,3,5,19,-4,7,Grey Coat Hospital,Westminster,--,per,PROPN-PROPN-PROPN,PROPN,compound-compound-compound,pobj,NNP-NNP-NNP,NNP,4,1
3522,2048.0,18,responding,2,11,16,5,10,1,-9,14,Council on Foreign Relations,New York,---,org-org,PROPN-ADP-PROPN-PROPN,PROPN-PROPN,pobj-prep-compound-pobj,compound-pobj,NNP-IN-NNP-NNPS,NNP-NNP,3,1
3523,2049.0,39,located,11,8,21,13,7,17,3,10,I Holdings Co.,Japan,org-org-org,,PRON-PROPN-PROPN,PROPN,compound-compound-pobj,attr,PRP-NNPS-NNP,NNP,5,1
3524,2050.0,35,created,11,18,5,-13,17,29,-7,-6,1977,Botswana Federation of Trade Unions,per,----,NUM,PROPN-PROPN-ADP-PROPN-PROPN,pobj,compound-dobj-prep-compound-pobj,CD,NNP-NNP-IN-NNP-NNPS,5,1
3525,2051.0,35,is,3,14,32,18,13,2,-11,29,Mick Taylor,Decca,-,org,PROPN-PROPN,PROPN,compound-compound,compound,NNP-NNP,NNP,8,1
3526,2053.0,23,represented,7,3,10,7,2,12,4,3,Northern Iowa Panthers,University of Northern Iowa,org-org-org,---,PROPN-PROPN-PROPN,PROPN-ADP-PROPN-PROPN,compound-compound-compound,dobj-prep-compound-pobj,NNP-NNP-NNPS,NNP-IN-NNP-NNP,5,1
3527,2054.0,37,was,4,4,26,22,3,10,0,22,Prussia,Adolf Heinrich von Arnim-Boitzenburg,per,---,PROPN,PROPN-PROPN-PROPN-PROPN,pobj,compound-compound-compound-conj,NNP,NNP-NNP-NNP-NNP,3,1
3528,2055.0,44,involved,36,23,32,9,22,11,13,-4,Lester James Peiris,Radio,--,per,PROPN-PROPN-PROPN,PROPN,compound-compound-conj,compound,NNP-NNP-NNP,NNP,5,1
3529,2056.0,23,elected,2,1,7,6,0,15,1,5,Pierce,United States,,org-org,PROPN,PROPN-PROPN,nsubjpass,compound-pobj,NNP,NNP-NNP,4,1
3530,2057.0,14,flew,1,4,9,5,3,4,-3,8,South Africa,Smith,per-per,,PROPN-PROPN,PROPN,compound-pobj,pobj,NNP-NNP,NNP,6,1
3531,9743.0,27,launched,10,7,21,14,6,5,3,11,South Africa,Smith,org-org,,PROPN-PROPN,PROPN,compound-compound,dobj,NNP-NNP,NNP,8,1
3532,2058.0,15,considered,3,2,14,12,1,0,1,11,Kapoor,India,,org,PROPN,PROPN,nsubjpass,pobj,NNP,NNP,2,1
3533,2059.0,30,transfer,13,16,26,10,15,3,-3,13,Sprint,Overland Park,per,-,PROPN,PROPN-PROPN,poss,compound-compound,NNP,NNP-NNP,5,1
3534,2061.0,29,fled,6,1,11,10,0,17,5,5,Ante Paveli?,d Spai,org-org,-,PROPN-NOUN,ADJ-PROPN,compound-nsubj,nummod-compound,NNP-NN,JJ-NNP,-1,1
3535,2063.0,35,spent,2,6,23,17,5,11,-4,21,New York,Lord Taylor,org-org,-,PROPN-PROPN,PROPN-PROPN,compound-compound,compound-pobj,NNP-NNP,NNP-NNP,11,1
3536,2064.0,26,re-elected,2,9,19,10,8,6,-7,17,Werriwa,Gough Whitlam,,org-org,PROPN,PROPN-PROPN,pobj,compound-pobj,NNP,NNP-NNP,8,1
3537,2065.0,10,was,2,1,8,7,0,1,1,6,Samuel Wescott,Jersey City,per-per,-,PROPN-PROPN,PROPN-PROPN,compound-nsubj,compound-pobj,NNP-NNP,NNP-NNP,4,1
3538,2066.0,25,included,4,2,14,12,1,10,2,10,Paris,Henri Rousseau,,per-per,PROPN,PROPN-PROPN,compound,compound-compound,NNP,NNP-NNP,6,1
3539,2067.0,30,developed,3,6,10,4,5,19,-3,7,South Korea,Daewoo Motor,-,org-org,PROPN-PROPN,PROPN-PROPN,compound-pobj,compound-compound,NNP-NNP,NNP-NNP,5,1
3540,2068.0,12,jpg,0,3,8,5,2,3,-3,8,Manmohan Singh,India,-,per,PROPN-PROPN,PROPN,compound-compound,compound,NNP-NNP,NNP,2,1
3541,2250.0,25,jpg,0,3,8,5,2,16,-3,8,Manmohan Singh,India,org-org,,PROPN-PROPN,PROPN,compound-compound,compound,NNP-NNP,NNP,2,1
3542,2626.0,44,said,39,12,26,14,11,17,27,-13,Manmohan Singh,India,-,org,PROPN-PROPN,PROPN,compound-pobj,pobj,NNP-NNP,NNP,12,1
3543,8746.0,27,praised,5,4,10,6,3,16,1,5,Manmohan Singh,India,per-per,,PROPN-PROPN,PROPN,compound-dobj,pobj,NNP-NNP,NNP,3,1
3544,10105.0,27,invited,1,18,21,3,17,5,-17,20,Manmohan Singh,India,-,per,PROPN-PROPN,PROPN,compound-appos,pobj,NNP-NNP,NNP,1,1
3545,11420.0,23,said,2,1,4,3,0,18,1,2,Manmohan Singh,India,org-org,,PROPN-PROPN,PROPN,compound-nsubj,nsubj,NNP-NNP,NNP,3,1
3546,13713.0,17,was,1,10,16,6,9,0,-9,15,Manmohan Singh,India,per-per,,PROPN-PROPN,PROPN,compound-pobj,pobj,NNP-NNP,NNP,4,1
3547,2069.0,28,visited,3,5,11,6,4,16,-2,8,Italy,Giuseppe Saragat,,org-org,PROPN,PROPN-PROPN,dobj,compound-pobj,NNP,NNP-NNP,3,1
3548,2070.0,25,is,2,6,14,8,5,10,-4,12,David Cage,Quantic Dream,per-per,-,PROPN-PROPN,PROPN-PROPN,compound-pobj,compound-compound,NNP-NNP,NNP-NNP,3,1
3549,2071.0,21,is,1,1,10,9,0,10,0,9,She,Japan,,per,PRON,PROPN,nsubj,pobj,PRP,NNP,3,1
3550,2072.0,40,sought,8,5,8,3,4,31,3,0,Lisa Murkowski,Anchorage,per-per,,PROPN-PROPN,PROPN,compound-nsubj,pobj,NNP-NNP,NNP,1,1
3551,2073.0,18,said,8,1,14,13,0,3,7,6,Switzerland,Samuel Schmid,org,-,PROPN,PROPN-PROPN,nsubj,compound-pobj,NNP,NNP-NNP,4,1
3552,2074.0,23,went,3,9,12,3,8,10,-6,9,Lamar University,Beaumont,-,per,PROPN-PROPN,PROPN,compound-pobj,compound,NNP-NNP,NNP,1,1
3553,2075.0,33,granted,17,3,16,13,2,16,14,-1,Chile,Jorge Alessandri,per,-,PROPN,PROPN-PROPN,pobj,compound-pobj,NNP,NNP-NNP,4,1
3554,2076.0,14,wanted,5,1,4,3,0,9,4,-1,Nicolas Sarkozy,Carla Bruni,org-org,-,PROPN-PROPN,PROPN-PROPN,nmod-nmod,conj-nsubj,NNP-NNP,NNP-NNP,1,1
3555,2078.0,22,dissolved,5,1,4,3,0,17,4,-1,Italy,Giorgio Napolitano,,per-per,PROPN,PROPN-PROPN,poss,compound-nsubj,NNP,NNP-NNP,2,1
3556,2178.0,30,said,27,12,20,8,11,9,15,-7,Italy,Giorgio Napolitano,per,-,PROPN,PROPN-PROPN,pobj,compound-appos,NNP,NNP-NNP,4,1
3557,6136.0,31,received,4,16,17,1,15,13,-12,13,Italy,Giorgio Napolitano,per,-,PROPN,PROPN-PROPN,pobj,compound-ROOT,NNP,NNP-NNP,1,1
3558,2079.0,22,graduated,1,4,8,4,3,13,-3,7,Brandeis University,Massachusetts,per-per,,PROPN-PROPN,PROPN,compound-pobj,pobj,NNP-NNP,NNP,3,1
3559,2080.0,25,On,0,14,19,5,13,5,-14,19,Koodo Mobile,Telus Mobility,-,per-per,PROPN-PROPN,PROPN-PROPN,compound-nsubjpass,compound-pobj,NNP-NNP,NNP-NNP,5,1
3560,2082.0,41,was,1,26,29,3,25,11,-25,28,Michael Jackson,Epic,per-per,,PROPN-PROPN,PROPN,compound-poss,compound,NNP-NNP,NNP,3,1
3561,2083.0,28,escaped,11,10,11,1,9,16,1,0,France,Marceau,,per,PROPN,PROPN,compound,pobj,NNP,NNP,5,1
3562,2084.0,24,is,12,1,15,14,0,8,11,3,Martin Rogan,Irish,-,org,PROPN-PROPN,ADJ,compound-nsubj,amod,NNP-NNP,JJ,3,1
3563,2086.0,28,was,1,19,26,7,18,1,-18,25,Connecticut,Christopher Dodd,per,-,PROPN,PROPN-PROPN,pobj,compound-pobj,NNP,NNP-NNP,4,1
3564,9212.0,33,beat,8,25,31,6,24,1,-17,23,Connecticut,Christopher Dodd,org,-,PROPN,PROPN-PROPN,compound,compound-pobj,NNP,NNP-NNP,3,1
3565,10251.0,18,incumbent,1,14,16,2,13,1,-13,15,Connecticut,Christopher Dodd,,per-per,PROPN,PROPN-PROPN,compound,compound-pobj,NNP,NNP-NNP,1,1
3566,11140.0,27,is,1,5,19,14,4,7,-4,18,Connecticut,Christopher Dodd,,per-per,PROPN,PROPN-PROPN,compound,compound-pobj,NNP,NNP-NNP,8,1
3567,2087.0,40,is,3,7,10,3,6,29,-4,7,hero,Philippines,,per,NOUN,PROPN,attr,pobj,NN,NNP,1,1
3568,2088.0,32,known,3,23,23,0,22,8,-20,20,Ohio,Ohio Central Railroad,org,--,PROPN,PROPN-PROPN-PROPN,conj,compound-compound-compound,NNP,NNP-NNP-NNP,0,1
3569,2089.0,12,Sweden,1,2,10,8,1,1,-1,9,Sweden,Ingmar Bergman,,per-per,PROPN,PROPN-PROPN,ROOT,compound-dobj,NNP,NNP-NNP,-1,1
3570,2605.0,36,Apart,0,8,28,20,7,7,-8,28,Sweden,Ingmar Bergman,per,-,PROPN,PROPN-PROPN,pobj,compound-pobj,NNP,NNP-NNP,10,1
3571,6032.0,39,managed,14,29,37,8,28,1,-15,23,Sweden,Ingmar Bergman,,org-org,PROPN,PROPN-PROPN,pobj,compound-pobj,NNP,NNP-NNP,4,1
3572,6605.0,25,It's,0,6,18,12,5,6,-6,18,Sweden,Ingmar Bergman,,org-org,PROPN,PROPN-PROPN,pobj,compound-compound,NNP,NNP-NNP,8,1
3573,14002.0,29,says,27,2,7,5,1,21,25,-20,Sweden,Ingmar Bergman,per,-,PROPN,PROPN-PROPN,nsubj,compound-nsubj,NNP,NNP-NNP,2,1
3574,2090.0,37,referred,4,1,17,16,0,19,3,13,CBS,Columbia Records,per,-,PROPN,PROPN-PROPN,compound,compound-compound,NNP,NNP-NNPS,7,1
3575,3037.0,11,bought,4,4,7,3,3,3,0,3,CBS,Columbia Records,,org-org,PROPN,PROPN-PROPN,nsubj,compound-dobj,NNP,NNP-NNPS,1,1
3576,2091.0,24,inspired,8,1,7,6,0,16,7,-1,His,United States,,per-per,DET,PROPN-PROPN,poss,compound-pobj,PRP$,NNP-NNP,3,1
3577,2092.0,29,has,17,1,17,16,0,11,16,0,Rose McGowan,actress,-,per,PROPN-PROPN,NOUN,compound-compound,nsubj,NNP-NNP,NN,2,1
3578,2093.0,72,opined,38,5,8,3,4,63,33,-30,Legislative Council,Rita Fan,org-org,-,PROPN-PROPN,PROPN-PROPN,compound-compound,compound-conj,NNP-NNP,NNP-NNP,2,1
3579,10370.0,61,greeted,6,40,42,2,39,18,-34,36,Legislative Council,Rita Fan,org-org,-,PROPN-PROPN,PROPN-PROPN,compound-compound,compound-compound,NNP-NNP,NNP-NNP,4,1
3580,2094.0,15,served,3,2,14,12,1,0,1,11,she,India,,org,PRON,PROPN,nsubj,conj,PRP,NNP,2,1
3581,2095.0,20,said,7,2,19,17,1,0,5,12,Iowa,Grassley,,org,PROPN,PROPN,compound,dobj,NNP,NNP,5,1
3582,2096.0,22,said,13,20,21,1,19,0,-7,8,Genpact,India,per,,PROPN,PROPN,compound,pobj,NNP,NNP,4,1
3583,2097.0,16,was,1,1,4,3,0,11,0,3,He,European Parliament,,per-per,PRON,PROPN-PROPN,nsubj,compound-compound,PRP,NNP-NNP,2,1
3584,2098.0,23,was,1,16,21,5,15,1,-15,20,Terence O'Neill,Northern Ireland,per-per,-,PROPN-PROPN,PROPN-PROPN,compound-compound,compound-pobj,NNP-NNP,NNP-NNP,3,1
3585,4456.0,18,was,9,11,16,5,10,1,-2,7,Terence O'Neill,Northern Ireland,-,per-per,PROPN-PROPN,PROPN-PROPN,compound-compound,compound-pobj,NNP-NNP,NNP-NNP,3,1
3586,2099.0,24,accepted,3,10,23,13,9,0,-7,20,Ferris State University,Michigan,--,per,PROPN-PROPN-PROPN,PROPN,compound-compound-pobj,pobj,NNP-NNP-NNP,NNP,5,1
3587,2100.0,36,founded,4,2,7,5,1,28,2,3,1972,Front National,,per-per,NUM,PROPN-PROPN,pobj,nmod-nmod,CD,NNP-NNP,4,1
3588,2102.0,36,commented,4,22,25,3,21,10,-18,21,Alex Kapranos,Franz Ferdinand,-,org-org,PROPN-PROPN,PROPN-PROPN,compound-nsubj,compound-pobj,NNP-NNP,NNP-NNP,2,1
3589,9167.0,11,included,3,5,8,3,4,2,-2,5,Alex Kapranos,Franz Ferdinand,-,per-per,PROPN-PROPN,PROPN-PROPN,compound-dobj,compound-appos,NNP-NNP,NNP-NNP,1,1
3590,2103.0,17,opened,4,1,11,10,0,5,3,7,Rocky Mountain High School,1973,---,per,PROPN-PROPN-PROPN-PROPN,NUM,compound-compound-compound-nsubj,pobj,NNP-NNP-NNP-NNP,CD,3,1
3591,2104.0,27,agreed,15,4,7,3,3,19,11,-8,Daniel Ortega,Nicaragua,-,org,PROPN-PROPN,PROPN,compound-nsubj,pobj,NNP-NNP,NNP,1,1
3592,3530.0,27,changed,3,16,21,5,15,5,-13,18,Daniel Ortega,Nicaragua,per-per,,PROPN-PROPN,PROPN,compound-pobj,poss,NNP-NNP,NNP,11,1
3593,5137.0,12,sworn,3,1,9,8,0,2,2,6,Daniel Ortega,Nicaragua,-,per,PROPN-PROPN,PROPN,compound-nsubjpass,pobj,NNP-NNP,NNP,2,1
3594,5158.0,36,was,1,21,33,12,20,2,-20,32,Daniel Ortega,Nicaragua,-,org,PROPN-PROPN,PROPN,compound-poss,pobj,NNP-NNP,NNP,5,1
3595,7193.0,45,is,1,9,17,8,8,27,-8,16,Daniel Ortega,Nicaragua,per-per,,PROPN-PROPN,PROPN,compound-pobj,pobj,NNP-NNP,NNP,6,1
3596,7680.0,51,generated,2,31,35,4,30,15,-29,33,Daniel Ortega,Nicaragua,per-per,,PROPN-PROPN,PROPN,compound-conj,pobj,NNP-NNP,NNP,2,1
3597,7692.0,31,accepted,6,21,29,8,20,1,-15,23,Daniel Ortega,Nicaragua,-,org,PROPN-PROPN,PROPN,compound-pobj,compound,NNP-NNP,NNP,2,1
3598,9856.0,17,included,4,13,16,3,12,0,-9,12,Daniel Ortega,Nicaragua,-,per,PROPN-PROPN,PROPN,compound-conj,pobj,NNP-NNP,NNP,3,1
3599,9979.0,33,was,26,1,20,19,0,12,25,-6,Daniel Ortega,Nicaragua,per-per,,PROPN-PROPN,PROPN,compound-compound,pobj,NNP-NNP,NNP,5,1
3600,13633.0,24,sworn,7,5,14,9,4,9,2,7,Daniel Ortega,Nicaragua,org-org,,PROPN-PROPN,PROPN,compound-nsubjpass,pobj,NNP-NNP,NNP,5,1
3601,13922.0,26,stated,5,8,19,11,7,6,-3,14,Daniel Ortega,Nicaragua,-,org,PROPN-PROPN,PROPN,compound-poss,pobj,NNP-NNP,NNP,5,1
3602,2107.0,27,recorded,1,23,25,2,22,1,-22,24,Zorn,Tzadik,,per,PROPN,PROPN,poss,compound,NNP,NNP,2,1
3603,11792.0,19,released,2,7,9,2,6,9,-5,7,Zorn,Tzadik,per,,PROPN,PROPN,poss,compound,NNP,NNP,2,1
3604,2108.0,37,contributed,5,17,23,6,16,13,-12,18,Robyn,Stockholm,per,,PROPN,PROPN,dobj,pobj,NNP,NNP,5,1
3605,11464.0,26,began,1,1,11,10,0,14,0,10,Robyn,Stockholm,org,,PROPN,PROPN,nsubj,pobj,NNP,NNP,2,1
3606,2109.0,22,Let,0,14,20,6,13,1,-14,20,Doro,AFM Records,,per-per,PROPN,PROPN-PROPN,compound,compound-pobj,NNP,NNP-NNPS,3,1
3607,2110.0,30,met,3,8,29,21,7,0,-5,26,Denholm Elliott,Ibiza,org-org,,PROPN-PROPN,PROPN,compound-appos,pobj,NNP-NNP,NNP,10,1
3608,2111.0,34,returned,1,14,24,10,13,9,-13,23,Japan,Junichiro Koizumi,per,-,PROPN,PROPN-PROPN,compound,compound-pobj,NNP,NNP-NNP,7,1
3609,4649.0,39,decided,24,4,23,19,3,15,20,-1,Japan,Junichiro Koizumi,per,-,PROPN,PROPN-PROPN,compound,compound-nsubj,NNP,NNP-NNP,6,1
3610,2112.0,35,recognise,3,1,33,32,0,1,2,30,Iran,Ruhollah Khomeini,per,-,PROPN,PROPN-PROPN,poss,compound-dobj,NNP,NNP-NNP,6,1
3611,4609.0,28,issued,8,1,7,6,0,20,7,-1,Iran,Ruhollah Khomeini,,org-org,PROPN,PROPN-PROPN,poss,compound-appos,NNP,NNP-NNP,3,1
3612,2113.0,8,Oliver,1,1,4,3,0,3,0,3,David Oliver,USA,org-org,,PROPN-PROPN,PROPN,compound-ROOT,appos,NNP-NNP,NNP,2,1
3613,3453.0,8,Oliver,1,1,4,3,0,3,0,3,David Oliver,USA,per-per,,PROPN-PROPN,PROPN,compound-ROOT,appos,NNP-NNP,NNP,2,1
3614,2114.0,24,was,2,1,22,21,0,1,1,20,MKC Networks,Ontario,-,org,PROPN-PROPN,PROPN,compound-nsubj,compound,NNP-NNP,NNP,9,1
3615,2115.0,15,joined,1,4,11,7,3,3,-3,10,Reform Party,Preston Manning,per-per,-,PROPN-PROPN,PROPN-PROPN,compound-dobj,compound-pobj,NNP-NNP,NNP-NNP,4,1
3616,2116.0,24,replace,12,3,5,2,2,18,9,-7,Australia,General Motors,per,-,PROPN,PROPN-PROPN,pobj,compound-compound,NNP,NNP-NNP,3,1
3617,2118.0,37,Malaysia,1,1,2,1,0,34,0,1,Telekom Malaysia,Malaysia,per-per,,PROPN-PROPN,PROPN,compound-ROOT,poss,NNP-NNP,NNP,1,1
3618,2120.0,29,said,27,1,24,23,0,4,26,-3,Tata Motors,Land Rover,per-per,-,PROPN-PROPN,PROPN-PROPN,compound-nsubj,compound-pobj,NNP-NNP,NNP-NNP,11,1
3619,9005.0,19,completed,2,1,10,9,0,8,1,8,Tata Motors,Land Rover,-,per-per,PROPN-PROPN,PROPN-PROPN,compound-nsubj,compound-conj,NNP-NNP,NNP-NNP,3,1
3620,2121.0,32,decided,4,2,3,1,1,28,2,-1,1954,HSUS,per,,NUM,PROPN,pobj,compound,CD,NNP,1,1
3621,2123.0,7,of,0,2,5,3,1,1,-2,5,Rissho University,Tokyo,per-per,,PROPN-PROPN,PROPN,compound-nmod,pobj,NNP-NNP,NNP,2,1
3622,2124.0,33,refused,9,5,17,12,4,15,4,8,Pakistan,Liaquat Ali Khan,per,--,PROPN,PROPN-PROPN-PROPN,compound,compound-compound-nsubj,NNP,NNP-NNP-NNP,8,1
3623,3440.0,35,is,1,3,24,21,2,10,-2,23,Pakistan,Liaquat Ali Khan,org,--,PROPN,PROPN-PROPN-PROPN,poss,compound-compound-pobj,NNP,NNP-NNP-NNP,8,1
3624,8134.0,28,led,3,20,25,5,19,2,-17,22,Pakistan,Liaquat Ali Khan,org,--,PROPN,PROPN-PROPN-PROPN,poss,compound-compound-pobj,NNP,NNP-NNP-NNP,3,1
3625,2125.0,28,became,2,24,26,2,23,1,-22,24,UNIS,New York,,per-per,PROPN,PROPN-PROPN,conj,compound-pobj,NNP,NNP-NNP,3,1
3626,8842.0,58,said,20,37,40,3,36,17,-17,20,UNIS,New York,,per-per,PROPN,PROPN-PROPN,appos,compound-pobj,NNP,NNP-NNP,2,1
3627,2126.0,20,is,5,2,17,15,1,2,3,12,168th Brigade Support Battalion,Fort Sill,---,per-per,NOUN-PROPN-PROPN-PROPN,PROPN-PROPN,compound-compound-compound-nsubj,compound-compound,NN-NNP-NNP-NNP,NNP-NNP,7,1
3628,4530.0,27,re-designated,3,6,17,11,5,9,-3,14,168th Brigade Support Battalion,Fort Sill,org-org-org-org,-,NOUN-PROPN-PROPN-PROPN,PROPN-PROPN,compound-compound-compound-dobj,compound-pobj,NN-NNP-NNP-NNP,NNP-NNP,4,1
3629,2127.0,28,named,4,6,6,0,5,21,-2,2,Houghton College,Houghton,per-per,,PROPN-PROPN,PROPN,compound-compound,pobj,NNP-NNP,NNP,0,1
3630,6621.0,28,is,4,1,1,0,0,26,3,-3,Houghton College,Houghton,-,org,PROPN-PROPN,PROPN,compound-nmod,pobj,NNP-NNP,NNP,0,1
3631,2128.0,44,is,15,13,19,6,12,24,2,4,Jon Bon Jovi,musician,org-org-org,,PROPN-PROPN-PROPN,ADJ,compound-compound-pobj,amod,NNP-NNP-NNP,JJ,8,1
3632,2129.0,25,is,1,11,21,10,10,3,-10,20,People's Justice Party,Wan Azizah Wan Ismail,--,per-per-per-per,PROPN-PROPN-PROPN,PROPN-PROPN-PROPN-PROPN,compound-compound-conj,compound-compound-compound-appos,NNP-NNP-NNP,NNP-NNP-NNP-NNP,8,1
3633,2130.0,97,is,1,20,34,14,19,62,-19,33,Jerry Garcia,California,-,org,PROPN-PROPN,PROPN,compound-pobj,pobj,NNP-NNP,NNP,7,1
3634,2131.0,21,is,1,1,12,11,0,8,0,11,He,Philippines,,per,PRON,PROPN,nsubj,compound,PRP,NNP,5,1
3635,9238.0,21,is,1,1,15,14,0,5,0,14,He,Philippines,per,,PRON,PROPN,nsubj,pobj,PRP,NNPS,4,1
3636,2133.0,45,went,1,15,23,8,14,21,-14,22,McMicken College of Arts and Sciences,University of Cincinnati,org-org-org-org-org-org,--,PROPN-PROPN-ADP-PROPN-CCONJ-PROPN,PROPN-ADP-PROPN,compound-pobj-prep-pobj-cc-conj,pobj-prep-pobj,NNP-NNP-IN-NNPS-CC-NNPS,NNP-IN-NNP,5,1
3637,2134.0,17,serving,6,4,9,5,3,7,2,3,Sir Lloyd,Barbados,org-org,,PROPN-PROPN,PROPN,compound-nsubj,poss,NNP-NNP,NNP,5,1
3638,2135.0,31,are,5,1,18,17,0,12,4,13,Kyrgyzstan,Kurmanbek Bakiyev,,org-org,PROPN,PROPN-PROPN,poss,compound-nsubj,NNP,NNP-NNP,6,1
3639,2136.0,23,born,4,1,13,12,0,9,3,9,Ian Douglas Smith,Rhodesia,--,per,PROPN-PROPN-PROPN,PROPN,compound-compound-nsubjpass,pobj,NNP-NNP-NNP,NNP,7,1
3640,2137.0,49,says,8,19,44,25,18,4,-11,36,Chen Shui-bian,DPP,-,org,PROPN-ADJ,PROPN,compound-amod,appos,NNP-JJ,NNP,10,1
3641,6959.0,27,took,16,2,15,13,1,11,14,-1,Chen Shui-bian,DPP,-,per,PROPN-PROPN,PROPN,compound-nsubj,appos,NNP-NNP,NNP,7,1
3642,2138.0,27,is,2,11,17,6,10,9,-9,15,Surrey,Lord Tweedsmuir Secondary School,,per-per-per-per,PROPN,PROPN-PROPN-PROPN-PROPN,pobj,compound-compound-compound-pobj,NNP,NNP-NNP-NNP-NNP,4,1
3643,2139.0,29,Halifax,1,3,6,3,2,22,-2,5,NDP,Alexa McDonough,org,-,PROPN,PROPN-PROPN,appos,compound-pobj,NNP,NNP-NNP,2,1
3644,2140.0,18,is,10,3,14,11,2,3,7,4,Vlad,producer,org,,PROPN,NOUN,compound,compound,NNP,NN,3,1
3645,2141.0,26,include,19,6,13,7,5,12,13,-6,KEB,South Korea,org,-,PROPN,PROPN-PROPN,pobj,compound-pobj,NNP,NNP-NNP,3,1
3646,2142.0,34,Way,1,1,24,23,0,9,0,23,The Morning Of,Tragic Hero Records,per-per-per,--,DET-NOUN-ADP,PROPN-PROPN-PROPN,det-nsubjpass-prep,compound-compound-pobj,DT-NN-IN,NNP-NNP-NNPS,-1,1
3647,2143.0,24,considered,1,16,22,6,15,1,-15,21,Civic Democratic Party,Mirek Topolanek,--,per-per,PROPN-PROPN-PROPN,PROPN-PROPN,compound-compound-pobj,compound-pobj,NNP-NNP-NNP,NNP-NNP,3,1
3648,2144.0,37,represented,8,4,16,12,3,20,4,8,Tennessee State University,National Collegiate Athletic Association,per-per-per,---,PROPN-PROPN-PROPN,PROPN-PROPN-PROPN-PROPN,compound-compound-dobj,compound-compound-compound-pobj,NNP-NNP-NNP,NNP-NNP-NNP-NNP,7,1
3649,2145.0,17,is,3,1,11,10,0,5,2,8,Seton Hall University,South Orange,per-per-per,-,PROPN-PROPN-PROPN,PROPN-PROPN,compound-compound-nsubj,compound-compound,NNP-NNP-NNP,NNP-NNP,7,1
3650,2146.0,36,Institute,1,15,18,3,14,17,-14,17,Taichung County,Ming-Dao High School,-,per-per-per,PROPN-PROPN,PROPN-PROPN-PROPN,compound-poss,compound-compound-pobj,NNP-NNP,NNP-NNP-NNP,3,1
3651,2147.0,13,was,2,7,12,5,6,0,-5,10,Leo,Ariadne,,org,PROPN,PROPN,compound,pobj,NNP,NNP,4,1
3652,2149.0,22,founded,7,5,12,7,4,9,2,5,Best Co.,New York,-,per-per,PROPN-PROPN,PROPN-PROPN,compound-pobj,compound-compound,NNP-NNP,NNP-NNP,6,1
3653,2150.0,40,been,1,22,27,5,21,12,-21,26,United States Football League,Baltimore Stars,per-per-per-per,-,PROPN-PROPN-PROPN-PROPN,PROPN-PROPN,compound-compound-compound-poss,compound-pobj,NNP-NNP-NNP-NNP,NNP-NNPS,4,1
3654,2151.0,35,is,6,14,16,2,13,18,-8,10,Interpol,International Criminal Police Organization,per,---,PROPN,PROPN-PROPN-PROPN-PROPN,pobj,compound-compound-compound-ROOT,NNP,NNP-NNP-NNP-NNP,2,1
3655,9281.0,35,detained,7,10,28,18,9,6,-3,21,Interpol,International Criminal Police Organization,,org-org-org-org,PROPN,PROPN-PROPN-PROPN-PROPN,compound,nmod-compound-compound-conj,NNP,NNP-NNP-NNP-NNP,9,1
3656,2152.0,34,is,4,1,33,32,0,0,3,29,Ghada Al-Samman,poet,-,org,PROPN-PROPN,NOUN,compound-nsubj,attr,NNP-NNP,NN,6,1
3657,2153.0,35,demolished,3,8,12,4,7,22,-5,9,federal investigation agency,FIA,--,per,ADJ-NOUN-NOUN,PROPN,amod-compound-pobj,nmod,JJ-NN-NN,NNP,3,1
3658,2155.0,52,founded,2,22,29,7,21,22,-20,27,University of the Philippines,Diliman,org-org-org-org,,PROPN-ADP-DET-PROPN,PROPN,pobj-prep-det-nmod,compound,NNP-IN-DT-NNP,NNP,4,1
3659,8114.0,28,is,8,23,27,4,22,0,-15,19,University of the Philippines,Diliman,---,per,PROPN-ADP-DET-PROPN,PROPN,pobj-prep-det-compound,pobj,NNP-IN-DT-NNP,NNP,10,1
3660,2157.0,19,moved,4,1,3,2,0,15,3,-1,Italy,Carolina Kostner,org,-,PROPN,PROPN-PROPN,poss,compound-nsubj,NNP,NNP-NNP,2,1
3661,6724.0,24,Kostner,3,1,3,2,0,20,2,0,Italy,Carolina Kostner,per,-,PROPN,PROPN-PROPN,poss,compound-ROOT,NNP,NNP-NNP,2,1
3662,2159.0,71,chose,13,30,39,9,29,31,-17,26,West Virginia Mountaineers,Big East,org-org-org,-,PROPN-PROPN-PROPN,PROPN-PROPN,compound-compound-compound,compound-compound,NNP-NNP-NNP,NNP-NNP,8,1
3663,2160.0,20,was,4,2,4,2,1,15,2,0,Clayton County,C-TRAN,-,org,PROPN-PROPN,PROPN,compound-compound,nsubj,NNP-NNP,NNP,2,1
3664,2162.0,31,is,1,20,25,5,19,5,-19,24,Green Day,Foxboro Hot Tubs,org-org,--,PROPN-PROPN,PROPN-PROPN-PROPN,compound-poss,compound-compound-pobj,NNP-NNP,NNP-NNP-NNP,3,1
3665,2163.0,27,began,4,1,24,23,0,2,3,20,Hooker,Modern,org,,PROPN,PROPN,poss,compound,NNP,NNP,11,1
3666,2164.0,13,left,1,1,8,7,0,4,0,7,He,Los Angeles,org,-,PRON,PROPN-PROPN,nsubj,compound-compound,PRP,NNP-NNP,4,1
3667,6464.0,39,earned,1,1,15,14,0,23,0,14,He,Los Angeles,org,-,PRON,PROPN-PROPN,nsubj,compound-attr,PRP,NNP-NNP,3,1
3668,2165.0,27,is,17,1,23,22,0,3,16,6,Paola,Albert II of Belgium,org,---,PROPN,PROPN-PROPN-ADP-PROPN,compound,compound-pobj-prep-pobj,NNP,NNP-NNP-IN-NNP,-1,1
3669,2166.0,28,is,10,1,23,22,0,4,9,13,Dan Cristian Diaconescu,DDTV,per-per-per,,PROPN-PROPN-PROPN,PROPN,compound-compound-nsubj,pobj,NNP-NNP-NNP,NNP,7,1
3670,2167.0,18,was,5,3,17,14,2,0,2,12,Abubakar Tafawa Balewa,Nigeria,org-org-org,,PROPN-PROPN-PROPN,PROPN,compound-compound-nsubj,pobj,NNP-NNP-NNP,NNP,3,1
3671,2378.0,19,is,7,1,18,17,0,0,6,11,Abubakar Tafawa Balewa,Nigeria,org-org-org,,PROPN-PROPN-PROPN,PROPN,compound-compound-compound,pobj,NNP-NNP-NNP,NNP,3,1
3672,7083.0,32,chose,2,20,27,7,19,4,-18,25,Abubakar Tafawa Balewa,Nigeria,org-org-org,,PROPN-PROPN-PROPN,PROPN,compound-compound-dobj,poss,NNP-NNP-NNP,NNP,6,1
3673,13387.0,17,established,6,2,16,14,1,0,4,10,Abubakar Tafawa Balewa,Nigeria,org-org-org,,PROPN-PROPN-PROPN,PROPN,compound-compound-compound,pobj,NNP-NNP-NNP,NNP,3,1
3674,13409.0,35,holds,1,28,34,6,27,0,-27,33,Abubakar Tafawa Balewa,Nigeria,--,org,PROPN-PROPN-PROPN,PROPN,compound-compound-compound,pobj,NNP-NNP-NNP,NNP,8,1
3675,2168.0,26,said,6,22,25,3,21,0,-16,19,Colby College,Waterville,-,org,PROPN-PROPN,PROPN,compound-pobj,pobj,NNP-NNP,NNP,3,1
3676,2169.0,57,is,3,12,27,15,11,29,-9,24,Ahmad Jamal,Argo,org-org,,PROPN-PROPN,PROPN,compound-pobj,compound,NNP-NNP,NNP,8,1
3677,11456.0,56,is,4,1,30,29,0,25,3,26,Ahmad Jamal,Argo,per-per,,PROPN-PROPN,PROPN,compound-poss,compound,NNP-NNP,NNP,10,1
3678,2170.0,54,were,2,36,49,13,35,4,-34,47,Gytha,Harold Godwinson,,per-per,PROPN,PROPN-PROPN,conj,compound-compound,NNP,NNP-NNP,7,1
3679,2171.0,28,Lehman,1,1,2,1,0,25,0,1,Henry Lehman,Lehman Brothers,-,per-per,PROPN-PROPN,PROPN-PROPN,compound-ROOT,nmod-nmod,NNP-NNP,NNP-NNPS,2,1
3680,10692.0,22,is,11,1,2,1,0,19,10,-9,Henry Lehman,Lehman Brothers,-,per-per,PROPN-PROPN,PROPN-PROPN,compound-nsubj,compound-dobj,NNP-NNP,NNP-NNPS,2,1
3681,2172.0,43,After,0,7,13,6,6,29,-7,13,8th Infantry Division,Army,--,per,PROPN-PROPN-PROPN,PROPN,compound-compound-nsubj,pobj,NNP-NNP-NNP,NNP,2,1
3682,2173.0,11,is,3,1,8,7,0,2,2,5,Michael Prue,Beaches East York,-,org-org-org,PROPN-PROPN,PROPN-PROPN-PROPN,compound-nsubj,compound-compound-pobj,NNP-NNP,NNP-NNP-NNP,5,1
3683,2175.0,13,dies,9,6,8,2,5,4,3,-1,Malta,Andrew Bertie,,per-per,PROPN,PROPN-PROPN,compound,compound-pobj,NNP,NNP-NNP,1,1
3684,2176.0,89,placed,10,21,23,2,20,65,-11,13,Iceland,Oddsson,,per,PROPN,PROPN,pobj,nsubj,NNP,NNP,2,1
3685,6554.0,23,was,1,9,13,4,8,9,-8,12,Iceland,Oddsson,org,,PROPN,PROPN,pobj,dobj,NNP,NNP,3,1
3686,12466.0,16,clarified,7,4,6,2,3,9,3,-1,Iceland,Oddsson,,per,PROPN,PROPN,pobj,nsubj,NNP,NNP,3,1
3687,2177.0,35,provide,5,4,10,6,3,24,1,5,Asiana Airlines,Seoul,per-per,,PROPN-PROPN,PROPN,conj-nsubj,pobj,NNP-NNPS,NNP,4,1
3688,2179.0,39,appointed,19,29,34,5,28,4,-10,15,Morarji Desai,India,-,per,PROPN-PROPN,PROPN,compound-appos,poss,NNP-NNP,NNP,5,1
3689,8704.0,28,was,8,19,23,4,18,4,-11,15,Morarji Desai,India,-,per,PROPN-PROPN,PROPN,compound-compound,pobj,NNP-NNP,NNP,5,1
3690,9471.0,31,was,1,8,27,19,7,3,-7,26,Morarji Desai,India,per-per,,PROPN-PROPN,PROPN,compound-poss,compound,NNP-NNP,NNP,10,1
3691,9620.0,60,replied,19,2,47,45,1,12,17,28,Morarji Desai,India,-,per,PROPN-PROPN,PROPN,compound-nsubjpass,pobj,NNP-NNP,NNP,6,1
3692,10468.0,14,was,3,9,13,4,8,0,-6,10,Morarji Desai,India,-,per,PROPN-PROPN,PROPN,compound-compound,pobj,NNP-NNP,NNP,5,1
3693,12307.0,43,led,2,7,23,16,6,19,-5,21,Morarji Desai,India,per-per,,PROPN-PROPN,PROPN,nmod-amod,pobj,NNP-NNP,NNP,8,1
3694,13362.0,28,recommended,2,5,11,6,4,16,-3,9,Morarji Desai,India,org-org,,PROPN-PROPN,PROPN,compound-pobj,pobj,NNP-NNP,NNP,1,1
3695,2181.0,33,In,0,26,31,5,25,1,-26,31,National Reconnaissance Office,Chantilly,per-per-per,,PROPN-PROPN-PROPN,PROPN,compound-compound-pobj,compound,NNP-NNP-NNP,NNP,10,1
3696,2182.0,13,convey,4,8,11,3,7,1,-4,7,Zimbabwe,Morgan Tsvangirai,org,-,PROPN,PROPN-PROPN,poss,compound-pobj,NNP,NNP-NNP,2,1
3697,6701.0,32,entered,6,2,24,22,1,7,4,18,Zimbabwe,Morgan Tsvangirai,per,-,PROPN,PROPN-PROPN,compound,compound-conj,NNP,NNP-NNP,3,1
3698,12848.0,30,says,5,1,4,3,0,25,4,-1,Zimbabwe,Morgan Tsvangirai,,per-per,PROPN,PROPN-PROPN,compound,compound-nsubj,NNP,NNP-NNP,2,1
3699,2183.0,31,decided,3,3,12,9,2,18,0,9,she,Finland,per,,PRON,PROPN,nsubj,pobj,PRP,NNP,4,1
3700,2185.0,25,happens,4,17,23,6,16,1,-13,19,President,him,,org,PROPN,PRON,compound,nsubj,NNP,PRP,5,1
3701,2186.0,22,produced,3,19,20,1,18,1,-16,17,singer,Jerry Butler,,org-org,NOUN,PROPN-PROPN,compound,compound-pobj,NN,NNP-NNP,1,1
3702,2187.0,28,tried,14,8,13,5,7,14,6,-1,Castro,Cuba,per,,PROPN,PROPN,pobj,pobj,NNP,NNP,7,1
3703,5409.0,33,met,7,11,32,21,10,0,-4,25,Castro,Cuba,,org,PROPN,PROPN,dobj,pobj,NNP,NNP,7,1
3704,9066.0,35,elected,9,30,34,4,29,0,-21,25,Castro,Cuba,per,,PROPN,PROPN,dobj,pobj,NNP,NNP,6,1
3705,10694.0,28,elected,9,8,21,13,7,6,1,12,Castro,Cuba,org,,PROPN,PROPN,nsubjpass,poss,NNP,NNP,8,1
3706,14123.0,32,retained,11,2,18,16,1,13,9,7,Castro,Cuba,,per,PROPN,PROPN,nsubj,pobj,NNP,NNP,3,1
3707,2188.0,46,served,1,8,19,11,7,26,-7,18,U.S. House,Gerald Ford,-,per-per,PROPN-PROPN,PROPN-PROPN,compound-pobj,compound-pobj,NNP-NNP,NNP-NNP,8,1
3708,2189.0,77,is,4,20,75,55,19,1,-16,71,North Carolina,NCANG,-,per,PROPN-PROPN,PROPN,compound-compound,appos,NNP-NNP,NNP,-1,1
3709,2190.0,19,said,6,5,9,4,4,9,1,3,Joe,Washington,,per,PROPN,PROPN,compound,nsubj,NNP,NNP,2,1
3710,10841.0,34,said,12,11,14,3,10,19,1,2,Joe,Washington,,org,PROPN,PROPN,compound,nsubj,NNP,NNP,2,1
3711,2193.0,27,served,1,8,25,17,7,1,-7,24,Ontario,David Peterson,per,-,PROPN,PROPN-PROPN,pobj,compound-pobj,NNP,NNP-NNP,7,1
3712,2194.0,30,was,7,10,23,13,9,6,-3,16,Ulysses S. Grant,United States,per-per-per,-,PROPN-PROPN-PROPN,PROPN-PROPN,compound-compound-nsubj,compound-compound,NNP-NNP-NNP,NNP-NNP,6,1
3713,5999.0,50,was,14,3,21,18,2,28,11,7,Ulysses S. Grant,United States,--,org-org,PROPN-PROPN-PROPN,PROPN-PROPN,compound-compound-nsubj,compound-compound,NNP-NNP-NNP,NNP-NNP,6,1
3714,2195.0,22,University,1,16,19,3,15,2,-15,18,Utah State University,Logan,org-org-org,,PROPN-PROPN-PROPN,PROPN,compound-compound-compound,compound,NNP-NNP-NNP,NNP,3,1
3715,2196.0,16,created,5,4,8,4,3,7,1,3,Argentina,Manuel Belgrano,,per-per,PROPN,PROPN-PROPN,pobj,compound-pobj,NNP,NNP-NNP,3,1
3716,2197.0,29,are,10,17,8,-9,16,20,-7,-2,General Confederation of Democratic Workers,Colombia,per-per-per-per-per,,PROPN-PROPN-ADP-PROPN-PROPN,PROPN,compound-appos-prep-compound-pobj,pobj,NNP-NNP-IN-NNP-NNPS,NNP,8,1
3717,2198.0,25,faces,2,1,13,12,0,11,1,11,Russia,Vladimir Putin,per,-,PROPN,PROPN-PROPN,nsubj,compound-nsubj,NNP,NNP-NNP,3,1
3718,8240.0,16,reappointed,9,5,8,3,4,7,4,-1,Russia,Vladimir Putin,,org-org,PROPN,PROPN-PROPN,poss,compound-nsubj,NNP,NNP-NNP,3,1
3719,9751.0,21,confirmed,3,1,19,18,0,1,2,16,Russia,Vladimir Putin,per,-,PROPN,PROPN-PROPN,poss,compound-pobj,NNP,NNP-NNP,7,1
3720,2199.0,21,granted,10,4,10,6,3,10,6,0,Kurt Waldheim,Austria,-,per,PROPN-PROPN,PROPN,compound-pobj,pobj,NNP-NNP,NNP,2,1
3721,4282.0,42,Waldheim,1,1,20,19,0,21,0,19,Kurt Waldheim,Austria,per-per,,PROPN-PROPN,PROPN,compound-ROOT,pobj,NNP-NNP,NNP,3,1
3722,14119.0,9,meets,3,5,8,3,4,0,-2,5,Kurt Waldheim,Austria,-,org,PROPN-PROPN,PROPN,compound-dobj,pobj,NNP-NNP,NNP,2,1
3723,2200.0,45,is,1,10,22,12,9,22,-9,21,Viggo Larsen,Denmark,-,per,PROPN-PROPN,PROPN,compound-nsubjpass,nsubj,NNP-NNP,NNP,9,1
3724,2201.0,20,Students,0,8,8,0,7,11,-8,8,Needville High School,Needville Independent School District,per-per-per,---,PROPN-PROPN-PROPN,PROPN-PROPN-PROPN-PROPN,compound-compound-appos,compound-compound-compound-pobj,NNP-NNP-NNP,NNP-NNP-NNP-NNP,0,1
3725,2202.0,21,marks,1,11,19,8,10,1,-10,18,Mbeki,ANC,,per,ADJ,PROPN,compound,compound,JJ,NNP,5,1
3726,2203.0,21,Ohio,1,1,13,12,0,7,0,12,Cleveland,Case Western Reserve University School of Medicine,,org-org-org-org-org-org-org,PROPN,PROPN-PROPN-PROPN-PROPN-PROPN-ADP-PROPN,compound,compound-compound-compound-compound-ROOT-prep-pobj,NNP,NNP-NNP-NNP-NNP-NNP-IN-NNP,-1,1
3727,2204.0,42,said,13,2,6,4,1,35,11,-7,Simon Hughes,Dem,per-per,,PROPN-PROPN,PROPN,compound-nsubj,compound,NNP-NNP,NNP,1,1
3728,2205.0,27,jpg,0,5,8,3,4,18,-5,8,Tommy Thompson,Wisconsin,-,org,PROPN-PROPN,PROPN,compound-npadvmod,compound,NNP-NNP,NNP,2,1
3729,5182.0,43,moderated,9,29,34,5,28,8,-20,25,Tommy Thompson,Wisconsin,org-org,,PROPN-PROPN,PROPN,nmod-conj,pobj,NNP-NNP,NNP,6,1
3730,5834.0,60,worked,5,9,12,3,8,47,-4,7,Tommy Thompson,Wisconsin,-,per,PROPN-PROPN,PROPN,compound-pobj,pobj,NNP-NNP,NNP,3,1
3731,6150.0,26,On,0,13,20,7,12,5,-13,20,Tommy Thompson,Wisconsin,-,per,PROPN-PROPN,PROPN,compound-conj,compound,NNP-NNP,NNP,4,1
3732,6245.0,39,Prior,0,12,28,16,11,10,-12,28,Tommy Thompson,Wisconsin,-,org,PROPN-PROPN,PROPN,compound-pobj,compound,NNP-NNP,NNP,8,1
3733,8327.0,34,are,2,4,9,5,3,24,-2,7,Tommy Thompson,Wisconsin,-,per,PROPN-PROPN,PROPN,nmod-nmod,pobj,NNP-NNP,NNP,2,1
3734,12586.0,40,began,7,2,12,10,1,27,5,5,Tommy Thompson,Wisconsin,-,org,PROPN-PROPN,PROPN,nmod-nmod,compound,NNP-NNP,NNP,4,1
3735,2207.0,26,owned,5,9,24,15,8,1,-4,19,WinCo Foods,Boise,-,per,PROPN-PROPN,PROPN,compound-compound,compound,NNP-NNPS,NNP,7,1
3736,2208.0,39,said,8,16,24,8,15,14,-8,16,Cerberus Capital Management,Chrysler,per-per-per,,PROPN-PROPN-PROPN,PROPN,compound-compound-compound,pobj,NNP-NNP-NNP,NNP,3,1
3737,2209.0,17,refers,9,1,7,6,0,9,8,-2,Citgo,de Venezuela S.A.,org,--,VERB,X-PROPN-PROPN,nsubj,compound-compound-pobj,VB,FW-NNP-NNP,5,1
3738,2210.0,28,sold,5,10,14,4,9,13,-5,9,George Wimpey,Taylor Wimpey,-,per-per,PROPN-PROPN,PROPN-PROPN,compound-pobj,compound-appos,NNP-NNP,NNP-NNP,1,1
3739,2211.0,11,joined,4,6,8,2,5,2,-2,4,Dubstar,Food,,org,PROPN,PROPN,dobj,compound,NNP,NNP,2,1
3740,2212.0,27,was,1,19,26,7,18,0,-18,25,Khama,Botswana,,per,PROPN,PROPN,nsubj,attr,NNP,NNP,4,1
3741,2213.0,15,merged,10,6,14,8,5,0,4,4,United Garment Workers of America,UFCW,per-per-per-per-per,,PROPN-PROPN-PROPN-ADP-PROPN,PROPN,compound-compound-nsubj-prep-pobj,pobj,NNP-NNP-NNPS-IN-NNP,NNP,3,1
3742,2214.0,30,resigned,7,1,5,4,0,24,6,-2,Algeria,Ahmed Ouyahia,per,-,PROPN,PROPN-PROPN,poss,compound-appos,NNP,NNP-NNP,3,1
3743,6971.0,25,said,21,5,20,15,4,4,16,-1,Algeria,Ahmed Ouyahia,,per-per,PROPN,PROPN-PROPN,pobj,compound-nsubj,NNP,NNP-NNP,3,1
3744,12139.0,56,adopted,40,22,27,5,21,28,18,-13,Algeria,Ahmed Ouyahia,,per-per,PROPN,PROPN-PROPN,poss,compound-appos,NNP,NNP-NNP,3,1
3745,12979.0,30,was,6,1,5,4,0,24,5,-1,Algeria,Ahmed Ouyahia,org,-,PROPN,PROPN-PROPN,poss,compound-nsubj,NNP,NNP-NNP,3,1
3746,2215.0,17,issued,5,1,13,12,0,3,4,8,Their,Go,,org,DET,VERB,poss,conj,PRP$,VB,4,1
3747,2216.0,23,is,8,14,17,3,13,5,-6,9,Yang Huiyan,Country Garden,per-per,-,PROPN-PROPN,PROPN-PROPN,compound-ROOT,compound-pobj,NNP-NNP,NNP-NNP,2,1
3748,2217.0,59,are,4,34,30,-4,33,28,-30,26,James Stevenson,UK,-,org,PROPN-PROPN,PROPN,compound-appos,compound,NNP-NNP,NNP,2,1
3749,4997.0,28,is,7,1,10,9,0,17,6,3,James Stevenson,UK,org-org,,PROPN-PROPN,PROPN,compound-nsubj,nmod,NNP-NNP,NNP,4,1
3750,2218.0,19,attended,1,8,16,8,7,2,-7,15,London,Joyce Grenfell,,org-org,PROPN,PROPN-PROPN,pobj,compound-attr,NNP,NNP-NNP,4,1
3751,2219.0,35,declared,22,7,11,4,6,23,15,-11,Jomo Kenyatta,Kenya,per-per,,PROPN-PROPN,PROPN,compound-pobj,poss,NNP-NNP,NNP,6,1
3752,4268.0,19,is,5,4,14,10,3,4,1,9,Jomo Kenyatta,Kenya,per-per,,PROPN-PROPN,PROPN,compound-pobj,pobj,NNP-NNP,NNP,9,1
3753,7387.0,33,started,3,8,25,17,7,7,-5,22,Jomo Kenyatta,Kenya,-,org,PROPN-PROPN,PROPN,compound-compound,pobj,NNP-NNP,NNP,7,1
3754,10232.0,18,University,2,1,17,16,0,0,1,15,Jomo Kenyatta,Kenya,org-org,,PROPN-PROPN,PROPN,compound-compound,appos,NNP-NNP,NNP,3,1
3755,2220.0,13,joined,3,2,5,3,1,7,1,2,Paul Sykes,Wakefield,-,per,PROPN-PROPN,PROPN,compound-nsubj,compound,NNP-NNP,NNP,3,1
3756,2221.0,25,is,1,19,22,3,18,2,-18,21,Kim Il-Sung,Pyongyang,org-org,,PROPN-PROPN,PROPN,compound-conj,pobj,NNP-NNP,NNP,1,1
3757,2222.0,24,is,3,2,22,20,1,1,1,19,Infiniti,Nissan Motors,org,-,PROPN,PROPN-PROPN,compound,compound-pobj,NNP,NNP-NNPS,9,1
3758,2223.0,22,joined,1,5,13,8,4,8,-4,12,Electronic,EETPU,,org,PROPN,PROPN,nmod,compound,NNP,NNP,4,1
3759,2224.0,39,is,2,1,14,13,0,24,1,12,Eagle Forum,Phyllis Schlafly,-,per-per,PROPN-PROPN,PROPN-PROPN,compound-nsubj,compound-pobj,NNP-NNP,NNP-NNP,5,1
3760,8490.0,13,says,6,8,11,3,7,1,-2,5,Eagle Forum,Phyllis Schlafly,org-org,-,PROPN-PROPN,PROPN-PROPN,compound-compound,compound-nsubj,NNP-NNP,NNP-NNP,2,1
3761,10017.0,23,awarded,3,12,19,7,11,3,-9,16,Eagle Forum,Phyllis Schlafly,-,org-org,PROPN-PROPN,PROPN-PROPN,compound-pobj,compound-pobj,NNP-NNP,NNP-NNP,6,1
3762,10167.0,15,said,8,10,13,3,9,1,-2,5,Eagle Forum,Phyllis Schlafly,-,per-per,PROPN-PROPN,PROPN-PROPN,compound-compound,compound-nsubj,NNP-NNP,NNP-NNP,2,1
3763,13386.0,19,Forum,1,1,6,5,0,12,0,5,Eagle Forum,Phyllis Schlafly,per-per,-,PROPN-PROPN,PROPN-PROPN,compound-ROOT,compound-nsubj,NNP-NNP,NNP-NNP,2,1
3764,2225.0,38,is,1,17,25,8,16,12,-16,24,808 State,UK,org-org,,NUM-NOUN,PROPN,nummod-nsubj,dobj,CD-NN,NNP,-1,1
3765,2227.0,34,is,18,1,8,7,0,25,17,-10,California State University,CSUB,--,org,PROPN-PROPN-PROPN,PROPN,compound-compound-compound,dobj,NNP-NNP-NNP,NNP,4,1
3766,4314.0,36,consist,4,24,29,5,23,6,-20,25,California State University,CSUB,org-org-org,,PROPN-PROPN-PROPN,PROPN,compound-compound-compound,compound,NNP-NNP-NNP,NNP,2,1
3767,2228.0,19,is,1,4,4,0,3,14,-3,3,Barcelona Metro,Barcelona,-,per,PROPN-PROPN,PROPN,compound-compound,compound,NNP-NNP,NNP,0,1
3768,2229.0,37,is,3,1,19,18,0,17,2,16,Lincoln High School,United States,per-per-per,-,PROPN-PROPN-PROPN,PROPN-PROPN,compound-compound-nsubj,compound-pobj,NNP-NNP-NNP,NNP-NNP,7,1
3769,2230.0,21,studied,1,8,7,-1,7,13,-7,6,Berkeley,California Golden Bears,,org-org-org,PROPN,PROPN-PROPN-PROPN,pobj,compound-compound-nmod,NNP,NNP-NNP-NNPS,4,1
3770,8373.0,28,attended,1,15,9,-6,14,18,-14,8,Berkeley,California Golden Bears,per,--,PROPN,PROPN-PROPN-PROPN,conj,compound-compound-compound,NNP,NNP-NNP-NNP,4,1
3771,2231.0,29,include,3,10,7,-3,9,21,-7,4,Sierra Entertainment,Vivendi Games,per-per,-,PROPN-PROPN,PROPN-PROPN,compound-compound,compound-compound,NNP-NNP,NNP-NNPS,2,1
3772,5934.0,29,include,3,10,7,-3,9,21,-7,4,Sierra Entertainment,Vivendi Games,-,per-per,PROPN-PROPN,PROPN-PROPN,compound-compound,compound-compound,NNP-NNP,NNP-NNPS,2,1
3773,2232.0,27,editor-in-chief,2,2,4,2,1,22,0,2,Vogue,Anna Wintour,,per-per,PROPN,PROPN-PROPN,subtok,compound-nsubj,NNP,NNP-NNP,1,1
3774,10821.0,18,escapes,4,10,12,2,9,5,-6,8,Vogue,Anna Wintour,per,-,PROPN,PROPN-PROPN,compound,compound-pobj,NNP,NNP-NNP,1,1
3775,2233.0,32,was,7,9,10,1,8,21,-2,3,drummer,Robert Sweet,per,-,NOUN,PROPN-PROPN,amod,compound-poss,NN,NNP-NNP,2,1
3776,2234.0,36,serves,2,11,18,7,10,17,-9,16,New Zealand national football team,All Whites,per-per-per-per-per,-,PROPN-PROPN-ADJ-NOUN-NOUN,DET-PROPN,nmod-nmod-amod-compound-pobj,det-appos,NNP-NNP-JJ-NN-NN,DT-NNPS,2,1
3777,9739.0,27,was,1,5,12,7,4,14,-4,11,New Zealand national football team,All Whites,per-per-per-per-per,-,PROPN-PROPN-ADJ-NOUN-NOUN,DET-PROPN,nmod-nmod-amod-compound-nsubj,det-appos,NNP-NNP-JJ-NN-NN,DT-NNPS,2,1
3778,2235.0,36,form,4,17,23,6,16,12,-13,19,Tommy Sheridan,Solidarity,per-per,,PROPN-PROPN,PROPN,compound-nsubj,pobj,NNP-NNP,NNP,3,1
3779,3443.0,21,won,10,5,10,5,4,10,5,0,Tommy Sheridan,Solidarity,-,org,PROPN-PROPN,PROPN,compound-conj,nsubj,NNP-NNP,NNP,4,1
3780,6570.0,45,declared,6,23,33,10,22,11,-17,27,Tommy Sheridan,Solidarity,-,per,PROPN-PROPN,PROPN,compound-pobj,compound,NNP-NNP,NNP,7,1
3781,2236.0,39,is,3,1,12,11,0,26,2,9,RTA,Riverside,,org,NOUN,PROPN,compound,pobj,NN,NNP,4,1
3782,2237.0,20,named,5,4,8,4,3,11,1,3,Quebec,his,,org,PROPN,DET,pobj,poss,NNP,PRP$,3,1
3783,2238.0,35,is,8,1,16,15,0,18,7,8,Hang Lung Group,Hong Kong,org-org-org,-,PROPN-PROPN-PROPN,PROPN-PROPN,compound-compound-nsubj,compound-pobj,NNP-NNP-NNP,NNP-NNP,5,1
3784,2239.0,31,comprised,6,2,22,20,1,8,4,16,Pennsylvania Railroad,Philadelphia Pennsylvania,per-per,-,PROPN-PROPN,PROPN-PROPN,compound-poss,compound-compound,NNP-NNP,NNP-NNP,10,1
3785,2240.0,53,assisted,22,21,1,-20,20,51,1,-21,ECW,Edge,,per,PROPN,PROPN,compound,dobj,NNP,NNP,3,1
3786,2241.0,28,started,13,4,16,12,3,11,9,3,North Carolina Agricultural and Technical State University,Greensboro,------,org,PROPN-PROPN-PROPN-CCONJ-PROPN-PROPN-PROPN,PROPN,nmod-nmod-nmod-cc-compound-conj-pobj,compound,NNP-NNP-NNP-CC-NNP-NNP-NNP,NNP,6,1
3787,2242.0,28,founded,3,1,11,10,0,16,2,8,Barings Bank,Francis Baring,org-org,-,PROPN-PROPN,PROPN-PROPN,compound-nsubjpass,conj-compound,NNPS-NNP,NNP-NNP,4,1
3788,2243.0,23,ARLFC,21,7,20,13,6,2,14,-1,Hall Bower,Newsome Panthers,org-org,-,PROPN-PROPN,PROPN-PROPN,compound-compound,compound-pobj,NNP-NNP,NNP-NNPS,10,1
3789,2244.0,23,represented,7,10,18,8,9,4,-3,11,University of Central Florida,Division I,---,org-org,PROPN-ADP-PROPN-PROPN,PROPN-PRON,dobj-prep-compound-pobj,compound-compound,NNP-IN-NNP-NNP,NNP-PRP,5,1
3790,2938.0,38,Is,1,15,29,14,14,8,-14,28,University of Central Florida,Division I,per-per-per-per,-,PROPN-ADP-PROPN-PROPN,PROPN-PRON,pobj-prep-compound-pobj,pobj-nmod,NNP-IN-NNP-NNP,NNP-PRP,9,1
3791,13120.0,36,was,19,11,27,16,10,8,8,8,University of Central Florida,Division I,---,per-per,PROPN-ADP-PROPN-PROPN,PROPN-PRON,pobj-prep-compound-pobj,compound-compound,NNP-IN-NNP-NNP,NNP-PRP,10,1
3792,2245.0,27,contribute,10,1,9,8,0,17,9,-1,MTV Networks,Viacom,-,org,PROPN-PROPN,PROPN,compound-nsubj,pobj,NNP-NNP,NNP,2,1
3793,2246.0,37,awarded,14,6,12,6,5,24,8,-2,University of California,UCSF,org-org-org,,PROPN-ADP-PROPN,PROPN,pobj-prep-pobj,appos,NNP-IN-NNP,NNP,5,1
3794,3153.0,35,University,1,2,8,6,1,26,-1,7,University of California,UCSF,--,per,PROPN-ADP-PROPN,PROPN,ROOT-prep-pobj,appos,NNP-IN-NNP,NNP,4,1
3795,6940.0,18,earned,1,10,16,6,9,1,-9,15,University of California,UCSF,per-per-per,,PROPN-ADP-PROPN,PROPN,pobj-prep-pobj,appos,NNP-IN-NNP,NNP,4,1
3796,8631.0,23,is,3,15,21,6,14,1,-12,18,University of California,UCSF,--,org,PROPN-ADP-PROPN,PROPN,nmod-prep-pobj,appos,NNP-IN-NNP,NNP,3,1
3797,2247.0,40,said,17,24,38,14,23,1,-7,21,Uganda,Milton Obote,,per-per,PROPN,PROPN-PROPN,compound,compound-appos,NNP,NNP-NNP,6,1
3798,8543.0,63,represented,1,45,61,16,44,1,-44,60,Uganda,Milton Obote,org,-,PROPN,PROPN-PROPN,compound,compound-pobj,NNP,NNP-NNP,6,1
3799,2248.0,27,has,14,2,8,6,1,18,12,-6,Harbor-UCLA Medical Center,Los Angeles,org-org-org,-,NOUN-PROPN-PROPN,PROPN-PROPN,compound-compound-nsubj,compound-compound,NN-NNP-NNP,NNP-NNP,6,1
3800,2249.0,17,served,1,13,16,3,12,0,-12,15,Wayne Allard,Colorado,per-per,,PROPN-PROPN,PROPN,compound-pobj,pobj,NNP-NNP,NNP,3,1
3801,7943.0,47,forwarded,3,25,30,5,24,16,-22,27,Wayne Allard,Colorado,-,per,PROPN-PROPN,PROPN,compound-pobj,pobj,NNP-NNP,NNP,4,1
3802,9059.0,33,joins,11,24,27,3,23,5,-13,16,Wayne Allard,Colorado,per-per,,PROPN-PROPN,PROPN,compound-conj,pobj,NNP-NNP,NNP,1,1
3803,11620.0,11,announced,7,3,6,3,2,4,4,-1,Wayne Allard,Colorado,-,org,PROPN-PROPN,PROPN,compound-nsubj,pobj,NNP-NNP,NNP,2,1
3804,2251.0,52,beleaguered,4,16,17,1,15,34,-12,13,Navy,Gideon Welles,,per-per,PROPN,PROPN-PROPN,compound,compound-nsubj,NNP,NNP-NNP,4,1
3805,5481.0,39,won,8,21,24,3,20,14,-13,16,Navy,Gideon Welles,per,-,PROPN,PROPN-PROPN,pobj,compound-pobj,NNP,NNP-NNP,2,1
3806,5490.0,50,called,7,5,6,1,4,43,2,-1,Navy,Gideon Welles,,per-per,PROPN,PROPN-PROPN,compound,compound-pobj,NNP,NNP-NNP,1,1
3807,6408.0,29,named,6,12,13,1,11,15,-6,7,Navy,Gideon Welles,per,-,PROPN,PROPN-PROPN,compound,compound-pobj,NNP,NNP-NNP,1,1
3808,6487.0,127,called,9,53,54,1,52,72,-44,45,Navy,Gideon Welles,,per-per,PROPN,PROPN-PROPN,compound,compound-pobj,NNP,NNP-NNP,1,1
3809,6771.0,34,named,11,9,10,1,8,23,2,-1,Navy,Gideon Welles,org,-,PROPN,PROPN-PROPN,compound,compound-nsubj,NNP,NNP-NNP,1,1
3810,11107.0,31,stated,19,17,18,1,16,12,2,-1,Navy,Gideon Welles,org,-,PROPN,PROPN-PROPN,compound,compound-pobj,NNP,NNP-NNP,1,1
3811,13621.0,77,announced,5,32,34,2,31,42,-27,29,Navy,Gideon Welles,,per-per,PROPN,PROPN-PROPN,compound,compound-pobj,NNP,NNP-NNP,1,1
3812,2252.0,25,played,13,8,12,4,7,12,5,-1,Northridge High School,Dayton,org-org-org,,PROPN-PROPN-PROPN,PROPN,compound-compound-pobj,compound,NNP-NNP-NNP,NNP,3,1
3813,2253.0,26,elected,8,6,12,6,5,13,2,4,Shane Gibson,Parliament,org-org,,PROPN-PROPN,PROPN,compound-nsubjpass,pobj,NNP-NNP,NNP,4,1
3814,9262.0,46,expected,5,21,27,6,20,18,-16,22,Shane Gibson,Parliament,org-org,,PROPN-PROPN,PROPN,compound-nsubjpass,conj,NNP-NNP,NNP,5,1
3815,2254.0,50,is,10,6,6,0,5,43,4,-4,Hainan,Hainan Airlines,org,-,PROPN,PROPN-PROPN,compound,compound-pobj,NNP,NNP-NNPS,0,1
3816,2255.0,26,performed,3,8,10,2,7,15,-5,7,Turkey,Kenan Do?ul,org,-,PROPN,PROPN-ADP,poss,pobj-aux,NNP,NNP-IN,3,1
3817,2256.0,29,represents,2,1,24,23,0,4,1,22,No Age,Sub Pop,org-org,-,DET-PROPN,PROPN-PROPN,det-nsubj,compound-compound,DT-NNP,NNP-NNP,5,1
3818,6430.0,18,is,2,12,16,4,11,1,-10,14,No Age,Sub Pop,-,per-per,DET-NOUN,PROPN-PROPN,det-nsubj,compound-pobj,DT-NN,NNP-NNP,3,1
3819,8100.0,22,Everything,0,12,20,8,11,1,-12,20,No Age,Sub Pop,per-per,-,DET-PROPN,PROPN-PROPN,det-ROOT,compound-pobj,DT-NNP,NNP-NNP,3,1
3820,9764.0,20,Buoyed,0,9,18,9,8,1,-9,18,No Age,Sub Pop,-,org-org,DET-NOUN,PROPN-PROPN,det-nsubj,compound-appos,DT-NN,NNP-NNP,4,1
3821,2257.0,44,reaffirmed,15,8,12,4,7,31,7,-3,Kenya,Raila Odinga,,org-org,PROPN,PROPN-PROPN,poss,compound-appos,NNP,NNP-NNP,3,1
3822,3064.0,28,took,1,15,23,8,14,4,-14,22,Kenya,Raila Odinga,,org-org,PROPN,PROPN-PROPN,pobj,compound-pobj,NNP,NNP-NNP,6,1
3823,4880.0,18,say,1,3,16,13,2,1,-2,15,Kenya,Raila Odinga,per,-,PROPN,PROPN-PROPN,poss,compound-pobj,NNP,NNP-NNP,7,1
3824,5946.0,39,became,7,15,19,4,14,19,-8,12,Kenya,Raila Odinga,org,-,PROPN,PROPN-PROPN,pobj,compound-compound,NNP,NNP-NNP,4,1
3825,6246.0,39,said,37,12,34,22,11,4,25,-3,Kenya,Raila Odinga,,org-org,PROPN,PROPN-PROPN,poss,compound-conj,NNP,NNP-NNP,-1,1
3826,7555.0,35,reached,12,1,9,8,0,25,11,-3,Kenya,Raila Odinga,per,-,PROPN,PROPN-PROPN,compound,compound-conj,NNP,NNP-NNP,4,1
3827,7598.0,37,Kenya,19,20,35,15,19,1,-1,16,Kenya,Raila Odinga,per,-,PROPN,PROPN-PROPN,ROOT,compound-pobj,NNP,NNP-NNP,10,1
3828,10040.0,27,called,9,1,6,5,0,20,8,-3,Kenya,Raila Odinga,org,-,PROPN,PROPN-PROPN,poss,compound-appos,NNP,NNP-NNP,3,1
3829,10569.0,13,meet,8,1,6,5,0,6,7,-2,Kenya,Raila Odinga,per,-,PROPN,PROPN-PROPN,poss,compound-conj,NNP,NNP-NNP,3,1
3830,12286.0,40,suggest,2,34,35,1,33,4,-32,33,Kenya,Raila Odinga,per,-,PROPN,PROPN-PROPN,compound,compound-pobj,NNP,NNP-NNP,1,1
3831,2258.0,70,established,3,23,26,3,22,43,-20,23,Cornell University,USA,-,org,PROPN-PROPN,PROPN,conj-conj,compound,NNP-NNP,NNP,3,1
3832,2259.0,17,was,6,1,5,4,0,11,5,-1,Rajiv Gandhi,Sonia Gandhi,-,org-org,PROPN-PROPN,PROPN-PROPN,compound-poss,compound-appos,NNP-NNP,NNP-NNP,2,1
3833,2260.0,21,resumed,4,6,7,1,5,13,-2,3,his,Depeche Mode,,org-org,DET,PROPN-PROPN,poss,compound-compound,PRP$,NNP-NNP,1,1
3834,2261.0,17,included,2,8,15,7,7,1,-6,13,Interpipe Group,Viktor Pinchuk,-,per-per,PROPN-PROPN,PROPN-PROPN,compound-conj,compound-pobj,NNP-NNP,NNP-NNP,6,1
3835,2262.0,13,lived,1,1,12,11,0,0,0,11,She,Canada,,org,PRON,PROPN,nsubj,pobj,PRP,NNP,1,1
3836,2263.0,36,banned,4,26,31,5,25,4,-22,27,Olga Knipper,Anton Chekhov,per-per,-,PROPN-PROPN,PROPN-PROPN,compound-conj,compound-pobj,NNP-NNP,NNP-NNP,3,1
3837,2264.0,36,found,1,1,13,12,0,22,0,12,Hepburn,Connecticut,per,,PROPN,PROPN,nsubj,compound,NNP,NNP,4,1
3838,2265.0,36,suspended,10,5,30,25,4,5,5,20,Libyan Airlines,Libya,-,per,PROPN-PROPN,PROPN,compound-nsubj,compound,NNP-NNPS,NNP,6,1
3839,2266.0,26,is,8,2,22,20,1,3,6,14,Santa Fe Indian School,New Mexico,org-org-org-org,-,PROPN-PROPN-PROPN-PROPN,PROPN-PROPN,compound-compound-compound-nsubj,compound-compound,NNP-NNP-NNP-NNP,NNP-NNP,6,1
3840,2267.0,19,is,3,1,1,0,0,17,2,-2,Notre Dame,Notre Dame Fighting Irish,per-per,---,PROPN-PROPN,PROPN-PROPN-VERB-ADJ,compound-compound,pobj-pobj-advcl-amod,NNP-NNP,NNP-NNP-VBG-JJ,0,1
3841,2268.0,20,held,9,2,14,12,1,5,7,5,New Mexico,Jeff Bingaman,-,org-org,PROPN-PROPN,PROPN-PROPN,compound-poss,compound-pobj,NNP-NNP,NNP-NNP,4,1
3842,3053.0,22,gave,10,1,4,3,0,17,9,-6,New Mexico,Jeff Bingaman,-,org-org,PROPN-PROPN,PROPN-PROPN,compound-compound,compound-poss,NNP-NNP,NNP-NNP,2,1
3843,2269.0,24,initiated,13,5,12,7,4,11,8,-1,University of Pittsburgh,USA,--,per,PROPN-ADP-PROPN,PROPN,nmod-prep-pobj,pobj,NNP-IN-NNP,NNP,6,1
3844,2270.0,31,fled,3,2,19,17,1,11,1,16,Lon Nol,Governing Council,-,org-org,PROPN-PROPN,PROPN-PROPN,compound-nsubj,compound-pobj,NNP-NNP,NNP-NNP,6,1
3845,2271.0,12,Washington,10,6,11,5,5,0,4,1,Bill Melinda Gates Foundation,Washington,---,per,PROPN-PROPN-PROPN-PROPN,PROPN,compound-compound-compound-compound,ROOT,NNP-NNP-NNP-NNP,NNP,4,1
3846,2273.0,28,was,16,18,26,8,17,1,-2,10,Erich Mielke,State Security,per-per,-,PROPN-PROPN,PROPN-PROPN,compound-attr,pobj-appos,NNP-NNP,NNP-NNP,4,1
3847,2274.0,43,studied,2,1,15,14,0,27,1,13,Mark Wood,Port Washington,per-per,-,PROPN-PROPN,PROPN-PROPN,compound-nsubj,compound-compound,NNP-NNP,NNP-NNP,6,1
3848,2276.0,41,stated,5,1,25,24,0,15,4,20,MTV Philippines,Lisette Buendia,per-per,-,PROPN-PROPN,PROPN-PROPN,compound-compound,compound-appos,NNP-NNP,NNP-NNP,9,1
3849,2278.0,23,won,6,4,12,8,3,10,2,6,Stephen Harper,Canada,per-per,,PROPN-PROPN,PROPN,compound-nsubj,poss,NNP-NNP,NNP,6,1
3850,5142.0,23,said,4,3,6,3,2,16,1,2,Stephen Harper,Canada,-,per,PROPN-PROPN,PROPN,compound-nsubj,nsubj,NNP-NNP,NNP,3,1
3851,5441.0,29,contested,3,16,28,12,15,0,-13,25,Stephen Harper,Canada,-,org,PROPN-PROPN,PROPN,compound-pobj,pobj,NNP-NNP,NNP,6,1
3852,6235.0,22,was,4,6,21,15,5,0,-2,17,Stephen Harper,Canada,org-org,,PROPN-PROPN,PROPN,compound-attr,pobj,NNP-NNP,NNP,5,1
3853,6516.0,32,announced,4,3,24,21,2,7,1,20,Stephen Harper,Canada,-,org,PROPN-PROPN,PROPN,compound-nsubj,pobj,NNP-NNP,NNP,12,1
3854,9260.0,26,appointed,7,4,16,12,3,9,3,9,Stephen Harper,Canada,-,org,PROPN-PROPN,PROPN,compound-nsubj,poss,NNP-NNP,NNP,6,1
3855,9631.0,22,invited,4,3,15,12,2,6,1,11,Stephen Harper,Canada,org-org,,PROPN-PROPN,PROPN,compound-nsubj,dobj,NNP-NNP,NNP,3,1
3856,12066.0,62,Perrin,7,30,35,5,29,26,-23,28,Stephen Harper,Canada,per-per,,PROPN-PROPN,PROPN,compound-compound,pobj,NNP-NNP,NNP,6,1
3857,13056.0,29,includes,9,8,28,20,7,0,1,19,Stephen Harper,Canada,-,org,PROPN-PROPN,PROPN,compound-pobj,pobj,NNP-NNP,NNP,9,1
3858,13909.0,29,capitalized,11,23,28,5,22,0,-12,17,Stephen Harper,Canada,org-org,,PROPN-PROPN,PROPN,compound-compound,pobj,NNP-NNP,NNP,2,1
3859,2279.0,22,moved,8,18,21,3,17,0,-10,13,Hero Cycles,1956,org-org,,PROPN-PROPN,NUM,compound-oprd,pobj,NNP-NNPS,CD,5,1
3860,2280.0,27,was,3,11,17,6,10,9,-8,14,Grant McLennan,singer,org-org,,PROPN-PROPN,NOUN,compound-pobj,compound,NNP-NNP,NN,8,1
3861,2281.0,39,recognized,30,3,3,0,2,35,27,-27,California,California National Guard,,org-org-org,PROPN,PROPN-PROPN-PROPN,compound,compound-compound-pobj,NNP,NNP-NNP-NNP,0,1
3862,2282.0,36,are,4,12,12,0,11,23,-8,8,British Army,British Armed Forces,-,per-per-per,PROPN-PROPN,PROPN-PROPN-PROPN,compound-pobj,compound-compound-pobj,NNP-NNP,NNP-NNP-NNPS,0,1
3863,2283.0,41,play,3,2,21,19,1,19,1,18,he,Slayer,org,,PRON,PROPN,nsubj,nsubj,PRP,NNP,-1,1
3864,2284.0,23,elected,12,9,19,10,8,3,3,7,Timothy Chad Hutchinson,Arkansas,per-per-per,,PROPN-PROPN-PROPN,PROPN,compound-compound-nsubjpass,compound,NNP-NNP-NNP,NNP,5,1
3865,2285.0,25,gave,3,8,21,13,7,3,-5,18,Billy J. Kramer,Parlophone,org-org-org,,PROPN-PROPN-PROPN,PROPN,compound-compound-pobj,pobj,NNP-NNP-NNP,NNP,6,1
3866,2286.0,27,is,8,2,4,2,1,22,6,-4,Vesey,Grammar School,,per-per,PROPN,PROPN-PROPN,poss,compound-nsubj,NNP,NNP-NNP,2,1
3867,2287.0,27,held,19,5,22,17,4,4,14,3,Antonio de Santa Anna,Mexico,per-per-per-per,,PROPN-ADP-PROPN-PROPN,PROPN,nmod-compound-compound-nsubj,pobj,NNP-IN-NNP-NNP,NNP,-1,1
3868,2288.0,27,told,6,2,5,3,1,21,4,-1,Veterans Affairs,Jim Nicholson,per-per,-,PROPN-PROPN,PROPN-PROPN,compound-compound,compound-nsubj,NNPS-NNPS,NNP-NNP,2,1
3869,3900.0,37,announced,8,4,7,3,3,29,4,-1,Veterans Affairs,Jim Nicholson,per-per,-,PROPN-PROPN,PROPN-PROPN,compound-compound,compound-nsubj,NNPS-NNPS,NNP-NNP,2,1
3870,8761.0,27,signed,6,1,4,3,0,22,5,-2,Veterans Affairs,Jim Nicholson,per-per,-,PROPN-PROPN,PROPN-PROPN,compound-compound,compound-nsubj,NNP-NNPS,NNP-NNP,2,1
3871,10472.0,23,head,6,1,4,3,0,18,5,-2,Veterans Affairs,Jim Nicholson,per-per,-,PROPN-PROPN,PROPN-PROPN,compound-compound,compound-nsubj,NNP-NNPS,NNP-NNP,2,1
3872,11148.0,15,ATLANTA,0,3,6,3,2,8,-3,6,Veterans Affairs,Jim Nicholson,per-per,-,PROPN-PROPN,PROPN-PROPN,compound-compound,compound-nsubj,NNP-NNPS,NNP-NNP,2,1
3873,11327.0,31,Affairs,4,4,9,5,3,21,0,5,Veterans Affairs,Jim Nicholson,-,org-org,PROPN-PROPN,PROPN-PROPN,pobj-ROOT,compound-nsubj,NNP-NNP,NNP-NNP,-1,1
3874,2290.0,79,was,10,6,36,30,5,42,4,26,Malfatti,Brazilian,org,,PROPN,ADJ,nsubj,amod,NNP,JJ,10,1
3875,2291.0,22,did,4,3,16,13,2,5,1,12,Gr8pop,Gregg,,org,NUM,PROPN,nummod,poss,CD,NNP,7,1
3876,2292.0,21,be,3,12,20,8,11,0,-9,17,Larry Craig,Idaho,per-per,,PROPN-PROPN,PROPN,compound-pobj,pobj,NNP-NNP,NNP,6,1
3877,3949.0,29,caught,5,4,26,22,3,2,1,21,Larry Craig,Idaho,org-org,,PROPN-PROPN,PROPN,compound-nsubj,compound,NNP-NNP,NNP,4,1
3878,5126.0,58,Here's,1,15,28,13,14,29,-14,27,Larry Craig,Idaho,org-org,,PROPN-PROPN,PROPN,compound-nsubj,compound,NNP-NNP,NNP,7,1
3879,10712.0,16,join,5,3,7,4,2,8,2,2,Larry Craig,Idaho,per-per,,PROPN-PROPN,PROPN,compound-nsubj,compound,NNP-NNP,NNP,2,1
3880,2293.0,13,is,1,1,9,8,0,3,0,8,CNBC-TV18,India,org,,PROPN,PROPN,nsubj,pobj,NNP,NNP,4,1
3881,2294.0,24,gone,3,17,19,2,16,4,-14,16,Italy,Marco Simoncelli,per,-,PROPN,PROPN-PROPN,poss,compound-pobj,NNP,NNP-NNP,3,1
3882,2295.0,30,located,9,1,12,11,0,17,8,3,Cathay Pacific,Hong Kong,-,org-org,PROPN-PROPN,PROPN-PROPN,compound-poss,compound-compound,NNP-NNP,NNP-NNP,5,1
3883,2296.0,25,formed,3,13,23,10,12,1,-10,20,National Bank Cup,Southern Sting,--,org-org,PROPN-PROPN-PROPN,PROPN-PROPN,compound-compound-pobj,compound-conj,NNP-NNP-NNP,NNP-NNP,9,1
3884,2298.0,13,acquired,3,3,6,3,2,6,0,3,NBG,Bank,per,,PROPN,PROPN,nsubj,dobj,NNP,NNP,2,1
3885,10280.0,22,took,4,4,8,4,3,13,0,4,NBG,Bank,per,,PROPN,PROPN,nsubj,dobj,NNP,NNP,2,1
3886,2300.0,34,had,1,21,32,11,20,1,-20,31,Walter Veltroni,Democratic Party,-,org-org,PROPN-PROPN,PROPN-PROPN,compound-nmod,compound-pobj,NNP-NNP,NNP-NNP,3,1
3887,2301.0,24,served,1,9,12,3,8,11,-8,11,Wittenberg University,Springfield Ohio,per-per,-,PROPN-PROPN,PROPN-PROPN,compound-pobj,compound-pobj,NNP-NNP,NNP-NNP,1,1
3888,2302.0,24,attacked,8,16,21,5,15,2,-8,13,his,West Chester,,per-per,DET,PROPN-PROPN,poss,compound-compound,PRP$,NNP-NNP,4,1
3889,2303.0,37,opened,7,16,21,5,15,15,-9,14,Kim Yong-nam,Presidium,-,per,PROPN-PROPN,PROPN,compound-compound,pobj,NNP-NNP,NNP,3,1
3890,2304.0,71,follows,2,43,43,0,42,27,-41,41,Petersburg,Petersburg High School,per,--,PROPN,PROPN-PROPN-PROPN,compound,compound-compound-appos,NNP,NNP-NNP-NNP,0,1
3891,2305.0,27,accused,4,3,3,0,2,23,1,-1,Jamba Juice,Jamba,-,per,PROPN-PROPN,PROPN,compound-nsubj,nsubj,NNP-NNP,NNP,0,1
3892,2306.0,25,built,13,1,10,9,0,14,12,-3,Cecil Rhodes,De Beers,per-per,-,PROPN-VERB,PROPN-PROPN,compound-nsubj,compound-compound,NNP-VBZ,NNP-NNP,5,1
3893,2307.0,45,originated,3,6,8,2,5,36,-3,5,Coventry,Frank Ifield,org,-,PROPN,PROPN-PROPN,pobj,compound-compound,NNP,NNP-NNP,5,1
3894,2308.0,37,founded,4,17,23,6,16,13,-13,19,Matsushita Electric Industrial Co.,Panasonic,---,per,PROPN-PROPN-PROPN-PROPN,PROPN,compound-compound-compound-compound,ROOT,NNP-NNP-NNP-NNP,NNP,3,1
3895,2309.0,30,rose,5,5,22,17,4,7,0,17,Arizona,her,per,,PROPN,DET,pobj,poss,NNP,PRP$,3,1
3896,2310.0,8,heads,1,1,3,2,0,4,0,2,He,Italy,org,,PRON,PROPN,nsubj,poss,PRP,NNP,3,1
3897,9442.0,31,stayed,1,1,11,10,0,19,0,10,He,Italy,org,,PRON,PROPN,nsubj,pobj,PRP,NNP,1,1
3898,2311.0,36,became,1,1,8,7,0,27,0,7,He,Moscow State University,,per-per-per,PRON,PROPN-PROPN-PROPN,nsubj,compound-compound-pobj,PRP,NNP-NNP-NNP,4,1
3899,2312.0,33,England,2,3,5,2,2,27,-1,3,England,Brian May,org,-,NOUN,PROPN-VERB,ROOT,nsubj-dep,NN,NNP-MD,2,1
3900,2313.0,23,educated,3,6,12,6,5,10,-3,9,Hulme Grammar School,Greater Manchester,--,per-per,PROPN-PROPN-PROPN,PROPN-PROPN,compound-compound-pobj,compound-pobj,NNP-NNP-NNP,NNP-NNP,3,1
3901,2314.0,19,announced,10,10,17,7,9,1,0,7,Acer,Packard Bell,,org-org,PROPN,PROPN-PROPN,pobj,compound-dobj,NNP,NNP-NNP,2,1
3902,4891.0,48,noted,9,7,26,19,6,21,2,17,Acer,Packard Bell,per,-,PROPN,PROPN-PROPN,compound,compound-conj,NNP,NNP-NNP,2,1
3903,2317.0,13,won,3,3,6,3,2,6,0,3,he,Guyana,per,,PRON,PROPN,nsubj,compound,PRP,NNP,1,1
3904,2318.0,32,said,4,2,3,1,1,28,2,-1,Secretary,Lito Atienza,,org-org,PROPN,PROPN-PROPN,compound,compound-nsubj,NNP,NNP-NNP,1,1
3905,2319.0,30,Institute,1,7,12,5,6,17,-6,11,ITB,Baile,org,,PROPN,PROPN,appos,nsubj,NNP,NNP,3,1
3906,2320.0,25,begin,14,1,14,13,0,10,13,0,Hugh McCulloch,Treasury,-,org,PROPN-PROPN,PROPN,compound-nsubj,pobj,NNP-NNP,NNP,2,1
3907,2321.0,62,was,12,19,22,3,18,39,-7,10,Risto Ryti,Finland,-,per,PROPN-PROPN,PROPN,compound-pobj,pobj,NNP-NNP,NNP,3,1
3908,3106.0,36,led,6,11,19,8,10,16,-5,13,Risto Ryti,Finland,-,org,PROPN-PROPN,PROPN,compound-pobj,nsubj,NNP-NNP,NNP,4,1
3909,7487.0,16,born,10,1,6,5,0,9,9,-4,Risto Ryti,Finland,-,org,PROPN-PROPN,PROPN,compound-nsubjpass,pobj,NNP-NNP,NNP,1,1
3910,9617.0,28,signed,3,17,27,10,16,0,-14,24,Risto Ryti,Finland,-,per,PROPN-PROPN,PROPN,compound-compound,pobj,NNP-NNP,NNP,4,1
3911,14029.0,14,was,5,1,13,12,0,0,4,8,Risto Ryti,Finland,org-org,,PROPN-PROPN,PROPN,compound-poss,pobj,NNP-NNP,NNP,3,1
3912,2322.0,70,provided,2,11,18,7,10,51,-9,16,Sri Lanka,Indian Peace Keeping Force,-,org-org-org-org,PROPN-PROPN,PROPN-PROPN-PROPN-PROPN,compound-pobj,compound-compound-compound-pobj,NNP-NNP,NNP-NNP-NNP-NNP,5,1
3913,2323.0,36,said,24,3,24,21,2,11,21,0,Air France-KLM,KLM,-,per,PROPN-PROPN,PROPN,compound-dobj,appos,NNP-NNP,NNP,8,1
3914,2324.0,58,said,38,10,12,2,9,45,28,-26,IAM,International Association of Machinists and Aerospace Workers,per,------,PROPN,PROPN-PROPN-ADP-PROPN-CCONJ-PROPN-PROPN,nmod,compound-pobj-prep-pobj-cc-compound-conj,NNP,NNP-NNP-IN-NNPS-CC-NNP-NNPS,1,1
3915,2325.0,83,played,39,45,64,19,44,18,-6,25,Paris,Simone de Beauvoir,per,--,PROPN,PROPN-PROPN-PROPN,compound,compound-compound-pobj,NNP,NNP-NNP-NNP,7,1
3916,2326.0,40,VIETNAM,4,1,38,37,0,1,3,34,HO CHI MINH,Vietnam,--,per,PROPN-PROPN-PROPN,PROPN,compound-compound-compound,compound,NNP-NNP-NNP,NNP,-1,1
3917,3862.0,9,CITY,3,1,5,4,0,3,2,2,HO CHI MINH,Vietnam,per-per-per,,PROPN-PROPN-PROPN,PROPN,compound-compound-compound,appos,NNP-NNP-NNP,NNP,4,1
3918,2327.0,17,Chae-young,1,1,4,3,0,12,0,3,Han Chae-young,Kim Ji-young,org-org,-,PROPN-PROPN,PROPN-PROPN,compound-ROOT,compound-nsubj,NNP-NNP,NNP-NNP,3,1
3919,2328.0,31,wrote,7,6,25,19,5,5,1,18,Wyeth,New Jersey,org,-,PROPN,PROPN-PROPN,compound,compound-poss,NNP,NNP-NNP,8,1
3920,2330.0,34,announced,2,8,13,5,7,20,-6,11,China,CITIC,,per,PROPN,PROPN,poss,compound,NNP,NNP,2,1
3921,2331.0,31,took,2,5,13,8,4,17,-3,11,Steve McNamara,Bulls,per-per,,PROPN-PROPN,PROPN,compound-dobj,pobj,NNP-NNP,NNPS,6,1
3922,2332.0,26,had,4,20,23,3,19,2,-16,19,Navy,Claude A. Swanson,,per-per-per,PROPN,PROPN-NOUN-PROPN,pobj,compound-compound-appos,NNP,NNP-NN-NNP,2,1
3923,5971.0,31,appointed,6,15,23,8,14,7,-9,17,Navy,Claude A. Swanson,per,--,PROPN,PROPN-NOUN-PROPN,pobj,compound-compound-nsubj,NNP,NNP-NN-NNP,4,1
3924,7215.0,80,argued,17,9,10,1,8,69,8,-7,Navy,Claude A. Swanson,org,--,PROPN,PROPN-NOUN-PROPN,compound,compound-compound-pobj,NNP,NNP-NN-NNP,2,1
3925,11847.0,37,launched,8,27,28,1,26,8,-19,20,Navy,Claude A. Swanson,per,--,PROPN,PROPN-NOUN-PROPN,compound,compound-compound-pobj,NNP,NNP-NN-NNP,2,1
3926,12120.0,108,effective,19,12,13,1,11,94,7,-6,Navy,Claude A. Swanson,,org-org-org,PROPN,PROPN-NOUN-PROPN,compound,compound-compound-pobj,NNP,NNP-NN-NNP,2,1
3927,14135.0,31,used,6,15,16,1,14,14,-9,10,Navy,Claude A. Swanson,per,--,PROPN,PROPN-NOUN-PROPN,compound,compound-compound-pobj,NNP,NNP-NN-NNP,2,1
3928,2333.0,63,had,8,24,27,3,23,35,-16,19,Marky Ramone,Ramones,org-org,,PROPN-PROPN,PROPN,compound-ROOT,appos,NNP-NNP,NNP,2,1
3929,2334.0,28,was,10,1,16,15,0,11,9,6,Girija Prasad Koirala,Nepal,per-per-per,,PROPN-PROPN-PROPN,PROPN,compound-compound-nsubj,pobj,NNP-NNP-NNP,NNP,4,1
3930,10411.0,31,made,5,3,16,13,2,14,2,11,Girija Prasad Koirala,Nepal,org-org-org,,PROPN-PROPN-PROPN,PROPN,compound-compound-nsubj,pobj,NNP-NNP-NNP,NNP,7,1
3931,11625.0,53,served,1,23,38,15,22,14,-22,37,Girija Prasad Koirala,Nepal,per-per-per,,PROPN-PROPN-PROPN,PROPN,compound-compound-pobj,pobj,NNP-NNP-NNP,NNP,6,1
3932,13987.0,44,meet,8,14,24,10,13,19,-6,16,Girija Prasad Koirala,Nepal,org-org-org,,PROPN-PROPN-PROPN,PROPN,compound-compound-compound,pobj,NNP-NNP-NNP,NNP,3,1
3933,2335.0,22,predicted,10,3,9,6,2,12,7,-1,Zachary Taylor,Whig,per-per,,PROPN-PROPN,PROPN,compound-compound,compound,NNP-NNP,NNP,3,1
3934,2336.0,63,enjoyed,5,1,4,3,0,58,4,-1,Dave Halverson,GameFan,-,org,PROPN-PROPN,PROPN,compound-nsubj,compound,NNP-NNP,NNP,2,1
3935,2337.0,14,includes,5,1,11,10,0,2,4,6,Regal Recordings,Cathy Davey,-,org-org,PROPN-PROPN,PROPN-PROPN,compound-poss,compound-dobj,NNP-NNPS,NNP-NNP,3,1
3936,2339.0,57,http://therealnews.com/t2/about-the-real-news,0,2,35,33,1,21,-2,35,The Real News,Jay,--,per,DET-PROPN-PROPN,PROPN,det-compound-compound,compound,DT-NNP-NNP,NNP,-1,1
3937,2340.0,22,is,5,10,13,3,9,8,-5,8,Rio de Janeiro,FGV,per-per-per,,PROPN-PROPN-PROPN,PROPN,compound-compound-compound,appos,NNP-NNP-NNP,NNP,3,1
3938,2341.0,26,received,7,5,15,10,4,10,2,8,Missouri,Enterprise Rent-A-Car,per,-,PROPN,NOUN-PROPN,compound,compound-pobj,NNP,NN-NNP,11,1
3939,2342.0,30,became,8,16,20,4,15,9,-8,12,Southwestern College,Winfield,per-per,,PROPN-PROPN,PROPN,compound-compound,compound,NNP-NNP,NNP,3,1
3940,2344.0,38,injured,5,15,25,10,14,12,-10,20,Thailand,Surayud Chulanont,,org-org,PROPN,PROPN-PROPN,poss,compound-nsubj,NNP,NNP-NNP,4,1
3941,2955.0,50,PM,0,3,23,20,2,26,-3,23,Thailand,Surayud Chulanont,org,-,PROPN,PROPN-PROPN,nsubj,compound-nsubj,NNP,NNP-NNP,-1,1
3942,5256.0,38,Latina,6,9,12,3,8,25,-3,6,Thailand,Surayud Chulanont,org,-,PROPN,PROPN-PROPN,compound,compound-nsubj,NNP,NNP-NNP,2,1
3943,8387.0,29,gunned,3,10,21,11,9,7,-7,18,Thailand,Surayud Chulanont,per,-,PROPN,PROPN-PROPN,poss,compound-nsubj,NNP,NNP-NNP,10,1
3944,13105.0,28,sacked,9,1,6,5,0,21,8,-3,Thailand,Surayud Chulanont,,per-per,PROPN,PROPN-PROPN,poss,compound-nsubj,NNP,NNP-NNP,2,1
3945,14204.0,29,hospitalised,2,25,27,2,24,1,-23,25,Thailand,Surayud Chulanont,per,-,PROPN,PROPN-PROPN,compound,compound-pobj,NNP,NNP-NNP,1,1
3946,2345.0,38,was,11,29,35,6,28,2,-18,24,George,Charlotte of Mecklenburg-Strelitz,,org-org-org,PROPN,PROPN-ADP-PROPN,compound,conj-prep-pobj,NNP,NNP-IN-NNP,2,1
3947,4907.0,43,is,1,7,14,7,6,28,-6,13,George,Charlotte of Mecklenburg-Strelitz,,per-per-per,PROPN,PROPN-ADP-PROPN,compound,conj-prep-pobj,NNP,NNP-IN-NNP,4,1
3948,7760.0,29,prevailed,2,11,26,15,10,2,-9,24,George,Charlotte of Mecklenburg-Strelitz,,org-org-org,PROPN,PROPN-ADP-PROPN,compound,pobj-prep-pobj,NNP,NNP-IN-NNP,6,1
3949,2346.0,15,was,10,2,1,-1,1,13,8,-9,VII Corps,The Jayhawk Corps,-,per-per-per,PROPN-PROPN,DET-PROPN-PROPN,compound-nsubj,det-compound-attr,NNP-NNP,DT-NNP-NNP,1,1
3950,2347.0,20,announced,6,13,5,-8,12,14,-7,-1,Future US,Nintendo Power,-,org-org,PROPN-PROPN,PROPN-PROPN,compound-appos,compound-dobj,NNP-NNP,NNP-NNP,3,1
3951,13343.0,21,announced,7,7,5,-2,6,15,0,-2,Future US,Nintendo Power,per-per,-,PROPN-PROPN,PROPN-PROPN,compound-nsubj,compound-compound,NNP-NNP,NNP-NNP,2,1
3952,2348.0,29,was,2,1,26,25,0,2,1,24,Igor Ternov,Moscow State University,per-per,--,PROPN-PROPN,PROPN-PROPN-PROPN,compound-nsubj,compound-compound-pobj,NNP-NNP,NNP-NNP-NNP,10,1
3953,2350.0,23,told,4,6,10,4,5,12,-2,6,New Komeito party,Akihiro Ota,--,org-org,PROPN-PROPN-NOUN,PROPN-PROPN,compound-compound-compound,compound-dobj,NNP-NNP-NN,NNP-NNP,2,1
3954,2351.0,53,conducted,1,36,41,5,35,11,-35,40,Finland,Martti Ahtisaari,,per-per,PROPN,PROPN-PROPN,pobj,compound-conj,NNP,NNP-NNP,6,1
3955,2640.0,33,received,5,1,4,3,0,28,4,-1,Finland,Martti Ahtisaari,,org-org,PROPN,PROPN-PROPN,poss,compound-nsubj,NNP,NNP-NNP,4,1
3956,4231.0,34,garnered,2,9,13,4,8,20,-7,11,Finland,Martti Ahtisaari,per,-,PROPN,PROPN-PROPN,pobj,compound-appos,NNP,NNP-NNP,2,1
3957,2352.0,15,is,1,1,8,7,0,6,0,7,SJCIT,1986,,org,PROPN,NUM,nsubj,pobj,NNP,CD,2,1
3958,2353.0,18,Donavia,1,6,11,5,5,6,-5,10,Aeroflot-Don,Aeroflot,org,,NOUN,PROPN,subtok,compound,NN,NNP,4,1
3959,2354.0,15,born,2,6,8,2,5,6,-4,6,Malta,George,,org,PROPN,PROPN,pobj,nmod,NNP,NNP,2,1
3960,2355.0,37,Ministry,1,2,7,5,1,29,-1,6,Ministry of Finance,Republic of China,--,org-org-org,PROPN-ADP-PROPN,PROPN-ADP-PROPN,ROOT-prep-pobj,pobj-prep-pobj,NNP-IN-NNP,NNP-IN-NNP,4,1
3961,2356.0,18,located,7,2,14,12,1,3,5,7,Ural State University,Sverdlovsk Oblast,org-org-org,-,PROPN-PROPN-PROPN,PROPN-PROPN,compound-compound-nsubjpass,compound-compound,NNP-NNP-NNP,NNP-NNP,7,1
3962,2357.0,53,invade,22,24,24,0,23,28,-2,2,Georgia,Georgia,,per,PROPN,PROPN,nsubj,nsubj,NNP,NNP,0,1
3963,2358.0,23,elected,6,2,8,6,1,14,4,2,House,Taro Aso,,per-per,PROPN,PROPN-PROPN,nsubj,compound-dobj,NNP,NNP-NNP,4,1
3964,11755.0,42,said,40,25,35,10,24,6,15,-5,House,Taro Aso,org,-,PROPN,PROPN-PROPN,compound,compound-pobj,NNP,NNP-NNP,7,1
3965,2359.0,23,was,1,1,19,18,0,3,0,18,He,International Atomic Energy Agency,,per-per-per-per,PRON,PROPN-PROPN-PROPN-PROPN,nsubj,compound-compound-compound-pobj,PRP,NNP-NNP-NNP-NNP,6,1
3966,2360.0,26,said,22,13,21,8,12,4,9,-1,Volkswagen,Martin Winterkorn,org,-,PROPN,PROPN-PROPN,pobj,compound-appos,NNP,NNP-NNP,3,1
3967,2361.0,26,offered,6,2,21,19,1,4,4,15,Hall High,Little Rock,-,org-org,PROPN-PROPN,PROPN-PROPN,compound-amod,compound-pobj,NNP-NNP,NNP-NNP,8,1
3968,2362.0,25,renamed,4,1,1,0,0,23,3,-3,Wausau,Wausau East High School,per,---,PROPN,PROPN-PROPN-PROPN-PROPN,compound,compound-compound-compound-nsubj,NNP,NNP-NNP-NNP-NNP,0,1
3969,2364.0,25,affects,2,8,17,9,7,7,-6,15,Toyota,Scion,org,,PROPN,PROPN,compound,compound,NNP,NNP,4,1
3970,2365.0,45,agitated,34,25,33,8,24,11,9,-1,Williams College,Massachusetts,-,per,PROPN-PROPN,PROPN,compound-dobj,pobj,NNP-NNP,NNP,5,1
3971,2366.0,42,included,7,14,14,0,13,27,-7,7,San Diego Mesa College,San Diego,org-org-org-org,-,PROPN-PROPN-PROPN-PROPN,PROPN-PROPN,compound-compound-compound-compound,compound-compound,NNP-NNP-NNP-NNP,NNP-NNP,0,1
3972,2367.0,25,impressed,9,14,21,7,13,3,-5,12,Singapore,Lee Kuan Yew,,org-org-org,PROPN,PROPN-PROPN-PROPN,poss,compound-compound-nsubj,NNP,NNP-NNP-NNP,7,1
3973,4894.0,21,said,11,5,9,4,4,11,6,-2,Singapore,Lee Kuan Yew,,org-org-org,PROPN,PROPN-PROPN-PROPN,poss,compound-compound-appos,NNP,NNP-NNP-NNP,4,1
3974,7091.0,32,Yuanchao,1,23,27,4,22,4,-22,26,Singapore,Lee Kuan Yew,,org-org-org,PROPN,PROPN-PROPN-PROPN,poss,compound-compound-pobj,NNP,NNP-NNP-NNP,4,1
3975,7635.0,44,known,15,21,30,9,20,13,-6,15,Singapore,Lee Kuan Yew,,org-org-org,PROPN,PROPN-PROPN-PROPN,poss,compound-compound-conj,NNP,NNP-NNP-NNP,6,1
3976,7741.0,11,funeral,1,6,8,2,5,2,-5,7,Singapore,Lee Kuan Yew,per,--,PROPN,PROPN-PROPN-PROPN,poss,compound-compound-pobj,NNP,NNP-NNP-NNP,2,1
3977,8139.0,22,said,6,1,4,3,0,17,5,-2,Singapore,Lee Kuan Yew,,per-per-per,PROPN,PROPN-PROPN-PROPN,compound,compound-compound-nsubj,NNP,NNP-NNP-NNP,2,1
3978,8580.0,28,said,7,1,5,4,0,22,6,-2,Singapore,Lee Kuan Yew,,org-org-org,PROPN,PROPN-PROPN-PROPN,poss,compound-compound-appos,NNP,NNP-NNP-NNP,4,1
3979,9871.0,36,meet,9,17,7,-10,16,28,-8,-2,Singapore,Lee Kuan Yew,,org-org-org,PROPN,PROPN-PROPN-PROPN,compound,compound-compound-pobj,NNP,NNP-NNP-NNP,6,1
3980,9908.0,30,said,28,5,9,4,4,20,23,-19,Singapore,Lee Kuan Yew,per,--,PROPN,PROPN-PROPN-PROPN,poss,compound-compound-appos,NNP,NNP-NNP-NNP,6,1
3981,11208.0,38,lit,7,1,5,4,0,32,6,-2,Singapore,Lee Kuan Yew,per,--,PROPN,PROPN-PROPN-PROPN,poss,compound-compound-appos,NNP,NNP-NNP-NNP,3,1
3982,12560.0,37,was,7,12,17,5,11,19,-5,10,Singapore,Lee Kuan Yew,,per-per-per,PROPN,PROPN-PROPN-PROPN,poss,compound-compound-pobj,NNP,NNP-NNP-NNP,7,1
3983,12950.0,16,reported,14,1,5,4,0,10,13,-9,Singapore,Lee Kuan Yew,per,--,PROPN,PROPN-PROPN-PROPN,poss,compound-compound-nsubjpass,NNP,NNP-NNP-NNP,3,1
3984,2368.0,43,was,17,2,6,4,1,36,15,-11,Tan Cheng Lock,MCA,--,per,PROPN-PROPN-PROPN,PROPN,compound-compound-pobj,nsubj,NNP-NNP-NNP,NNP,3,1
3985,2369.0,35,read,7,23,33,10,22,1,-16,26,Imperial College,Geoffrey Wilkinson,-,org-org,PROPN-PROPN,PROPN-PROPN,compound-compound,compound-pobj,NNP-NNP,NNP-NNP,8,1
3986,6106.0,18,introduced,12,5,9,4,4,8,7,-3,Imperial College,Geoffrey Wilkinson,org-org,-,PROPN-PROPN,PROPN-PROPN,compound-compound,compound-pobj,NNP-NNP,NNP-NNP,5,1
3987,2370.0,27,was,13,1,20,19,0,6,12,7,Charles Sumner,Massachusetts,org-org,,PROPN-PROPN,PROPN,compound-compound,pobj,NNP-NNP,NNP,-1,1
3988,3394.0,25,criticized,10,7,10,3,6,14,3,0,Charles Sumner,Massachusetts,per-per,,PROPN-PROPN,PROPN,compound-pobj,pobj,NNP-NNP,NNP,4,1
3989,2371.0,28,released,21,9,24,15,8,3,12,3,Ted Heath,Decca,org-org,,PROPN-PROPN,PROPN,compound-conj,compound,NNP-NNP,NNP,6,1
3990,2372.0,30,appeared,3,19,21,2,18,8,-16,18,Swan,High Wycombe,,per-per,PROPN,PROPN-PROPN,pobj,compound-pobj,NNP,NNP-NNP,1,1
3991,2373.0,45,is,0,13,34,21,12,10,-13,34,Outlawz,Young Noble,per,-,PROPN,PROPN-PROPN,pobj,compound-conj,NNP,NNP-NNP,9,1
3992,2374.0,24,is,14,1,22,21,0,1,13,8,Antje Duvekot,Somerville,org-org,,PROPN-PROPN,PROPN,compound-nsubj,compound,NNP-NNP,NNP,3,1
3993,2375.0,23,joined,3,3,9,6,2,13,0,6,he,University of Texas,org,--,PRON,PROPN-ADP-PROPN,nsubj,nmod-prep-pobj,PRP,NNP-IN-NNP,5,1
3994,2376.0,21,grew,12,1,9,8,0,11,11,-3,Charlie Cruz,Puerto Rico,-,org-org,PROPN-PROPN,PROPN-PROPN,compound-nsubj,compound-pobj,NNP-NNP,NNP-NNP,4,1
3995,2377.0,14,introduced,6,1,3,2,0,10,5,-3,Invensys,Wonderware,,per,PROPN,PROPN,nsubj,appos,NNP,NNP,2,1
3996,2379.0,29,include,2,27,28,1,26,0,-25,26,Vermont,USA,org,,PROPN,PROPN,compound,pobj,NNP,NNP,5,1
3997,2380.0,32,licensed,3,1,2,1,0,29,2,-1,ESPN Classic,Classic Sports,org-org,-,PROPN-PROPN,PROPN-PROPN,compound-nsubjpass,compound-pobj,NNP-NNP,NNP-NNPS,2,1
3998,2381.0,26,is,7,1,1,0,0,24,6,-6,Pitt Meadows Secondary School,Pitt Meadows,---,per-per,PROPN-PROPN-PROPN-PROPN,PROPN-PROPN,compound-compound-compound-nsubj,compound-compound,NNP-NNP-NNP-NNP,NNP-NNP,0,1
3999,2382.0,24,appointed,2,10,7,-3,9,16,-8,5,Technology,Norwegian University of Science and Technology,per,-----,PROPN,PROPN-PROPN-ADP-PROPN-CCONJ-PROPN,pobj,compound-pobj-prep-pobj-cc-conj,NNP,NNP-NNP-IN-NNP-CC-NNP,4,1
4000,2384.0,25,took,6,12,21,9,11,3,-6,15,David James Elliott,actor,per-per-per,,PROPN-PROPN-PROPN,NOUN,compound-compound-pobj,attr,NNP-NNP-NNP,NN,8,1
4001,2385.0,30,supporter,2,5,6,1,4,23,-3,4,King,Charles I of England,per,---,PROPN,PROPN-PROPN-ADP-PROPN,compound,pobj-appos-prep-pobj,NNP,NNP-NNP-IN-NNP,1,1
4002,2386.0,27,defeated,19,10,13,3,9,13,9,-6,Costa Rica,Juan Rafael Mora Porras,org-org,---,PROPN-PROPN,PROPN-PROPN-PROPN-PROPN,compound-compound,compound-compound-compound-pobj,NNP-NNP,NNP-NNP-NNP-NNP,10,1
4003,2387.0,24,led,9,5,16,11,4,7,4,7,El Cerrito High School,California,org-org-org-org,,PROPN-PROPN-PROPN-PROPN,PROPN,compound-compound-compound-compound,compound,NNP-NNP-NNP-NNP,NNP,10,1
4004,2388.0,19,took,1,1,11,10,0,7,0,10,Goodman,Columbia,per,,PROPN,PROPN,nsubj,appos,NNP,NNP,1,1
4005,2389.0,34,replaced,2,1,7,6,0,26,1,5,Musharraf,Pakistan,per,,PROPN,PROPN,nsubjpass,poss,NNP,NNP,5,1
4006,4994.0,27,passed,3,3,20,17,2,6,0,17,Musharraf,Pakistan,per,,PROPN,PROPN,nsubj,poss,NNP,NNP,6,1
4007,2390.0,25,released,2,9,21,12,8,3,-7,19,No Limit,Beats By the Pound,per-per,---,DET-PROPN,NOUN-ADP-DET-PROPN,det-compound,pobj-prep-det-pobj,DT-NNP,NNS-IN-DT-NNP,5,1
4008,11765.0,23,released,2,9,19,10,8,3,-7,17,No Limit,Beats By the Pound,-,per-per-per-per,DET-PROPN,PROPN-ADP-DET-PROPN,det-compound,conj-prep-det-pobj,DT-NNP,NNPS-IN-DT-NNP,5,1
4009,2391.0,65,includes,7,9,3,-6,8,61,-2,-4,Pamela Youde Nethersole Eastern Hospital,Hong Kong,----,org-org,PROPN-PROPN-PROPN-PROPN-PROPN,PROPN-PROPN,compound-compound-compound-compound-dobj,compound-compound,NNP-NNP-NNP-NNP-NNP,NNP-NNP,5,1
4010,2392.0,46,was,14,5,17,12,4,28,9,3,Grateful Dead,Jerry Garcia,org-org,-,PROPN-PROPN,PROPN-PROPN,compound-pobj,compound-attr,NNP-NNP,NNP-NNP,4,1
4011,6925.0,45,dig,2,27,29,2,26,15,-25,27,Grateful Dead,Jerry Garcia,-,org-org,ADJ-PROPN,PROPN-PROPN,compound-compound,compound-compound,JJ-NNP,NNP-NNP,2,1
4012,2393.0,36,co-ordinating,18,1,8,7,0,27,17,-10,Tim Howard,Northeastern University,per-per,-,PROPN-PROPN,PROPN-PROPN,compound-nsubj,compound-pobj,NNP-NNP,NNP-NNP,3,1
4013,2394.0,31,intending,3,1,20,19,0,10,2,17,I,New Zealand,org,-,PRON,PROPN-PROPN,nsubj,compound-compound,PRP,NNP-NNP,-1,1
4014,2395.0,31,returned,20,11,23,12,10,7,9,3,Gabriel Videla,Chile,org-org,,PROPN-PROPN,PROPN,compound-pobj,pobj,NNP-NNP,NNP,5,1
4015,3596.0,33,started,0,15,27,12,14,5,-15,27,Gabriel Videla,Chile,-,per,PROPN-PROPN,PROPN,compound-appos,pobj,NNP-NNP,NNP,9,1
4016,8068.0,31,appointed,2,12,18,6,11,12,-10,16,Gabriel Videla,Chile,-,per,PROPN-PROPN,PROPN,compound-pobj,pobj,NNP-NNP,NNP,7,1
4017,2396.0,12,grew,1,1,11,10,0,0,0,10,He,USA,,org,PRON,PROPN,nsubj,pobj,PRP,NNP,1,1
4018,3563.0,36,left,1,1,11,10,0,24,0,10,He,USA,org,,PRON,PROPN,nsubj,pobj,PRP,NNP,1,1
4019,2397.0,20,made,2,1,10,9,0,9,1,8,Cockburn,Canada,,per,PROPN,PROPN,nsubjpass,pobj,NNP,NNP,2,1
4020,6864.0,24,Wondering,2,20,23,3,19,0,-18,21,Cockburn,Canada,per,,ADJ,PROPN,compound,pobj,JJ,NNP,4,1
4021,2398.0,21,Handley,0,1,10,9,0,10,-1,10,Handley,Connecticut,per,,PROPN,PROPN,ROOT,compound,NNP,NNP,8,1
4022,2401.0,42,warned,14,1,11,10,0,30,13,-3,Stan Shih,Acer Inc.,org-org,-,PROPN-PROPN,PROPN-PROPN,compound-compound,compound-pobj,NNP-NNP,NNP-NNP,4,1
4023,2402.0,23,married,1,1,5,4,0,17,0,4,Peters,Michael Wittenberg,per,-,PROPN,PROPN-PROPN,nsubj,compound-dobj,NNP,NNP-NNP,2,1
4024,2404.0,33,is,3,15,26,11,14,6,-12,23,Suharto,Indonesia,,per,PROPN,PROPN,poss,pobj,NNP,NNP,6,1
4025,3248.0,22,called,5,7,14,7,6,7,-2,9,Suharto,Indonesia,,per,PROPN,PROPN,dobj,pobj,NNP,NNP,3,1
4026,3413.0,38,cultivated,2,13,34,21,12,3,-11,32,Suharto,Indonesia,per,,PROPN,PROPN,poss,pobj,NNP,NNP,11,1
4027,3964.0,22,proven,5,8,10,2,7,11,-3,5,Suharto,Indonesia,per,,PROPN,PROPN,nsubj,poss,NNP,NNP,4,1
4028,4945.0,36,said,18,1,32,31,0,3,17,14,Suharto,Indonesia,,per,VERB,PROPN,nsubj,poss,VB,NNP,8,1
4029,5269.0,22,criticized,2,11,20,9,10,1,-9,18,Suharto,Indonesia,,per,PROPN,PROPN,poss,compound,NNP,NNP,7,1
4030,5822.0,47,reconciled,3,10,20,10,9,26,-7,17,Suharto,Indonesia,per,,PROPN,PROPN,nsubj,pobj,NNP,NNP,6,1
4031,6273.0,31,elected,2,1,13,12,0,17,1,11,Suharto,Indonesia,per,,PROPN,PROPN,nsubjpass,nsubj,NNP,NNP,3,1
4032,6351.0,33,had,6,10,24,14,9,8,-4,18,Suharto,Indonesia,org,,PROPN,PROPN,poss,nsubj,NNP,NNP,9,1
4033,7457.0,43,steered,1,1,3,2,0,39,0,2,Suharto,Indonesia,org,,PROPN,PROPN,nsubj,dobj,NNP,NNP,1,1
4034,7917.0,41,is,1,9,30,21,8,10,-8,29,Suharto,Indonesia,per,,PROPN,PROPN,appos,pobj,NNP,NNP,7,1
4035,8017.0,20,began,2,2,15,13,1,4,0,13,Suharto,Indonesia,,org,PROPN,PROPN,nsubj,pobj,NNP,NNP,8,1
4036,8677.0,27,removed,4,21,26,5,20,0,-17,22,Suharto,Indonesia,,per,PROPN,PROPN,nsubj,pobj,NNP,NNP,1,1
4037,9295.0,28,returned,4,1,20,19,0,7,3,16,Suharto,Indonesia,per,,PROPN,PROPN,nsubj,pobj,NNP,NNP,3,1
4038,9411.0,21,served,6,13,16,3,12,4,-7,10,Suharto,Indonesia,,per,PROPN,PROPN,compound,pobj,NNP,NNP,5,1
4039,9852.0,24,ruled,12,1,14,13,0,9,11,2,Suharto,Indonesia,org,,PROPN,PROPN,nsubj,dobj,NNP,NNP,4,1
4040,10391.0,19,was,2,11,13,2,10,5,-9,11,Suharto,Indonesia,org,,PROPN,PROPN,compound,nsubj,NNP,NNP,6,1
4041,11810.0,40,assigned,9,12,33,21,11,6,-3,24,Suharto,Indonesia,,per,PROPN,PROPN,pobj,pobj,NNP,NNP,6,1
4042,12460.0,30,stood,21,1,13,12,0,16,20,-8,Suharto,Indonesia,,per,PROPN,PROPN,nsubj,pobj,NNP,NNP,2,1
4043,12772.0,41,wrote,9,14,16,2,13,24,-5,7,Suharto,Indonesia,,per,PROPN,PROPN,poss,appos,NNP,NNP,7,1
4044,13903.0,31,elected,2,1,13,12,0,17,1,11,Suharto,Indonesia,,org,PROPN,PROPN,nsubjpass,nsubj,NNP,NNP,3,1
4045,14047.0,28,said,3,5,17,12,4,10,-2,14,Suharto,Indonesia,org,,PROPN,PROPN,nsubj,poss,NNP,NNP,5,1
4046,2405.0,29,re-elected,6,8,9,1,7,19,-2,3,Belgian,Jacques Rogge,per,-,PROPN,PROPN-PROPN,compound,compound-dobj,NNP,NNP-NNP,2,1
4047,2406.0,51,offer,41,28,50,22,27,0,13,9,Romania,Romtelecom,org,,PROPN,PROPN,pobj,pobj,NNP,NNP,-1,1
4048,4797.0,46,Romania,1,2,16,14,1,29,-1,15,Romania,Romtelecom,,per,PROPN,PROPN,ROOT,nsubj,NNP,NNP,4,1
4049,2407.0,25,is,2,8,11,3,7,13,-6,9,American,Johnny Cash,per,-,ADJ,PROPN-PROPN,amod,compound-pobj,JJ,NNP-NNP,2,1
4050,2408.0,19,moved,3,3,15,12,2,3,0,12,INL,The Nelson Mail,per,--,PROPN,DET-PROPN-PROPN,nsubj,det-compound-oprd,NNP,DT-NNP-NNP,4,1
4051,2409.0,34,carried,2,1,31,30,0,2,1,29,FNC,News Corporation,per,-,PROPN,PROPN-PROPN,poss,compound-appos,NNP,NNP-NNP,11,1
4052,2410.0,17,collaborated,1,4,7,3,3,9,-3,6,Young Noble,Outlawz,per-per,,PROPN-PROPN,PROPN,compound-pobj,pobj,NNP-NNP,NNP,3,1
4053,5036.0,30,worked,6,12,19,7,11,10,-6,13,Young Noble,Outlawz,-,org,PROPN-PROPN,PROPN,compound-conj,appos,NNP-NNP,NNP,4,1
4054,2411.0,27,located,5,3,19,16,2,7,2,14,WyoTech,Wyoming,per,,PROPN,PROPN,compound,conj,NNP,NNP,-1,1
4055,2412.0,39,NASDAQ,4,1,19,18,0,19,3,15,ATS Medical,Minneapolis,per-per,,PROPN-PROPN,PROPN,compound-compound,compound,NNP-NNP,NNP,-1,1
4056,2413.0,26,was,3,12,17,5,11,8,-9,14,he,Lithuania,,per,PRON,PROPN,nsubj,nsubj,PRP,NNP,3,1
4057,2414.0,27,S.A.,3,7,26,19,6,0,-4,23,Austral,Argentinas,,per,PROPN,PROPN,pobj,pobj,NNP,NNP,5,1
4058,2415.0,43,had,17,3,9,6,2,33,14,-8,Union Association,St. Louis Maroons,-,org-org-org,PROPN-PROPN,PROPN-PROPN-PROPN,compound-nsubjpass,compound-compound-pobj,NNP-NNP,NNP-NNP-NNPS,4,1
4059,2416.0,49,released,10,9,25,16,8,23,1,15,Apollyon Sun,Mayan Records,per-per,-,PROPN-PROPN,PROPN-PROPN,compound-conj,compound-pobj,NNP-NNP,NNP-NNPS,4,1
4060,4459.0,24,is,6,16,22,6,15,1,-10,16,Apollyon Sun,Mayan Records,org-org,-,PROPN-PROPN,PROPN-PROPN,compound-pobj,compound-pobj,NNP-NNP,NNP-NNPS,5,1
4061,2417.0,26,represented,2,4,13,9,3,12,-2,11,Victoria Osteen,Joel Osteen,per-per,-,PROPN-PROPN,PROPN-PROPN,compound-compound,compound-dobj,NNP-NNP,NNP-NNP,4,1
4062,2418.0,31,opened,1,4,10,6,3,20,-3,9,1956,English Martyrs School and Sixth Form College,per,------,NUM,PROPN-PROPN-PROPN-CCONJ-PROPN-PROPN-PROPN,pobj,compound-nmod-pobj-cc-compound-compound-pobj,CD,NNP-NNP-NNP-CC-NNP-NNP-NNP,5,1
4063,2419.0,68,abolished,10,24,31,7,23,36,-14,21,Joseph Lyons,Australia,-,per,PROPN-PROPN,PROPN,compound-dobj,pobj,NNP-NNP,NNP,3,1
4064,8705.0,33,was,6,15,31,16,14,1,-9,25,Joseph Lyons,Australia,per-per,,PROPN-PROPN,PROPN,compound-dobj,compound,NNP-NNP,NNP,6,1
4065,2420.0,23,includes,3,9,12,3,8,10,-6,9,New York,Onaje Allan Gumbs,-,org-org-org,PROPN-PROPN,PROPN-PROPN-PROPN,compound-compound,compound-compound-appos,NNP-NNP,NNP-NNP-NNP,3,1
4066,2421.0,22,said,15,11,14,3,10,7,4,-1,Fininvest,Pasquale Cannatelli,,per-per,PROPN,PROPN-PROPN,compound,compound-nsubj,NNP,NNP-NNP,2,1
4067,2422.0,26,moved,8,6,19,13,5,6,2,11,Gamal Abdel Nasser,Cairo,--,org,PROPN-PROPN-PROPN,PROPN,compound-compound-nsubj,pobj,NNP-NNP-NNP,NNP,5,1
4068,2423.0,24,passed,4,13,19,6,12,4,-9,15,English Crossing Elementary,1995,--,org,PROPN-PROPN-PROPN,NUM,compound-compound-compound,pobj,NNP-NNP-NNP,CD,8,1
4069,2424.0,32,cleared,12,10,18,8,9,13,2,6,Korea Exchange,South Korea,-,org-org,PROPN-PROPN,PROPN-PROPN,compound-compound,compound-poss,NNP-NNP,NNP-NNP,10,1
4070,2425.0,14,seized,3,2,13,11,1,0,1,10,Daoud,Afghanistan,org,,PROPN,PROPN,poss,pobj,NNP,NNP,2,1
4071,2426.0,16,moved,2,1,6,5,0,9,1,4,Jewell,Arkansas,org,,PROPN,PROPN,nsubj,pobj,NNP,NNP,2,1
4072,2427.0,15,raised,7,6,10,4,5,4,1,3,South Africa,Cape Town Highlanders,per-per,--,PROPN-PROPN,PROPN-PROPN-PROPN,compound-pobj,compound-compound-dobj,NNP-NNP,NNP-NNP-NNP,5,1
4073,2428.0,19,signed,5,2,12,10,1,6,3,7,United States,Herbie Hancock,org-org,-,PROPN-PROPN,PROPN-PROPN,compound-nsubj,compound-pobj,NNP-NNP,NNP-NNP,5,1
4074,2429.0,31,made,3,3,15,12,2,15,0,12,Cruz,Sonora Matancera,org,-,PROPN,PROPN-PROPN,nsubj,compound-pobj,NNP,NNP-NNP,4,1
4075,2430.0,28,said,7,5,12,7,4,15,2,5,Fouad Siniora,Lebanon,-,org,PROPN-PROPN,PROPN,compound-nsubj,pobj,NNP-NNP,NNP,6,1
4076,13712.0,28,criticized,6,5,12,7,4,15,1,6,Fouad Siniora,Lebanon,per-per,,PROPN-PROPN,PROPN,compound-nsubj,pobj,NNP-NNP,NNP,5,1
4077,2431.0,44,Series,2,5,7,2,4,36,-3,5,Sally Field,Brothers Sisters,per-per,-,PROPN-PROPN,PROPN-PROPN,compound-compound,compound-compound,NNP-NNP,NNPS-NNPS,1,1
4078,9809.0,38,took,5,4,21,17,3,16,1,16,Sally Field,Brothers Sisters,per-per,-,PROPN-PROPN,PROPN-PROPN,compound-nsubj,compound-appos,NNP-NNP,NNPS-NNPS,6,1
4079,2432.0,27,said,17,19,25,6,18,1,-2,8,J. Christopher Flowers,JC Flowers,--,org-org,PROPN-PROPN-PROPN,PROPN-PROPN,compound-compound-nmod,compound-pobj,NNP-NNP-NNP,NNP-NNP,4,1
4080,2433.0,23,was,1,6,9,3,5,13,-5,8,Wheaton College,Massachusetts,per-per,,PROPN-PROPN,PROPN,compound-compound,pobj,NNP-NNP,NNP,6,1
4081,2445.0,16,graduated,1,4,7,3,3,8,-3,6,Wheaton College,Massachusetts,per-per,,PROPN-PROPN,PROPN,compound-pobj,pobj,NNP-NNP,NNP,3,1
4082,2435.0,39,captured,7,10,17,7,9,21,-3,10,New Jersey,Bret Schundler,org-org,-,PROPN-PROPN,PROPN-PROPN,compound-compound,compound-conj,NNP-NNP,NNP-NNP,5,1
4083,2436.0,34,say,1,7,10,3,6,23,-6,9,Ventura College,California,per-per,,PROPN-PROPN,PROPN,compound-pobj,pobj,NNP-NNP,NNP,3,1
4084,2437.0,24,grew,1,10,13,3,9,10,-9,12,his,France,org,,DET,PROPN,poss,pobj,PRP$,NNP,4,1
4085,2438.0,32,sold,9,12,15,3,11,16,-3,6,Loeb,Ontario,org,,PROPN,PROPN,compound,pobj,NNP,NNP,3,1
4086,12128.0,18,began,1,1,16,15,0,1,0,15,Loeb,Ontario,org,,PROPN,PROPN,nsubj,compound,NNP,NNP,6,1
4087,2439.0,26,stood,14,4,8,4,3,17,10,-6,4th Mechanized Corps,Soviet Union,per-per-per,-,ADJ-PROPN-PROPN,PROPN-PROPN,amod-amod-pobj,compound-appos,JJ-NNP-NNP,NNP-NNP,2,1
4088,13590.0,25,stood,6,10,14,4,9,10,-4,8,4th Mechanized Corps,Soviet Union,org-org-org,-,ADJ-PROPN-PROPN,PROPN-PROPN,amod-amod-appos,compound-appos,JJ-NNP-NNP,NNP-NNP,2,1
4089,2441.0,39,reported,11,9,15,6,8,23,2,4,Studio Ghibli,Hayao Miyazaki,org-org,-,PROPN-PROPN,PROPN-PROPN,compound-compound,compound-nsubj,NNP-NNP,NNP-NNP,7,1
4090,8950.0,18,1915,0,11,16,5,10,1,-11,16,Studio Ghibli,Hayao Miyazaki,per-per,-,PROPN-PROPN,PROPN-PROPN,compound-compound,compound-appos,NNP-NNP,NNP-NNP,4,1
4091,9287.0,23,has,2,7,11,4,6,11,-5,9,Studio Ghibli,Hayao Miyazaki,per-per,-,PROPN-PROPN,PROPN-PROPN,compound-pobj,compound-pobj,NNP-NNP,NNP-NNP,5,1
4092,11721.0,36,established,13,1,16,15,0,19,12,3,Studio Ghibli,Hayao Miyazaki,org-org,-,PROPN-PROPN,PROPN-PROPN,compound-nsubjpass,compound-nmod,NNP-NNP,NNP-NNP,4,1
4093,2442.0,40,was,10,10,15,5,9,24,0,5,Scarpaleggia,Quebec,,per,PROPN,PROPN,nsubj,compound,NNP,NNP,3,1
4094,2443.0,13,born,8,5,6,1,4,6,3,-2,Israel,Ariel Sharon,per,-,PROPN,PROPN-PROPN,pobj,compound-nsubjpass,NNP,NNP-NNP,1,1
4095,2444.0,17,established,3,8,13,5,7,3,-5,10,Bhopal,Barkatullah University,per,-,PROPN,PROPN-PROPN,compound,compound-oprd,NNP,NNP-NNP,4,1
4096,2446.0,48,beat,5,2,11,9,1,36,3,6,University of Southern California,Los Angeles,---,org-org,PROPN-ADP-PROPN-PROPN,PROPN-PROPN,nsubj-prep-compound-pobj,compound-appos,NNP-IN-NNP-NNP,NNP-NNP,3,1
4097,2447.0,25,Jay,1,1,3,2,0,21,0,2,Paul Jay,The Real News,org-org,--,PROPN-PROPN,DET-PROPN-PROPN,compound-ROOT,det-compound-poss,NNP-NNP,DT-NNP-NNP,4,1
4098,2448.0,38,acted,4,2,14,12,1,23,2,10,Comptroller,Maryland,,per,PROPN,PROPN,pobj,compound,NNP,NNP,4,1
4099,2449.0,51,Company,1,6,12,6,5,38,-5,11,Chew Choon Seng,Singapore Airlines,--,per-per,VERB-PROPN-PROPN,PROPN-PROPN,compound-compound-nsubj,compound-pobj,VBP-NNP-NNP,NNP-NNP,4,1
4100,2450.0,35,shown,9,1,7,6,0,27,8,-2,Thatcher,Conservative Party,org,-,PROPN,PROPN-PROPN,nsubjpass,compound-pobj,NNP,NNP-NNP,4,1
4101,2451.0,25,is,10,19,23,4,18,1,-9,13,F.C. Copenhagen,Danish Superliga,per-per,-,PROPN-PROPN,PROPN-PROPN,compound-pobj,compound-pobj,NNP-NNP,NNP-NNP,4,1
4102,2452.0,35,has,5,5,28,23,4,6,0,23,NavyArmy,Stripes convenience stores,org,--,PROPN,PROPN-NOUN-NOUN,nsubj,compound-compound-pobj,NNP,NNPS-NN-NNS,9,1
4103,2453.0,44,remained,15,13,26,13,12,17,2,11,Ahmad Shah Massoud,Afghanistan,org-org-org,,PROPN-PROPN-PROPN,PROPN,compound-compound-pobj,pobj,NNP-NNP-NNP,NNP,11,1
4104,6639.0,29,set,7,14,28,14,13,0,-7,21,Ahmad Shah Massoud,Afghanistan,per-per-per,,PROPN-PROPN-PROPN,PROPN,compound-compound-pobj,pobj,NNP-NNP-NNP,NNP,4,1
4105,2454.0,24,became,1,1,10,9,0,13,0,9,He,Czechoslovakia,,per,PRON,PROPN,nsubj,pobj,PRP,NNP,3,1
4106,6325.0,12,served,1,1,7,6,0,4,0,6,He,Czechoslovakia,org,,PRON,PROPN,nsubj,pobj,PRP,NNP,1,1
4107,11296.0,8,returned,1,1,4,3,0,3,0,3,He,Czechoslovakia,,per,PRON,PROPN,nsubj,pobj,PRP,NNP,1,1
4108,2455.0,18,received,5,10,13,3,9,4,-5,8,the,Manchester,org,,DET,PROPN,det,pobj,DT,NNP,4,1
4109,2456.0,26,were,2,8,25,17,7,0,-6,23,1980,Solidarity,per,,NUM,PROPN,nummod,pobj,CD,NNP,2,1
4110,11218.0,49,catapulted,13,20,40,20,19,8,-7,27,1980,Solidarity,org,,NUM,PROPN,pobj,attr,CD,NNP,14,1
4111,2457.0,35,hospitalized,4,1,25,24,0,9,3,21,Khieu Samphan,Cambodia,-,per,PROPN-PROPN,PROPN,compound-nsubjpass,pobj,NNP-NNP,NNP,5,1
4112,2458.0,25,launched,2,18,24,6,17,0,-16,22,Davey Tree Expert Company,Kent,---,org,PROPN-PROPN-PROPN-PROPN,PROPN,compound-compound-compound-dobj,pobj,NNP-NNP-NNP-NNP,NNP,3,1
4113,7326.0,36,published,3,20,29,9,19,6,-17,26,Davey Tree Expert Company,Kent,org-org-org-org,,PROPN-PROPN-PROPN-PROPN,PROPN,compound-compound-compound-dobj,pobj,NNP-NNP-NNP-NNP,NNP,6,1
4114,2460.0,65,became,1,48,62,14,47,2,-47,61,Arizona,Salt River Project,org,--,PROPN,PROPN-PROPN-PROPN,pobj,compound-compound-pobj,NNP,NNP-NNP-NNP,3,1
4115,2461.0,40,Three,0,4,16,12,3,23,-4,16,Army,Punjab Regiment,,org-org,PROPN,PROPN-PROPN,poss,compound-compound,NNP,NNP-NNP,4,1
4116,2462.0,22,agreed,9,9,15,6,8,6,0,6,Halifax,HBOS,per,,PROPN,PROPN,nsubj,dobj,NNP,NNP,2,1
4117,2463.0,20,became,2,1,8,7,0,11,1,6,Harold Wilson,United Kingdom,-,org-org,PROPN-PROPN,PROPN-PROPN,compound-nsubj,compound-pobj,NNP-NNP,NNP-NNP,4,1
4118,14099.0,60,2nd,3,45,58,13,44,1,-42,55,Harold Wilson,United Kingdom,-,per-per,PROPN-PROPN,PROPN-PROPN,compound-pobj,compound-pobj,NNP-NNP,NNP-NNP,7,1
4119,2464.0,34,include,1,21,29,8,20,4,-20,28,Texas,University,per,,PROPN,PROPN,compound,conj,NNP,NNP,6,1
4120,2465.0,32,assisted,14,8,8,0,7,23,6,-6,China University of Political Science and Law,China,------,org,PROPN-PROPN-ADP-PROPN-PROPN-CCONJ-PROPN,PROPN,compound-pobj-prep-compound-pobj-cc-conj,poss,NNP-NNP-IN-NNP-NNP-CC-NNP,NNP,0,1
4121,2468.0,37,had,1,23,20,-3,22,16,-22,19,Juilliard School,New York,per-per,-,PROPN-PROPN,PROPN-PROPN,compound-compound,compound-pobj,NNP-NNP,NNP-NNP,7,1
4122,2470.0,37,offers,5,1,28,27,0,8,4,23,St. Charles North High School,Illinois,----,org,PROPN-PROPN-PROPN-PROPN-PROPN,PROPN,compound-compound-compound-compound-nsubj,nmod,NNP-NNP-NNP-NNP-NNP,NNP,9,1
4123,2471.0,34,celebrated,18,12,33,21,11,0,6,15,Bustamante,Jamaica,per,,PROPN,PROPN,poss,pobj,NNP,NNP,7,1
4124,2472.0,30,is,18,11,18,7,10,11,7,0,Ben-Gurion University of the Negev,Israel,org-org-org-org-org,,PROPN-PROPN-ADP-DET-PROPN,PROPN,compound-pobj-prep-det-pobj,pobj,NNP-NNP-IN-DT-NNP,NNP,7,1
4125,2473.0,25,was,2,1,1,0,0,23,1,-1,Tiridates,Tiridates I of Armenia,,per-per-per-per,NOUN,PROPN-PRON-ADP-PROPN,compound,appos-appos-prep-pobj,NNS,NNPS-PRP-IN-NNP,0,1
4126,2474.0,44,said,1,26,31,5,25,12,-25,30,Sweden,Olof Palme,,org-org,PROPN,PROPN-PROPN,pobj,compound-compound,NNP,NNP-NNP,3,1
4127,2475.0,16,died,2,1,12,11,0,3,1,10,Duncan Stewart,Uruguay,-,per,PROPN-PROPN,PROPN,compound-nsubj,poss,NNP-NNP,NNP,8,1
4128,2478.0,26,is,10,2,7,5,1,18,8,-3,Brazilian Navy,Marinha do Brasil,per-per,--,ADJ-PROPN,PROPN-VERB-PROPN,amod-nsubj,nsubj-dep-dobj,JJ-NNP,NNP-VBP-NNP,1,1
4129,2480.0,21,formed,3,17,20,3,16,0,-14,17,Wanderers F.C.,1877,org-org,,PROPN-PROPN,NUM,compound-oprd,pobj,NNP-NNP,CD,3,1
4130,2481.0,40,had,15,11,14,3,10,25,4,-1,Partizan,Euroleague,,per,PROPN,PROPN,pobj,compound,NNP,NNP,1,1
4131,2483.0,23,earned,8,3,6,3,2,16,5,-2,University of Toronto,John Tuzo Wilson,per-per-per,--,PROPN-ADP-PROPN,PROPN-PROPN-PROPN,nmod-prep-pobj,compound-compound-nsubj,NNP-IN-NNP,NNP-NNP-NNP,5,1
4132,2484.0,22,attended,1,6,3,-3,5,18,-5,2,Stillwater,Oklahoma State Cowboys,org,--,PROPN,PROPN-PROPN-PROPN,dobj,compound-compound-compound,NNP,NNP-NNP-NNPS,4,1
4133,6255.0,23,attended,1,6,3,-3,5,19,-5,2,Stillwater,Oklahoma State Cowboys,per,--,PROPN,PROPN-PROPN-PROPN,dobj,compound-compound-compound,NNP,NNP-NNP-NNPS,4,1
4134,2486.0,29,owned,2,7,11,4,6,17,-5,9,NTV,Moscow,,org,PROPN,PROPN,dobj,conj,NNP,NNP,5,1
4135,2487.0,47,JAKARTA,0,21,23,2,20,23,-21,23,Japan,Inpex,per,,PROPN,PROPN,poss,compound,NNP,NNP,2,1
4136,3101.0,19,rose,6,11,13,2,10,5,-5,7,Japan,Inpex,org,,PROPN,PROPN,poss,compound,NNP,NNP,2,1
4137,2488.0,14,was,1,3,8,5,2,5,-2,7,London,Liberty Records,org,-,PROPN,PROPN-PROPN,poss,compound-pobj,NNP,NNP-NNPS,4,1
4138,2489.0,21,created,3,1,20,19,0,0,2,17,Sears Holdings,2005,-,per,PROPN-PROPN,NUM,compound-nsubjpass,nummod,NNP-NNPS,CD,2,1
4139,2490.0,20,covered,5,11,12,1,10,7,-6,7,singer,Minori Chihara,,per-per,NOUN,PROPN-PROPN,compound,compound-conj,NN,NNP-NNP,1,1
4140,2491.0,24,was,12,2,23,21,1,0,10,11,Joseph Cook,Australia,per-per,,PROPN-PROPN,PROPN,compound-compound,pobj,NNP-NNP,NNP,3,1
4141,8110.0,24,born,16,2,15,13,1,8,14,-1,Joseph Cook,Australia,per-per,,PROPN-PROPN,PROPN,compound-compound,pobj,NNP-NNP,NNP,-1,1
4142,10049.0,22,took,12,11,14,3,10,7,1,2,Joseph Cook,Australia,per-per,,PROPN-PROPN,PROPN,compound-conj,poss,NNP-NNP,NNP,5,1
4143,2493.0,25,Chairman,8,18,19,1,17,5,-10,11,BSU,Minsk,,per,PROPN,PROPN,compound,appos,NNP,NNP,3,1
4144,2494.0,19,spoke,1,15,17,2,14,1,-14,16,Interior,Dirk Kempthorne,org,-,PROPN,PROPN-PROPN,compound,compound-pobj,NNP,NNP-NNP,1,1
4145,4212.0,32,facing,4,1,3,2,0,28,3,-1,Interior,Dirk Kempthorne,org,-,PROPN,PROPN-PROPN,compound,compound-nsubj,NNP,NNP-NNP,1,1
4146,5011.0,31,proposed,4,1,3,2,0,27,3,-1,Interior,Dirk Kempthorne,,org-org,PROPN,PROPN-PROPN,compound,compound-nsubj,NNP,NNP-NNP,1,1
4147,5526.0,42,included,2,7,8,1,6,33,-5,6,Interior,Dirk Kempthorne,per,-,PROPN,PROPN-PROPN,pobj,compound-dobj,NNP,NNP-NNP,1,1
4148,7034.0,14,issue,9,6,7,1,5,6,3,-2,Interior,Dirk Kempthorne,,per-per,PROPN,PROPN-PROPN,compound,compound-pobj,NNP,NNP-NNP,1,1
4149,7201.0,29,carried,7,18,27,9,17,1,-11,20,Interior,Dirk Kempthorne,,org-org,PROPN,PROPN-PROPN,compound,compound-conj,NNP,NNP-NNP,7,1
4150,8711.0,21,pushed,13,10,11,1,9,9,3,-2,Interior,Dirk Kempthorne,per,-,PROPN,PROPN-PROPN,compound,compound-pobj,NNP,NNP-NNP,1,1
4151,8922.0,14,handed,3,11,12,1,10,1,-8,9,Interior,Dirk Kempthorne,org,-,PROPN,PROPN-PROPN,compound,compound-pobj,NNP,NNP-NNP,1,1
4152,10677.0,16,became,1,8,10,2,7,5,-7,9,Interior,Dirk Kempthorne,,per-per,PROPN,PROPN-PROPN,pobj,compound-dobj,NNP,NNP-NNP,1,1
4153,11169.0,13,Norton,5,4,9,5,3,3,1,4,Interior,Dirk Kempthorne,per,-,PROPN,PROPN-PROPN,compound,compound-nsubj,NNP,NNP-NNP,-1,1
4154,11687.0,38,said,22,20,21,1,19,16,2,-1,Interior,Dirk Kempthorne,,per-per,PROPN,PROPN-PROPN,pobj,compound-pobj,NNP,NNP-NNP,1,1
4155,11994.0,28,sworn,5,19,20,1,18,7,-14,15,Interior,Dirk Kempthorne,per,-,PROPN,PROPN-PROPN,compound,compound-pobj,NNP,NNP-NNP,1,1
4156,12269.0,32,discovered,1,17,30,13,16,1,-16,29,Interior,Dirk Kempthorne,,org-org,PROPN,PROPN-PROPN,compound,compound-pobj,NNP,NNP-NNP,7,1
4157,12594.0,18,lives,13,3,5,2,2,12,10,-8,Interior,Dirk Kempthorne,,org-org,PROPN,PROPN-PROPN,compound,compound-nsubj,NNP,NNP-NNP,1,1
4158,12860.0,35,led,5,19,20,1,18,14,-14,15,Interior,Dirk Kempthorne,per,-,PROPN,PROPN-PROPN,compound,compound-pobj,NNP,NNP-NNP,1,1
4159,13283.0,27,expand,5,1,3,2,0,23,4,-2,Interior,Dirk Kempthorne,,org-org,PROPN,PROPN-PROPN,compound,compound-nsubj,NNP,NNP-NNP,1,1
4160,13788.0,17,declared,11,5,7,2,4,9,6,-4,Interior,Dirk Kempthorne,org,-,PROPN,PROPN-PROPN,compound,compound-compound,NNP,NNP-NNP,1,1
4161,2495.0,15,launched,2,8,10,2,7,4,-6,8,Maxim,Dennis Publishing,,org-org,PROPN,PROPN-PROPN,compound,compound-pobj,NNP,NNP-NNP,1,1
4162,2496.0,23,are,1,7,14,7,6,8,-6,13,Madurai,Thiagarajar College of Engineering,org,---,PROPN,PROPN-PROPN-ADP-PROPN,pobj,compound-nsubj-prep-pobj,NNP,NNP-NNP-IN-NNP,2,1
4163,2497.0,21,compete,8,7,18,11,6,2,1,10,Waterloo Warriors,Canadian Interuniversity Sport,-,org-org-org,PROPN-PROPN,PROPN-PROPN-PROPN,compound-pobj,compound-compound-pobj,NNP-NNPS,NNP-NNP-NNP,10,1
4164,2499.0,35,discussed,21,17,19,2,16,15,4,-2,Prime Minister,Jan Peter Balkenende,-,per-per-per,PROPN-PROPN,PROPN-PROPN-PROPN,compound-compound,compound-compound-dobj,NNP-NNP,NNP-NNP-NNP,2,1
4165,7140.0,22,said,8,4,6,2,3,15,4,-2,Prime Minister,Jan Peter Balkenende,-,org-org-org,PROPN-PROPN,PROPN-PROPN-PROPN,compound-nsubj,compound-compound-appos,NNP-NNP,NNP-NNP-NNP,2,1
4166,12945.0,25,asked,6,9,11,2,8,13,-3,5,Prime Minister,Jan Peter Balkenende,per-per,--,PROPN-PROPN,PROPN-PROPN-PROPN,compound-compound,compound-compound-dobj,NNP-NNP,NNP-NNP-NNP,2,1
4167,2500.0,16,is,5,3,11,8,2,4,2,6,BYD Company,China,-,org,PROPN-PROPN,PROPN,compound-pobj,pobj,NNP-NNP,NNP,4,1
4168,2501.0,27,is,1,16,18,2,15,8,-15,17,Algeria,Sonatrach,,per,PROPN,PROPN,poss,pobj,NNP,NNP,3,1
4169,2502.0,28,origins,1,4,16,12,3,11,-3,15,CBS,United Independent Broadcasters,org,--,PROPN,PROPN-PROPN-PROPN,compound,compound-compound-compound,NNP,NNP-NNP-NNPS,8,1
4170,2503.0,20,said,17,9,16,7,8,3,8,-1,Matisse,French,,org,PROPN,ADJ,pobj,amod,NNP,JJ,8,1
4171,2504.0,32,tutored,27,8,21,13,7,10,19,-6,Henry,Catherine of Aragon,per,--,PROPN,PROPN-ADP-PROPN,compound,pobj-prep-pobj,NNP,NNP-IN-NNP,8,1
4172,5259.0,73,stems,14,41,46,5,40,26,-27,32,Henry,Catherine of Aragon,per,--,PROPN,PROPN-ADP-PROPN,compound,pobj-prep-pobj,NNP,NNP-IN-NNP,2,1
4173,2506.0,29,is,1,11,16,5,10,12,-10,15,Los Medanos College,California,--,per,PROPN-PROPN-PROPN,PROPN,compound-compound-pobj,pobj,NNP-NNP-NNP,NNP,5,1
4174,2508.0,13,born,2,1,7,6,0,5,1,5,Nkurunziza,Burundi,,org,PROPN,PROPN,nsubjpass,poss,NNP,NNP,5,1
4175,2509.0,32,said,24,19,23,4,18,8,5,-1,Birzeit University,West Bank,org-org,-,PROPN-PROPN,PROPN-PROPN,compound-pobj,compound-pobj,NNP-NNP,NNP-NNP,2,1
4176,5471.0,39,said,26,33,37,4,32,1,-7,11,Birzeit University,West Bank,-,org-org,PROPN-PROPN,PROPN-PROPN,compound-pobj,compound-pobj,NNP-NNP,NNP-NNP,4,1
4177,2510.0,20,is,2,1,17,16,0,2,1,15,Notorious MSG,New York City,-,per-per-per,PROPN-PROPN,PROPN-PROPN-PROPN,amod-nsubj,compound-compound-pobj,NNP-NNP,NNP-NNP-NNP,8,1
4178,2511.0,43,was,14,23,37,14,22,5,-9,23,Communist Party of the Soviet Union,August 1991,org-org-org-org-org-org,-,PROPN-PROPN-ADP-DET-PROPN-PROPN,PROPN-NUM,compound-pobj-prep-det-compound-pobj,pobj-nummod,NNP-NNP-IN-DT-NNP-NNP,NNP-CD,8,1
4179,2512.0,7,based,2,1,5,4,0,1,1,3,GO,Marsa,,org,PROPN,PROPN,nsubjpass,compound,NNP,NNP,3,1
4180,2513.0,18,appointed,4,10,17,7,9,0,-6,13,Surayud Chulanont,Thailand,-,org,PROPN-PROPN,PROPN,compound-dobj,pobj,NNP-NNP,NNP,2,1
4181,2514.0,60,MOH,7,2,8,6,1,51,5,1,Ministry of Health,MOH,--,per,PROPN-ADP-PROPN,PROPN,nmod-prep-pobj,ROOT,NNP-IN-NNP,NNP,3,1
4182,2515.0,53,served,2,9,19,10,8,33,-7,17,UCLA School of Public Affairs,Los Angeles,----,per-per,PROPN-PROPN-ADP-PROPN-PROPN,PROPN-PROPN,compound-pobj-prep-compound-pobj,compound-appos,NNP-NNP-IN-NNP-NNPS,NNP-NNP,4,1
4183,2517.0,12,choose,1,1,6,5,0,5,0,5,Kaamos,Candlelight,,org,PROPN,PROPN,nsubj,compound,NNP,NNP,3,1
4184,2518.0,23,is,1,1,8,7,0,14,0,7,He,Punch Brothers,org,-,PRON,PROPN-PROPN,nsubj,compound-appos,PRP,NNP-NNPS,4,1
4185,2519.0,29,nominated,12,11,24,13,10,4,1,12,United States,Calvin Coolidge,per-per,-,PROPN-PROPN,PROPN-PROPN,compound-pobj,compound-conj,NNP-NNP,NNP-NNP,9,1
4186,2520.0,20,is,2,1,2,1,0,17,1,0,Aero Slovakia,Slovakia,-,per,PROPN-PROPN,PROPN,compound-nsubj,pobj,NNP-NNP,NNP,1,1
4187,2521.0,50,connected,4,36,21,-15,35,28,-32,17,MI6,Secret Intelligence Service,,per-per-per,NOUN,PROPN-PROPN-PROPN,ROOT,compound-compound-pobj,NNS,NNP-NNP-NNP,8,1
4188,2522.0,24,worked,1,8,22,14,7,1,-7,21,California,Barbara Boxer,org,-,PROPN,PROPN-PROPN,compound,compound-pobj,NNP,NNP-NNP,10,1
4189,10023.0,20,renominated,13,1,11,10,0,8,12,-2,California,Barbara Boxer,per,-,PROPN,PROPN-PROPN,poss,compound-nsubjpass,NNP,NNP-NNP,5,1
4190,11018.0,32,want,14,6,8,2,5,23,8,-6,California,Barbara Boxer,,per-per,PROPN,PROPN-PROPN,compound,compound-pobj,NNP,NNP-NNP,1,1
4191,2523.0,27,became,8,2,13,11,1,13,6,5,Arkansas,1st Arkansas Infantry,per,--,PROPN,ADJ-PROPN-PROPN,nsubj,compound-compound-pobj,NNP,JJ-NNP-NNP,5,1
4192,2524.0,42,sued,6,8,8,0,7,33,-2,2,ESPN,ESPN Classic,per,-,PROPN,PROPN-PROPN,nsubj,compound-conj,NNP,NNP-NNP,0,1
4193,2527.0,18,defeated,8,13,16,3,12,1,-5,8,Los Angeles,Tom Bradley,org-org,-,PROPN-PROPN,PROPN-PROPN,compound-compound,compound-appos,NNP-NNP,NNP-NNP,2,1
4194,9074.0,36,ran,3,17,32,15,16,3,-14,29,Los Angeles,Tom Bradley,per-per,-,PROPN-PROPN,PROPN-PROPN,compound-compound,compound-pobj,NNP-NNP,NNP-NNP,10,1
4195,11468.0,32,went,10,20,25,5,19,6,-10,15,Los Angeles,Tom Bradley,per-per,-,PROPN-PROPN,PROPN-PROPN,compound-compound,compound-conj,NNP-NNP,NNP-NNP,2,1
4196,13346.0,19,served,6,14,17,3,13,1,-8,11,Los Angeles,Tom Bradley,org-org,-,PROPN-PROPN,PROPN-PROPN,compound-compound,compound-pobj,NNP-NNP,NNP-NNP,2,1
4197,2528.0,44,served,10,18,37,19,17,6,-8,27,Minnesota,Satveer Chaudhary,org,-,PROPN,PROPN-PROPN,nmod,compound-dobj,NNP,NNP-NNP,7,1
4198,2529.0,8,Member,2,2,7,5,1,0,0,5,Michael,Kingdom,per,,PROPN,PROPN,compound,appos,NNP,NNP,2,1
4199,2530.0,16,was,3,1,15,14,0,0,2,12,Jagadish Chandra Bose,India,org-org-org,,PROPN-PROPN-PROPN,PROPN,compound-compound-nsubj,pobj,NNP-NNP-NNP,NNP,8,1
4200,2531.0,30,arrived,14,11,17,6,10,12,3,3,I SS Panzer Corps,Hungary,org-org-org-org,,PRON-PROPN-PROPN-PROPN,PROPN,compound-compound-compound-nsubj,pobj,PRP-NNP-NNP-NNP,NNP,7,1
4201,2532.0,33,purchased,1,1,31,30,0,1,0,30,Eminem,Bass Brothers,org,-,PROPN,PROPN-PROPN,nsubj,compound-pobj,NNP,NNP-NNPS,9,1
4202,2534.0,21,is,9,16,20,4,15,0,-7,11,Sofia Rotaru,Ukraine,per-per,,PROPN-PROPN,PROPN,compound-pobj,pobj,NNP-NNP,NNP,4,1
4203,7877.0,12,awarded,5,3,11,8,2,0,2,6,Sofia Rotaru,Ukraine,per-per,,PROPN-PROPN,PROPN,compound-nsubjpass,pobj,NNP-NNP,NNP,2,1
4204,13779.0,27,received,14,1,9,8,0,17,13,-5,Sofia Rotaru,Ukraine,per-per,,PROPN-PROPN,PROPN,compound-nsubj,pobj,NNP-NNP,NNP,2,1
4205,2535.0,26,became,16,10,18,8,9,7,6,2,United States,Eminem,-,per,PROPN-PROPN,PROPN,compound-pobj,poss,NNP-NNP,NNP,9,1
4206,2536.0,16,is,6,1,10,9,0,5,5,4,Alaskan Air Command,United States Air Force,org-org-org,---,PROPN-PROPN-PROPN,PROPN-PROPN-PROPN-PROPN,amod-compound-nsubj,compound-compound-compound-compound,NNP-NNP-NNP,NNP-NNP-NNP-NNP,5,1
4207,2539.0,26,is,3,1,17,16,0,8,2,14,Firbank Grammar School,Brighton,--,org,PROPN-PROPN-PROPN,PROPN,compound-compound-nsubj,pobj,NNP-NNP-NNP,NNP,7,1
4208,2541.0,44,was,1,15,17,2,14,26,-14,16,soil,Chicago,,per,NOUN,PROPN,pobj,pobj,NN,NNP,9,1
4209,2542.0,34,come,30,9,9,0,8,24,21,-21,Hong Kong Express Airways,Hong Kong,per-per-per-per,-,PROPN-PROPN-PROPN-PROPN,PROPN-PROPN,compound-compound-compound-pobj,compound-pobj,NNP-NNP-NNP-NNP,NNP-NNP,0,1
4210,2543.0,26,play,8,16,12,-4,15,13,-8,4,Virginia Wesleyan College,Division III,--,per-per,PROPN-PROPN-PROPN,PROPN-PROPN,compound-compound-poss,compound-pobj,NNP-NNP-NNP,NNP-NNP,5,1
4211,2544.0,57,dissolved,2,17,28,11,16,28,-15,26,Isao Takahata,Studio Ghibli,-,per-per,PROPN-PROPN,PROPN-PROPN,compound-conj,compound-pobj,NNP-NNP,NNP-NNP,5,1
4212,10619.0,22,worked,1,12,18,6,11,3,-11,17,Isao Takahata,Studio Ghibli,per-per,-,PROPN-PROPN,PROPN-PROPN,compound-conj,compound-dobj,NNP-NNP,NNP-NNP,5,1
4213,2545.0,14,won,1,5,10,5,4,3,-4,9,PFF League,Pakistan Premier League,-,org-org-org,PROPN-PROPN,PROPN-PROPN-PROPN,compound-dobj,compound-compound-pobj,NNP-NNP,NNP-NNP-NNP,5,1
4214,2547.0,43,housed,12,22,38,16,21,4,-10,26,Philadelphia,University of the Arts,per,---,PROPN,PROPN-ADP-DET-PROPN,compound,parataxis-prep-det-pobj,NNP,NNP-IN-DT-NNPS,3,1
4215,2548.0,48,help,37,5,17,12,4,30,32,-20,Sergey Brin,Google,per-per,,PROPN-PROPN,PROPN,compound-conj,dobj,NNP-NNP,NNP,4,1
4216,8220.0,20,announced,7,1,7,6,0,12,6,0,Sergey Brin,Google,-,per,PROPN-PROPN,PROPN,compound-nsubj,pobj,NNP-NNP,NNP,2,1
4217,2550.0,15,was,1,1,11,10,0,3,0,10,Crossbreed,Florida,per,,PROPN,PROPN,nsubj,pobj,NNP,NNP,2,1
4218,2551.0,39,forced,24,7,18,11,6,20,17,-6,Yes,Chris Squire,,per-per,PROPN,PROPN-PROPN,pobj,compound-pobj,NNP,NNP-NNP,7,1
4219,2552.0,43,founded,3,13,15,2,12,27,-10,12,2002,Caribbean Sun Airlines,,org-org-org,NUM,PROPN-PROPN-PROPN,nummod,compound-compound-pobj,CD,NNP-NNP-NNP,2,1
4220,2553.0,53,featured,2,10,13,3,9,39,-8,11,actress,Sandra Bernhard,per,-,NOUN,PROPN-PROPN,compound,compound-pobj,NN,NNP-NNP,1,1
4221,2554.0,29,is,6,17,25,8,16,3,-11,19,48th Infantry Brigade Combat Team,Georgia,----,per,ADJ-PROPN-PROPN-PROPN-PROPN,PROPN,amod-compound-compound-compound-pobj,compound,JJ-NNP-NNP-NNP-NNP,NNP,6,1
4222,2556.0,65,responded,5,32,43,11,31,21,-27,38,Thailand,Anand Panyarachun,org,-,PROPN,PROPN-PROPN,pobj,compound-nsubjpass,NNP,NNP-NNP,-1,1
4223,4004.0,36,said,8,5,25,20,4,10,3,17,Thailand,Anand Panyarachun,per,-,PROPN,PROPN-PROPN,poss,compound-pobj,NNP,NNP-NNP,10,1
4224,8171.0,25,been,7,6,23,17,5,1,1,16,Thailand,Anand Panyarachun,org,-,PROPN,PROPN-PROPN,pobj,compound-pobj,NNP,NNP-NNP,8,1
4225,2557.0,37,exploring,27,17,25,8,16,11,10,-2,Pat Roberts,Kansas,per-per,,PROPN-PROPN,PROPN,compound-conj,pobj,NNP-NNP,NNP,4,1
4226,2558.0,25,is,8,1,21,20,0,3,7,13,Garnet Crow,Giza Studio,org-org,-,PROPN-PROPN,PROPN-PROPN,compound-nsubj,compound-compound,NNP-NNP,NNP-NNP,7,1
4227,2559.0,35,is,8,16,25,9,15,9,-8,17,Western Michigan Broncos,NCAA,--,org,PROPN-PROPN-PROPN,PROPN,compound-compound-compound,compound,NNP-NNP-NNP,NNP,6,1
4228,5970.0,21,represented,7,3,15,12,2,5,4,8,Western Michigan Broncos,NCAA,--,org,PROPN-PROPN-PROPN,PROPN,amod-compound-compound,compound,NNP-NNP-NNP,NNP,5,1
4229,6902.0,22,was,9,4,12,8,3,9,5,3,Western Michigan Broncos,NCAA,--,org,ADJ-PROPN-PROPN,PROPN,amod-compound-compound,compound,JJ-NNP-NNP,NNP,6,1
4230,2561.0,20,moved,3,9,16,7,8,3,-6,13,Berlin,Technical University of Berlin,,org-org-org-org,PROPN,PROPN-PROPN-ADP-PROPN,compound,compound-pobj-prep-pobj,NNP,NNP-NNP-IN-NNP,6,1
4231,2562.0,30,said,16,7,13,6,6,16,9,-3,Ji Baocheng,Renmin University of China,-,per-per-per-per,PROPN-PROPN,PROPN-PROPN-ADP-PROPN,compound-pobj,compound-pobj-prep-pobj,NNP-NNP,NNP-NNP-IN-NNP,3,1
4232,12340.0,54,said,31,33,48,15,32,5,-2,17,Ji Baocheng,Renmin University of China,per-per,---,PROPN-PROPN,PROPN-PROPN-ADP-PROPN,compound-nsubj,compound-pobj-prep-pobj,NNP-NNP,NNP-NNP-IN-NNP,4,1
4233,2563.0,28,said,4,1,3,2,0,24,3,-1,Foxconn,Terry Gou,org,-,PROPN,PROPN-PROPN,compound,compound-nsubj,NNP,NNP-NNP,1,1
4234,2564.0,46,was,19,18,19,1,17,26,1,0,Kenya,E-Sir,,org,PROPN,PROPN,compound,appos,NNP,NNP,2,1
4235,2565.0,19,is,6,2,4,2,1,14,4,-2,University of Talca,Talca,--,org,PROPN-ADP-PROPN,PROPN,nsubj-prep-pobj,pobj,NNP-IN-NNP,NNP,3,1
4236,2566.0,37,became,4,13,20,7,12,16,-9,16,Hamilton,McMaster University,per,-,PROPN,PROPN-PROPN,compound,compound-pobj,NNP,NNP-NNP,6,1
4237,2568.0,35,was,11,28,34,6,27,0,-17,23,Edward Blake,Ontario,-,org,PROPN-PROPN,PROPN,compound-pobj,pobj,NNP-NNP,NNP,3,1
4238,2569.0,24,said,22,9,12,3,8,11,13,-10,Humana,Louisville,,per,PROPN,PROPN,compound,compound,NNP,NNP,2,1
4239,8628.0,24,include,13,16,19,3,15,4,-3,6,Humana,Louisville,,per,PROPN,PROPN,compound,compound,NNP,NNP,4,1
4240,2571.0,29,overthrown,13,5,26,21,4,2,8,13,Cambodia,Lon Nol,per,-,PROPN,PROPN-PROPN,poss,compound-appos,NNP,NNP-NNP,8,1
4241,6707.0,42,led,21,6,15,9,5,26,15,-6,Cambodia,Lon Nol,,per-per,PROPN,PROPN-PROPN,pobj,compound-pobj,NNP,NNP-NNP,5,1
4242,2572.0,28,been,24,1,7,6,0,20,23,-17,Edith of Wessex,Edward the Confessor,--,per-per-per,PROPN-ADP-PROPN,PROPN-DET-PROPN,nsubj-prep-pobj,pobj-det-appos,NNP-IN-NNP,NNP-DT-NNP,6,1
4243,2573.0,39,said,24,20,35,15,19,3,4,11,United Kingdom,Gordon Brown,per-per,-,PROPN-PROPN,PROPN-PROPN,compound-nsubjpass,compound-poss,NNP-NNP,NNP-NNP,-1,1
4244,2574.0,22,is,3,11,19,8,10,2,-8,16,USA,Jack Nicholson,per,-,PROPN,PROPN-PROPN,compound,compound-compound,NNP,NNP-NNP,3,1
4245,2575.0,34,merged,5,2,10,8,1,23,3,5,1 January 2005,University of Johannesburg,--,org-org-org,NUM-PROPN-NUM,PROPN-ADP-PROPN,nummod-pobj-nummod,dobj-prep-pobj,CD-NNP-CD,NNP-IN-NNP,4,1
4246,2576.0,40,says,19,7,18,11,6,21,12,-1,Peter F. Drucker and Masatoshi Ito Graduate School of Management,Claremont,per-per-per-per-per-per-per-per-per-per,,PROPN-PROPN-PROPN-CCONJ-PROPN-PROPN-PROPN-PROPN-ADP-PROPN,PROPN,compound-compound-pobj-cc-compound-compound-compound-conj-prep-pobj,compound,NNP-NNP-NNP-CC-NNP-NNP-NNP-NNP-IN-NNP,NNP,4,1
4247,2578.0,17,married,1,1,3,2,0,13,0,2,She,actor,,org,PRON,NOUN,nsubj,compound,PRP,NN,2,1
4248,2579.0,42,boasted,14,7,14,7,6,27,7,0,Vodafone,India,org,,PROPN,PROPN,compound,conj,NNP,NNP,6,1
4249,2580.0,26,include,3,11,13,2,10,12,-8,10,Mexico,Telmex,,per,PROPN,PROPN,pobj,appos,NNP,NNP,1,1
4250,11554.0,30,said,11,8,11,3,7,18,3,0,Mexico,Telmex,org,,PROPN,PROPN,compound,conj,NNP,NNP,1,1
4251,2581.0,28,booked,1,3,15,12,2,12,-2,14,Sun Ra,Arkestra,org-org,,PROPN-PROPN,PROPN,compound-dobj,pobj,NNP-NNP,NNP,4,1
4252,2582.0,32,Following,0,18,18,0,17,13,-18,18,British Pacific Fleet,British Commonwealth,org-org-org,-,PROPN-PROPN-PROPN,PROPN-PROPN,compound-compound-pobj,compound-compound,NNP-NNP-NNP,NNP-NNP,0,1
4253,3217.0,19,formed,13,5,5,0,4,13,8,-8,British Pacific Fleet,British Commonwealth,org-org-org,-,PROPN-PROPN-PROPN,PROPN-PROPN,compound-compound-nsubjpass,compound-compound,NNP-NNP-NNP,NNP-NNP,0,1
4254,2583.0,95,At,0,16,19,3,15,75,-16,19,United States,Franklin D. Roosevelt,-,org-org-org,PROPN-PROPN,PROPN-PROPN-PROPN,compound-pobj,compound-compound-pobj,NNP-NNP,NNP-NNP-NNP,8,1
4255,2584.0,35,was,1,26,30,4,25,4,-25,29,Luther Seminary,Minnesota,per-per,,PROPN-PROPN,PROPN,compound-compound,dobj,NNP-NNP,NNP,3,1
4256,2585.0,17,is,7,1,16,15,0,0,6,9,Tallinn University,Estonia,per-per,,PROPN-PROPN,PROPN,compound-nsubj,pobj,NNP-NNP,NNP,5,1
4257,2586.0,32,is,15,12,30,18,11,1,3,15,Bute Medical school,Fife,org-org-org,,PROPN-PROPN-NOUN,PROPN,compound-compound-appos,compound,NNP-NNP-NN,NNP,9,1
4258,2587.0,27,use,5,3,24,21,2,2,2,19,Pakistan,Shaheen Air International,,per-per-per,PROPN,PROPN-PROPN-PROPN,poss,compound-compound-conj,NNP,NNP-NNP-NNP,8,1
4259,2588.0,37,promised,9,6,21,15,5,15,3,12,Robert Fico,Slovakia,-,per,PROPN-PROPN,PROPN,compound-nsubj,pobj,NNP-NNP,NNP,3,1
4260,4133.0,20,led,2,5,11,6,4,8,-3,9,Robert Fico,Slovakia,-,per,PROPN-PROPN,PROPN,nmod-pobj,pobj,NNP-NNP,NNP,2,1
4261,7296.0,24,made,4,3,16,13,2,7,1,12,Robert Fico,Slovakia,org-org,,PROPN-PROPN,PROPN,compound-nsubj,poss,NNP-NNP,NNP,7,1
4262,7476.0,26,pledged,5,4,16,12,3,9,1,11,Robert Fico,Slovakia,org-org,,PROPN-PROPN,PROPN,compound-nsubj,nsubj,NNP-NNP,NNP,3,1
4263,9180.0,21,coming,17,4,20,16,3,0,13,3,Robert Fico,Slovakia,-,org,PROPN-PROPN,PROPN,compound-nsubj,pobj,NNP-NNP,NNP,3,1
4264,9438.0,29,said,4,3,13,10,2,15,1,9,Robert Fico,Slovakia,per-per,,PROPN-PROPN,PROPN,compound-nsubj,nsubj,NNP-NNP,NNP,4,1
4265,12454.0,34,said,4,3,9,6,2,24,1,5,Robert Fico,Slovakia,per-per,,PROPN-PROPN,PROPN,compound-nsubj,nsubj,NNP-NNP,NNP,3,1
4266,2590.0,28,deemed,10,1,17,16,0,10,9,7,Her,model,,per,DET,NOUN,poss,pobj,PRP$,NN,4,1
4267,2591.0,37,appointed,4,12,12,0,11,24,-8,8,IRA,IRA Army Council,,per-per-per,PROPN,PROPN-PROPN-PROPN,pobj,compound-compound-pobj,NNP,NNP-NNP-NNP,0,1
4268,3524.0,20,elects,4,8,8,0,7,11,-4,4,IRA,IRA Army Council,,per-per-per,PROPN,PROPN-PROPN-PROPN,compound,compound-compound-dobj,NNP,NNP-NNP-NNP,0,1
4269,2592.0,20,is,1,3,10,7,2,9,-2,9,Malta,Magic,,org,PROPN,PROPN,poss,nsubj,NNP,NNP,6,1
4270,2593.0,34,nominated,6,10,19,9,9,14,-4,13,Franklin D. Roosevelt,United States,org-org-org,-,PROPN-PROPN-PROPN,PROPN-PROPN,compound-compound-pobj,compound-compound,NNP-NNP-NNP,NNP-NNP,8,1
4271,8786.0,24,elected,6,3,17,14,2,6,3,11,Franklin D. Roosevelt,United States,--,per-per,PROPN-PROPN-PROPN,PROPN-PROPN,compound-compound-nsubjpass,compound-pobj,NNP-NNP-NNP,NNP-NNP,8,1
4272,12449.0,44,is,10,4,31,27,3,12,6,21,Franklin D. Roosevelt,United States,org-org-org,-,PROPN-PROPN-PROPN,PROPN-PROPN,compound-compound-compound,compound-pobj,NNP-NNP-NNP,NNP-NNP,13,1
4273,2594.0,29,demonstrated,6,2,26,24,1,2,4,20,his,Guyana,per,,DET,PROPN,poss,poss,PRP$,NNP,7,1
4274,2595.0,30,made,5,11,24,13,10,5,-6,19,Finland national football team,Stuart Baxter,per-per-per-per,-,ADJ-ADJ-NOUN-NOUN,PROPN-PROPN,nmod-amod-compound-pobj,compound-nsubj,JJ-JJ-NN-NN,NNP-NNP,6,1
4275,2596.0,21,discovered,2,17,20,3,16,0,-15,18,William Jones,Navy,org-org,,PROPN-PROPN,PROPN,compound-compound,pobj,NNP-NNP,NNP,7,1
4276,2597.0,25,went,8,8,15,7,7,9,0,7,Spiders,Atlantic 10 Conference,,org-org-org,PROPN,PROPN-NUM-PROPN,nsubj,nmod-nummod-dobj,NNPS,NNP-CD-NNP,4,1
4277,2598.0,27,was,3,12,16,4,11,10,-9,13,European Space Agency,1975,per-per-per,,PROPN-PROPN-PROPN,NUM,compound-compound-pobj,pobj,NNP-NNP-NNP,CD,7,1
4278,2599.0,21,conferred,5,4,13,9,3,7,1,8,Pervez Musharraf,Pakistan,-,org,PROPN-PROPN,PROPN,compound-nsubj,pobj,NNP-NNP,NNP,2,1
4279,4010.0,14,says,4,3,7,4,2,6,1,3,Pervez Musharraf,Pakistan,org-org,,PROPN-PROPN,PROPN,compound-nsubj,compound,NNP-NNP,NNP,3,1
4280,9903.0,54,is,6,32,53,21,31,0,-26,47,Pervez Musharraf,Pakistan,org-org,,PROPN-PROPN,PROPN,compound-pobj,pobj,NNP-NNP,NNP,7,1
4281,11878.0,14,sworn,2,1,10,9,0,3,1,8,Pervez Musharraf,Pakistan,-,per,PROPN-PROPN,PROPN,compound-nsubj,poss,NNP-NNP,NNP,4,1
4282,12833.0,18,visited,15,13,17,4,12,0,2,2,Pervez Musharraf,Pakistan,-,per,PROPN-PROPN,PROPN,compound-pobj,dobj,NNP-NNP,NNP,6,1
4283,2600.0,17,is,3,1,1,0,0,15,2,-2,California Pacific University,California,--,per,PROPN-PROPN-PROPN,PROPN,compound-compound-nsubj,pobj,NNP-NNP-NNP,NNP,0,1
4284,2602.0,59,is,9,1,3,2,0,55,8,-6,Connecticut Transit,Hartford,org-org,,PROPN-PROPN,PROPN,compound-compound,nsubj,NNP-NNP,NNP,3,1
4285,2603.0,57,found,13,31,54,23,30,2,-18,41,Klaus Voormann,London,org-org,,PROPN-PROPN,PROPN,compound-nsubj,compound,NNP-NNP,NNP,2,1
4286,2604.0,32,separated,6,15,28,13,14,3,-9,22,2004,Medical University of Graz,,org-org-org-org,NUM,PROPN-PROPN-ADP-PROPN,pobj,compound-pobj-prep-pobj,CD,NNP-NNP-IN-NNP,7,1
4287,2606.0,39,is,11,2,21,19,1,17,9,10,Hebrew Academy of the Five Towns and Rockaway,South Shore,-------,org-org,PROPN-PROPN-ADP-DET-NUM-NOUN-CCONJ-PROPN,PROPN-PROPN,compound-nsubj-prep-det-nummod-pobj-cc-conj,compound-pobj,NNP-NNP-IN-DT-CD-NNS-CC-NNP,NNP-NNP,4,1
4288,2607.0,32,accepted,12,10,21,11,9,10,2,9,Life of Agony,Keith Caputo,per-per-per,-,PROPN-ADP-PROPN,PROPN-PROPN,pobj-prep-pobj,compound-nsubjpass,NNP-IN-NNP,NNP-NNP,8,1
4289,2608.0,20,built,2,12,19,7,11,0,-10,17,American Locomotive Company,1901,--,org,PROPN-PROPN-PROPN,NUM,compound-compound-attr,pobj,NNP-NNP-NNP,CD,6,1
4290,2609.0,53,is,36,3,4,1,2,48,33,-32,2007,China Mobile,,org-org,NUM,PROPN-PROPN,nummod,compound-compound,CD,NNP-NNP,2,1
4291,2610.0,41,held,7,6,19,13,5,21,1,12,New Brunswick,Richard Hatfield,per-per,-,PROPN-PROPN,PROPN-PROPN,compound-pobj,compound-dobj,NNP-NNP,NNP-NNP,6,1
4292,2611.0,41,make,36,4,13,9,3,27,32,-23,Yu Minhong,New Oriental,per-per,-,PROPN-PROPN,PROPN-PROPN,compound-compound,compound-pobj,NNP-NNP,NNP-NNP,6,1
4293,2613.0,98,is,4,70,71,1,69,26,-66,67,Japan,Shinz Ab,per,-,PROPN,PROPN-PROPN,pobj,compound-compound,NNP,NNP-NNP,-1,1
4294,2615.0,68,began,13,36,56,20,35,11,-23,43,National Championship Game,Ohio State Buckeyes,org-org-org,--,PROPN-PROPN-PROPN,PROPN-PROPN-PROPN,compound-compound-pobj,compound-dobj-ROOT,NNP-NNP-NNP,NNP-NNP-NNP,5,1
4295,2616.0,15,Mexico,4,1,4,3,0,10,3,0,Albuquerque Journal,New Mexico,per-per,-,PROPN-PROPN,PROPN-PROPN,compound-compound,compound-ROOT,NNP-NNP,NNP-NNP,1,1
4296,2618.0,20,won,2,2,8,6,1,11,0,6,party,1935,,per,NOUN,NUM,nsubj,pobj,NN,CD,3,1
4297,2620.0,27,represented,9,12,21,9,11,5,-3,12,University of Arkansas at Pine Bluff,NCAA,per-per-per-per-per-per,,PROPN-ADP-PROPN-ADP-PROPN-PROPN,PROPN,dobj-prep-pobj-prep-compound-pobj,compound,NNP-IN-NNP-IN-NNP-NNP,NNP,4,1
4298,2621.0,35,joined,3,25,28,3,24,6,-22,25,Jim James,My Morning Jacket,-,org-org-org,PROPN-PROPN,DET-PROPN-PROPN,compound-dobj,poss-compound-pobj,NNP-NNP,PRP$-NNP-NNP,3,1
4299,2622.0,41,awarded,4,17,18,1,16,22,-13,14,McGraw-Hill,Construction Publishing,,per-per,NUM,PROPN-PROPN,compound,compound-poss,CD,NNP-NNP,1,1
4300,2623.0,27,appointed,9,6,15,9,5,11,3,6,Michael Szymanczyk,Altria Group,org-org,-,PROPN-PROPN,PROPN-PROPN,compound-nsubjpass,compound-pobj,NNP-NNP,NNP-NNP,4,1
4301,2624.0,26,elected,10,3,16,13,2,9,7,6,MNSD,Tandja Mamadou,,per-per,PROPN,PROPN-PROPN,compound,compound-nsubjpass,NNP,NNP-NNP,4,1
4302,2625.0,57,said,17,3,10,7,2,46,14,-7,Hamidullah,Chairman,org,,PROPN,PROPN,compound,conj,NNP,NNP,3,1
4303,2627.0,44,is,5,27,33,6,26,10,-22,28,Catherine of Braganza,Charles,--,per,PROPN-ADP-PROPN,PROPN,pobj-prep-pobj,compound,NNP-IN-NNP,NNP,4,1
4304,2628.0,32,was,13,15,16,1,14,15,-2,3,guitarist,Mile Lojpur,,org-org,NOUN,PROPN-PROPN,compound,compound-attr,NN,NNP-NNP,1,1
4305,2629.0,35,said,2,14,17,3,13,17,-12,15,Frank Lautenberg,New Jersey,-,per-per,PROPN-PROPN,PROPN-PROPN,compound-pobj,compound-compound,NNP-NNP,NNP-NNP,2,1
4306,3704.0,35,makes,26,17,23,6,16,11,9,-3,Frank Lautenberg,New Jersey,per-per,-,PROPN-PROPN,PROPN-PROPN,compound-pobj,compound-compound,NNP-NNP,NNP-NNP,5,1
4307,11267.0,27,said,16,19,22,3,18,4,-3,6,Frank Lautenberg,New Jersey,per-per,-,PROPN-PROPN,PROPN-PROPN,compound-nsubj,compound-pobj,NNP-NNP,NNP-NNP,2,1
4308,2630.0,41,pulled,17,22,22,0,21,18,-5,5,BBC Arabic Television,BBC,--,per,PROPN-PROPN-PROPN,PROPN,compound-compound-pobj,nsubj,NNP-NNP-NNP,NNP,0,1
4309,2633.0,14,be,8,2,7,5,1,6,6,-1,Jeep,Chrysler,org,,PROPN,PROPN,dobj,pobj,NNP,NNP,3,1
4310,12502.0,25,said,23,1,15,14,0,9,22,-8,Jeep,Chrysler,,per,NOUN,PROPN,nsubj,nsubj,NN,NNP,4,1
4311,2634.0,20,assumed,5,3,10,7,2,9,2,5,Modesto A. Maidique,FIU,--,org,PROPN-PROPN-PROPN,PROPN,compound-compound-nsubj,pobj,NNP-NNP-NNP,NNP,3,1
4312,2635.0,34,is,2,1,5,4,0,28,1,3,Flula Borg,German,org-org,,PROPN-PROPN,ADJ,compound-nsubj,amod,NNP-NNP,JJ,3,1
4313,2637.0,68,known,12,10,15,5,9,52,2,3,Jamaica,Junior Byles,,org-org,PROPN,PROPN-PROPN,pobj,compound-compound,NNP,NNP-NNPS,5,1
4314,2638.0,30,educated,2,17,19,2,16,10,-15,17,Heythrop College,University of London,per-per,--,PROPN-PROPN,PROPN-ADP-PROPN,compound-compound,dobj-prep-pobj,NNP-NNP,NNP-IN-NNP,2,1
4315,4000.0,48,studied,6,12,20,8,11,27,-6,14,Heythrop College,University of London,per-per,--,PROPN-PROPN,PROPN-ADP-PROPN,compound-pobj,pobj-prep-pobj,NNP-NNP,NNP-IN-NNP,6,1
4316,5018.0,40,been,2,17,8,-9,16,31,-15,6,Heythrop College,University of London,per-per,--,PROPN-PROPN,PROPN-ADP-PROPN,compound-pobj,pobj-prep-pobj,NNP-NNP,NNP-IN-NNP,6,1
4317,6559.0,20,associated,4,15,17,2,14,2,-11,13,Heythrop College,University of London,per-per,--,PROPN-PROPN,PROPN-ADP-PROPN,compound-compound,pobj-prep-pobj,NNP-NNP,NNP-IN-NNP,2,1
4318,2641.0,30,regulated,5,11,27,16,10,2,-6,22,Hong Kong,Kowloon Motor Bus,-,per-per-per,PROPN-PROPN,PROPN-PROPN-PROPN,compound-compound,compound-compound-conj,NNP-NNP,NNP-NNP-NNP,5,1
4319,2642.0,34,was,11,1,18,17,0,15,10,7,Park Eunsik,President,per-per,,PROPN-PROPN,PROPN,compound-nsubj,conj,NNP-NNP,NNP,4,1
4320,2644.0,45,was,2,5,18,13,4,26,-3,16,British,Winston Churchill,per,-,ADJ,PROPN-PROPN,amod,compound-pobj,JJ,NNP-NNP,5,1
4321,7184.0,45,waged,27,23,26,3,22,18,4,-1,British,Winston Churchill,org,-,ADJ,PROPN-PROPN,amod,compound-nsubj,JJ,NNP-NNP,3,1
4322,2645.0,25,is,15,1,10,9,0,14,14,-5,Olympique Lyonnais,Lyon,-,per,PROPN-PROPN,PROPN,compound-nsubj,pobj,NNP-NNP,NNP,4,1
4323,2646.0,43,Aluf,0,6,26,20,5,16,-6,26,Yusef Mishleb,Israel Defense Forces,per-per,--,PROPN-PROPN,PROPN-PROPN-PROPN,compound-nsubj,compound-compound-pobj,NNP-NNP,NNP-NNP-NNPS,5,1
4324,2647.0,44,acquired,2,8,23,15,7,20,-6,21,Canadian National Railway,CNR Radio,--,org-org,PROPN-PROPN-PROPN,PROPN-PROPN,compound-compound-compound,compound-compound,NNP-NNP-NNP,NNP-NNP,7,1
4325,2648.0,49,host,7,24,29,5,23,19,-17,22,Canvey Island,Dr Feelgood,-,per-per,PROPN-PROPN,PROPN-PROPN,compound-compound,compound-pobj,NNP-NNP,NNP-NNP,2,1
4326,4414.0,32,were,4,15,20,5,14,11,-11,16,Canvey Island,Dr Feelgood,per-per,-,PROPN-PROPN,PROPN-PROPN,compound-pobj,compound-compound,NNP-NNP,NNP-NNP,5,1
4327,2649.0,24,is,6,1,13,12,0,10,5,7,Oregon,Steve Prefontaine,,per-per,PROPN,PROPN-PROPN,poss,compound-appos,NNP,NNP-NNP,4,1
4328,2650.0,25,Walsh,1,10,24,14,9,0,-9,23,England,Starsailor,,org,PROPN,PROPN,nsubj,pobj,NNP,NNP,3,1
4329,2651.0,19,lost,1,6,18,12,5,0,-5,17,Ouellet,Quebec,,org,PROPN,PROPN,pobj,pobj,NNP,NNP,2,1
4330,2653.0,43,visited,23,3,10,7,2,32,20,-13,Mark Kimmitt,Political-Military Affairs,per-per,-,PROPN-PROPN,PROPN-PROPN,compound-compound,amod-pobj,NNP-NNP,NNP-NNPS,4,1
4331,2654.0,29,wrote,9,19,25,6,18,3,-10,16,Walter Ulbricht,Germany,-,per,PROPN-PROPN,PROPN,compound-pobj,poss,NNP-NNP,NNP,5,1
4332,2655.0,12,leased,5,4,10,6,3,1,1,5,US Microbics,Carlsbad,-,per,PROPN-PROPN,PROPN,compound-nsubj,compound,NNP-NNPS,NNP,3,1
4333,2656.0,17,known,12,3,15,12,2,1,9,3,early May 2009,Visceral Games,--,org-org,ADJ-PROPN-NUM,PROPN-PROPN,amod-pobj-nummod,compound-pobj,JJ-NNP-CD,NNP-NNPS,5,1
4334,2657.0,32,played,1,1,25,24,0,6,0,24,He,West,per,,PRON,PROPN,nsubj,compound,PRP,NNP,8,1
4335,2659.0,66,quoted,7,57,64,7,56,1,-50,57,Exchequer,Nigel Lawson,,org-org,PROPN,PROPN-PROPN,pobj,compound-appos,NNP,NNP-NNP,2,1
4336,3455.0,20,lived,11,6,10,4,5,9,5,-1,Exchequer,Nigel Lawson,,per-per,PROPN,PROPN-PROPN,pobj,compound-pobj,NNP,NNP-NNP,1,1
4337,13827.0,30,gives,1,23,24,1,22,5,-22,23,Exchequer,Nigel Lawson,org,-,PROPN,PROPN-PROPN,pobj,compound-pobj,NNP,NNP-NNP,1,1
4338,2661.0,36,reported,13,1,7,6,0,28,12,-6,Dean Rusk,State,-,per,PROPN-PROPN,PROPN,compound-nsubj,pobj,NNP-NNP,NNP,2,1
4339,2662.0,29,continue,1,5,14,9,4,14,-4,13,China,CNOOC,,per,PROPN,PROPN,nsubj,appos,NNP,NNP,2,1
4340,11262.0,26,Incorporated,0,18,24,6,17,1,-18,24,China,CNOOC,per,,PROPN,PROPN,compound,appos,NNP,NNP,2,1
4341,2663.0,56,are,16,34,36,2,33,19,-18,20,Miami,Manny Diaz,org,-,PROPN,PROPN-PROPN,compound,compound-conj,NNP,NNP-NNP,3,1
4342,3703.0,42,circulating,23,12,14,2,11,27,11,-9,Miami,Manny Diaz,,per-per,PROPN,PROPN-PROPN,compound,compound-pobj,NNP,NNP-NNP,1,1
4343,11168.0,40,said,4,1,3,2,0,36,3,-1,Miami,Manny Diaz,org,-,PROPN,PROPN-PROPN,compound,compound-nsubj,NNP,NNP-NNP,2,1
4344,12326.0,35,Diaz,3,1,3,2,0,31,2,0,Miami,Manny Diaz,,per-per,PROPN,PROPN-VERB,compound,compound-ROOT,NNP,NNP-VBZ,1,1
4345,2664.0,29,worked,4,23,26,3,22,2,-19,22,Pixar,John Lasseter,,org-org,PROPN,PROPN-PROPN,compound,compound-nsubj,NNP,NNP-NNP,3,1
4346,10957.0,29,said,13,15,20,5,14,8,-2,7,Pixar,John Lasseter,org,-,PROPN,PROPN-PROPN,poss,compound-appos,NNP,NNP-NNP,3,1
4347,2665.0,33,is,14,2,22,20,1,10,12,8,University of Graz,Styria,--,org,PROPN-ADP-PROPN,PROPN,nsubj-prep-pobj,pobj,NNP-IN-NNP,NNP,5,1
4348,3039.0,23,studied,2,7,10,3,6,12,-5,8,University of Graz,Styria,--,org,PROPN-ADP-PROPN,PROPN,nmod-prep-pobj,pobj,NNP-IN-NNP,NNP,3,1
4349,2666.0,16,moved,4,7,11,4,6,4,-3,7,Vancouver,Harris,,per,PROPN,PROPN,compound,nsubj,NNP,NNP,2,1
4350,2667.0,21,was,12,1,10,9,0,10,11,-2,Stephenson King,Saint Lucia,-,per-per,PROPN-PROPN,PROPN-PROPN,compound-nsubj,compound-pobj,NNP-NNP,NNP-NNP,3,1
4351,2668.0,25,hit,2,10,14,4,9,10,-8,12,Air France,Pierre-Henri Gourgeon,-,per-per,PROPN-PROPN,PROPN-PROPN,nmod-nmod,amod-pobj,NNP-NNP,NNP-NNP,2,1
4352,2669.0,28,involved,3,10,12,2,9,15,-7,9,Bank of Israel,Israel,per-per-per,,PROPN-ADP-PROPN,PROPN,nsubj-prep-pobj,poss,NNP-IN-NNP,NNP,4,1
4353,2670.0,32,caused,21,13,17,4,12,14,8,-4,Italian,Clemente Mastella,,per-per,ADJ,PROPN-PROPN,amod,compound-dobj,JJ,NNP-NNP,2,1
4354,2671.0,28,went,2,19,21,2,18,6,-17,19,Flipmode,Spliff Star,per,-,PROPN,PROPN-PROPN,compound,compound-compound,NNP,NNP-NNP,5,1
4355,2672.0,31,became,17,9,14,5,8,16,8,-3,Joseph Goebbels,Public Enlightenment and Propaganda,per-per,---,PROPN-PROPN,PROPN-PROPN-CCONJ-PROPN,compound-dobj,compound-pobj-cc-conj,NNP-NNP,NNP-NNP-CC-NNP,5,1
4356,3490.0,46,was,2,15,19,4,14,26,-13,17,Joseph Goebbels,Public Enlightenment and Propaganda,-,org-org-org-org,PROPN-PROPN,PROPN-PROPN-CCONJ-PROPN,compound-compound,compound-pobj-cc-conj,NNP-NNP,NNP-NNP-CC-NNP,4,1
4357,6812.0,26,assembled,3,9,17,8,8,8,-6,14,Joseph Goebbels,Public Enlightenment and Propaganda,org-org,---,PROPN-PROPN,PROPN-PROPN-CCONJ-PROPN,compound-pobj,compound-pobj-cc-conj,NNP-NNP,NNP-NNP-CC-NNP,5,1
4358,13451.0,19,came,6,9,15,6,8,3,-3,9,Joseph Goebbels,Public Enlightenment and Propaganda,-,org-org-org-org,PROPN-PROPN,PROPN-PROPN-CCONJ-PROPN,compound-poss,compound-pobj-cc-conj,NNP-NNP,NNP-NNP-CC-NNP,3,1
4359,2673.0,19,is,3,2,10,8,1,8,1,7,Sabanci,Holdings,org,,PROPN,PROPN,compound,pobj,NNP,NNPS,3,1
4360,2675.0,37,born,2,14,14,0,13,22,-12,12,Waterford,Waterford Kettering High School,per,---,PROPN,PROPN-PROPN-PROPN-PROPN,compound,compound-compound-compound-dobj,NNP,NNP-NNP-NNP-NNP,0,1
4361,2676.0,34,rebranded,17,14,14,0,13,19,3,-3,Tesco,Tesco Ireland,,per-per,PROPN,PROPN-PROPN,pobj,compound-conj,NNP,NNP-NNP,0,1
4362,4990.0,22,folded,5,8,8,0,7,13,-3,3,Tesco,Tesco Ireland,org,-,PROPN,PROPN-PROPN,poss,compound-attr,NNP,NNP-NNP,0,1
4363,2677.0,24,named,9,8,19,11,7,4,1,10,Bulgari,Francesco Trapani,,per-per,PROPN,PROPN-PROPN,nsubjpass,compound-nsubjpass,NNP,NNP-NNP,5,1
4364,2678.0,19,died,4,3,18,15,2,0,1,14,Ethelred,England,org,,VERB,PROPN,conj,pobj,VBN,NNP,6,1
4365,2680.0,36,Founded,0,3,25,22,2,10,-3,25,1935,Corban College,,org-org,NUM,PROPN-PROPN,pobj,compound-pobj,CD,NNP-NNP,5,1
4366,2681.0,17,became,2,1,11,10,0,5,1,9,Stat Quo,Shady,-,per,PROPN-PROPN,PROPN,compound-nsubj,pobj,NNP-NNP,NNP,6,1
4367,10465.0,51,elaborated,8,40,48,8,39,2,-32,40,Stat Quo,Shady,per-per,,PROPN-PROPN,PROPN,compound-conj,compound,NNP-NNP,NNP,10,1
4368,10486.0,33,was,5,4,13,9,3,19,1,8,Stat Quo,Shady,per-per,,PROPN-PROPN,PROPN,compound-nsubj,compound,NNP-NNP,NNP,5,1
4369,10514.0,11,Quo,1,1,5,4,0,5,0,4,Stat Quo,Shady,org-org,,PROPN-PROPN,PROPN,compound-ROOT,nmod,NNP-NNP,NNP,3,1
4370,2682.0,33,was,5,4,16,12,3,16,1,11,Stat Quo,Aftermath,org-org,,PROPN-PROPN,PROPN,compound-nsubj,compound,NNP-NNP,NNP,6,1
4371,3285.0,19,cited,5,3,10,7,2,8,2,5,Stat Quo,Aftermath,org-org,,PROPN-PROPN,PROPN,compound-nsubjpass,compound,NNP-NNP,NNP,5,1
4372,4418.0,17,became,2,1,13,12,0,3,1,11,Stat Quo,Aftermath,-,per,PROPN-PROPN,PROPN,compound-nsubj,conj,NNP-NNP,NNP,4,1
4373,2683.0,42,introduced,4,8,25,17,7,16,-4,21,Hinda Hicks,Island Records,org-org,-,PROPN-PROPN,PROPN-PROPN,compound-dobj,compound-appos,NNP-NNP,NNP-NNPS,3,1
4374,2684.0,21,sponsored,6,4,6,2,3,14,2,0,Oregon House,she,-,per,PROPN-PROPN,PRON,compound-pobj,nsubj,NNP-NNP,PRP,2,1
4375,2685.0,15,using,4,2,14,12,1,0,2,10,Office Depot,Florida,per-per,,PROPN-PROPN,PROPN,compound-nsubj,pobj,NNP-NNP,NNP,3,1
4376,2686.0,20,was,1,1,8,7,0,11,0,7,Washington,United States,org,-,PROPN,PROPN-PROPN,nsubj,compound-pobj,NNP,NNP-NNP,3,1
4377,2687.0,34,attended,26,22,28,6,21,5,4,2,New York,Columbia University School of General Studies,org-org,-----,PROPN-PROPN,PROPN-PROPN-PROPN-ADP-PROPN-PROPN,compound-pobj,compound-compound-dobj-prep-compound-pobj,NNP-NNP,NNP-NNP-NNP-IN-NNP-NNPS,8,1
4378,2688.0,36,agreed,10,1,24,23,0,11,9,14,Thailand,Somchai Wongsawat,,per-per,PROPN,PROPN-PROPN,poss,compound-appos,NNP,NNP-NNP,6,1
4379,2689.0,18,explained,3,2,9,7,1,8,1,6,Shigeru Miyamoto,Nintendo,-,per,PROPN-PROPN,PROPN,compound-nsubj,nsubj,NNP-NNP,NNP,4,1
4380,2690.0,31,was,14,28,30,2,27,0,-14,16,Barazoku,1971,per,,PROPN,NUM,pobj,pobj,NNP,CD,2,1
4381,2691.0,22,commanded,1,8,19,11,7,2,-7,18,George W. Morgan,XIII Corps,--,org-org,PROPN-PROPN-PROPN,PROPN-PROPN,compound-compound-dobj,compound-appos,NNP-NNP-NNP,NNP-NNP,7,1
4382,2692.0,35,were,2,11,16,5,10,18,-9,14,Thornton Township High School,Harvey,---,per,PROPN-PROPN-PROPN-PROPN,PROPN,compound-compound-compound-pobj,compound,NNP-NNP-NNP-NNP,NNP,3,1
4383,10298.0,88,was,1,25,32,7,24,55,-24,31,Thornton Township High School,Harvey,per-per-per-per,,PROPN-PROPN-PROPN-PROPN,PROPN,compound-compound-compound-pobj,compound,NNP-NNP-NNP-NNP,NNP,4,1
4384,2693.0,10,Guiney,3,3,7,4,2,2,0,4,Bob Guiney,Rebecca Budig,-,org-org,PROPN-PROPN,PROPN-PROPN,compound-ROOT,conj-compound,NNP-NNP,NNP-NNP,2,1
4385,2694.0,17,is,4,2,16,14,1,0,2,12,Copenhagen Business School,Denmark,--,org,PROPN-PROPN-PROPN,PROPN,compound-compound-pobj,pobj,NNP-NNP-NNP,NNP,7,1
4386,10453.0,19,is,3,13,18,5,12,0,-10,15,Copenhagen Business School,Denmark,--,per,PROPN-PROPN-PROPN,PROPN,compound-compound-pobj,pobj,NNP-NNP-NNP,NNP,5,1
4387,2695.0,25,is,11,16,23,7,15,1,-5,12,Gordon Brown,United Kingdom,org-org,-,PROPN-PROPN,PROPN-PROPN,compound-pobj,compound-pobj,NNP-NNP,NNP-NNP,3,1
4388,4147.0,23,said,5,4,21,17,3,1,1,16,Gordon Brown,United Kingdom,-,org-org,PROPN-PROPN,PROPN-PROPN,compound-nsubj,compound-conj,NNP-NNP,NNP-NNP,8,1
4389,2696.0,10,is,4,6,9,3,5,0,-2,5,JAKKS Pacific,Malibu,per-per,,PROPN-PROPN,PROPN,compound-attr,pobj,NNP-NNP,NNP,2,1
4390,2697.0,20,is,3,1,12,11,0,7,2,9,Mutant Enemy Productions,Joss Whedon,per-per-per,-,PROPN-PROPN-PROPN,PROPN-PROPN,compound-compound-nsubj,compound-pobj,NNP-NNP-NNPS,NNP-NNP,6,1
4391,2698.0,79,Escuelas,0,8,12,4,7,66,-8,12,Wolfgang,Venezuela,,org,PROPN,PROPN,nmod,pobj,NNP,NNP,3,1
4392,2702.0,27,plays,3,3,25,22,2,1,0,22,Boca,Argentine Primera,,per-per,PROPN,PROPN-PROPN,nsubj,compound-pobj,NNP,NNP-NNP,6,1
4393,2704.0,31,released,3,15,26,11,14,4,-12,23,Japan,Daiei,per,,PROPN,PROPN,pobj,compound,NNP,NNP,5,1
4394,2705.0,86,contained,11,38,9,-29,37,76,-27,-2,Metlink,Melbourne,,org,PROPN,PROPN,nmod,nmod,NNP,NNP,-1,1
4395,2706.0,51,formed,39,27,41,14,26,9,12,2,O'Keefe,Australia,,per,PROPN,PROPN,nsubj,poss,NNP,NNP,3,1
4396,2707.0,20,located,8,6,18,12,5,1,2,10,Bard College,New York,-,org-org,PROPN-PROPN,PROPN-PROPN,compound-pobj,compound-pobj,NNP-NNP,NNP-NNP,8,1
4397,2708.0,13,described,3,9,11,2,8,1,-6,8,American,Thomas Say,org,-,ADJ,PROPN-PROPN,amod,compound-pobj,JJ,NNP-NNP,3,1
4398,2709.0,33,evidence,4,23,27,4,22,5,-19,23,New Mexico,Pete Domenici,-,org-org,PROPN-PROPN,PROPN-PROPN,compound-compound,compound-pobj,NNP-NNP,NNP-NNP,4,1
4399,3938.0,34,include,9,18,21,3,17,12,-9,12,New Mexico,Pete Domenici,org-org,-,PROPN-PROPN,PROPN-PROPN,compound-compound,compound-compound,NNP-NNP,NNP-NNP,2,1
4400,4693.0,38,was,17,1,4,3,0,33,16,-13,New Mexico,Pete Domenici,-,per-per,PROPN-PROPN,PROPN-PROPN,compound-poss,compound-nsubj,NNP-NNP,NNP-NNP,1,1
4401,8022.0,57,warned,22,3,6,3,2,50,19,-16,New Mexico,Pete Domenici,-,per-per,PROPN-PROPN,PROPN-PROPN,compound-compound,compound-nsubj,NNP-NNP,NNP-NNP,2,1
4402,8866.0,41,said,19,1,4,3,0,36,18,-15,New Mexico,Pete Domenici,-,org-org,PROPN-PROPN,PROPN-PROPN,compound-compound,compound-nsubj,NNP-NNP,NNP-NNP,2,1
4403,2710.0,30,took,4,16,17,1,15,12,-12,13,James Nasmyth,Nasmyth Gaskell and Company,org-org,---,PROPN-PROPN,PROPN-PROPN-CCONJ-PROPN,compound-pobj,compound-appos-cc-conj,NNP-NNP,NNP-NNP-CC-NNP,1,1
4404,2711.0,33,closed,5,10,13,3,9,19,-5,8,Austrian Airlines,AUA,per-per,,PROPN-PROPN,PROPN,amod-pobj,appos,NNP-NNP,NNP,2,1
4405,5358.0,26,said,5,18,24,6,17,1,-13,19,Austrian Airlines,AUA,per-per,,PROPN-PROPN,PROPN,compound-appos,appos,NNP-NNP,NNP,4,1
4406,2712.0,39,announced,7,22,24,2,21,14,-15,17,Taipei,his,org,,PROPN,DET,compound,poss,NNP,PRP$,1,1
4407,2713.0,20,said,0,8,17,9,7,2,-8,17,Stanford University,Wyden,per-per,,PROPN-PROPN,PROPN,compound-poss,poss,NNP-NNP,NNP,7,1
4408,2714.0,29,is,16,3,28,25,2,0,13,12,Air Force Reserve Command,AFRC,org-org-org-org,,PROPN-PROPN-PROPN-PROPN,PROPN,compound-compound-compound-compound,pobj,NNP-NNP-NNP-NNP,NNP,5,1
4409,2716.0,21,is,1,1,19,18,0,1,0,18,HSAS,Michael Shrieve,per,-,NOUN,PROPN-PROPN,nsubj,compound-conj,NN,NNP-NNP,4,1
4410,2718.0,29,is,7,17,19,2,16,9,-10,12,University of Prince Edward Island,Prince Edward Island,org-org-org-org-org,--,PROPN-ADP-PROPN-PROPN-PROPN,PROPN-PROPN-PROPN,nmod-prep-pobj-compound-pobj,compound-compound-compound,NNP-IN-NNP-NNP-NNP,NNP-NNP-NNP,4,1
4411,2719.0,42,went,2,10,27,17,9,14,-8,25,Indianapolis,Bernard Vonnegut,per,-,PROPN,PROPN-PROPN,pobj,compound-nsubj,NNP,NNP-NNP,8,1
4412,2720.0,28,is,5,2,11,9,1,16,3,6,Smoky Hill High School,Centennial League,---,org-org,PROPN-PROPN-PROPN-PROPN,PROPN-PROPN,compound-compound-compound-nsubj,compound-pobj,NNP-NNP-NNP-NNP,NNP-NNP,6,1
4413,2721.0,27,made,15,11,13,2,10,13,4,-2,England,Loughborough University,,org-org,PROPN,PROPN-PROPN,pobj,compound-compound,NNP,NNP-NNP,2,1
4414,2722.0,23,is,4,10,22,12,9,0,-6,18,Hong Kong,Citybus,-,org,PROPN-PROPN,PROPN,compound-pobj,conj,NNP-NNP,NNP,5,1
4415,2723.0,16,owned,3,1,1,0,0,14,2,-2,Air Dominicana,Air Europa,org-org,-,PROPN-PROPN,PROPN-PROPN,compound-nsubjpass,compound-pobj,NNP-NNP,NNP-NNP,0,1
4416,2724.0,19,is,9,7,14,7,6,4,2,5,Queen Elizabeth,Armed Forces,per-per,-,PROPN-PROPN,PROPN-PROPN,compound-compound,compound-pobj,NNP-NNP,NNP-NNPS,9,1
4417,2725.0,20,telling,3,11,15,4,10,4,-8,12,Demi Moore,Bruce Willis,org-org,-,PROPN-PROPN,PROPN-PROPN,compound-poss,compound-dobj,NNP-NNP,NNP-NNP,3,1
4418,2726.0,36,is,24,3,6,3,2,29,21,-18,Tom Bradley,Los Angeles,-,per-per,PROPN-PROPN,PROPN-PROPN,compound-pobj,compound-compound,NNP-NNP,NNP-NNP,2,1
4419,3240.0,37,was,6,4,15,11,3,21,2,9,Tom Bradley,Los Angeles,-,org-org,PROPN-PROPN,PROPN-PROPN,compound-compound,compound-compound,NNP-NNP,NNP-NNP,8,1
4420,7636.0,42,is,2,17,23,6,16,18,-15,21,Tom Bradley,Los Angeles,org-org,-,PROPN-PROPN,PROPN-PROPN,compound-pobj,compound-pobj,NNP-NNP,NNP-NNP,3,1
4421,12400.0,18,elected,5,3,12,9,2,5,2,7,Tom Bradley,Los Angeles,per-per,-,PROPN-PROPN,PROPN-PROPN,compound-nsubjpass,compound-pobj,NNP-NNP,NNP-NNP,4,1
4422,14030.0,33,appointed,6,2,14,12,1,18,4,8,Tom Bradley,Los Angeles,per-per,-,PROPN-PROPN,PROPN-PROPN,compound-nsubj,compound-compound,NNP-NNP,NNP-NNP,6,1
4423,2727.0,29,issued,4,9,16,7,8,12,-5,12,Gwatney,Arkansas,,per,PROPN,PROPN,dobj,poss,NNP,NNP,5,1
4424,12869.0,16,was,1,1,3,2,0,12,0,2,Gwatney,Arkansas,org,,NOUN,PROPN,nsubj,compound,NN,NNP,3,1
4425,2728.0,40,Rasmussen,3,1,7,6,0,32,2,4,Pvt.,Gardehusarregimentet,per,,PROPN,PROPN,compound,dobj,NNP,NNP,-1,1
4426,2729.0,47,went,1,15,19,4,14,27,-14,18,Irondale,EWTN,org,,PROPN,PROPN,compound,nsubjpass,NNP,NNP,2,1
4427,2730.0,17,is,3,1,1,0,0,15,2,-2,Hinchley Wood School,Hinchley Wood,--,per-per,PROPN-PROPN-PROPN,PROPN-PROPN,compound-compound-nsubj,compound-compound,NNP-NNP-NNP,NNP-NNP,0,1
4428,2731.0,25,is,4,1,23,22,0,1,3,19,Heanor Gate Science College,Derbyshire,---,per,PROPN-PROPN-PROPN-PROPN,PROPN,compound-compound-compound-nsubj,compound,NNP-NNP-NNP-NNP,NNP,8,1
4429,2732.0,33,oversaw,5,22,25,3,21,7,-17,20,Paul Allen,Vulcan Inc.,org-org,-,PROPN-PROPN,PROPN-PROPN,compound-poss,compound-conj,NNP-NNP,NNP-NNP,1,1
4430,2733.0,21,is,5,2,17,15,1,3,3,12,St. Joseph High School,University Heights Suburban Centre,per-per-per-per,---,PROPN-PROPN-PROPN-PROPN,PROPN-PROPN-PROPN-PROPN,compound-compound-compound-nsubj,compound-compound-compound-pobj,NNP-NNP-NNP-NNP,NNP-NNPS-NNP-NNP,6,1
4431,7589.0,20,located,8,1,12,11,0,7,7,4,St. Joseph High School,University Heights Suburban Centre,---,per-per-per-per,PROPN-PROPN-PROPN-PROPN,PROPN-PROPN-PROPN-PROPN,compound-compound-compound-nsubjpass,compound-compound-compound-pobj,NNP-NNP-NNP-NNP,NNP-NNPS-NNP-NNP,5,1
4432,2734.0,18,protested,0,5,17,12,4,0,-5,17,Nano,Albania,org,,PROPN,PROPN,poss,pobj,NNP,NNP,7,1
4433,2735.0,40,said,10,15,13,-2,14,26,-5,3,Keith Urban,Nicole Kidman,org-org,-,PROPN-PROPN,PROPN-PROPN,compound-conj,compound-nsubj,NNP-NNP,NNP-NNP,4,1
4434,2736.0,15,founded,3,2,10,8,1,4,1,7,RVC,University of London,org,--,PROPN,PROPN-ADP-PROPN,nsubjpass,dobj-prep-pobj,NNP,NNP-IN-NNP,4,1
4435,11065.0,16,became,7,7,13,6,6,2,0,6,RVC,University of London,,per-per-per,PROPN,PROPN-ADP-PROPN,nsubj,pobj-prep-pobj,NNP,NNP-IN-NNP,4,1
4436,2737.0,12,signed,3,1,9,8,0,2,2,6,Eluvium,Temporary Residence Limited,,per-per-per,NOUN,PROPN-PROPN-PROPN,nsubjpass,compound-compound-appos,NN,NNP-NNP-NNP,4,1
4437,2738.0,17,tried,9,3,8,5,2,8,6,-1,Reform Party/Canadian Alliance,Stockwell Day,--,org-org,PROPN-PROPN-PROPN,PROPN-PROPN,nmod-compound-compound,compound-appos,NNP-NNP-NNP,NNP-NNP,3,1
4438,2739.0,34,fired,8,18,24,6,17,9,-10,16,Interior,James Harlan,,org-org,PROPN,PROPN-PROPN,pobj,compound-nsubj,NNP,NNP-NNP,3,1
4439,2740.0,17,became,6,4,15,11,3,1,2,9,Karen Clark Sheard,Elektra,--,org,PROPN-PROPN-PROPN,PROPN,compound-compound-nsubj,compound,NNP-NNP-NNP,NNP,6,1
4440,2741.0,39,wrote,6,22,33,11,21,5,-16,27,New Hampshire,Franklin Pierce,-,org-org,PROPN-PROPN,PROPN-PROPN,compound-pobj,compound-pobj,NNP-NNP,NNP-NNP,10,1
4441,3048.0,31,was,14,12,28,16,11,2,2,14,New Hampshire,Franklin Pierce,per-per,-,PROPN-PROPN,PROPN-PROPN,compound-appos,compound-compound,NNP-NNP,NNP-NNP,8,1
4442,5402.0,22,sent,9,1,11,10,0,10,8,2,New Hampshire,Franklin Pierce,per-per,-,PROPN-PROPN,PROPN-PROPN,compound-nsubj,compound-dobj,NNP-NNP,NNP-NNP,3,1
4443,11138.0,36,was,31,11,20,9,10,15,20,-11,New Hampshire,Franklin Pierce,org-org,-,PROPN-PROPN,PROPN-PROPN,compound-compound,compound-relcl,NNP-NNP,NNP-NNP,5,1
4444,2742.0,26,included,8,21,23,2,20,2,-13,15,Transportation,Rodney E. Slater,,org-org-org,PROPN,PROPN-PROPN-PROPN,compound,compound-compound-conj,NNP,NNP-NNP-NNP,2,1
4445,2743.0,31,started,5,14,29,15,13,1,-9,24,Canada,Montreal Supra,,per-per,PROPN,PROPN-PROPN,pobj,compound-conj,NNP,NNP-NNP,5,1
4446,2745.0,49,hosted,7,4,6,2,3,42,3,-1,Foreign Affairs,Lawrence Cannon,per-per,-,PROPN-PROPN,PROPN-PROPN,compound-pobj,compound-nsubj,NNP-NNPS,NNP-NNP,3,1
4447,2746.0,9,attended,1,3,6,3,2,2,-2,5,Trinity-Pawling School,Pawling,-,org,PROPN-PROPN,VERB,xcomp-dobj,pcomp,NNP-NNP,VBG,3,1
4448,2747.0,20,was,9,9,17,8,8,2,0,8,he,New York,,org-org,PRON,PROPN-PROPN,nsubj,compound-compound,PRP,NNP-NNP,5,1
4449,2748.0,34,took,15,20,22,2,19,11,-5,7,England,Mendes,org,,PROPN,PROPN,pobj,nsubj,NNP,NNPS,3,1
4450,2749.0,21,recruited,3,2,17,15,1,3,1,14,Cult,Bob Rock,org,-,PROPN,PROPN-PROPN,nsubj,compound-pobj,NNP,NNP-NNP,4,1
4451,2750.0,29,built,10,2,8,6,1,20,8,-2,President,Evo Morales,,org-org,PROPN,PROPN-PROPN,compound,compound-conj,NNP,NNP-NNPS,3,1
4452,4925.0,30,said,28,18,19,1,17,10,10,-9,President,Evo Morales,per,-,PROPN,PROPN-PROPN,compound,compound-pobj,NNP,NNP-NNPS,1,1
4453,2751.0,23,extended,3,18,20,2,17,2,-15,17,TARC,Kuala Lumpur,,org-org,NOUN,PROPN-PROPN,pobj,compound-compound,NN,NNP-NNP,5,1
4454,2753.0,18,based,3,1,6,5,0,11,2,3,Lion Air,Jakarta,-,per,PROPN-PROPN,PROPN,compound-nsubjpass,compound,NNP-NNP,NNP,3,1
4455,2754.0,45,include,5,7,13,6,6,31,-2,8,Mahmoud Ahmadinejad,Iran,-,org,PROPN-PROPN,PROPN,compound-dative,compound,NNP-NNP,NNP,4,1
4456,4814.0,30,said,4,3,26,23,2,3,1,22,Mahmoud Ahmadinejad,Iran,org-org,,PROPN-PROPN,PROPN,compound-nsubj,poss,NNP-NNP,NNP,10,1
4457,9095.0,17,says,3,2,5,3,1,11,1,2,Mahmoud Ahmadinejad,Iran,-,per,PROPN-PROPN,PROPN,compound-nsubj,nsubj,NNP-NNP,NNP,2,1
4458,10207.0,26,said,4,3,8,5,2,17,1,4,Mahmoud Ahmadinejad,Iran,per-per,,PROPN-PROPN,PROPN,compound-nsubj,nsubj,NNP-NNP,NNP,2,1
4459,11838.0,24,warned,3,2,7,5,1,16,1,4,Mahmoud Ahmadinejad,Iran,per-per,,PROPN-PROPN,PROPN,compound-nsubj,nsubj,NNP-NNP,NNP,3,1
4460,2755.0,36,educated,2,5,23,18,4,12,-3,21,Denstone College,Staffordshire,per-per,,PROPN-PROPN,PROPN,compound-pobj,pobj,NNP-NNP,NNP,8,1
4461,2756.0,11,elected,5,3,10,7,2,0,2,5,Diosdado Macapagal,Philippines,org-org,,PROPN-PROPN,PROPN,compound-nsubjpass,pobj,NNP-NNP,NNPS,2,1
4462,3010.0,18,occurred,12,4,12,8,3,5,8,0,Diosdado Macapagal,Philippines,per-per,,PROPN-PROPN,PROPN,compound-pobj,pobj,NNP-NNP,NNPS,2,1
4463,2757.0,19,describes,7,1,4,3,0,14,6,-3,New Zealand,Ministry for the Environment,-,per-per-per-per,PROPN-PROPN,PROPN-ADP-DET-PROPN,compound-poss,nsubj-prep-det-pobj,NNP-NNP,NNP-IN-DT-NNP,2,1
4464,8304.0,10,Ministry,2,1,3,2,0,6,1,1,New Zealand,Ministry for the Environment,-,org-org-org-org,PROPN-PROPN,PROPN-ADP-DET-PROPN,compound-compound,ROOT-prep-det-pobj,NNP-NNP,NNP-IN-DT-NNP,2,1
4465,2758.0,16,signed,4,3,14,11,2,1,1,10,Naomi,The Judds,per,-,PROPN,DET-PROPN,conj,det-appos,NNP,DT-NNP,4,1
4466,2759.0,45,beat,2,21,27,6,20,17,-19,25,England,Chris Eubank,,per-per,PROPN,PROPN-PROPN,pobj,compound-pobj,NNP,NNP-NNP,7,1
4467,2760.0,30,is,3,1,20,19,0,9,2,17,Hydra Head,Aaron Turner,-,per-per,PROPN-PROPN,PROPN-PROPN,compound-compound,compound-pobj,NNP-NNP,NNP-NNP,9,1
4468,9847.0,29,signed,1,4,14,10,3,14,-3,13,Hydra Head,Aaron Turner,-,org-org,PROPN-PROPN,PROPN-PROPN,compound-compound,compound-pobj,NNP-NNP,NNP-NNP,5,1
4469,2761.0,14,elected,2,1,5,4,0,8,1,3,Koizumi,Japan,,org,PROPN,PROPN,nsubjpass,poss,NNP,NNP,5,1
4470,2762.0,28,Texas-based,5,5,7,2,4,20,0,2,Plano,EDS,org,,PROPN,PROPN,conj,nsubj,NNP,NNP,4,1
4471,2763.0,17,1996,0,8,15,7,7,1,-8,15,Paul Keating,Australian,org-org,,PROPN-PROPN,ADJ,compound-pobj,amod,NNP-NNP,JJ,7,1
4472,2764.0,48,took,3,7,22,15,6,25,-4,19,New York,Ruth Hassell-Thompson,org-org,-,PROPN-PROPN,PROPN-PROPN,compound-compound,compound-compound,NNP-NNP,NNP-NNP,11,1
4473,2765.0,12,polls,7,4,6,2,3,5,3,-1,Benjamin Netanyahu,Israel,per-per,,PROPN-PROPN,PROPN,compound-compound,compound,NNP-NNP,NNP,1,1
4474,2766.0,27,opposed,4,16,26,10,15,0,-12,22,Gheorghe Gheorghiu-Dej,Romania,-,per,PROPN-PROPN,PROPN,compound-appos,pobj,NNP-NNP,NNP,5,1
4475,2767.0,49,hosts,2,10,24,14,9,24,-8,22,Lebanon,Middle East Airlines,,per-per-per,PROPN,PROPN-PROPN-PROPN,poss,compound-compound-pobj,NNP,NNP-NNP-NNPS,7,1
4476,2768.0,33,is,12,24,31,7,23,1,-12,19,Ronald Reagan,Jane Wyman,-,per-per,PROPN-PROPN,PROPN-PROPN,compound-pobj,compound-appos,NNP-NNP,NNP-NNP,3,1
4477,5459.0,34,has,1,26,32,6,25,1,-25,31,Ronald Reagan,Jane Wyman,org-org,-,PROPN-PROPN,PROPN-PROPN,compound-pobj,compound-appos,NNP-NNP,NNP-NNP,2,1
4478,2769.0,34,is,12,1,10,9,0,23,11,-2,Lutheran Theological Southern Seminary,Columbia,org-org-org-org,,PROPN-PROPN-PROPN-PROPN,PROPN,csubj-compound-compound-dobj,compound,NNP-NNP-NNP-NNP,NNP,5,1
4479,2771.0,41,purchased,14,3,12,9,2,28,11,-2,Arthur B. Hancock,Kentucky,org-org-org,,PROPN-PROPN-PROPN,PROPN,compound-compound-pobj,appos,NNP-NNP-NNP,NNP,5,1
4480,2772.0,32,said,29,13,26,13,12,5,16,-3,Bob Marley,Jamaica,per-per,,PROPN-PROPN,PROPN,compound-appos,compound,NNP-NNP,NNP,13,1
4481,10165.0,29,included,17,6,28,22,5,0,11,11,Bob Marley,Jamaica,per-per,,PROPN-PROPN,PROPN,compound-appos,pobj,NNP-NNP,NNP,3,1
4482,2774.0,29,was,13,1,9,8,0,19,12,-4,Air Force Cyber Command,AFCYBER,per-per-per-per,,PROPN-PROPN-PROPN-PROPN,PROPN,compound-compound-compound-nsubj,appos,NNP-NNP-NNP-NNP,NNP,4,1
4483,2775.0,51,On,0,12,49,37,11,1,-12,49,Japan,Prince Chichibu,org,-,PROPN,PROPN-PROPN,compound,compound-appos,NNP,NNP-NNP,9,1
4484,8207.0,24,Result,0,7,18,11,6,5,-7,18,Japan,Prince Chichibu,org,-,PROPN,PROPN-PROPN,pobj,compound-compound,NNP,NNP-NNP,8,1
4485,10985.0,23,remembered,7,6,15,9,5,7,1,8,Japan,Prince Chichibu,,org-org,PROPN,PROPN-PROPN,pobj,compound-compound,NNP,NNP-NNP,5,1
4486,2776.0,30,is,6,14,19,5,13,10,-8,13,Virginia Commonwealth University,Division I,per-per-per,-,PROPN-PROPN-PROPN,PROPN-NUM,compound-compound-pobj,appos-nmod,NNP-NNP-NNP,NNP-CD,2,1
4487,2992.0,29,represented,8,10,24,14,9,4,-2,16,Virginia Commonwealth University,Division I,per-per-per,-,PROPN-PROPN-PROPN,PROPN-PRON,compound-compound-dobj,pobj-nsubj,NNP-NNP-NNP,NNP-PRP,4,1
4488,3234.0,22,represent,8,10,17,7,9,4,-2,9,Virginia Commonwealth University,Division I,org-org-org,-,PROPN-PROPN-PROPN,PROPN-PRON,compound-compound-dobj,pobj-nsubj,NNP-NNP-NNP,NNP-PRP,4,1
4489,5629.0,21,represents,6,8,16,8,7,4,-2,10,Virginia Commonwealth University,Division I,--,per-per,PROPN-PROPN-PROPN,PROPN-PRON,compound-compound-dobj,pobj-nsubj,NNP-NNP-NNP,NNP-PRP,3,1
4490,11285.0,22,represented,7,9,16,7,8,5,-2,9,Virginia Commonwealth University,Division I,per-per-per,-,PROPN-PROPN-PROPN,PROPN-PRON,compound-compound-dobj,pobj-nsubj,NNP-NNP-NNP,NNP-PRP,4,1
4491,13625.0,23,represented,8,10,18,8,9,4,-2,10,Virginia Commonwealth University,Division I,org-org-org,-,PROPN-PROPN-PROPN,PROPN-PRON,compound-compound-dobj,pobj-nsubj,NNP-NNP-NNP,NNP-PRP,4,1
4492,2777.0,37,invested,2,1,16,15,0,20,1,14,Scaife,Pittsburgh,,per,NOUN,PROPN,nsubj,poss,NN,NNP,7,1
4493,2778.0,29,allowed,8,6,24,18,5,4,2,16,Slovenia,Olimpija,,per,PROPN,PROPN,pobj,pobj,NNP,NNP,3,1
4494,2779.0,23,said,4,3,9,6,2,13,1,5,Evo Morales,Bolivia,per-per,,PROPN-PROPN,PROPN,compound-nsubj,nsubj,NNP-NNPS,NNP,4,1
4495,7195.0,15,approves,3,2,12,10,1,2,1,9,Evo Morales,Bolivia,org-org,,PROPN-PROPN,PROPN,compound-nsubj,poss,NNP-NNP,NNP,5,1
4496,10849.0,28,decided,9,2,18,16,1,9,7,9,Evo Morales,Bolivia,-,per,PROPN-PROPN,PROPN,compound-nsubj,poss,NNP-NNPS,NNP,6,1
4497,13845.0,22,wants,3,2,5,3,1,16,1,2,Evo Morales,Bolivia,-,per,PROPN-PROPN,PROPN,compound-nsubj,nsubj,NNP-NNPS,NNP,3,1
4498,2780.0,25,sold,9,8,22,14,7,2,1,13,Adler Seeds,Indiana,-,org,PROPN-PROPN,PROPN,compound-nsubj,pobj,NNP-NNPS,NNP,9,1
4499,2781.0,9,known,3,1,6,5,0,2,2,3,He,Leo,per,,PRON,PROPN,nsubjpass,pobj,PRP,NNP,5,1
4500,2782.0,24,is,7,13,2,-11,12,21,-6,-5,Zambia,Zambian Defence Force,,per-per-per,PROPN,PROPN-PROPN-PROPN,pobj,compound-compound-pobj,NNP,NNP-NNP-NNP,4,1
4501,2783.0,20,has,2,12,15,3,11,4,-10,13,Southeastern,Go-Ahead group,per,-,PROPN,PROPN-NOUN,pobj,compound-compound,NNP,NNP-NN,5,1
4502,2784.0,15,fell,3,3,12,9,2,2,0,9,Prudential,London,per,,PROPN,PROPN,pobj,compound,NNP,NNP,5,1
4503,2785.0,41,established,11,3,7,4,2,33,8,-4,Stella Maris College,Montevideo,--,org,PROPN-PROPN-PROPN,PROPN,compound-compound-nsubjpass,appos,NNP-NNP-NNP,NNP,3,1
4504,2786.0,19,signed,4,3,8,5,2,10,1,4,1915,Tennessee Technological University,,per-per-per,NUM,PROPN-PROPN-PROPN,nummod,compound-compound-appos,CD,NNP-NNP-NNP,5,1
4505,2788.0,10,US,2,1,5,4,0,4,1,3,Hoboken,John Wiley Sons,,per-per-per,PROPN,PROPN-PROPN-PROPN,amod,compound-compound-compound,NNP,NNP-NNP-NNPS,3,1
4506,2789.0,44,acn,4,30,41,11,29,2,-26,37,Mexico,David Alfaro Siqueiros,per,--,PROPN,PROPN-PROPN-PROPN,poss,compound-compound-conj,NNP,NNP-NNP-NNP,5,1
4507,5625.0,37,traveled,1,4,16,12,3,20,-3,15,Mexico,David Alfaro Siqueiros,org,--,PROPN,PROPN-PROPN-PROPN,pobj,compound-compound-conj,NNP,NNP-NNP-NNP,8,1
4508,2790.0,35,founded,19,1,5,4,0,29,18,-14,Ruhr University Bochum,German,per-per-per,,PROPN-PROPN-PROPN,PROPN,compound-compound-nsubjpass,compound,NNP-NNP-NNP,NNP,3,1
4509,2791.0,23,was,1,8,19,11,7,3,-7,18,her,United States,,org-org,DET,PROPN-PROPN,poss,compound-pobj,PRP$,NNP-NNP,5,1
4510,3775.0,23,released,6,8,21,13,7,1,-2,15,her,United States,per,-,DET,PROPN-PROPN,poss,compound-pobj,PRP$,NNP-NNP,7,1
4511,2792.0,32,praised,9,8,27,19,7,4,1,18,Grinnell College,Iowa,org-org,,PROPN-PROPN,PROPN,compound-pobj,compound,NNP-NNP,NNP,10,1
4512,2793.0,9,Walentynowicz,1,4,6,2,3,2,-3,5,Poland,Solidarity,,per,PROPN,PROPN,poss,compound,NNP,NNP,3,1
4513,12761.0,20,was,10,3,6,3,2,13,7,-4,Poland,Solidarity,org,,PROPN,PROPN,poss,compound,NNP,NNP,3,1
4514,2794.0,31,is,1,14,20,6,13,10,-13,19,Pakistan,Muhammad Mian Soomro,,org-org-org,PROPN,PROPN-PROPN-PROPN,pobj,compound-compound-pobj,NNP,NNP-NNP-NNP,6,1
4515,6068.0,27,condemned,14,1,10,9,0,16,13,-4,Pakistan,Muhammad Mian Soomro,,per-per-per,PROPN,PROPN-PROPN-PROPN,poss,compound-compound-conj,NNP,NNP-NNP-NNP,5,1
4516,2795.0,44,exists,2,22,13,-9,21,30,-20,11,1960,Tower Records,per,-,NUM,PROPN-PROPN,pobj,compound-nsubj,CD,NNP-NNPS,3,1
4517,2796.0,24,represented,8,5,11,6,4,12,3,3,Hurricanes,University of Miami,,org-org-org,PROPN,PROPN-ADP-PROPN,compound,dobj-prep-pobj,NNP,NNP-IN-NNP,3,1
4518,2797.0,39,became,9,18,38,20,17,0,-9,29,Ne Win,Korea,per-per,,PROPN-PROPN,PROPN,compound-pobj,pobj,NNP-NNP,NNP,11,1
4519,2798.0,26,appointed,7,2,5,3,1,20,5,-2,Periyar University,Tamil Nadu,org-org,-,PROPN-PROPN,PROPN-PROPN,compound-nsubj,compound-pobj,NNP-NNP,NNP-NNP,2,1
4520,2799.0,28,announced,2,17,26,9,16,1,-15,24,Oxiana,Oz Minerals,per,-,PROPN,PROPN-PROPN,pobj,compound-dobj,NNP,NNP-NNPS,3,1
4521,2800.0,15,calls,3,3,9,6,2,5,0,6,ZCTU,Zimbabwe,,org,PROPN,PROPN,nsubj,compound,NNP,NNP,2,1
4522,8400.0,39,warned,3,21,27,6,20,11,-18,24,ZCTU,Zimbabwe,per,,PROPN,PROPN,nsubj,poss,NNP,NNP,12,1
4523,2801.0,36,is,1,4,17,13,3,18,-3,16,Thailand,Suchinda Kraprayoon,,org-org,PROPN,PROPN-PROPN,nsubj,compound-pobj,NNP,NNP-NNP,3,1
4524,8423.0,46,was,8,17,32,15,16,13,-9,24,Thailand,Suchinda Kraprayoon,org,-,PROPN,PROPN-PROPN,pobj,compound-conj,NNP,NNP-NNP,6,1
4525,2802.0,41,was,1,1,11,10,0,29,0,10,He,Georgia,,org,PRON,PROPN,nsubj,compound,PRP,NNP,5,1
4526,2803.0,21,was,1,11,19,8,10,1,-10,18,Grateful Dead,Warner Bros,org-org,-,PROPN-PROPN,PROPN-PROPN,compound-compound,compound-pobj,NNP-NNP,NNP-NNP,10,1
4527,2804.0,22,voted,1,10,16,6,9,5,-9,15,Franklin Pierce,United States,-,org-org,PROPN-PROPN,PROPN-PROPN,compound-appos,compound-compound,NNP-NNP,NNP-NNP,7,1
4528,3918.0,25,appointed,12,11,19,8,10,5,1,7,Franklin Pierce,United States,-,per-per,PROPN-PROPN,PROPN-PROPN,compound-pobj,compound-compound,NNP-NNP,NNP-NNP,8,1
4529,9932.0,29,resumed,1,12,16,4,11,12,-11,15,Franklin Pierce,United States,-,per-per,PROPN-PROPN,PROPN-PROPN,compound-pobj,compound-compound,NNP-NNP,NNP-NNP,5,1
4530,2805.0,18,is,8,1,14,13,0,3,7,6,Souad Massi,iter and g,per-per,--,PROPN-PROPN,NOUN-CCONJ-NOUN,compound-nsubj,amod-cc-det,NNP-NNP,NN-CC-NN,3,1
4531,2806.0,44,is,10,17,24,7,16,19,-7,14,Cheadle High School,Staffordshire,--,org,PROPN-PROPN-PROPN,PROPN,compound-compound-pobj,pobj,NNP-NNP-NNP,NNP,5,1
4532,3388.0,27,is,9,2,20,18,1,6,7,11,Cheadle High School,Staffordshire,per-per-per,,PROPN-PROPN-PROPN,PROPN,compound-compound-appos,pobj,NNP-NNP-NNP,NNP,6,1
4533,2808.0,28,announced,12,1,7,6,0,20,11,-5,OL,Olympique Lyonnais,org,-,PROPN,PROPN-PROPN,compound,compound-compound,NNP,NNP-NNP,4,1
4534,2809.0,24,is,4,2,23,21,1,0,2,19,Malone University,NAIA,per-per,,PROPN-PROPN,PROPN,compound-dobj,pobj,NNP-NNP,NNP,8,1
4535,2810.0,28,declared,12,3,21,18,2,6,9,9,Rogers,United States,org,-,PROPN,PROPN-PROPN,nsubj,nmod-nmod,NNP,NNP-NNP,5,1
4536,2811.0,55,was,22,2,28,26,1,26,20,6,Imperial Japanese Navy,Empire of Japan,--,org-org-org,ADJ-ADJ-PROPN,PROPN-ADP-PROPN,amod-amod-nsubj,pobj-prep-pobj,JJ-JJ-NNP,NNP-IN-NNP,6,1
4537,2812.0,50,see,17,23,28,5,22,21,-6,11,Kenyatta,Kenya,,per,PROPN,PROPN,pobj,compound,NNP,NNP,3,1
4538,10457.0,27,managed,4,8,14,6,7,12,-4,10,Kenyatta,Kenya,per,,PROPN,PROPN,poss,compound,NNP,NNP,7,1
4539,2813.0,26,fired,4,8,9,1,7,16,-4,5,guitarist,Izzy Stradlin,,org-org,NOUN,PROPN-PROPN,compound,compound-nsubj,NN,NNP-NNP,1,1
4540,11355.0,23,involved,10,6,7,1,5,15,4,-3,guitarist,Izzy Stradlin,per,-,NOUN,PROPN-PROPN,compound,compound-nsubjpass,NN,NNP-NNP,1,1
4541,2814.0,19,Court,1,12,15,3,11,3,-11,14,Perth,University of Western Australia,,org-org-org-org,PROPN,PROPN-ADP-PROPN-PROPN,pobj,conj-prep-compound-pobj,NNP,NNP-IN-NNP-NNP,3,1
4542,2815.0,44,was,1,32,32,0,31,11,-31,31,Birmingham,Birmingham Conservatoire,per,-,PROPN,PROPN-PROPN,nmod,compound-appos,NNP,NNP-NNP,0,1
4543,4255.0,20,is,1,1,1,0,0,18,0,0,Birmingham,Birmingham Conservatoire,,per-per,PROPN,PROPN-PROPN,nsubj,compound-pobj,NNP,NNP-NNP,0,1
4544,2816.0,7,started,2,5,6,1,4,0,-3,4,Delhi,University,org,,PROPN,PROPN,compound,pobj,NNP,NNP,3,1
4545,2817.0,100,Troy,1,31,42,11,30,57,-30,41,Hudson Valley Community College,State University of New York,---,org-org-org-org-org,PROPN-PROPN-PROPN-PROPN,PROPN-PROPN-ADP-PROPN-PROPN,compound-compound-compound-dobj,compound-nmod-prep-compound-pobj,NNP-NNP-NNP-NNP,NNP-NNP-IN-NNP-NNP,-1,1
4546,2818.0,24,is,2,13,18,5,12,5,-11,16,We the Kings,S-Curve,org-org-org,,PRON-DET-NOUN,PROPN,ROOT-det-appos,compound,PRP-DT-NNS,NNP,6,1
4547,2819.0,37,was,2,30,32,2,29,4,-28,30,Talabani,Patriotic Union of Kurdistan,,per-per-per-per,PROPN,PROPN-PROPN-ADP-PROPN,poss,compound-nmod-prep-pobj,NNP,NNP-NNP-IN-NNP,2,1
4548,2820.0,44,is,5,19,34,15,18,9,-14,29,Chicago,Peter Cetera,per,-,PROPN,PROPN-PROPN,appos,compound-pobj,NNP,NNP-NNP,-1,1
4549,8862.0,37,forgiven,12,5,8,3,4,28,7,-4,Chicago,Peter Cetera,,per-per,PROPN,PROPN-PROPN,compound,compound-nsubjpass,NNP,NNP-NNP,2,1
4550,9977.0,39,is,4,17,32,15,16,6,-13,28,Chicago,Peter Cetera,org,-,PROPN,PROPN-PROPN,appos,compound-conj,NNP,NNP-NNP,4,1
4551,13527.0,32,'N',2,15,27,12,14,4,-13,25,Chicago,Peter Cetera,,per-per,PROPN,PROPN-PROPN,appos,compound-compound,NNP,NNP-NNP,6,1
4552,2821.0,23,is,9,1,21,20,0,1,8,12,Fly MI,Miguel Freitas,-,org-org,VERB-PROPN,PROPN-PROPN,compound-nsubj,compound-pobj,VB-NNP,NNP-NNP,5,1
4553,2822.0,43,Established,0,3,16,13,2,26,-3,16,1827,Fourah Bay College,per,--,NUM,PROPN-PROPN-PROPN,pobj,compound-compound-nsubj,CD,NNP-NNP-NNP,-1,1
4554,2823.0,36,elected,8,2,15,13,1,20,6,7,Nicolas Sarkozy,France,per-per,,PROPN-PROPN,PROPN,compound-poss,poss,NNP-NNP,NNP,9,1
4555,6857.0,35,said,33,2,12,10,1,22,31,-21,Nicolas Sarkozy,France,-,org,PROPN-PROPN,PROPN,compound-nsubj,nsubjpass,NNP-NNP,NNP,4,1
4556,2824.0,24,Born,0,8,21,13,7,2,-8,21,England,Sutton High School,org,--,PROPN,PROPN-PROPN-PROPN,pobj,compound-compound-pobj,NNP,NNP-NNP-NNP,5,1
4557,2825.0,26,was,3,1,17,16,0,8,2,14,Carnival Air Lines,1988,per-per-per,,PROPN-PROPN-PROPN,NUM,compound-compound-nsubj,pobj,NNP-NNP-NNP,CD,5,1
4558,2826.0,41,called,16,7,14,7,6,26,9,-2,California,Redford,org,,PROPN,PROPN,nmod,appos,NNP,NNP,4,1
4559,2827.0,36,Beginning,0,4,18,14,3,17,-4,18,Citgo,PDVSA,,org,PROPN,PROPN,compound,appos,NNP,NNP,5,1
4560,8656.0,15,is,7,10,14,4,9,0,-3,7,Citgo,PDVSA,org,,PROPN,PROPN,attr,pobj,NNP,NNP,3,1
4561,2829.0,50,Left,38,24,24,0,23,25,14,-14,he Communist Party of Bohemia and Morav,he European United Left Nordic Green Le,------,org-org-org-org-org-org-org,PRON-PROPN-PROPN-ADP-PROPN-CCONJ-PROPN,PRON-PROPN-PROPN-VERB-PROPN-PROPN-PROPN,compound-compound-appos-prep-pobj-cc-conj,nsubj-compound-appos-ROOT-dobj-compound-dobj,PRP-NNP-NNP-IN-NNP-CC-NNP,PRP-NNP-NNP-VBD-NNP-NNP-NNP,0,1
4562,2830.0,15,featured,6,2,13,11,1,1,4,7,December 1953,Playboy,per-per,,PROPN-NUM,PROPN,pobj-nummod,compound,NNP-CD,NNP,6,1
4563,2831.0,24,won,17,3,16,13,2,7,14,-1,Saint Kitts and Nevis,Denzil Douglas,---,per-per,PROPN-PROPN-CCONJ-PROPN,PROPN-PROPN,compound-nsubj-cc-compound,compound-pobj,NNP-NNP-CC-NNP,NNP-NNP,3,1
4564,2832.0,40,participated,17,15,25,10,14,14,2,8,Rome,Italian Labour Union,,org-org-org,PROPN,PROPN-PROPN-PROPN,pobj,amod-compound-pobj,NNP,NNP-NNP-NNP,7,1
4565,2833.0,31,nominated,6,10,17,7,9,13,-4,11,Calvin Coolidge,United States,-,org-org,PROPN-PROPN,PROPN-PROPN,compound-pobj,compound-compound,NNP-NNP,NNP-NNP,7,1
4566,4874.0,31,nominated,6,10,17,7,9,13,-4,11,Calvin Coolidge,United States,-,org-org,PROPN-PROPN,PROPN-PROPN,compound-pobj,compound-compound,NNP-NNP,NNP-NNP,7,1
4567,13048.0,31,nominated,6,10,18,8,9,12,-4,12,Calvin Coolidge,United States,per-per,-,PROPN-PROPN,PROPN-PROPN,compound-pobj,compound-compound,NNP-NNP,NNP-NNP,7,1
4568,2834.0,21,represented,7,3,3,0,2,17,4,-4,Tennessee,Tennessee State University,,org-org-org,PROPN,PROPN-PROPN-PROPN,compound,compound-compound-dobj,NNP,NNP-NNP-NNP,0,1
4569,2835.0,29,is,2,24,26,2,23,2,-22,24,Spain,Romero,,org,PROPN,PROPN,pobj,nsubj,NNP,NNP,2,1
4570,2836.0,21,heckled,4,1,2,1,0,18,3,-2,Chairman,Albert Ho,per,-,PROPN,PROPN-PROPN,compound,compound-nsubjpass,NNP,NNP-NNP,1,1
4571,12575.0,102,Gang,1,37,38,1,36,63,-36,37,Chairman,Albert Ho,,org-org,PROPN,PROPN-PROPN,compound,compound-nsubj,NNP,NNP-NNP,1,1
4572,2837.0,17,is,4,11,16,5,10,0,-7,12,Turkish Air Force,Turkey,--,org,PROPN-PROPN-PROPN,PROPN,compound-compound-pobj,pobj,NNP-NNP-NNP,NNP,5,1
4573,2838.0,16,is,6,3,6,3,2,9,3,0,Samy Deluxe,Hamburg,-,per,PROPN-PROPN,PROPN,compound-appos,pobj,NNP-NNP,NNP,1,1
4574,2839.0,35,drawings,3,29,31,2,28,3,-26,28,Nice,he,org,,PROPN,PRON,pobj,nsubj,NNP,PRP,1,1
4575,2841.0,27,handled,1,9,12,3,8,14,-8,11,Spencer Abraham,Michigan,per-per,,PROPN-PROPN,PROPN,compound-pobj,pobj,NNP-NNP,NNP,3,1
4576,12232.0,5,Abraham,1,1,4,3,0,0,0,3,Spencer Abraham,Michigan,per-per,,PROPN-PROPN,PROPN,compound-ROOT,pobj,NNP-NNP,NNP,1,1
4577,2843.0,40,challenged,4,21,29,8,20,10,-17,25,England,Catherine of Valois,org,--,PROPN,PROPN-ADP-PROPN,pobj,conj-prep-compound,NNP,NNP-IN-NNP,5,1
4578,2844.0,6,live,2,2,5,3,1,0,0,3,Bluey,Australia,,per,PROPN,PROPN,nsubj,pobj,NNPS,NNP,1,1
4579,4471.0,39,is,4,2,10,8,1,28,2,6,Bluey,Australia,,org,PROPN,PROPN,compound,pobj,NNP,NNP,5,1
4580,2845.0,13,is,6,1,12,11,0,0,5,6,Belarusian State University,Belarus,--,org,PROPN-PROPN-PROPN,PROPN,compound-compound-nsubj,pobj,NNP-NNP-NNP,NNP,3,1
4581,2847.0,21,has,2,1,11,10,0,9,1,9,He,Cassandra Harris,,org-org,PRON,PROPN-PROPN,nsubj,compound-appos,PRP,NNP-NNP,4,1
4582,2848.0,37,became,3,8,10,2,7,26,-5,7,Alexander,New Radicals,,org-org,PROPN,PROPN-PROPN,poss,compound-compound,NNP,NNP-NNPS,3,1
4583,2849.0,30,is,3,1,27,26,0,2,2,24,MITIE Group,UK,-,per,PROPN-PROPN,PROPN,compound-compound,pobj,NNP-NNP,NNP,7,1
4584,2850.0,31,am,9,6,8,2,5,22,3,-1,Yukon College,Whitehorse,-,org,PROPN-PROPN,PROPN,compound-compound,nsubj,NNP-NNP,NNP,3,1
4585,2851.0,25,is,9,1,8,7,0,16,8,-1,Jussi,Finland,per,,PROPN,PROPN,nsubj,pobj,NNP,NNP,3,1
4586,2852.0,50,moved,17,1,12,11,0,37,16,-5,Oldfield School,Bath,-,org,PROPN-PROPN,PROPN,compound-nsubjpass,pobj,NNP-NNP,NNP,3,1
4587,2855.0,33,headed,3,12,17,5,11,15,-9,14,Irving Trust Company,Bank of New York,org-org-org,---,PROPN-PROPN-PROPN,PROPN-ADP-PROPN-PROPN,compound-compound-dobj,pobj-prep-compound-pobj,NNP-NNP-NNP,NNP-IN-NNP-NNP,5,1
4588,2856.0,11,is,2,1,9,8,0,1,1,7,Harding Academy,Searcy,per-per,,PROPN-PROPN,PROPN,compound-nsubj,compound,NNP-NNP,NNP,4,1
4589,2858.0,34,owned,15,26,29,3,25,4,-11,14,Sun Media,Quebecor Media,per-per,-,PROPN-PROPN,PROPN-PROPN,compound-pobj,compound-appos,NNP-NNP,NNP-NNP,1,1
4590,2859.0,37,composed,3,18,34,16,17,2,-15,31,Paris,Institut Telecom,per,-,PROPN,PROPN-PROPN,conj,compound-compound,NNP,NNP-NNP,-1,1
4591,2860.0,25,called,6,10,16,6,9,8,-4,10,South Africa,Jan Smuts,per-per,-,PROPN-PROPN,PROPN-PROPN,compound-pobj,compound-appos,NNP-NNP,NNP-NNP,5,1
4592,2861.0,42,has,11,14,34,20,13,7,-3,23,Arkansas Razorbacks,Hogs,-,per,PROPN-PROPN,PROPN,compound-dobj,compound,NNP-NNP,NNPS,4,1
4593,2862.0,60,are,3,56,59,3,55,0,-53,56,Ingvar Carlsson,Sweden,per-per,,PROPN-PROPN,PROPN,compound-conj,pobj,NNP-NNP,NNP,5,1
4594,3509.0,45,proposed,3,41,44,3,40,0,-38,41,Ingvar Carlsson,Sweden,-,per,PROPN-PROPN,PROPN,compound-appos,pobj,NNP-NNP,NNP,11,1
4595,3854.0,21,asserted,1,14,20,6,13,0,-13,19,Ingvar Carlsson,Sweden,org-org,,PROPN-PROPN,PROPN,compound-pobj,pobj,NNP-NNP,NNP,3,1
4596,4236.0,32,held,1,11,27,16,10,4,-10,26,Ingvar Carlsson,Sweden,-,per,PROPN-PROPN,PROPN,compound-pobj,pobj,NNP-NNP,NNP,6,1
4597,5787.0,43,was,31,2,26,24,1,16,29,-5,Ingvar Carlsson,Sweden,org-org,,PROPN-PROPN,PROPN,compound-nsubj,compound,NNP-NNP,NNP,5,1
4598,7688.0,19,was,6,5,11,6,4,7,1,5,Ingvar Carlsson,Sweden,per-per,,PROPN-PROPN,PROPN,compound-pobj,pobj,NNP-NNP,NNP,5,1
4599,9447.0,52,due,1,8,15,7,7,36,-7,14,Ingvar Carlsson,Sweden,per-per,,PROPN-PROPN,PROPN,compound-pobj,compound,NNP-NNP,NNP,5,1
4600,11986.0,22,served,6,1,9,8,0,12,5,3,Ingvar Carlsson,Sweden,per-per,,PROPN-PROPN,PROPN,compound-nsubj,compound,NNP-NNP,NNP,4,1
4601,12904.0,32,proceed,29,3,25,22,2,6,26,-4,Ingvar Carlsson,Sweden,org-org,,PROPN-PROPN,PROPN,compound-appos,pobj,NNP-NNP,NNP,9,1
4602,2864.0,11,served,1,1,5,4,0,5,0,4,He,Connecticut,per,,PRON,PROPN,nsubj,compound,PRP,NNP,2,1
4603,3587.0,17,served,2,1,6,5,0,10,1,4,He,Connecticut,,org,PRON,PROPN,nsubj,compound,PRP,NNP,3,1
4604,4312.0,17,made,1,1,8,7,0,8,0,7,He,Connecticut,per,,PRON,PROPN,nsubj,pobj,PRP,NNP,1,1
4605,11848.0,16,became,2,1,8,7,0,7,1,6,He,Connecticut,,org,PRON,PROPN,nsubj,pobj,PRP,NNP,3,1
4606,2865.0,18,accomplishing,4,1,17,16,0,0,3,13,Felipe Sosa,Paraguay,per-per,,PROPN-PROPN,PROPN,compound-nsubj,pobj,NNP-NNP,NNP,2,1
4607,2867.0,25,became,2,2,4,2,1,20,0,2,Jameson,Prime Minister,org,-,PROPN,PROPN-PROPN,nsubj,compound-attr,NNP,NNP-NNP,1,1
4608,2868.0,28,sworn,12,16,9,-7,15,18,-4,-3,President,Ali Abdullah Saleh,org,--,PROPN,PROPN-PROPN-PROPN,compound,compound-compound-pobj,NNP,NNP-NNP-NNP,8,1
4609,2869.0,25,rushed,14,4,13,9,3,11,10,-1,Kingston,he,per,,PROPN,PRON,compound,nsubjpass,NNP,PRP,5,1
4610,2870.0,27,was,1,10,15,5,9,11,-9,14,United Microelectronics Corporation,Taiwan,org-org-org,,PROPN-PROPN-PROPN,PROPN,compound-compound-pobj,poss,NNP-NNP-NNP,NNP,6,1
4611,2872.0,19,retired,4,4,16,12,3,2,0,12,he,Virginia,per,,PRON,PROPN,nsubj,pobj,PRP,NNP,4,1
4612,2873.0,23,formed,3,8,17,9,7,5,-5,14,Manchester,Andy Rourke,,org-org,PROPN,PROPN-PROPN,pobj,compound-pobj,NNP,NNP-NNP,3,1
4613,2874.0,35,known,11,14,13,-1,13,21,-3,2,s DonGURALesk,a Poli,org-org,-,NOUN-PROPN,DET-PROPN,compound-dobj,det-amod,NN-NNP,DT-NNP,1,1
4614,2875.0,24,is,10,9,17,8,8,6,1,7,CJTF-HOA,United States,per,-,PROPN,PROPN-PROPN,appos,compound-compound,NNP,NNP-NNP,5,1
4615,2876.0,17,is,1,1,14,13,0,2,0,13,Plantronics,Santa Cruz,,org-org,PROPN,PROPN-PROPN,nsubj,compound-compound,NNP,NNP-NNP,5,1
4616,2877.0,89,broadcast,2,10,26,16,9,62,-8,24,United States,Michael Rapaport,org-org,-,PROPN-PROPN,PROPN-PROPN,compound-pobj,compound-appos,NNP-NNP,NNP-NNP,4,1
4617,2878.0,37,released,2,1,23,22,0,13,1,21,The Gambit,Finland,-,per,DET-PROPN,PROPN,det-nsubj,pobj,DT-NNP,NNP,4,1
4618,2879.0,15,was,2,1,11,10,0,3,1,9,David Gordon,Programma International,org-org,-,PROPN-PROPN,PROPN-PROPN,compound-nsubj,compound-dobj,NNP-NNP,NNP-NNP,4,1
4619,2880.0,33,told,11,5,11,6,4,21,6,0,Tony Yayo,G-Unit,per-per,,PROPN-PROPN,PROPN,compound-pobj,punct,NNP-NNP,NNP,2,1
4620,2881.0,29,guided,5,1,12,11,0,16,4,7,Finland,Juho Kusti Paasikivi,per,--,PROPN,PROPN-PROPN-PROPN,poss,compound-compound-pobj,NNP,NNP-NNP-NNP,9,1
4621,4819.0,19,settled,4,15,16,1,14,2,-11,12,Finland,Juho Kusti Paasikivi,,org-org-org,PROPN,PROPN-PROPN-PROPN,compound,compound-compound-pobj,NNP,NNP-NNP-NNP,2,1
4622,2882.0,36,said,22,24,30,6,23,5,-2,8,George Friedman,Stratfor,per-per,,PROPN-PROPN,PROPN,compound-nsubj,pobj,NNP-NNP,NNP,4,1
4623,2883.0,42,is,25,1,10,9,0,31,24,-15,Edguy,Tobias Sammet,per,-,NOUN,PROPN-PROPN,nsubj,compound-nsubj,NN,NNP-NNP,3,1
4624,2884.0,17,is,2,9,15,6,8,1,-7,13,Amanda Lear,Ariola Records,-,per-per,PROPN-PROPN,PROPN-PROPN,compound-pobj,compound-pobj,NNP-NNP,NNP-NNPS,5,1
4625,2885.0,35,attended,1,3,8,5,2,26,-2,7,Orange Glen High School,Escondido,per-per-per-per,,PROPN-PROPN-PROPN-PROPN,PROPN,compound-compound-compound-dobj,compound,NNP-NNP-NNP-NNP,NNP,3,1
4626,2886.0,35,is,3,1,25,24,0,9,2,22,Bell Aliant,NorthernTel,-,per,PROPN-PROPN,PROPN,compound-compound,pobj,NNP-NNP,NNP,10,1
4627,2887.0,34,represented,7,2,14,12,1,19,5,7,East Carolina University,NCAA,--,per,PROPN-PROPN-PROPN,PROPN,compound-compound-dobj,compound,NNP-NNP-NNP,NNP,7,1
4628,5994.0,21,represented,7,3,15,12,2,5,4,8,East Carolina University,NCAA,--,per,PROPN-PROPN-PROPN,PROPN,compound-compound-dobj,compound,NNP-NNP-NNP,NNP,5,1
4629,2888.0,29,is,8,17,20,3,16,8,-9,12,his,Kaos,org,,DET,PROPN,poss,appos,PRP$,NNP,7,1
4630,2889.0,34,joined,11,1,4,3,0,29,10,-7,Japan,Princess,per,,PROPN,PROPN,poss,compound,NNP,NNP,2,1
4631,2891.0,27,revamping,12,9,25,16,8,1,3,13,David A. Martin,Guthrey Club,--,per-per,PROPN-PROPN-PROPN,PROPN-PROPN,compound-compound-nsubj,compound-pobj,NNP-NNP-NNP,NNP-NNP,10,1
4632,2892.0,32,Sprawling,0,16,26,10,15,5,-16,26,Electronic Data Systems,Texas,per-per-per,,PROPN-PROPN-PROPN,PROPN,compound-compound-compound,compound,NNP-NNPS-NNP,NNP,4,1
4633,2893.0,42,lined,6,17,24,7,16,17,-11,18,Nepal,Girija Prasad Koirala,,org-org-org,PROPN,PROPN-PROPN-PROPN,poss,compound-compound-pobj,NNP,NNP-NNP-NNP,10,1
4634,11959.0,32,paid,1,6,9,3,5,22,-5,8,Nepal,Girija Prasad Koirala,per,--,PROPN,PROPN-PROPN-PROPN,amod,compound-compound-pobj,NNP,NNP-NNP-NNP,3,1
4635,12312.0,25,said,23,9,13,4,8,11,14,-10,Nepal,Girija Prasad Koirala,org,--,PROPN,PROPN-PROPN-PROPN,poss,compound-compound-pobj,NNP,NNP-NNP-NNP,4,1
4636,2894.0,31,graduated,7,12,15,3,11,15,-5,8,Barnard College,New York,org-org,-,PROPN-PROPN,PROPN-PROPN,compound-pobj,compound-pobj,NNP-NNP,NNP-NNP,2,1
4637,12199.0,24,is,4,16,21,5,15,2,-12,17,Barnard College,New York,org-org,-,PROPN-PROPN,PROPN-PROPN,compound-compound,compound-compound,NNP-NNP,NNP-NNP,5,1
4638,2896.0,19,is,2,11,14,3,10,4,-9,12,Williams College,Williamstown,per-per,,PROPN-PROPN,PROPN,compound-pobj,compound,NNP-NNP,NNP,2,1
4639,2897.0,18,met,4,8,17,9,7,0,-4,13,Maumoon Abdul Gayoom,Maldives,--,org,PROPN-PROPN-PROPN,PROPN,compound-compound-pobj,pobj,NNP-NNP-NNP,NNPS,4,1
4640,3320.0,21,elected,11,2,20,18,1,0,9,9,Maumoon Abdul Gayoom,Maldives,per-per-per,,PROPN-PROPN-PROPN,PROPN,compound-compound-nsubj,pobj,NNP-NNP-NNP,NNPS,3,1
4641,4146.0,29,show,3,7,23,16,6,5,-4,20,Maumoon Abdul Gayoom,Maldives,org-org-org,,PROPN-PROPN-PROPN,PROPN,compound-compound-nsubj,poss,NNP-NNP-NNP,NNPS,10,1
4642,2898.0,29,educated,2,8,23,15,7,5,-6,21,Cranbourne Business and Enterprise College,Hampshire,per-per-per-per-per,,PROPN-PROPN-CCONJ-PROPN-PROPN,PROPN,nmod-nmod-cc-compound-oprd,pobj,NNP-NNP-CC-NNP-NNP,NNP,2,1
4643,2899.0,28,announced,3,11,13,2,10,14,-8,10,Prime Minister,Brian Mulroney,-,per-per,PROPN-PROPN,PROPN-PROPN,compound-compound,compound-pobj,NNP-NNP,NNP-NNP,3,1
4644,6813.0,22,led,0,4,6,2,3,15,-4,6,Prime Minister,Brian Mulroney,-,per-per,PROPN-PROPN,PROPN-PROPN,compound-compound,compound-compound,NNP-NNP,NNP-NNP,1,1
4645,2900.0,40,stars,1,3,17,14,2,22,-2,16,Bono,Dublin,,org,PROPN,PROPN,ROOT,compound,NNP,NNP,7,1
4646,2901.0,29,was,1,6,11,5,5,17,-5,10,Hans Zimmer,Remote Control Productions,-,per-per-per,PROPN-PROPN,PROPN-PROPN-PROPN,compound-poss,compound-compound-pobj,NNP-NNP,NNP-NNP-NNP,3,1
4647,4020.0,11,writes,2,5,8,3,4,2,-3,6,Hans Zimmer,Remote Control Productions,org-org,--,PROPN-PROPN,PROPN-PROPN-PROPN,compound-poss,compound-compound-pobj,NNP-NNP,NNP-NNP-NNP,2,1
4648,7065.0,21,works,1,7,13,6,6,7,-6,12,Hans Zimmer,Remote Control Productions,-,per-per-per,PROPN-PROPN,PROPN-PROPN-PROPN,compound-poss,compound-compound-pobj,NNP-NNP,NNP-NNP-NNP,3,1
4649,13920.0,17,began,5,3,12,9,2,4,2,7,Hans Zimmer,Remote Control Productions,org-org,--,PROPN-PROPN,PROPN-PROPN-PROPN,compound-compound,compound-compound-dobj,NNP-NNP,NNP-NNP-NNPS,10,1
4650,2902.0,19,gained,1,1,17,16,0,1,0,16,He,Interscope,per,,PRON,PROPN,nsubj,compound,PRP,NNP,5,1
4651,2903.0,25,came,2,17,23,6,16,1,-15,21,Anne of Cleves,Henry,org-org-org,,PROPN-ADP-PROPN,PROPN,nmod-prep-pobj,compound,NNP-IN-NNPS,NNP,5,1
4652,2904.0,25,gave,10,2,14,12,1,10,8,4,Chicago,Jane Byrne,org,-,PROPN,PROPN-PROPN,compound,compound-compound,NNP,NNP-NNP,7,1
4653,4246.0,18,elect,9,2,11,9,1,6,7,2,Chicago,Jane Byrne,per,-,PROPN,PROPN-PROPN,nmod,compound-dobj,NNP,NNP-NNP,5,1
4654,8300.0,61,encouraged,1,12,30,18,11,30,-11,29,Chicago,Jane Byrne,org,-,PROPN,PROPN-PROPN,compound,compound-conj,NNP,NNP-NNP,9,1
4655,2905.0,11,Is,0,2,9,7,1,1,-2,9,California,Tiffany,,org,PROPN,PROPN,compound,compound,NNP,NNP,5,1
4656,2906.0,19,represented,6,3,14,11,2,4,3,8,Northwestern Wildcats,Division I,per-per,-,PROPN-PROPN,PROPN-PRON,compound-compound,compound-compound,NNP-NNP,NNP-PRP,5,1
4657,5255.0,19,represented,6,3,14,11,2,4,3,8,Northwestern Wildcats,Division I,per-per,-,PROPN-PROPN,PROPN-PRON,compound-compound,compound-compound,NNP-NNP,NNP-PRP,5,1
4658,2907.0,50,was,25,1,38,37,0,11,24,13,Harvey Comics,Alfred Harvey,-,org-org,PROPN-PROPN,PROPN-PROPN,compound-nsubj,compound-pobj,NNP-NNP,NNP-NNP,5,1
4659,5396.0,50,sued,15,5,13,8,4,36,10,-2,Harvey Comics,Alfred Harvey,org-org,-,PROPN-PROPN,PROPN-PROPN,compound-compound,compound-pobj,NNP-NNP,NNP-NNP,2,1
4660,2908.0,31,is,11,10,19,9,9,11,1,8,Netherlands,Eerste Divisie,per,-,PROPN,PROPN-PROPN,pobj,compound-compound,NNP,NNP-NNP,7,1
4661,2909.0,25,won,2,1,6,5,0,18,1,4,CHS,Indiana,per,,PROPN,PROPN,nsubj,compound,NNP,NNP,3,1
4662,2910.0,48,announced,6,13,26,13,12,21,-7,20,PBS Kids Sprout,Apax Partners,--,org-org,PROPN-PROPN-PROPN,PROPN-PROPN,compound-compound-pobj,compound-conj,NNP-NNP-NNP,NNP-NNPS,9,1
4663,2911.0,25,is,8,1,12,11,0,12,7,4,Jeffree Star,model,-,per,PROPN-PROPN,NOUN,compound-nsubj,compound,NNP-NNP,NN,5,1
4664,2912.0,34,entered,4,13,19,6,12,14,-9,15,Sunderland Technical College,University of Sunderland,org-org-org,--,PROPN-PROPN-PROPN,PROPN-ADP-PROPN,compound-compound-pobj,appos-prep-pobj,NNP-NNP-NNP,NNP-IN-NNP,3,1
4665,2913.0,26,is,11,13,18,5,12,7,-2,7,Lemmy,French,per,,PROPN,ADJ,compound,amod,NNP,JJ,5,1
4666,2914.0,19,is,2,1,2,1,0,16,1,0,Dudley,College,org,,PROPN,PROPN,compound,nsubj,NNP,NNP,1,1
4667,2915.0,27,founded,2,5,15,10,4,11,-3,13,Independent Ecological Movement,1994,per-per-per,,PROPN-PROPN-PROPN,NUM,compound-compound-dobj,pobj,NNP-NNP-NNP,CD,3,1
4668,2916.0,44,introduced,3,26,37,11,25,6,-23,34,U.S.,Rutgers University,org,-,PROPN,PROPN-PROPN,pobj,compound-compound,NNP,NNP-NNP,9,1
4669,2917.0,24,Department,8,14,14,0,13,9,-6,6,Tehran University of Medical Sciences,Tehran,----,per,PROPN-PROPN-ADP-PROPN-PROPN,PROPN,compound-appos-prep-compound-pobj,compound,NNP-NNP-IN-NNP-NNPS,NNP,0,1
4670,4364.0,62,held,6,28,28,0,27,33,-22,22,Tehran University of Medical Sciences,Tehran,per-per-per-per-per,,PROPN-PROPN-ADP-PROPN-PROPN,PROPN,compound-pobj-prep-compound-pobj,pobj,NNP-NNP-IN-NNP-NNPS,NNP,0,1
4671,6168.0,31,Department,8,14,14,0,13,16,-6,6,Tehran University of Medical Sciences,Tehran,----,per,PROPN-PROPN-ADP-PROPN-PROPN,PROPN,compound-appos-prep-compound-pobj,compound,NNP-NNP-IN-NNP-NNPS,NNP,0,1
4672,2918.0,94,participated,7,5,13,8,4,80,2,6,French Foreign Legion,France,per-per-per,,ADJ-PROPN-PROPN,PROPN,amod-compound-pobj,pobj,JJ-NNP-NNP,NNP,5,1
4673,2919.0,24,established,10,1,6,5,0,17,9,-4,Notre Dame High School,Sheffield,per-per-per-per,,PROPN-PROPN-PROPN-PROPN,PROPN,compound-compound-compound-nsubjpass,compound,NNP-NNP-NNP-NNP,NNP,4,1
4674,2922.0,29,Follow,0,11,15,4,10,13,-11,15,Nikki Webster,Australia,-,per,PROPN-PROPN,PROPN,compound-pobj,pobj,NNP-NNP,NNP,4,1
4675,2923.0,16,is,9,1,12,11,0,3,8,3,Igor Yebra,Spanish,-,per,PROPN-PROPN,ADJ,compound-nsubj,amod,NNP-NNP,JJ,4,1
4676,2924.0,31,said,29,1,19,18,0,11,28,-10,Estonia,Estonian Air,,org-org,PROPN,PROPN-PROPN,nsubj,compound-pobj,NNP,NNP-NNP,7,1
4677,2925.0,44,triumphed,20,2,7,5,1,36,18,-13,Montana,Conrad Burns,org,-,PROPN,PROPN-PROPN,compound,compound-dobj,NNP,NNP-NNP,3,1
4678,9241.0,24,was,1,9,16,7,8,7,-8,15,Montana,Conrad Burns,,org-org,PROPN,PROPN-PROPN,pobj,compound-pobj,NNP,NNP-NNP,3,1
4679,10337.0,43,was,3,22,34,12,21,8,-19,31,Montana,Conrad Burns,,org-org,PROPN,PROPN-PROPN,pobj,compound-pobj,NNP,NNP-NNPS,6,1
4680,2926.0,32,is,4,4,15,11,3,16,0,11,Abraham,Michigan,,org,PROPN,PROPN,nsubj,compound,NNP,NNP,7,1
4681,2927.0,15,began,9,2,3,1,1,11,7,-6,2005,Thompson Rivers University,org,--,NUM,PROPN-PROPN-PROPN,pobj,compound-compound-nsubj,CD,NNP-NNPS-NNP,2,1
4682,2928.0,25,located,5,1,8,7,0,16,4,3,Its,Tonsley Park,,org-org,DET,PROPN-PROPN,poss,compound-pobj,PRP$,NNP-NNP,4,1
4683,2929.0,72,began,58,36,44,8,35,27,22,-14,Texas,Gary Hart,per,-,PROPN,PROPN-PROPN,compound,compound-appos,NNP,NNP-NNP,6,1
4684,2930.0,27,claimed,8,1,3,2,0,23,7,-5,Ranbaxy Laboratories,India,-,org,PROPN-PROPN,PROPN,compound-compound,poss,NNP-NNPS,NNP,2,1
4685,2932.0,21,is,1,1,6,5,0,14,0,5,ASIS,Department of Foreign Affairs and Trade,,org-org-org-org-org-org,PROPN,PROPN-ADP-PROPN-PROPN-CCONJ-PROPN,nsubj,pobj-prep-nmod-pobj-cc-conj,NNP,NNP-IN-NNP-NNPS-CC-NNP,4,1
4686,2934.0,23,Put,1,14,21,7,13,1,-13,20,Nina Simone,Philips,-,org,PROPN-PROPN,PROPN,compound-ROOT,compound,NNP-NNP,NNP,3,1
4687,2935.0,32,released,5,17,30,13,16,1,-12,25,Rolling Stones,Ian Stewart,org-org,-,PROPN-PROPN,PROPN-PROPN,compound-pobj,compound-pobj,NNP-NNPS,NNP-NNP,9,1
4688,2936.0,21,worked,2,1,6,5,0,14,1,4,He,composer,org,,PRON,NOUN,nsubj,pobj,PRP,NN,2,1
4689,2937.0,24,graduated,1,7,23,16,6,0,-6,22,nationale de chimie de Paris,France,org-org-org-org-org,,ADJ-X-NOUN-X-PROPN,PROPN,amod-compound-nmod-compound-conj,pobj,JJ-FW-NN-FW-NNP,NNP,4,1
4690,2939.0,13,acquired,5,5,8,3,4,4,0,3,Quebecor,Sun Media,org,-,PROPN,PROPN-PROPN,nsubj,compound-compound,NNP,NNP-NNP,2,1
4691,3764.0,52,was,2,45,47,2,44,4,-43,45,Quebecor,Sun Media,per,-,PROPN,PROPN-PROPN,poss,compound-compound,NNP,NNP-NNP,3,1
4692,2940.0,24,is,11,1,10,9,0,13,10,-1,Hanoch Piven,Uruguay,per-per,,PROPN-PROPN,PROPN,compound-nsubj,pobj,NNP-NNP,NNP,1,1
4693,2941.0,22,was,3,2,10,8,1,11,1,7,Duquesne Football,Division I,per-per,-,PROPN-PROPN,PROPN-PRON,compound-nsubj,pobj-nmod,NNP-NNP,NNP-PRP,5,1
4694,2942.0,15,started,1,10,11,1,9,3,-9,10,Toledo,Central Catholic High School,,org-org-org-org,PROPN,PROPN-PROPN-PROPN-PROPN,compound,compound-compound-compound-pobj,NNP,NNP-NNP-NNP-NNP,2,1
4695,2943.0,34,run,7,14,23,9,13,10,-7,16,Wear Valleys NHS Trust,West Park Hospital,---,per-per-per,PROPN-PROPN-PROPN-PROPN,PROPN-PROPN-PROPN,compound-compound-compound-conj,compound-compound-dobj,NNP-NNP-NNP-NNP,NNP-NNP-NNP,8,1
4696,2944.0,36,set,4,15,34,19,14,1,-11,30,United States,his,per-per,,PROPN-PROPN,DET,compound-pobj,poss,NNP-NNP,PRP$,6,1
4697,11354.0,36,presented,19,6,21,15,5,14,13,2,United States,his,per-per,,PROPN-PROPN,DET,compound-compound,poss,NNP-NNP,PRP$,7,1
4698,2946.0,22,is,1,1,5,4,0,16,0,4,Vlad,composer,org,,PROPN,NOUN,nsubj,attr,NNP,NN,4,1
4699,2947.0,11,demutualised,5,1,5,4,0,5,4,0,Standard Life,Edinburgh,-,per,PROPN-PROPN,PROPN,compound-nsubj,pobj,NNP-NNP,NNP,1,1
4700,2948.0,46,GETTING,0,27,28,1,26,17,-27,28,Australia,La Trobe University,org,--,PROPN,PROPN-PROPN-PROPN,compound,compound-compound-conj,NNP,NNP-NNP-NNP,2,1
4701,2949.0,32,is,5,3,16,13,2,15,2,11,Antonio Sanchez,Mexico,-,per,PROPN-PROPN,PROPN,compound-compound,pobj,NNP-NNP,NNP,7,1
4702,2952.0,20,began,13,6,6,0,5,13,7,-7,Kiev,Kiev Arsenal factory,per,--,PROPN,PROPN-PROPN-NOUN,compound,compound-compound-pobj,NNP,NNP-NNP-NN,0,1
4703,2953.0,12,is,1,1,4,3,0,7,0,3,La,Costa Rica,,per-per,PROPN,PROPN-PROPN,nsubj,compound-pobj,NNP,NNP-NNP,2,1
4704,2954.0,31,appointed,4,8,9,1,7,21,-4,5,Governor,Bob Graham,per,-,PROPN,PROPN-PROPN,compound,compound-pobj,NNP,NNP-NNP,1,1
4705,2956.0,42,held,5,2,4,2,1,37,3,-1,Iran,Saipa,,org,PROPN,PROPN,poss,nsubjpass,NNP,NNP,4,1
4706,14242.0,37,managed,8,1,8,7,0,28,7,0,Iran,Saipa,per,,PROPN,PROPN,poss,nsubj,NNP,NNP,3,1
4707,2957.0,29,was,4,18,24,6,17,4,-14,20,Los Angeles,she,org-org,,PROPN-PROPN,PRON,compound-pobj,nsubj,NNP-NNP,PRP,5,1
4708,2958.0,35,cast,5,8,16,8,7,18,-3,11,Gold Label Records,Hong Kong,per-per-per,-,PROPN-PROPN-PROPN,PROPN-PROPN,compound-compound-pobj,compound-pobj,NNP-NNP-NNPS,NNP-NNP,6,1
4709,2959.0,48,be,7,3,6,3,2,41,4,-1,Nanyang Polytechnic,Singapore,-,org,PROPN-PROPN,PROPN,compound-pobj,pobj,NNP-NNP,NNP,4,1
4710,2960.0,30,nominated,2,1,17,16,0,12,1,15,He,United States,,org-org,PRON,PROPN-PROPN,nsubjpass,compound-compound,PRP,NNP-NNP,6,1
4711,5015.0,13,came,1,1,5,4,0,7,0,4,He,United States,,per-per,PRON,PROPN-PROPN,nsubj,compound-pobj,PRP,NNP-NNP,2,1
4712,12146.0,26,remained,1,1,5,4,0,20,0,4,He,United States,,per-per,PRON,PROPN-PROPN,nsubj,compound-pobj,PRP,NNP-NNP,2,1
4713,13956.0,24,was,1,1,22,21,0,1,0,21,He,United States,,per-per,PRON,PROPN-PROPN,nsubj,compound-pobj,PRP,NNP-NNP,3,1
4714,2962.0,26,invited,5,8,14,6,7,11,-3,9,Adolf Galland,Jagdverband 44,-,per-per,PROPN-PROPN,PROPN-NUM,compound-pobj,nsubj-nummod,NNP-NNP,NNP-CD,5,1
4715,2963.0,35,recalled,9,22,25,3,21,9,-13,16,Vytautas Landsbergis,Lithuania,org-org,,PROPN-PROPN,PROPN,compound-attr,poss,NNP-NNP,NNP,4,1
4716,7638.0,38,shifted,5,20,32,12,19,5,-15,27,Vytautas Landsbergis,Lithuania,-,per,PROPN-PROPN,PROPN,compound-pobj,pobj,NNP-NNP,NNP,8,1
4717,12208.0,36,was,18,17,28,11,16,7,1,10,Vytautas Landsbergis,Lithuania,-,per,PROPN-PROPN,PROPN,compound-pobj,pobj,NNP-NNP,NNP,-1,1
4718,2964.0,45,was,3,1,18,17,0,26,2,15,Lee,Singapore,per,,PROPN,PROPN,poss,pobj,NNP,NNP,6,1
4719,11151.0,26,was,2,1,4,3,0,21,1,2,Lee,Singapore,,per,PROPN,PROPN,nsubj,poss,NNP,NNP,5,1
4720,13088.0,35,served,1,1,4,3,0,30,0,3,Lee,Singapore,per,,PROPN,PROPN,nsubj,poss,NNP,NNP,4,1
4721,2965.0,24,lives,2,9,22,13,8,1,-7,20,Llewellyn Park,Thomas Edison,org-org,-,PROPN-PROPN,PROPN-PROPN,compound-pobj,compound-pobj,NNP-NNP,NNP-NNP,7,1
4722,2966.0,24,said,4,1,3,2,0,20,3,-1,Ontario,Dalton McGuinty,org,-,PROPN,PROPN-PROPN,compound,compound-nsubj,NNP,NNP-NNP,1,1
4723,2967.0,45,awarded,10,8,12,4,7,32,2,2,Ukraine,Durdynets,,org,PROPN,NOUN,compound,dative,NNP,NNS,6,1
4724,2968.0,25,established,8,4,7,3,3,17,4,-1,American University of Afghanistan,Afghanistan,per-per-per-per,,PROPN-PROPN-ADP-PROPN,PROPN,compound-nsubjpass-prep-pobj,pobj,NNP-NNP-IN-NNP,NNP,2,1
4725,2969.0,27,is,15,2,14,12,1,12,13,-1,University of California,UCM,--,org,PROPN-ADP-PROPN,PROPN,nmod-prep-pobj,conj,NNP-IN-NNP,NNP,4,1
4726,7975.0,33,became,4,10,19,9,9,13,-6,15,University of California,UCM,--,per,PROPN-ADP-PROPN,PROPN,nmod-prep-pobj,appos,NNP-IN-NNP,NNP,5,1
4727,2970.0,22,signed,8,1,1,0,0,20,7,-7,China Power Investment Corporation,China,---,org,PROPN-PROPN-PROPN-PROPN,PROPN,compound-compound-compound-nsubj,compound,NNP-NNP-NNP-NNP,NNP,0,1
4728,2971.0,12,calls,4,1,3,2,0,8,3,-1,Prime Minister,Taro Aso,-,org-org,PROPN-PROPN,PROPN-PROPN,compound-compound,compound-nsubj,NNP-NNP,NNP-NNP,1,1
4729,2972.0,53,won,3,26,40,14,25,12,-23,37,Colorado,Wayne Allard,org,-,PROPN,PROPN-PROPN,poss,compound-conj,NNP,NNP-NNP,5,1
4730,9851.0,31,January,0,4,7,3,3,23,-4,7,Colorado,Wayne Allard,,org-org,PROPN,PROPN-PROPN,compound,compound-nsubj,NNP,NNP-NNP,2,1
4731,9937.0,27,worked,3,12,14,2,11,12,-9,11,Colorado,Wayne Allard,,org-org,PROPN,PROPN-PROPN,compound,compound-appos,NNP,NNP-NNP,1,1
4732,12933.0,20,said,13,13,18,5,12,1,0,5,Colorado,Wayne Allard,org,-,PROPN,PROPN-PROPN,pobj,compound-nsubj,NNP,NNP-NNP,1,1
4733,14179.0,29,said,5,1,4,3,0,24,4,-1,Colorado,Wayne Allard,org,-,PROPN,PROPN-PROPN,compound,compound-nsubj,NNP,NNP-NNP,2,1
4734,2973.0,10,describes,1,1,6,5,0,3,0,5,She,painter,,per,PRON,NOUN,nsubj,pobj,PRP,NN,3,1
4735,2975.0,14,attended,1,9,13,4,8,0,-8,12,Downe House school,Berkshire,org-org-org,,PROPN-PROPN-NOUN,PROPN,compound-conj-pobj,pobj,NNP-NNP-NN,NNP,6,1
4736,2976.0,35,waiting,3,31,34,3,30,0,-28,31,Tetsu,Japan,,per,PROPN,PROPN,compound,pobj,NNP,NNP,2,1
4737,2977.0,79,receive,3,11,34,23,10,44,-8,31,ENC,Church of the Nazarene,org,---,PROPN,PROPN-ADP-DET-PROPN,pobj,pobj-prep-det-pobj,NNP,NNP-IN-DT-NNP,-1,1
4738,2978.0,13,was,1,7,10,3,6,2,-6,9,Jersey City,Cornelius Van Vorst,org-org,--,PROPN-PROPN,PROPN-PROPN-PROPN,compound-compound,compound-compound-pobj,NNP-NNP,NNP-NNP-NNP,1,1
4739,2979.0,42,developed,2,5,11,6,4,30,-3,9,Atari Games,Midway Games,per-per,-,PROPN-PROPN,PROPN-PROPN,compound-pobj,compound-compound,NNP-NNPS,NNP-NNP,3,1
4740,2980.0,58,wanted,4,23,36,13,22,21,-19,32,d Bab,l Japa,-,per-per,NOUN-PROPN,PROPN-PROPN,amod-ROOT,punct-subtok,NN-NNP,NNP-NNP,5,1
4741,2981.0,32,Working,0,13,29,16,12,2,-13,29,Hot Chip,London,org-org,,PROPN-PROPN,PROPN,compound-compound,pobj,NNP-NNP,NNP,8,1
4742,2982.0,59,include,5,9,26,17,8,32,-4,21,NPA,NPA-sponsored,per,,PROPN,PROPN,amod,amod,NNP,NNP,9,1
4743,2983.0,35,started,9,13,33,20,12,1,-4,24,Chemikal Underground,Arab Strap,per-per,-,PROPN-PROPN,PROPN-PROPN,compound-dobj,compound-conj,NNP-NNP,NNP-NNP,6,1
4744,2984.0,21,agreed,5,18,20,2,17,0,-13,15,Arcelor,Luxembourg,,per,PROPN,PROPN,dobj,pobj,NNP,NNP,5,1
4745,2985.0,117,took,6,6,24,18,5,92,0,18,GLC,New York,,per-per,PROPN,PROPN-PROPN,nsubj,nmod-nmod,NNP,NNP-NNP,6,1
4746,2986.0,36,was,1,13,16,3,12,19,-12,15,Royal Inniskilling Fusiliers,British Army,--,per-per,PROPN-PROPN-PROPN,PROPN-PROPN,compound-compound-compound,compound-pobj,NNP-NNP-NNPS,NNP-NNP,2,1
4747,2987.0,39,was,2,15,19,4,14,19,-13,17,Buddy Bolden,New Orleans,org-org,-,PROPN-PROPN,PROPN-PROPN,compound-compound,compound-compound,NNP-NNP,NNP-NNP,4,1
4748,2988.0,30,is,8,2,2,0,1,27,6,-6,China,China State Shipbuilding Corporation,,org-org-org-org,PROPN,PROPN-PROPN-PROPN-PROPN,compound,compound-compound-compound-attr,NNP,NNP-NNP-NNP-NNP,0,1
4749,2989.0,26,Inauguration,1,4,13,9,3,12,-3,12,Carlos P. Garcia,Philippines,--,org,PROPN-PROPN-PROPN,PROPN,compound-compound-pobj,pobj,NNP-NNP-NNP,NNPS,4,1
4750,2990.0,26,returned,1,4,9,5,3,16,-3,8,Ecuador,himself,,per,PROPN,PRON,pobj,dobj,NNP,PRP,3,1
4751,2993.0,74,replace,4,16,23,7,15,50,-12,19,Atlantic,Solomon Burke,,per-per,PROPN,PROPN-PROPN,pobj,compound-nsubj,NNP,NNP-NNP,4,1
4752,2994.0,23,attended,4,8,11,3,7,11,-4,7,Ronnie Drew,The Dubliners,org-org,-,PROPN-PROPN,DET-PROPN,compound-pobj,det-pobj,NNP-NNP,DT-NNPS,2,1
4753,2995.0,50,is,22,18,18,0,17,31,4,-4,University of Florida Alumni Association,University of Florida,per-per-per-per-per,--,PROPN-ADP-PROPN-PROPN-PROPN,PROPN-ADP-PROPN,nmod-prep-pobj-compound-pobj,pobj-prep-pobj,NNP-IN-NNP-NNPS-NNP,NNP-IN-NNP,0,1
4754,2996.0,28,was,7,9,19,10,8,8,-2,12,Arago,France,,org,PROPN,PROPN,attr,pobj,NNP,NNP,-1,1
4755,12780.0,28,born,2,1,16,15,0,11,1,14,Arago,France,per,,PROPN,PROPN,nsubjpass,pobj,NNP,NNP,8,1
4756,2998.0,28,accompanied,3,17,23,6,16,4,-14,20,Mexico,Frida Kahlo,,org-org,PROPN,PROPN-PROPN,pobj,compound-pobj,NNP,NNP-NNP,3,1
4757,6485.0,30,headlined,4,17,28,11,16,1,-13,24,Mexico,Frida Kahlo,per,-,PROPN,PROPN-PROPN,compound,compound-conj,NNP,NNP-NNP,13,1
4758,10896.0,18,KAHLO-EXHIBIT,0,3,9,6,2,8,-3,9,Mexico,Frida Kahlo,per,-,PROPN,PROPN-PROPN,compound,compound-nsubj,NNP,NNP-NNP,-1,1
4759,2999.0,79,turned,3,61,65,4,60,13,-58,62,Adlai Stevenson III,Illinois,per-per-per,,PROPN-PROPN-PROPN,PROPN,compound-compound-appos,pobj,NNP-NNP-NNP,NNP,2,1
4760,3000.0,48,is,10,19,29,10,18,18,-9,19,enical,ndhra Pradesh in I,org,---,ADJ,NOUN-PROPN-ADP-NUM,amod,compound-pobj-prep-pobj,JJ,NN-NNP-IN-CD,2,1
4761,3001.0,12,renamed,3,5,11,6,4,0,-2,8,Red Bee Media,2005,--,org,PROPN-PROPN-PROPN,NUM,compound-compound-oprd,nummod,NNP-NNP-NNP,CD,3,1
4762,3002.0,27,knocked,3,9,16,7,8,10,-6,13,Georges Clemenceau,France,-,per,PROPN-PROPN,PROPN,compound-pobj,pobj,NNP-NNP,NNP,5,1
4763,4825.0,80,signed,26,10,12,2,9,67,16,-14,Georges Clemenceau,France,-,org,PROPN-PROPN,PROPN,compound-compound,poss,NNP-NNP,NNP,2,1
4764,3003.0,19,charge,2,11,14,3,10,4,-9,12,Robert Mugabe,ZANU-PF,org-org,,PROPN-PROPN,PROPN,compound-dobj,predet,NNP-NNP,NNP,1,1
4765,10733.0,36,been,3,16,19,3,15,16,-13,16,Robert Mugabe,ZANU-PF,per-per,,PROPN-PROPN,PROPN,compound-poss,compound,NNP-NNP,NNP,3,1
4766,3005.0,15,named,4,8,14,6,7,0,-4,10,Fnac,France,,org,PROPN,PROPN,pobj,pobj,NNP,NNP,2,1
4767,3006.0,51,paved,28,16,20,4,15,30,12,-8,Denis O'Brien,Digicel,per-per,,PROPN-PROPN,PROPN,compound-conj,compound,NNP-NNP,NNP,3,1
4768,3401.0,28,entered,12,6,10,4,5,17,6,-2,Denis O'Brien,Digicel,org-org,,PROPN-PROPN,PROPN,compound-compound,nsubj,NNP-NNP,NNP,6,1
4769,3007.0,16,was,8,1,4,3,0,11,7,-4,Marco Cappato,European Parliament,org-org,-,PROPN-PROPN,ADJ-PROPN,compound-nsubj,compound-compound,NNP-NNP,JJ-NNP,2,1
4770,3009.0,36,said,6,22,24,2,21,11,-16,18,Afghanistan,Abdul Kabir,,per-per,PROPN,PROPN-PROPN,compound,compound-pobj,NNP,NNP-NNP,1,1
4771,3011.0,33,appointed,4,3,19,16,2,13,1,15,she,Pakistan,,org,PRON,PROPN,nsubj,compound,PRP,NNP,7,1
4772,3012.0,33,acquired,3,3,21,18,2,11,0,18,Synanon,California,,per,PROPN,PROPN,pobj,pobj,NNP,NNP,3,1
4773,3013.0,17,said,6,1,5,4,0,11,5,-1,Alberta,Rob Renner,per,-,PROPN,PROPN-PROPN,poss,compound-nsubj,NNP,NNP-NNP,3,1
4774,9893.0,19,said,5,1,4,3,0,14,4,-1,Alberta,Rob Renner,org,-,PROPN,PROPN-PROPN,compound,compound-nsubj,NNP,NNP-NNP,2,1
4775,3015.0,41,said,39,2,10,8,1,30,37,-29,Ludwig Scotty,Nauru,per-per,,PROPN-PROPN,PROPN,compound-nsubjpass,pobj,NNP-NNP,NNP,2,1
4776,3016.0,29,starts,12,4,4,0,3,24,8,-8,Edmonton Transit System,Edmonton,per-per-per,,PROPN-PROPN-PROPN,PROPN,compound-compound-pobj,poss,NNP-NNP-NNP,NNP,0,1
4777,3017.0,28,born,4,1,27,26,0,0,3,23,R. B. Bennett,Canada,--,per,PROPN-PROPN-PROPN,PROPN,compound-compound-nsubjpass,pobj,NNP-NNP-NNP,NNP,3,1
4778,3018.0,41,made,17,13,13,0,12,27,4,-4,NASDAQ OMX Group,NASDAQ,per-per-per,,PROPN-PROPN-PROPN,PROPN,compound-compound-conj,nsubj,NNP-NNP-NNP,NNP,0,1
4779,3019.0,77,is,3,1,10,9,0,66,2,7,North Greenville University,South Carolina,--,org-org,PROPN-PROPN-PROPN,PROPN-PROPN,compound-compound-nsubj,compound-compound,NNP-NNP-NNP,NNP-NNP,6,1
4780,3020.0,19,played,1,11,15,4,10,3,-10,14,Camrose Kodiaks,Alberta Junior Hockey League,org-org,---,PROPN-PROPN,PROPN-PROPN-PROPN-PROPN,compound-pobj,compound-compound-compound-pobj,NNP-NNPS,NNP-NNP-NNP-NNP,3,1
4781,3021.0,36,expressed,13,8,11,3,7,24,5,-2,Hong Kong,MTR Corporation,per-per,-,PROPN-PROPN,PROPN-PROPN,compound-poss,compound-compound,NNP-NNP,NNP-NNP,4,1
4782,3022.0,44,began,26,21,24,3,20,19,5,-2,Erskine Bowles,North Carolina,per-per,-,PROPN-PROPN,PROPN-PROPN,compound-conj,compound-pobj,NNP-NNP,NNP-NNP,2,1
4783,3023.0,46,2010,3,22,38,16,21,7,-19,35,South Carolina,Nikki Haley,per-per,-,PROPN-PROPN,PROPN-PROPN,compound-pobj,compound-nsubj,NNP-NNP,NNP-NNP,10,1
4784,4386.0,42,blocked,36,2,5,3,1,36,34,-31,South Carolina,Nikki Haley,per-per,-,PROPN-PROPN,PROPN-PROPN,compound-compound,compound-pobj,NNP-NNP,NNP-NNP,2,1
4785,3025.0,23,observed,13,7,11,4,6,11,6,-2,Roger Holder,University of Birmingham,-,org-org-org,PROPN-PROPN,PROPN-ADP-PROPN,compound-conj,pobj-prep-pobj,NNP-NNP,NNP-IN-NNP,3,1
4786,3026.0,33,is,1,7,13,6,6,19,-6,12,Dino Cazares,Fear Factory,per-per,-,PROPN-PROPN,PROPN-PROPN,compound-pobj,compound-pobj,NNP-NNP,NNP-NNP,3,1
4787,3027.0,27,is,2,9,26,17,8,0,-7,24,Makerere University,Uganda,-,per,PROPN-PROPN,PROPN,compound-compound,pobj,NNP-NNP,NNP,4,1
4788,3030.0,15,located,2,8,14,6,7,0,-6,12,Hayes,Ohio,per,,PROPN,PROPN,nmod,pobj,NNP,NNP,6,1
4789,8579.0,21,are,5,2,15,13,1,5,3,10,Hayes,Ohio,org,,PROPN,PROPN,nsubj,pobj,NNP,NNP,6,1
4790,3031.0,17,served,1,1,8,7,0,8,0,7,He,Egypt,org,,PRON,PROPN,nsubj,pobj,PRP,NNP,1,1
4791,8482.0,35,received,1,1,17,16,0,17,0,16,He,Egypt,per,,PRON,PROPN,nsubj,pobj,PRP,NNP,4,1
4792,3032.0,75,approved,35,40,43,3,39,31,-5,8,Prime Minister,Atef Ebeid,-,per-per,PROPN-PROPN,PROPN-PROPN,compound-pobj,compound-appos,NNP-NNP,NNP-NNP,1,1
4793,3033.0,43,received,10,3,7,4,2,35,7,-3,Dunmore High School,Pennsylvania,per-per-per,,PROPN-PROPN-PROPN,PROPN,compound-compound-compound,pobj,NNP-NNP-NNP,NNP,5,1
4794,3034.0,25,told,6,1,5,4,0,19,5,-1,Marcel Granier,RCTV,per-per,,PROPN-PROPN,PROPN,compound-nsubj,compound,NNP-NNP,NNP,2,1
4795,3035.0,23,shot,3,15,19,4,14,3,-12,16,Coronado High School,Scottsdale,org-org-org,,PROPN-PROPN-PROPN,PROPN,compound-compound-pobj,compound,NNP-NNP-NNP,NNP,3,1
4796,5479.0,23,drafted,2,17,21,4,16,1,-15,19,Coronado High School,Scottsdale,per-per-per,,PROPN-PROPN-PROPN,PROPN,compound-compound-pobj,compound,NNP-NNP-NNP,NNP,3,1
4797,3036.0,19,include,5,16,17,1,15,1,-11,12,Defense,Robert Gates,per,-,PROPN,PROPN-PROPN,pobj,compound-conj,NNP,NNP-NNP,1,1
4798,3038.0,23,was,4,11,21,10,10,1,-7,17,46th Infantry Brigade,France,--,org,ADJ-PROPN-PROPN,PROPN,nummod-compound-compound,pobj,JJ-NNP-NNP,NNP,5,1
4799,3040.0,13,Labels,0,7,9,2,6,3,-7,9,Idaho,Larry Craig,,org-org,PROPN,PROPN-PROPN,compound,compound-compound,NNP,NNP-NNP,3,1
4800,13035.0,43,responded,31,3,18,15,2,24,28,-13,Idaho,Larry Craig,,per-per,PROPN,PROPN-PROPN,compound,compound-pobj,NNP,NNP-NNP,7,1
4801,3042.0,40,owns,2,18,24,6,17,15,-16,22,QantasLink,Eastern,,per,PROPN,PROPN,ROOT,compound,NNP,NNP,5,1
4802,3043.0,54,decided,45,41,43,2,40,10,4,-2,Taipei,Chen Shui-Bian,org,-,PROPN,PROPN-PROPN,compound,compound-compound,NNP,NNP-NNP,2,1
4803,3044.0,13,appointed,5,4,9,5,3,3,1,4,Dorsey,St. Louis Community College,,org-org-org-org,PROPN,PROPN-PROPN-PROPN-PROPN,nsubjpass,compound-compound-compound-pobj,NNP,NNP-NNP-NNP-NNP,5,1
4804,3045.0,31,published,27,7,20,13,6,10,20,-7,Republica,England,per,,PROPN,PROPN,compound,pobj,NNP,NNP,7,1
4805,3046.0,26,been,17,3,11,8,2,14,14,-6,Alexander Dyukov,Agency of Military,org-org,--,PROPN-PROPN,PROPN-ADP-PROPN,nmod-nsubj,pobj-prep-nmod,NNP-NNP,NNP-IN-NNP,5,1
4806,3047.0,15,formed,9,8,11,3,7,3,1,2,Michael Brown,City Year,org-org,-,PROPN-PROPN,PROPN-PROPN,compound-conj,compound-dobj,NNP-NNP,NNP-NNP,3,1
4807,3049.0,79,were,11,9,32,23,8,46,2,21,Sierra Leonean,Siaka Stevens,per-per,-,PROPN-PROPN,PROPN-PROPN,compound-compound,compound-nsubj,NNP-NNP,NNP-NNP,13,1
4808,3050.0,16,ran,3,12,14,2,11,1,-9,11,Democratic,Paul Simon,per,-,ADJ,PROPN-PROPN,amod,compound-pobj,JJ,NNP-NNP,1,1
4809,3051.0,62,married,7,6,13,7,5,48,1,6,Lance Rentzel,Joey Heatherton,-,per-per,PROPN-PROPN,PROPN-PROPN,compound-nsubj,compound-nsubj,NNP-NNP,NNP-NNP,3,1
4810,3052.0,39,participated,3,18,38,20,17,0,-15,35,Carlos Chagas,Brazil,org-org,,PROPN-PROPN,PROPN,compound-compound,pobj,NNP-NNP,NNP,2,1
4811,3054.0,21,described,4,3,20,17,2,0,1,16,GAM,Tokyo,per,,PROPN,PROPN,compound,pobj,NNP,NNP,2,1
4812,3055.0,9,signed,2,1,5,4,0,3,1,3,Giuffria,MCA,org,,PROPN,PROPN,nsubjpass,compound,NNP,NNP,3,1
4813,3056.0,27,Founded,0,7,9,2,6,17,-7,9,Boston,Wheelock College,,per-per,PROPN,PROPN-PROPN,compound,compound-pobj,NNP,NNP-NNP,1,1
4814,3057.0,39,Inn,1,1,23,22,0,15,0,22,Days Inn,Cecil B. Day,org-org,--,NOUN-NOUN,PROPN-PROPN-PROPN,compound-ROOT,compound-compound-pobj,NNS-NN,NNP-NNP-NNP,7,1
4815,3058.0,48,educated,2,25,28,3,24,19,-23,26,Devon,Exeter School,org,-,PROPN,PROPN-PROPN,pobj,compound-pobj,NNP,NNP-NNP,2,1
4816,3059.0,54,signed,2,9,14,5,8,39,-7,12,Soviet Union,Andrei Gromyko,org-org,-,PROPN-PROPN,PROPN-PROPN,compound-pobj,compound-pobj,NNP-NNP,NNP-NNP,7,1
4817,4286.0,29,hold,7,13,27,14,12,1,-6,20,Soviet Union,Andrei Gromyko,org-org,-,PROPN-PROPN,PROPN-PROPN,compound-pobj,compound-pobj,NNP-NNP,NNP-NNP,7,1
4818,11587.0,16,dispatched,3,2,8,6,1,7,1,5,Soviet Union,Andrei Gromyko,per-per,-,PROPN-PROPN,PROPN-PROPN,compound-nsubj,compound-appos,NNP-NNP,NNP-NNP,2,1
4819,3060.0,54,studied,2,24,33,9,23,20,-22,31,Venezuela,Rafael Caldera,,per-per,PROPN,PROPN-PROPN,pobj,compound-poss,NNP,NNP-NNP,4,1
4820,3061.0,61,showed,12,8,12,4,7,48,4,0,University of Waterloo,Canada,org-org-org,,PROPN-ADP-PROPN,PROPN,pobj-prep-pobj,pobj,NNP-IN-NNP,NNP,7,1
4821,3062.0,17,won,11,7,10,3,6,6,4,-1,British,Damien Hirst,org,-,ADJ,PROPN-PROPN,amod,compound-nsubj,JJ,NNP-NNP,2,1
4822,3063.0,25,lost,4,3,18,15,2,6,1,14,Elpidio Quirino,Philippines,-,per,PROPN-PROPN,PROPN,compound-nsubj,pobj,NNP-NNP,NNPS,4,1
4823,14038.0,31,resigned,22,10,21,11,9,9,12,-1,Elpidio Quirino,Philippines,per-per,,PROPN-PROPN,PROPN,compound-appos,compound,NNP-NNP,NNP,8,1
4824,3065.0,29,predates,6,11,16,5,10,12,-5,10,NBC Entertainment/Universal Media Studios,Ben Silverman,org-org-org-org,-,PROPN-PROPN-PROPN-PROPN,PROPN-PROPN,nmod-nummod-compound-compound,compound-pobj,NNP-NNP-NNP-NNPS,NNP-NNP,2,1
4825,3066.0,31,revealed,4,13,16,3,12,14,-9,12,Chris Gaines,Garth Brooks,per-per,-,PROPN-PROPN,PROPN-PROPN,compound-pobj,compound-appos,NNP-NNP,NNP-NNP,1,1
4826,3067.0,41,say,5,20,23,3,19,17,-15,18,GeoEye,Virginia,,org,PROPN,PROPN,pobj,pobj,NNP,NNP,2,1
4827,9163.0,8,are,3,1,7,6,0,0,2,4,GeoEye,Virginia,per,,PROPN,PROPN,poss,pobj,NNP,NNP,4,1
4828,3068.0,14,played,1,7,13,6,6,0,-6,12,Hart High School,California,--,org,PROPN-PROPN-PROPN,PROPN,compound-compound-pobj,pobj,NNP-NNP-NNP,NNP,4,1
4829,3069.0,46,congratulates,6,8,15,7,7,30,-2,9,Chen Shui-bian,Republic,-,per,PROPN-PROPN,PROPN,compound-dobj,nmod,NNP-NNP,NNP,8,1
4830,3070.0,33,is,11,3,25,22,2,7,8,14,Bernie,Parliament-Funkadelic,,per,PROPN,PROPN,compound,pobj,NNP,NNP,9,1
4831,3071.0,29,served,1,6,22,16,5,6,-5,21,New Brunswick,Louis Robichaud,-,per-per,PROPN-PROPN,PROPN-PROPN,compound-compound,compound-pobj,NNP-NNP,NNP-NNP,6,1
4832,3073.0,19,taught,2,5,16,11,4,2,-3,14,West Virginia State University,Institute,---,per,PROPN-PROPN-PROPN-PROPN,PROPN,compound-compound-compound-pobj,compound,NNP-NNP-NNP-NNP,NNP,7,1
4833,3074.0,30,was,4,12,24,12,11,5,-8,20,Victoria Vikes,Canada West Universities Athletic Association,per-per,----,PROPN-PROPN,PROPN-PROPN-PROPN-PROPN-PROPN,pobj-nmod,compound-compound-compound-compound-oprd,NNP-NNP,NNP-NNP-NNP-NNP-NNP,10,1
4834,3075.0,35,was,2,10,18,8,9,16,-8,16,Federation of Organized Trades and Labor Unions,1881,per-per-per-per-per-per-per,,PROPN-ADP-PROPN-PROPN-CCONJ-PROPN-PROPN,NUM,pobj-prep-compound-pobj-cc-compound-conj,pobj,NNP-IN-NNP-NNPS-CC-NNP-NNPS,CD,6,1
4835,3076.0,30,allow,21,13,19,6,12,10,8,-2,Michigan,Abraham,,org,PROPN,PROPN,compound,pobj,NNP,NNP,4,1
4836,3077.0,29,caused,7,11,11,0,10,17,-4,4,University College Cardiff,University of Wales,org-org-org,--,PROPN-PROPN-PROPN,PROPN-ADP-PROPN,compound-compound-conj,nmod-prep-pobj,NNP-NNP-NNP,NNP-IN-NNP,0,1
4837,3078.0,37,grew,1,8,26,18,7,10,-7,25,Lincolnshire,King Edward VI Grammar School,,org-org-org-org-org,PROPN,PROPN-PROPN-PROPN-PROPN-PROPN,compound,compound-compound-compound-compound-conj,NNP,NNP-NNP-NNP-NNP-NNP,8,1
4838,3079.0,22,was,11,1,17,16,0,4,10,6,Lauri Kristian Relander,Finland,--,per,ADJ-PROPN-PROPN,PROPN,compound-compound-nsubj,pobj,JJ-NNP-NNP,NNP,4,1
4839,3080.0,28,located,4,1,8,7,0,19,3,4,Chadron State College,Nebraska,--,per,PROPN-PROPN-PROPN,PROPN,compound-compound-nsubjpass,pobj,NNP-NNP-NNP,NNP,3,1
4840,13385.0,21,founded,4,1,10,9,0,10,3,6,Chadron State College,Nebraska,org-org-org,,PROPN-PROPN-PROPN,PROPN,compound-compound-nsubjpass,pobj,NNP-NNP-NNP,NNP,4,1
4841,3081.0,24,is,9,4,4,0,3,19,5,-5,Chittagong University,Chittagong,org-org,,PROPN-PROPN,PROPN,compound-compound,compound,NNP-NNP,NNP,0,1
4842,9204.0,28,is,5,1,1,0,0,26,4,-4,Chittagong University,Chittagong,org-org,,PROPN-PROPN,PROPN,compound-nmod,compound,NNP-NNP,NNP,0,1
4843,3082.0,13,founded,4,1,12,11,0,0,3,8,Eagle Test,1976,-,per,PROPN-PROPN,NUM,compound-compound,pobj,NNP-NNP,CD,3,1
4844,3083.0,23,held,9,6,14,8,5,8,3,5,Florida,Martinez,per,,PROPN,PROPN,compound,poss,NNP,NNP,7,1
4845,4676.0,43,been,4,29,41,12,28,1,-25,37,Florida,Martinez,,per,PROPN,PROPN,pobj,nsubj,NNP,NNP,13,1
4846,3084.0,14,found,1,1,7,6,0,6,0,6,Sewell,Ontario,,per,PROPN,PROPN,nsubj,pobj,NNP,NNP,2,1
4847,3085.0,16,developed,2,13,15,2,12,0,-11,13,Macromedia,2005,org,,PROPN,NUM,pobj,pobj,NNP,CD,5,1
4848,3086.0,20,represented,7,3,15,12,2,4,4,8,West Virginia University,NCAA,per-per-per,,PROPN-PROPN-PROPN,PROPN,compound-compound-dobj,compound,NNP-NNP-NNP,NNP,7,1
4849,4051.0,20,represented,7,3,15,12,2,4,4,8,West Virginia University,NCAA,per-per-per,,PROPN-PROPN-PROPN,PROPN,compound-compound-dobj,compound,NNP-NNP-NNP,NNP,7,1
4850,4689.0,20,represented,7,3,15,12,2,4,4,8,West Virginia University,NCAA,per-per-per,,PROPN-PROPN-PROPN,PROPN,compound-compound-dobj,compound,NNP-NNP-NNP,NNP,7,1
4851,11616.0,20,represented,7,3,15,12,2,4,4,8,West Virginia University,NCAA,org-org-org,,PROPN-PROPN-PROPN,PROPN,compound-compound-dobj,compound,NNP-NNP-NNP,NNP,7,1
4852,12805.0,20,represented,7,3,15,12,2,4,4,8,West Virginia University,NCAA,--,org,PROPN-PROPN-PROPN,PROPN,compound-compound-dobj,compound,NNP-NNP-NNP,NNP,7,1
4853,13517.0,20,represented,7,3,15,12,2,4,4,8,West Virginia University,NCAA,per-per-per,,PROPN-PROPN-PROPN,PROPN,compound-compound-dobj,compound,NNP-NNP-NNP,NNP,7,1
4854,3087.0,35,led,1,9,30,21,8,4,-8,29,NYSE,Merrill Lynch,org,-,PROPN,PROPN-PROPN,appos,compound-nmod,NNP,NNP-NNP,8,1
4855,3088.0,17,brought,2,13,15,2,12,1,-11,13,Education,William Bennett,org,-,PROPN,PROPN-PROPN,compound,compound-pobj,NNP,NNP-NNP,1,1
4856,3089.0,25,reestablished,9,6,12,6,5,12,3,3,September 2 1789,United States Department of the Treasury,per-per-per,-----,PROPN-NUM-NUM,PROPN-PROPN-PROPN-ADP-DET-PROPN,pobj-nummod-nummod,compound-compound-dobj-prep-det-pobj,NNP-CD-CD,NNP-NNP-NNP-IN-DT-NNP,8,1
4857,3090.0,25,--,0,7,14,7,6,10,-7,14,Lee County High School,Leesburg,per-per-per-per,,PROPN-PROPN-PROPN-PROPN,PROPN,compound-compound-nmod-nmod,compound,NNP-NNP-NNP-NNP,NNP,3,1
4858,3809.0,14,is,4,1,11,10,0,2,3,7,Lee County High School,Leesburg,---,per,PROPN-PROPN-PROPN-PROPN,PROPN,compound-compound-compound-nsubj,compound,NNP-NNP-NNP-NNP,NNP,7,1
4859,3092.0,24,approved,5,4,21,17,3,2,1,16,2008,OZ Minerals,org,-,NUM,PROPN-PROPN,nummod,compound-pobj,CD,NNP-NNPS,5,1
4860,3093.0,13,studied,1,5,12,7,4,0,-4,11,Lebanese University,Lebanon,org-org,,PROPN-PROPN,PROPN,nmod-nmod,pobj,NNP-NNP,NNP,3,1
4861,11086.0,40,said,10,9,20,11,8,19,1,10,Lebanese University,Lebanon,-,per,PROPN-PROPN,PROPN,compound-pobj,conj,NNP-NNP,NNP,8,1
4862,3094.0,33,voted,1,10,11,1,9,21,-9,10,State,James Buchanan,,org-org,PROPN,PROPN-PROPN,pobj,compound-pobj,NNP,NNP-NNP,1,1
4863,5425.0,24,jpg,0,6,7,1,5,16,-6,7,State,James Buchanan,org,-,PROPN,PROPN-PROPN,pobj,compound-appos,NNP,NNP-NNP,1,1
4864,12049.0,28,put,2,19,20,1,18,7,-17,18,State,James Buchanan,,per-per,PROPN,PROPN-PROPN,pobj,compound-pobj,NNP,NNP-NNP,1,1
4865,3095.0,15,has,4,2,8,6,1,6,2,4,First National Bank,Nebraska,org-org-org,,PROPN-PROPN-PROPN,PROPN,compound-compound-nsubj,compound,NNP-NNP-NNP,NNP,5,1
4866,3096.0,9,Aug.,0,4,5,1,3,3,-4,5,Singer,Van Morrison,,per-per,NOUN,PROPN-PROPN,compound,compound-nsubj,NN,NNP-NNP,1,1
4867,3097.0,48,is,3,31,41,10,30,6,-28,38,Boston Properties,Mortimer Zuckerman,-,org-org,PROPN-PROPN,PROPN-PROPN,nmod-nmod,compound-pobj,NNP-NNP,NNP-NNP,5,1
4868,6065.0,17,announced,3,7,15,8,6,1,-4,12,Boston Properties,Mortimer Zuckerman,-,per-per,PROPN-PROPN,PROPN-PROPN,compound-pobj,compound-pobj,NNP-NNPS,NNP-NNP,6,1
4869,3098.0,44,established,10,1,1,0,0,42,9,-9,Georgia Tech,Georgia Institute of Technology,-,org-org-org-org,PROPN-PROPN,PROPN-PROPN-ADP-PROPN,compound-poss,nmod-nmod-prep-pobj,NNP-NNP,NNP-NNP-IN-NNP,0,1
4870,3099.0,51,held,15,27,28,1,26,22,-12,13,Interior,Franklin Knight Lane,per,--,PROPN,PROPN-PROPN-PROPN,pobj,compound-compound-pobj,NNP,NNP-NNP-NNP,1,1
4871,3100.0,27,nationalised,13,2,21,19,1,5,11,8,29 April 1977,Aircraft,org-org-org,,NUM-PROPN-NUM,PROPN,nummod-pobj-nummod,nmod,CD-NNP-CD,NNP,10,1
4872,3102.0,41,Beginning,0,15,27,12,14,13,-15,27,Tennessee,Roy Orbison,org,-,PROPN,PROPN-PROPN,compound,compound-pobj,NNP,NNP-NNP,5,1
4873,3103.0,75,include,2,23,27,4,22,47,-21,25,Kimora Lee Simmons,Baby Phat,--,per-per,PROPN-PROPN-PROPN,PROPN-PROPN,compound-compound-ROOT,compound-appos,NNP-NNP-NNP,NNP-NNP,4,1
4874,3104.0,24,declares,8,2,7,5,1,16,6,-1,Health and Human Services,Mike Leavitt,per-per-per-per,-,PROPN-CCONJ-PROPN-PROPN,PROPN-PROPN,nmod-cc-compound-conj,compound-nsubj,NNP-CC-NNP-NNPS,NNP-NNP,3,1
4875,3474.0,38,lead,5,19,24,5,18,13,-14,19,Health and Human Services,Mike Leavitt,per-per-per-per,-,PROPN-CCONJ-PROPN-PROPN,PROPN-PROPN,nmod-cc-compound-conj,compound-compound,NNP-CC-NNP-NNPS,NNP-NNP,3,1
4876,4155.0,53,include,4,15,19,4,14,33,-11,15,Health and Human Services,Mike Leavitt,org-org-org-org,-,PROPN-CCONJ-PROPN-PROPN,PROPN-PROPN,pobj-cc-compound-conj,compound-conj,NNP-CC-NNP-NNPS,NNP-NNP,4,1
4877,8152.0,38,strengthens,1,19,31,12,18,6,-18,30,Health and Human Services,Mike Leavitt,org-org-org-org,-,PROPN-CCONJ-PROPN-PROPN,PROPN-PROPN,pobj-cc-compound-conj,compound-pobj,NNP-CC-NNP-NNP,NNP-NNP,13,1
4878,10077.0,29,dispatching,5,7,12,5,6,16,-2,7,Health and Human Services,Mike Leavitt,org-org-org-org,-,PROPN-CCONJ-PROPN-PROPN,PROPN-PROPN,nmod-cc-compound-conj,compound-dobj,NNP-CC-NNP-NNPS,NNP-NNP,3,1
4879,11184.0,36,said,31,25,30,5,24,5,6,-1,Health and Human Services,Mike Leavitt,---,per-per,PROPN-CCONJ-PROPN-PROPN,PROPN-PROPN,nmod-cc-compound-conj,compound-nsubj,NNP-CC-NNP-NNPS,NNP-NNP,1,1
4880,3105.0,44,quantifies,2,33,42,9,32,1,-31,40,Wake Forest University Baptist Medical Center,North Carolina,org-org-org-org-org-org,-,PROPN-PROPN-PROPN-PROPN-PROPN-PROPN,PROPN-PROPN,compound-compound-compound-compound-compound-pobj,compound-pobj,NNP-NNP-NNP-NNP-NNP-NNP,NNP-NNP,4,1
4881,3107.0,46,is,12,20,20,0,19,25,-8,8,San Francisco Municipal Railway,San Francisco,org-org-org-org,-,PROPN-PROPN-PROPN-PROPN,PROPN-PROPN,compound-compound-compound-poss,compound-compound,NNP-NNP-NNP-NNP,NNP-NNP,0,1
4882,3108.0,38,announced,10,9,28,19,8,9,1,18,Republican,Arlen Specter,,per-per,PROPN,PROPN-PROPN,amod,compound-pobj,NNP,NNP-NNP,7,1
4883,3109.0,35,joined,4,3,24,21,2,10,1,20,Mr Onuch,Poland,-,org,PROPN-PROPN,PROPN,compound-nsubj,pobj,NNP-NNP,NNP,7,1
4884,3110.0,19,is,4,11,13,2,10,5,-7,9,Parliament-Funkadelic,Jerome Brailey,org,-,PROPN,PROPN-PROPN,amod,compound-pobj,NNP,NNP-NNP,2,1
4885,3114.0,15,had,1,7,14,7,6,0,-6,13,Ong Teng Cheong,Singapore,--,per,PROPN-PROPN-PROPN,PROPN,compound-compound-pobj,pobj,NNP-NNP-NNP,NNP,5,1
4886,10814.0,26,was,13,1,19,18,0,6,12,6,Ong Teng Cheong,Singapore,org-org-org,,PROPN-PROPN-PROPN,PROPN,compound-compound-nsubj,pobj,NNP-NNP-NNP,NNP,4,1
4887,3115.0,12,wins,4,1,3,2,0,8,3,-1,Japan,Nippon Oil,org,-,PROPN,PROPN-PROPN,poss,compound-nsubj,NNP,NNP-NNP,2,1
4888,6477.0,25,set,19,13,15,2,12,9,6,-4,Japan,Nippon Oil,org,-,PROPN,PROPN-PROPN,compound,compound-compound,NNP,NNP-NNP,7,1
4889,3117.0,41,is,31,5,19,14,4,21,26,-12,Ian Khama,Botswana,org-org,,PROPN-PROPN,PROPN,compound-nsubj,compound,NNP-NNP,NNP,2,1
4890,13063.0,33,ascended,8,7,21,14,6,11,1,13,Ian Khama,Botswana,-,org,PROPN-PROPN,PROPN,compound-nsubj,pobj,NNP-NNP,NNP,2,1
4891,3118.0,34,has,2,1,1,0,0,32,1,-1,Chiang Mai,Chiang Mai University,org-org,--,PROPN-PROPN,PROPN-PROPN-PROPN,compound-nsubj,compound-compound-compound,NNP-NNP,NNP-NNP-NNP,0,1
4892,3119.0,17,is,1,6,16,10,5,0,-5,15,England school,Buckinghamshire,-,per,PROPN-NOUN,PROPN,pobj-attr,pobj,NNP-NN,NNP,2,1
4893,3120.0,44,was,4,16,20,4,15,23,-12,16,Sirius Satellite Radio,New York,--,org-org,PROPN-PROPN-PROPN,PROPN-PROPN,compound-compound-conj,compound-pobj,NNP-NNP-NNP,NNP-NNP,3,1
4894,3121.0,30,Established,0,8,20,12,7,9,-8,20,1883,UND,,org,NUM,PROPN,pobj,pobj,CD,NNP,4,1
4895,3122.0,31,was,9,1,30,29,0,0,8,21,European Air Transport,Belgium,--,per,PROPN-PROPN-PROPN,PROPN,compound-nmod-nmod,pobj,NNP-NNP-NNP,NNP,6,1
4896,3123.0,20,operates,1,6,9,3,5,10,-5,8,CTVglobemedia,Globe,,org,PROPN,PROPN,nsubj,dobj,NNP,NNP,2,1
4897,3124.0,26,represented,8,4,11,7,3,14,4,3,UCLA,University of California,,per-per-per,PROPN,PROPN-ADP-PROPN,npadvmod,dobj-prep-pobj,NNP,NNP-IN-NNP,4,1
4898,3125.0,109,upheld,13,55,56,1,54,52,-42,43,Senator,Walker,org,,PROPN,PROPN,compound,nsubjpass,NNP,NNP,3,1
4899,3126.0,28,was,1,12,12,0,11,15,-11,11,Iowa Hawkeyes,Iowa,per-per,,PROPN-PROPN,PROPN,compound-conj,pobj,NNP-NNP,NNP,0,1
4900,3127.0,34,gamble,5,1,10,9,0,23,4,5,Indian,Mishra,org,,ADJ,PROPN,amod,dobj,JJ,NNP,4,1
4901,3129.0,31,is,4,11,16,5,10,14,-7,12,Winston Rodney,Burning Spear,per-per,-,PROPN-PROPN,VERB-PROPN,compound-pobj,pcomp-dobj,NNP-NNP,VBG-NNP,6,1
4902,3130.0,25,began,2,14,17,3,13,7,-12,15,Pax,Ion Television,,per-per,PROPN,PROPN-PROPN,nmod,compound-appos,NNP,NNP-NNP,4,1
4903,3133.0,28,grow,3,2,21,19,1,6,1,18,France,Sarah Bernhardt,per,-,PROPN,PROPN-PROPN,pobj,compound-compound,NNP,NNP-NNPS,4,1
4904,3134.0,12,is,1,1,8,7,0,3,0,7,Hill,New Hampshire,per,-,PROPN,PROPN-PROPN,nsubj,compound-compound,NNP,NNP-NNP,4,1
4905,3135.0,66,served,22,57,64,7,56,1,-35,42,Italy,Pietro Annigoni,,org-org,PROPN,PROPN-PROPN,pobj,compound-dobj,NNP,NNP-NNP,5,1
4906,3136.0,88,included,5,10,13,3,9,74,-5,8,John L. Anderson,Illinois Institute of Technology,--,org-org-org-org,PROPN-PROPN-PROPN,PROPN-PROPN-ADP-PROPN,compound-compound-compound,compound-appos-prep-pobj,NNP-NNP-NNP,NNP-NNP-IN-NNP,2,1
4907,3137.0,44,DRB-HICOM,0,1,8,7,0,35,-1,8,DRB-HICOM,Malaysia,per,,PROPN,PROPN,ROOT,poss,NNP,NNP,4,1
4908,3138.0,28,is,3,2,15,13,1,12,1,12,Episcopal Church,World Council of Churches,-,org-org-org-org,PROPN-PROPN,PROPN-PROPN-ADP-PROPN,compound-nsubj,compound-appos-prep-pobj,NNP-NNP,NNP-NNP-IN-NNPS,5,1
4909,3139.0,31,gained,19,8,18,10,7,12,11,-1,John Dahmer,Reform Party,org-org,-,PROPN-PROPN,PROPN-PROPN,compound-compound,compound-nsubj,NNP-NNP,NNP-NNP,7,1
4910,3140.0,14,show,4,7,11,4,6,2,-3,7,Dimitris Christofias,Cyprus,org-org,,PROPN-PROPN,PROPN,compound-nsubj,nmod,NNP-NNP,NNP,2,1
4911,10112.0,19,show,6,10,13,3,9,5,-4,7,Dimitris Christofias,Cyprus,-,per,PROPN-PROPN,PROPN,compound-nsubj,nmod,NNP-NNP,NNP,2,1
4912,3141.0,17,was,5,12,16,4,11,0,-7,11,Stoke Mandeville Hospital,England,--,org,PROPN-PROPN-PROPN,PROPN,compound-compound-pobj,pobj,NNP-NNP-NNP,NNP,5,1
4913,5676.0,16,disabled,5,9,15,6,8,0,-4,10,Stoke Mandeville Hospital,England,--,org,PROPN-PROPN-PROPN,PROPN,compound-compound-compound,appos,NNP-NNP-NNP,NNP,4,1
4914,3142.0,22,taken,16,8,13,5,7,8,8,-3,Hua Guofeng,Central Military Commission,org-org,--,PROPN-PROPN,PROPN-PROPN-PROPN,compound-compound,compound-compound-pobj,NNP-NNP,NNP-NNP-NNP,4,1
4915,3143.0,38,is,3,15,16,1,14,21,-12,13,songwriter,Elvis Costello,org,-,NOUN,PROPN-PROPN,compound,compound-conj,NN,NNP-NNP,1,1
4916,3144.0,26,is,7,2,21,19,1,4,5,14,Ultimate Fighting Championship,Art Davie,org-org-org,-,PROPN-PROPN-PROPN,PROPN-PROPN,compound-compound-nsubj,compound-nmod,NNP-NNP-NNP,NNP-NNP,7,1
4917,3145.0,34,But,0,8,25,17,7,8,-8,25,Australia,his,,per,PROPN,DET,compound,poss,NNP,PRP$,8,1
4918,5174.0,19,released,3,10,13,3,9,5,-7,10,Australia,his,,org,PROPN,DET,pobj,poss,NNP,PRP$,3,1
4919,3147.0,19,lists,15,2,2,0,1,16,13,-13,Dubai,Dubai Financial Market,,per-per-per,PROPN,PROPN-PROPN-PROPN,nsubjpass,compound-compound-nsubj,NNP,NNP-NNP-NNP,0,1
4920,3148.0,32,is,4,21,30,9,20,1,-17,26,Elvis Costello,Demon,per-per,,PROPN-PROPN,PROPN,compound-pobj,compound,NNP-NNP,NNP,3,1
4921,3149.0,50,|,1,14,20,6,13,29,-13,19,Henry II of England,Eleanor of Aquitaine,---,per-per-per,PROPN-PROPN-ADP-PROPN,PROPN-ADP-PROPN,compound-pobj-prep-pobj,appos-prep-pobj,NNP-NNP-IN-NNP,NNP-IN-NNP,7,1
4922,3150.0,20,is,3,1,19,18,0,0,2,16,La Roche College,Pennsylvania,--,org,PROPN-PROPN-PROPN,PROPN,compound-compound-nsubj,pobj,NNP-NNP-NNP,NNP,3,1
4923,3151.0,73,said,48,46,47,1,45,25,2,-1,host,Michael Reagan,,per-per,NOUN,PROPN-PROPN,conj,compound-nsubj,NN,NNP-NNP,3,1
4924,4092.0,25,comes,14,4,5,1,3,19,10,-9,host,Michael Reagan,,per-per,NOUN,PROPN-PROPN,compound,compound-nsubj,NN,NNP-NNP,1,1
4925,3152.0,14,is,1,6,10,4,5,3,-5,9,Ranasinghe Premadasa,President,per-per,,PROPN-PROPN,PROPN,compound-pobj,appos,NNP-NNP,NNP,2,1
4926,3154.0,25,became,3,2,3,1,1,21,1,0,Canada,Ryder,per,,PROPN,PROPN,compound,nsubj,NNP,NNP,2,1
4927,3155.0,23,was,1,9,16,7,8,6,-8,15,Washington,Hammerbox,,per,PROPN,PROPN,pobj,pobj,NNP,NNP,3,1
4928,3157.0,33,Founded,0,8,11,3,7,21,-8,11,Cypher Zero,Academy,org-org,,PROPN-PROPN,PROPN,compound-appos,nsubj,NNP-NNP,NNP,4,1
4929,3158.0,27,played,10,2,25,23,1,1,8,15,Blazers,Conference USA,,org-org,PROPN,PROPN-PROPN,nsubj,compound-pobj,NNPS,NNP-NNP,7,1
4930,7471.0,32,led,13,16,30,14,15,1,-3,17,Blazers,Conference USA,,per-per,PROPN,PROPN-PROPN,dobj,compound-pobj,NNPS,NNP-NNP,5,1
4931,3159.0,13,66th,3,2,5,3,1,7,1,2,Ramsey Clark,United States,per-per,-,PROPN-PROPN,PROPN-PROPN,compound-compound,compound-dobj,NNP-NNP,NNP-NNP,3,1
4932,3161.0,22,is,11,1,4,3,0,17,10,-7,Sup de Co Marrakech,Marrakech,org-org-org-org,,PROPN-X-PROPN-PROPN,PROPN,compound-compound-compound-nsubj,appos,NNP-FW-NNP-NNP,NNP,4,1
4933,3162.0,31,allied,8,6,30,24,5,0,2,22,Adib Shishakli,Syria,per-per,,PROPN-PROPN,PROPN,compound-compound,pobj,NNP-NNP,NNP,10,1
4934,3163.0,20,met,1,7,16,9,6,3,-6,15,boxer James Braddock,New Jersey,--,per-per,NOUN-PROPN-PROPN,PROPN-PROPN,advcl-compound-dobj,compound-pobj,NN-NNP-NNP,NNP-NNP,8,1
4935,3164.0,68,is,5,16,30,14,15,37,-11,25,Oscar Peterson,Pablo,org-org,,PROPN-PROPN,PROPN,compound-nsubj,compound,NNP-NNP,NNP,6,1
4936,3166.0,25,run,4,1,7,6,0,17,3,3,CNN,Turner Broadcasting System,per,--,PROPN,PROPN-PROPN-PROPN,compound,compound-compound-compound,NNP,NNP-NNP-NNP,5,1
4937,6565.0,16,owned,10,1,7,6,0,8,9,-3,CNN,Turner Broadcasting System,,org-org-org,PROPN,PROPN-PROPN-PROPN,nsubjpass,compound-compound-pobj,NNP,NNP-NNP-NNP,5,1
4938,3167.0,24,received,1,6,8,2,5,15,-5,7,Theodore Frelinghuysen,New Jersey,-,org-org,PROPN-PROPN,PROPN-PROPN,compound-compound,compound-poss,NNP-NNP,NNP-NNP,1,1
4939,10573.0,16,born,2,10,14,4,9,1,-8,12,Theodore Frelinghuysen,New Jersey,org-org,-,PROPN-PROPN,PROPN-PROPN,compound-pobj,compound-pobj,NNP-NNP,NNP-NNP,2,1
4940,3168.0,39,It's,0,15,21,6,14,17,-15,21,Liverpool John Moores University,England,per-per-per-per,,PROPN-PROPN-PROPN-PROPN,PROPN,compound-compound-compound-pobj,pobj,NNP-NNP-NNP-NNP,NNP,4,1
4941,9188.0,66,found,27,22,27,5,21,38,5,0,Liverpool John Moores University,England,---,org,PROPN-PROPN-PROPN-PROPN,PROPN,compound-compound-compound-pobj,pobj,NNP-NNP-NNP-NNP,NNP,10,1
4942,3169.0,39,moved,9,12,21,9,11,17,-3,12,Chicago,Curtis Mayfield,,per-per,PROPN,PROPN-PROPN,pobj,compound-poss,NNP,NNP-NNP,11,1
4943,3170.0,28,operated,2,7,6,-1,6,21,-5,4,Illinois,Southern Illinois University Carbondale,org,---,PROPN,PROPN-PROPN-PROPN-PROPN,compound,compound-compound-compound-nmod,NNP,NNP-NNP-NNP-NNP,2,1
4944,3171.0,22,responded,5,4,21,17,3,0,1,16,John Baird,Canada,-,per,PROPN-PROPN,PROPN,compound-nsubj,pobj,NNP-NNP,NNP,8,1
4945,10423.0,41,stated,15,5,18,13,4,22,10,3,John Baird,Canada,-,org,PROPN-PROPN,PROPN,compound-nsubj,nsubj,NNP-NNP,NNP,3,1
4946,11438.0,30,outlined,5,4,25,21,3,4,1,20,John Baird,Canada,per-per,,PROPN-PROPN,PROPN,compound-nsubj,poss,NNP-NNP,NNP,10,1
4947,3172.0,26,became,11,10,8,-2,9,17,1,-3,Joe Quesada,Marvel Comics,per-per,-,PROPN-PROPN,PROPN-PROPN,compound-nsubj,compound-pobj,NNP-NNP,NNP-NNPS,1,1
4948,3173.0,8,is,1,1,5,4,0,2,0,4,Opel,General Motors,,org-org,PROPN,PROPN-PROPN,nsubj,compound-compound,NNP,NNP-NNPS,4,1
4949,3174.0,38,illustrates,25,25,31,6,24,6,0,6,Alessandri,Chile,,per,PROPN,PROPN,pobj,nsubj,NNP,NNP,1,1
4950,13888.0,23,focused,2,1,20,19,0,2,1,18,Alessandri,Chile,,per,PROPN,PROPN,nsubj,poss,NNP,NNP,5,1
4951,3175.0,38,founded,19,12,17,5,11,20,7,-2,Washington College of Law,WCL,---,per,PROPN-PROPN-ADP-PROPN,PROPN,compound-pobj-prep-pobj,appos,NNP-NNP-IN-NNP,NNP,4,1
4952,4206.0,71,composed,3,64,69,5,63,1,-61,66,Washington College of Law,WCL,---,org,PROPN-PROPN-ADP-PROPN,PROPN,compound-conj-prep-pobj,appos,NNP-NNP-IN-NNP,NNP,3,1
4953,3176.0,14,owns,1,1,3,2,0,10,0,2,KiwiRail,Tranz Metro,,per-per,PROPN,PROPN-PROPN,nsubj,compound-dobj,NNP,NNP-NNP,1,1
4954,3177.0,27,is,1,5,25,20,4,1,-4,24,Blue October,C.B. Hudson,-,org-org,PROPN-PROPN,PROPN-PROPN,compound-compound,compound-dobj,NNP-NNP,NNP-NNP,10,1
4955,10935.0,33,took,15,5,10,5,4,22,10,-5,Blue October,C.B. Hudson,org-org,-,PROPN-PROPN,PROPN-PROPN,compound-poss,compound-appos,NNP-NNP,NNP-NNP,2,1
4956,3178.0,24,was,1,8,16,8,7,7,-7,15,Mercury,Little Richard,,org-org,PROPN,PROPN-PROPN,compound,compound-poss,NNP,NNP-NNP,6,1
4957,3179.0,19,is,4,7,18,11,6,0,-3,14,Moscow Metro,Russia,per-per,,PROPN-PROPN,PROPN,compound-compound,pobj,NNP-NNP,NNP,3,1
4958,3181.0,40,send,3,27,30,3,26,9,-24,27,Imperial College London,Chelsea and Westminster Hospital,org-org-org,---,PROPN-PROPN-PROPN,PROPN-CCONJ-PROPN-PROPN,compound-pobj-compound,appos-cc-compound-conj,NNP-NNP-NNP,NNP-CC-NNP-NNP,3,1
4959,3182.0,40,coached,1,3,8,5,2,31,-2,7,NCAA,University of Houston,per,--,PROPN,PROPN-ADP-PROPN,compound,pobj-prep-pobj,NNP,NNP-IN-NNP,4,1
4960,8101.0,20,is,5,8,17,9,7,2,-3,12,NCAA,University of Houston,org,--,PROPN,PROPN-ADP-PROPN,nmod,dobj-prep-pobj,NNP,NNP-IN-NNP,4,1
4961,9087.0,32,is,10,14,20,6,13,11,-4,10,NCAA,University of Houston,per,--,PROPN,PROPN-ADP-PROPN,compound,nmod-prep-pobj,NNP,NNP-IN-NNP,5,1
4962,12777.0,42,competes,6,17,29,12,16,12,-11,23,NCAA,University of Houston,per,--,PROPN,PROPN-ADP-PROPN,nmod,dobj-prep-pobj,NNP,NNP-IN-NNP,-1,1
4963,3183.0,12,was,6,1,5,4,0,6,5,-1,Maryland State Fire Marshal,William Barnard,per-per-per-per,-,PROPN-PROPN-PROPN-PROPN,PROPN-PROPN,compound-compound-compound-compound,compound-nsubj,NNP-NNP-NNP-NNP,NNP-NNP,2,1
4964,3184.0,75,spoke,41,3,59,56,2,15,38,18,Juan,Argentina,per,,PROPN,PROPN,nsubjpass,poss,NNP,NNP,-1,1
4965,3185.0,34,was,2,11,21,10,10,12,-9,19,Lin,Cultural Revolution,per,-,PROPN,PROPN-PROPN,nsubj,compound-pobj,NNP,NNP-NNP,7,1
4966,3186.0,47,has,35,2,14,12,1,32,33,-21,Rompetrol,; Romani,,org-org,PROPN,PUNCT-PROPN,compound,punct-npadvmod,NNP,:-NNP,4,1
4967,3187.0,39,disclosed,2,9,25,16,8,13,-7,23,Nigeria,Shehu Shagari,per,-,PROPN,PROPN-PROPN,poss,compound-compound,NNP,NNP-NNP,-1,1
4968,3188.0,28,founded,3,13,22,9,12,5,-10,19,Scotland,University,org,,PROPN,PROPN,pobj,poss,NNP,NNP,10,1
4969,3189.0,11,is,1,1,7,6,0,3,0,6,It,Tacoma,,per,PRON,PROPN,nsubj,compound,PRP,NNP,5,1
4970,3190.0,13,released,2,9,11,2,8,1,-7,9,his,Aggro Berlin,,org-org,DET,PROPN-PROPN,poss,compound-appos,PRP$,NNP-NNP,1,1
4971,3191.0,16,finished,1,1,14,13,0,1,0,13,He,West Adelaide,per,-,PRON,PROPN-PROPN,nsubj,compound-pobj,PRP,NNP-NNP,4,1
4972,3192.0,20,is,0,14,18,4,13,1,-14,18,Avex Group,Rhythm Zone,-,org-org,PROPN-PROPN,PROPN-PROPN,compound-poss,compound-pobj,NNP-NNP,NNP-NNP,4,1
4973,3193.0,30,signed,16,4,6,2,3,23,12,-10,American,Malcolm Bricklin,,org-org,ADJ,PROPN-PROPN,amod,compound-appos,JJ,NNP-NNP,1,1
4974,3194.0,26,brought,16,3,8,5,2,17,13,-8,Thompson,Health and Human Services,per,---,PROPN,PROPN-CCONJ-PROPN-PROPN,nsubjpass,nmod-cc-compound-conj,NNP,NNP-CC-NNP-NNP,5,1
4975,11946.0,41,entered,14,1,3,2,0,37,13,-11,Thompson,Health and Human Services,,org-org-org-org,PROPN,PROPN-CCONJ-PROPN-PROPN,nmod,nmod-cc-compound-conj,NNP,NNP-CC-NNP-NNP,3,1
4976,13126.0,23,said,12,14,19,5,13,3,-2,7,Thompson,Health and Human Services,,org-org-org-org,PROPN,PROPN-CCONJ-PROPN-PROPN,nsubj,pobj-cc-compound-conj,NNP,NNP-CC-NNP-NNPS,3,1
4977,13397.0,27,was,2,2,6,4,1,20,0,4,Thompson,Health and Human Services,per,---,PROPN,PROPN-CCONJ-PROPN-PROPN,nsubj,pobj-cc-compound-conj,NNP,NNP-CC-NNP-NNPS,4,1
4978,3195.0,15,assert,2,1,9,8,0,5,1,7,Swissair,Switzerland,org,,PROPN,PROPN,compound,pobj,NNP,NNP,7,1
4979,3196.0,39,founded,9,8,24,16,7,14,1,15,Spain,Pedro Romero,org,-,PROPN,PROPN-PROPN,pobj,nmod-nmod,NNP,NNP-NNP,5,1
4980,3197.0,26,is,15,1,5,4,0,20,14,-10,Noel-Baker Community School,Language College,--,per-per,PROPN-PROPN-PROPN,PROPN-PROPN,compound-compound-nsubj,compound-conj,NNP-NNP-NNP,NNP-NNP,2,1
4981,3198.0,19,received,1,9,17,8,8,1,-8,16,Harvard University,Jeffrey Sachs,-,per-per,PROPN-PROPN,PROPN-PROPN,compound-pobj,compound-attr,NNP-NNP,NNP-NNP,4,1
4982,3200.0,16,is,5,1,15,14,0,0,4,10,CordLife,Singapore,per,,PROPN,PROPN,nsubj,pobj,NNP,NNP,3,1
4983,3201.0,14,elected,5,4,9,5,3,4,1,4,Arthur,Quebec,org,,PROPN,PROPN,nsubjpass,compound,NNP,NNP,3,1
4984,3202.0,27,referred,11,3,6,3,2,20,8,-5,Monroe,Joe DiMaggio,org,-,PROPN,PROPN-PROPN,poss,compound-appos,NNP,NNP-NNP,5,1
4985,3203.0,61,include,3,35,9,-26,34,51,-32,6,Dan Marsh,Mr.,org-org,,PROPN-PROPN,PROPN,compound-conj,compound,NNP-NNP,NNP,10,1
4986,3204.0,19,moved,12,4,15,11,3,3,8,3,Triumph Motorcycles Ltd,Hinckley,per-per-per,,PROPN-PROPN-PROPN,PROPN,compound-compound-appos,compound,NNP-NNP-NNP,NNP,6,1
4987,3205.0,37,hoped,1,10,27,17,9,9,-9,26,United States,Welles,per-per,,PROPN-PROPN,PROPN,compound-compound,nsubj,NNP-NNP,NNP,6,1
4988,3206.0,16,represents,5,4,5,1,3,10,1,0,Aberdeen,Scotland,org,,PROPN,PROPN,pobj,nsubj,NNP,NNP,3,1
4989,3207.0,18,represented,6,3,9,6,2,8,3,3,Pittsburgh Panthers,University of Pittsburgh,-,org-org-org,PROPN-PROPN,PROPN-ADP-PROPN,compound-compound,dobj-prep-pobj,NNP-NNPS,NNP-IN-NNP,4,1
4990,3208.0,104,Fragonard,2,39,52,13,38,51,-37,50,Jacques-Louis David,Belgium,-,org,PROPN-PROPN,PROPN,compound-pobj,pobj,NNP-NNP,NNP,-1,1
4991,3209.0,31,made,1,10,25,15,9,5,-9,24,France,his,per,,PROPN,DET,pobj,poss,NNP,PRP$,3,1
4992,3210.0,23,B.C.,1,14,21,7,13,1,-13,20,Canibus,Universal,,org,PROPN,PROPN,pobj,compound,NNP,NNP,4,1
4993,3211.0,45,appointed,5,10,19,9,9,25,-5,14,David Ben-Gurion,Israel,per-per,,PROPN-PROPN,PROPN,compound-pobj,compound,NNP-NNP,NNP,8,1
4994,3212.0,36,produced,8,1,2,1,0,33,7,-6,Alfred Harvey,Harvey World Famous Comics,org-org,---,PROPN-PROPN,PROPN-PROPN-PROPN-PROPN,compound-poss,compound-compound-compound-appos,NNP-NNP,NNP-NNP-NNP-NNP,1,1
4995,3214.0,17,attended,1,4,8,4,3,8,-3,7,University of Ulster,Coleraine,per-per-per,,PROPN-ADP-PROPN,PROPN,dobj-prep-pobj,compound,NNP-IN-NNP,NNP,5,1
4996,4754.0,26,graduated,3,9,13,4,8,12,-6,10,University of Ulster,Coleraine,org-org-org,,PROPN-ADP-PROPN,PROPN,pobj-prep-pobj,pobj,NNP-IN-NNP,NNP,6,1
4997,11879.0,32,Burges,2,25,29,4,24,2,-23,27,University of Ulster,Coleraine,--,per,PROPN-ADP-PROPN,PROPN,pobj-prep-pobj,compound,NNP-IN-NNP,NNP,4,1
4998,3215.0,20,founded,2,1,14,13,0,5,1,12,Owens College,Victoria University of Manchester,org-org,---,PROPN-PROPN,PROPN-PROPN-ADP-PROPN,compound-nsubj,compound-attr-prep-pobj,NNP-NNP,NNP-NNP-IN-NNP,3,1
4999,3218.0,33,involved,2,9,32,23,8,0,-7,30,James Scullin,Australia,-,per,PROPN-PROPN,PROPN,compound-compound,pobj,NNP-NNP,NNP,7,1
5000,3220.0,65,was,3,20,31,11,19,33,-17,28,Gazprom Media,Gazprombank,org-org,,PROPN-PROPN,PROPN,compound-pobj,pobj,NNP-NNP,NNP,4,1
5001,3221.0,17,won,10,10,15,5,9,1,0,5,Rekha,Actress,per,,PROPN,PROPN,conj,compound,NNP,NNP,1,1
5002,3222.0,32,withdrew,3,3,10,7,2,21,0,7,Botswana,Bank of Botswana,per,--,PROPN,PROPN-ADP-PROPN,nsubj,conj-prep-pobj,NNP,NNP-IN-NNP,4,1
5003,3224.0,18,managed,4,7,16,9,6,1,-3,12,Dave Olbrich,Malibu Comics,org-org,-,PROPN-PROPN,PROPN-PROPN,nmod-pobj,compound-pobj,NNP-NNP,NNP-NNPS,4,1
5004,3225.0,41,retained,37,11,25,14,10,15,26,-12,Rover Group,Riley,-,per,PROPN-PROPN,PROPN,compound-pobj,compound,NNP-NNP,NNP,7,1
5005,12399.0,33,sold,4,7,14,7,6,18,-3,10,Rover Group,Riley,-,org,PROPN-PROPN,PROPN,compound-dobj,compound,NNP-NNP,NNP,4,1
5006,3226.0,14,opened,1,1,6,5,0,7,0,5,Liberty,2006,org,,PROPN,NUM,nsubj,nummod,NNP,CD,1,1
5007,3227.0,39,established,6,1,15,14,0,23,5,9,The Hongkong and Shanghai Banking Corporation,1865,-----,org,DET-PROPN-CCONJ-PROPN-PROPN-PROPN,NUM,det-nmod-cc-conj-compound-nsubj,nummod,DT-NNP-CC-NNP-NNP-NNP,CD,2,1
5008,3229.0,20,played,1,1,17,16,0,2,0,16,USF,Big East,,per-per,PROPN,PROPN-PROPN,nsubj,compound-compound,NNP,NNP-NNP,5,1
5009,5901.0,31,surprised,5,5,17,12,4,13,0,12,USF,Big East,,per-per,PROPN,PROPN-PROPN,nsubj,compound-compound,NNP,NNP-NNP,5,1
5010,9292.0,33,is,2,2,7,5,1,25,0,5,USF,Big East,per,-,PROPN,PROPN-PROPN,nsubj,compound-compound,NNP,NNP-NNP,5,1
5011,3231.0,19,refused,2,2,5,3,1,13,0,3,he,Mexico,per,,PRON,PROPN,nsubj,nsubj,PRP,NNP,2,1
5012,5465.0,42,started,3,3,11,8,2,30,0,8,he,Mexico,per,,PRON,PROPN,nsubj,pobj,PRP,NNP,4,1
5013,9410.0,25,porfirismo,16,3,13,10,2,11,13,-3,he,Mexico,org,,PRON,PROPN,nsubj,compound,PRP,NNP,7,1
5014,9459.0,8,Was,0,3,7,4,2,0,-3,7,he,Mexico,org,,PRON,PROPN,nsubj,pobj,PRP,NNP,3,1
5015,3232.0,14,was,2,1,11,10,0,2,1,9,National Airlines,1934,-,org,PROPN-PROPN,NUM,compound-nsubj,pobj,NNP-NNPS,CD,5,1
5016,3233.0,44,School,3,1,1,0,0,42,2,-2,New Dorp High School,New York,org-org-org-org,-,PROPN-PROPN-PROPN-PROPN,PROPN-PROPN,compound-compound-compound-ROOT,compound-compound,NNP-NNP-NNP-NNP,NNP-NNP,0,1
5017,3235.0,10,establishes,4,3,4,1,2,5,1,0,France,Telecom,,org,PROPN,PROPN,compound,nsubj,NNP,NNP,1,1
5018,3236.0,22,is,8,1,21,20,0,0,7,13,Devon Nicholson,Hannibal,-,per,PROPN-PROPN,PROPN,compound-nsubj,appos,NNP-NNP,NNP,2,1
5019,3237.0,45,is,6,3,4,1,2,40,3,-2,2007,University Campus Suffolk,,org-org-org,NUM,PROPN-PROPN-PROPN,pobj,compound-compound-nsubj,CD,NNP-NNP-NNP,2,1
5020,3238.0,41,is,2,1,16,15,0,24,1,14,Skye Sweetnam,Canada,per-per,,PROPN-PROPN,PROPN,compound-nsubj,pobj,NNP-NNP,NNP,2,1
5021,3239.0,32,is,9,1,12,11,0,19,8,3,Ratnasiri Wickremanayake,Sri Lanka,-,per-per,PROPN-PROPN,PROPN-PROPN,compound-nsubj,pobj-attr,NNP-NNP,NNP-NNP,3,1
5022,3241.0,42,co-written,21,9,17,8,8,24,12,-4,The Band,Richard Manuel,per-per,-,DET-PROPN,PROPN-PROPN,det-pobj,compound-dobj,DT-NNP,NNP-NNP,5,1
5023,3242.0,18,built,8,4,13,9,3,4,4,5,New Hampshire,Pierce,-,org,PROPN-PROPN,PROPN,compound-pobj,poss,NNP-NNP,NNP,7,1
5024,3243.0,24,approached,9,15,19,4,14,4,-6,10,Maurice Wilkes,University of Cambridge Mathematical Laboratory,per-per,----,PROPN-PROPN,PROPN-ADP-PROPN-PROPN-PROPN,compound-nsubj,pobj-prep-compound-compound-pobj,NNP-NNP,NNP-IN-NNP-NNP-NNP,3,1
5025,3244.0,38,forced,5,7,29,22,6,8,-2,24,TriMet,MAX Light Rail,,org-org-org,PROPN,PROPN-PROPN-PROPN,dobj,compound-compound-compound,NNP,NNP-NNP-NNP,8,1
5026,3245.0,28,doing,5,16,22,6,15,5,-11,17,Bukit Persekutuan,Malaysian Nature Society,org-org,--,PROPN-PROPN,PROPN-PROPN-PROPN,compound-conj,compound-compound-compound,NNP-NNP,NNP-NNP-NNP,11,1
5027,3246.0,33,rankled,3,9,11,2,8,21,-6,8,Blackstone Group,Stephen A. Schwarzman,org-org,--,PROPN-PROPN,PROPN-PROPN-PROPN,compound-compound,compound-compound-pobj,NNP-NNP,NNP-NNP-NNP,2,1
5028,9380.0,18,became,4,11,15,4,10,2,-7,11,Blackstone Group,Stephen A. Schwarzman,per-per,--,PROPN-PROPN,PROPN-PROPN-PROPN,compound-poss,compound-compound-appos,NNP-NNP,NNP-NNP-NNP,3,1
5029,3247.0,26,began,8,4,22,18,3,3,4,14,Nirvana,Channing,org,,PROPN,NOUN,poss,nsubj,NNP,NN,11,1
5030,3249.0,19,included,7,9,11,2,8,7,-2,4,Ohio,Rob Portman,,org-org,PROPN,PROPN-PROPN,compound,compound-dobj,NNP,NNP-NNP,1,1
5031,4897.0,33,told,12,4,11,7,3,21,8,-1,Ohio,Rob Portman,org,-,PROPN,PROPN-PROPN,compound,compound-conj,NNP,NNP-NNP,1,1
5032,3250.0,37,established,2,11,6,-5,10,30,-9,4,Wales,Nursing,,per,PROPN,PROPN,conj,pobj,NNP,NNP,1,1
5033,3252.0,23,was,2,6,12,6,5,10,-4,10,Harding University,Searcy,org-org,,PROPN-PROPN,PROPN,pcomp-dobj,compound,NNP-NNP,NNP,3,1
5034,3253.0,69,was,4,15,43,28,14,25,-11,39,Japan,Naomichi Marufuji,org,-,PROPN,PROPN-PROPN,ROOT,compound-compound,NNP,NNP-NNP,10,1
5035,3254.0,20,Title,0,7,12,5,6,7,-7,12,Iowa State University,Ames,--,org,PROPN-PROPN-PROPN,PROPN,compound-compound-compound,compound,NNP-NNP-NNP,NNP,6,1
5036,5079.0,29,Title,0,10,21,11,9,7,-10,21,Iowa State University,Ames,org-org-org,,PROPN-PROPN-PROPN,PROPN,compound-compound-nmod,compound,NNP-NNP-NNP,NNP,6,1
5037,6789.0,61,Paley,1,56,59,3,55,1,-55,58,Iowa State University,Ames,per-per-per,,PROPN-PROPN-PROPN,PROPN,compound-compound-compound,compound,NNP-NNP-NNP,NNP,2,1
5038,7221.0,39,tel,4,22,25,3,21,13,-18,21,Iowa State University,Ames,per-per-per,,PROPN-PROPN-PROPN,PROPN,compound-compound-compound,ROOT,NNP-NNP-NNP,NNP,3,1
5039,3256.0,18,is,2,1,8,7,0,9,1,6,Swiss Chalet,Cara Operations,per-per,-,PROPN-PROPN,PROPN-PROPN,compound-nsubj,compound-pobj,NNP-NNP,NNP-NNP,5,1
5040,3257.0,26,is,9,2,8,6,1,17,7,-1,22nd Marine Expeditionary Unit,MEU,---,org,ADJ-PROPN-PROPN-PROPN,PROPN,amod-compound-compound-nsubj,appos,JJ-NNP-NNP-NNP,NNP,2,1
5041,5591.0,45,taskforce,10,16,22,6,15,22,-6,12,22nd Marine Expeditionary Unit,MEU,per-per-per-per,,ADJ-PROPN-PROPN-PROPN,PROPN,amod-compound-compound-pobj,conj,JJ-NNP-NNP-NNP,NNP,6,1
5042,3258.0,36,appointed,4,25,32,7,24,3,-21,28,Moon Landrieu,Housing and Urban Development,per-per,---,PROPN-PROPN,PROPN-CCONJ-PROPN-PROPN,compound-pobj,pobj-cc-compound-conj,NNP-NNP,NNP-CC-NNP-NNP,6,1
5043,3259.0,24,treating,4,10,11,1,9,12,-6,7,Georgian,Koba Gogoladze,per,-,PROPN,PROPN-PROPN,compound,compound-pobj,NNP,NNP-NNP,3,1
5044,3260.0,32,included,9,24,24,0,23,7,-15,15,Monterey Institute of International Studies,Monterey,per-per-per-per-per,,PROPN-PROPN-ADP-PROPN-PROPN,PROPN,compound-pobj-prep-compound-pobj,compound,NNP-NNP-IN-NNP-NNPS,NNP,0,1
5045,3261.0,34,appointed,4,15,9,-6,14,24,-11,5,TAA,Australian Airlines,,per-per,PROPN,PROPN-PROPN,dobj,compound-conj,NNP,NNP-NNPS,4,1
5046,10327.0,34,renamed,5,4,7,3,3,26,1,2,TAA,Australian Airlines,org,-,PROPN,PROPN-PROPN,conj,compound-dobj,NNP,NNP-NNPS,2,1
5047,3262.0,13,started,1,10,12,2,9,0,-9,11,Dharmasoka College,Ambalangoda,-,per,PROPN-PROPN,PROPN,compound-compound,pobj,NNP-NNP,NNP,6,1
5048,3263.0,23,began,9,5,8,3,4,14,4,-1,Melbourne,Lochie Daddo,per,-,PROPN,PROPN-PROPN,pobj,compound-nsubj,NNP,NNP-NNP,4,1
5049,3264.0,32,began,1,5,14,9,4,17,-4,13,Grambling State,Louisiana Negro Normal,org-org,--,PROPN-PROPN,PROPN-PROPN-PROPN,compound-pobj,compound-nmod-nmod,NNP-NNP,NNP-NNP-NNP,5,1
5050,3265.0,30,receive,2,16,22,6,15,7,-14,20,Robert Wood Johnson University Hospital,New Brunswick,----,org-org,PROPN-PROPN-PROPN-PROPN-PROPN,PROPN-PROPN,compound-compound-compound-compound-appos,compound-pobj,NNP-NNP-NNP-NNP-NNP,NNP-NNP,4,1
5051,8526.0,73,known,45,12,32,20,11,40,33,-13,Robert Wood Johnson University Hospital,New Brunswick,org-org-org-org-org,-,PROPN-PROPN-PROPN-PROPN-PROPN,PROPN-PROPN,compound-compound-compound-compound-nmod,compound-nsubjpass,NNP-NNP-NNP-NNP-NNP,NNP-NNP,7,1
5052,3266.0,28,is,1,8,23,15,7,4,-7,22,Josefa Iloilo,Fiji,org-org,,PROPN-PROPN,PROPN,compound-pobj,poss,NNP-NNP,NNP,11,1
5053,6301.0,46,announced,9,8,23,15,7,22,1,14,Josefa Iloilo,Fiji,-,per,PROPN-PROPN,PROPN,compound-nsubj,pobj,NNP-NNP,NNP,2,1
5054,3267.0,22,was,3,5,8,3,4,13,-2,5,James Jackson,Georgia,-,per,PROPN-PROPN,PROPN,compound-nsubj,pobj,NNP-NNP,NNP,2,1
5055,3268.0,25,based,5,8,16,8,7,8,-3,11,South Australia,Adelaide College of Divinity,per-per,---,PROPN-PROPN,PROPN-PROPN-ADP-PROPN,compound-compound,compound-pobj-prep-pobj,NNP-NNP,NNP-NNP-IN-NNP,5,1
5056,3269.0,5,Mexico,3,2,4,2,1,0,1,1,ERNESTO ZEDILLO,Mexico,-,per,PROPN-PROPN,PROPN,compound-compound,ROOT,NNP-NNP,NNP,2,1
5057,3270.0,33,passed,2,11,12,1,10,20,-9,10,Staff,Alexander Haig,,org-org,PROPN,PROPN-PROPN,pobj,compound-pobj,NNP,NNP-NNP,1,1
5058,5274.0,17,proposed,10,8,9,1,7,7,2,-1,Staff,Alexander Haig,per,-,PROPN,PROPN-PROPN,pobj,compound-nsubj,NNP,NNP-NNP,1,1
5059,5560.0,30,Following,0,11,12,1,10,17,-11,12,Staff,Alexander Haig,,per-per,PROPN,PROPN-PROPN,pobj,compound-nsubj,NNP,NNP-NNP,4,1
5060,12203.0,31,was,1,18,19,1,17,11,-17,18,Staff,Alexander Haig,org,-,PROPN,PROPN-PROPN,pobj,compound-pobj,NNP,NNP-NNP,4,1
5061,3271.0,50,is,11,27,44,17,26,5,-16,33,ime minis,in the favor,-,per-per-per,DET-X,ADP-DET-NOUN,conj-compound,prep-det-pobj,DT-FW,IN-DT-NN,8,1
5062,3272.0,23,was,10,1,14,13,0,8,9,4,Joseph Sweeney,actor,org-org,,PROPN-PROPN,NOUN,compound-nsubj,attr,NNP-NNP,NN,4,1
5063,3273.0,36,received,9,5,9,4,4,26,4,0,Division I,VCU,-,per,PROPN-NUM,PROPN,nmod-compound,nsubj,NNP-CD,NNP,1,1
5064,3274.0,32,renamed,1,4,22,18,3,9,-3,21,Aqua,Universal Music,org,-,PROPN,PROPN-PROPN,oprd,compound-compound,NNP,NNP-NNP,4,1
5065,3276.0,24,led,5,1,8,7,0,15,4,3,Her,Pakistan,,org,DET,PROPN,poss,compound,PRP$,NNP,3,1
5066,3278.0,19,said,10,1,9,8,0,9,9,-1,Victor Fung,Li Fung,per-per,-,PROPN-PROPN,PROPN-PROPN,compound-compound,compound-pobj,NNP-NNP,NNP-NNP,4,1
5067,3279.0,14,served,5,4,10,6,3,3,1,5,Paulus,State,,per,PROPN,PROPN,nsubj,compound,NNP,NNP,4,1
5068,3280.0,16,was,2,8,14,6,7,1,-6,12,France,Manu Chao,org,-,PROPN,PROPN-PROPN,pobj,compound-pobj,NNP,NNP-NNP,4,1
5069,3282.0,29,mobbed,12,8,17,9,7,11,4,5,Fugees,he,org,,PROPN,PRON,pobj,nsubj,NNPS,PRP,4,1
5070,3283.0,89,******,0,14,54,40,13,34,-14,54,Manager,Graphic Designer,,per-per,PROPN,PROPN-PROPN,compound,compound-appos,NNP,NNP-NNP,6,1
5071,3284.0,53,be,36,8,8,0,7,44,28,-28,Iraq national football team,Iraq Football Association,org-org-org-org,--,PROPN-ADJ-NOUN-NOUN,PROPN-PROPN-PROPN,nmod-amod-compound-compound,compound-compound-pobj,NNP-JJ-NN-NN,NNP-NNP-NNP,0,1
5072,3287.0,41,spent,12,11,22,11,10,18,1,10,club,Cypriot Second Division,per,--,NOUN,PROPN-PROPN-PROPN,nsubj,compound-compound-compound,NN,NNP-NNP-NNP,5,1
5073,3290.0,25,announced,4,1,1,0,0,23,3,-3,Air New Zealand,Air Nelson,--,per-per,PROPN-PROPN-PROPN,PROPN-PROPN,compound-compound-nsubj,compound-compound,NNP-NNP-NNP,NNP-NNP,0,1
5074,4150.0,29,purchased,4,1,1,0,0,27,3,-3,Air New Zealand,Air Nelson,org-org-org,-,PROPN-PROPN-PROPN,PROPN-PROPN,compound-compound-nsubj,compound-pobj,NNP-NNP-NNP,NNP-NNP,0,1
5075,3291.0,15,was,2,1,12,11,0,2,1,10,Operation Ivy,California,-,per,PROPN-PROPN,PROPN,compound-nsubj,pobj,NNP-NNP,NNP,4,1
5076,3293.0,44,opened,6,21,24,3,20,19,-15,18,New Haven,Yale University,org-org,-,PROPN-PROPN,PROPN-PROPN,compound-pobj,compound-pobj,NNP-NNP,NNP-NNP,2,1
5077,3294.0,56,pressured,34,1,40,39,0,15,33,6,Jagan,Guyana,per,,PROPN,PROPN,nsubj,poss,NNP,NNP,4,1
5078,5507.0,24,was,10,10,19,9,9,4,0,9,Jagan,Guyana,,per,PROPN,PROPN,appos,poss,NNP,NNP,5,1
5079,13266.0,21,has,1,1,20,19,0,0,0,19,Jagan,Guyana,,per,PROPN,PROPN,nsubj,pobj,NNP,NNP,1,1
5080,3295.0,34,chosen,9,13,16,3,12,17,-4,7,Oregon House,Jeff Merkley,-,org-org,PROPN-PROPN,PROPN-PROPN,compound-compound,compound-dobj,NNP-NNP,NNP-NNP,2,1
5081,7753.0,20,running,3,12,15,3,11,4,-9,12,Oregon House,Jeff Merkley,-,org-org,PROPN-PROPN,PROPN-PROPN,compound-conj,compound-appos,NNP-NNP,NNP-NNP,5,1
5082,13325.0,33,ran,3,28,31,3,27,1,-25,28,Oregon House,Jeff Merkley,-,per-per,PROPN-PROPN,PROPN-PROPN,compound-compound,compound-pobj,NNP-NNP,NNP-NNP,4,1
5083,3296.0,18,formed,3,2,16,14,1,1,1,13,1980,Carlos Cavazo,per,-,NUM,PROPN-PROPN,pobj,compound-conj,CD,NNP-NNP,5,1
5084,3297.0,55,included,2,34,40,6,33,14,-32,38,The Four Tops,Levi Stubbs,--,per-per,DET-PROPN-NOUN,PROPN-PROPN,det-compound-poss,compound-pobj,DT-NNP-NNS,NNP-NNP,2,1
5085,3298.0,24,Jinping,12,2,6,4,1,17,10,-6,Chinese,Wu Bangguo,,org-org,ADJ,PROPN-PROPN,amod,compound-compound,JJ,NNP-NNP,2,1
5086,3299.0,22,known,3,16,21,5,15,0,-13,18,M. G. Ramachandran,actor,per-per-per,,PROPN-PROPN-PROPN,NOUN,compound-compound-pobj,pobj,NNP-NNP-NNP,NN,6,1
5087,3300.0,24,says,3,2,5,3,1,18,1,2,Vladimir Putin,Russia,-,per,PROPN-PROPN,PROPN,compound-nsubj,nsubj,NNP-NNP,NNP,3,1
5088,6026.0,17,says,3,2,6,4,1,10,1,3,Vladimir Putin,Russia,-,per,PROPN-PROPN,PROPN,compound-nsubj,nsubj,NNP-NNP,NNP,4,1
5089,3301.0,49,is,1,32,18,-14,31,30,-31,17,Kevin Flynn,The New York Times Company,org-org,----,PROPN-PROPN,DET-PROPN-PROPN-PROPN-PROPN,compound-pobj,det-compound-compound-compound-pobj,NNP-NNP,DT-NNP-NNP-NNP-NNP,2,1
5090,3302.0,31,is,4,2,29,27,1,1,2,25,Quicksilver,California,,per,PROPN,PROPN,compound,compound,NNP,NNP,10,1
5091,12238.0,40,evolved,3,35,39,4,34,0,-32,36,Quicksilver,California,,per,PROPN,PROPN,compound,pobj,NNP,NNP,4,1
5092,3303.0,32,helped,11,2,11,9,1,20,9,0,India,Desai,per,,PROPN,PROPN,poss,pobj,NNP,NNP,5,1
5093,3304.0,38,conflict,2,21,28,7,20,9,-19,26,nese warlord Zh,Repub,--,org,NOUN-NOUN-PROPN,PROPN,amod-conj-nsubj,compound,NN-NN-NNP,NNPS,-1,1
5094,3305.0,49,is,6,1,16,15,0,32,5,10,Galatasaray University,n 199,per-per,-,PROPN-PROPN,CCONJ-NUM,compound-nsubj,quantmod-compound,NNP-NNP,CC-CD,-1,1
5095,3308.0,25,is,1,1,7,6,0,17,0,6,Epiphone,Gibson Guitar Corporation,,per-per-per,PROPN,PROPN-PROPN-PROPN,nsubj,compound-compound-pobj,NNP,NNP-NNP-NNP,4,1
5096,3309.0,34,said,18,10,28,18,9,5,8,10,Finland,Finnair,,per,PROPN,PROPN,pobj,pobj,NNP,NNP,6,1
5097,3310.0,45,originated,3,6,16,10,5,28,-3,13,Coventry,Terry Hall,org,-,PROPN,PROPN-PROPN,pobj,compound-ROOT,NNP,NNP-NNP,4,1
5098,3311.0,27,appointed,2,7,15,8,6,11,-5,13,United States,Zachary Taylor,per-per,-,PROPN-PROPN,PROPN-PROPN,compound-compound,compound-pobj,NNP-NNP,NNP-NNP,5,1
5099,3313.0,21,located,13,6,20,14,5,0,7,7,Universidad de Sonora,Mexico,--,org,PROPN-ADP-PROPN,PROPN,compound-compound-appos,pobj,NNP-IN-NNP,NNP,3,1
5100,3314.0,14,began,3,9,13,4,8,0,-6,10,Columbian,1890,per,,PROPN,NUM,pobj,nummod,NNP,CD,2,1
5101,3315.0,63,released,5,54,58,4,53,4,-49,53,Yigal Carmon,Middle East Media Research Institute,-,per-per-per-per-per,PROPN-PROPN,PROPN-PROPN-PROPN-PROPN-PROPN,compound-pobj,compound-compound-compound-compound-pobj,NNP-NNP,NNP-NNP-NNP-NNP-NNP,3,1
5102,3316.0,21,was,1,4,18,14,3,2,-3,17,Fort Worth,Texas Christian University,-,per-per-per,PROPN-PROPN,PROPN-PROPN-PROPN,compound-pobj,compound-compound-pobj,NNP-NNP,NNP-NNP-NNP,9,1
5103,3317.0,47,Arizona-based,1,1,3,2,0,43,0,2,Tempe,US Airways,,per-per,PROPN,PROPN-PROPN,nsubj,compound-compound,NNP,NNP-NNP,1,1
5104,4575.0,18,is,1,1,6,5,0,11,0,5,Tempe,US Airways,org,-,NOUN,PROPN-PROPN,nsubj,nmod-nmod,NN,NNP-NNP,5,1
5105,7287.0,35,told,17,12,14,2,11,20,5,-3,Tempe,US Airways,,org-org,PROPN,PROPN-PROPN,pobj,compound-compound,NNP,NNP-NNP,1,1
5106,3318.0,107,Government,3,36,52,16,35,54,-33,49,Australia,Harold Holt,,per-per,PROPN,PROPN-PROPN,compound,compound-pobj,NNP,NNP-NNP,9,1
5107,3322.0,25,is,4,1,1,0,0,23,3,-3,Kuwait Airways,Kuwait,per-per,,PROPN-PROPN,PROPN,compound-nsubj,compound,NNP-NNP,NNP,0,1
5108,3323.0,31,is,15,24,30,6,23,0,-9,15,Ecuador,Lucio,,per,PROPN,PROPN,pobj,pobj,NNP,NNP,3,1
5109,3324.0,35,disclosed,15,7,13,6,6,21,8,-2,St. Jude Medical,Minnesota,per-per-per,,PROPN-PROPN-PROPN,PROPN,compound-compound-compound,pobj,NNP-NNP-NNP,NNP,4,1
5110,3325.0,23,founded,3,6,8,2,5,14,-3,5,1982,El Diario Austral de Valdivia,org,----,NUM,PROPN-PROPN-PROPN-ADP-PROPN,pobj,compound-compound-compound-compound-pobj,CD,NNP-NNP-NNP-IN-NNP,2,1
5111,3326.0,30,owned,20,7,14,7,6,15,13,-6,Washington,Skagit Valley College,,per-per-per,PROPN,PROPN-PROPN-PROPN,compound,compound-compound-pobj,NNP,NNP-NNP-NNP,7,1
5112,3327.0,56,returned,2,34,55,21,33,0,-32,53,Louise,France,,per,PROPN,PROPN,nsubj,pobj,NNP,NNP,2,1
5113,3328.0,26,resigned,3,6,21,15,5,4,-3,18,Brisbane Grammar School,Queensland,--,org,PROPN-PROPN-PROPN,PROPN,compound-compound-pobj,compound,NNP-NNP-NNP,NNP,7,1
5114,3330.0,14,is,6,5,13,8,4,0,1,7,Omaha-area,USHL,,per,NOUN,PROPN,compound,pobj,NN,NNP,9,1
5115,9082.0,21,include,6,4,12,8,3,8,2,6,Omaha-area,USHL,,per,NOUN,PROPN,compound,compound,NN,NNP,6,1
5116,3331.0,18,was,12,6,16,10,5,1,6,4,Nast Publications,Vogue,-,per,PROPN-PROPN,PROPN,compound-pobj,compound,NNP-NNPS,NNP,7,1
5117,3332.0,19,appointed,12,14,18,4,13,0,-2,6,Alexander Ankvab,Minister,-,per,PROPN-PROPN,PROPN,compound-dobj,pobj,NNP-NNP,NNP,2,1
5118,3333.0,22,became,11,2,10,8,1,11,9,-1,Laos,Sisavang Vong,org,-,PROPN,PROPN-PROPN,nsubj,compound-pobj,NNP,NNP-NNP,3,1
5119,4569.0,44,marry,5,4,14,10,3,29,1,9,Laos,Sisavang Vong,,org-org,PROPN,PROPN-PROPN,pobj,compound-nsubj,NNP,NNP-NNP,4,1
5120,12436.0,18,remained,6,4,5,1,3,12,2,-1,Laos,Sisavang Vong,,org-org,PROPN,PROPN-PROPN,pobj,compound-appos,NNP,NNP-NNP,1,1
5121,3334.0,21,drawn,4,16,18,2,15,2,-12,14,National Intelligence,John Michael McConnell,org-org,--,PROPN-PROPN,PROPN-PROPN-PROPN,compound-compound,compound-compound-pobj,NNP-NNP,NNP-NNP-NNP,4,1
5122,5331.0,26,received,4,14,16,2,13,9,-10,12,National Intelligence,John Michael McConnell,org-org,--,PROPN-PROPN,PROPN-PROPN-PROPN,compound-compound,compound-compound-pobj,NNP-NNP,NNP-NNP-NNP,4,1
5123,5788.0,29,follows,3,20,22,2,19,6,-17,19,National Intelligence,John Michael McConnell,org-org,--,PROPN-PROPN,PROPN-PROPN-PROPN,compound-compound,compound-compound-pobj,NNP-NNP,NNP-NNP-NNP,4,1
5124,3335.0,38,warns,13,9,13,4,8,24,4,0,University of Kiel,Germany,--,org,PROPN-ADP-PROPN,PROPN,pobj-prep-pobj,pobj,NNP-IN-NNP,NNP,7,1
5125,3336.0,20,was,6,5,1,-4,4,18,1,-5,AIC,Arizona,,org,PROPN,PROPN,appos,pobj,NNP,NNP,3,1
5126,3337.0,30,played,1,10,20,10,9,9,-9,19,Ligue Nationale de Basketball,France,---,org,PROPN-PROPN-PROPN-PROPN,PROPN,pobj-compound-appos-pobj,pobj,NNP-NNP-NNP-NNP,NNP,7,1
5127,3338.0,32,represented,17,3,3,0,2,28,14,-14,Houston Cougars,Houston,-,per,PROPN-PROPN,PROPN,compound-compound,pobj,NNP-NNP,NNP,0,1
5128,3340.0,62,was,9,51,55,4,50,6,-42,46,Royal Hospital School,Suffolk,per-per-per,,PROPN-PROPN-PROPN,PROPN,compound-compound-pobj,pobj,NNP-NNP-NNP,NNP,4,1
5129,3342.0,25,following,1,10,14,4,9,10,-9,13,Bosnia and Herzegovina,?eljko,org-org-org,,PROPN-CCONJ-PROPN,PUNCT,nmod-cc-conj,punct,NNP-CC-NNP,.,-1,1
5130,3343.0,15,Image,1,4,11,7,3,3,-3,10,University of Connecticut School of Law,Hartford,-----,per,PROPN-ADP-PROPN-PROPN-ADP-PROPN,PROPN,nmod-prep-pobj-appos-prep-pobj,compound,NNP-IN-NNP-NNP-IN-NNP,NNP,5,1
5131,3344.0,16,appointed,4,3,12,9,2,3,1,8,Cracknell,Australia,org,,PROPN,PROPN,nsubjpass,nmod,NNP,NNP,8,1
5132,3345.0,18,competed,8,11,15,4,10,2,-3,7,New Zealand,Tri Nations,-,org-org,PROPN-PROPN,PROPN-PROPN,compound-pobj,compound-compound,NNP-NNP,NNP-NNP,5,1
5133,3346.0,40,was,1,11,36,25,10,3,-10,35,Australian Quarantine and Inspection Service,Australia,----,org,PROPN-PROPN-CCONJ-PROPN-PROPN,PROPN,compound-pobj-cc-compound-conj,pobj,NNP-NNP-CC-NNP-NNP,NNP,15,1
5134,5633.0,28,joined,2,6,13,7,5,14,-4,11,Australian Quarantine and Inspection Service,Australia,----,org,PROPN-PROPN-CCONJ-PROPN-PROPN,PROPN,compound-pobj-cc-compound-conj,poss,NNP-NNP-CC-NNP-NNP,NNP,7,1
5135,13368.0,24,is,6,2,23,21,1,0,4,17,Australian Quarantine and Inspection Service,Australia,per-per-per-per-per,,PROPN-PROPN-CCONJ-PROPN-PROPN,PROPN,compound-nsubj-cc-compound-conj,dobj,NNP-NNP-CC-NNP-NNP,NNP,3,1
5136,3347.0,27,sold,3,5,7,2,4,19,-2,4,Lamborghini,Megatech,per,,PROPN,PROPN,dobj,nsubj,NNP,NNP,4,1
5137,3348.0,45,speaking,10,7,27,20,6,17,3,17,Kentucky,McConnell,org,,PROPN,PROPN,pobj,nsubj,NNP,NNP,-1,1
5138,3349.0,42,was,16,5,7,2,4,34,11,-9,Labor,Frances Perkins,,per-per,PROPN,PROPN-PROPN,pobj,compound-nsubj,NNP,NNP-NNP,2,1
5139,6371.0,34,distributed,1,22,24,2,21,9,-21,23,Labor,Frances Perkins,org,-,PROPN,PROPN-PROPN,compound,compound-pobj,NNP,NNP-NNP,3,1
5140,8217.0,72,In,0,18,19,1,17,52,-18,19,Labor,Frances Perkins,org,-,PROPN,PROPN-PROPN,pobj,pobj-compound,NNP,NNP-NNP,1,1
5141,9491.0,38,became,2,14,36,22,13,1,-12,34,Labor,Frances Perkins,per,-,PROPN,PROPN-PROPN,pobj,compound-pobj,NNP,NNP-NNP,12,1
5142,12450.0,52,was,21,40,41,1,39,10,-19,20,Labor,Frances Perkins,per,-,PROPN,PROPN-PROPN,pobj,compound-conj,NNP,NNP-NNP,1,1
5143,3350.0,20,was,4,3,15,12,2,4,1,11,his,Syria,,org,DET,PROPN,poss,poss,PRP$,NNP,7,1
5144,3351.0,43,contested,9,27,39,12,26,3,-18,30,Edmund Barton,High Court,org-org,-,PROPN-PROPN,PROPN-PROPN,compound-poss,compound-pobj,NNP-NNP,NNP-NNP,5,1
5145,3352.0,33,chose,11,11,17,6,10,15,0,6,Gilman,Iowa State University,per,--,PROPN,PROPN-PROPN-PROPN,nsubj,compound-compound-pobj,NNP,NNP-NNP-NNP,4,1
5146,3353.0,52,named,4,11,42,31,10,9,-7,38,Renault,Dacia,,per,PROPN,PROPN,pobj,pobj,NNP,NNP,12,1
5147,13893.0,28,started,12,1,7,6,0,20,11,-5,Renault,Dacia,,org,PROPN,PROPN,nsubj,nmod,NNP,NNP,4,1
5148,3354.0,46,said,3,1,25,24,0,20,2,22,Dubai World,Istithmar,-,per,PROPN-PROPN,PROPN,compound-nsubj,compound,NNP-NNP,NNP,7,1
5149,3355.0,14,laid,2,1,12,11,0,1,1,10,Swanson,Navy,org,,PROPN,PROPN,nsubjpass,compound,NNP,NNP,3,1
5150,3356.0,37,reported,7,7,24,17,6,12,0,17,Nirvana,Island,org,,PROPN,PROPN,pobj,pobj,NNP,NNP,2,1
5151,3357.0,23,moved,4,2,7,5,1,15,2,3,Eighth Air Force,Barksdale Air Force Base,org-org-org,---,PROPN-PROPN-PROPN,PROPN-PROPN-PROPN-PROPN,compound-compound-nsubj,compound-compound-compound-compound,NNP-NNP-NNP,NNP-NNP-NNP-NNP,6,1
5152,3358.0,50,are,3,6,14,8,5,35,-3,11,Sly Stone,producer,org-org,,PROPN-PROPN,NOUN,nmod-npadvmod,nsubjpass,NNP-NNP,NN,4,1
5153,3359.0,20,launched,9,2,2,0,1,17,7,-7,Jordan Telecom,Jordan,-,per,PROPN-PROPN,PROPN,compound-compound,pobj,NNP-NNP,NNP,0,1
5154,3360.0,49,made,1,24,29,5,23,19,-23,28,singer,Rob Halford,org,-,NOUN,PROPN-PROPN,nsubj,compound-pobj,NN,NNP-NNP,3,1
5155,12178.0,31,asked,15,18,27,9,17,3,-3,12,singer,Rob Halford,per,-,NOUN,PROPN-PROPN,dobj,compound-compound,NN,NNP-NNP,6,1
5156,3361.0,30,is,0,15,23,8,14,6,-15,23,Elena Paparizou,Greece,-,per,PROPN-PROPN,PROPN,compound-pobj,pobj,NNP-NNP,NNP,5,1
5157,3362.0,14,serves,2,6,11,5,5,2,-4,9,Hollywood,Screen Actors Guild,,per-per-per,PROPN,PROPN-PROPN-PROPN,compound,compound-compound-pobj,NNP,NNP-NNPS-NNP,5,1
5158,3363.0,23,started,4,8,14,6,7,8,-4,10,Jimmy Jam and Terry Lewis,Flyte Tyme,org-org-org-org-org,-,PROPN-PROPN-CCONJ-PROPN-PROPN,PROPN-PROPN,compound-pobj-cc-compound-conj,compound-compound,NNP-NNP-CC-NNP-NNP,NNP-NNP,5,1
5159,3364.0,17,attended,1,4,7,3,3,9,-3,6,Browning School,New York,per-per,-,PROPN-PROPN,PROPN-PROPN,compound-dobj,compound-compound,NNP-NNP,NNP-NNP,4,1
5160,10206.0,22,received,1,8,11,3,7,10,-7,10,Browning School,New York,org-org,-,PROPN-PROPN,PROPN-PROPN,compound-pobj,compound-compound,NNP-NNP,NNP-NNP,3,1
5161,3365.0,22,was,10,1,21,20,0,0,9,11,Tristram Dalton,Massachusetts,-,org,PROPN-PROPN,PROPN,compound-nsubj,pobj,NNP-NNP,NNP,2,1
5162,3367.0,38,invoked,7,21,35,14,20,2,-14,28,Chiang,Taiwan,org,,PROPN,PROPN,poss,pobj,NNP,NNP,7,1
5163,3368.0,17,known,6,3,14,11,2,2,3,8,Clan of Xymox,Netherlands,--,per,PROPN-ADP-PROPN,PROPN,nsubj-prep-pobj,pobj,NNP-IN-NNP,NNP,6,1
5164,10224.0,37,Attrition,0,11,15,4,10,21,-11,15,Clan of Xymox,Netherlands,per-per-per,,PROPN-ADP-PROPN,PROPN,ROOT-prep-nmod,nmod,NNP-IN-NNP,NNP,3,1
5165,3369.0,45,are,41,16,29,13,15,15,25,-12,her,South Dakota,,per-per,DET,PROPN-PROPN,poss,compound-compound,PRP$,NNP-NNP,10,1
5166,3370.0,28,is,12,9,10,1,8,17,3,-2,Mazda,North American Operations,per,--,PROPN,PROPN-PROPN-PROPN,compound,compound-compound-pobj,NNP,NNP-NNP-NNP,3,1
5167,3371.0,64,announced,24,10,13,3,9,50,14,-11,Corus Entertainment,Nelvana,per-per,,PROPN-PROPN,PROPN,compound-poss,compound,NNP-NNP,NNP,1,1
5168,3372.0,23,collaborated,6,9,16,7,8,6,-3,10,Roger Hodgson,Supertramp,per-per,,PROPN-PROPN,PROPN,nmod-nmod,pobj,NNP-NNP,NNP,2,1
5169,13546.0,37,blended,11,19,22,3,18,14,-8,11,Roger Hodgson,Supertramp,org-org,,PROPN-PROPN,PROPN,nmod-nmod,nmod,NNP-NNP,NNP,2,1
5170,3373.0,30,enunciated,15,1,2,1,0,27,14,-13,Charles Dow,Dow Jones Company,org-org,--,PROPN-PROPN,PROPN-PROPN-PROPN,compound-nsubj,compound-compound-pobj,NNP-NNP,NNP-NNP-NNP,1,1
5171,6722.0,30,(,0,16,17,1,15,12,-16,17,Charles Dow,Dow Jones Company,per-per,--,PROPN-PROPN,PROPN-PROPN-PROPN,compound-compound,compound-compound-pobj,NNP-NNP,NNP-NNP-NNP,1,1
5172,3374.0,37,was,8,1,8,7,0,28,7,0,Watt,Interior,org,,PROPN,PROPN,poss,pobj,NNP,NNP,3,1
5173,13317.0,21,appointed,4,3,20,17,2,0,1,16,Watt,Interior,org,,PROPN,PROPN,nsubjpass,pobj,NNP,NNP,2,1
5174,3375.0,69,announced,6,38,48,10,37,20,-32,42,Santa Ana,Kendall,per-per,,PROPN-PROPN,PROPN,compound-pobj,appos,NNP-NNP,NNP,7,1
5175,3376.0,25,is,1,6,6,0,5,18,-5,5,Dick Smith Electronics,Dick Smith,per-per-per,-,PROPN-PROPN-PROPN,PROPN-PROPN,compound-compound-compound,compound-compound,NNP-NNP-NNP,NNP-NNP,0,1
5176,3379.0,14,names,1,11,12,1,10,1,-10,11,Fiat,Giovanni Agnelli,org,-,PROPN,PROPN-PROPN,compound,compound-pobj,NNP,NNP-NNP,1,1
5177,3380.0,26,taught,1,11,11,0,10,14,-10,10,Langston University,Langston,-,per,PROPN-PROPN,PROPN,compound-pobj,compound,NNP-NNP,NNP,0,1
5178,3381.0,26,is,2,2,24,22,1,1,0,22,Iwerks Entertainment,Stan Kinsey,per-per,-,PROPN-PROPN,PROPN-PROPN,compound-pobj,compound-pobj,NNP-NNP,NNP-NNP,4,1
5179,3382.0,21,represents,6,3,9,6,2,11,3,3,Utah Utes,University of Utah,-,org-org-org,PROPN-PROPN,PROPN-ADP-PROPN,compound-compound,dobj-prep-pobj,NNP-NNP,NNP-IN-NNP,4,1
5180,9133.0,24,represented,8,4,11,7,3,12,4,3,Utah Utes,University of Utah,org-org,--,PROPN-PROPN,PROPN-ADP-PROPN,compound-compound,dobj-prep-pobj,NNP-NNPS,NNP-IN-NNP,4,1
5181,3383.0,21,represented,7,3,16,13,2,4,4,9,Appalachian State Mountaineers,Division I,per-per-per,-,PROPN-PROPN-PROPN,PROPN-PROPN,amod-compound-compound,pobj-compound,NNP-NNP-NNPS,NNP-NNP,7,1
5182,3384.0,21,hired,5,10,11,1,9,9,-5,6,choreographer,Debbie Allen,org,-,NOUN,PROPN-PROPN,compound,compound-conj,NN,NNP-NNP,1,1
5183,3385.0,33,known,16,3,25,22,2,7,13,9,Walt Disney,Walter Elias Disney,per-per,--,PROPN-PROPN,PROPN-PROPN-PROPN,compound-pobj,compound-compound-dobj,NNP-NNP,NNP-NNP-NNP,8,1
5184,3387.0,29,is,12,22,28,6,21,0,-10,16,Loyola Marymount University,California,per-per-per,,PROPN-PROPN-PROPN,PROPN,compound-compound-pobj,pobj,NNP-NNP-NNP,NNP,6,1
5185,3389.0,32,group,1,11,13,2,10,18,-10,12,HIM,Ville Valo,per,-,PROPN,PROPN-PROPN,compound,compound-nsubj,NNP,NNP-NNP,1,1
5186,3390.0,14,represented,7,3,10,7,2,3,4,3,Army Black Knights,United States Military Academy,org-org-org,---,PROPN-PROPN-PROPN,PROPN-PROPN-PROPN-PROPN,compound-compound-compound,compound-compound-compound-dobj,NNP-NNP-NNPS,NNP-NNP-NNP-NNP,5,1
5187,3391.0,10,expecting,6,1,5,4,0,4,5,-1,Casey Affleck,Summer Phoenix,org-org,-,PROPN-PROPN,PROPN-PROPN,compound-nsubj,compound-conj,NNP-NNP,NNP-NNP,1,1
5188,3392.0,47,is,1,1,9,8,0,37,0,8,Canica,Oslo,per,,PROPN,PROPN,nsubj,compound,NNP,NNP,4,1
5189,3395.0,22,named,2,5,14,9,4,7,-3,12,John Sherman,Treasury,-,per,PROPN-PROPN,PROPN,compound-pobj,pobj,NNP-NNP,NNP,2,1
5190,7844.0,24,utilized,2,1,6,5,0,17,1,4,John Sherman,Treasury,-,per,PROPN-PROPN,PROPN,compound-nsubj,compound,NNP-NNP,NNP,3,1
5191,3396.0,28,lead,19,9,22,13,8,5,10,3,Seattle,Kim Thayil,org,-,PROPN,PROPN-PROPN,compound,compound-dobj,NNP,NNP-NNP,6,1
5192,3397.0,23,having,7,5,20,15,4,2,2,13,Reliance Energy,Mumbai,-,per,PROPN-PROPN,PROPN,compound-compound,ccomp,NNP-NNP,NNP,5,1
5193,3398.0,31,emigrated,2,6,12,6,5,18,-4,10,Canada,Canadian Expeditionary Force,,per-per-per,PROPN,PROPN-PROPN-PROPN,pobj,compound-compound-pobj,NNP,NNP-NNP-NNP,4,1
5194,3399.0,56,jpg,0,15,17,2,14,38,-15,17,Gustav Heinemann,Essen,org-org,,PROPN-PROPN,PROPN,compound-compound,poss,NNP-NNP,NNP,2,1
5195,3400.0,35,was,22,3,20,17,2,14,19,-2,Springsteen,New Jersey,org,-,PROPN,PROPN-PROPN,compound,compound-pobj,NNP,NNP-NNP,4,1
5196,3403.0,18,became,4,4,16,12,3,1,0,12,he,United Abkhazia,,org-org,PRON,PROPN-PROPN,nsubj,compound-appos,PRP,NNP-NNP,6,1
5197,3404.0,14,was,1,11,12,1,10,1,-10,11,Navy,Smith Thompson,,per-per,PROPN,PROPN-PROPN,compound,compound-pobj,NNP,NNP-NNP,1,1
5198,7655.0,33,assumed,3,15,17,2,14,15,-12,14,Navy,Smith Thompson,per,-,PROPN,PROPN-PROPN,compound,compound-pobj,NNP,NNP-NNP,1,1
5199,8293.0,26,called,1,12,13,1,11,12,-11,12,Navy,Smith Thompson,org,-,PROPN,PROPN-PROPN,compound,compound-pobj,NNP,NNP-NNP,5,1
5200,8561.0,49,selected,11,9,10,1,8,38,2,-1,Navy,Smith Thompson,per,-,PROPN,PROPN-PROPN,compound,compound-pobj,NNP,NNP-NNP,1,1
5201,10927.0,47,suppressed,21,15,16,1,14,30,6,-5,Navy,Smith Thompson,per,-,PROPN,PROPN-PROPN,compound,compound-pobj,NNP,NNP-NNP,1,1
5202,13790.0,30,subjected,13,8,9,1,7,20,5,-4,Navy,Smith Thompson,,org-org,PROPN,PROPN-PROPN,compound,compound-pobj,NNP,NNP-NNP,1,1
5203,3405.0,16,acquired,7,1,6,5,0,9,6,-1,L. S. Ayres,Indiana,per-per-per,,PROPN-PROPN-PROPN,PROPN,compound-compound-compound,nsubjpass,NNP-NNP-NNP,NNP,3,1
5204,3406.0,34,1989,3,25,32,7,24,1,-22,29,Combs,Uptown,,per,PROPN,PROPN,pobj,compound,NNPS,NNP,4,1
5205,3407.0,30,paid,16,5,29,24,4,0,11,13,John Howard,Sydney,org-org,,PROPN-PROPN,PROPN,compound-nsubj,pobj,NNP-NNP,NNP,2,1
5206,3408.0,35,is,7,25,33,8,24,1,-18,26,Sam Dave,Stax,org-org,,PROPN-PROPN,PROPN,compound-pobj,compound,NNP-NNP,NNP,7,1
5207,11182.0,32,were,2,1,16,15,0,15,1,14,Sam Dave,Stax,org-org,,PROPN-PROPN,PROPN,compound-nsubj,pobj,NNP-NNP,NNP,3,1
5208,3409.0,54,were,6,47,49,2,46,4,-41,43,Press and Journal,Journal,--,per,PROPN-CCONJ-PROPN,PROPN,appos-cc-conj,conj,NNP-CC-NNP,NNP,3,1
5209,3410.0,20,went,4,8,12,4,7,7,-4,8,Living Sacrifice,Solid State Records,-,org-org-org,PROPN-PROPN,PROPN-PROPN-PROPN,compound-nsubj,compound-compound-pobj,NNP-NNP,NNP-NNP-NNPS,4,1
5210,3411.0,30,is,17,1,11,10,0,18,16,-6,Time Warner,TNT,per-per,,PROPN-PROPN,PROPN,compound-poss,compound,NNP-NNP,NNP,4,1
5211,3412.0,24,is,13,2,16,14,1,7,11,3,Paul Lockhart,American,-,per,PROPN-PROPN,ADJ,compound-nsubj,amod,NNP-NNP,JJ,5,1
5212,3414.0,31,drafting,4,16,19,3,15,11,-12,15,Evan Bayh,Indiana,org-org,,PROPN-PROPN,PROPN,compound-conj,pobj,NNP-NNP,NNP,5,1
5213,13199.0,64,said,19,5,19,14,4,44,14,0,Evan Bayh,Indiana,per-per,,PROPN-PROPN,PROPN,compound-appos,pobj,NNP-NNP,NNP,4,1
5214,3415.0,32,released,26,1,12,11,0,19,25,-14,The Contrast,Wicked Cool,per-per,-,DET-PROPN,PROPN-PROPN,det-poss,compound-compound,DT-NNP,NNP-NNP,3,1
5215,3416.0,10,defeated,1,4,6,2,3,3,-3,5,Liberal,Maria Minna,per,-,ADJ,PROPN-PROPN,amod,compound-dobj,JJ,NNP-NNP,1,1
5216,3417.0,45,slow,3,14,41,27,13,3,-11,38,Vale,Roger Agnelli,,per-per,PROPN,PROPN-PROPN,conj,compound-pobj,NNP,NNP-NNP,6,1
5217,3418.0,46,_,1,5,8,3,4,37,-4,7,Under Armour,Kevin Plank,org-org,-,PROPN-PROPN,PROPN-PROPN,prep-compound,compound-nsubj,NNP-NNP,NNP-NNP,2,1
5218,3419.0,23,is,4,1,1,0,0,21,3,-3,St. Charles High School,St. Charles,---,org-org,PROPN-PROPN-PROPN-PROPN,PROPN-PROPN,compound-compound-compound-nsubj,compound-compound,NNP-NNP-NNP-NNP,NNP-NNP,0,1
5219,3420.0,24,ran,17,1,15,14,0,8,16,-2,Kim Jong-il,National Defence Commission,per-per,--,PROPN-PROPN,PROPN-PROPN-PROPN,compound-nsubj,compound-compound-pobj,NNP-NNP,NNP-NNP-NNP,8,1
5220,10930.0,22,died,2,1,19,18,0,2,1,17,Kim Jong-il,National Defence Commission,-,org-org-org,PROPN-PROPN,PROPN-PROPN-PROPN,compound-nsubj,compound-compound-pobj,NNP-NNP,NNP-NNP-NNP,7,1
5221,12368.0,27,proclaimed,14,16,24,8,15,2,-2,10,Kim Jong-il,National Defence Commission,org-org,--,PROPN-PROPN,PROPN-PROPN-PROPN,compound-dobj,compound-compound-pobj,NNP-NNP,NNP-NNP-NNP,5,1
5222,3422.0,28,said,10,2,14,12,1,13,8,4,Bank,NBG,,org,PROPN,PROPN,nsubj,nsubj,NNP,NNP,-1,1
5223,5254.0,21,took,2,10,2,-8,9,18,-8,0,Bank,NBG,,per,PROPN,PROPN,dobj,nsubj,NNP,NNP,2,1
5224,3423.0,19,won,4,1,12,11,0,6,3,8,Hikawa,Japan,,org,PROPN,PROPN,poss,compound,NNP,NNP,6,1
5225,3424.0,33,encompasses,16,5,10,5,4,22,11,-6,Portugal,Portuguese Armed Forces,per,--,PROPN,PROPN-PROPN-PROPN,pobj,amod-compound-pobj,NNP,NNP-NNP-NNPS,4,1
5226,11490.0,49,conducted,2,1,19,18,0,29,1,17,Portugal,Portuguese Armed Forces,org,--,PROPN,ADJ-PROPN-PROPN,nsubj,compound-compound-pobj,NNP,JJ-NNP-NNPS,8,1
5227,14010.0,27,signed,4,11,24,13,10,2,-7,20,Portugal,Portuguese Armed Forces,,per-per-per,PROPN,PROPN-PROPN-PROPN,pobj,compound-compound-pobj,NNP,NNP-NNP-NNPS,8,1
5228,3426.0,39,watched,2,11,20,9,10,18,-9,18,South Dakota,Tom Daschle,org-org,-,PROPN-PROPN,PROPN-PROPN,compound-pobj,compound-dobj,NNP-NNP,NNP-NNP,4,1
5229,3427.0,28,May,24,1,5,4,0,22,23,-19,GAO,Government Accountability Office,per,--,PROPN,PROPN-PROPN-PROPN,compound,compound-compound-compound,NNP,NNP-NNP-NNP,2,1
5230,3428.0,19,is,1,14,16,2,13,2,-13,15,Rainbow,Joe Lynn Turner,per,--,PROPN,PROPN-PROPN-PROPN,compound,compound-compound-pobj,NNP,NNP-NNP-NNP,3,1
5231,3429.0,42,Karad?i,4,4,37,33,3,4,0,33,Radovan Karad?i,t of Republika Sr,per-per,---,PROPN-NUM,PROPN-ADP-PROPN-PROPN,pobj-ROOT,appos-prep-compound-compound,NNP-CD,NNP-IN-NNP-NNP,-1,1
5232,3430.0,21,represented,8,3,16,13,2,4,5,8,Florida Atlantic University,NCAA,--,org,PROPN-PROPN-PROPN,PROPN,compound-compound-compound,compound,NNP-NNP-NNP,NNP,6,1
5233,5620.0,21,represented,7,3,15,12,2,5,4,8,Florida Atlantic University,NCAA,per-per-per,,PROPN-PROPN-PROPN,PROPN,compound-compound-dobj,compound,NNP-NNP-NNP,NNP,4,1
5234,13144.0,33,represents,6,2,13,11,1,19,4,7,Florida Atlantic University,NCAA,--,per,PROPN-PROPN-PROPN,PROPN,compound-compound-dative,compound,NNP-NNP-NNP,NNP,4,1
5235,3431.0,45,Milkowski,0,1,11,10,0,33,-1,11,Milkowski,DIW,,org,PROPN,PROPN,ROOT,compound,NNP,NNP,-1,1
5236,3432.0,32,after,3,5,13,8,4,18,-2,10,his,Gatineau,org,,DET,PROPN,poss,pobj,PRP$,NNP,5,1
5237,3433.0,33,scheduled,2,12,29,17,11,3,-10,27,Shimon Peres,Israel,per-per,,PROPN-PROPN,PROPN,compound-compound,compound,NNP-NNP,NNP,9,1
5238,3434.0,17,replaces,3,1,2,1,0,14,2,-1,Fra,Matthew Festing,per,-,PROPN,PROPN-PROPN,compound,compound-nsubj,NNP,NNP-NNP,1,1
5239,3436.0,10,signed,2,1,7,6,0,2,1,5,She,Island Records,,org-org,PRON,PROPN-PROPN,nsubj,compound-compound,PRP,NNP-NNPS,5,1
5240,3437.0,11,B.C.,1,1,8,7,0,2,0,7,Burnaby,Simon Fraser University,,per-per-per,PROPN,PROPN-PROPN-PROPN,compound,compound-compound-ROOT,NNP,NNP-NNP-NNP,-1,1
5241,3438.0,57,planned,7,18,23,5,17,33,-11,16,Quebec,Jean Lesage,org,-,PROPN,PROPN-PROPN,compound,compound-compound,NNP,NNP-NNP,5,1
5242,3439.0,51,offered,8,18,27,9,17,23,-10,19,University of Missouri,Big 12,org-org-org,-,PROPN-ADP-PROPN,PROPN-NUM,pobj-prep-poss,amod-nummod,NNP-IN-NNP,NNP-CD,8,1
5243,5694.0,58,graduate,3,31,39,8,30,18,-28,36,University of Missouri,Big 12,per-per-per,-,PROPN-ADP-PROPN,PROPN-NUM,nmod-prep-pobj,nmod-nummod,NNP-IN-NNP,NNP-CD,9,1
5244,9750.0,27,defeated,5,2,21,19,1,5,3,16,University of Missouri,Big 12,org-org-org,-,PROPN-ADP-PROPN,ADJ-NUM,nsubj-prep-compound,amod-nummod,NNP-IN-NNP,JJ-CD,7,1
5245,3444.0,13,born,2,6,10,4,5,2,-4,8,Greater Manchester,Bury Grammar School,per-per,--,PROPN-PROPN,PROPN-PROPN-PROPN,compound-pobj,compound-compound-dobj,NNP-NNP,NNP-NNP-NNP,5,1
5246,3446.0,37,began,3,12,20,8,11,16,-9,17,CHEP,Brambles,,per,PROPN,PROPN,dobj,pobj,NNP,NNP,3,1
5247,3447.0,37,said,35,5,18,13,4,18,30,-17,Raymond Barre,Paris,-,per,PROPN-PROPN,PROPN,compound-nsubj,compound,NNP-NNP,NNP,7,1
5248,3448.0,33,is,8,1,10,9,0,22,7,2,His,Elaine Chao,,org-org,DET,PROPN-PROPN,poss,compound-attr,PRP$,NNP-NNP,3,1
5249,3449.0,18,stated,3,1,7,6,0,10,2,4,Richard Patrick,Filter,-,per,PROPN-PROPN,PROPN,compound-nsubj,compound,NNP-NNP,NNP,3,1
5250,3450.0,33,Headquartered,0,6,21,15,5,11,-6,21,/ Octone Records,Hollywood Undead,per-per-per,-,SYM-PROPN-PROPN,PROPN-PROPN,punct-compound-pobj,compound-compound,SYM-NNP-NNPS,NNP-NNP,7,1
5251,3451.0,48,announced,6,44,9,-35,43,38,-38,3,Qubo,NBC,,org,PROPN,PROPN,dobj,compound,NNP,NNP,8,1
5252,3452.0,42,was,18,30,13,-17,29,28,-12,-5,ITV News Channel,ITN,per-per-per,,PROPN-PROPN-PROPN,PROPN,compound-compound-pobj,poss,NNP-NNP-NNP,NNP,12,1
5253,3454.0,36,was,5,4,18,14,3,17,1,13,Josh Smith,Weakling,per-per,,PROPN-PROPN,PROPN,compound-nsubj,appos,NNP-NNP,NNP,4,1
5254,3456.0,14,was,1,9,10,1,8,3,-8,9,singer,Marisol,,per,NOUN,PROPN,compound,conj,NN,NNP,4,1
5255,3457.0,47,Holding,0,22,24,2,21,22,-22,24,Army,Corps,per,,PROPN,PROPN,poss,compound,NNP,NNP,2,1
5256,3458.0,18,is,3,1,13,12,0,4,2,10,Ilfracombe Arts College,Devon,--,org,PROPN-PROPN-PROPN,PROPN,compound-compound-nsubj,compound,NNP-NNP-NNP,NNP,6,1
5257,3459.0,27,was,2,2,9,7,1,17,0,7,college,Australia,,per,NOUN,PROPN,nsubj,pobj,NN,NNP,3,1
5258,3460.0,34,announced,5,3,18,15,2,15,2,13,Pakistan,Benazir Bhutto,,org-org,PROPN,PROPN-PROPN,compound,compound-compound,NNP,NNP-NNP,7,1
5259,4815.0,18,exposed,5,4,16,12,3,1,1,11,Pakistan,Benazir Bhutto,,per-per,PROPN,PROPN-PROPN,compound,compound-pobj,NNP,NNP-NNP,5,1
5260,3461.0,34,retained,24,11,27,16,10,6,13,3,Australia,The Lifestyle Channel,,per-per-per,PROPN,DET-PROPN-PROPN,pobj,det-compound-pobj,NNP,DT-NNP-NNP,6,1
5261,3464.0,47,wrestlers,1,34,25,-9,33,21,-33,24,Mike Mizanin,The Miz,per-per,-,PROPN-PROPN,DET-PROPN,compound-ROOT,det-appos,NNP-NNP,DT-NNP,-1,1
5262,3465.0,48,continued,11,5,23,18,4,24,6,12,Richard Currie,Loblaws,-,org,PROPN-PROPN,PROPN,compound-nsubj,nsubj,NNP-NNP,NNP,10,1
5263,3466.0,29,moved,17,7,16,9,6,12,10,-1,PGP-RTB,Yugoslavia,per,,NOUN,PROPN,pobj,compound,NN,NNP,3,1
5264,3467.0,50,McConnaughey,2,40,47,7,39,2,-38,45,North Carolina School of Science and Mathematics,Durham,------,org,PROPN-PROPN-PROPN-ADP-PROPN-CCONJ-PROPN,PROPN,compound-compound-appos-prep-pobj-cc-compound,conj,NNP-NNP-NNP-IN-NNP-CC-NNP,NNP,2,1
5265,3468.0,12,is,0,8,10,2,7,1,-8,10,Kotoko,Geneon Entertainment,per,-,PROPN,PROPN-PROPN,pobj,compound-pobj,NNP,NNP-NNP,4,1
5266,3469.0,22,is,15,1,1,0,0,20,14,-14,Coronado School of the Arts,Coronado,per-per-per-per-per,,PROPN-PROPN-ADP-DET-PROPN,PROPN,compound-nsubj-prep-det-pobj,compound,NNP-NNP-IN-DT-NNPS,NNP,0,1
5267,3470.0,49,For,0,10,13,3,9,35,-10,13,California,Disney,per,,PROPN,PROPN,npadvmod,nsubj,NNP,NNP,6,1
5268,3471.0,41,ended,6,1,35,34,0,5,5,29,Her,New York,org,-,DET,PROPN-PROPN,poss,compound-poss,PRP$,NNP-NNP,7,1
5269,3472.0,64,In,0,25,7,-18,24,56,-25,7,George Marshall,Army man,-,org-org,PROPN-PROPN,PROPN-NOUN,compound-pobj,compound-nsubjpass,NNP-NNP,NNP-NN,-1,1
5270,3473.0,41,competes,7,16,10,-6,15,30,-9,3,NCAA,the College of William Mary,,org-org-org-org-org,PROPN,DET-PROPN-ADP-PROPN-PROPN,nmod,det-dobj-prep-compound-pobj,NNP,DT-NNP-IN-NNP-NNP,2,1
5271,3475.0,30,was,1,21,26,5,20,3,-20,25,Eleanor of Provence,Henry III of England,--,org-org-org-org,PROPN-ADP-PROPN,PROPN-PROPN-ADP-PROPN,pobj-prep-pobj,compound-pobj-prep-pobj,NNP-IN-NNP,NNP-NNP-IN-NNP,5,1
5272,3476.0,31,represented,8,4,18,14,3,12,4,10,Kansas Jayhawks,Division I,-,per-per,PROPN-PROPN,PROPN-PRON,compound-compound,pobj-nsubj,NNP-NNP,NNP-PRP,7,1
5273,3477.0,35,was,3,23,23,0,22,11,-20,20,Scranton High School,Scranton,--,per,PROPN-PROPN-PROPN,PROPN,compound-compound-pobj,pobj,NNP-NNP-NNP,NNP,0,1
5274,3478.0,15,is,7,1,13,12,0,1,6,6,Ms. Jade,Philadelphia,org-org,,PROPN-PROPN,PROPN,compound-nsubj,compound,NNP-NNP,NNP,4,1
5275,3479.0,38,arrives,7,15,26,11,14,11,-8,19,Morocco,Abbas el Fassi,org,--,PROPN,PROPN-PROPN-PROPN,pobj,compound-compound-pobj,NNP,NNP-NNP-NNP,5,1
5276,3480.0,22,includes,2,11,14,3,10,7,-9,12,Flipmode Squad,Spliff Star,org-org,-,PROPN-PROPN,PROPN-PROPN,compound-appos,compound-compound,NNP-NNP,NNP-NNP,5,1
5277,6278.0,22,is,1,7,16,9,6,5,-6,15,Flipmode Squad,Spliff Star,-,org-org,PROPN-PROPN,PROPN-PROPN,compound-pobj,compound-pobj,NNP-NNP,NNP-NNP,6,1
5278,3481.0,14,born,2,1,13,12,0,0,1,11,Regehr,Canada,,per,PROPN,PROPN,nsubjpass,pobj,NNP,NNP,2,1
5279,3482.0,25,is,5,2,2,0,1,22,3,-3,Royal Cambodian Air Force,Royal Cambodian Armed Forces,---,org-org-org-org,PROPN-PROPN-PROPN-PROPN,PROPN-PROPN-PROPN-PROPN,compound-compound-compound-nsubj,compound-compound-compound-pobj,NNP-NNP-NNP-NNP,NNP-NNP-NNP-NNPS,0,1
5280,3483.0,33,maintains,5,4,11,7,3,21,1,6,Zhejiang University,China,per-per,,PROPN-PROPN,PROPN,compound-nsubj,pobj,NNP-NNP,NNP,3,1
5281,6917.0,24,is,4,1,14,13,0,9,3,10,Zhejiang University,China,org-org,,PROPN-PROPN,PROPN,compound-compound,pobj,NNP-NNP,NNP,6,1
5282,3484.0,26,nicknamed,5,2,7,5,1,18,3,2,64th Brigade Support Battalion,Mountaineers,per-per-per-per,,ADJ-PROPN-PROPN-PROPN,PROPN,amod-compound-compound-nsubj,nsubj,JJ-NNP-NNP-NNP,NNP,2,1
5283,3485.0,31,moved,6,11,28,17,10,2,-5,22,Missouri,Thomas Hart Benton,per,--,PROPN,PROPN-PROPN-PROPN,pobj,compound-compound-pobj,NNP,NNP-NNP-NNP,7,1
5284,8873.0,27,settled,5,12,14,2,11,12,-7,9,Missouri,Thomas Hart Benton,,per-per-per,PROPN,PROPN-PROPN-PROPN,compound,compound-compound-nsubjpass,NNP,NNP-NNP-NNP,2,1
5285,3486.0,20,is,11,1,5,4,0,14,10,-6,Man Parrish,Manuel Joseph Parrish,-,org-org-org,PROPN-PROPN,PROPN-PROPN-PROPN,compound-nsubj,compound-compound-compound,NNP-NNP,NNP-NNP-NNP,4,1
5286,3487.0,45,made,10,19,23,4,18,21,-9,13,Pacific Southwest Airlines,PSA,org-org-org,,PROPN-PROPN-PROPN,PROPN,compound-compound-nsubj,appos,NNP-NNP-NNPS,NNP,3,1
5287,3488.0,43,revealed,3,14,17,3,13,25,-11,14,Actress,Jacquetta,org,,NOUN,PROPN,nsubj,compound,NN,NNP,2,1
5288,3489.0,39,is,3,20,38,18,19,0,-17,35,Eva Braun,Berlin,per-per,,PROPN-PROPN,PROPN,compound-appos,pobj,NNP-NNP,NNP,7,1
5289,3491.0,30,known,6,2,23,21,1,6,4,17,4th Pennsylvania Reserve Regiment,Union,---,org,ADJ-PROPN-PROPN-PROPN,PROPN,amod-compound-compound-nsubj,compound,JJ-NNP-NNP-NNP,NNP,7,1
5290,3492.0,97,is,4,11,32,21,10,64,-7,28,UK,Bathstore,per,,PROPN,PROPN,pobj,compound,NNP,NNP,-1,1
5291,3493.0,23,is,1,6,7,1,5,15,-5,6,Karnataka University,University of Agricultural Sciences,-,org-org-org-org,PROPN-PROPN,PROPN-ADP-PROPN-PROPN,compound-pobj,conj-prep-compound-pobj,NNP-NNP,NNP-IN-NNP-NNPS,1,1
5292,3494.0,26,was,2,1,1,0,0,24,1,-1,Air Europa,Air Dominicana,org-org,-,PROPN-PROPN,PROPN-PROPN,compound-nsubj,compound-pobj,NNP-NNP,NNP-NNP,0,1
5293,3495.0,50,elected,4,1,8,7,0,41,3,4,Gaston Flosse,French Polynesia,-,per-per,PROPN-PROPN,PROPN-PROPN,compound-nsubjpass,amod-pobj,NNP-NNP,NNP-NNP,4,1
5294,3496.0,34,ran,11,6,9,3,5,24,5,-2,Navajo Nation Council,Lawrence T. Morgan,--,per-per-per,PROPN-PROPN-PROPN,PROPN-PROPN-PROPN,compound-compound-compound,compound-compound-pobj,NNP-NNP-NNP,NNP-NNP-NNP,3,1
5295,3497.0,54,informed,31,34,50,16,33,3,-3,19,Rembrandt,Amsterdam,,org,PROPN,PROPN,poss,poss,NNP,NNP,12,1
5296,3498.0,22,stated,3,1,8,7,0,13,2,5,Brad Paisley,Kimberly Williams-Paisley,org-org,-,PROPN-PROPN,PROPN-PROPN,compound-nsubj,compound-appos,NNP-NNP,NNP-NNP,5,1
5297,8420.0,21,says,8,7,14,7,6,6,1,6,Brad Paisley,Kimberly Williams-Paisley,-,org-org,PROPN-PROPN,PROPN-PROPN,compound-pobj,compound-appos,NNP-NNP,NNP-NNP,8,1
5298,3499.0,33,is,5,1,23,22,0,9,4,18,Johnny Cash,Columbia,per-per,,PROPN-PROPN,PROPN,compound-nsubj,compound,NNP-NNP,NNP,5,1
5299,8829.0,24,is,1,10,14,4,9,9,-9,13,Johnny Cash,Columbia,org-org,,PROPN-PROPN,PROPN,compound-pobj,compound,NNP-NNP,NNP,5,1
5300,3500.0,31,included,2,8,23,15,7,7,-6,21,Ghulam Ishaq Khan,Pakistan,--,per,PROPN-PROPN-PROPN,PROPN,compound-compound-compound,compound,NNP-NNP-NNP,NNP,5,1
5301,4207.0,40,was,16,1,22,21,0,17,15,6,Ghulam Ishaq Khan,Pakistan,org-org-org,,PROPN-PROPN-PROPN,PROPN,compound-compound-nsubj,pobj,NNP-NNP-NNP,NNP,3,1
5302,8165.0,25,dismissed,7,3,13,10,2,11,4,6,Ghulam Ishaq Khan,Pakistan,per-per-per,,PROPN-PROPN-PROPN,PROPN,compound-compound-nsubj,pobj,NNP-NNP-NNP,NNP,5,1
5303,3501.0,25,formed,2,1,6,5,0,18,1,4,AMEC,1982,,per,PROPN,NUM,nsubjpass,nummod,NNP,CD,3,1
5304,3502.0,17,attended,1,3,7,4,2,9,-2,6,Athens High School,Troy,per-per-per,,PROPN-PROPN-PROPN,PROPN,compound-compound-dobj,compound,NNP-NNP-NNP,NNP,3,1
5305,3503.0,30,gave,3,17,20,3,16,9,-14,17,Snow Patrol,Gary Lightbody,-,org-org,PROPN-PROPN,PROPN-PROPN,compound-compound,compound-compound,NNP-NNP,NNP-NNP,4,1
5306,3504.0,16,was,2,11,12,1,10,3,-9,10,MTV,Canada,org,,PROPN,PROPN,compound,pobj,NNP,NNP,2,1
5307,3505.0,20,is,9,1,17,16,0,2,8,8,Envision Financial,British Columbia,org-org,-,PROPN-PROPN,PROPN-PROPN,compound-nsubj,compound-compound,NNP-NNP,NNP-NNP,4,1
5308,3506.0,18,was,1,12,16,4,11,1,-11,15,Henry Chapman Mercer,Doylestown,--,per,PROPN-PROPN-PROPN,PROPN,compound-compound-pobj,compound,NNP-NNP-NNP,NNP,3,1
5309,3507.0,54,developed,5,5,4,-1,4,49,0,-1,Hornby,Meccano Magazine,per,-,PROPN,PROPN-PROPN,pobj,compound-dobj,NNP,NNP-NNP,4,1
5310,3508.0,18,had,1,1,8,7,0,9,0,7,Shaw,Ava Gardner,org,-,PROPN,PROPN-PROPN,nsubj,compound-compound,NNP,NNP-NNP,2,1
5311,3510.0,31,declared,3,24,25,1,23,5,-21,22,President,Lahoud,per,,PROPN,PROPN,compound,pobj,NNP,NNP,2,1
5312,3511.0,57,provides,26,19,25,6,18,31,7,-1,Sias International University,China,per-per-per,,PROPN-PROPN-PROPN,PROPN,compound-compound-pobj,appos,NNP-NNP-NNP,NNP,4,1
5313,3512.0,43,captured,8,12,12,0,11,30,-4,4,James I of Scotland,James,---,org,PROPN-PRON-ADP-PROPN,PROPN,pobj-appos-prep-pobj,compound,NNP-PRP-IN-NNP,NNP,0,1
5314,3513.0,12,Basten,2,1,7,6,0,4,1,5,Marco van Basten,Netherlands,--,org,PROPN-PROPN-PROPN,PROPN,compound-nsubj-ROOT,compound,NNP-NNP-NNP,NNP,4,1
5315,3514.0,33,is,13,1,8,7,0,24,12,-5,California State University,CSUDH,org-org-org,,PROPN-PROPN-PROPN,NOUN,compound-compound-compound,dobj,NNP-NNP-NNP,NNS,4,1
5316,3515.0,58,bore,1,6,22,16,5,35,-5,21,Cyrus the Great,Egypt,org-org-org,,PROPN-DET-PROPN,PROPN,pobj-det-appos,nmod,NNP-DT-NNP,NNP,6,1
5317,3516.0,24,is,9,1,1,0,0,22,8,-8,Azerbaijan Architecture and Construction University,Azerbaijan,per-per-per-per-per,,PROPN-PROPN-CCONJ-PROPN-PROPN,PROPN,nmod-nmod-cc-conj-nsubj,pobj,NNP-NNP-CC-NNP-NNP,NNP,0,1
5318,3517.0,37,served,4,13,25,12,12,11,-9,21,Verve,Fitzgerald,,per,PROPN,PROPN,compound,dobj,NNP,NNP,7,1
5319,3518.0,24,formed,3,6,11,5,5,12,-3,8,Lotus Engineering Ltd.,Colin Chapman,per-per-per,-,PROPN-PROPN-PROPN,PROPN-PROPN,compound-compound-pobj,compound-pobj,NNP-NNP-NNP,NNP-NNP,5,1
5320,3519.0,14,studied,5,4,12,8,3,1,1,7,Germany,University of,,per-per,PROPN,PROPN-ADP,pobj,pobj-prep,NNP,NNP-IN,4,1
5321,3520.0,74,has,3,13,36,23,12,37,-10,33,University of Sussex,United Kingdom,per-per-per,-,PROPN-ADP-PROPN,PROPN-PROPN,conj-prep-pobj,compound-pobj,NNP-IN-NNP,NNP-NNP,5,1
5322,3521.0,30,is,6,1,20,19,0,9,5,14,Willes Little Flower School,Bangladesh,per-per-per-per,,PROPN-PROPN-PROPN-PROPN,PROPN,compound-compound-compound-nsubj,pobj,NNP-NNP-NNP-NNP,NNP,3,1
5323,3522.0,35,McCollum,2,1,21,20,0,13,1,19,Robert Lee McCollum,musician,org-org-org,,PROPN-PROPN-PROPN,NOUN,compound-compound-ROOT,attr,NNP-NNP-NNP,NN,5,1
5324,3525.0,9,has,2,2,8,6,1,0,0,6,group,California,org,,NOUN,PROPN,nsubj,pobj,NN,NNP,1,1
5325,3527.0,27,is,1,6,13,7,5,13,-5,12,Nigel Lawson,Exchequer,per-per,,PROPN-PROPN,PROPN,compound-pobj,pobj,NNP-NNP,NNP,2,1
5326,8637.0,15,Chancellor,3,1,7,6,0,7,2,4,Nigel Lawson,Exchequer,-,org,PROPN-PROPN,PROPN,compound-nmod,pobj,NNP-NNP,NNP,2,1
5327,3528.0,25,Entertainment,1,1,17,16,0,7,0,16,JYP Entertainment,South Korea in,-,org-org-org,PROPN-PROPN,PROPN-PROPN-ADP,compound-ROOT,compound-pobj-prep,NNP-NNP,NNP-NNP-IN,-1,1
5328,3529.0,25,credited,5,7,9,2,6,15,-2,4,Collingwood,Bob Rose,,per-per,PROPN,PROPN-PROPN,compound,compound-dobj,NNP,NNP-NNP,1,1
5329,3531.0,39,is,8,2,23,21,1,15,6,15,University of Delaware Press,United States,---,per-per,PROPN-ADP-PROPN-PROPN,PROPN-PROPN,nsubj-prep-compound-pobj,compound-pobj,NNP-IN-NNP-NNP,NNP-NNP,7,1
5330,3533.0,90,said,1,76,83,7,75,6,-75,82,Organization of the Petroleum Exporting Countries,OPEC,per-per-per-per-per-per,,PROPN-ADP-DET-PROPN-PROPN-PROPN,PROPN,conj-prep-det-compound-compound-pobj,appos,NNP-IN-DT-NNP-NNP-NNPS,NNP,4,1
5331,3535.0,44,affiliated,4,1,15,14,0,28,3,11,St Virgil,JSHAA,-,org,PROPN-PROPN,PROPN,compound-nsubjpass,appos,NNP-NNP,NNP,5,1
5332,3536.0,38,Standing,2,1,19,18,0,18,1,17,Wu,Central Committee,per,-,PROPN,PROPN-PROPN,nsubj,compound-nsubj,NNP,NNP-NNP,-1,1
5333,3537.0,12,provide,5,2,3,1,1,8,3,-2,Interflora,FTD,org,,PROPN,PROPN,compound,nsubj,NNP,NNP,1,1
5334,3538.0,33,Zorn,1,1,20,19,0,12,0,19,John Zorn,Naked City,-,per-per,PROPN-PROPN,PROPN-PROPN,compound-ROOT,amod-pobj,NNP-NNP,NNP-NNP,1,1
5335,3539.0,20,are,4,1,13,12,0,6,3,9,Montclair State University,New Jersey,org-org-org,-,PROPN-PROPN-PROPN,PROPN-PROPN,compound-compound-compound,compound-compound,NNP-NNP-NNP,NNP-NNP,6,1
5336,3540.0,23,is,5,1,16,15,0,6,4,11,Martin Baron,The Boston Globe,-,org-org-org,PROPN-PROPN,DET-PROPN-PROPN,compound-nsubj,det-compound-pobj,NNP-NNP,DT-NNP-NNP,7,1
5337,3541.0,22,marks,2,7,14,7,6,7,-5,12,Mendes,Winslet,org,,PROPN,PROPN,nsubj,poss,NNP,NNP,5,1
5338,3542.0,29,founded,1,3,7,4,2,21,-2,6,Standard Oil,Ohio,org-org,,PROPN-PROPN,PROPN,compound-dobj,compound,NNP-NNP,NNP,3,1
5339,8321.0,19,formed,4,6,9,3,5,9,-2,5,Standard Oil,Ohio,org-org,,PROPN-PROPN,PROPN,compound-dobj,pobj,NNP-NNP,NNP,2,1
5340,3543.0,27,thede,7,12,12,0,11,14,-5,5,Akbar,Akbar the Great,per,--,PROPN,PROPN-DET-PROPN,poss,pobj-det-appos,NNP,NNP-DT-NNP,0,1
5341,3544.0,17,founded,7,1,6,5,0,10,6,-1,Ursuline College,Ohio,per-per,,PROPN-PROPN,PROPN,compound-nsubjpass,pobj,NNP-NNP,NNP,2,1
5342,3545.0,22,married,7,5,9,4,4,12,2,2,Margaret of Denmark,James,org-org-org,,PROPN-ADP-PROPN,PROPN,appos-prep-pobj,compound,NNP-IN-NNP,NNP,6,1
5343,3546.0,19,Lucie,0,1,13,12,0,5,-1,13,Lucie Arnaz,Roman Catholic Immaculate Heart High School,org-org,-----,PROPN-PROPN,ADJ-PROPN-PROPN-PROPN-PROPN-PROPN,ROOT-nsubjpass,compound-compound-compound-compound-compound-dobj,NNP-NNP,JJ-NNP-NNP-NNP-NNP-NNP,7,1
5344,3547.0,100,knew,2,16,27,11,15,72,-14,25,Tamara de Lempicka,Poland,--,per,PROPN-PROPN-PROPN,PROPN,nmod-nmod-nsubjpass,pobj,NNP-NNP-NNP,NNP,5,1
5345,3548.0,38,is,2,19,37,18,18,0,-17,35,Immigration and Naturalization Service,2003,per-per-per-per,,PROPN-CCONJ-PROPN-PROPN,NUM,nmod-cc-conj-pobj,pobj,NNP-CC-NNP-NNP,CD,6,1
5346,3549.0,106,located,101,64,68,4,63,37,37,-33,NATO,Joint Command Lisbon,org,--,PROPN,PROPN-PROPN-PROPN,compound,compound-compound-appos,NNP,NNP-NNP-NNP,3,1
5347,14268.0,29,is,1,11,18,7,10,10,-10,17,NATO,Joint Command Lisbon,,per-per-per,PROPN,PROPN-PROPN-PROPN,compound,compound-compound-compound,NNP,NNP-NNP-NNP,8,1
5348,3550.0,47,was,11,2,20,18,1,26,9,9,Ecevit,journalist,,per,PROPN,NOUN,nsubj,conj,NNP,NN,6,1
5349,3551.0,22,is,13,1,21,20,0,0,12,8,Serzh Sargsyan,Armenia,per-per,,PROPN-PROPN,PROPN,compound-nsubj,pobj,NNP-NNP,NNP,2,1
5350,10564.0,18,At,0,8,17,9,7,0,-8,17,Serzh Sargsyan,Armenia,-,per,PROPN-PROPN,PROPN,compound-nsubjpass,pobj,NNPS-NNP,NNP,2,1
5351,12990.0,18,congratulated,6,8,14,6,7,3,-2,8,Serzh Sargsyan,Armenia,-,per,PROPN-PROPN,PROPN,compound-dobj,poss,NNP-NNP,NNP,7,1
5352,13697.0,18,elected,7,5,17,12,4,0,2,10,Serzh Sargsyan,Armenia,per-per,,PROPN-PROPN,PROPN,compound-nsubjpass,pobj,NNPS-NNP,NNP,2,1
5353,13710.0,42,said,4,3,16,13,2,25,1,12,Serzh Sargsyan,Armenia,-,org,PROPN-PROPN,PROPN,compound-nsubj,conj,NNP-NNP,NNP,3,1
5354,3553.0,33,make,4,25,28,3,24,4,-21,24,Smollett,actress,,per,PROPN,NOUN,nsubj,attr,NNP,NN,2,1
5355,3554.0,18,was,1,7,10,3,6,7,-6,9,H. Otto Wittpenn,Jersey City,--,org-org,PROPN-PROPN-PROPN,PROPN-PROPN,compound-compound-compound,compound-compound,NNP-NNP-NNP,NNP-NNP,3,1
5356,9437.0,14,named,2,5,12,7,4,1,-3,10,H. Otto Wittpenn,Jersey City,--,per-per,PROPN-PROPN-PROPN,PROPN-PROPN,compound-compound-pobj,compound-pobj,NNP-NNP-NNP,NNP-NNP,4,1
5357,3555.0,14,was,1,4,7,3,3,6,-3,6,Judge,New York,,per-per,PROPN,PROPN-PROPN,attr,compound-compound,NNP,NNP-NNP,2,1
5358,3557.0,23,lives,2,16,21,5,15,1,-14,19,LA,Tulane University,per,-,PROPN,PROPN-PROPN,conj,compound-pobj,NNP,NNP-NNP,3,1
5359,3558.0,50,launched,5,5,11,6,4,38,0,6,Mogae,Botswana,,org,PROPN,PROPN,nsubj,dobj,NNP,NNP,4,1
5360,11763.0,21,retire,1,6,16,10,5,4,-5,15,Mogae,Botswana,org,,PROPN,PROPN,nsubj,compound,NNP,NNP,6,1
5361,3559.0,46,was,10,26,31,5,25,14,-16,21,nd Ante Markov,hen Prime Minis,per-per-per,--,PROPN-PROPN-PROPN,NOUN-PROPN-PROPN,compound-compound-ROOT,ROOT-compound-compound,NNP-NNP-NNP,NN-NNP-NNP,-1,1
5362,3560.0,22,been,3,8,8,0,7,13,-5,5,Estonia national basketball team,Estonia,---,org,PROPN-ADJ-NOUN-NOUN,PROPN,nmod-amod-compound-pobj,nsubj,NNP-JJ-NN-NN,NNP,0,1
5363,3561.0,20,exploring,2,13,17,4,12,2,-11,15,Arkansas Democratic Party,Bill Gwatney,--,org-org,PROPN-PROPN-PROPN,PROPN-PROPN,compound-compound-compound,compound-conj,NNP-NNP-NNP,NNP-NNP,3,1
5364,3562.0,41,broke,4,9,11,2,8,29,-5,7,Disney,Burbank,,per,PROPN,PROPN,poss,compound,NNP,NNP,2,1
5365,10305.0,25,said,16,18,23,5,17,1,-2,7,Disney,Burbank,org,,PROPN,PROPN,dobj,compound,NNP,NNP,6,1
5366,13488.0,19,financed,7,7,17,10,6,1,0,10,Disney,Burbank,per,,PROPN,PROPN,pobj,compound,NNP,NNP,5,1
5367,3564.0,19,met,3,5,12,7,4,6,-2,9,Anna Wintour,Vogue,-,per,PROPN-PROPN,PROPN,compound-dobj,pobj,NNP-NNP,NNP,2,1
5368,9232.0,25,said,10,2,9,7,1,15,8,-1,Anna Wintour,Vogue,-,per,PROPN-PROPN,PROPN,compound-compound,pobj,NNP-NNP,NNP,4,1
5369,10069.0,28,elicited,2,13,17,4,12,10,-11,15,Anna Wintour,Vogue,per-per,,PROPN-PROPN,PROPN,compound-dobj,pobj,NNP-NNP,NNP,4,1
5370,3565.0,14,is,3,1,13,12,0,0,2,10,Santo,Mexico,org,,PROPN,PROPN,compound,pobj,NNP,NNP,6,1
5371,3566.0,30,meet,3,18,27,9,17,2,-15,24,Taiwan,NCC,per,,PROPN,PROPN,poss,compound,NNP,NNP,11,1
5372,3568.0,29,sought,8,3,7,4,2,21,5,-1,Iowa,Tom Harkin,per,-,PROPN,PROPN-PROPN,poss,compound-appos,NNP,NNP-NNP,5,1
5373,4219.0,30,achieved,15,10,13,3,9,16,5,-2,Iowa,Tom Harkin,org,-,PROPN,PROPN-PROPN,nmod,compound-pobj,NNP,NNP-NNP,2,1
5374,11506.0,34,wrote,4,7,12,5,6,21,-3,8,Iowa,Tom Harkin,,org-org,PROPN,PROPN-PROPN,dobj,compound-compound,NNP,NNP-NNP,4,1
5375,3569.0,20,is,1,11,9,-2,10,10,-10,8,Pomona,Cal Poly Pomona Broncos,org,---,PROPN,PROPN-PROPN-PROPN-PROPN,poss,compound-compound-compound-appos,NNP,NNP-NNP-NNP-NNPS,2,1
5376,3571.0,28,is,4,4,22,18,3,5,0,18,VMI,US,per,,PROPN,PROPN,pobj,nmod,NNP,NNP,3,1
5377,3572.0,29,was,18,16,2,-14,15,26,2,-16,Mexico,Bravo,per,,PROPN,PROPN,compound,pobj,NNP,NNP,3,1
5378,3573.0,28,sits,1,1,8,7,0,19,0,7,He,Tierra del Fuego Province,org,---,PRON,PROPN-PROPN-PROPN-PROPN,nsubj,compound-compound-compound-dobj,PRP,NNP-NNP-NNP-NNP,3,1
5379,3575.0,28,led,10,17,19,2,16,8,-7,9,Lombardy,Roberto Formigoni,per,-,PROPN,PROPN-PROPN,compound,compound-pobj,NNP,NNP-NNP,2,1
5380,3576.0,16,return,4,7,10,3,6,5,-3,6,France,Faure,per,,PROPN,PROPN,pobj,poss,NNP,NNP,3,1
5381,3577.0,35,is,1,12,14,2,11,20,-11,13,oil group,Yukos,-,per,NOUN-NOUN,PROPN,compound-pobj,appos,NN-NN,NNP,5,1
5382,3578.0,22,endorsed,2,10,14,4,9,7,-8,12,Baltimore City,Curt Anderson,-,org-org,PROPN-PROPN,PROPN-PROPN,compound-compound,compound-pobj,NNP-NNP,NNP-NNP,3,1
5383,3579.0,22,discovered,2,7,8,1,6,13,-5,6,director,Ted Demme,per,-,NOUN,PROPN-PROPN,pobj,compound-appos,NN,NNP-NNP,1,1
5384,3581.0,31,featured,8,1,18,17,0,12,7,10,The Rolling Stones,Brian Jones,org-org-org,-,DET-PROPN-PROPN,PROPN-PROPN,det-compound-nsubj,compound-conj,DT-NNP-NNPS,NNP-NNP,8,1
5385,3582.0,16,put,3,9,14,5,8,1,-6,11,Speedway Motorsports,Bruton Smith,-,per-per,PROPN-PROPN,PROPN-PROPN,compound-compound,compound-conj,NNP-NNP,NNP-NNP,2,1
5386,3583.0,33,is,15,4,29,25,3,3,11,14,Prince Chichibu,Japan,org-org,,PROPN-PROPN,PROPN,compound-compound,compound,NNP-NNP,NNP,10,1
5387,3584.0,13,is,2,1,12,11,0,0,1,10,Bucaram,Ecuador,per,,PROPN,PROPN,compound,pobj,NNP,NNP,2,1
5388,3585.0,16,highlighted,8,4,7,3,3,8,4,-1,Paul Tsongas,Massachusetts,-,org,PROPN-PROPN,PROPN,compound-nsubj,appos,NNP-NNP,NNP,2,1
5389,8658.0,31,won,4,1,4,3,0,26,3,0,Paul Tsongas,Massachusetts,per-per,,PROPN-PROPN,PROPN,compound-nsubj,pobj,NNP-NNP,NNP,1,1
5390,3586.0,19,was,3,3,16,13,2,2,0,13,Eastwood,California,per,,PROPN,PROPN,nsubj,compound,NNP,NNP,7,1
5391,11226.0,19,received,5,5,18,13,4,0,0,13,Eastwood,California,,per,PROPN,PROPN,nsubj,pobj,NNP,NNP,1,1
5392,3588.0,14,signed,2,7,8,1,6,5,-5,6,President,Gloria Macapagal-Arroyo,,org-org,PROPN,PROPN-PROPN,compound,compound-pobj,NNP,NNP-NNP,2,1
5393,9400.0,40,sent,7,14,15,1,13,24,-7,8,President,Gloria Macapagal-Arroyo,per,-,PROPN,PROPN-PROPN,compound,compound-pobj,NNP,NNP-NNP,2,1
5394,12520.0,41,signed,7,5,6,1,4,34,2,-1,President,Gloria Macapagal-Arroyo,,org-org,PROPN,PROPN-PROPN,compound,compound-nsubj,NNP,NNP-NNP,2,1
5395,3589.0,31,recorded,1,16,19,3,15,11,-15,18,Brooklyn,Martin Bisi,,per-per,PROPN,PROPN-PROPN,pobj,compound-pobj,NNP,NNP-NNP,6,1
5396,3590.0,27,is,3,1,2,1,0,24,2,-1,Air New Zealand,New Zealand,--,org-org,PROPN-PROPN-PROPN,PROPN-PROPN,compound-compound-nsubj,compound-compound,NNP-NNP-NNP,NNP-NNP,1,1
5397,3591.0,35,is,1,9,22,13,8,12,-8,21,musician,Paul McCartney,,per-per,NOUN,PROPN-PROPN,compound,compound-pobj,NN,NNP-NNP,9,1
5398,3592.0,49,ordained,1,10,21,11,9,27,-9,20,Ziegler School of Rabbinic Studies,California,org-org-org-org-org,,PROPN-PROPN-ADP-PROPN-PROPN,PROPN,compound-appos-prep-compound-pobj,appos,NNP-NNP-IN-NNP-NNPS,NNP,5,1
5399,3593.0,27,is,2,9,16,7,8,10,-7,14,Freddie Hubbard,Blue Note,-,per-per,PROPN-PROPN,PROPN-PROPN,compound-pobj,compound-compound,NNP-NNP,NNP-NNP,7,1
5400,3595.0,34,said,15,1,10,9,0,23,14,-5,Albert Ho,China Human Rights Lawyers Concern Group,-,per-per-per-per-per-per,PROPN-PROPN,PROPN-PROPN-PROPN-PROPN-PROPN-PROPN,compound-nsubj,compound-compound-compound-compound-compound-pobj,NNP-NNP,NNP-NNP-NNPS-NNP-NNP-NNP,7,1
5401,3597.0,27,president,1,7,9,2,6,17,-6,8,Chicago,Walter S. Gurnee,,per-per-per,PROPN,PROPN-PROPN-PROPN,compound,compound-compound-nsubj,NNP,NNP-NNP-NNP,2,1
5402,3598.0,37,inaugurated,18,22,16,-6,21,20,-4,-2,Said Irandoust,AIT,-,org,PROPN-PROPN,PROPN,compound-compound,compound,NNP-NNP,NNP,5,1
5403,3599.0,34,was,3,8,26,18,7,7,-5,23,n Zvonko Pantovi,t; Osvaja,--,per-per,CCONJ-PROPN-PROPN,X-PROPN,intj-compound-attr,nmod-pobj,CC-NNP-NNP,XX-NNP,-1,1
5404,3600.0,17,is,1,11,15,4,10,1,-10,14,Peter Sellers,Britt Ekland,-,per-per,PROPN-PROPN,PROPN-PROPN,compound-pobj,compound-conj,NNP-NNP,NNP-NNP,7,1
5405,3602.0,14,is,1,1,13,12,0,0,0,12,It,Michigan,,per,PRON,PROPN,nsubj,pobj,PRP,NNP,1,1
5406,3603.0,29,attended,1,23,27,4,22,1,-22,26,Midhurst Grammar School,West Sussex,org-org-org,-,PROPN-PROPN-PROPN,PROPN-PROPN,compound-compound-appos,compound-pobj,NNP-NNP-NNP,NNP-NNP,3,1
5407,3604.0,38,include,2,5,27,22,4,10,-3,25,CNBC Pakistan,Pakistan,org-org,,PROPN-PROPN,PROPN,compound-pobj,pobj,NNP-NNP,NNP,7,1
5408,3605.0,25,selected,4,3,8,5,2,16,1,4,she,Greece,per,,PRON,PROPN,nsubjpass,dobj,PRP,NNP,3,1
5409,13914.0,24,gave,3,3,21,18,2,2,0,18,she,Greece,per,,PRON,PROPN,nsubj,pobj,PRP,NNP,3,1
5410,3606.0,21,formed,5,3,14,11,2,6,2,9,Denbighshire Hussars,United Kingdom,per-per,-,PROPN-PROPN,PROPN-PROPN,compound-nsubjpass,compound-pobj,NNP-NNP,NNP-NNP,4,1
5411,3607.0,21,elected,1,4,10,6,3,10,-3,9,Marc Ravalomanana,leader,per-per,,PROPN-PROPN,NOUN,compound-nsubjpass,compound,NNP-NNP,NN,6,1
5412,3608.0,29,known,5,1,27,26,0,1,4,22,Korea University,South Korea,per-per,-,PROPN-PROPN,PROPN-PROPN,compound-nsubjpass,compound-pobj,NNP-NNP,NNP-NNP,11,1
5413,3609.0,28,is,15,1,1,0,0,26,14,-14,Pennsylvania,Pennsylvania Department of Transportation,,per-per-per-per,PROPN,PROPN-PROPN-ADP-PROPN,compound,compound-pobj-prep-pobj,NNP,NNP-NNP-IN-NNP,0,1
5414,3610.0,19,located,5,2,10,8,1,8,3,5,Andy Griffith,North Carolina,-,per-per,PROPN-PROPN,PROPN-PROPN,compound-compound,compound-pobj,NNP-NNP,NNP-NNP,4,1
5415,3611.0,36,said,14,12,14,2,11,21,2,0,Finance,Carstens,org,,PROPN,PROPN,compound,conj,NNP,NNP,6,1
5416,4808.0,19,appointed,10,13,18,5,12,0,-3,8,Finance,Carstens,org,,PROPN,PROPN,compound,pobj,NNP,NNP,2,1
5417,3615.0,30,included,5,4,11,7,3,18,1,6,Istanbul,Revolution Brigades,,org-org,PROPN,PROPN-PROPN,compound,compound-pobj,NNP,NNP-NNPS,6,1
5418,3616.0,21,announced,4,6,19,13,5,1,-2,15,Lee Ranaldo,Sonic Youth,per-per,-,PROPN-PROPN,PROPN-PROPN,compound-nsubj,compound-pobj,NNP-NNP,NNP-NNP,8,1
5419,3617.0,27,made,1,8,9,1,7,17,-7,8,U.S. Lecce,Lecce,per-per,,PROPN-PROPN,PROPN,compound-pobj,pobj,NNP-NNP,NNP,4,1
5420,11287.0,30,signed,4,7,8,1,6,21,-3,4,U.S. Lecce,Lecce,-,org,PROPN-PROPN,PROPN,compound-pobj,nsubj,NNP-NNP,NNP,3,1
5421,3618.0,24,is,10,6,17,11,5,6,4,7,Richard Carpenter,Carpenters,-,per,PROPN-PROPN,PROPN,compound-pobj,pobj,NNP-NNP,NNPS,5,1
5422,5452.0,19,written,8,3,18,15,2,0,5,10,Richard Carpenter,Carpenters,-,per,PROPN-PROPN,PROPN,compound-nsubj,pobj,NNP-NNP,NNPS,2,1
5423,3619.0,35,bought,5,9,9,0,8,25,-4,4,Armstrong Whitworth,Armstrong Siddeley,-,org-org,PROPN-PROPN,PROPN-PROPN,compound-compound,compound-compound,NNP-NNP,NNP-NNP,0,1
5424,3620.0,54,reported,52,1,15,14,0,38,51,-37,Maung Aye,SPDC,per-per,,PROPN-PROPN,PROPN,compound-nsubj,appos,NNP-NNP,NNP,6,1
5425,11962.0,33,control,29,22,32,10,21,0,7,3,Maung Aye,SPDC,org-org,,PROPN-PROPN,NOUN,compound-nsubj,dobj,NNP-NNP,NNS,5,1
5426,12618.0,11,was,2,1,10,9,0,0,1,8,Maung Aye,SPDC,org-org,,PROPN-PROPN,NOUN,compound-nsubj,pobj,NNP-NNP,NNS,5,1
5427,3621.0,22,spent,1,11,20,9,10,1,-10,19,Salk Institute,Jacob Bronowski,-,per-per,PROPN-PROPN,PROPN-PROPN,compound-pobj,compound-appos,NNP-NNP,NNP-NNP,5,1
5428,3622.0,29,won,10,19,23,4,18,5,-9,13,Keith Bain,Progressive Conservative,-,per-per,PROPN-PROPN,PROPN-PROPN,compound-pobj,compound-compound,NNP-NNP,NNP-NNP,3,1
5429,3623.0,26,completed,1,11,14,3,10,11,-10,13,Clark University,Arthur Gordon Webster,per-per,--,PROPN-PROPN,PROPN-PROPN-PROPN,compound-pobj,compound-compound-pobj,NNP-NNP,NNP-NNP-NNP,3,1
5430,3624.0,22,is,8,1,2,1,0,19,7,-6,FC Punjab Police,Punjab,org-org-org,,PROPN-PROPN-PROPN,PROPN,compound-compound-nsubj,pobj,NNP-NNP-NNP,NNP,1,1
5431,8589.0,32,played,19,15,16,1,14,15,4,-3,FC Punjab Police,Punjab,per-per-per,,PROPN-PROPN-PROPN,PROPN,compound-compound-compound,pobj,NNP-NNP-NNP,NNP,2,1
5432,3625.0,24,founded,3,1,19,18,0,4,2,16,Monitor Group,Mark Fuller,org-org,-,PROPN-PROPN,PROPN-PROPN,compound-nsubjpass,compound-pobj,NNP-NNP,NNP-NNP,9,1
5433,3626.0,28,find,12,19,26,7,18,1,-7,14,he,Episode Six,per,-,PRON,PROPN-NUM,nsubj,compound-dobj,PRP,NNP-CD,3,1
5434,3627.0,63,occurred,8,7,30,23,6,32,1,22,Joey Kramer,Aerosmith,org-org,,PROPN-PROPN,ADJ,compound-pobj,ROOT,NNP-NNP,JJ,5,1
5435,3629.0,40,stayed,4,1,13,12,0,26,3,9,Thirsty Ear,Matthew Shipp,org-org,-,PROPN-PROPN,PROPN-PROPN,compound-compound,compound-dobj,NNP-NNP,NNP-NNP,4,1
5436,3630.0,38,was,1,16,16,0,15,21,-15,15,Novosibirsk,Novosibirsk State University,,org-org-org,PROPN,PROPN-PROPN-PROPN,pobj,compound-compound-pobj,NNP,NNP-NNP-NNP,0,1
5437,3631.0,34,lost,1,18,33,15,17,0,-17,32,Stanley Baldwin,Worcestershire,per-per,,PROPN-PROPN,PROPN,compound-pobj,pobj,NNP-NNP,NNP,8,1
5438,3632.0,33,Born,0,16,21,5,15,11,-16,21,Henry Irving,Florence,-,per,PROPN-PROPN,PROPN,compound-appos,appos,NNP-NNP,NNP,3,1
5439,3633.0,8,promotes,1,1,3,2,0,4,0,2,GlaxoSmithKline,Andrew Witty,,per-per,NOUN,PROPN-PROPN,nsubj,compound-dobj,NN,NNP-NNP,1,1
5440,3634.0,42,see,6,30,40,10,29,1,-24,34,Austrian,Sigmund Freud,per,-,ADJ,PROPN-PROPN,amod,compound-pobj,JJ,NNP-NNP,3,1
5441,3635.0,30,replaced,5,13,27,14,12,2,-8,22,Atlantic Southeast Airlines,Republic Airways Holdings,--,per-per-per,PROPN-PROPN-PROPN,PROPN-PROPN-PROPN,compound-compound-pobj,compound-compound-pobj,NNP-NNP-NNPS,NNP-NNP-NNPS,10,1
5442,3636.0,6,Carr,1,1,4,3,0,1,0,3,Eric Carr,Kiss,-,org,PROPN-PROPN,PROPN,compound-ROOT,appos,NNP-NNP,NNP,2,1
5443,3637.0,42,is,8,18,20,2,17,21,-10,12,England,Brian Blessed,per,-,PROPN,PROPN-PROPN,pobj,compound-ROOT,NNP,NNP-NNP,1,1
5444,3639.0,63,Image,0,19,20,1,18,42,-19,20,State,Jeremiah S. Black,per,--,PROPN,PROPN-PROPN-PROPN,pobj,compound-compound-appos,NNP,NNP-NNP-NNP,2,1
5445,3640.0,59,graduated,4,7,23,16,6,35,-3,19,BYU,United States,org,-,PROPN,PROPN-PROPN,pobj,compound-compound,NNP,NNP-NNP,8,1
5446,3641.0,24,co-founded,2,5,13,8,4,10,-3,11,Institute for Systems Biology,Ruedi Aebersold,per-per-per-per,-,PROPN-ADP-PROPN-PROPN,PROPN-PROPN,dobj-prep-compound-pobj,compound-conj,NNP-IN-NNP-NNP,NNP-NNP,5,1
5447,3642.0,18,is,6,2,17,15,1,0,4,11,University of Catania,1434,--,per,PROPN-ADP-PROPN,NUM,nsubj-prep-pobj,pobj,NNP-IN-NNP,CD,3,1
5448,3643.0,28,formed,5,4,25,21,3,2,1,20,GIGN,National Gendarmerie,per,-,PROPN,PROPN-PROPN,pobj,compound-pobj,NNP,NNP-NNP,5,1
5449,3645.0,22,served,2,1,12,11,0,9,1,10,He,National Defense,org,-,PRON,PROPN-PROPN,nsubj,compound-pobj,PRP,NNP-NNP,7,1
5450,3646.0,51,described,6,2,35,33,1,15,4,29,BNP,Chris Jackson,org,-,ADJ,PROPN-PROPN,nmod,compound-pobj,JJ,NNP-NNP,7,1
5451,3648.0,31,went,9,9,30,21,8,0,0,21,Ed,England,per,,PROPN,PROPN,pobj,pobj,NNP,NNP,1,1
5452,3650.0,11,Sending,0,6,10,4,5,0,-6,10,Tiffany,California,,per,PROPN,PROPN,pobj,pobj,NNP,NNP,4,1
5453,9613.0,29,be,4,10,17,7,9,11,-6,13,Tiffany,California,per,,PROPN,PROPN,pobj,poss,NNP,NNP,6,1
5454,3652.0,37,stated,2,6,20,14,5,16,-4,18,McGuinness,U2,per,,PROPN,PROPN,nsubj,nsubj,NNP,NNP,5,1
5455,3653.0,30,was,9,8,18,10,7,11,1,9,RAC,Army,per,,PROPN,PROPN,appos,poss,NNP,NNP,7,1
5456,3654.0,44,formed,3,1,1,0,0,42,2,-2,Leeds Student,Leeds University Union,org-org,--,PROPN-PROPN,PROPN-PROPN-PROPN,compound-nsubjpass,compound-compound-compound,NNP-NNP,NNP-NNP-NNP,0,1
5457,3655.0,15,was,2,1,7,6,0,7,1,5,Capstone Software,IntraCorp,-,per,PROPN-PROPN,PROPN,compound-nsubj,pobj,NNP-NNP,NNP,6,1
5458,3656.0,16,is,3,1,13,12,0,2,2,10,The Missouri Review,University of Missouri,--,org-org-org,DET-PROPN-PROPN,PROPN-ADP-PROPN,det-compound-nsubj,pobj-prep-pobj,DT-NNP-NNP,NNP-IN-NNP,7,1
5459,3657.0,22,announced,8,7,8,1,6,13,1,0,RWE,npower,,org,PROPN,NOUN,conj,nsubj,NNP,NN,3,1
5460,3658.0,14,is,6,2,13,11,1,0,4,7,University,Tunisia,,per,PROPN,PROPN,nsubj,pobj,NNP,NNP,3,1
5461,3659.0,48,known,4,38,21,-17,37,26,-34,17,Margaret Spellings,Education,per-per,,PROPN-PROPN,PROPN,compound-poss,pobj,NNP-NNP,NNP,11,1
5462,3660.0,20,was,6,1,5,4,0,14,5,-1,Teaneck High School,Angela Davis,--,per-per,PROPN-PROPN-PROPN,PROPN-PROPN,compound-compound-compound,compound-nsubj,NNP-NNP-NNP,NNP-NNP,3,1
5463,3661.0,23,were,9,1,17,16,0,5,8,8,Ahmed Rushdi-Nisar Bazmi,director,org-org-org,,PROPN-PROPN-PROPN,NOUN,amod-compound-compound,compound,NNP-NNP-NNP,NN,9,1
5464,3663.0,25,moved,6,10,22,12,9,2,-4,16,England,Talbot Heath School,org,--,PROPN,PROPN-PROPN-PROPN,pobj,compound-compound-conj,NNP,NNP-NNP-NNP,6,1
5465,3664.0,13,competes,1,1,9,8,0,3,0,8,Westmont,Illinois,,org,PROPN,PROPN,compound,compound,NNP,NNP,5,1
5466,3665.0,29,announced,3,1,17,16,0,11,2,14,Paris,Dominique de Villepin,,per-per-per,PROPN,PROPN-X-PROPN,nmod,compound-compound-dobj,NNP,NNP-FW-NNP,8,1
5467,3666.0,15,Corporate,1,10,13,3,9,1,-9,12,Walt Disney,Burbank,per-per,,PROPN-PROPN,PROPN,compound-compound,compound,NNP-NNP,NNP,2,1
5468,3667.0,45,Among,0,8,16,8,7,28,-8,16,Lee Myung-bak,GNP,org-org,,PROPN-PROPN,PROPN,appos-pobj,appos,NNP-NNP,NNP,5,1
5469,3668.0,28,endeavored,4,22,23,1,21,4,-18,19,President,Hamid Karzai,per,-,PROPN,PROPN-PROPN,compound,compound-pobj,NNP,NNP-NNP,2,1
5470,5332.0,32,was,1,15,16,1,14,15,-14,15,President,Hamid Karzai,org,-,PROPN,PROPN-PROPN,compound,compound-nsubj,NNP,NNP-NNP,1,1
5471,13652.0,22,stated,10,19,20,1,18,1,-9,10,President,Hamid Karzai,org,-,PROPN,PROPN-PROPN,compound,compound-pobj,NNP,NNP-NNP,1,1
5472,3669.0,23,University,1,1,8,7,0,14,0,7,Khost University,Shaikh Zayed University,per-per,--,PROPN-PROPN,PROPN-PROPN-PROPN,compound-ROOT,compound-compound-appos,NNP-NNP,NNP-NNP-NNP,3,1
5473,3670.0,35,EXCERPT,1,13,17,4,12,17,-12,16,United States,Liberty,-,per,PROPN-PROPN,PROPN,compound-compound,compound,NNP-NNP,NNP,3,1
5474,3672.0,38,included,3,26,31,5,25,6,-23,28,Robin Ray,Susan Stranks,-,per-per,PROPN-PROPN,PROPN-PROPN,compound-compound,compound-conj,NNP-NNP,NNP-NNP,2,1
5475,3673.0,36,took,8,3,24,21,2,11,5,16,Conservative Party of Canada,Stephen Harper,per-per-per-per,-,PROPN-PROPN-ADP-PROPN,PROPN-PROPN,compound-nmod-prep-pobj,compound-pobj,NNP-NNP-IN-NNP,NNP-NNP,7,1
5476,3674.0,25,lets,7,4,6,2,3,18,3,-1,E-Loan,Chris Larsen,,org-org,PROPN,PROPN-PROPN,compound,compound-pobj,NNP,NNP-NNP,1,1
5477,3675.0,38,Waggener,0,5,8,3,4,29,-5,8,Citrus College,Glendora,org-org,,PROPN-PROPN,PROPN,compound-pobj,compound,NNP-NNP,NNP,3,1
5478,3676.0,34,brings,14,10,31,21,9,2,4,17,Trinity Western University,Canada,--,org,PROPN-PROPN-PROPN,PROPN,compound-compound-compound,poss,NNP-NNP-NNP,NNP,12,1
5479,3677.0,29,has,1,1,13,12,0,15,0,12,Myanmar,TV Myanmar,,org-org,PROPN,NOUN-PROPN,nsubj,compound-ROOT,NNP,NN-NNP,4,1
5480,3678.0,29,Dazed,14,4,11,7,3,17,10,-3,he,musician,,org,PRON,NOUN,nsubj,pobj,PRP,NN,3,1
5481,3679.0,50,try,7,44,49,5,43,0,-37,42,Allstate,Illinois,org,,PROPN,PROPN,compound,pobj,NNP,NNP,3,1
5482,3680.0,27,July,0,6,6,0,5,20,-6,6,Sudan Airways,Sudan,per-per,,PROPN-PROPN,PROPN,compound-compound,compound,NNP-NNP,NNP,0,1
5483,3681.0,24,been,6,12,23,11,11,0,-6,17,Cochin University of Science and Technology,Kerala,org-org-org-org-org-org,,PROPN-PROPN-ADP-PROPN-CCONJ-PROPN,PROPN,compound-pobj-prep-pobj-cc-conj,pobj,NNP-NNP-IN-NNP-CC-NNP,NNP,5,1
5484,3682.0,20,pardoned,4,2,3,1,1,16,2,-1,President,Vladimir Putin,per,-,PROPN,PROPN-PROPN,compound,compound-nsubj,NNP,NNP-NNP,1,1
5485,13252.0,39,Fagnidi,0,15,16,1,14,22,-15,16,President,Vladimir Putin,per,-,PROPN,PROPN-PROPN,compound,compound-pobj,NNP,NNP-NNP,1,1
5486,3683.0,27,became,3,3,18,15,2,8,0,15,he,Afghanistan,org,,PRON,PROPN,nsubj,pobj,PRP,NNP,7,1
5487,3685.0,28,served,1,8,24,16,7,3,-7,23,Scots Guards,Army,-,org,PROPN-PROPN,PROPN,compound-pobj,pobj,NNPS-NNPS,NNP,-1,1
5488,3686.0,18,was,3,13,14,1,12,3,-10,11,King,Edward IV of England,,per-per-per-per,PROPN,PROPN-PROPN-ADP-PROPN,compound,compound-pobj-prep-pobj,NNP,NNP-NNP-IN-NNP,1,1
5489,3687.0,28,entered,6,19,25,6,18,2,-13,19,Newport Television,Providence Equity Partners,org-org,--,PROPN-PROPN,PROPN-PROPN-PROPN,compound-pobj,compound-compound-pobj,NNP-NNP,NNP-NNP-NNPS,7,1
5490,9905.0,35,entered,6,20,32,12,19,2,-14,26,Newport Television,Providence Equity Partners,per-per,--,PROPN-PROPN,PROPN-PROPN-PROPN,compound-pobj,compound-compound-appos,NNP-NNP,NNP-NNP-NNPS,7,1
5491,10236.0,43,Communications,6,28,40,12,27,2,-22,34,Newport Television,Providence Equity Partners,org-org,--,PROPN-PROPN,PROPN-PROPN-PROPN,compound-pobj,compound-compound-appos,NNP-NNP,NNP-NNP-NNPS,7,1
5492,3688.0,41,opened,3,3,19,16,2,21,0,16,VGH,British Columbia,per,-,PROPN,PROPN-PROPN,nsubj,compound-pobj,NNP,NNP-NNP,10,1
5493,3689.0,27,known,5,2,19,17,1,7,3,14,Swindon Robins,1949,-,per,PROPN-PROPN,NUM,compound-nsubj,pobj,NNP-NNPS,CD,6,1
5494,3690.0,43,entered,4,16,31,15,15,11,-12,27,Network,MTV,org,,PROPN,PROPN,pobj,compound,NNP,NNP,9,1
5495,3691.0,17,is,1,6,6,0,5,10,-5,5,Mississippi Army National Guard,Mississippi,org-org-org-org,,PROPN-PROPN-PROPN-PROPN,PROPN,compound-compound-compound-pobj,compound,NNP-NNP-NNP-NNP,NNP,0,1
5496,3692.0,36,was,2,1,12,11,0,23,1,10,Her,Mexico,,per,DET,PROPN,poss,pobj,PRP$,NNP,9,1
5497,3693.0,38,included,6,24,32,8,23,5,-18,26,Germany,Gotthard Graubner,,per-per,PROPN,PROPN-PROPN,pobj,compound-pobj,NNP,NNP-NNP,4,1
5498,3694.0,27,took,6,3,26,23,2,0,3,20,McClory,Ireland,org,,PROPN,PROPN,nsubj,pobj,NNP,NNP,4,1
5499,3695.0,24,contained,5,1,2,1,0,21,4,-3,Sonny Cher,Cher,org-org,,PROPN-PROPN,PROPN,compound-poss,poss,NNP-NNP,NNP,1,1
5500,3696.0,25,?eslovas,0,1,19,18,0,5,-1,19,?eslovas,he Seim,org,-,PUNCT,PRON-PROPN,ROOT,nsubj-relcl,",",PRP-NNP,5,1
5501,13267.0,32,proposed,10,13,19,6,12,12,-3,9,?eslovas,he Seim,,org-org,NOUN,PRON-PROPN,punct,nsubj-advcl,NNS,PRP-NNP,4,1
5502,3697.0,36,said,30,4,13,9,3,22,26,-17,Al-Waleed bin Talal,Kingdom Holding company,org-org-org,--,PROPN-PROPN-PROPN,PROPN-PROPN-NOUN,punct-compound-nsubj,compound-compound-pobj,NNP-NNP-NNP,NNP-NNP-NN,7,1
5503,3698.0,61,provided,17,7,11,4,6,49,10,-6,CP,Canadian Pacific Airlines,,org-org-org,PROPN,PROPN-PROPN-PROPN,compound,compound-compound-appos,NNP,NNP-NNP-NNPS,2,1
5504,3701.0,23,opened,7,2,6,4,1,16,5,-1,Spalding University,Nazareth College,org-org,-,PROPN-PROPN,PROPN-PROPN,compound-nsubj,compound-oprd,NNP-NNP,NNP-NNP,2,1
5505,3702.0,22,have,6,12,20,8,11,1,-6,14,Per Schlingmann,Moderate Party,org-org,-,ADP-PROPN,PROPN-PROPN,prep-pobj,compound-pobj,IN-NNP,NNP-NNP,6,1
5506,3705.0,21,released,5,5,19,14,4,1,0,14,Canada,Michelle Wright,,per-per,PROPN,PROPN-PROPN,nsubj,compound-pobj,NNP,NNP-NNP,4,1
5507,3706.0,25,was,4,8,1,-7,7,23,-4,-3,Prince,The Revolution,,org-org,PROPN,DET-PROPN,pobj,det-pobj,NNP,DT-NNP,6,1
5508,3707.0,12,recorded,1,1,11,10,0,0,0,10,Parker,Verve,,per,PROPN,PROPN,nsubj,conj,NNP,NNP,1,1
5509,3709.0,36,seen,8,28,33,5,27,2,-20,25,Hedda Hopper,DeWolf Hopper,org-org,-,PROPN-PROPN,PROPN-PROPN,compound-pobj,compound-conj,NNP-NNP,NNP-NNP,3,1
5510,3710.0,23,moved,3,6,19,13,5,3,-3,16,Sudbury,Laurentian University,org,-,PROPN,PROPN-PROPN,compound,compound-pobj,NNP,NNP-NNP,9,1
5511,3711.0,19,is,3,1,1,0,0,17,2,-2,Klein High School,Klein,org-org-org,,PROPN-PROPN-PROPN,PROPN,compound-compound-nsubj,compound,NNP-NNP-NNP,NNP,0,1
5512,3712.0,14,include,4,11,13,2,10,0,-7,9,Quebec,Godbout,,org,PROPN,PROPN,conj,appos,NNP,NNP,3,1
5513,3713.0,25,pledged,9,5,17,12,4,7,4,8,GEO Group,George Zoley,per-per,-,PROPN-PROPN,PROPN-PROPN,compound-poss,compound-poss,NNP-NNP,NNP-NNP,5,1
5514,3714.0,61,cleaned,1,40,41,1,39,19,-39,40,Treasury,Benjamin H. Bristow,,per-per-per,PROPN,PROPN-PROPN-PROPN,pobj,compound-compound-nsubj,NNP,NNP-NNP-NNP,1,1
5515,3715.0,19,became,3,3,14,11,2,4,0,11,she,Oregon House,per,-,PRON,PROPN-PROPN,nsubj,compound-pobj,PRP,NNP-NNP,6,1
5516,3716.0,34,said,7,5,9,4,4,24,2,2,Susilo Bambang Yudhoyono,Indonesia,org-org-org,,PROPN-PROPN-PROPN,PROPN,compound-compound-nsubj,nsubj,NNP-NNP-NNP,NNP,3,1
5517,3717.0,44,born,2,9,19,10,8,24,-7,17,Brandon High School,Florida,per-per-per,,PROPN-PROPN-PROPN,PROPN,compound-compound-pobj,pobj,NNP-NNP-NNP,NNP,7,1
5518,3718.0,46,stated,6,43,44,1,42,1,-37,38,President,Michel Suleiman,,org-org,PROPN,PROPN-PROPN,compound,compound-dobj,NNP,NNP-NNP,1,1
5519,10001.0,27,welcomed,4,11,12,1,10,14,-7,8,President,Michel Suleiman,,per-per,PROPN,PROPN-PROPN,compound,compound-compound,NNP,NNP-NNP,1,1
5520,12543.0,27,highlighted,4,2,3,1,1,23,2,-1,President,Michel Suleiman,,org-org,PROPN,PROPN-PROPN,compound,compound-nsubj,NNP,NNP-NNP,1,1
5521,12823.0,22,wore,1,9,10,1,8,11,-8,9,President,Michel Suleiman,per,-,PROPN,PROPN-PROPN,compound,compound-pobj,NNP,NNP-NNP,1,1
5522,3719.0,26,supposed,2,6,15,9,5,10,-4,13,Emperor,Heraclius,,org,PROPN,PROPN,nsubj,attr,NNP,NNP,5,1
5523,3720.0,31,is,9,1,18,17,0,12,8,9,Lee Hsien Loong,Singapore,--,per,PROPN-PROPN-PROPN,PROPN,compound-compound-nsubj,pobj,NNP-NNP-NNP,NNP,4,1
5524,3722.0,40,featured,4,18,37,19,17,2,-14,33,Ultra Violet,designer,org-org,,PROPN-PROPN,NOUN,compound-pobj,conj,NNP-NNP,NN,8,1
5525,3723.0,41,affiliated,4,13,24,11,12,16,-9,20,St. Petro Mohyla Institute,Saskatoon,---,org,PROPN-PROPN-PROPN-PROPN,PROPN,compound-compound-compound-ROOT,compound,NNP-NNP-NNP-NNP,NNP,4,1
5526,3724.0,23,is,6,5,18,13,4,4,1,12,Amarinder Singh,Punjab,-,per,PROPN-PROPN,PROPN,compound-nsubj,pobj,NNP-NNP,NNP,7,1
5527,11996.0,34,succeeded,2,8,29,21,7,4,-6,27,Amarinder Singh,Punjab,-,per,PROPN-PROPN,PROPN,compound-appos,pobj,NNP-NNP,NNP,5,1
5528,12891.0,41,followed,15,22,29,7,21,11,-7,14,Amarinder Singh,Punjab,-,per,PROPN-PROPN,PROPN,compound-pobj,compound,NNP-NNP,NNP,6,1
5529,13969.0,20,are,13,2,7,5,1,12,11,-6,Amarinder Singh,Punjab,org-org,,PROPN-PROPN,PROPN,compound-nsubj,appos,NNP-NNP,NNP,2,1
5530,14080.0,34,is,1,20,33,13,19,0,-19,32,Amarinder Singh,Punjab,org-org,,PROPN-PROPN,PROPN,compound-pobj,pobj,NNP-NNP,NNP,6,1
5531,3726.0,48,is,9,1,19,18,0,28,8,10,Inara Maryland George,The Bird and the Bee,--,per-per-per-per-per,PROPN-PROPN-PROPN,DET-PROPN-CCONJ-DET-PROPN,compound-compound-nsubj,det-pobj-cc-det-conj,NNP-NNP-NNP,DT-NNP-CC-DT-NNP,5,1
5532,3727.0,53,educated,9,45,48,3,44,4,-36,39,1992-5,University of Salford,per,--,PROPN,PROPN-ADP-PROPN,pobj,conj-prep-pobj,NNP,NNP-IN-NNP,9,1
5533,3728.0,38,announced,8,30,34,4,29,3,-22,26,RAR,Australia,per,,PROPN,PROPN,appos,pobj,NNP,NNP,3,1
5534,3729.0,40,had,36,30,34,4,29,5,6,-2,Harris Bank,Chicago,per-per,,PROPN-PROPN,PROPN,compound-conj,pobj,NNP-NNP,NNP,3,1
5535,3730.0,38,served,2,22,30,8,21,7,-20,28,France,American Graduate School of International Relations and Diplomacy,per,-------,PROPN,PROPN-PROPN-PROPN-ADP-PROPN-PROPN-CCONJ-PROPN,pobj,compound-compound-pobj-prep-compound-pobj-cc-conj,NNP,NNP-NNP-NNP-IN-NNP-NNPS-CC-NNP,6,1
5536,3732.0,75,Kass,16,27,31,4,26,43,-11,15,Tulane University,LA,org-org,,PROPN-PROPN,PROPN,compound-compound,appos,NNP-NNP,NNP,2,1
5537,6388.0,37,Interviews,0,31,35,4,30,1,-31,35,Tulane University,LA,per-per,,PROPN-PROPN,PROPN,compound-appos,ROOT,NNP-NNP,NNP,2,1
5538,3733.0,13,favored,3,5,12,7,4,0,-2,9,Cho Chikun,Japan,-,per,PROPN-PROPN,PROPN,compound-dobj,pobj,NNP-NNP,NNP,2,1
5539,3735.0,18,Royal,2,2,17,15,1,0,0,15,Joe,singer,,per,PROPN,NOUN,compound,attr,NNP,NN,2,1
5540,3736.0,24,built,6,2,10,8,1,13,4,4,network,Leslie Moonves,per,-,NOUN,PROPN-VERB,poss,compound-nsubj,NN,NNP-VBZ,5,1
5541,3737.0,9,is,1,1,8,7,0,0,0,7,Vaksalaskolan,Sweden,per,,PROPN,PROPN,nsubj,pobj,NNP,NNP,1,1
5542,3738.0,14,said,12,11,12,1,10,1,1,0,Ali,Hasan,org,,PROPN,PROPN,compound,appos,NNP,NNP,1,1
5543,3740.0,35,founded,2,22,34,12,21,0,-20,32,Redcats,PPR,,per,PROPN,PROPN,compound,pobj,NNP,NNP,5,1
5544,3741.0,16,born,3,1,7,6,0,8,2,4,Hughes,England,per,,PROPN,PROPN,nsubjpass,pobj,NNP,NNP,2,1
5545,3742.0,32,disposed,2,5,26,21,4,5,-3,24,China Resources,Hong Kong,per-per,-,PROPN-PROPN,PROPN-PROPN,compound-compound,compound-pobj,NNP-NNP,NNP-NNP,5,1
5546,3743.0,25,born,3,1,9,8,0,15,2,6,Dov Feigin,Ukraine,per-per,,PROPN-PROPN,PROPN,compound-nsubjpass,pobj,NNP-NNP,NNP,3,1
5547,3744.0,26,launched,1,1,7,6,0,18,0,6,Ryanair,October 2006,org,-,NOUN,PROPN-NUM,nsubj,pobj-nummod,NN,NNP-CD,3,1
5548,3745.0,26,headed,9,9,19,10,8,6,0,10,Corps,V Corps,per,-,PROPN,PROPN-PROPN,nsubj,compound-nsubj,NNP,NNP-NNP,4,1
5549,3746.0,23,says,8,1,5,4,0,17,7,-3,Eric Mabius,ABC,-,per,PROPN-PROPN,PROPN,compound-compound,poss,NNP-NNP,NNP,4,1
5550,3748.0,33,born,27,7,11,4,6,21,20,-16,Sophia Loren,Sofia Villani Scicolone,-,org-org-org,PROPN-PROPN,PROPN-PROPN-NOUN,compound-pobj,compound-compound-dobj,NNP-NNP,NNP-NNP-NN,2,1
5551,3750.0,55,transformed,24,6,9,3,5,45,18,-15,Commercial Bank of China,China Development Bank,org-org-org-org,--,PROPN-PROPN-ADP-PROPN,PROPN-PROPN-PROPN,conj-nmod-prep-pobj,compound-compound-conj,NNP-NNP-IN-NNP,NNP-NNP-NNP,2,1
5552,3752.0,18,is,1,1,16,15,0,1,0,15,Khaddam,Baniyas,,per,PROPN,PROPN,nsubj,compound,NNP,NNP,9,1
5553,3753.0,14,operates,9,1,5,4,0,8,8,-4,Kaiser Permanente,California,org-org,,PROPN-PROPN,PROPN,compound-nsubj,nmod,NNP-NNP,NNP,3,1
5554,3754.0,46,presented,30,8,25,17,7,20,22,-5,G. Wayne Clough,Georgia Institute of Technology,per-per-per,---,PROPN-PROPN-PROPN,PROPN-PROPN-ADP-PROPN,compound-compound-compound,compound-pobj-prep-pobj,NNP-NNP-NNP,NNP-NNP-IN-NNP,7,1
5555,3755.0,38,left,3,20,26,6,19,11,-17,23,Bruce Bodaken,Blue Shield of California,per-per,---,PROPN-PROPN,PROPN-PROPN-ADP-PROPN,nsubj-ccomp,compound-pobj-prep-pobj,NNP-NNP,NNP-NNP-IN-NNP,5,1
5556,3756.0,23,was,1,7,19,12,6,3,-6,18,George I of Great Britain,Sophia Dorothea of Celle,per-per-per-per-per,---,PROPN-PRON-ADP-PROPN-PROPN,PROPN-PROPN-ADP-PROPN,appos-appos-prep-compound-pobj,compound-conj-prep-pobj,NNP-PRP-IN-NNP-NNP,NNP-NNP-IN-NNP,8,1
5557,3757.0,27,added,25,1,6,5,0,20,24,-19,Soe Win,Burma,org-org,,PROPN-PROPN,PROPN,compound-nsubj,pobj,NNP-NNP,NNP,2,1
5558,3758.0,21,represented,7,3,3,0,2,17,4,-4,Iowa State Cyclones,Iowa State University,org-org-org,--,PROPN-PROPN-PROPN,PROPN-PROPN-PROPN,compound-compound-compound,compound-compound-dobj,NNP-NNP-NNPS,NNP-NNP-NNP,0,1
5559,3759.0,38,attended,7,9,14,5,8,23,-2,7,Friends Pacific Academy,George Fox University,per-per-per,--,PROPN-PROPN-PROPN,PROPN-PROPN-PROPN,compound-compound-dobj,compound-compound-appos,NNP-NNP-NNP,NNP-NNP-NNP,3,1
5560,3760.0,22,ended,2,2,11,9,1,10,0,9,band,Lava,,per,NOUN,PROPN,nsubj,compound,NN,NNP,3,1
5561,3761.0,39,includes,3,17,22,5,16,16,-14,19,actress,Victoria Rowell,org,-,NOUN,PROPN-PROPN,nsubj,compound-appos,NN,NNP-NNP,3,1
5562,3762.0,36,is,7,11,12,1,10,23,-4,5,de Radio-Canada,Radio-Canada,per-per,,X-PROPN,PROPN,nmod-compound,amod,FW-NNP,NNP,2,1
5563,3763.0,39,upgraded,4,28,28,0,27,10,-24,24,Universiti Pertanian Malaysia,Universiti Putra Malaysia,org-org-org,--,PROPN-PROPN-PROPN,PROPN-PROPN-PROPN,compound-compound-pobj,compound-compound-pobj,NNP-NNP-NNP,NNP-NNP-NNP,0,1
5564,3766.0,31,Wei,3,10,11,1,9,19,-7,8,President,Chiang Ching-kuo,org,-,PROPN,PROPN-PROPN,compound,pobj-nummod,NNP,NNP-NNP,2,1
5565,3767.0,44,1,4,35,2,-33,34,41,-31,-2,Premier League,Manchester United,per-per,-,PROPN-PROPN,PROPN-PROPN,compound-dobj,compound-appos,NNP-NNP,NNP-NNP,7,1
5566,3768.0,32,says,5,18,27,9,17,4,-13,22,Charlottesville,Thomas Jefferson,per,-,PROPN,PROPN-PROPN,compound,compound-appos,NNP,NNP-NNP,9,1
5567,3769.0,28,urged,8,1,5,4,0,22,7,-3,Singapore,Lee Hsien Loong,per,--,PROPN,PROPN-PROPN-PROPN,poss,compound-compound-nsubj,NNP,NNP-NNP-NNP,4,1
5568,4927.0,38,Zaobao,1,5,8,3,4,29,-4,7,Singapore,Lee Hsien Loong,per,--,PROPN,PROPN-PROPN-PROPN,compound,compound-compound-nsubj,NNP,NNP-NNP-NNP,3,1
5569,8453.0,37,is,30,17,28,11,16,8,13,-2,Singapore,Lee Hsien Loong,,per-per-per,PROPN,PROPN-PROPN-PROPN,pobj,compound-compound-conj,NNP,NNP-NNP-NNP,7,1
5570,10796.0,23,wrote,13,1,9,8,0,13,12,-4,Singapore,Lee Hsien Loong,,per-per-per,PROPN,PROPN-PROPN-PROPN,compound,compound-compound-conj,NNP,NNP-NNP-NNP,3,1
5571,12710.0,26,was,2,4,1,-3,3,24,-2,-1,Singapore,Lee Hsien Loong,org,--,PROPN,PROPN-PROPN-PROPN,poss,compound-compound-appos,NNP,NNP-NNP-NNP,5,1
5572,13630.0,20,relinquish,7,1,4,3,0,15,6,-3,Singapore,Lee Hsien Loong,,per-per-per,PROPN,PROPN-PROPN-PROPN,compound,compound-compound-nsubj,NNP,NNP-NNP-NNP,3,1
5573,3770.0,37,signed,9,8,19,11,7,17,1,10,Kevin Cadogan,Elektra,-,per,PROPN-PROPN,PROPN,compound-conj,compound,NNP-NNP,NNP,8,1
5574,3771.0,24,was,8,1,15,14,0,8,7,7,Kirchner,Argentina,org,,PROPN,PROPN,nsubj,pobj,NNP,NNP,4,1
5575,3772.0,26,attended,1,6,10,4,5,15,-5,9,Arias,Costa Rica,per,-,PROPN,PROPN-PROPN,pobj,compound-pobj,NNP,NNP-NNP,3,1
5576,14088.0,12,served,1,1,6,5,0,5,0,5,Arias,Costa Rica,,per-per,PROPN,PROPN-PROPN,nsubj,compound-pobj,NNP,NNP-NNP,4,1
5577,3773.0,28,became,7,6,26,20,5,1,1,19,Airlift Wing,United States,per-per,-,PROPN-PROPN,PROPN-PROPN,compound-nsubj,compound-pobj,NNP-NNP,NNP-NNP,6,1
5578,3774.0,19,has,2,2,18,16,1,0,0,16,school,Vellore,per,,NOUN,PROPN,nsubj,pobj,NN,NNP,2,1
5579,3776.0,33,continued,1,1,6,5,0,26,0,5,CBG,Greece,,org,PROPN,PROPN,nsubj,pobj,NNP,NNP,2,1
5580,3777.0,27,In,0,4,10,6,3,16,-4,10,Rolling Stone,Jann Wenner,per-per,-,PROPN-PROPN,PROPN-PROPN,compound-compound,compound-nsubj,NNP-NNP,NNP-NNP,3,1
5581,5395.0,15,irked,2,4,7,3,3,7,-2,5,Rolling Stone,Jann Wenner,-,org-org,PROPN-PROPN,PROPN-PROPN,compound-compound,compound-dobj,NNP-NNP,NNP-NNP,2,1
5582,3778.0,55,known,5,19,33,14,18,21,-14,28,Islamic International Brigade,Ibn al-Khattab,per-per-per,-,PROPN-PROPN-PROPN,PROPN-PROPN,compound-compound-nsubj,compound-conj,NNP-NNP-NNP,NNP-NNP,6,1
5583,3779.0,21,is,8,2,20,18,1,0,6,12,Overseas Chinese Town,China,--,org,PROPN-PROPN-PROPN,PROPN,compound-compound-compound,pobj,NNP-NNP-NNP,NNP,3,1
5584,3780.0,50,In,0,30,30,0,29,19,-30,30,Florida,Florida Army National Guard,,org-org-org-org,PROPN,PROPN-PROPN-PROPN-PROPN,compound,compound-compound-compound-pobj,NNP,NNP-NNP-NNP-NNP,0,1
5585,3781.0,29,told,6,22,24,2,21,4,-16,18,Dublin,Byrne,,org,PROPN,PROPN,pobj,nsubjpass,NNP,NNP,3,1
5586,3782.0,67,has,1,21,18,-3,20,48,-20,17,Glendale,High Schools,,per-per,PROPN,PROPN-PROPN,nmod,compound-nmod,NNP,NNP-NNPS,3,1
5587,3783.0,20,is,2,11,15,4,10,4,-9,13,MBDA,EADS,,org,PROPN,PROPN,pobj,compound,NNP,NNP,4,1
5588,3785.0,30,created,8,7,10,3,6,19,1,2,Richard Squires,Newfoundland,org-org,,PROPN-PROPN,PROPN,compound-pobj,poss,NNP-NNP,NNP,6,1
5589,5979.0,50,served,1,20,26,6,19,23,-19,25,Richard Squires,Newfoundland,org-org,,PROPN-PROPN,PROPN,compound-dobj,pobj,NNP-NNP,NNP,2,1
5590,3786.0,36,born,2,5,13,8,4,22,-3,11,Finedon,Wellingborough School,per,-,PROPN,PROPN-PROPN,compound,compound-pobj,NNP,NNP-NNP,5,1
5591,3788.0,51,proposed,9,6,9,3,5,41,3,0,Confederation,Jefferson,org,,PROPN,PROPN,pobj,nsubj,NNP,NNP,1,1
5592,3789.0,29,assassinated,18,8,26,18,7,2,10,8,Paraguay,Juan Carlos Wasmosy,,per-per-per,PROPN,PROPN-PROPN-PROPN,poss,compound-compound-pobj,NNP,NNP-NNP-NNP,12,1
5593,12236.0,42,elected,8,13,18,5,12,23,-5,10,Paraguay,Juan Carlos Wasmosy,,org-org-org,PROPN,PROPN-PROPN-PROPN,pobj,compound-compound-pobj,NNP,NNP-NNP-NNP,4,1
5594,3790.0,17,played,6,1,9,8,0,7,5,3,Kip,Denver,,per,PROPN,PROPN,nsubj,compound,NNP,NNP,5,1
5595,3792.0,38,confirmed,2,15,15,0,14,22,-13,13,Mayo Clinic Hospital,Mayo Clinic,per-per-per,-,PROPN-PROPN-PROPN,PROPN-PROPN,compound-compound-pobj,compound-pobj,NNP-NNP-NNP,NNP-NNP,0,1
5596,3794.0,18,worked,1,14,16,2,13,1,-13,15,Oregon,Douglas McKay,org,-,PROPN,PROPN-PROPN,compound,compound-pobj,NNP,NNP-NNP,1,1
5597,6938.0,77,include,4,24,31,7,23,45,-20,27,Oregon,Douglas McKay,,per-per,PROPN,PROPN-PROPN,pobj,compound-conj,NNP,NNP-NNP,4,1
5598,3795.0,10,is,2,1,8,7,0,1,1,6,Cyprus College,Nicosia,org-org,,PROPN-PROPN,PROPN,compound-nsubj,compound,NNP-NNP,NNP,3,1
5599,3796.0,31,represented,8,4,11,7,3,19,4,3,Kansas Jayhawks,University of Kansas,per-per,--,PROPN-PROPN,PROPN-ADP-PROPN,compound-compound,dobj-prep-pobj,NNP-NNP,NNP-IN-NNP,4,1
5600,3797.0,16,manufactured,7,1,5,4,0,10,6,-2,Daktronics,South Dakota,org,-,NOUN,PROPN-PROPN,nsubj,compound-pobj,NNS,NNP-NNP,2,1
5601,3798.0,29,said,7,2,4,2,1,24,5,-3,auto maker,Geely Automobile,org-org,-,NOUN-NOUN,PROPN-PROPN,compound-compound,compound-compound,NN-NN,NNP-NNP,2,1
5602,3800.0,20,is,4,1,19,18,0,0,3,15,West Valley High School,California,org-org-org-org,,PROPN-PROPN-PROPN-PROPN,PROPN,compound-compound-compound-nsubj,pobj,NNP-NNP-NNP-NNP,NNP,3,1
5603,3801.0,24,ask,9,1,23,22,0,0,8,14,I,USA,org,,PRON,PROPN,nsubj,pobj,PRP,NNP,2,1
5604,3802.0,27,graduated,7,7,14,7,6,12,0,7,Moustakas,Greece,,per,PROPN,PROPN,nsubj,pobj,NNP,NNP,1,1
5605,3803.0,21,elected,2,1,12,11,0,8,1,10,Coolidge,Massachusetts,org,,PROPN,PROPN,nsubjpass,pobj,NNP,NNP,2,1
5606,3804.0,16,said,1,4,9,5,3,6,-3,8,Royal Alexandra Hospital,Paisley,--,org,PROPN-PROPN-PROPN,PROPN,compound-compound-nsubjpass,pobj,NNP-NNP-NNP,NNP,3,1
5607,3805.0,22,is,13,1,11,10,0,10,12,-2,The Times Group,Co. Ltd.,--,per-per,DET-PROPN-PROPN,PROPN-PROPN,det-compound-nsubj,subtok-conj,DT-NNP-NNP,NNP-NNP,5,1
5608,3806.0,28,released,5,1,22,21,0,5,4,17,Jim Corcoran,Canada,per-per,,PROPN-PROPN,PROPN,compound-nsubj,pobj,NNP-NNP,NNP,9,1
5609,3807.0,53,replaced,37,8,17,9,7,35,29,-20,Dirk Kempthorne,Interior,-,org,PROPN-PROPN,PROPN,compound-nsubj,pobj,NNP-NNP,NNP,2,1
5610,4460.0,58,sued,24,2,14,12,1,43,22,-10,Dirk Kempthorne,Interior,org-org,,PROPN-PROPN,PROPN,compound-pobj,pobj,NNP-NNP,NNP,1,1
5611,9127.0,30,came,1,8,29,21,7,0,-7,28,Dirk Kempthorne,Interior,org-org,,PROPN-PROPN,PROPN,compound-pobj,pobj,NNP-NNP,NNP,8,1
5612,10904.0,36,vetoed,14,4,14,10,3,21,10,0,Dirk Kempthorne,Interior,per-per,,PROPN-PROPN,PROPN,compound-compound,pobj,NNP-NNP,NNP,2,1
5613,3808.0,30,attended,1,3,27,24,2,2,-2,26,Columbia University,NCAA,per-per,,PROPN-PROPN,PROPN,compound-dobj,nmod,NNP-NNP,NNP,8,1
5614,13408.0,18,represents,6,3,13,10,2,4,3,7,Columbia University,NCAA,-,per,PROPN-PROPN,PROPN,compound-dobj,compound,NNP-NNP,NNP,4,1
5615,3810.0,10,married,5,4,8,4,3,1,1,3,Jim Carrey,Lauren Holly,-,per-per,PROPN-PROPN,PROPN-PROPN,compound-nsubj,compound-dobj,NNP-NNP,NNP-NNP,2,1
5616,3811.0,70,are,53,39,58,19,38,11,14,5,NCAA,Towson University,per,-,PROPN,PROPN-PROPN,compound,compound-attr,NNP,NNP-NNP,14,1
5617,3812.0,25,was,1,5,19,14,4,5,-4,18,McPherson College,Kansas,-,per,PROPN-PROPN,PROPN,compound-poss,compound,NNP-NNP,NNP,8,1
5618,3813.0,22,offered,4,8,20,12,7,1,-4,16,Jefferson High School,VA,--,org,PROPN-PROPN-PROPN,PROPN,compound-compound-pobj,appos,NNP-NNP-NNP,NNP,3,1
5619,3814.0,65,held,5,48,50,2,47,14,-43,45,Russia,Sergei Bagapsh,,per-per,PROPN,PROPN-PROPN,pobj,compound-conj,NNP,NNP-NNP,2,1
5620,3815.0,17,was,1,10,15,5,9,1,-9,14,Louisiana,John Slidell,,per-per,PROPN,PROPN-PROPN,compound,compound-dobj,NNP,NNP-NNP,2,1
5621,3816.0,23,was,3,1,20,19,0,2,2,17,DuSable High School,Chicago,org-org-org,,PROPN-PROPN-PROPN,PROPN,compound-compound-nsubj,compound,NNP-NNP-NNP,NNP,7,1
5622,3817.0,48,blamed,36,31,44,13,30,3,5,8,Air India,Indian Airlines,-,org-org,PROPN-PROPN,PROPN-PROPN,compound-pobj,compound-pobj,NNP-NNP,NNP-NNPS,15,1
5623,3961.0,16,office,4,2,10,8,1,5,2,6,Air India,Indian Airlines,org-org,-,PROPN-PROPN,PROPN-PROPN,nmod-nmod,compound-compound,NNP-NNP,NNP-NNPS,4,1
5624,3818.0,29,re-founded,14,3,10,7,2,18,11,-4,CCF,1961,org,,PROPN,NUM,nsubj,pobj,NNP,CD,3,1
5625,3819.0,28,has,9,1,8,7,0,19,8,-1,Bangladesh University of Business and Technology,BUBT,-----,org,PROPN-PROPN-ADP-PROPN-CCONJ-PROPN,PROPN,compound-nsubj-prep-pobj-cc-conj,appos,NNP-NNP-IN-NNP-CC-NNP,NNP,2,1
5626,3821.0,55,said,10,9,33,24,8,21,1,23,Equatorial Guinea,Teodoro Obiang Nguema Mbasogo,org-org,---,PROPN-PROPN,PROPN-PROPN-PROPN-PROPN,compound-pobj,compound-compound-compound-dobj,NNP-NNP,NNP-NNP-NNP-NNP,10,1
5627,3822.0,33,are,17,14,22,8,13,10,3,5,White City,BBC,per-per,,PROPN-PROPN,PROPN,compound-conj,compound,NNP-NNP,NNP,8,1
5628,3823.0,41,acknowledged,9,2,7,5,1,33,7,-2,Los Angeles Police Department,LAPD,per-per-per-per,,PROPN-PROPN-PROPN-PROPN,PROPN,compound-compound-compound-nsubj,appos,NNP-NNP-NNP-NNP,NNP,3,1
5629,7911.0,52,was,1,16,21,5,15,30,-15,20,Los Angeles Police Department,LAPD,org-org-org-org,,PROPN-PROPN-PROPN-PROPN,PROPN,compound-compound-compound-conj,appos,NNP-NNP-NNP-NNP,NNP,8,1
5630,3824.0,30,studied,6,17,24,7,16,5,-11,18,Japan,Kuroda Seiki,per,-,PROPN,PROPN-PROPN,pobj,compound-pobj,NNP,NNP-NNP,3,1
5631,9803.0,13,contributed,4,3,11,8,2,1,1,7,Japan,Kuroda Seiki,per,-,PROPN,PROPN-PROPN,pobj,compound-pobj,NNP,NNP-NNP,6,1
5632,3825.0,35,added,1,5,17,12,4,17,-4,16,Integrity,Paul Baloche,org,-,PROPN,PROPN-PROPN,poss,compound-dobj,NNP,NNP-NNP,4,1
5633,7191.0,61,added,1,5,17,12,4,43,-4,16,Integrity,Paul Baloche,org,-,PROPN,PROPN-PROPN,poss,compound-dobj,NNP,NNP-NNP,4,1
5634,3826.0,121,thumb,2,84,16,-68,83,104,-82,14,Hongkong International Terminals Ltd.,Hutchison Whampoa,org-org-org-org,-,PROPN-PROPN-PROPN-PROPN,PROPN-PROPN,compound-compound-compound-nmod,compound-compound,NNP-NNP-NNPS-NNP,NNP-NNP,11,1
5635,3828.0,29,said,26,3,24,21,2,4,23,-2,Sergei Bagapsh,Russia,per-per,,PROPN-PROPN,PROPN,compound-nsubj,compound,NNP-NNP,NNP,7,1
5636,5027.0,34,builds,17,16,23,7,15,10,1,6,Sergei Bagapsh,Russia,per-per,,PROPN-PROPN,PROPN,compound-pobj,nsubj,NNP-NNP,NNP,10,1
5637,6102.0,33,won,4,3,17,14,2,15,1,13,Sergei Bagapsh,Russia,org-org,,PROPN-PROPN,PROPN,compound-nsubj,nsubj,NNP-NNP,NNP,4,1
5638,7451.0,29,said,14,16,24,8,15,4,-2,10,Sergei Bagapsh,Russia,-,per,PROPN-PROPN,PROPN,compound-nmod,poss,NNP-NNP,NNP,4,1
5639,3829.0,30,married,18,15,18,3,14,11,3,0,Minnesota,Wheaton,,org,PROPN,PROPN,pobj,nsubj,NNP,NNP,4,1
5640,3830.0,52,led,19,7,11,4,6,40,12,-8,France,Charles de Freycinet,org,--,PROPN,PROPN-PROPN-PROPN,pobj,nmod-compound-pobj,NNP,NNP-NNP-NNP,4,1
5641,3831.0,27,served,2,1,5,4,0,21,1,3,Thompson,Wisconsin,,per,PROPN,PROPN,nsubj,compound,NNP,NNP,4,1
5642,8769.0,8,was,2,1,4,3,0,3,1,2,Thompson,Wisconsin,org,,PROPN,PROPN,nsubj,poss,NNP,NNP,5,1
5643,10708.0,27,appointed,6,8,21,13,7,5,-2,15,Thompson,Wisconsin,,per,PROPN,PROPN,dobj,pobj,NNP,NNP,4,1
5644,11192.0,34,said,13,8,13,5,7,20,5,0,Thompson,Wisconsin,,org,PROPN,PROPN,appos,pobj,NNP,NNP,4,1
5645,3832.0,21,soldiered,1,1,8,7,0,12,0,7,Swayze,his,org,,PROPN,DET,nsubj,poss,NNP,PRP$,6,1
5646,3833.0,31,built,3,7,17,10,6,13,-4,14,Simon Property Group,Indiana,--,org,PROPN-PROPN-PROPN,PROPN,compound-compound-appos,pobj,NNP-NNP-NNP,NNP,1,1
5647,10688.0,12,is,4,1,11,10,0,0,3,7,Simon Property Group,Indiana,per-per-per,,PROPN-PROPN-PROPN,PROPN,compound-compound-compound,pobj,NNP-NNP-NNP,NNP,4,1
5648,3834.0,32,released,7,4,25,21,3,6,3,18,Ninja Tune,Amon Tobin,org-org,-,PROPN-PROPN,PROPN-PROPN,compound-compound,compound-compound,NNP-NNP,NNP-NNP,15,1
5649,3835.0,24,merged,4,9,14,5,8,9,-5,10,Radio Corporation of America,RCA,---,per,PROPN-PROPN-ADP-PROPN,PROPN,compound-pobj-prep-pobj,appos,NNP-NNP-IN-NNP,NNP,2,1
5650,3836.0,17,returned,3,3,6,3,2,10,0,3,he,Italy,,per,PRON,PROPN,nsubj,pobj,PRP,NNP,2,1
5651,9387.0,11,worked,3,3,8,5,2,2,0,5,he,Italy,org,,PRON,PROPN,nsubj,pobj,PRP,NNP,2,1
5652,3837.0,39,Representatives,0,10,28,18,9,10,-10,28,Washington,Herbert Hoover,org,-,PROPN,PROPN-PROPN,compound,compound-pobj,NNP,NNP-NNP,-1,1
5653,3838.0,61,decided,44,8,29,21,7,31,36,-15,Netherlands,Maxime Verhagen,org,-,PROPN,PROPN-PROPN,pobj,compound-appos,NNP,NNP-NNP,3,1
5654,3839.0,33,come,1,6,8,2,5,24,-5,7,Hugo,Venezuela,org,,PROPN,NOUN,poss,pobj,NNP,NN,1,1
5655,13135.0,22,Mismanagement,1,8,10,2,7,11,-7,9,Hugo,Venezuela,,org,PROPN,PROPN,poss,pobj,NNP,NNP,6,1
5656,3840.0,30,backs,25,1,19,18,0,10,24,-6,Blix,International Atomic Energy Agency,org,---,PROPN,PROPN-PROPN-PROPN-PROPN,nsubj,compound-compound-compound-conj,NNP,NNP-NNP-NNP-NNP,6,1
5657,7412.0,40,headed,1,1,4,3,0,35,0,3,Blix,International Atomic Energy Agency,,org-org-org-org,PROPN,PROPN-PROPN-PROPN-PROPN,nsubj,compound-compound-compound-dobj,NNP,NNP-NNP-NNP-NNP,3,1
5658,8833.0,41,told,19,1,13,12,0,27,18,-6,Blix,International Atomic Energy Agency,per,---,PROPN,PROPN-PROPN-PROPN-PROPN,nsubj,compound-compound-compound-pobj,NNP,NNP-NNP-NNP-NNP,7,1
5659,3841.0,13,born,2,1,10,9,0,2,1,8,Medill,New Brunswick,,per-per,PROPN,PROPN-PROPN,nsubjpass,compound-compound,NNP,NNP-NNP,4,1
5660,3842.0,31,performed,2,6,29,23,5,1,-4,27,United States,Johnny Winter,-,per-per,PROPN-PROPN,PROPN-PROPN,compound-pobj,compound-conj,NNP-NNP,NNP-NNP,12,1
5661,12704.0,26,on-stage,4,10,14,4,9,11,-6,10,United States,Johnny Winter,org-org,-,PROPN-PROPN,PROPN-PROPN,compound-compound,compound-dobj,NNP-NNP,NNP-NNP,2,1
5662,3843.0,20,attended,1,10,14,4,9,5,-9,13,Politecnico di Milano,Milan,--,org,PROPN-ADP-PROPN,PROPN,nmod-nmod-pobj,compound,NNP-IN-NNP,NNP,3,1
5663,3844.0,24,is,4,11,15,4,10,8,-7,11,Jerry Lee Lewis,Sun Records,org-org-org,-,PROPN-PROPN-PROPN,PROPN-PROPN,compound-compound-pobj,compound-pobj,NNP-NNP-NNP,NNP-NNPS,5,1
5664,12014.0,38,edit,1,4,29,25,3,8,-3,28,Jerry Lee Lewis,Sun Records,--,org-org,PROPN-PROPN-PROPN,PROPN-PROPN,compound-compound-compound,compound-pobj,NNP-NNP-NNP,NNP-NNPS,9,1
5665,3845.0,18,elected,4,3,8,5,2,9,1,4,Alger,Michigan,,per,PROPN,PROPN,nsubjpass,pobj,NNP,NNP,2,1
5666,3846.0,34,was,2,1,11,10,0,22,1,9,Connex Melbourne,Veolia Environnement,-,per-per,PROPN-PROPN,PROPN-PROPN,compound-nsubj,compound-pobj,NNP-NNP,NNP-NNP,4,1
5667,3847.0,32,moved,26,3,24,21,2,7,23,-2,teal,1939,,org,ADJ,NUM,amod,pobj,JJ,CD,6,1
5668,3848.0,35,combines,5,2,2,0,1,32,3,-3,Duke University Health System,Duke University,per-per-per-per,-,PROPN-PROPN-PROPN-PROPN,PROPN-PROPN,compound-compound-compound-nsubj,compound-compound,NNP-NNP-NNP-NNP,NNP-NNP,0,1
5669,3849.0,33,described,13,1,5,4,0,27,12,-8,Aaron Turner,Hydra Head,per-per,-,PROPN-PROPN,PROPN-PROPN,compound-compound,compound-compound,NNP-NNP,NNP-NNP,4,1
5670,3850.0,49,was,15,21,26,5,20,22,-6,11,Showtime,CBS Corporation,,per-per,PROPN,PROPN-PROPN,compound,compound-pobj,NNP,NNP-NNP,3,1
5671,3852.0,21,represented,6,5,13,8,4,7,1,7,Interior,Gale Norton,per,-,PROPN,PROPN-PROPN,pobj,compound-compound,NNP,NNP-NNP,5,1
5672,11557.0,66,appointed,2,9,10,1,8,55,-7,8,Interior,Gale Norton,,per-per,PROPN,PROPN-PROPN,compound,compound-pobj,NNP,NNP-NNP,1,1
5673,11572.0,27,held,1,13,25,12,12,1,-12,24,Interior,Gale Norton,per,-,PROPN,PROPN-PROPN,pobj,compound-appos,NNP,NNP-NNP,8,1
5674,13702.0,64,destroyed,10,46,47,1,45,16,-36,37,Interior,Gale Norton,per,-,PROPN,PROPN-PROPN,compound,compound-pobj,NNP,NNP-NNP,1,1
5675,3853.0,34,spent,1,12,15,3,11,18,-11,14,Technical University of Denmark,Denmark,---,per,PROPN-PROPN-ADP-PROPN,PROPN,compound-pobj-prep-compound,pobj,NNP-NNP-IN-NNP,NNP,3,1
5676,3855.0,29,assigned,2,6,20,14,5,8,-4,18,GHQ Liaison Regiment,George Frederick Hopkinson,--,per-per-per,PROPN-PROPN-PROPN,PROPN-PROPN-PROPN,compound-compound-pobj,compound-compound-compound,NNP-NNP-NNP,NNP-NNP-NNP,9,1
5677,3857.0,35,is,13,16,28,12,15,6,-3,15,Chilean,Salvador Allende,per,-,PROPN,PROPN-PROPN,compound,compound-pobj,NNP,NNP-NNP,7,1
5678,3858.0,26,is,3,8,24,16,7,1,-5,21,London,Innocent drinks,,per-per,PROPN,ADJ-NOUN,pobj,compound-pobj,NNP,JJ-NNS,7,1
5679,3859.0,30,said,5,4,23,19,3,6,1,18,Yulia Tymoshenko,Ukraine,-,per,PROPN-PROPN,PROPN,compound-nsubj,pobj,NNP-NNP,NNP,3,1
5680,3860.0,22,is,1,7,16,9,6,5,-6,15,United Malays National Organisation,Malaysia,per-per-per-per,,PROPN-PROPN-PROPN-PROPN,PROPN,compound-compound-compound-nmod,poss,NNP-NNP-NNP-NNP,NNP,6,1
5681,3863.0,27,played,7,12,12,0,11,14,-5,5,Albany State University,Albany,--,per,PROPN-PROPN-PROPN,PROPN,compound-compound-pobj,compound,NNP-NNP-NNP,NNP,0,1
5682,3864.0,17,is,2,11,15,4,10,1,-9,13,University of Kent,Canterbury,org-org-org,,PROPN-ADP-PROPN,PROPN,pobj-prep-pobj,compound,NNP-IN-NNP,NNP,5,1
5683,3866.0,30,is,7,2,13,11,1,16,5,6,28th Infantry Division,Army National Guard,per-per-per,--,ADJ-PROPN-PROPN,PROPN-PROPN-PROPN,amod-compound-nsubj,compound-compound-pobj,JJ-NNP-NNP,NNP-NNP-NNP,6,1
5684,3867.0,22,performed,1,8,9,1,7,12,-7,8,actor,Vadivelu,,org,NOUN,PROPN,compound,pobj,NN,NNP,3,1
5685,3868.0,29,are,13,12,20,8,11,8,1,7,Venezuela,Jaime Lusinchi,org,-,PROPN,PROPN-PROPN,pobj,compound-pobj,NNP,NNP-NNP,4,1
5686,3869.0,19,is,2,8,17,9,7,1,-6,15,The Golden Palominos,Restless,--,org,DET-PROPN-PROPN,PROPN,det-compound-pobj,compound,DT-NNP-NNP,NNP,4,1
5687,7817.0,20,Drunk,0,9,18,9,8,1,-9,18,The Golden Palominos,Restless,--,per,DET-PROPN-PROPN,PROPN,det-compound-pobj,compound,DT-NNP-NNP,NNP,6,1
5688,3870.0,22,was,3,10,20,10,9,1,-7,17,Southern University,United States,per-per,-,PROPN-PROPN,PROPN-PROPN,compound-pobj,compound-pobj,NNP-NNP,NNP-NNP,6,1
5689,3871.0,28,shared,9,13,19,6,12,8,-4,10,914th Airlift Wing,Air Force,--,org-org,PROPN-PROPN-PROPN,PROPN-PROPN,amod-compound-pobj,compound-compound,NNP-NNP-NNP,NNP-NNP,4,1
5690,3872.0,10,is,2,1,7,6,0,2,1,5,Linda,musician,per,,PROPN,NOUN,compound,attr,NNP,NN,3,1
5691,3873.0,25,served,1,10,18,8,9,6,-9,17,Nebraska,Carl Curtis,,per-per,PROPN,PROPN-PROPN,poss,compound-conj,NNP,NNP-NNP,6,1
5692,3874.0,28,said,6,1,5,4,0,22,5,-1,Digicel,Denis O'Brien,org,-,NOUN,PROPN-PROPN,compound,compound-nsubj,NN,NNP-NNP,2,1
5693,3875.0,16,was,1,10,14,4,9,1,-9,13,Northland High School,Columbus,per-per-per,,PROPN-PROPN-PROPN,PROPN,compound-compound-pobj,compound,NNP-NNP-NNP,NNP,4,1
5694,3876.0,18,is,12,1,15,14,0,2,11,3,Jaroslav,Czech,org,,PROPN,ADJ,dobj,compound,NNP,JJ,-1,1
5695,3878.0,51,helped,9,14,28,14,13,22,-5,19,Canadian Tire,Canada,-,per,PROPN-PROPN,PROPN,amod-compound,pobj,NNP-NNP,NNP,7,1
5696,3879.0,19,take,4,1,13,12,0,5,3,9,Charest,Sherbrooke,,org,PROPN,PROPN,nsubj,pobj,NNP,NNP,4,1
5697,3880.0,26,was,13,15,18,3,14,7,-2,5,Conrad Burns,Montana,per-per,,PROPN-PROPN,PROPN,compound-attr,pobj,NNP-NNP,NNP,2,1
5698,3882.0,20,is,4,11,11,0,10,8,-7,7,New Jersey Transit Bus Operations,New Jersey,per-per-per-per-per,-,PROPN-PROPN-PROPN-PROPN-PROPN,PROPN-PROPN,compound-compound-compound-compound-pobj,compound-dobj,NNP-NNP-NNP-NNP-NNP,NNP-NNP,0,1
5699,3883.0,24,Murphy,1,1,21,20,0,2,0,20,Michael Murphy,Los Angeles,per-per,-,PROPN-PROPN,PROPN-PROPN,compound-ROOT,compound-compound,NNP-NNP,NNP-NNP,-1,1
5700,3884.0,46,is,23,1,1,0,0,44,22,-22,Freehold Township High School,Freehold Regional High School District,org-org-org-org,----,PROPN-PROPN-PROPN-PROPN,PROPN-PROPN-PROPN-PROPN-PROPN,compound-compound-compound-pobj,compound-compound-compound-compound-pobj,NNP-NNP-NNP-NNP,NNP-NNP-NNP-NNP-NNP,0,1
5701,3885.0,60,commemorates,2,42,53,11,41,6,-40,51,England,Margaret of Anjou,,org-org-org,PROPN,PROPN-ADP-PROPN,pobj,pobj-prep-pobj,NNP,NNP-IN-NNP,8,1
5702,8080.0,24,concentrated,3,9,16,7,8,7,-6,13,England,Margaret of Anjou,org,--,PROPN,PROPN-ADP-PROPN,pobj,pobj-prep-pobj,NNP,NNP-IN-NNP,5,1
5703,3886.0,19,used,4,9,14,5,8,4,-5,10,Urho Kekkonen,Finland,-,per,PROPN-PROPN,PROPN,compound-pobj,pobj,NNP-NNP,NNP,3,1
5704,4370.0,14,was,5,1,13,12,0,0,4,8,Urho Kekkonen,Finland,-,org,PROPN-PROPN,PROPN,compound-poss,pobj,NNP-NNP,NNP,3,1
5705,4624.0,14,was,5,1,13,12,0,0,4,8,Urho Kekkonen,Finland,-,per,PROPN-PROPN,PROPN,compound-poss,pobj,NNP-NNP,NNP,3,1
5706,4991.0,23,is,6,1,13,12,0,9,5,7,Urho Kekkonen,Finland,per-per,,PROPN-PROPN,PROPN,compound-compound,pobj,NNP-NNP,NNP,4,1
5707,7181.0,14,was,5,1,13,12,0,0,4,8,Urho Kekkonen,Finland,per-per,,PROPN-PROPN,PROPN,compound-poss,pobj,NNP-NNP,NNP,3,1
5708,12590.0,37,persuaded,4,7,12,5,6,24,-3,8,Urho Kekkonen,Finland,-,per,PROPN-PROPN,PROPN,compound-compound,pobj,NNP-NNP,NNP,2,1
5709,13198.0,18,elected,5,3,10,7,2,7,2,5,Urho Kekkonen,Finland,per-per,,PROPN-PROPN,PROPN,compound-nsubjpass,pobj,NNP-NNP,NNP,2,1
5710,13210.0,31,Kekkonen,1,1,16,15,0,14,0,15,Urho Kekkonen,Finland,-,per,PROPN-PROPN,PROPN,compound-ROOT,conj,NNP-NNP,NNP,3,1
5711,13542.0,39,is,3,6,21,15,5,17,-3,18,Urho Kekkonen,Finland,per-per,,PROPN-PROPN,PROPN,compound-attr,compound,NNP-NNP,NNP,4,1
5712,3887.0,38,is,2,5,11,6,4,26,-3,9,India,Lal,,org,PROPN,PROPN,poss,compound,NNP,NNP,-1,1
5713,3888.0,13,supported,2,9,12,3,8,0,-7,10,William Bigler,Pennsylvania,-,per,PROPN-PROPN,PROPN,compound-appos,pobj,NNP-NNP,NNP,4,1
5714,3889.0,15,is,10,1,13,12,0,1,9,3,Jacques Santer,Luxembourg,-,per,PROPN-PROPN,PROPN,compound-nsubj,compound,NNP-NNP,NNP,2,1
5715,3890.0,13,air,4,7,9,2,6,3,-3,5,TW3,Albany,,org,PROPN,PROPN,pobj,compound,NNP,NNP,2,1
5716,3891.0,16,began,12,8,12,4,7,3,4,0,RTL Group,Luxembourg,org-org,,PROPN-PROPN,PROPN,compound-pobj,oprd,NNP-NNP,NNP,4,1
5717,3892.0,21,started,1,12,15,3,11,5,-11,14,2005,Nicktoons,,org,NUM,PROPN,pobj,compound,CD,NNPS,5,1
5718,3893.0,23,Worth,0,13,21,8,12,1,-13,21,Meredith Andrews,Word Records,per-per,-,PROPN-PROPN,PROPN-PROPN,compound-pobj,compound-pobj,NNP-NNP,NNP-NNPS,9,1
5719,3895.0,22,is,9,2,8,6,1,13,7,-1,Oklahoma State Bureau of Investigation,OSBI,org-org-org-org-org,,PROPN-PROPN-PROPN-ADP-PROPN,PROPN,compound-compound-nsubj-prep-pobj,appos,NNP-NNP-NNP-IN-NNP,NNP,3,1
5720,3896.0,30,born,2,12,17,5,11,12,-10,15,California,Nina Olivette,org,-,PROPN,PROPN-PROPN,pobj,compound-pobj,NNP,NNP-NNP,3,1
5721,6233.0,32,born,2,6,10,4,5,21,-4,8,California,Nina Olivette,,per-per,PROPN,PROPN-PROPN,pobj,compound-pobj,NNP,NNP-NNP,3,1
5722,3897.0,34,helped,2,14,19,5,13,14,-12,17,Windham Hill,Ackerman,per-per,,PROPN-PROPN,PROPN,compound-compound,nsubj,NNP-NNP,NNP,10,1
5723,3898.0,45,Army,4,4,5,1,3,39,0,1,U.S. Army,Army National Guard,per-per,--,PROPN-PROPN,PROPN-PROPN-PROPN,compound-ROOT,compound-compound-conj,NNP-NNP,NNP-NNP-NNP,1,1
5724,3899.0,16,is,1,8,13,5,7,2,-7,12,Shanghai Golden Eagles,China Baseball League,org-org-org,--,PROPN-PROPN-PROPN,PROPN-PROPN-PROPN,compound-compound-pobj,compound-compound-pobj,NNP-NNP-NNPS,NNP-NNP-NNP,4,1
5725,3901.0,17,is,1,5,14,9,4,2,-4,13,he,Kentucky,per,,PRON,PROPN,nsubjpass,pobj,PRP,NNP,3,1
5726,5767.0,28,During,0,6,19,13,5,8,-6,19,he,Kentucky,org,,PRON,PROPN,nsubj,compound,PRP,NNP,6,1
5727,3902.0,29,is,3,1,24,23,0,4,2,21,Manalapan High School,Freehold Regional High School District,per-per-per,----,PROPN-PROPN-PROPN,PROPN-PROPN-PROPN-PROPN-PROPN,compound-compound-nsubj,compound-compound-compound-compound-pobj,NNP-NNP-NNP,NNP-NNP-NNP-NNP-NNP,9,1
5728,3903.0,33,won,6,1,6,5,0,26,5,0,Martti Ahtisaari,Finland,org-org,,PROPN-PROPN,PROPN,compound-npadvmod,pobj,NNP-NNP,NNP,1,1
5729,3904.0,58,rejected,2,22,1,-21,21,56,-20,-1,Kansas City,Funkhouser,per-per,,PROPN-PROPN,PROPN,compound-compound,nsubjpass,NNP-NNP,NNP,-1,1
5730,3906.0,13,returned,9,8,12,4,7,0,1,3,he,Thailand,,per,PRON,PROPN,nsubj,pobj,PRP,NNP,2,1
5731,7801.0,33,said,6,25,29,4,24,3,-19,23,he,Thailand,,per,PRON,PROPN,nsubj,poss,PRP,NNP,5,1
5732,3907.0,22,contested,4,14,18,4,13,3,-10,14,Joe Hockey,Liberal Party of Australia,per-per,---,PROPN-PROPN,PROPN-PROPN-ADP-PROPN,compound-appos,compound-pobj-prep-pobj,NNP-NNP,NNP-NNP-IN-NNP,5,1
5733,3909.0,31,visited,7,1,7,6,0,23,6,0,Deal,Pixies,per,,VERB,PROPN,nsubj,pobj,VB,NNPS,2,1
5734,3910.0,19,went,3,13,17,4,12,1,-10,14,United Russia,Vladimir Putin,per-per,-,PROPN-PROPN,PROPN-PROPN,compound-compound,compound-pobj,NNP-NNP,NNP-NNP,3,1
5735,9225.0,52,waiting,2,36,39,3,35,12,-34,37,United Russia,Vladimir Putin,per-per,-,PROPN-PROPN,PROPN-PROPN,compound-compound,compound-compound,NNP-NNP,NNP-NNP,3,1
5736,10176.0,41,agree,7,4,14,10,3,26,3,7,United Russia,Vladimir Putin,-,org-org,PROPN-PROPN,PROPN-PROPN,compound-appos,compound-pobj,NNP-NNP,NNP-NNP,8,1
5737,11186.0,33,said,1,24,31,7,23,1,-23,30,United Russia,Vladimir Putin,-,org-org,PROPN-PROPN,PROPN-PROPN,compound-poss,compound-pobj,NNP-NNP,NNP-NNP,4,1
5738,12127.0,28,characterised,4,1,18,17,0,9,3,14,United Russia,Vladimir Putin,-,per-per,PROPN-PROPN,PROPN-PROPN,compound-nsubj,compound-pobj,NNP-NNP,NNP-NNP,7,1
5739,12656.0,27,voted,5,3,11,8,2,15,2,6,United Russia,Vladimir Putin,-,org-org,PROPN-PROPN,PROPN-PROPN,compound-compound,compound-poss,NNP-NNP,NNP-NNP,5,1
5740,3911.0,76,provided,65,23,28,5,22,47,42,-37,British,Francis Crick,org,-,ADJ,PROPN-PROPN,amod,compound-compound,JJ,NNP-NNP,4,1
5741,3912.0,37,was,5,2,17,15,1,19,3,12,his UFC,Zuffa LLC,org-org,-,DET-PROPN,PROPN-PROPN,poss-compound,compound-nsubj,PRP$-NNP,NNP-NNP,7,1
5742,3913.0,26,founded,10,4,13,9,3,12,6,3,University of Kent,1965,--,org,PROPN-ADP-PROPN,NUM,dobj-prep-pobj,pobj,NNP-IN-NNP,CD,4,1
5743,3914.0,24,is,8,1,11,10,0,12,7,3,Jonathan Meese,German,per-per,,PROPN-PROPN,ADJ,compound-nsubj,amod,NNP-NNP,JJ,5,1
5744,3915.0,17,fell,2,1,16,15,0,0,1,14,Tenneco,NYSE,per,,ADJ,PROPN,compound,pobj,JJ,NNP,2,1
5745,3916.0,44,sought,1,1,20,19,0,23,0,19,France,Lionel Jospin,org,-,PROPN,PROPN-PROPN,nsubj,compound-pobj,NNP,NNP-NNP,4,1
5746,3917.0,34,was,1,21,29,8,20,4,-20,28,University of Adelaide,Australia,--,per,PROPN-ADP-PROPN,PROPN,poss-prep-pobj,pobj,NNP-IN-NNP,NNP,4,1
5747,3919.0,40,came,6,11,14,3,10,25,-5,8,Stax,Sam Dave,org,-,PROPN,PROPN-PROPN,compound,compound-poss,NNP,NNP-NNP,5,1
5748,12616.0,51,turned,15,25,42,17,24,8,-10,27,Stax,Sam Dave,per,-,PROPN,PROPN-PROPN,compound,compound-compound,NNP,NNP-NNP,4,1
5749,13767.0,16,asked,1,5,14,9,4,1,-4,13,Stax,Sam Dave,org,-,PROPN,PROPN-PROPN,compound,compound-pobj,NNP,NNP-NNP,4,1
5750,3920.0,32,divested,4,20,29,9,19,2,-16,25,Clayton Dubilier Inc.,Lexmark,--,org,PROPN-PROPN-PROPN,PROPN,compound-compound-pobj,compound,NNP-NNP-NNP,NNP,9,1
5751,3921.0,18,produced,4,3,7,4,2,10,1,3,Zuffa LLC,UFC,-,per,PROPN-PROPN,PROPN,compound-nsubj,compound,NNP-NNP,NNP,3,1
5752,6728.0,21,owns,2,7,20,13,6,0,-5,18,Zuffa LLC,UFC,per-per,,PROPN-PROPN,PROPN,compound-pobj,dobj,NNP-NNP,NNP,4,1
5753,3922.0,53,mention,1,5,44,39,4,8,-4,43,director,Michael Moore,per,-,NOUN,PROPN-PROPN,compound,compound-nsubj,NN,NNP-NNP,8,1
5754,3923.0,28,is,9,8,27,19,7,0,1,18,HSC-22,Virginia,,org,PROPN,PROPN,subtok,pobj,NNP,NNP,4,1
5755,3924.0,22,interviewed,3,1,12,11,0,9,2,9,Smith,Detroit,per,,PROPN,PROPN,nsubjpass,compound,NNP,NNP,3,1
5756,3926.0,44,moved,2,28,33,5,27,10,-26,31,Cary Grant,Dyan Cannon,-,per-per,PROPN-PROPN,VERB-PROPN,compound-pobj,compound-compound,NNP-NNP,VBP-NNP,7,1
5757,3927.0,26,employed,3,1,7,6,0,18,2,4,Durrance,Florida Institute of Technology,per,---,NOUN,PROPN-PROPN-ADP-PROPN,nsubjpass,compound-pobj-prep-pobj,NN,NNP-NNP-IN-NNP,3,1
5758,3928.0,24,achieved,1,13,20,7,12,3,-12,19,Ontario Institute for Studies in Education,University of Toronto,per-per-per-per-per-per,--,PROPN-PROPN-ADP-PROPN-ADP-PROPN,PROPN-ADP-PROPN,compound-pobj-prep-pobj-prep-pobj,appos-prep-pobj,NNP-NNP-IN-NNPS-IN-NNP,NNP-IN-NNP,2,1
5759,12970.0,21,is,2,12,18,6,11,2,-10,16,Ontario Institute for Studies in Education,University of Toronto,per-per-per-per-per-per,--,PROPN-PROPN-ADP-PROPN-ADP-PROPN,PROPN-ADP-PROPN,compound-pobj-prep-pobj-prep-compound,pobj-prep-pobj,NNP-NNP-IN-NNPS-IN-NNP,NNP-IN-NNP,5,1
5760,3929.0,23,were,19,7,16,9,6,6,12,-3,South Africa national basketball team,Basketball Championship,per-per-per-per-per,-,PROPN-PROPN-ADJ-NOUN-NOUN,PROPN-PROPN,nmod-nmod-amod-compound-pobj,compound-pobj,NNP-NNP-JJ-NN-NN,NNP-NNP,5,1
5761,3930.0,19,is,10,2,7,5,1,11,8,-3,National Confederation of Workers of Burkina,Burkina Faso,per-per-per-per-per-per,-,PROPN-PROPN-ADP-PROPN-ADP-PROPN,PROPN-PROPN,compound-nsubj-prep-pobj-prep-pobj,compound-pobj,NNP-NNP-IN-NNPS-IN-NNP,NNP-NNP,2,1
5762,3932.0,28,27-year-old,5,7,12,5,6,15,-2,7,Gustavo Dudamel,Venezuela,-,per,PROPN-PROPN,PROPN,compound-nsubj,poss,NNP-NNP,NNP,6,1
5763,6638.0,37,premiered,4,30,36,6,29,0,-26,32,Gustavo Dudamel,Venezuela,org-org,,PROPN-PROPN,PROPN,compound-appos,pobj,NNP-NNP,NNP,9,1
5764,11471.0,59,says,36,1,15,14,0,43,35,-21,Gustavo Dudamel,Venezuela,per-per,,PROPN-PROPN,PROPN,compound-nsubj,pobj,NNP-NNP,NNP,5,1
5765,3934.0,24,was,1,1,15,14,0,8,0,14,It,Japan,org,,PRON,PROPN,nsubj,pobj,PRP,NNP,4,1
5766,3935.0,27,listed,17,2,7,5,1,19,15,-10,Francis Gillette,Connecticut,per-per,,PROPN-PROPN,PROPN,compound-compound,pobj,NNP-NNP,NNP,3,1
5767,3936.0,23,lacked,6,6,18,12,5,4,0,12,ICL,India,,org,PROPN,PROPN,nsubj,pobj,NNP,NNP,8,1
5768,3937.0,40,went,25,3,22,19,2,17,22,-3,La Liga,Barcelona,-,per,PROPN-PROPN,PROPN,compound-nsubj,conj,NNP-NNP,NNP,4,1
5769,3939.0,29,continued,1,14,20,6,13,8,-13,19,Harris Technology,Coles Group,per-per,-,PROPN-PROPN,PROPN-PROPN,compound-pobj,compound-pobj,NNP-NNP,NNP-NNP,3,1
5770,3940.0,41,served,8,16,24,8,15,16,-8,16,Millsaps College,Mississippi,-,per,PROPN-PROPN,PROPN,compound-pobj,pobj,NNP-NNP,NNP,8,1
5771,3941.0,14,are,2,1,10,9,0,3,1,8,The Mavericks,1989,-,org,DET-PROPN,NUM,det-nsubj,pobj,DT-NNPS,CD,4,1
5772,3942.0,26,appeared,1,6,7,1,5,18,-5,6,Democrat,Erskine Bowles,org,-,PROPN,PROPN-PROPN,nmod,compound-appos,NNP,NNP-NNP,3,1
5773,3944.0,16,represented,6,4,3,-1,3,12,2,-3,Boilermakers,Purdue University,org,-,PROPN,PROPN-PROPN,compound,compound-dobj,NNP,NNP-NNP,2,1
5774,3945.0,23,Live,0,11,21,10,10,1,-11,21,The Holy Modal Rounders,DBK Works,per-per-per-per,-,DET-PROPN-PROPN-PROPN,PROPN-NOUN,det-compound-compound-nsubj,compound-pobj,DT-NNP-NNP-NNPS,NNP-NNS,5,1
5775,3946.0,57,Meeting,0,27,48,21,26,8,-27,48,University of Minnesota,Minneapolis,--,per,PROPN-ADP-PROPN,PROPN,poss-prep-pobj,compound,NNP-IN-NNP,NNP,-1,1
5776,9597.0,96,uses,2,50,73,23,49,22,-48,71,University of Minnesota,Minneapolis,per-per-per,,PROPN-ADP-PROPN,PROPN,nmod-prep-pobj,pobj,NNP-IN-NNP,NNP,10,1
5777,3947.0,23,made,7,1,5,4,0,17,6,-2,Varian Medical Systems,Palo Alto,--,per-per,PROPN-PROPN-PROPN,PROPN-PROPN,compound-compound-nsubj,compound-compound,NNP-NNP-NNPS,NNP-NNP,4,1
5778,3948.0,28,is,2,8,14,6,7,13,-6,12,Sacramento City College,California,--,org,PROPN-PROPN-PROPN,PROPN,compound-compound-pobj,compound,NNP-NNP-NNP,NNP,9,1
5779,10319.0,40,had,2,13,22,9,12,17,-11,20,Sacramento City College,California,per-per-per,,PROPN-PROPN-PROPN,PROPN,compound-compound-pobj,compound,NNP-NNP-NNP,NNP,5,1
5780,3950.0,31,known,3,1,25,24,0,5,2,22,He,Japan,,org,PRON,PROPN,nsubjpass,poss,PRP,NNP,8,1
5781,10113.0,31,lived,2,1,5,4,0,25,1,3,He,Japan,per,,PRON,PROPN,nsubj,compound,PRP,NNP,5,1
5782,3951.0,24,offered,10,13,14,1,12,9,-3,4,Frenchman,Mike Di Meglio,per,--,PROPN,PROPN-PROPN-PROPN,compound,compound-compound-pobj,NNP,NNP-NNP-NNP,2,1
5783,3952.0,26,founded,7,6,9,3,5,16,1,2,Nicholas Csendes,Ansoft,-,per,PROPN-PROPN,PROPN,compound-appos,dobj,NNP-NNP,NNP,4,1
5784,3954.0,36,Prof.,0,28,33,5,27,2,-28,33,the University of S,#44; Paki,---,org-org,DET-PROPN-ADP-PROPN,NOUN-PROPN,det-nmod-prep-pobj,compound-appos,DT-NNP-IN-NNP,NNS-NNP,4,1
5785,3957.0,27,inspires,9,2,24,22,1,2,7,15,Eleanor Roosevelt,New York,org-org,-,PROPN-PROPN,PROPN-PROPN,compound-compound,compound-compound,NNP-NNP,NNP-NNP,6,1
5786,3958.0,31,Shares,0,3,6,3,2,24,-3,6,AGL Energy,Australia,org-org,,PROPN-PROPN,PROPN,compound-subtok,poss,NNP-NNP,NNP,-1,1
5787,3959.0,32,is,2,24,5,-19,23,26,-22,3,Ranil Wickremasinghe,Sri Lanka,-,per-per,PROPN-PROPN,PROPN-PROPN,compound-pobj,compound-pobj,NNP-NNP,NNP-NNP,6,1
5788,6543.0,23,lost,3,12,17,5,11,5,-9,14,Ranil Wickremasinghe,Sri Lanka,per-per,-,PROPN-PROPN,PROPN-PROPN,compound-nsubj,compound-poss,NNP-NNP,NNP-NNP,10,1
5789,3960.0,25,selected,10,14,24,10,13,0,-4,14,British Bulldogs,London,org-org,,ADJ-PROPN,PROPN,amod-compound,pobj,JJ-NNPS,NNP,4,1
5790,3962.0,41,been,2,29,31,2,28,9,-27,29,Green Party,M. Claude Genest,org-org,--,PROPN-PROPN,PROPN-PROPN-PROPN,compound-compound,compound-compound-poss,NNP-NNP,NNP-NNP-NNP,2,1
5791,3963.0,20,sang,7,3,7,4,2,12,4,0,Italy,Bocelli,,per,PROPN,PROPN,pobj,nsubj,NNP,NNP,2,1
5792,3966.0,11,Labels,0,5,7,2,4,3,-5,7,Martha Coakley,Massachusetts,-,org,PROPN-PROPN,PROPN,compound-compound,compound,NNP-NNP,NNP,2,1
5793,3967.0,47,recorded,3,34,40,6,33,6,-31,37,Fat Wreck Chords,No Use for a Name,org-org-org,----,PROPN-PROPN-PROPN,DET-NOUN-ADP-DET-NOUN,compound-compound-pobj,compound-pobj-prep-det-pobj,NNP-NNP-NNPS,DT-NN-IN-DT-NN,9,1
5794,8448.0,67,prepared,9,43,57,14,42,9,-34,48,Fat Wreck Chords,No Use for a Name,--,per-per-per-per-per,PROPN-PROPN-PROPN,DET-NOUN-ADP-DET-NOUN,compound-compound-pobj,det-pobj-prep-det-compound,NNP-NNP-NNPS,DT-NN-IN-DT-NN,6,1
5795,3968.0,32,located,12,8,27,19,7,4,4,15,Platit,Switzerland,org,,PROPN,PROPN,compound,pobj,NNP,NNP,5,1
5796,3969.0,34,taught,1,4,7,3,3,26,-3,6,Antioch College,Yellow Springs,-,org-org,PROPN-PROPN,PROPN-PROPN,compound-pobj,compound-compound,NNP-NNP,NNP-NNP,2,1
5797,3970.0,35,featured,2,7,20,13,6,14,-5,18,Norah Jones,Brooklyn,per-per,,PROPN-PROPN,PROPN,compound-pobj,compound,NNP-NNP,NNP,6,1
5798,3972.0,28,are,3,26,27,1,25,0,-23,24,IWC,Schaffhausen,,per,PROPN,PROPN,compound,conj,NNP,NNP,3,1
5799,3973.0,22,opened,11,2,7,5,1,14,9,-4,Bobby Jones,Nashville,-,org,PROPN-PROPN,PROPN,compound-compound,compound,NNP-NNP,NNP,4,1
5800,3974.0,24,was,12,10,10,0,9,13,2,-2,Faroe Islands,Faroe Islands national football team,org-org,----,PROPN-PROPN,PROPN-PROPN-ADJ-NOUN-NOUN,compound-pobj,nmod-nmod-amod-compound-pobj,NNP-NNPS,NNP-NNPS-JJ-NN-NN,0,1
5801,3975.0,38,went,1,1,15,14,0,22,0,14,Bush,Texas,org,,PROPN,PROPN,nsubj,compound,NNP,NNP,8,1
5802,3976.0,33,born,2,1,18,17,0,14,1,16,Fermat,France,,per,PROPN,PROPN,nsubjpass,nsubj,NNP,NNP,9,1
5803,3977.0,29,said,27,6,7,1,5,21,21,-20,Adamkus,Lithuania,per,,PROPN,PROPN,compound,pobj,NNP,NNP,5,1
5804,3978.0,31,was,3,17,29,12,16,1,-14,26,Simone Veil,European Parliament,org-org,-,PROPN-PROPN,PROPN-PROPN,compound-pobj,compound-pobj,NNP-NNP,NNP-NNP,6,1
5805,7452.0,21,elected,4,1,12,11,0,8,3,8,Simone Veil,European Parliament,org-org,-,PROPN-PROPN,PROPN-PROPN,compound-nsubjpass,compound-pobj,NNP-NNP,NNP-NNP,5,1
5806,3979.0,22,worked,5,10,20,10,9,1,-5,15,Bessie Smith,Columbia,org-org,,PROPN-PROPN,PROPN,compound-pobj,compound,NNP-NNP,NNP,6,1
5807,3980.0,22,flies,11,3,3,0,2,18,8,-8,Vietnam,Vietnam Airlines,per,-,PROPN,PROPN-PROPN,poss,compound-conj,NNP,NNP-NNP,0,1
5808,3981.0,34,proposed,6,2,12,10,1,21,4,6,2007,Union,org,,NUM,PROPN,pobj,pobj,CD,NNP,7,1
5809,3982.0,44,is,33,23,26,3,22,17,10,-7,Austin motor company,Longbridge,--,org,PROPN-NOUN-NOUN,PROPN,compound-compound-compound,compound,NNP-NN-NN,NNP,2,1
5810,3983.0,30,is,8,1,17,16,0,12,7,9,Louis Plamondon,Quebec,org-org,,PROPN-PROPN,PROPN,compound-nsubj,pobj,NNP-NNP,NNP,5,1
5811,3984.0,41,Home,5,2,14,12,1,26,3,9,Katie Holmes,Actress,-,per,PROPN-PROPN,PROPN,compound-compound,compound,NNP-NNP,NNP,5,1
5812,3985.0,35,affiliated,4,1,8,7,0,26,3,4,Burnsville High School,Minnesota,per-per-per,,PROPN-PROPN-PROPN,PROPN,compound-compound-nsubjpass,compound,NNP-NNP-NNP,NNP,5,1
5813,3986.0,74,By,0,10,67,57,9,6,-10,67,Singapore,Ong Teng Cheong,per,--,PROPN,PROPN-PROPN-PROPN,pobj,compound-compound-nsubj,NNP,NNP-NNP-NNP,7,1
5814,9526.0,34,conducted,2,4,21,17,3,12,-2,19,Singapore,Ong Teng Cheong,per,--,PROPN,PROPN-PROPN-PROPN,compound,compound-compound-compound,NNP,NNP-NNP-NNP,7,1
5815,11466.0,23,visited,10,7,8,1,6,14,3,-2,Singapore,Ong Teng Cheong,org,--,PROPN,PROPN-PROPN-PROPN,compound,compound-compound-pobj,NNP,NNP-NNP-NNP,2,1
5816,3989.0,27,invited,7,5,19,14,4,7,2,12,Cirrus Design,Minnesota,per-per,,PROPN-PROPN,PROPN,compound-compound,pobj,NNP-NNP,NNP,3,1
5817,3990.0,56,checked,6,38,54,16,37,1,-32,48,Demi Lovato,Hollywood Records,org-org,-,PROPN-PROPN,PROPN-PROPN,compound-poss,compound-pobj,NNP-NNP,NNP-NNPS,3,1
5818,3991.0,50,On,0,8,26,18,7,23,-8,26,Hawaii,Daniel Inouye,per,-,PROPN,PROPN-PROPN,compound,compound-pobj,NNP,NNP-NNP,11,1
5819,6006.0,34,announced,6,20,26,6,19,7,-14,20,Hawaii,Daniel Inouye,,org-org,PROPN,PROPN-PROPN,pobj,compound-dobj,NNP,NNP-NNP,2,1
5820,3992.0,38,defeated,14,12,13,1,11,24,2,-1,Australia,Paul Keating,per,-,PROPN,PROPN-PROPN,pobj,compound-pobj,NNP,NNP-NNP,1,1
5821,3993.0,19,approves,6,1,15,14,0,3,5,9,Japan,Bank of Japan,org,--,PROPN,PROPN-ADP-PROPN,poss,nmod-prep-pobj,NNP,NNP-IN-NNP,8,1
5822,3994.0,21,is,4,1,19,18,0,1,3,15,Shrewsbury Sixth Form College,Shropshire,per-per-per-per,,PROPN-PROPN-PROPN-PROPN,PROPN,compound-compound-compound-nsubj,compound,NNP-NNP-NNP-NNP,NNP,8,1
5823,3995.0,28,is,3,3,21,18,2,6,0,18,Natural,Sony BMG,,org-org,PROPN,PROPN-PROPN,oprd,compound-pobj,NNP,NNP-NNP,4,1
5824,3996.0,25,founded,4,3,7,4,2,17,1,3,SpaceX,2002,per,,PROPN,NUM,nsubjpass,pobj,NNP,CD,3,1
5825,3997.0,19,is,1,1,8,7,0,10,0,7,Amala,Akkineni Nagarjuna,per,-,PROPN,PROPN-PROPN,nsubj,compound-pobj,NNP,NNP-NNP,3,1
5826,3998.0,27,was,11,1,25,24,0,1,10,14,Charlotte of Mecklenburg-Strelitz,George,per-per-per,,PROPN-ADP-PROPN,PROPN,nsubj-prep-pobj,compound,NNP-IN-NNP,NNP,8,1
5827,9596.0,17,named,3,6,15,9,5,1,-3,12,Charlotte of Mecklenburg-Strelitz,George,per-per-per,,PROPN-ADP-PROPN,PROPN,pobj-prep-pobj,compound,NNP-IN-NNP,NNP,6,1
5828,12270.0,44,refer,2,30,38,8,29,5,-28,36,Charlotte of Mecklenburg-Strelitz,George,org-org-org,,PROPN-ADP-PROPN,PROPN,pobj-prep-pobj,compound,NNP-IN-NNP,NNP,5,1
5829,3999.0,14,is,2,1,10,9,0,3,1,8,Liberty University,Lynchburg,per-per,,PROPN-PROPN,PROPN,compound-nsubj,compound,NNP-NNP,NNP,6,1
5830,4001.0,34,congratulated,10,4,8,4,3,25,6,-2,Bangladesh,Fakhruddin Ahmed,,org-org,PROPN,PROPN-PROPN,poss,compound-appos,NNP,NNP-NNP,5,1
5831,8404.0,43,left,9,4,8,4,3,34,5,-1,Bangladesh,Fakhruddin Ahmed,per,-,PROPN,PROPN-PROPN,poss,compound-appos,NNP,NNP-NNP,5,1
5832,4002.0,26,held,7,19,25,6,18,0,-12,18,University of Miami,Florida,--,org,PROPN-ADP-PROPN,PROPN,pobj-prep-pobj,pobj,NNP-IN-NNP,NNP,6,1
5833,4003.0,24,argues,4,14,21,7,13,2,-10,17,Leopold Kronecker,University of Berlin,org-org,--,PROPN-PROPN,PROPN-ADP-PROPN,compound-compound,pobj-prep-pobj,NNP-NNP,NNP-IN-NNP,5,1
5834,4005.0,28,moved,4,2,14,12,1,13,2,10,Morvan,Joss Entertainment Group,per,--,PROPN,PROPN-PROPN-PROPN,nsubj,compound-compound-pobj,NNP,NNP-NNP-NNP,6,1
5835,4006.0,26,became,3,12,15,3,11,10,-9,12,Richard Branson,Virgin Atlantic Airways,org-org,--,PROPN-PROPN,PROPN-PROPN-PROPN,compound-pobj,compound-compound-conj,NNP-NNP,NNP-NNP-NNPS,2,1
5836,4007.0,17,is,4,2,16,14,1,0,2,12,Bernard Lovell,England,-,per,PROPN-PROPN,PROPN,compound-compound,pobj,NNP-NNP,NNP,3,1
5837,4008.0,58,studied,2,7,51,44,6,6,-5,49,sensei,Florida,org,,NOUN,PROPN,compound,pobj,NN,NNP,9,1
5838,4009.0,31,noted,3,3,14,11,2,16,0,11,Wang,Taiwan,per,,PROPN,PROPN,nsubj,compound,NNP,NNP,6,1
5839,13146.0,28,said,1,1,11,10,0,16,0,10,Wang,Taiwan,per,,PROPN,PROPN,nsubj,poss,NNP,NNP,4,1
5840,4011.0,38,include,5,15,31,16,14,6,-10,26,director,Steven Shainberg,per,-,NOUN,PROPN-PROPN,compound,compound-pobj,NN,NNP-NNP,4,1
5841,4012.0,45,According,0,6,8,2,5,36,-6,8,YG Entertainment,Yang Hyun Suk,-,per-per-per,PROPN-PROPN,PROPN-PROPN-PROPN,compound-compound,pobj-ROOT-ROOT,NNP-NNP,NNP-NNP-NNP,1,1
5842,5905.0,17,worked,1,4,7,3,3,9,-3,6,YG Entertainment,Yang Hyun Suk,org-org,--,PROPN-PROPN,PROPN-PROPN-PROPN,compound-compound,compound-compound-compound,NNP-NNP,NNP-NNP-NNP,2,1
5843,7529.0,59,is,3,42,45,3,41,13,-39,42,YG Entertainment,Yang Hyun Suk,org-org,--,PROPN-PROPN,PROPN-PROPN-PROPN,compound-compound,compound-compound-pobj,NNP-NNP,NNP-NNP-NNP,3,1
5844,14072.0,43,stated,25,20,23,3,19,19,5,-2,YG Entertainment,Yang Hyun Suk,-,org-org-org,PROPN-PROPN,PROPN-PROPN-PROPN,compound-compound,compound-compound-nsubj,NNP-NNP,NNP-NNP-NNP,3,1
5845,4013.0,9,mar2008,7,1,4,3,0,4,6,-3,Nicole Kidman,Keith Urban,-,per-per,PROPN-PROPN,PROPN-PROPN,amod-nsubj,compound-conj,NNP-NNP,NNP-NNP,1,1
5846,4014.0,22,represented,8,3,16,13,2,5,5,8,Wake Forest University,NCAA,--,org,PROPN-PROPN-PROPN,PROPN,compound-compound-dobj,compound,NNP-NNP-NNP,NNP,5,1
5847,6384.0,45,attended,6,27,34,7,26,10,-21,28,Wake Forest University,NCAA,org-org-org,,PROPN-PROPN-PROPN,PROPN,compound-compound-pobj,compound,NNP-NNP-NNP,NNP,3,1
5848,4015.0,27,attended,1,3,5,2,2,21,-2,4,University of New Hampshire,New Hampshire Wildcats,org-org-org-org,--,PROPN-ADP-PROPN-PROPN,PROPN-PROPN-PROPN,dobj-prep-compound-pobj,compound-compound-compound,NNP-IN-NNP-NNP,NNP-NNP-NNPS,1,1
5849,4016.0,22,says,6,1,5,4,0,16,5,-1,Sweden,Fredrik Reinfeldt,per,-,PROPN,PROPN-PROPN,poss,compound-nsubj,NNP,NNP-NNP,3,1
5850,4515.0,27,formed,8,8,13,5,7,13,0,5,Sweden,Fredrik Reinfeldt,,per-per,PROPN,PROPN-PROPN,pobj,compound-pobj,NNP,NNP-NNP,6,1
5851,8166.0,15,was,1,9,13,4,8,1,-8,12,Sweden,Fredrik Reinfeldt,,org-org,PROPN,PROPN-PROPN,poss,compound-dobj,NNP,NNP-NNP,3,1
5852,8513.0,18,said,6,4,5,1,3,12,2,-1,Sweden,Fredrik Reinfeldt,,org-org,PROPN,PROPN-PROPN,pobj,compound-nsubj,NNP,NNP-NNP,1,1
5853,8682.0,15,has,2,9,13,4,8,1,-7,11,Sweden,Fredrik Reinfeldt,,per-per,PROPN,PROPN-PROPN,poss,compound-appos,NNP,NNP-NNP,3,1
5854,9945.0,30,thanked,4,6,10,4,5,19,-2,6,Sweden,Fredrik Reinfeldt,org,-,PROPN,PROPN-PROPN,poss,compound-appos,NNP,NNP-NNP,3,1
5855,14092.0,43,discussed,6,5,16,11,4,26,1,10,Sweden,Fredrik Reinfeldt,,per-per,PROPN,PROPN-PROPN,compound,compound-compound,NNP,NNP-NNP,8,1
5856,4017.0,33,is,2,9,9,0,8,23,-7,7,Ontario Institute for Studies in Education,Ontario,org-org-org-org-org-org,,PROPN-PROPN-ADP-PROPN-ADP-PROPN,PROPN,compound-pobj-prep-pobj-prep-pobj,pobj,NNP-NNP-IN-NNPS-IN-NNP,NNP,0,1
5857,4018.0,19,located,12,10,15,5,9,3,2,3,Xidian University,Xi'an,-,per,PROPN-PROPN,PROPN,compound-nsubjpass,compound,NNP-NNP,NNP,5,1
5858,4019.0,36,developed,16,6,12,6,5,23,10,-4,della Svizzera italiana,Lugano,per-per-per,,PROPN-PROPN-NOUN,PROPN,compound-compound-pobj,pobj,NNP-NNP-NN,NNP,6,1
5859,4021.0,27,received,1,8,15,7,7,11,-7,14,James M. Gavin,82nd Airborne Division,--,org-org-org,PROPN-PROPN-PROPN,ADJ-PROPN-PROPN,compound-compound-pobj,compound-compound-pobj,NNP-NNP-NNP,JJ-NNP-NNP,5,1
5860,4022.0,54,born,6,19,27,8,18,26,-13,21,Charles Edward Duke of Saxe-Coburg and Gotha,Princess Victoria Adelaide of Schleswig-Holstein,------,per-per-per-per-per,PROPN-PROPN-PROPN-ADP-PROPN-CCONJ-PROPN,PROPN-PROPN-PROPN-ADP-PROPN,compound-compound-pobj-prep-pobj-cc-conj,compound-compound-conj-prep-pobj,NNP-NNP-NNP-IN-NNP-CC-NNP,NNP-NNP-NNP-IN-NNP,5,1
5861,9224.0,43,was,14,28,38,10,27,4,-14,24,Charles Edward Duke of Saxe-Coburg and Gotha,Princess Victoria Adelaide of Schleswig-Holstein,per-per-per-per-per-per-per,----,PROPN-PROPN-PROPN-ADP-PROPN-CCONJ-PROPN,PROPN-PROPN-PROPN-ADP-PROPN,compound-compound-pobj-prep-pobj-cc-conj,compound-compound-appos-prep-pobj,NNP-NNP-NNP-IN-NNP-CC-NNP,NNP-NNP-NNP-IN-NNP,6,1
5862,4023.0,26,served,3,1,7,6,0,18,2,4,Nicholas Gilman,New Hampshire,org-org,-,PROPN-PROPN,PROPN-PROPN,compound-compound,compound-compound,NNP-NNP,NNP-NNP,6,1
5863,4024.0,23,is,3,1,13,12,0,9,2,10,West Coast Customs,Ryan Friedlinghaus,per-per-per,-,PROPN-PROPN-PROPN,PROPN-PROPN,compound-compound-nsubj,compound-pobj,NNP-NNP-NNP,NNP-NNP,5,1
5864,4025.0,21,is,6,18,19,1,17,1,-12,13,minister,Abraham Kuyper,,per-per,NOUN,PROPN-PROPN,pobj,compound-appos,NN,NNP-NNP,1,1
5865,4026.0,25,give,3,8,21,13,7,3,-5,18,Brown,Georgia,per,,PROPN,PROPN,poss,pobj,NNP,NNP,9,1
5866,4027.0,40,supported,4,19,23,4,18,16,-15,19,University of Oslo,Norway,--,org,PROPN-ADP-PROPN,PROPN,pobj-prep-pobj,pobj,NNP-IN-NNP,NNP,4,1
5867,4028.0,46,was,20,5,15,10,4,30,15,-5,Kode9,Hyperdub,per,,PUNCT,PROPN,poss,compound,",",NNP,5,1
5868,4029.0,33,appointed,12,8,12,4,7,20,4,0,Florida University,Trustees,per-per,,PROPN-PROPN,PROPN,compound-compound,pobj,NNP-NNP,NNPS,2,1
5869,4031.0,64,elected,4,11,23,12,10,40,-7,19,United States,John Adams,per-per,-,PROPN-PROPN,PROPN-PROPN,compound-compound,compound-pobj,NNP-NNP,NNP-NNP,11,1
5870,13862.0,41,losses,5,4,13,9,3,27,1,8,United States,John Adams,org-org,-,PROPN-PROPN,PROPN-PROPN,compound-nsubj,compound-nsubj,NNP-NNP,NNP-NNP,3,1
5871,14208.0,26,was,8,4,18,14,3,7,4,10,United States,John Adams,per-per,-,PROPN-PROPN,PROPN-PROPN,nmod-nmod,compound-dobj,NNP-NNP,NNP-NNP,8,1
5872,4032.0,19,In,0,8,11,3,7,7,-8,11,Molson,Canada,,per,PROPN,PROPN,pobj,pobj,NNP,NNP,1,1
5873,10464.0,57,focuses,26,17,25,8,16,31,9,-1,Molson,Canada,org,,PROPN,PROPN,compound,pobj,NNP,NNP,4,1
5874,4033.0,30,said,22,21,29,8,20,0,1,7,Fatmir Sejdiu,Pristina,org-org,,PROPN-PROPN,PROPN,compound-conj,appos,NNP-NNP,NNP,9,1
5875,4034.0,24,said,3,3,5,2,2,18,0,2,Brown,Ohio,per,,PROPN,PROPN,nsubj,compound,NNP,NNP,2,1
5876,4035.0,26,was,1,5,14,9,4,11,-4,13,Joseph Saidu Momoh,Sierra Leone,--,org-org,PROPN-PROPN-PROPN,PROPN-PROPN,compound-compound-attr,compound-compound,NNP-NNP-NNP,NNP-NNP,7,1
5877,12202.0,27,chose,10,13,20,7,12,6,-3,10,Joseph Saidu Momoh,Sierra Leone,per-per-per,-,PROPN-PROPN-PROPN,PROPN-PROPN,compound-compound-dobj,compound-compound,NNP-NNP-NNP,NNP-NNP,5,1
5878,4036.0,22,remained,6,13,9,-4,12,12,-7,3,GmbH,Robert Bosch GmbH,org,--,PROPN,PROPN-PROPN-PROPN,pobj,compound-compound-pobj,NNP,NNP-NNP-NNP,6,1
5879,4037.0,38,criticized,6,34,35,1,33,2,-28,29,Canadian,Supreme Court,,per-per,PROPN,PROPN-PROPN,compound,compound-compound,NNP,NNP-NNP,2,1
5880,4038.0,25,waiting,12,18,24,6,17,0,-6,12,he,Washington,org,,PRON,PROPN,nsubj,pobj,PRP,NNP,5,1
5881,4039.0,40,came,24,7,20,13,6,19,17,-4,Cork,University College Cork,org,--,PROPN,PROPN-PROPN-PROPN,pobj,compound-compound-compound,NNP,NNP-NNP-NNP,7,1
5882,4040.0,14,lives,4,1,7,6,0,6,3,3,Paulinho Da Viola,Rio de Janeiro,org-org-org,--,PROPN-PROPN-PROPN,PROPN-PROPN-PROPN,compound-compound-nsubj,compound-compound-pobj,NNP-NNP-NNP,NNP-NNP-NNP,5,1
5883,4041.0,31,awarded,5,2,23,21,1,7,3,18,Australia,RMIT University,per,-,PROPN,PROPN-PROPN,pobj,compound-pobj,NNP,NNP-NNP,12,1
5884,4043.0,17,represented,6,2,12,10,1,4,4,6,Appalachian State University,Boone,--,per,PROPN-PROPN-PROPN,PROPN,compound-compound-dobj,compound,NNP-NNP-NNP,NNP,7,1
5885,4044.0,19,is,8,1,16,15,0,2,7,8,Oil Refineries Ltd.,Haifa,per-per-per,,PROPN-PROPN-PROPN,PROPN,compound-compound-subtok,compound,NNP-NNPS-NNP,NNP,7,1
5886,4045.0,16,run,13,3,15,12,2,0,10,2,Harry Rosenberg,LE,org-org,,PROPN-PROPN,NOUN,compound-compound,dobj,NNP-NNP,NN,5,1
5887,4046.0,28,attended,12,11,12,1,10,15,1,0,Canada,he,,per,PROPN,PRON,pobj,nsubj,NNP,PRP,1,1
5888,4047.0,28,envisioned,7,21,27,6,20,0,-14,20,Argentina,Eva,per,,PROPN,PROPN,poss,pobj,NNP,NNP,2,1
5889,4048.0,39,broken,3,18,30,12,17,8,-15,27,ABN AMRO,Royal Bank of Scotland Group,org-org,----,PROPN-PROPN,PROPN-PROPN-ADP-PROPN-PROPN,compound-pobj,compound-dobj-prep-compound-pobj,NNP-NNP,NNP-NNP-IN-NNP-NNP,8,1
5890,12180.0,43,agreed,3,8,14,6,7,28,-5,11,ABN AMRO,Royal Bank of Scotland Group,-,org-org-org-org-org,PROPN-PROPN,PROPN-PROPN-ADP-PROPN-PROPN,compound-dobj,compound-conj-prep-compound-pobj,NNP-NNP,NNP-NNP-IN-NNP-NNP,3,1
5891,4049.0,18,organized,6,11,17,6,10,0,-5,11,Association,Malaysia,per,,PROPN,PROPN,pobj,appos,NNP,NNP,4,1
5892,4050.0,41,made,4,34,38,4,33,2,-30,34,t Hugo,f Venezuel,org-org,-,PROPN-PROPN,X-PROPN,compound-compound,det-compound,NNP-NNP,XX-NNP,-1,1
5893,4052.0,33,told,5,1,9,8,0,23,4,4,Air India,Mumbai,-,per,PROPN-PROPN,PROPN,compound-compound,pobj,NNP-NNP,NNP,5,1
5894,4054.0,41,Jankovi?,1,5,16,11,4,24,-4,15,s Nele Karajli,PR Bosnia-Herzegovi,per-per-per,-,NOUN-PROPN-PROPN,PROPN-VERB,dobj-compound-oprd,pobj-dep,NN-NNP-NNP,NNP-VBZ,-1,1
5895,4055.0,26,received,3,13,15,2,12,10,-10,12,London,David Suchet,per,-,PROPN,PROPN-PROPN,pobj,compound-pobj,NNP,NNP-NNP,1,1
5896,4381.0,36,directed,4,16,22,6,15,13,-12,18,London,David Suchet,,per-per,PROPN,PROPN-PROPN,pobj,compound-compound,NNP,NNP-NNP,6,1
5897,4056.0,26,returned,3,3,7,4,2,18,0,4,NPG,Prince,per,,PROPN,PROPN,nsubj,compound,NNP,NNP,1,1
5898,4057.0,11,born,2,5,8,3,4,2,-3,6,Hampshire,Purbrook Junior School,org,--,PROPN,PROPN-PROPN-PROPN,dobj,compound-compound-dobj,NNP,NNP-NNP-NNP,4,1
5899,4058.0,36,led,8,25,33,8,24,2,-17,25,Billy Hughes,National Labor Party,org-org,--,PROPN-PROPN,PROPN-PROPN-PROPN,compound-conj,compound-compound-dobj,NNP-NNP,NNP-NNP-NNP,8,1
5900,4059.0,59,is,45,40,43,3,39,15,5,-2,BASF,Ludwigshafen,per,,PROPN,PROPN,amod,pobj,NNP,NNP,9,1
5901,4060.0,29,started,1,9,13,4,8,15,-8,12,his,Lowest Music Arts,,org-org-org,DET,PROPN-PROPN-PROPN,poss,compound-compound-appos,PRP$,NNP-NNP-NNPS,3,1
5902,4061.0,18,is,3,1,10,9,0,7,2,7,Dundee-Crown High School,Carpentersville,per-per-per,,PROPN-PROPN-PROPN,PROPN,compound-compound-nsubj,compound,NNP-NNP-NNP,NNP,5,1
5903,4062.0,24,sent,5,9,19,10,8,4,-4,14,Air Education and Training Command,Texas,----,org,PROPN-PROPN-CCONJ-PROPN-PROPN,PROPN,compound-appos-cc-compound-conj,pobj,NNP-NNP-CC-NNP-NNP,NNP,3,1
5904,4063.0,52,protesting,2,30,35,5,29,16,-28,33,Emily Lau,Hong Kong,-,per-per,PROPN-PROPN,PROPN-PROPN,nsubj-ROOT,compound-poss,NNP-NNP,NNP-NNP,6,1
5905,4065.0,33,said,4,3,20,17,2,12,1,16,Nicolas Sarkozy,Paris,org-org,,PROPN-PROPN,PROPN,compound-nsubj,pobj,NNP-NNP,NNP,5,1
5906,4067.0,43,consisted,20,6,31,25,5,11,14,11,United Kingdom,Henry Campbell-Bannerman,-,per-per,PROPN-PROPN,PROPN-PROPN,compound-pobj,compound-pobj,NNP-NNP,NNP-NNP,5,1
5907,4068.0,54,studied,1,5,7,2,4,46,-4,6,Maryland,Frederick High School,,per-per-per,PROPN,PROPN-PROPN-PROPN,pobj,compound-compound-pobj,NNP,NNP-NNP-NNP,2,1
5908,4069.0,17,interpolates,1,7,15,8,6,1,-6,14,The Sequence,Sugar Hill,org-org,-,DET-NOUN,PROPN-PROPN,det-pobj,compound-pobj,DT-NN,NNP-NNP,7,1
5909,4071.0,19,threaten,10,8,15,7,7,3,2,5,Switzerland,Pascal Couchepin,per,-,PROPN,PROPN-PROPN,pobj,compound-nsubj,NNP,NNP-NNP,7,1
5910,4072.0,10,sell,3,1,8,7,0,1,2,5,Chrysler,Jeep,,org,PROPN,PROPN,poss,conj,NNP,NNP,4,1
5911,4767.0,13,said,3,1,5,4,0,7,2,2,Chrysler,Jeep,,org,PROPN,PROPN,poss,nsubj,NNP,NNP,4,1
5912,6353.0,32,says,4,1,9,8,0,22,3,5,Chrysler,Jeep,,per,PROPN,PROPN,compound,conj,NNP,NNP,4,1
5913,6732.0,27,was,1,6,25,19,5,1,-5,24,Chrysler,Jeep,,org,PROPN,PROPN,poss,compound,NNP,NNP,8,1
5914,7179.0,31,retains,1,14,26,12,13,4,-13,25,Chrysler,Jeep,org,,PROPN,PROPN,nmod,pobj,NNP,NNP,6,1
5915,8000.0,29,knows,2,13,22,9,12,6,-11,20,Chrysler,Jeep,,org,PROPN,PROPN,compound,nmod,NNP,NNP,8,1
5916,10140.0,15,say,1,3,6,3,2,8,-2,5,Chrysler,Jeep,per,,PROPN,PROPN,nsubj,poss,NNP,NNP,4,1
5917,11695.0,37,acquired,1,1,4,3,0,32,0,3,Chrysler,Jeep,org,,PROPN,PROPN,nsubj,compound,NNP,NNP,1,1
5918,12630.0,28,have,3,1,14,13,0,13,2,11,Chrysler,Jeep,per,,PROPN,PROPN,nsubj,compound,NNP,NNP,5,1
5919,4073.0,15,Passed,0,10,12,2,9,2,-10,12,Kakatiya University,Warangal,org-org,,PROPN-PROPN,PROPN,compound-compound,compound,NNP-NNP,NNP,2,1
5920,4075.0,13,named,9,2,8,6,1,4,7,-1,Burton Cummings,Winnipeg,per-per,,PROPN-PROPN,PROPN,compound-compound,pobj,NNP-NNP,NNP,3,1
5921,4076.0,24,succeeded,3,2,14,12,1,9,1,11,Kim Campbell,Communications,-,per,PROPN-PROPN,PROPN,compound-nsubj,pobj,NNP-NNP,NNPS,3,1
5922,4077.0,57,proceeds,7,28,49,21,27,7,-21,42,France,Jacques Demy,,per-per,PROPN,PROPN-PROPN,pobj,compound-appos,NNP,NNP-NNP,8,1
5923,4078.0,39,is,10,18,34,16,17,4,-8,24,artist,her,,org,NOUN,DET,conj,poss,NN,PRP$,4,1
5924,4079.0,54,Fortunately,0,7,14,7,6,39,-7,14,Brigade,15th Infantry Brigade,,org-org-org,PROPN,PROPN-PROPN-PROPN,nmod,npadvmod-compound-nsubj,NNP,NNP-NNP-NNP,3,1
5925,4080.0,24,used,7,18,23,5,17,0,-11,16,Evansville Crimson Giants,NFL,org-org-org,,PROPN-PROPN-PROPN,PROPN,compound-compound-pobj,pobj,NNP-NNP-NNPS,NNP,6,1
5926,4938.0,25,is,1,14,23,9,13,1,-13,22,Evansville Crimson Giants,NFL,per-per-per,,PROPN-PROPN-PROPN,PROPN,compound-compound-pobj,appos,NNP-NNP-NNP,NNP,8,1
5927,4082.0,54,heard,3,22,23,1,21,30,-19,20,Sirius XM Radio,XM Satellite Radio,org-org-org,--,PROPN-PROPN-PROPN,PROPN-PROPN-PROPN,compound-compound-pobj,compound-compound-poss,NNP-NNP-NNP,NNP-NNP-NNP,1,1
5928,4083.0,27,is,6,12,24,12,11,2,-6,18,Arkansas,her,org,,PROPN,DET,pobj,poss,NNP,PRP$,4,1
5929,4084.0,32,is,2,16,16,0,15,15,-14,14,Nintendo Software Technology,Nintendo,per-per-per,,PROPN-PROPN-PROPN,PROPN,compound-compound-compound,compound,NNP-NNP-NNP,NNP,0,1
5930,4085.0,19,founded,1,1,7,6,0,11,0,6,She,Paris,per,,PRON,PROPN,nsubj,pobj,PRP,NNP,2,1
5931,4086.0,79,Source,1,21,43,22,20,35,-20,42,UK,Clydesdale Bank,per,-,PROPN,PROPN-PROPN,pobj,compound-pobj,NNP,NNP-NNP,7,1
5932,4087.0,49,introduced,9,5,16,11,4,32,4,7,1986,The Machines,,per-per,NUM,DET-PROPN,pobj,det-oprd,CD,DT-NNPS,7,1
5933,4088.0,17,Ansteel,8,2,9,7,1,7,6,1,Anshan Iron and Steel Group,Ansteel,----,per,PROPN-PROPN-CCONJ-PROPN-PROPN,PROPN,compound-nmod-cc-compound-compound,ROOT,NNP-NNP-CC-NNP-NNP,NNP,2,1
5934,4089.0,27,is,2,12,17,5,11,9,-10,15,China National Space Administration,CNSA,---,org,PROPN-PROPN-PROPN-PROPN,PROPN,compound-compound-compound-pobj,appos,NNP-NNP-NNP-NNP,NNP,3,1
5935,6541.0,28,be,2,21,26,5,20,1,-19,24,China National Space Administration,CNSA,org-org-org-org,,PROPN-PROPN-PROPN-PROPN,PROPN,compound-compound-compound-pobj,appos,NNP-NNP-NNP-NNP,NNP,2,1
5936,4090.0,24,created,3,3,6,3,2,17,0,3,Disney,Jetix,,org,PROPN,PROPN,nsubj,compound,NNP,NNP,1,1
5937,4091.0,45,found,8,32,40,8,31,4,-24,32,Frank Swettenham,Federated Malay States,-,per-per-per,PROPN-PROPN,PROPN-PROPN-PROPN,compound-pobj,compound-compound-pobj,NNP-NNP,NNP-NNP-NNP,4,1
5938,4093.0,42,was,2,1,38,37,0,3,1,36,Lagos Weber,Chile,org-org,,PROPN-PROPN,PROPN,compound-nsubj,poss,NNP-NNP,NNP,15,1
5939,4097.0,23,recognized,21,7,7,0,6,15,14,-14,Bill Melinda Gates Foundation,Bill Gates,per-per-per-per,-,PROPN-PROPN-PROPN-PROPN,PROPN-PROPN,compound-compound-compound-pobj,compound-pobj,NNP-NNP-NNP-NNP,NNP-NNP,0,1
5940,4098.0,82,Consider,0,23,26,3,22,55,-23,26,Les Paul,inventor,-,per,PROPN-PROPN,NOUN,compound-ROOT,appos,NNP-NNP,NN,2,1
5941,4099.0,33,asset,3,6,1,-5,5,31,-3,-2,CTVglobemedia,The Woodbridge Company,,per-per-per,PROPN,DET-PROPN-PROPN,pobj,compound-compound-nmod,NNP,DT-NNP-NNP,2,1
5942,4100.0,27,was,7,1,12,11,0,14,6,5,Alexandra of Denmark,Edward,org-org-org,,PROPN-ADP-PROPN,PROPN,nsubj-prep-pobj,compound,NNP-IN-NNP,NNP,5,1
5943,4407.0,25,was,5,5,19,14,4,5,0,14,Alexandra of Denmark,Edward,per-per-per,,PROPN-ADP-PROPN,PROPN,pobj-prep-pobj,compound,NNP-IN-NNP,NNP,4,1
5944,4101.0,27,has,1,7,15,8,6,11,-6,14,Netherlands,The Prophet,,org-org,PROPN,DET-PROPN,pobj,det-conj,NNP,DT-NNP,6,1
5945,4102.0,33,HAVANA,0,3,22,19,2,10,-3,22,Cuba,Castro,,per,PROPN,PROPN,nsubj,nsubj,NNP,NNP,6,1
5946,6577.0,18,joined,2,1,15,14,0,2,1,13,Cuba,Castro,,per,PROPN,PROPN,nsubj,conj,NNP,NNP,5,1
5947,4103.0,21,became,3,3,18,15,2,2,0,15,UMUC,Maryland,org,,PROPN,PROPN,nsubj,pobj,NNP,NNP,2,1
5948,4104.0,15,was,1,7,13,6,6,1,-6,12,John Cassavetes,Gena Rowlands,-,per-per,PROPN-PROPN,PROPN-PROPN,compound-pobj,compound-pobj,NNP-NNP,NNP-NNP,3,1
5949,4105.0,32,was,13,1,10,9,0,21,12,-3,Confucius,China,,per,PROPN,PROPN,nsubj,poss,NNP,NNP,6,1
5950,6759.0,33,began,5,2,22,20,1,10,3,17,Confucius,China,,org,PROPN,PROPN,poss,pobj,NNP,NNP,7,1
5951,4106.0,33,ordered,16,3,10,7,2,22,13,-6,Joseph Hooker,Army of the Potomac,-,org-org-org-org,PROPN-PROPN,PROPN-ADP-DET-PROPN,compound-nsubj,pobj-prep-det-pobj,NNP-NNP,NNP-IN-DT-NNP,5,1
5952,4107.0,27,is,2,14,20,6,13,6,-12,18,Aftermath,Eminem,per,,PROPN,PROPN,conj,pobj,NNP,NNP,5,1
5953,6010.0,34,released,10,5,10,5,4,23,5,0,Aftermath,Eminem,,per,PROPN,PROPN,nmod,nsubj,NNP,NNP,5,1
5954,8918.0,17,signed,9,9,14,5,8,2,0,5,Aftermath,Eminem,,per,PROPN,PROPN,pobj,dobj,NNP,NNP,2,1
5955,4108.0,12,is,2,1,11,10,0,0,1,9,Since October,Florida,-,org,ADP-PROPN,PROPN,prep-pobj,pobj,IN-NNP,NNP,2,1
5956,4109.0,28,are,2,11,22,11,10,5,-9,20,Nova Scotia,Jack Syperek,-,org-org,PROPN-PROPN,PROPN-PROPN,compound-pobj,compound-pobj,NNP-NNP,NNP-NNP,-1,1
5957,4111.0,35,secured,9,1,8,7,0,26,8,-1,Zardari,Benazir Bhutto,org,-,PROPN,PROPN-PROPN,amod,compound-pobj,NNP,NNP-NNP,2,1
5958,4112.0,22,is,7,1,1,0,0,20,6,-6,Defiance College,Defiance Ohio,-,org-org,PROPN-PROPN,PROPN-PROPN,compound-nsubj,compound-compound,NNP-NNP,NNP-NNP,0,1
5959,4113.0,26,started,14,2,13,11,1,12,12,-1,Petra,Bob Hartman,per,-,PROPN,PROPN-PROPN,poss,compound-conj,NNP,NNP-NNP,6,1
5960,4114.0,22,studied,7,10,20,10,9,1,-3,13,Naropa University,Boulder,-,per,PROPN-PROPN,PROPN,compound-poss,compound,NNP-NNP,NNP,2,1
5961,10664.0,35,disciplined,9,23,26,3,22,8,-14,17,Naropa University,Boulder,-,org,PROPN-PROPN,PROPN,compound-pobj,compound,NNP-NNP,NNP,1,1
5962,4115.0,32,issued,5,2,21,19,1,10,3,16,Rough Trade,Cabaret Voltaire,per-per,-,PROPN-PROPN,PROPN-PROPN,compound-compound,compound-pobj,NNP-NNP,NNP-NNP,7,1
5963,4117.0,32,',0,9,11,2,8,20,-9,11,Analyst,Sibel Edmonds,per,-,NOUN,PROPN-PROPN,ROOT,compound-nsubj,NN,NNP-NNP,3,1
5964,4118.0,48,is,2,22,25,3,21,22,-20,23,Phil Manzanera,musician,per-per,,PROPN-PROPN,ADJ,compound-pobj,amod,NNP-NNP,JJ,5,1
5965,4120.0,11,is,3,2,9,7,1,1,1,6,PSTU,Patuakhali,per,,PROPN,PROPN,compound,compound,NNP,NNP,3,1
5966,4121.0,61,is,8,3,27,24,2,33,5,19,New Zealand,ANZ National Bank,org-org,--,PROPN-PROPN,PROPN-PROPN-PROPN,nmod-nmod,compound-compound-appos,NNP-NNP,NNP-NNP-NNP,7,1
5967,4122.0,15,is,4,2,13,11,1,1,2,9,Glenn Gould,Toronto,per-per,,PROPN-PROPN,PROPN,compound-compound,compound,NNP-NNP,NNP,6,1
5968,11273.0,43,asked,10,5,39,34,4,3,5,29,Glenn Gould,Toronto,per-per,,PROPN-PROPN,PROPN,compound-compound,pobj,NNP-NNP,NNP,13,1
5969,13491.0,37,included,1,3,6,3,2,30,-2,5,Glenn Gould,Toronto,org-org,,PROPN-PROPN,PROPN,compound-dobj,compound,NNP-NNP,NNP,1,1
5970,4123.0,26,is,7,1,23,22,0,2,6,16,Global Urban Research Unit,Newcastle University,---,per-per,PROPN-PROPN-PROPN-PROPN,PROPN-PROPN,compound-compound-compound-nsubj,compound-compound,NNP-NNP-NNP-NNP,NNP-NNP,11,1
5971,4124.0,51,made,6,24,40,16,23,10,-18,34,Sean Waltman,Kid,-,per,PROPN-PROPN,PROPN,compound-nsubj,pobj,NNP-NNP,NNP,6,1
5972,4125.0,52,Smith,2,20,30,10,19,21,-18,28,songwriter,Carl Wilson,org,-,NOUN,PROPN-PROPN,attr,compound-poss,NN,NNP-NNP,4,1
5973,4126.0,21,purchased,2,16,19,3,15,1,-14,17,Commercial Iron Works,Portland Oregon,--,per-per,PROPN-PROPN-PROPN,PROPN-PROPN,compound-compound-compound,compound-pobj,NNP-NNP-NNP,NNP-NNP,2,1
5974,10098.0,49,launched,15,21,24,3,20,24,-6,9,Commercial Iron Works,Portland Oregon,--,org-org,PROPN-PROPN-PROPN,PROPN-PROPN,compound-compound-compound,compound-pobj,NNP-NNP-NNP,NNP-NNP,3,1
5975,4127.0,32,was,10,1,15,14,0,16,9,5,Maureen Murphy,Illinois,per-per,,PROPN-PROPN,PROPN,compound-nsubj,pobj,NNP-NNP,NNP,3,1
5976,4128.0,24,Got,1,15,22,7,14,1,-14,21,James Cruze,Betty Compson,-,org-org,PROPN-PROPN,PROPN-PROPN,compound-pobj,compound-appos,NNP-NNP,NNP-NNP,3,1
5977,4129.0,25,recorded,3,12,22,10,11,2,-9,19,Toronto,Glenn Gould,,per-per,PROPN,PROPN-PROPN,pobj,compound-compound,NNP,NNP-NNP,10,1
5978,6881.0,20,given,4,16,17,1,15,2,-12,13,Toronto,Glenn Gould,per,-,PROPN,PROPN-PROPN,pobj,compound-compound,NNP,NNP-NNP,2,1
5979,4130.0,34,founded,5,11,25,14,10,8,-6,20,Bronx,Crazy Legs,per,-,PROPN,PROPN-PROPN,pobj,compound-compound,NNP,NNP-NNP,8,1
5980,4131.0,28,is,10,2,9,7,1,18,8,-1,Red Sea Institute of Cinematic Arts,RSICA,-----,per,PROPN-PROPN-PROPN-ADP-PROPN-PROPN,PROPN,compound-compound-nsubj-prep-compound-pobj,appos,NNP-NNP-NNP-IN-NNP-NNP,NNP,3,1
5981,4132.0,22,is,9,1,1,0,0,20,8,-8,Kongsberg Maritime,Kongsberg Gruppen,-,per-per,PROPN-PROPN,PROPN-PROPN,compound-pobj,compound-pobj,NNP-NNP,NNP-NNP,0,1
5982,12306.0,18,is,5,1,1,0,0,16,4,-4,Kongsberg Maritime,Kongsberg Gruppen,-,org-org,PROPN-PROPN,PROPN-PROPN,compound-nsubj,compound-pobj,NNP-NNP,NNP-NNP,0,1
5983,4134.0,27,released,2,9,17,8,8,9,-7,15,So So Def Recordings,Jermaine Dupri,per-per-per-per,-,ADV-ADV-PROPN-PROPN,PROPN-PROPN,pobj-advmod-compound-ROOT,compound-pobj,RB-RB-NNP-NNP,NNP-NNP,5,1
5984,4135.0,35,played,1,20,31,11,19,3,-19,30,Missouri Tigers,Division I,org-org,-,PROPN-PROPN,PROPN-PRON,compound-pobj,compound-compound,NNP-NNP,NNP-PRP,8,1
5985,4136.0,17,competed,5,3,9,6,2,7,2,4,Suns,school,org,,PROPN,NOUN,compound,poss,NNPS,NN,6,1
5986,4137.0,26,played,1,20,25,5,19,0,-19,24,Hillcrest High School,Missouri,--,per,PROPN-PROPN-PROPN,PROPN,compound-compound-pobj,pobj,NNP-NNP-NNP,NNP,10,1
5987,4138.0,17,are,3,13,16,3,12,0,-10,13,Jeff Halper,ICAHD,org-org,,PROPN-PROPN,PROPN,compound-conj,pobj,NNP-NNP,NNP,3,1
5988,11233.0,66,nominated,19,21,34,13,20,31,-2,15,Jeff Halper,ICAHD,per-per,,PROPN-PROPN,PROPN,compound-dobj,poss,NNP-NNP,NNP,3,1
5989,4139.0,19,produced,6,12,1,-11,11,17,-6,-5,Bad Boy Records,The Hitmen,--,per-per,PROPN-PROPN-PROPN,DET-PROPN,compound-compound-compound,det-appos,NNP-NNP-NNPS,DT-NNP,7,1
5990,14228.0,23,released,2,9,16,7,8,6,-7,14,Bad Boy Records,The Hitmen,--,per-per,PROPN-PROPN-PROPN,DET-PROPN,compound-compound-pobj,det-compound,NNP-NNP-NNPS,DT-NNP,7,1
5991,4140.0,25,reinstated,6,4,23,19,3,1,2,17,Heath Streak,Zimbabwean,per-per,,PROPN-PROPN,ADJ,compound-nsubjpass,amod,NNP-NNP,JJ,3,1
5992,4141.0,19,devoted,2,1,10,9,0,8,1,8,His,Quebec,,per,DET,PROPN,poss,pobj,PRP$,NNP,2,1
5993,4142.0,22,gained,5,5,9,4,4,12,0,4,she,Switzerland,per,,PRON,PROPN,nsubj,pobj,PRP,NNP,1,1
5994,4143.0,26,is,12,9,11,2,8,14,3,-1,Australia,APESMA,per,,PROPN,PROPN,conj,appos,NNP,NNP,2,1
5995,4144.0,30,As,0,7,12,5,6,17,-7,12,Florida,he,org,,PROPN,PRON,compound,nsubj,NNP,PRP,4,1
5996,4145.0,40,became,8,4,10,6,3,29,4,2,Tetsuya Komuro,Japan,-,org,PROPN-PROPN,PROPN,compound-poss,poss,NNP-NNP,NNP,6,1
5997,4148.0,28,was,5,4,15,11,3,12,1,10,Bell,Chicago,per,,PROPN,PROPN,nsubj,compound,NNP,NNP,6,1
5998,4149.0,19,is,2,10,18,8,9,0,-8,16,Katy Garbi,Greece,-,per,PROPN-PROPN,PROPN,compound-pobj,pobj,NNP-NNP,NNP,4,1
5999,10903.0,24,is,5,13,23,10,12,0,-8,18,Katy Garbi,Greece,per-per,,PROPN-PROPN,PROPN,compound-pobj,pobj,NNP-NNP,NNP,4,1
6000,4153.0,25,are,1,10,19,9,9,5,-9,18,Glasgow,Loganair,,org,PROPN,PROPN,nmod,pobj,NNP,NNP,7,1
6001,4154.0,22,requested,4,6,15,9,5,6,-2,11,Noriega,French,,per,PROPN,ADJ,poss,amod,NNP,JJ,7,1
6002,4158.0,26,is,12,1,11,10,0,14,11,-1,Steve Jones,England,-,per,PROPN-PROPN,PROPN,compound-nsubj,pobj,NNP-NNP,NNP,2,1
6003,4159.0,24,founded,16,12,19,7,11,4,4,3,University of Westminster,1838,--,org,PROPN-ADP-PROPN,NUM,appos-prep-pobj,pobj,NNP-IN-NNP,CD,4,1
6004,4161.0,15,are,8,2,7,5,1,7,6,-1,Vietnam,VPAF,org,,PROPN,PROPN,nmod,appos,NNP,NNP,2,1
6005,4163.0,17,is,7,1,11,10,0,5,6,4,Sasha,singer,,per,PROPN,NOUN,nsubj,compound,NNP,NN,4,1
6006,4164.0,25,coined,3,8,17,9,7,7,-5,14,Luis von Ahn,Carnegie Mellon University,per-per-per,--,PROPN-PROPN-PROPN,PROPN-PROPN-PROPN,compound-compound-compound,compound-compound-pobj,NNP-NNP-NNP,NNP-NNP-NNP,4,1
6007,9305.0,25,is,7,1,22,21,0,2,6,15,Luis von Ahn,Carnegie Mellon University,per-per-per,--,PROPN-PROPN-PROPN,PROPN-PROPN-PROPN,compound-compound-nsubj,compound-compound-pobj,NNP-NNP-NNP,NNP-NNP-NNP,9,1
6008,4165.0,21,is,6,2,18,16,1,2,4,12,Western Michigan Broncos,Kalamazoo,per-per-per,,PROPN-PROPN-PROPN,PROPN,compound-compound-compound,compound,NNP-NNP-NNP,NNP,9,1
6009,4166.0,22,graduated,3,6,10,4,5,11,-3,7,Catawba College,North Carolina,per-per,-,PROPN-PROPN,PROPN-PROPN,compound-pobj,compound-pobj,NNP-NNP,NNP-NNP,2,1
6010,4167.0,27,was,6,12,18,6,11,8,-6,12,London,Heath,,org,PROPN,PROPN,compound,compound,NNP,NNP,6,1
6011,4168.0,25,announced,6,9,12,3,8,12,-3,6,Ronald Perelman,MacAndrews Forbes Holdings,-,per-per-per,PROPN-PROPN,PROPN-PROPN-PROPN,compound-poss,compound-compound-compound,NNP-NNP,NNP-NNP-NNPS,3,1
6012,4169.0,24,is,7,2,21,19,1,2,5,14,Idaho Botanical Garden,Boise,per-per-per,,PROPN-PROPN-PROPN,PROPN,compound-compound-nsubj,compound,NNP-NNP-NNP,NNP,7,1
6013,4170.0,21,recorded,1,6,9,3,5,11,-5,8,Matchbox Twenty,Rob Thomas,per-per,-,PROPN-PROPN,PROPN-PROPN,compound-compound,compound-pobj,NNP-NNP,NNP-NNP,2,1
6014,4171.0,32,run,3,21,29,8,20,2,-18,26,MTR Corporation,Hong Kong,per-per,-,PROPN-PROPN,PROPN-PROPN,compound-pobj,compound-compound,NNP-NNP,NNP-NNP,5,1
6015,4172.0,24,left,1,3,23,20,2,0,-2,22,OMX,Latvia,per,,PROPN,PROPN,dobj,conj,NNP,NNP,2,1
6016,4173.0,26,try,16,6,10,4,5,15,10,-6,ld Naotake Sa,44; Ja,per-per-per,-,VERB-PROPN-PROPN,NUM-PROPN,nmod-compound-dobj,compound-compound,VB-NNP-NNP,CD-NNP,6,1
6017,4174.0,18,is,3,1,17,16,0,0,2,14,Tumbleweed Southwest Grill,Indiana,org-org-org,,PROPN-PROPN-PROPN,PROPN,compound-compound-nsubj,pobj,NNP-NNP-NNP,NNP,3,1
6018,4175.0,35,are,1,8,27,19,7,7,-7,26,Vietnam,HCMC,,per,PROPN,NOUN,pobj,pobj,NNP,NN,8,1
6019,4176.0,34,is,9,1,22,21,0,11,8,13,Paroube,e Czech Republi,,org-org-org,PROPN,PUNCT-PROPN-PROPN,compound,compound-compound-compound,NNP,LS-NNP-NNP,9,1
6020,4177.0,79,is,3,36,14,-22,35,64,-33,11,Lehigh Valley Railroad,New Jersey,--,org-org,PROPN-PROPN-PROPN,PROPN-PROPN,compound-compound-pobj,compound-compound,NNP-NNP-NNP,NNP-NNP,11,1
6021,4178.0,35,organized,10,6,26,20,5,8,4,16,Union,6th Wisconsin Volunteer Infantry Regiment,per,----,PROPN,ADJ-PROPN-PROPN-PROPN-PROPN,compound,compound-compound-compound-compound-conj,NNP,JJ-NNP-NNP-NNP-NNP,10,1
6022,4229.0,24,joined,9,12,19,7,11,4,-3,10,Union,6th Wisconsin Volunteer Infantry Regiment,per,----,PROPN,ADJ-PROPN-PROPN-PROPN-PROPN,compound,compound-compound-compound-compound-pobj,NNP,JJ-NNP-NNP-NNP-NNP,5,1
6023,4179.0,54,cited,1,14,18,4,13,35,-13,17,University,Donna Shalala,,per-per,PROPN,PROPN-PROPN,nmod,compound-compound,NNP,NNP-NNP,3,1
6024,12134.0,50,appointed,24,1,15,14,0,34,23,-9,University,Donna Shalala,per,-,PROPN,PROPN-PROPN,nmod,compound-conj,NNP,NNP-NNP,3,1
6025,4180.0,12,is,2,2,6,4,1,5,0,4,he,Punjab,per,,PRON,PROPN,nsubj,compound,PRP,NNP,4,1
6026,4181.0,33,supposed,2,9,16,7,8,16,-7,14,Mikkel Kessler,Denmark,-,org,PROPN-PROPN,PROPN,compound-dobj,pobj,NNP-NNP,NNP,7,1
6027,4182.0,18,represented,6,3,8,5,2,9,3,2,LSU Tigers,Louisiana State University,per-per,--,PROPN-PROPN,PROPN-PROPN-PROPN,compound-compound,compound-compound-dobj,NNP-NNP,NNP-NNP-NNP,4,1
6028,4183.0,27,changed,6,19,23,4,18,3,-13,17,Western Illinois University,Macomb,org-org-org,,PROPN-PROPN-PROPN,PROPN,compound-compound-compound,appos,NNP-NNP-NNP,NNP,2,1
6029,5915.0,28,Title,0,7,20,13,6,7,-7,20,Western Illinois University,Macomb,--,org,PROPN-PROPN-PROPN,PROPN,compound-compound-compound,compound,NNP-NNP-NNP,NNP,3,1
6030,12820.0,42,be,18,35,40,5,34,1,-17,22,Western Illinois University,Macomb,org-org-org,,PROPN-PROPN-PROPN,PROPN,compound-compound-compound,compound,NNP-NNP-NNP,NNP,3,1
6031,4184.0,15,is,1,1,14,13,0,0,0,13,Xenomorph,Netherlands,per,,PROPN,PROPN,nsubj,appos,NNP,NNP,1,1
6032,4185.0,38,1933,0,4,5,1,3,32,-4,5,Chancellor,Adolf Hitler,,org-org,PROPN,PROPN-PROPN,compound,compound-compound,NNP,NNP-NNP,1,1
6033,9794.0,44,set,14,34,35,1,33,8,-20,21,Chancellor,Adolf Hitler,per,-,PROPN,PROPN-PROPN,compound,compound-pobj,NNP,NNP-NNP,1,1
6034,4186.0,32,appointed,2,9,12,3,8,19,-7,10,Nebraska,Mike Johanns,,per-per,PROPN,PROPN-PROPN,pobj,compound-pobj,NNP,NNP-NNP,1,1
6035,4187.0,55,said,8,28,50,22,27,4,-20,42,Extreme Pita,Mark Rechichi,per-per,-,PROPN-PROPN,PROPN-PROPN,compound-compound,compound-appos,NNP-NNP,NNP-NNP,7,1
6036,4188.0,18,is,2,10,10,0,9,7,-8,8,Indiana State University,Indiana,per-per-per,,PROPN-PROPN-PROPN,PROPN,compound-compound-pobj,compound,NNP-NNP-NNP,NNP,0,1
6037,10249.0,24,is,1,17,17,0,16,6,-16,16,Indiana State University,Indiana,per-per-per,,PROPN-PROPN-PROPN,PROPN,compound-compound-pobj,pobj,NNP-NNP-NNP,NNP,0,1
6038,4189.0,44,Tarzi,0,11,31,20,10,12,-11,31,Abdullah Khan,Afghanistan,org-org,,PROPN-PROPN,PROPN,compound-compound,pobj,NNP-NNP,NNP,5,1
6039,4190.0,15,focus,4,1,14,13,0,0,3,10,General Motors,Cadillac,org-org,,PROPN-PROPN,PROPN,compound-compound,conj,NNP-NNPS,NNP,3,1
6040,7683.0,44,granted,6,10,19,9,9,24,-4,13,General Motors,Cadillac,per-per,,PROPN-PROPN,PROPN,compound-pobj,compound,NNP-NNPS,NNP,5,1
6041,4191.0,17,is,1,10,16,6,9,0,-9,15,Danish Superliga,1991,-,per,PROPN-PROPN,NUM,compound-pobj,pobj,NNP-NNP,CD,6,1
6042,4192.0,37,obituary,6,9,15,6,8,21,-3,9,Kiichi Miyazawa,Japan,-,org,PROPN-PROPN,PROPN,nmod-nmod,pobj,NNP-NNP,NNP,3,1
6043,4194.0,14,located,10,7,13,6,6,0,3,3,University of Calicut,Malappuram,--,per,PROPN-ADP-PROPN,PROPN,conj-prep-pobj,pobj,NNP-IN-NNP,NNP,4,1
6044,4195.0,50,founded,2,25,29,4,24,20,-23,27,Starfish Software,1994,-,org,PROPN-PROPN,NUM,compound-nsubj,pobj,NNP-NNP,CD,3,1
6045,4196.0,16,known,3,10,12,2,9,3,-7,9,Division I,Milwaukee Panthers,org-org,-,PROPN-PRON,PROPN-VERB,pobj-compound,compound-appos,NNP-PRP,NNP-VBZ,1,1
6046,14266.0,43,went,1,11,16,5,10,26,-10,15,Division I,Milwaukee Panthers,-,org-org,PROPN-PROPN,PROPN-PROPN,pobj-nmod,compound-appos,NNP-NNP,NNP-NNPS,1,1
6047,4197.0,44,see,7,10,22,12,9,21,-3,15,Magners League,Wales,per-per,,PROPN-PROPN,PROPN,compound-nsubj,conj,NNPS-NNP,NNP,3,1
6048,4198.0,12,denounced,8,1,7,6,0,4,7,-1,Wyoming,John Barrasso,org,-,PROPN,PROPN-PROPN,compound,compound-conj,NNP,NNP-NNP,4,1
6049,4199.0,121,named,8,6,31,25,5,89,2,23,San Bernardino,CSUSB,-,org,PROPN-PROPN,NOUN,compound-nsubjpass,pobj,NNP-NNP,NN,7,1
6050,4200.0,36,announced,13,29,35,6,28,0,-16,22,Social Development Canada,HRSDC,per-per-per,,PROPN-PROPN-PROPN,PROPN,compound-compound-pobj,pobj,NNP-NNP-NNP,NNP,9,1
6051,4201.0,25,co-authored,1,1,13,12,0,11,0,12,He,Defense,org,,PRON,PROPN,nsubj,pobj,PRP,NNP,7,1
6052,4202.0,44,said,5,1,4,3,0,39,4,-1,IL,Doug Scott,org,-,PROPN,PROPN-PROPN,compound,compound-nsubj,NNP,NNP-NNP,2,1
6053,4205.0,25,Luna-C,3,4,7,3,3,17,-1,4,Luna-C,DJ,per,,PROPN,PROPN,ROOT,nsubj,NNP,NNP,3,1
6054,4208.0,22,graduated,14,5,9,4,4,12,9,-5,England,David Williams,per,-,PROPN,PROPN-PROPN,pobj,compound-pobj,NNP,NNP-NNP,3,1
6055,4209.0,36,defeated,4,18,22,4,17,13,-14,18,Maine,Susan Collins,,per-per,PROPN,PROPN-PROPN,compound,compound-appos,NNP,NNP-NNP,5,1
6056,4299.0,54,are,3,27,43,16,26,10,-24,40,Maine,Susan Collins,,org-org,PROPN,PROPN-PROPN,pobj,compound-nsubj,NNP,NNP-NNP,6,1
6057,13253.0,13,are,4,1,7,6,0,5,3,3,Maine,Susan Collins,,org-org,PROPN,PROPN-PROPN,poss,compound-attr,NNP,NNP-NNPS,4,1
6058,4210.0,19,awarded,4,3,16,13,2,2,1,12,Fulbright College,University of Arkansas,-,per-per-per,PROPN-PROPN,PROPN-ADP-PROPN,compound-nsubj,pobj-prep-pobj,NNP-NNP,NNP-IN-NNP,7,1
6059,4211.0,10,were,3,5,8,3,4,1,-2,5,Barbados,Owen Arthur,org,-,PROPN,PROPN-PROPN,compound,compound-nsubj,NNP,NNP-NNP,2,1
6060,4213.0,56,is,1,5,21,16,4,34,-4,20,Director,University of South Australia,per,---,PROPN,PROPN-ADP-PROPN-PROPN,attr,pobj-prep-compound-pobj,NNP,NNP-IN-NNP-NNP,4,1
6061,4214.0,43,founded,3,9,26,17,8,16,-6,23,John Willinsky,University of British Columbia,org-org,---,PROPN-PROPN,PROPN-ADP-PROPN-PROPN,compound-pobj,pobj-prep-compound-pobj,NNP-NNP,NNP-IN-NNP-NNP,5,1
6062,4215.0,18,owned,2,1,5,4,0,12,1,3,It,The McClatchy Company,org,--,PRON,DET-PROPN-PROPN,nsubjpass,det-compound-pobj,PRP,DT-NNP-NNP,4,1
6063,4217.0,13,reported,1,1,10,9,0,2,0,9,Rotaru,Ukraine,per,,PROPN,PROPN,nsubj,pobj,NNP,NNP,2,1
6064,4218.0,40,said,14,8,9,1,7,30,6,-5,Hilliard,Davidson High School,org,--,PROPN,PROPN-PROPN-PROPN,compound,compound-compound-pobj,NNP,NNP-NNP-NNP,2,1
6065,10662.0,35,held,12,9,10,1,8,24,3,-2,Hilliard,Davidson High School,org,--,PROPN,PROPN-PROPN-PROPN,compound,compound-compound-pobj,NNP,NNP-NNP-NNP,2,1
6066,4220.0,19,blocked,3,6,10,4,5,8,-3,7,Michigan,Spencer Abraham,,org-org,PROPN,PROPN-PROPN,poss,compound-pobj,NNP,NNP-NNP,3,1
6067,4221.0,26,comprised,6,9,11,2,8,14,-3,5,AlpInvest Partners,NV,org-org,,PROPN-PROPN,PROPN,compound-compound,pobj,NNP-NNPS,NNP,4,1
6068,4222.0,24,combined,7,9,21,12,8,2,-2,14,her,actress,,per,DET,NOUN,poss,pobj,PRP$,NN,6,1
6069,4223.0,38,became,16,16,24,8,15,13,0,8,school,Illinois,,org,NOUN,PROPN,nsubj,pobj,NN,NNP,2,1
6070,4224.0,26,was,2,5,15,10,4,10,-3,13,the Walt Disney Company,Hollywood Records,---,org-org,DET-PROPN-PROPN-PROPN,PROPN-PROPN,det-compound-compound-pobj,compound-dobj,DT-NNP-NNP-NNP,NNP-NNPS,5,1
6071,4225.0,17,fired,7,4,13,9,3,3,3,6,Paul Davis,Mississippi,per-per,,PROPN-PROPN,PROPN,compound-nsubjpass,compound,NNP-NNP,NNP,5,1
6072,4226.0,18,ended,2,13,17,4,12,0,-11,15,Hampton University,Virginia,-,per,PROPN-PROPN,PROPN,compound-pobj,pobj,NNP-NNP,NNP,5,1
6073,4227.0,23,is,7,5,21,16,4,1,2,14,Sabena,Belgium,per,,PROPN,PROPN,compound,appos,NNP,NNP,8,1
6074,4230.0,42,Co.,3,1,6,5,0,35,2,3,Taiwan,TSMC,org,,PROPN,PROPN,compound,appos,NNP,NNP,3,1
6075,4232.0,34,became,21,6,19,13,5,14,15,-2,Muhammad Mian Soomro,Pakistan,--,per,PROPN-PROPN-PROPN,PROPN,compound-compound-appos,pobj,NNP-NNP-NNP,NNP,6,1
6076,4233.0,26,are,6,2,4,2,1,21,4,-2,University of Delaware,Delaware,--,per,PROPN-ADP-PROPN,PROPN,nmod-prep-compound,compound,NNP-IN-NNP,NNP,3,1
6077,4234.0,26,is,17,11,12,1,10,13,6,-5,Pakistan,Ufone,,org,PROPN,PROPN,compound,pobj,NNP,NNP,3,1
6078,11951.0,37,is,7,31,36,5,30,0,-24,29,Pakistan,Ufone,per,,PROPN,PROPN,pobj,pobj,NNP,NNP,5,1
6079,4235.0,38,sought,18,6,7,1,5,30,12,-11,William,Mary II of England,,per-per-per-per,PROPN,PROPN-PROPN-ADP-PROPN,compound,compound-conj-prep-pobj,NNP,NNP-NNP-IN-NNP,6,1
6080,4237.0,31,said,13,18,24,6,17,6,-5,11,pediatrician,University of Texas Medical Branch,,org-org-org-org-org,ADJ,PROPN-ADP-PROPN-PROPN-PROPN,amod,pobj-prep-compound-compound-pobj,JJ,NNP-IN-NNP-NNP-NNP,2,1
6081,4238.0,50,died,40,1,8,7,0,41,39,-32,Verne Orr,Air Force,per-per,-,PROPN-PROPN,PROPN-PROPN,compound-nsubj,compound-pobj,NNP-NNP,NNP-NNP,5,1
6082,12614.0,25,nominated,6,11,23,12,10,1,-5,17,Verne Orr,Air Force,per-per,-,PROPN-PROPN,PROPN-PROPN,compound-dobj,compound-pobj,NNP-NNP,NNP-NNP,5,1
6083,4240.0,35,held,3,1,8,7,0,26,2,5,Blaxland,Paul Keating,,per-per,PROPN,PROPN-PROPN,nsubjpass,compound-pobj,NNP,NNP-NNP,3,1
6084,4241.0,25,took,3,2,21,19,1,3,1,18,Boston Celtics,National Basketball Association,per-per,--,PROPN-PROPN,PROPN-PROPN-PROPN,compound-nsubj,compound-compound-compound,NNP-NNPS,NNP-NNP-NNP,5,1
6085,4243.0,23,used,4,7,11,4,6,11,-3,7,Air China,Star Alliance,-,per-per,PROPN-PROPN,PROPN-PROPN,compound-pobj,compound-compound,NNP-NNP,NNP-NNP,2,1
6086,4244.0,27,was,16,1,26,25,0,0,15,10,Marie Henriette of Austria,Belgium,---,per,PROPN-PROPN-ADP-PROPN,PROPN,compound-nsubj-prep-pobj,pobj,NNP-NNP-IN-NNP,NNP,2,1
6087,4245.0,20,is,9,1,18,17,0,1,8,9,Herbert Hoover High School,West Virginia,org-org-org-org,-,PROPN-PROPN-PROPN-PROPN,PROPN-PROPN,compound-compound-compound-nsubj,compound-pobj,NNP-NNP-NNP-NNP,NNP-NNP,5,1
6088,4247.0,24,visit,3,12,15,3,11,8,-9,12,Fudan University,Shanghai,org-org,,PROPN-PROPN,PROPN,compound-pobj,pobj,NNP-NNP,NNP,3,1
6089,11499.0,22,graduated,3,6,11,5,5,10,-3,8,Fudan University,Shanghai,-,per,PROPN-PROPN,PROPN,compound-compound,pobj,NNP-NNP,NNP,4,1
6090,4248.0,48,is,1,14,46,32,13,1,-13,45,National University of Rosario,Argentina,org-org-org-org,,PROPN-PROPN-ADP-PROPN,PROPN,nmod-nmod-prep-pobj,appos,NNP-NNP-IN-NNP,NNP,9,1
6091,4249.0,27,told,18,23,25,2,22,1,-5,7,his,Kuomintang,per,,DET,PROPN,poss,compound,PRP$,NNP,1,1
6092,4250.0,25,opened,3,1,20,19,0,4,2,17,Centereach High School,Middle Country Central School District,org-org-org,----,PROPN-PROPN-PROPN,PROPN-PROPN-PROPN-PROPN-PROPN,compound-compound-nsubj,compound-compound-compound-compound-pobj,NNP-NNP-NNP,NNP-NNP-NNP-NNP-NNP,8,1
6093,4251.0,31,left,17,10,10,0,9,20,7,-7,Tim Alexander,Tim,org-org,,PROPN-PROPN,PROPN,compound-conj,compound,NNP-NNP,NNP,0,1
6094,4252.0,48,is,4,12,29,17,11,18,-8,25,Whitney Houston,United States,-,per-per,PROPN-PROPN,PROPN-PROPN,compound-pobj,compound-pobj,NNP-NNP,NNP-NNP,7,1
6095,4253.0,23,intended,3,7,12,5,6,10,-4,9,her,Hawaii,org,,DET,PROPN,poss,pobj,PRP$,NNP,3,1
6096,4254.0,33,brokered,4,12,30,18,11,2,-8,26,Mwai Kibaki,Kenya,-,org,PROPN-PROPN,PROPN,compound-dobj,poss,NNP-NNP,NNP,7,1
6097,10790.0,33,pay,12,1,11,10,0,21,11,-1,Mwai Kibaki,Kenya,-,per,PROPN-PROPN,PROPN,compound-compound,pobj,NNP-NNP,NNP,4,1
6098,12451.0,55,start,6,23,38,15,22,16,-17,32,Mwai Kibaki,Kenya,per-per,,PROPN-PROPN,PROPN,compound-dobj,compound,NNP-NNP,NNP,4,1
6099,13234.0,19,urges,5,2,5,3,1,13,3,0,Mwai Kibaki,Kenya,per-per,,PROPN-PROPN,PROPN,compound-nsubj,pobj,NNP-NNP,NNP,1,1
6100,4256.0,34,was,2,28,33,5,27,0,-26,31,Frontier Airlines,Colorado,per-per,,PROPN-PROPN,PROPN,compound-dobj,pobj,NNP-NNPS,NNP,6,1
6101,4258.0,27,defeated,10,2,6,4,1,20,8,-4,Peacock,Liberal Party,,org-org,PROPN,PROPN-PROPN,nsubj,compound-compound,NNP,NNP-NNP,6,1
6102,4260.0,20,received,9,7,18,11,6,1,2,9,Afghanistan,Habibullah Khan,per,-,PROPN,PROPN-PROPN,pobj,compound-pobj,NNP,NNP-NNP,4,1
6103,4262.0,16,is,1,7,15,8,6,0,-6,14,Camp Airy,Thurmont,per-per,,PROPN-PROPN,PROPN,compound-pobj,pobj,NNP-NNP,NNP,4,1
6104,4263.0,38,cited,5,30,35,5,29,2,-25,30,Guo Shuqing,China Construction Bank,per-per,--,PROPN-VERB,PROPN-PROPN-PROPN,compound-pobj,compound-compound-pobj,NNP-VBG,NNP-NNP-NNP,4,1
6105,4264.0,57,announced,4,31,43,12,30,13,-27,39,JYP Entertainment,Park Jin-young,-,per-per,PROPN-PROPN,PROPN-PROPN,compound-pobj,compound-nsubj,NNP-NNP,NNP-NNP,8,1
6106,4265.0,24,is,8,2,22,20,1,1,6,14,University of St Andrews,Fife,---,org,PROPN-ADP-PROPN-PROPN,PROPN,nmod-prep-compound-compound,compound,NNP-IN-NNP-NNP,NNP,7,1
6107,12706.0,21,holds,2,14,19,5,13,1,-12,17,University of St Andrews,Fife,per-per-per-per,,PROPN-ADP-PROPN-PROPN,PROPN,pobj-prep-pobj-pobj,compound,NNP-IN-NNP-NNP,NNP,4,1
6108,4266.0,20,graduated,2,12,14,2,11,5,-10,12,University of St. Thomas,St. Paul,---,per-per,PROPN-ADP-PROPN-PROPN,PROPN-PROPN,conj-prep-compound-pobj,compound-compound,NNP-IN-NNP-NNP,NNP-NNP,1,1
6109,12541.0,19,community,7,11,13,2,10,5,-4,6,University of St. Thomas,St. Paul,org-org-org-org,-,PROPN-ADP-PROPN-PROPN,PROPN-PROPN,pobj-prep-compound-pobj,compound-compound,NNP-IN-NNP-NNP,NNP-NNP,1,1
6110,4267.0,24,published,2,15,22,7,14,1,-13,20,Brown,United Kingdom,,org-org,PROPN,PROPN-PROPN,nsubj,compound-pobj,NNP,NNP-NNP,4,1
6111,7239.0,21,said,1,1,19,18,0,1,0,18,Brown,United Kingdom,per,-,PROPN,PROPN-PROPN,nsubj,compound-pobj,NNP,NNP-NNP,7,1
6112,4269.0,43,surrender,4,18,32,14,17,10,-14,28,Canadian,Fox Sports World Canada,org,---,ADJ,PROPN-PROPN-PROPN-PROPN,amod,compound-compound-compound-pobj,JJ,NNP-NNPS-NNP-NNP,5,1
6113,4270.0,25,graduated,1,5,24,19,4,0,-4,23,University of the Punjab,Pakistan,---,per,PROPN-ADP-DET-PROPN,PROPN,pobj-prep-det-pobj,pobj,NNP-IN-DT-NNP,NNP,4,1
6114,6655.0,23,is,4,15,22,7,14,0,-11,18,University of the Punjab,Pakistan,per-per-per-per,,PROPN-ADP-DET-PROPN,PROPN,pobj-prep-det-pobj,appos,NNP-IN-DT-NNP,NNP,6,1
6115,4271.0,17,owned,3,9,15,6,8,1,-6,12,Kollektivtransportproduksjon,Oslo Sporvognsdrift,org,-,PROPN,PROPN-PROPN,appos,compound-appos,NNP,NNP-NNP,5,1
6116,4272.0,39,grew,4,16,21,5,15,17,-12,17,England,his,org,,PROPN,DET,poss,poss,NNP,PRP$,5,1
6117,8318.0,35,Stokes,4,28,17,-11,27,17,-24,13,England,his,,per,PROPN,DET,pobj,poss,NNP,PRP$,5,1
6118,4273.0,20,married,5,5,7,2,4,12,0,2,MacDonald,Gene Raymond,per,-,PROPN,PROPN-PROPN,nsubj,compound-dobj,NNP,NNP-NNP,1,1
6119,4274.0,18,succeeded,2,1,11,10,0,6,1,9,Harold,England,,org,NOUN,PROPN,nsubj,pobj,NN,NNP,3,1
6120,4275.0,29,attended,1,19,24,5,18,4,-18,23,Denton,University of North Texas,per,---,PROPN,PROPN-ADP-PROPN-PROPN,compound,appos-prep-compound-pobj,NNP,NNP-IN-NNP-NNP,2,1
6121,4276.0,48,is,3,11,32,21,10,15,-8,29,Commonwealth Scientific and Industrial Research Organisation,Australia,per-per-per-per-per-per,,PROPN-PROPN-CCONJ-PROPN-PROPN-PROPN,PROPN,nmod-nmod-cc-compound-compound-pobj,nmod,NNP-NNP-CC-NNP-NNP-NNP,NNP,-1,1
6122,4277.0,23,strongman,6,8,11,3,7,11,-2,5,Alfredo Stroessner,Paraguay,per-per,,PROPN-PROPN,PROPN,compound-dobj,pobj,NNP-NNP,NNP,1,1
6123,4280.0,26,told,21,18,19,1,17,6,3,-2,President,Pratibha Patil,org,-,PROPN,PROPN-PROPN,compound,compound-compound,NNP,NNP-NNP,2,1
6124,4281.0,32,accessed,2,8,9,1,7,22,-6,7,John,Moores,,per,PROPN,PROPN,compound,nsubj,NNP,NNP,1,1
6125,4283.0,28,is,15,15,21,6,14,6,0,6,JUMZ,Dominican,per,,PROPN,PROPN,appos,amod,NNP,NNP,3,1
6126,4284.0,35,is,15,1,2,1,0,32,14,-13,Northern Oklahoma college,Oklahoma,--,per,PROPN-PROPN-NOUN,PROPN,compound-compound-nsubj,compound,NNP-NNP-NN,NNP,1,1
6127,4287.0,40,said,16,13,19,6,12,20,3,3,Jeroen van der Veer,company,---,org,PROPN-PROPN-NOUN-PROPN,NOUN,compound-compound-compound-nsubj,nsubj,NNP-NNP-NN-NNP,NN,4,1
6128,4288.0,15,said,4,4,14,10,3,0,0,10,Bongo,Gabon,,per,PROPN,PROPN,nsubj,pobj,NNP,NNP,1,1
6129,4289.0,34,said,1,14,31,17,13,2,-13,30,Indianapolis Metropolitan Police Department,Frank J. Anderson,org-org-org-org,--,PROPN-PROPN-PROPN-PROPN,PROPN-PROPN-PROPN,compound-compound-compound-dobj,compound-compound-pobj,NNP-NNP-NNP-NNP,NNP-NNP-NNP,6,1
6130,4290.0,10,located,5,1,8,7,0,1,4,3,Lufthansa,Cologne,org,,PROPN,PROPN,poss,compound,NNP,NNP,5,1
6131,4291.0,35,According,0,3,8,5,2,26,-3,8,Kim Deal,Pixies,per-per,,PROPN-PROPN,PROPN,compound-pobj,poss,NNP-NNP,NNPS,7,1
6132,4292.0,35,has,2,15,26,11,14,8,-13,24,UK,University of Leicester,per,--,PROPN,PROPN-ADP-PROPN,compound,conj-prep-compound,NNP,NNP-IN-NNP,6,1
6133,4294.0,21,is,7,2,20,18,1,0,5,13,E. Claiborne Robins School of Business,1949,org-org-org-org-org-org,,PROPN-PROPN-PROPN-PROPN-ADP-PROPN,NUM,compound-compound-compound-nsubj-prep-pobj,pobj,NNP-NNP-NNP-NNP-IN-NNP,CD,3,1
6134,4295.0,27,was,8,5,18,13,4,8,3,10,Columbia,University of South Carolina,org,---,PROPN,PROPN-ADP-PROPN-PROPN,compound,pobj-prep-compound-pobj,NNP,NNP-IN-NNP-NNP,8,1
6135,4296.0,37,apologised,9,3,8,5,2,28,6,-1,Air New Zealand,Rob Fyfe,--,per-per,PROPN-PROPN-PROPN,PROPN-PROPN,compound-compound-poss,compound-nsubj,NNP-NNP-NNP,NNP-NNP,3,1
6136,4297.0,12,recorded,2,6,8,2,5,3,-4,6,California,Young,per,,PROPN,PROPN,pobj,poss,NNP,NNP,3,1
6137,4298.0,39,founded,3,1,10,9,0,28,2,7,Synon,Simon Williams,per,-,PROPN,PROPN-PROPN,compound,compound-pobj,NNP,NNP-NNP,3,1
6138,4300.0,28,According,0,3,5,2,2,22,-3,5,Bela G. Lugosi,Lugosi,org-org-org,,PROPN-PROPN-PROPN,PROPN,compound-compound-pobj,conj,NNP-NNP-NNP,NNP,2,1
6139,4301.0,19,married,7,7,16,9,6,2,0,9,Laodice,Antiochus IV Epiphanes,per,--,PROPN,PROPN-PROPN-PROPN,pobj,compound-compound-npadvmod,NNP,NNP-NNP-NNP,5,1
6140,4302.0,56,won,1,18,21,3,17,34,-17,20,Daniel Brewster,Maryland,per-per,,PROPN-PROPN,PROPN,compound-pobj,compound,NNP-NNP,NNP,3,1
6141,4303.0,39,abandoned,5,7,11,4,6,27,-2,6,England,Wolsey,per,,PROPN,PROPN,dobj,nsubj,NNP,NNP,2,1
6142,4304.0,39,born,2,7,25,18,6,13,-5,23,United States,Brownie McGhee,-,per-per,PROPN-PROPN,PROPN-PROPN,compound-pobj,compound-appos,NNP-NNP,NNP-NNP,8,1
6143,4306.0,47,In,0,30,33,3,29,13,-30,33,Stuart Murdoch,Belle Sebastian,per-per,-,PROPN-PROPN,PROPN-PROPN,compound-ROOT,pobj-compound,NNP-NNP,NNP-NNP,3,1
6144,4307.0,31,Times,2,23,27,4,22,3,-21,25,Prime Minister,Democratic Party of Japan,per-per,---,PROPN-PROPN,PROPN-PROPN-ADP-PROPN,compound-compound,compound-pobj-prep-pobj,NNP-NNP,NNP-NNP-IN-NNP,3,1
6145,4308.0,29,required,3,1,23,22,0,5,2,20,GHS,Germantown,org,,NOUN,PROPN,compound,compound,NN,NNP,-1,1
6146,4311.0,44,merged,3,31,36,5,30,7,-28,33,Canal + Group,Vivendi,--,org,PROPN-SYM-PROPN,PROPN,attr-cc-conj,pobj,NNP-SYM-NNP,NNP,3,1
6147,4313.0,6,Brownback,4,2,4,2,1,1,2,0,Kansas,Sam Brownback,org,-,PROPN,PROPN-PROPN,compound,compound-ROOT,NNP,NNP-NNP,1,1
6148,6865.0,29,announced,7,1,6,5,0,22,6,-1,Kansas,Sam Brownback,per,-,PROPN,PROPN-PROPN,poss,compound-nsubj,NNP,NNP-NNP,2,1
6149,4315.0,74,offered,7,42,13,-29,41,60,-35,6,Carnegie Mellon,NCAA,per-per,,PROPN-PROPN,PROPN,compound-nsubj,compound,NNP-NNP,NNP,11,1
6150,4317.0,26,got,1,1,10,9,0,15,0,9,MacIsaac,Loggerhead,org,,PROPN,PROPN,nsubj,appos,NNP,NNP,2,1
6151,11674.0,29,Ashley,5,5,21,16,4,7,0,16,MacIsaac,Loggerhead,,org,PROPN,PROPN,nsubj,compound,NNP,NNP,5,1
6152,4319.0,27,is,2,10,19,9,9,7,-8,17,France,Henri de Toulouse-Lautrec,org,--,PROPN,PROPN-ADP-PROPN,pobj,nmod-compound-appos,NNP,NNP-IN-NNP,8,1
6153,4320.0,38,produced,2,18,23,5,17,14,-16,21,as prod,asted in Taiwan on free-to,org-org,----,ADP-NOUN,VERB-ADP-PROPN-ADP-NOUN,prep-compound,acl-prep-pobj-prep-pobj,IN-NN,VBN-IN-NNP-IN-NN,4,1
6154,4321.0,48,come,8,31,7,-24,30,40,-23,-1,Nigeria,University,,per,PROPN,PROPN,nsubjpass,dobj,NNP,NNP,3,1
6155,4322.0,26,goes,3,1,18,17,0,7,2,15,Dr. Naik,India,org-org,,PROPN-PROPN,PROPN,compound-nsubj,pobj,NNP-NNP,NNP,6,1
6156,4323.0,31,is,4,12,12,0,11,18,-8,8,Iraq national football team,Iraq,---,per,PROPN-ADJ-NOUN-NOUN,PROPN,nmod-amod-compound-dobj,compound,NNP-JJ-NN-NN,NNP,0,1
6157,4325.0,31,musicians,1,19,26,7,18,4,-18,25,Mike Doughty,singer,-,per,PROPN-PROPN,NOUN,compound-nsubj,attr,NNP-NNP,NN,1,1
6158,4326.0,19,toured,1,3,17,14,2,1,-2,16,Australia,Johnny O'Keefe,per,-,PROPN,PROPN-PROPN,dobj,compound-conj,NNP,NNP-NNP,5,1
6159,7178.0,35,commemorated,25,3,27,24,2,7,22,2,Australia,Johnny O'Keefe,org,-,PROPN,PROPN-PROPN,compound,compound-poss,NNP,NNP-NNP,2,1
6160,11607.0,20,toured,5,8,11,3,7,8,-3,6,Australia,Johnny O'Keefe,org,-,PROPN,PROPN-PROPN,pobj,compound-compound,NNP,NNP-NNP,2,1
6161,4327.0,43,opened,1,18,20,2,17,22,-17,19,Michigan,Russell A. Alger,,per-per-per,PROPN,PROPN-NOUN-PROPN,compound,compound-compound-pobj,NNP,NNP-NN-NNP,2,1
6162,4328.0,20,graduated,1,9,9,0,8,10,-8,8,Delhi,Delhi College of Engineering,,per-per-per-per,PROPN,PROPN-PROPN-ADP-PROPN,compound,compound-appos-prep-pobj,NNP,NNP-NNP-IN-NNP,0,1
6163,7581.0,30,taken,9,7,7,0,6,22,2,-2,Delhi,Delhi College of Engineering,,org-org-org-org,PROPN,PROPN-PROPN-ADP-PROPN,compound,compound-pobj-prep-pobj,NNP,NNP-NNP-IN-NNP,0,1
6164,4329.0,41,found,2,11,16,5,10,24,-9,14,California State University,CSUN,per-per-per,,PROPN-PROPN-PROPN,PROPN,compound-compound-compound,appos,NNP-NNP-NNP,NNP,5,1
6165,8303.0,46,came,10,34,39,5,33,6,-24,29,California State University,CSUN,per-per-per,,PROPN-PROPN-PROPN,PROPN,compound-compound-compound,appos,NNP-NNP-NNP,NNP,10,1
6166,8850.0,33,played,1,26,31,5,25,1,-25,30,California State University,CSUN,--,org,PROPN-PROPN-PROPN,PROPN,compound-compound-compound,appos,NNP-NNP-NNP,NNP,7,1
6167,4330.0,20,were,3,8,15,7,7,4,-5,12,Germany,Wilhelm Cuno,per,-,PROPN,PROPN-PROPN,pobj,compound-pobj,NNP,NNP-NNP,7,1
6168,4332.0,19,is,7,1,17,16,0,1,6,10,Texas Tech University College of Arts Sciences,Lubbock,org-org-org-org-org-org-org,,PROPN-PROPN-PROPN-PROPN-ADP-PROPN-PROPN,PROPN,compound-compound-compound-nsubj-prep-compound-pobj,compound,NNP-NNP-NNP-NNP-IN-NNP-NNPS,NNP,8,1
6169,4333.0,28,was,12,23,27,4,22,0,-11,15,Allergan,California,,per,PROPN,PROPN,conj,pobj,NNP,NNP,8,1
6170,4334.0,40,met,7,6,21,15,5,18,1,14,Bucharest,r C?lin Popescu-T?rice,,per-per-per,PROPN,NOUN-NOUN-PROPN,compound,conj-ROOT-ROOT,NNP,NN-NN-NNP,11,1
6171,4335.0,34,became,5,13,20,7,12,13,-8,15,South Pacific Combat Air Transport Command,SCAT,-----,org,PROPN-PROPN-PROPN-PROPN-PROPN-PROPN,PROPN,compound-compound-compound-compound-compound-pobj,appos,NNP-NNP-NNP-NNP-NNP-NNP,NNP,3,1
6172,4336.0,19,converted,4,3,7,4,2,11,1,3,American Stores,Jewel Food Stores,per-per,--,PROPN-PROPN,PROPN-PROPN-PROPN,compound-nsubj,compound-compound-dobj,NNP-NNPS,NNP-NNP-NNPS,3,1
6173,4337.0,29,determined,5,4,22,18,3,6,1,17,School Council,Summer Hill,-,per-per,PROPN-PROPN,PROPN-PROPN,compound-nsubj,compound-compound,NNP-NNP,NNP-NNP,8,1
6174,4338.0,38,appeared,1,13,13,0,12,24,-12,12,Oxford University Cricket Club,Oxford University,---,org-org,PROPN-PROPN-PROPN-PROPN,PROPN-PROPN,compound-compound-compound-pobj,compound-poss,NNP-NNP-NNP-NNP,NNP-NNP,0,1
6175,4339.0,28,was,10,1,18,17,0,9,9,8,Edward Hoos,New Jersey,per-per,-,PROPN-PROPN,PROPN-PROPN,compound-nsubj,compound-pobj,NNP-NNP,NNP-NNP,3,1
6176,4340.0,22,is,1,17,20,3,16,1,-16,19,Sun Yat-sen University,Guangzhou,org-org-org,,PROPN-PROPN-PROPN,PROPN,compound-compound-compound,compound,NNP-NNP-NNP,NNP,3,1
6177,13559.0,64,is,1,24,28,4,23,35,-23,27,Sun Yat-sen University,Guangzhou,--,per,PROPN-PROPN-PROPN,PROPN,compound-compound-pobj,pobj,NNP-NNP-NNP,NNP,2,1
6178,4342.0,121,sought,16,15,2,-13,14,118,1,-14,Coach USA,Stagecoach,org-org,,PROPN-PROPN,PROPN,compound-appos,nsubj,NNP-NNP,NNP,7,1
6179,4343.0,58,buys,14,38,50,12,37,7,-24,36,Monitor Group,Michael Porter,-,per-per,PROPN-PROPN,PROPN-PROPN,compound-pobj,compound-pobj,NNP-NNP,NNP-NNP,10,1
6180,4344.0,36,include,1,8,15,7,7,20,-7,14,Wayne Closter,Geelong,-,org,PROPN-PROPN,PROPN,compound-dative,compound,NNP-NNP,NNP,4,1
6181,4345.0,20,S.p.A.,0,3,19,16,2,0,-3,19,Pontedera,Piaggio,,org,PROPN,PROPN,compound,pobj,NNP,NNP,3,1
6182,4347.0,12,donated,3,2,7,5,1,4,1,4,Teal,EAA Airventure Museum,org,--,PROPN,PROPN-PROPN-PROPN,nsubjpass,compound-compound-pobj,NNP,NNP-NNP-NNP,4,1
6183,4348.0,27,relinquished,5,21,25,4,20,1,-16,20,Ministry of Defence,MINDEF,--,per,PROPN-ADP-PROPN,PROPN,pobj-prep-pobj,appos,NNP-IN-NNP,NNP,7,1
6184,4349.0,37,opened,13,6,9,3,5,27,7,-4,South Dakota,John Thune,per-per,-,PROPN-PROPN,PROPN-PROPN,compound-compound,compound-nsubj,NNP-NNP,NNP-NNP,2,1
6185,4350.0,12,is,2,1,9,8,0,2,1,7,Roy Boudreau,New Brunswick,-,per-per,PROPN-PROPN,PROPN-PROPN,compound-nsubj,compound-compound,NNP-NNP,NNP-NNP,4,1
6186,4352.0,20,overheard,1,10,15,5,9,4,-9,14,Ministry of Sound,London,--,org,PROPN-ADP-PROPN,PROPN,attr-prep-pobj,poss,NNP-IN-NNP,NNP,6,1
6187,4353.0,47,teams,5,22,1,-21,21,45,-17,-4,Patriot High School,Brentsville,--,org,PROPN-PROPN-PROPN,PROPN,compound-compound-appos,poss,NNP-NNP-NNP,NNP,8,1
6188,4354.0,21,charged,6,10,13,3,9,7,-4,7,Kosovo,Ramush Haradinaj,per,-,PROPN,PROPN-PROPN,compound,compound-pobj,NNP,NNP-NNP,2,1
6189,4358.0,30,connected,21,5,17,12,4,12,16,-4,Mexico,Lerdo de Tejada,org,--,PROPN,PROPN-ADP-PROPN,compound,compound-compound-pobj,NNP,NNP-IN-NNP,6,1
6190,4359.0,26,closed,16,2,16,14,1,9,14,0,Wheaton,Northfield,,per,PROPN,PROPN,nsubj,pobj,NNP,NNP,1,1
6191,4360.0,35,is,1,31,34,3,30,0,-30,33,Cherry,Sweden,org,,PROPN,PROPN,poss,pobj,NNP,NNP,1,1
6192,4361.0,15,born,4,1,8,7,0,6,3,4,John W. Baird,Ontario,org-org-org,,PROPN-PROPN-PROPN,PROPN,compound-compound-nsubjpass,pobj,NNP-NNP-NNP,NNP,4,1
6193,4363.0,13,played,1,5,12,7,4,0,-4,11,Robert E. Lee High School,Texas,----,org,PROPN-PROPN-PROPN-PROPN-PROPN,PROPN,compound-compound-compound-compound-pobj,pobj,NNP-NNP-NNP-NNP-NNP,NNP,4,1
6194,4365.0,15,moved,3,6,12,6,5,2,-3,9,Victoria,Camosun College,org,-,PROPN,PROPN-PROPN,compound,compound-compound,NNP,NNP-NNP,6,1
6195,4366.0,28,is,4,2,21,19,1,6,2,17,William M. Landes,University of Chicago,per-per-per,--,PROPN-PROPN-PROPN,PROPN-ADP-PROPN,compound-compound-nsubj,poss-prep-pobj,NNP-NNP-NNP,NNP-IN-NNP,9,1
6196,4367.0,28,reported,4,4,25,21,3,2,0,21,RBS,UK,,org,PROPN,PROPN,nsubj,nmod,NNP,NNP,5,1
6197,4368.0,15,graduated,1,4,8,4,3,6,-3,7,Sheldon Jackson College,Sitka,org-org-org,,PROPN-PROPN-PROPN,PROPN,compound-compound-pobj,pobj,NNP-NNP-NNP,NNP,4,1
6198,4369.0,24,reported,22,1,16,15,0,7,21,-6,Iran,Mahmoud Ahmadinejad,per,-,PROPN,PROPN-PROPN,nsubj,compound-pobj,NNP,NNP-NNP,4,1
6199,12906.0,14,says,3,1,6,5,0,7,2,3,Iran,Mahmoud Ahmadinejad,,per-per,PROPN,PROPN-PROPN,compound,compound-nsubj,NNP,NNP-NNP,4,1
6200,4372.0,20,founded,2,5,11,6,4,8,-3,9,1967,Cambrian College,,org-org,NUM,PROPN-PROPN,pobj,compound-pobj,CD,NNP-NNP,4,1
6201,4373.0,10,is,4,1,7,6,0,2,3,3,Zafar Iqbal,Pakistani,org-org,,PROPN-PROPN,ADJ,compound-nsubj,amod,NNP-NNP,JJ,3,1
6202,4374.0,40,sent,20,18,19,1,17,20,2,-1,State,Dean Acheson,,per-per,PROPN,PROPN-PROPN,pobj,compound-nsubj,NNP,NNP-NNP,4,1
6203,4541.0,19,entered,1,16,17,1,15,1,-15,16,State,Dean Acheson,,per-per,PROPN,PROPN-PROPN,pobj,compound-pobj,NNP,NNP-NNP,1,1
6204,4777.0,27,was,1,17,18,1,16,8,-16,17,State,Dean Acheson,org,-,PROPN,PROPN-PROPN,pobj,compound-nsubj,NNP,NNP-NNP,1,1
6205,6227.0,59,asked,10,8,9,1,7,49,2,-1,State,Dean Acheson,per,-,PROPN,PROPN-PROPN,pobj,compound-nsubj,NNP,NNP-NNP,1,1
6206,13794.0,40,held,2,18,34,16,17,5,-16,32,State,Dean Acheson,org,-,PROPN,PROPN-PROPN,pobj,compound-pobj,NNP,NNP-NNP,9,1
6207,4375.0,29,began,3,3,11,8,2,17,0,8,he,Black Magic,per,-,PRON,PROPN-PROPN,nsubj,compound-nsubj,PRP,NNP-NNP,4,1
6208,4376.0,31,was,8,16,29,13,15,1,-8,21,Germany,Walter Ulbricht,,per-per,PROPN,PROPN-PROPN,pobj,compound-pobj,NNP,NNP-NNP,7,1
6209,12045.0,95,warned,5,22,82,60,21,12,-17,77,Germany,Walter Ulbricht,,per-per,PROPN,PROPN-PROPN,pobj,compound-conj,NNP,NNP-NNP,14,1
6210,4377.0,21,is,2,1,10,9,0,10,1,8,Notre Dame,Puerto Rico,org-org,-,PROPN-PROPN,PROPN-PROPN,compound-nsubj,compound-pobj,NNP-NNP,NNP-NNP,4,1
6211,4378.0,65,made,22,42,52,10,41,12,-20,30,Manuel,Mexico,org,,PROPN,PROPN,conj,pobj,NNP,NNP,3,1
6212,4379.0,34,was,16,1,6,5,0,27,15,-10,Lawford,Patricia Kennedy,,per-per,PROPN,PROPN-PROPN,poss,compound-compound,NNP,NNP-NNP,5,1
6213,4380.0,39,becomes,11,24,32,8,23,6,-13,21,Puerto Rico,Tito Rojas,-,per-per,PROPN-PROPN,PROPN-PROPN,compound-pobj,compound-compound,NNP-NNP,NNP-NNP,4,1
6214,4383.0,60,said,22,31,35,4,30,24,-9,13,Francis Marion University,Florence,--,per,PROPN-PROPN-PROPN,PROPN,compound-compound-pobj,compound,NNP-NNP-NNP,NNP,8,1
6215,4385.0,31,established,6,17,18,1,16,12,-11,12,President,Heydar Aliyev,per,-,PROPN,PROPN-PROPN,compound,compound-compound,NNP,NNP-NNP,1,1
6216,4387.0,28,includes,11,1,11,10,0,16,10,0,Robinson,Virginia,per,,PROPN,PROPN,compound,pobj,NNP,NNP,2,1
6217,4388.0,37,entered,1,16,24,8,15,12,-15,23,American Volunteer Group,Flying Tigers,org-org-org,-,PROPN-PROPN-PROPN,PROPN-PROPN,compound-compound-pobj,compound-pobj,NNP-NNP-NNP,NNP-NNP,7,1
6218,4390.0,61,says,4,1,3,2,0,57,3,-1,PETA,Ingrid Newkirk,,org-org,PROPN,PROPN-PROPN,compound,compound-nsubj,NNP,NNP-NNP,1,1
6219,8686.0,63,take,1,41,43,2,40,19,-40,42,PETA,Ingrid Newkirk,per,-,PROPN,PROPN-PROPN,compound,compound-nsubj,NNP,NNP-NNP,1,1
6220,11063.0,32,says,1,22,24,2,21,7,-21,23,PETA,Ingrid Newkirk,,per-per,PROPN,PROPN-PROPN,compound,compound-nsubj,NNP,NNP-NNP,1,1
6221,13554.0,70,Country,6,24,27,3,23,42,-18,21,PETA,Ingrid Newkirk,org,-,PROPN,PROPN-PROPN,compound,compound-pobj,NNP,NNP-NNP,3,1
6222,4391.0,23,Chairman,2,10,14,4,9,8,-8,12,Ma,Guangzhou,,org,PROPN,PROPN,nsubjpass,pobj,NNP,NNP,2,1
6223,8593.0,18,left,1,1,6,5,0,11,0,5,Ma,Guangzhou,,per,PROPN,PROPN,nsubj,pobj,NNP,NNP,2,1
6224,4392.0,15,became,4,2,13,11,1,1,2,9,1962,Black Watch,org,-,NUM,PROPN-PROPN,pobj,compound-pobj,CD,NNP-NNP,6,1
6225,4393.0,39,Located,0,11,22,11,10,16,-11,22,Cairo,Gamal Abdel Nasser,org,--,PROPN,PROPN-PROPN-PROPN,pobj,compound-compound-pobj,NNP,NNP-NNP-NNP,5,1
6226,4394.0,26,was,9,9,18,9,8,7,0,9,N.U.T.,UK,,per,PROPN,PROPN,pobj,compound,NNP,NNP,12,1
6227,4395.0,26,released,9,2,7,5,1,18,7,-2,Rita Fan,Legislative Council,per-per,-,PROPN-PROPN,PROPN-PROPN,compound-compound,compound-pobj,NNP-NNP,NNP-NNP,3,1
6228,4396.0,18,is,3,11,17,6,10,0,-8,14,Whole Foods Market,Texas,org-org-org,,PROPN-PROPN-PROPN,PROPN,compound-compound-compound,pobj,NNP-NNPS-NNP,NNP,5,1
6229,4397.0,10,exists,5,3,9,6,2,0,2,4,State Trading Organization,Maldives,--,org,PROPN-PROPN-PROPN,PROPN,compound-compound-nsubj,pobj,NNP-NNP-NNP,NNPS,3,1
6230,4398.0,6,is,1,1,4,3,0,1,0,3,Liu,KMT,per,,PROPN,PROPN,nsubj,compound,NNP,NNP,1,1
6231,4399.0,35,known,8,1,28,27,0,6,7,20,Quince Orchard High School,Gaithersburg,---,per,PROPN-PROPN-PROPN-PROPN,PROPN,compound-compound-compound-nsubj,pobj,NNP-NNP-NNP-NNP,NNP,9,1
6232,4400.0,53,accompanied,6,12,13,1,11,39,-6,7,Crass,1977,per,,PROPN,NUM,ROOT,npadvmod,NNP,CD,2,1
6233,4401.0,33,Live,4,8,20,12,7,12,-4,16,MA,Tweeter,,org,PROPN,PROPN,pobj,compound,NNP,NNP,4,1
6234,4403.0,19,studied,2,6,6,0,5,12,-4,4,China,China University of Political Science and Law,per,------,PROPN,PROPN-PROPN-ADP-PROPN-PROPN-CCONJ-PROPN,poss,compound-pobj-prep-compound-pobj-cc-conj,NNP,NNP-NNP-IN-NNP-NNP-CC-NNP,0,1
6235,4404.0,18,situated,3,1,8,7,0,9,2,5,Blyth Community College,Northumberland,per-per-per,,PROPN-PROPN-PROPN,PROPN,compound-compound-nsubj,pobj,NNP-NNP-NNP,NNP,3,1
6236,4757.0,12,is,3,1,10,9,0,1,2,7,Blyth Community College,Northumberland,--,per,PROPN-PROPN-PROPN,PROPN,compound-compound-nsubj,compound,NNP-NNP-NNP,NNP,5,1
6237,4405.0,43,was,1,20,41,21,19,1,-19,40,New York,Carole King,-,per-per,PROPN-PROPN,PROPN-PROPN,compound-compound,compound-conj,NNP-NNP,NNP-NNP,7,1
6238,4406.0,43,In,0,7,7,0,6,35,-7,7,Norfolk and Norwich University Hospital,Norfolk,----,per,PROPN-CCONJ-PROPN-PROPN-PROPN,PROPN,pobj-cc-compound-conj-compound,dobj,NNP-CC-NNP-NNP-NNP,NNP,0,1
6239,4408.0,23,created,3,12,19,7,11,3,-9,16,Tomiichi Murayama,Japan,org-org,,PROPN-PROPN,PROPN,compound-pobj,dobj,NNP-NNP,NNP,5,1
6240,8395.0,65,said,1,18,47,29,17,17,-17,46,Tomiichi Murayama,Japan,-,org,PROPN-PROPN,PROPN,compound-pobj,nsubj,NNP-NNP,NNP,10,1
6241,12166.0,32,vowed,2,13,23,10,12,8,-11,21,Tomiichi Murayama,Japan,org-org,,PROPN-PROPN,PROPN,compound-pobj,poss,NNP-NNP,NNP,9,1
6242,4409.0,39,defeated,14,11,26,15,10,12,3,12,South Australia,Mike Rann,org-org,-,PROPN-PROPN,PROPN-PROPN,compound-compound,compound-pobj,NNP-NNP,NNP-NNP,13,1
6243,8025.0,20,was,3,1,17,16,0,2,2,14,South Australia,Mike Rann,-,org-org,PROPN-PROPN,PROPN-PROPN,compound-compound,compound-nsubj,NNP-NNP,NNP-NNP,5,1
6244,8249.0,30,opened,3,12,21,9,11,8,-9,18,South Australia,Mike Rann,-,per-per,PROPN-PROPN,PROPN-PROPN,compound-compound,compound-pobj,NNP-NNP,NNP-NNP,6,1
6245,4411.0,18,is,4,1,1,0,0,16,3,-3,Essex District High School,Essex,---,per,PROPN-PROPN-PROPN-PROPN,PROPN,compound-compound-compound-nsubj,compound,NNP-NNP-NNP-NNP,NNP,0,1
6246,4412.0,31,let,3,1,18,17,0,12,2,15,Slovakia,Robert Fico,org,-,PROPN,PROPN-PROPN,nsubj,compound-nsubj,NNP,NNP-NNP,3,1
6247,11861.0,29,says,6,8,17,9,7,11,-2,11,Slovakia,Robert Fico,org,-,PROPN,PROPN-PROPN,poss,compound-nsubj,NNP,NNP-NNP,5,1
6248,4413.0,49,replace,20,22,27,5,21,21,-2,7,Mike Johanns,Agriculture,-,org,PROPN-PROPN,PROPN,compound-dobj,compound,NNP-NNP,NNP,3,1
6249,4415.0,21,appointed,3,2,11,9,1,9,1,8,Francesco Cossiga,Italy,org-org,,PROPN-PROPN,PROPN,compound-nsubj,compound,NNP-NNP,NNP,2,1
6250,7342.0,60,proves,6,20,31,11,19,28,-14,25,Francesco Cossiga,Italy,per-per,,PROPN-PROPN,PROPN,compound-appos,dobj,NNP-NNP,NNP,4,1
6251,11307.0,47,told,15,4,17,13,3,29,11,2,Francesco Cossiga,Italy,org-org,,PROPN-PROPN,PROPN,compound-nsubj,poss,NNP-NNP,NNP,3,1
6252,4417.0,28,is,2,14,17,3,13,10,-12,15,Vikram University,Madhya Pradesh,-,org-org,PROPN-PROPN,PROPN-PROPN,compound-compound,compound-pobj,NNP-NNP,NNP-NNP,1,1
6253,4419.0,31,moved,25,13,21,8,12,9,12,-4,Detroit,Raymond Parks,org,-,PROPN,PROPN-PROPN,compound,compound-conj,NNP,NNP-NNP,7,1
6254,4422.0,32,was,21,21,29,8,20,2,0,8,Denmark,Danfoss,org,,PROPN,PROPN,pobj,pobj,NNP,NNP,1,1
6255,4423.0,9,born,2,1,8,7,0,0,1,6,Fripp,England,org,,PROPN,PROPN,nsubjpass,pobj,NNP,NNP,2,1
6256,4424.0,23,stated,4,3,4,1,2,18,1,0,President,Colom,per,,PROPN,PROPN,compound,pobj,NNP,NNP,2,1
6257,4425.0,31,ordered,23,20,22,2,19,8,3,-1,French Polynesia,Gaston Flosse,org-org,-,PROPN-PROPN,PROPN-PROPN,compound-compound,compound-pobj,NNP-NNP,NNP-NNP,1,1
6258,4426.0,25,was,2,6,12,6,5,12,-4,10,Suburban Legends,Dallas Cook,org-org,-,PROPN-PROPN,PROPN-PROPN,compound-compound,compound-dobj,NNP-NNP,NNP-NNP,3,1
6259,4427.0,41,said,21,12,30,18,11,10,9,9,Kahlo,Mexico,,org,PROPN,PROPN,pobj,compound,NNP,NNP,9,1
6260,6903.0,21,witnessed,5,4,14,10,3,6,1,9,Kahlo,Mexico,org,,PROPN,PROPN,nsubj,compound,NNP,NNP,5,1
6261,4428.0,76,formed,26,2,12,10,1,63,24,-14,1979,German Football League,org,--,NUM,PROPN-PROPN-PROPN,pobj,compound-compound-compound,CD,NNP-NNP-NNP,7,1
6262,4430.0,60,developed,6,5,24,19,4,35,1,18,Motown,Levi Stubbs,org,-,PROPN,PROPN-PROPN,compound,compound-conj,NNP,NNP-NNP,11,1
6263,4431.0,24,is,1,7,10,3,6,13,-6,9,Griffith University,Centre for Public Culture,-,per-per-per-per,PROPN-PROPN,PROPN-ADP-PROPN-PROPN,compound-poss,pobj-prep-compound-pobj,NNP-NNP,NNP-IN-NNP-NNP,2,1
6264,4432.0,19,commemorates,1,10,16,6,9,2,-9,15,Mohammad Najibullah,Afghanistan,org-org,,PROPN-PROPN,PROPN,compound-poss,pobj,NNP-NNP,NNP,3,1
6265,5499.0,50,nemesis,3,15,18,3,14,31,-12,15,Mohammad Najibullah,Afghanistan,-,org,PROPN-PROPN,PROPN,compound-appos,pobj,NNP-NNP,NNP,4,1
6266,6594.0,16,headed,3,6,13,7,5,2,-3,10,Mohammad Najibullah,Afghanistan,-,per,PROPN-PROPN,PROPN,compound-pobj,pobj,NNP-NNP,NNP,4,1
6267,4433.0,30,said,9,8,29,21,7,0,1,20,Pakistan,MQM,per,,PROPN,PROPN,pobj,dobj,NNP,NNP,2,1
6268,4434.0,20,represented,8,4,10,6,3,9,4,2,Portland Pilots,University of Portland,per-per,--,PROPN-PROPN,PROPN-ADP-PROPN,compound-compound,dobj-prep-pobj,NNP-NNPS,NNP-IN-NNP,4,1
6269,4435.0,21,born,2,9,10,1,8,10,-7,8,President,Francisco Antonio Pinto,,per-per-per,PROPN,PROPN-PROPN-PROPN,compound,compound-compound-pobj,NNP,NNP-NNP-NNP,2,1
6270,4436.0,27,designated,8,11,26,15,10,0,-3,18,Classified,Canada,per,,PROPN,PROPN,compound,pobj,NNP,NNP,5,1
6271,4437.0,18,helped,1,4,13,9,3,4,-3,12,Little Feat,Bill Payne,org-org,-,PROPN-PROPN,PROPN-PROPN,compound-dobj,compound-pobj,NNP-NNP,NNP-NNP,4,1
6272,4438.0,36,is,1,7,19,12,6,16,-6,18,United States,18th Military Police Brigade,-,per-per-per-per,PROPN-PROPN,NOUN-PROPN-PROPN-PROPN,compound-pobj,amod-compound-compound-appos,NNP-NNP,NN-NNP-NNP-NNP,4,1
6273,4439.0,12,belonged,7,1,6,5,0,5,6,-1,Japanese,Hibari Misora,per,-,PROPN,PROPN-PROPN,amod,compound-nsubj,NNP,NNP-NNP,2,1
6274,4441.0,48,piece,3,20,21,1,19,26,-17,18,Belgian,Fabrique Nationale de Herstal,per,---,ADJ,PROPN-PROPN-PROPN-PROPN,compound,compound-nmod-nmod-pobj,JJ,NNP-NNP-NNP-NNP,2,1
6275,4442.0,80,was,7,14,25,11,13,54,-7,18,Malaysia,Mahathir bin Mohamad,,per-per-per,PROPN,PROPN-PROPN-PROPN,pobj,compound-compound-ROOT,NNP,NNP-NNP-NNP,-1,1
6276,6171.0,57,is,9,36,40,4,35,16,-27,31,Malaysia,Mahathir bin Mohamad,per,--,PROPN,PROPN-PROPN-PROPN,pobj,compound-compound-pobj,NNP,NNP-NNP-NNP,5,1
6277,10404.0,24,title,2,18,21,3,17,2,-16,19,Malaysia,Mahathir bin Mohamad,,per-per-per,PROPN,PROPN-PROPN-PROPN,pobj,compound-compound-appos,NNP,NNP-NNP-NNP,2,1
6278,14009.0,24,inaugurated,12,6,9,3,5,14,6,-3,Malaysia,Mahathir bin Mohamad,per,--,PROPN,PROPN-PROPN-PROPN,pobj,compound-compound-appos,NNP,NNP-NNP-NNP,4,1
6279,4443.0,25,was,2,1,24,23,0,0,1,22,Her,Manly,org,,DET,PROPN,poss,pobj,PRP$,NNP,3,1
6280,4444.0,24,is,9,1,19,18,0,4,8,10,Paolo De Castro,Agriculture Food and Forestry Policies,per-per-per,----,PROPN-PROPN-PROPN,PROPN-PROPN-CCONJ-PROPN-PROPN,compound-compound-nsubj,pobj-nmod-cc-conj-conj,NNP-NNP-NNP,NNP-NNP-CC-NNP-NNPS,5,1
6281,4445.0,33,promoted,2,5,22,17,4,10,-3,20,Braxton Bragg,Army of Tennessee,-,per-per-per,PROPN-PROPN,PROPN-ADP-PROPN,compound-pobj,pobj-prep-pobj,NNP-NNP,NNP-IN-NNP,9,1
6282,4447.0,13,established,3,1,6,5,0,6,2,3,Hapag-Lloyd Express,2002,-,per,PROPN-PROPN,NUM,compound-nsubjpass,pobj,NNP-NNP,CD,3,1
6283,4448.0,20,co-wrote,1,1,12,11,0,7,0,11,He,Triumph,,org,PRON,PROPN,nsubj,compound,PRP,NNP,4,1
6284,4449.0,21,has,3,3,16,13,2,4,0,13,school,Delaware,per,,NOUN,PROPN,nsubj,poss,NN,NNP,5,1
6285,4450.0,13,holds,1,1,10,9,0,2,0,9,Khalida,University of Karachi,,per-per-per,PROPN,PROPN-ADP-PROPN,nsubj,pobj-prep-pobj,NNP,NNP-IN-NNP,6,1
6286,4451.0,21,founded,6,2,9,7,1,11,4,3,Falcons,1947,,per,PROPN,NUM,compound,pobj,NNPS,CD,3,1
6287,13700.0,24,were,3,3,11,8,2,12,0,8,Falcons,1947,,per,PROPN,NUM,nsubj,pobj,NNPS,CD,3,1
6288,4452.0,27,announced,5,11,25,14,10,1,-6,20,The Sun,News International,-,per-per,DET-PROPN,PROPN-PROPN,det-dobj,compound-appos,DT-NNP,NNP-NNP,6,1
6289,4453.0,39,struggled,1,23,29,6,22,9,-22,28,Central Districts Football Club,South Australian National Football League,per-per-per-per,----,PROPN-PROPN-PROPN-PROPN,PROPN-PROPN-PROPN-PROPN-PROPN,compound-compound-compound-pobj,compound-compound-compound-compound-pobj,NNP-NNPS-NNP-NNP,NNP-NNP-NNP-NNP-NNP,4,1
6290,4454.0,28,was,20,9,16,7,8,11,11,-4,Kosovo,Hashim,,org,PROPN,PROPN,pobj,nsubj,NNP,NNP,5,1
6291,5795.0,18,appointed,6,11,17,6,10,0,-5,11,Kosovo,Hashim,org,,PROPN,PROPN,compound,pobj,NNP,NNP,5,1
6292,4455.0,42,wrote,1,7,9,2,6,32,-6,8,Treasury,Robert J. Walker,per,--,PROPN,PROPN-PROPN-PROPN,compound,compound-compound-pobj,NNP,NNP-NNP-NNP,2,1
6293,4457.0,17,dated,1,9,11,2,8,5,-8,10,French,Patrick Demarchelier,org,-,ADJ,PROPN-PROPN,amod,compound-pobj,JJ,NNP-NNP,3,1
6294,4461.0,86,undertaken,3,21,23,2,20,62,-18,20,Bangladesh,BRAC University,,per-per,PROPN,PROPN-PROPN,pobj,compound-compound,NNP,NNP-NNP,3,1
6295,4462.0,49,thumb,0,15,40,25,14,8,-15,40,New Brunswick,Bernard Lord,per-per,-,PROPN-PROPN,PROPN-PROPN,compound-pobj,compound-nsubj,NNP-NNP,NNP-NNP,-1,1
6296,4463.0,15,was,4,1,8,7,0,6,3,4,Calday Grange Grammar School,Wirral,---,per,PROPN-PROPN-PROPN-PROPN,PROPN,compound-compound-compound-nsubj,compound,NNP-NNP-NNP-NNP,NNP,3,1
6297,12404.0,49,Indie-rock,0,10,16,6,9,32,-10,16,Calday Grange Grammar School,Wirral,org-org-org-org,,PROPN-PROPN-PROPN-PROPN,PROPN,compound-compound-compound-pobj,pobj,NNP-NNP-NNP-NNP,NNP,4,1
6298,4464.0,30,unbeaten,3,2,10,8,1,19,1,7,Liverpool,Premier League,org,-,PROPN,PROPN-PROPN,nsubjpass,compound-compound,NNP,NNP-NNP,4,1
6299,4465.0,16,enrolled,1,1,7,6,0,8,0,6,Caro,Puerto Rico,,per-per,NOUN,PROPN-PROPN,nsubj,compound-pobj,NNS,NNP-NNP,4,1
6300,4466.0,34,produces,2,1,33,32,0,0,1,31,General Motors,Wuling,-,per,PROPN-PROPN,PROPN,compound-nsubj,conj,NNP-NNPS,NNP,2,1
6301,4467.0,19,was,6,14,17,3,13,1,-8,11,Thomas Jefferson,Democratic-Republican,-,org,PROPN-PROPN,PROPN,compound-poss,amod,NNP-NNP,NNP,3,1
6302,4468.0,27,is,3,15,16,1,14,10,-12,13,composer,Michael Andrews,,per-per,NOUN,PROPN-PROPN,compound,compound-pobj,NN,NNP-NNP,1,1
6303,4470.0,26,was,6,3,20,17,2,5,3,14,Centennial Secondary School,Ontario,per-per-per,,PROPN-PROPN-PROPN,PROPN,compound-compound-compound,compound,NNP-NNP-NNP,NNP,10,1
6304,4472.0,23,is,11,9,18,9,8,4,2,7,Divine Word Seminary,E. Rodriguez Boulevard,org-org-org,--,PROPN-PROPN-PROPN,PROPN-PROPN-PROPN,compound-compound-attr,compound-compound-compound,NNP-NNP-NNP,NNP-NNP-NNP,8,1
6305,4473.0,24,extending,5,1,12,11,0,11,4,7,Germany,its,org,,PROPN,DET,poss,poss,NNP,PRP$,6,1
6306,4474.0,60,considered,19,6,35,29,5,24,13,16,Pete Domenici,New Mexico,per-per,-,PROPN-PROPN,PROPN-PROPN,compound-nsubj,compound-compound,NNP-NNP,NNP-NNP,9,1
6307,7460.0,35,lied,2,10,14,4,9,20,-8,12,Pete Domenici,New Mexico,org-org,-,PROPN-PROPN,PROPN-PROPN,compound-pobj,compound-compound,NNP-NNP,NNP-NNP,2,1
6308,9192.0,28,was,5,17,20,3,16,7,-12,15,Pete Domenici,New Mexico,per-per,-,PROPN-PROPN,PROPN-PROPN,compound-pobj,compound-compound,NNP-NNP,NNP-NNP,5,1
6309,4475.0,68,was,9,27,45,18,26,22,-18,36,New York,Lotte Lenya,org-org,-,PROPN-PROPN,PROPN-PROPN,compound-pobj,compound-dobj,NNP-NNP,NNP-NNP,-1,1
6310,4476.0,30,founded,3,23,27,4,22,2,-20,24,American International Pictures,James H. Nicholson,per-per-per,--,PROPN-PROPN-PROPN,PROPN-PROPN-PROPN,compound-compound-compound,compound-compound-pobj,NNP-NNP-NNPS,NNP-NNP-NNP,1,1
6311,4477.0,16,said,6,1,6,5,0,9,5,0,Alexandra Shulman,Vogue,org-org,,PROPN-PROPN,PROPN,compound-compound,pobj,NNP-NNP,NNP,2,1
6312,8877.0,17,said,6,1,6,5,0,10,5,0,Alexandra Shulman,Vogue,-,per,PROPN-PROPN,PROPN,compound-compound,pobj,NNP-NNP,NNP,2,1
6313,4478.0,32,is,1,10,25,15,9,6,-9,24,South Australia,Adelaide High School,-,org-org-org,PROPN-PROPN,PROPN-PROPN-PROPN,compound-pobj,compound-compound-attr,NNP-NNP,NNP-NNP-NNP,7,1
6314,4479.0,33,was,8,3,7,4,2,25,5,-1,Health and Human Services,Donna Shalala,---,org-org,PROPN-CCONJ-PROPN-PROPN,PROPN-PROPN,pobj-cc-compound-conj,compound-nsubj,NNP-CC-NNP-NNPS,NNP-NNP,4,1
6315,9139.0,50,appointed,24,11,15,4,10,34,13,-9,Health and Human Services,Donna Shalala,per-per-per-per,-,PROPN-CCONJ-PROPN-PROPN,PROPN-PROPN,pobj-cc-compound-conj,compound-conj,NNP-CC-NNP-NNPS,NNP-NNP,5,1
6316,10611.0,39,appointed,6,20,25,5,19,13,-14,19,Health and Human Services,Donna Shalala,per-per-per-per,-,PROPN-CCONJ-PROPN-PROPN,PROPN-PROPN,nmod-cc-compound-conj,compound-appos,NNP-CC-NNP-NNPS,NNP-NNP,5,1
6317,11434.0,44,prompted,1,29,33,4,28,10,-28,32,Health and Human Services,Donna Shalala,---,per-per,PROPN-CCONJ-PROPN-PROPN,PROPN-PROPN,pobj-cc-compound-conj,compound-conj,NNP-CC-NNP-NNPS,NNP-NNP,2,1
6318,11773.0,41,met,18,12,17,5,11,23,6,-1,Health and Human Services,Donna Shalala,org-org-org-org,-,PROPN-CCONJ-PROPN-PROPN,PROPN-PROPN,nmod-cc-compound-conj,compound-conj,NNP-CC-NNP-NNPS,NNP-NNP,1,1
6319,12767.0,41,Clinton,0,19,23,4,18,17,-19,23,Health and Human Services,Donna Shalala,per-per-per-per,-,PROPN-CCONJ-PROPN-PROPN,PROPN-PROPN,pobj-cc-compound-conj,compound-nsubj,NNP-CC-NNP-NNPS,NNP-NNP,5,1
6320,13388.0,37,met,32,11,16,5,10,20,21,-16,Health and Human Services,Donna Shalala,---,org-org,PROPN-CCONJ-PROPN-PROPN,PROPN-PROPN,nmod-cc-compound-conj,compound-conj,NNP-CC-NNP-NNPS,NNP-NNP,3,1
6321,4480.0,13,signed,1,1,7,6,0,5,0,6,They,Coral,,per,PRON,PROPN,nsubj,compound,PRP,NNP,3,1
6322,4481.0,21,took,3,8,13,5,7,7,-5,10,Meccano,Hornby,,per,PROPN,PROPN,compound,compound,NNP,NNP,2,1
6323,4482.0,47,was,18,3,18,15,2,28,15,0,her,France,per,,DET,PROPN,poss,pobj,PRP$,NNP,4,1
6324,8776.0,31,asked,9,26,30,4,25,0,-17,21,her,France,org,,DET,PROPN,poss,pobj,PRP$,NNP,4,1
6325,10792.0,16,spent,1,5,8,3,4,7,-4,7,her,France,,org,DET,PROPN,poss,pobj,PRP$,NNP,3,1
6326,4483.0,30,focus,2,6,26,20,5,3,-4,24,Squadron,United Kingdom,,per-per,PROPN,PROPN-PROPN,pobj,compound-pobj,NNP,NNP-NNP,10,1
6327,4484.0,48,named,2,39,38,-1,38,9,-37,36,James Baker,Staff,per-per,,PROPN-PROPN,PROPN,compound-pobj,pobj,NNP-NNP,NNP,6,1
6328,4485.0,22,elected,4,3,8,5,2,13,1,4,Hathaway,Wyoming,,org,PROPN,PROPN,nsubjpass,pobj,NNP,NNP,2,1
6329,4486.0,37,is,1,19,34,15,18,2,-18,33,NSE,Punjab National Bank,per,--,PROPN,PROPN-PROPN-PROPN,compound,compound-compound-conj,NNP,NNP-NNP-NNP,4,1
6330,4487.0,23,was,12,4,8,4,3,14,8,-4,Brussels-based,CSC,,org,VERB,PROPN,amod,pobj,VBN,NNP,3,1
6331,4489.0,9,is,1,6,7,1,5,1,-5,6,actress,Michelle Williams,org,-,NOUN,PROPN-PROPN,compound,compound-pobj,NN,NNP-NNP,1,1
6332,4490.0,18,working,9,5,6,1,4,11,4,-3,Germany,Robert Bosch GmbH,,org-org-org,PROPN,PROPN-PROPN-PROPN,compound,compound-compound-pobj,NNP,NNP-NNP-NNP,2,1
6333,4491.0,46,owns,29,28,38,10,27,7,1,9,Malaysia Airports,Kuala Lumpur International Airport,per-per,---,PROPN-PROPN,PROPN-PROPN-PROPN-PROPN,compound-nsubj,compound-compound-compound-pobj,NNP-NNP,NNP-NNP-NNP-NNP,6,1
6334,4492.0,33,attended,31,19,21,2,18,11,12,-10,Treasury,Paul O'Neill,org,-,PROPN,PROPN-PROPN,compound,compound-appos,NNP,NNP-NNP,10,1
6335,7891.0,50,are,9,42,44,2,41,5,-33,35,Treasury,Paul O'Neill,org,-,PROPN,PROPN-PROPN,compound,compound-ROOT,NNP,NNP-NNP,1,1
6336,11171.0,50,pitching,11,27,24,-3,26,25,-16,13,Treasury,Paul O'Neill,,org-org,PROPN,PROPN-PROPN,compound,compound-conj,NNP,NNP-NNP,1,1
6337,4493.0,30,branded,5,2,23,21,1,6,3,18,Honda,Japan,per,,PROPN,PROPN,compound,poss,NNP,NNP,4,1
6338,7582.0,31,Scorers,0,4,6,2,3,24,-4,6,Honda,Japan,per,,PROPN,PROPN,appos,dep,NNP,NNP,2,1
6339,7935.0,24,Scorers,0,4,6,2,3,17,-4,6,Honda,Japan,org,,PROPN,PROPN,appos,dep,NNP,NNP,2,1
6340,10346.0,18,announced,3,3,12,9,2,5,0,9,Honda,Japan,per,,PROPN,PROPN,nsubj,conj,NNP,NNP,2,1
6341,10668.0,33,is,11,2,10,8,1,22,9,-1,Honda,Japan,org,,PROPN,PROPN,nsubj,pobj,NNP,NNP,3,1
6342,4494.0,26,convinced,2,10,25,15,9,0,-8,23,LHI,ISB,,per,PROPN,PROPN,compound,pobj,NNP,NNP,10,1
6343,4495.0,14,is,2,1,13,12,0,0,1,11,Tony Palacios,Guardian,per-per,,PROPN-PROPN,PROPN,compound-nsubj,pobj,NNP-NNP,NNP,2,1
6344,4496.0,39,entered,3,9,11,2,8,27,-6,8,Canadian,Norval Morrisseau,org,-,ADJ,PROPN-PROPN,amod,compound-pobj,JJ,NNP-NNP,1,1
6345,4497.0,29,is,8,1,18,17,0,10,7,10,Matthew Lokan,Collingwood,per-per,,PROPN-PROPN,PROPN,compound-nsubj,compound,NNP-NNP,NNP,6,1
6346,4498.0,16,is,2,1,13,12,0,2,1,11,Fisk University,Tennessee,org-org,,PROPN-PROPN,PROPN,compound-nsubj,compound,NNP-NNP,NNP,7,1
6347,4499.0,28,introduced,18,14,15,1,13,12,4,-3,Atlantic,Winger,,org,PROPN,PROPN,compound,pobj,NNP,NNP,1,1
6348,4501.0,35,acknowledged,2,23,28,5,22,6,-21,26,Office of the Director of National Intelligence,National Counterterrorism Center,------,per-per-per,PROPN-ADP-DET-PROPN-ADP-PROPN-PROPN,PROPN-PROPN-PROPN,pobj-prep-det-pobj-prep-compound-pobj,compound-compound-pobj,NNP-IN-DT-NNP-IN-NNP-NNP,NNP-NNP-NNP,5,1
6349,4502.0,58,is,22,4,17,13,3,40,18,-5,Long Beach,CSULB,org-org,,PROPN-PROPN,PROPN,compound-nsubj,compound,NNP-NNP,NNPS,3,1
6350,4503.0,29,comprise,21,7,19,12,6,9,14,-2,La Serna High School,Whittier Union High School District,---,org-org-org-org-org,PROPN-PROPN-PROPN-PROPN,PROPN-PROPN-PROPN-PROPN-PROPN,compound-compound-compound-compound,compound-compound-compound-compound-dobj,NNP-NNP-NNP-NNP,NNP-NNP-NNP-NNP-NNP,5,1
6351,12143.0,32,is,8,1,15,14,0,16,7,7,La Serna High School,Whittier Union High School District,---,per-per-per-per-per,PROPN-PROPN-PROPN-PROPN,PROPN-PROPN-PROPN-PROPN-PROPN,compound-compound-compound-nsubj,compound-compound-compound-compound-pobj,NNP-NNP-NNP-NNP,NNP-NNP-NNP-NNP-NNP,5,1
6352,4504.0,24,is,13,1,22,21,0,1,12,9,The Kings of Wessex School,Somerset,----,org,DET-NOUN-ADP-PROPN-PROPN,PROPN,det-pobj-prep-compound-pobj,compound,DT-NNS-IN-NNP-NNP,NNP,5,1
6353,4505.0,52,became,17,20,23,3,19,28,-3,6,Szeto,Hong Kong,,per-per,PROPN,PROPN-PROPN,nsubj,compound-compound,NNP,NNP-NNP,4,1
6354,4506.0,29,traces,2,1,15,14,0,13,1,13,Rhodes College,Tennessee,per-per,,PROPN-PROPN,PROPN,compound-nsubj,pobj,NNP-NNP,NNP,6,1
6355,4507.0,31,mentioned,11,19,27,8,18,3,-8,16,Gale Norton,Interior,org-org,,PROPN-PROPN,PROPN,compound-dobj,pobj,NNP-NNP,NNP,2,1
6356,10454.0,15,Voted,0,5,10,5,4,4,-5,10,Gale Norton,Interior,per-per,,PROPN-PROPN,PROPN,compound-dobj,pobj,NNP-NNP,NNP,5,1
6357,10646.0,33,was,10,7,12,5,6,20,3,2,Gale Norton,Interior,-,org,PROPN-PROPN,PROPN,compound-compound,poss,NNP-NNP,NNP,7,1
6358,4508.0,27,was,3,17,19,2,16,7,-14,16,Quebec,TVA,per,,PROPN,PROPN,pobj,conj,NNP,NNP,11,1
6359,4509.0,31,was,2,13,17,4,12,13,-11,15,Phantom Blue,Meldrum,org-org,,PROPN-PROPN,PROPN,compound-amod,pobj,NNP-NNP,NNP,3,1
6360,4510.0,34,was,1,8,10,2,7,23,-7,9,UCI Road World Cup,World,per-per-per-per,,PROPN-PROPN-PROPN-PROPN,PROPN,compound-compound-compound-pobj,compound,NNP-NNP-NNP-NNP,NNP,2,1
6361,4511.0,18,wrote,1,1,7,6,0,10,0,6,He,Arista,per,,PRON,PROPN,nsubj,appos,PRP,NNP,1,1
6362,4512.0,30,is,2,14,21,7,13,8,-12,19,Constantin,e Romania,org,-,PROPN,PROPN-PROPN,pobj,det-nmod,NNP,NNP-NNP,4,1
6363,4513.0,20,limiting,8,2,5,3,1,14,6,-3,Gulf Air,Bahrain,-,org,PROPN-PROPN,PROPN,compound-npadvmod,poss,NNP-NNP,NNP,4,1
6364,4514.0,31,like,2,5,18,13,4,12,-3,16,Freddie Mac,1970,per-per,,PROPN-PROPN,NUM,compound-nsubjpass,pobj,NNP-NNP,CD,2,1
6365,4516.0,86,withdrawn,14,29,40,11,28,45,-15,26,7th Armoured Division,William Gott,--,org-org,ADJ-PROPN-PROPN,PROPN-PROPN,amod-compound-poss,compound-pobj,JJ-NNP-NNP,NNP-NNP,8,1
6366,4517.0,29,During,0,10,27,17,9,1,-10,27,Army,Soviet Union,,org-org,PROPN,PROPN-PROPN,pobj,compound-pobj,NNP,NNP-NNP,-1,1
6367,4519.0,30,kills,4,22,29,7,21,0,-18,25,alex james,author,org-org,,ADJ-NOUN,NOUN,amod-pobj,appos,JJ-NNS,NN,6,1
6368,4520.0,29,recorded,1,16,25,9,15,3,-15,24,Pink Cream 69,Dennis Ward,--,per-per,PROPN-PROPN-NUM,PROPN-PROPN,compound-dobj-nummod,compound-conj,NNP-NNP-CD,NNP-NNP,7,1
6369,11705.0,26,formed,11,7,18,11,6,7,4,7,Pink Cream 69,Dennis Ward,org-org-org,-,PROPN-PROPN-NUM,PROPN-PROPN,compound-attr-nummod,compound-compound,NNP-NNP-CD,NNP-NNP,10,1
6370,4521.0,44,assigned,18,36,42,6,35,1,-18,24,Cheddi Jagan,Guyana,per-per,,PROPN-PROPN,PROPN,compound-compound,pobj,NNP-NNP,NNP,5,1
6371,5378.0,17,elected,3,1,8,7,0,8,2,5,Cheddi Jagan,Guyana,-,org,PROPN-PROPN,PROPN,compound-nsubjpass,pobj,NNP-NNP,NNP,2,1
6372,7824.0,19,is,3,14,18,4,13,0,-11,15,Cheddi Jagan,Guyana,-,org,PROPN-PROPN,PROPN,compound-compound,pobj,NNP-NNP,NNP,6,1
6373,9409.0,37,was,1,27,33,6,26,3,-26,32,Cheddi Jagan,Guyana,-,per,PROPN-PROPN,PROPN,compound-pobj,appos,NNP-NNP,NNP,8,1
6374,10153.0,34,overran,10,21,26,5,20,7,-11,16,Cheddi Jagan,Guyana,org-org,,PROPN-PROPN,PROPN,compound-compound,pobj,NNP-NNP,NNP,3,1
6375,11079.0,34,re-elected,31,10,27,17,9,6,21,-4,Cheddi Jagan,Guyana,org-org,,PROPN-PROPN,PROPN,compound-pobj,pobj,NNP-NNP,NNP,8,1
6376,13745.0,29,moved,9,4,28,24,3,0,5,19,Cheddi Jagan,Guyana,per-per,,PROPN-PROPN,PROPN,compound-nsubj,pobj,NNP-NNP,NNP,3,1
6377,4522.0,33,taken,7,23,29,6,22,3,-16,22,Peru,Yehude Simon,,per-per,PROPN,PROPN-PROPN,pobj,compound-nsubj,NNP,NNP-NNP,1,1
6378,4524.0,18,gained,10,4,8,4,3,9,6,-2,Time Warner,channel,org-org,,PROPN-PROPN,NOUN,compound-compound,poss,NNP-NNP,NN,6,1
6379,4525.0,11,welcomes,2,1,10,9,0,0,1,8,Fredrik Reinfeldt,Sweden,-,per,PROPN-PROPN,PROPN,compound-nsubj,pobj,NNP-NNP,NNP,2,1
6380,4526.0,22,was,17,10,16,6,9,5,7,-1,Shady,Eminem,per,,PROPN,PROPN,compound,nsubj,NNP,NNP,5,1
6381,4527.0,29,established,7,19,26,7,18,2,-12,19,Cornell University School of Hotel Administration,Ithaca,org-org-org-org-org-org,,PROPN-PROPN-PROPN-ADP-PROPN-PROPN,PROPN,compound-compound-attr-prep-compound-pobj,compound,NNP-NNP-NNP-IN-NNP-NNP,NNP,6,1
6382,4528.0,25,State-own,0,2,8,6,1,16,-2,8,Taiwan Tobacco,TTLC,-,org,PROPN-PROPN,PROPN,compound-ROOT,nsubj,NNP-NNP,NNP,3,1
6383,4529.0,47,began,3,10,20,10,9,26,-7,17,Syria,Bashar al-Assad,,org-org,PROPN,PROPN-PROPN,pobj,compound-nsubj,NNP,NNP-NNP,4,1
6384,7390.0,56,describes,1,21,26,5,20,29,-20,25,Syria,Bashar al-Assad,,org-org,PROPN,PROPN-PROPN,pobj,conj-ROOT,NNP,NNP-NNP,4,1
6385,10656.0,27,is,4,8,18,10,7,8,-4,14,Syria,Bashar al-Assad,,org-org,PROPN,PROPN-PROPN,dobj,compound-pobj,NNP,NNP-NNP,6,1
6386,10993.0,32,said,13,1,23,22,0,8,12,10,Syria,Bashar al-Assad,org,-,PROPN,PROPN-PROPN,nsubj,compound-pobj,NNP,NNP-NNP,9,1
6387,12739.0,24,are,1,13,16,3,12,7,-12,15,Syria,Bashar al-Assad,per,-,PROPN,PROPN-PROPN,pobj,compound-nsubj,NNP,NNP-NNP,2,1
6388,4531.0,31,was,7,23,28,5,22,2,-16,21,Acette,Dubai Internet City,per,--,PROPN,PROPN-PROPN-PROPN,compound,compound-compound-pobj,NNP,NNP-NNP-NNP,3,1
6389,4532.0,33,caters,13,7,11,4,6,21,6,-2,Granville,Delany College,org,-,PROPN,PROPN-PROPN,pobj,compound-nsubj,NNP,NNP-NNP,5,1
6390,4533.0,33,referred,4,7,29,22,6,3,-3,25,Schuldiner,U.S.,per,,PROPN,PROPN,pobj,compound,NNP,NNP,9,1
6391,4534.0,34,lends,29,1,27,26,0,6,28,-2,Jean,New Jersey,,org-org,PROPN,PROPN-PROPN,poss,compound-pobj,NNP,NNP-NNP,7,1
6392,4535.0,31,is,11,7,2,-5,6,28,4,-9,PLAN,People's Republic of China,,per-per-per-per,PROPN,PROPN-PROPN-ADP-PROPN,appos,compound-pobj-prep-pobj,NNP,NNP-NNP-IN-NNP,3,1
6393,4537.0,22,took,4,9,14,5,8,7,-5,10,Appalachian State University,North Carolina,per-per-per,-,PROPN-PROPN-PROPN,PROPN-PROPN,compound-compound-pobj,compound-pobj,NNP-NNP-NNP,NNP-NNP,3,1
6394,4538.0,59,For,0,13,32,19,12,26,-13,32,Connecticut,Paul Newman,per,-,PROPN,PROPN-PROPN,pobj,compound-conj,NNP,NNP-NNP,4,1
6395,4539.0,31,known,3,10,23,13,9,7,-7,20,1999,FleetBoston Financial,org,-,NUM,PROPN-PROPN,pobj,compound-pobj,CD,NNP-NNP,4,1
6396,4544.0,26,made,19,13,18,5,12,7,6,-1,Greece,OTE,per,,PROPN,PROPN,poss,appos,NNP,NNP,2,1
6397,10409.0,32,is,1,26,31,5,25,0,-25,30,Greece,OTE,per,,PROPN,PROPN,poss,appos,NNP,NNP,13,1
6398,4545.0,32,said,8,1,4,3,0,27,7,-4,MQM,Pakistan,per,,NOUN,PROPN,compound,pobj,NN,NNP,1,1
6399,4546.0,44,diaries,1,8,23,15,7,20,-7,22,Zhang Xueliang,Marshal,-,per,PROPN-PROPN,PROPN,compound-pobj,pobj,NNP-NNP,NNP,9,1
6400,4547.0,28,finished,18,1,4,3,0,23,17,-14,England,Tom Smith,org,-,NOUN,PROPN-PROPN,compound,compound-nsubj,NN,NNP-NNP,2,1
6401,4548.0,27,plans,2,1,19,18,0,7,1,17,Televisa,Mexico,,per,PROPN,PROPN,nsubj,pobj,NNP,NNP,9,1
6402,13084.0,18,is,1,9,17,8,8,0,-8,16,Televisa,Mexico,org,,PROPN,PROPN,nmod,pobj,NNP,NNP,4,1
6403,4549.0,16,was,2,7,14,7,6,1,-5,12,Brandeis University,Jehuda Reinharz,per-per,-,PROPN-PROPN,PROPN-PROPN,compound-compound,compound-conj,NNP-NNP,NNP-NNP,5,1
6404,4551.0,26,known,3,18,19,1,17,6,-15,16,King,William I of England,per,---,PROPN,PROPN-PROPN-ADP-PROPN,compound,compound-pobj-prep-poss,NNP,NNP-NNP-IN-NNP,1,1
6405,4552.0,51,spent,5,13,25,12,12,25,-8,20,Perth,David McComb,,per-per,PROPN,PROPN-PROPN,pobj,compound-pobj,NNP,NNP-NNP,8,1
6406,4553.0,29,won,12,9,12,3,8,16,3,0,Mississippi,Harrison,org,,PROPN,PROPN,compound,pobj,NNP,NNP,4,1
6407,4554.0,32,took,12,2,12,10,1,19,10,0,desai,India,,org,NOUN,PROPN,poss,pobj,NN,NNP,4,1
6408,4555.0,54,said,26,14,19,5,13,34,12,-7,Georgia,University of Georgia,,per-per-per,PROPN,PROPN-ADP-PROPN,pobj,conj-prep-compound,NNP,NNP-IN-NNP,4,1
6409,4556.0,12,went,1,6,11,5,5,0,-5,10,Rawlins Community College,Leicestershire,org-org-org,,PROPN-PROPN-PROPN,PROPN,compound-compound-pobj,pobj,NNP-NNP-NNP,NNP,4,1
6410,4557.0,10,left,3,3,5,2,2,4,0,2,Manilow,Arista,org,,PROPN,PROPN,nsubj,compound,NNP,NNP,1,1
6411,6135.0,16,renewed,10,2,7,5,1,8,8,-3,Manilow,Arista,per,,PROPN,PROPN,poss,compound,NNP,NNP,4,1
6412,4559.0,32,received,6,12,12,0,11,19,-6,6,University of South Dakota,University of South Dakota School of Law,---,org-org-org-org-org-org-org,PROPN-ADP-PROPN-PROPN,PROPN-ADP-PROPN-PROPN-PROPN-ADP-PROPN,pobj-prep-compound-pobj,nmod-prep-pobj-compound-pobj-prep-pobj,NNP-IN-NNP-NNP,NNP-IN-NNP-NNP-NNP-IN-NNP,0,1
6413,10748.0,36,earned,6,13,13,0,12,22,-7,7,University of South Dakota,University of South Dakota School of Law,---,per-per-per-per-per-per-per,PROPN-ADP-PROPN-PROPN,PROPN-ADP-PROPN-PROPN-PROPN-ADP-PROPN,pobj-prep-compound-pobj,pobj-prep-pobj-compound-appos-prep-pobj,NNP-IN-NNP-NNP,NNP-IN-NNP-NNP-NNP-IN-NNP,0,1
6414,4560.0,20,established,2,5,12,7,4,7,-3,10,Chile,Salvador Allende,per,-,PROPN,PROPN-PROPN,pobj,compound-compound,NNP,NNP-NNP,5,1
6415,7619.0,32,Allende,1,29,30,1,28,1,-28,29,Chile,Salvador Allende,per,-,PROPN,PROPN-PROPN,compound,compound-pobj,NNP,NNP-NNP,1,1
6416,7997.0,27,came,12,15,25,10,14,1,-3,13,Chile,Salvador Allende,,per-per,PROPN,PROPN-PROPN,pobj,compound-pobj,NNP,NNP-NNP,6,1
6417,8473.0,29,boarded,2,11,21,10,10,7,-9,19,Chile,Salvador Allende,per,-,PROPN,PROPN-PROPN,pobj,compound-pobj,NNP,NNP-NNP,3,1
6418,10551.0,29,released,3,20,27,7,19,1,-17,24,Chile,Salvador Allende,org,-,PROPN,PROPN-PROPN,pobj,compound-pobj,NNP,NNP-NNP,4,1
6419,4561.0,28,is,2,9,18,9,8,9,-7,16,Willie Nelson,RCA,per-per,,PROPN-PROPN,PROPN,compound-compound,compound,NNP-NNP,NNP,6,1
6420,6474.0,32,attempting,5,15,21,6,14,10,-10,16,Willie Nelson,RCA,per-per,,PROPN-PROPN,PROPN,compound-pobj,compound,NNP-NNP,NNP,6,1
6421,8803.0,18,is,1,10,14,4,9,3,-9,13,Willie Nelson,RCA,org-org,,PROPN-PROPN,PROPN,compound-conj,compound,NNP-NNP,NNP,6,1
6422,4562.0,35,taken,4,11,31,20,10,3,-7,27,New Delhi,Central Bureau of Investigation,-,org-org-org-org,PROPN-PROPN,PROPN-PROPN-ADP-PROPN,compound-pobj,compound-pobj-prep-pobj,NNP-NNP,NNP-NNP-IN-NNP,8,1
6423,4563.0,22,is,3,1,15,14,0,6,2,12,Double Fine Productions,Tim Schafer,per-per-per,-,ADJ-PROPN-PROPN,PROPN-PROPN,amod-compound-nsubj,compound-pobj,JJ-NNP-NNPS,NNP-NNP,6,1
6424,4564.0,44,met,7,29,33,4,28,10,-22,26,Belgium,Supreme Headquarters Allied Powers Europe,org,----,PROPN,PROPN-PROPN-PROPN-PROPN-PROPN,appos,compound-compound-compound-compound-appos,NNP,NNP-NNP-NNP-NNPS-NNP,6,1
6425,4565.0,49,offered,19,11,25,14,10,23,8,6,Nashville,Montgomery Bell Academy,,per-per-per,PROPN,PROPN-PROPN-PROPN,pobj,compound-compound-pobj,NNP,NNP-NNP-NNP,6,1
6426,4567.0,9,address,0,5,7,2,4,1,-5,7,oladele,Lagos,per,,ADJ,PROPN,compound,compound,JJ,NNP,1,1
6427,4568.0,51,cross-bred,5,39,42,3,38,8,-34,37,Kinki University,Japan,-,per,PROPN-PROPN,PROPN,compound-conj,pobj,NNP-NNP,NNP,4,1
6428,4570.0,16,include,6,4,11,7,3,4,2,5,Vidor,Tracy Byrd,,per-per,PROPN,PROPN-PROPN,compound,compound-appos,NNP,NNP-NNP,6,1
6429,4571.0,24,is,3,11,20,9,10,3,-8,17,TransAlta,Canada,,org,PROPN,PROPN,compound,pobj,NNP,NNP,6,1
6430,4572.0,15,1st,2,3,5,2,2,9,-1,3,1st Arkansas Infantry,Infantry,org-org-org,,NOUN-PROPN-PROPN,PROPN,ROOT-compound-compound,pobj,NN-NNP-NNP,NNP,3,1
6431,4573.0,21,is,3,8,15,7,7,5,-5,12,Kenny Rogers,United Artists Records,per-per,--,PROPN-PROPN,PROPN-PROPN-PROPN,compound-poss,compound-compound-pobj,NNP-NNP,NNP-NNP-NNP,4,1
6432,4574.0,23,written,4,9,18,9,8,4,-5,14,Peter Bratt,San Francisco,-,per-per,PROPN-PROPN,PROPN-PROPN,compound-pobj,compound-poss,NNP-NNP,NNP-NNP,8,1
6433,4576.0,18,named,2,5,17,12,4,0,-3,15,Afonso Augusto Moreira Pena,Brazil,org-org-org-org,,PROPN-PROPN-PROPN-PROPN,PROPN,compound-compound-compound-pobj,pobj,NNP-NNP-NNP-NNP,NNP,3,1
6434,4578.0,27,completed,7,5,7,2,4,19,2,0,Costa Rica,Arias,-,per,PROPN-PROPN,PROPN,compound-compound,pobj,NNP-NNP,NNP,4,1
6435,7704.0,40,returned,4,12,14,2,11,25,-8,10,Costa Rica,Arias,per-per,,PROPN-PROPN,PROPN,compound-compound,pobj,NNP-NNP,NNP,6,1
6436,4579.0,29,sought,1,1,7,6,0,21,0,6,Bruinooge,Winnipeg,,per,PROPN,PROPN,nsubj,compound,NNP,NNP,3,1
6437,4580.0,26,Raised,0,13,16,3,12,9,-13,16,Peddie School,Hightstown,-,per,PROPN-PROPN,PROPN,compound-pobj,compound,NNP-NNP,NNP,3,1
6438,4581.0,51,thanked,3,7,25,18,6,25,-4,22,Hun Sen,Cambodia,per-per,,PROPN-PROPN,PROPN,compound-dobj,pobj,NNP-NNP,NNP,4,1
6439,7541.0,24,jpg,0,10,12,2,9,11,-10,12,Hun Sen,Cambodia,org-org,,PROPN-PROPN,PROPN,compound-compound,compound,NNP-NNP,NNP,3,1
6440,10502.0,42,suggested,6,4,9,5,3,32,2,3,Hun Sen,Cambodia,-,per,PROPN-PROPN,PROPN,compound-nsubj,nsubj,NNP-NNP,NNP,3,1
6441,4582.0,47,writes,6,1,6,5,0,40,5,0,Ingrid Newkirk,PETA,-,org,PROPN-PROPN,PROPN,compound-nsubj,pobj,NNP-NNP,NNP,1,1
6442,9734.0,16,check,2,4,10,6,3,5,-2,8,Ingrid Newkirk,PETA,org-org,,PROPN-PROPN,PROPN,compound-poss,poss,NNP-NNP,NNP,5,1
6443,11771.0,23,Lowry,2,12,15,3,11,7,-10,13,Ingrid Newkirk,PETA,-,per,PROPN-PROPN,PROPN,compound-pobj,subtok,NNP-NNP,NNP,2,1
6444,4583.0,38,http://www.nowpublic.com/politics/india-favours-release-suu-kyi,0,5,7,2,4,30,-5,7,India,Manmohan Singh,org,-,PROPN,PROPN-PROPN,pobj,compound-nsubj,NNP,NNP-NNP,1,1
6445,4584.0,27,said,23,14,18,4,13,8,9,-5,Power Machines,Russia,per-per,,PROPN-PROPN,PROPN,compound-pobj,poss,NNP-NNPS,NNP,5,1
6446,4585.0,31,include,2,9,16,7,8,14,-7,14,Oil and Natural Gas Corporation,India,----,per,PROPN-CCONJ-PROPN-PROPN-PROPN,PROPN,nmod-cc-compound-conj-compound,compound,NNP-CC-NNP-NNP-NNP,NNP,6,1
6447,4586.0,49,February,1,5,7,2,4,41,-4,6,Chicago,Andrew Bird,org,-,PROPN,PROPN-PROPN,compound,compound-conj,NNP,NNP-NNP,1,1
6448,4587.0,33,said,23,14,16,2,13,16,9,-7,AirAsia X,D7,-,org,PROPN-PROPN,NOUN,compound-compound,pobj,NNP-NNP,NN,3,1
6449,4588.0,28,is,9,23,26,3,22,1,-14,17,Coxsone Dodd,Studio One,per-per,-,PROPN-PROPN,PROPN-PROPN,compound-poss,compound-pobj,NNP-NNP,NNP-NNP,3,1
6450,8229.0,60,included,4,30,33,3,29,26,-26,29,Coxsone Dodd,Studio One,-,per-per,PROPN-PROPN,PROPN-NUM,compound-pobj,pobj-nummod,NNP-NNP,NNP-CD,4,1
6451,4589.0,32,named,7,1,6,5,0,25,6,-1,Caistor Yarborough School,Lincolnshire,--,org,PROPN-PROPN-PROPN,PROPN,compound-compound-nsubjpass,pobj,NNP-NNP-NNP,NNP,3,1
6452,4590.0,46,represent,3,2,6,4,1,39,1,3,Florida Gators,University of Florida,org-org,--,PROPN-PROPN,PROPN-ADP-PROPN,compound-nsubj,dobj-prep-pobj,NNP-NNPS,NNP-IN-NNP,3,1
6453,4591.0,35,Bajrakitiyabha,1,2,4,2,1,30,-1,3,Bajrakitiyabha,Thailand,,org,PROPN,PROPN,ROOT,pobj,NNP,NNP,2,1
6454,4592.0,18,provided,8,5,15,10,4,2,3,7,Delaware,DART First State,,org-org-org,PROPN,PROPN-PROPN-PROPN,compound,compound-compound-pobj,NNP,NNP-NNP-NNP,9,1
6455,4593.0,44,returned,4,11,38,27,10,5,-7,34,Balochistan,Akhtar Mengal,per,-,PROPN,PROPN-PROPN,pobj,compound-pobj,NNP,NNP-NNP,11,1
6456,4595.0,18,pleaded,6,2,6,4,1,11,4,0,Craig,Idaho,org,,PROPN,PROPN,nsubj,pobj,NNP,NNP,3,1
6457,5081.0,32,was,1,1,7,6,0,24,0,6,Craig,Idaho,,org,PROPN,PROPN,nsubj,compound,NNP,NNP,4,1
6458,7484.0,33,chaired,1,1,31,30,0,1,0,30,Craig,Idaho,,per,PROPN,PROPN,nsubj,compound,NNP,NNP,8,1
6459,10522.0,12,defeated,1,1,3,2,0,8,0,2,Craig,Idaho,per,,PROPN,PROPN,nsubj,compound,NNP,NNP,3,1
6460,12141.0,18,said,3,3,8,5,2,9,0,5,Craig,Idaho,,org,PROPN,PROPN,nsubj,nmod,NNP,NNP,3,1
6461,4596.0,27,is,3,1,3,2,0,23,2,0,The Citadel,Bulldogs,-,per,DET-PROPN,PROPN,det-compound,nsubj,DT-NNP,NNP,2,1
6462,4597.0,62,include,2,24,4,-20,23,57,-22,2,Treasury,Robert M. Kimmitt,,per-per-per,PROPN,PROPN-PROPN-PROPN,compound,compound-compound-conj,NNP,NNP-NNP-NNP,3,1
6463,7949.0,78,think,39,58,60,2,57,17,-19,21,Treasury,Robert M. Kimmitt,org,--,PROPN,PROPN-PROPN-PROPN,compound,compound-compound-nsubj,NNP,NNP-NNP-NNP,1,1
6464,4598.0,26,gave,9,21,25,4,20,0,-12,16,Virginia Union University,Richmond,org-org-org,,PROPN-PROPN-PROPN,PROPN,compound-compound-pobj,pobj,NNP-NNP-NNP,NNP,8,1
6465,4600.0,30,operates,2,1,19,18,0,10,1,17,Limited Brands,La Senza,per-per,-,PROPN-PROPN,PROPN-PROPN,compound-nsubj,compound-ROOT,NNP-NNP,NNP-NNP,4,1
6466,4601.0,31,stressed,2,17,25,8,16,5,-15,23,LAF,Lebanon,per,,PROPN,PROPN,pobj,poss,NNP,NNP,12,1
6467,10334.0,50,increased,14,6,30,24,5,19,8,16,LAF,Lebanon,per,,PROPN,PROPN,pobj,pobj,NNP,NNP,9,1
6468,4603.0,24,represent,8,3,11,8,2,12,5,3,South Carolina,University of South Carolina,per-per,---,PROPN-PROPN,PROPN-ADP-PROPN-PROPN,compound-compound,dobj-prep-compound-pobj,NNP-NNP,NNP-IN-NNP-NNP,5,1
6469,4604.0,34,was,1,17,21,4,16,12,-16,20,1972,The Jam,,per-per,NUM,DET-PROPN,pobj,det-compound,CD,DT-NNP,3,1
6470,4605.0,20,returned,2,1,5,4,0,14,1,3,Toru Iwaya,Koriyama,-,per,PROPN-PROPN,PROPN,compound-nsubj,compound,NNP-NNP,NNP,3,1
6471,4606.0,44,organized,6,22,25,3,21,18,-16,19,Hong Kong,Sundream Motion Pictures,per-per,--,PROPN-PROPN,PROPN-PROPN-VERB,compound-pobj,compound-compound-pobj,NNP-NNP,NNP-NNP-VBZ,5,1
6472,4607.0,25,known,19,6,9,3,5,15,13,-10,Silicon Graphics,SGI,org-org,,PROPN-PROPN,PROPN,compound-poss,compound,NNP-NNP,NNP,4,1
6473,6167.0,39,referred,10,1,8,7,0,30,9,-2,Silicon Graphics,SGI,-,org,PROPN-PROPN,PROPN,compound-compound,pobj,NNP-NNP,NNP,4,1
6474,4608.0,24,is,7,11,18,7,10,5,-4,11,Japanese,Chiaki Mukai,per,-,ADJ,PROPN-PROPN,amod,compound-pobj,JJ,NNP-NNP,3,1
6475,4610.0,16,enjoyed,1,1,8,7,0,7,0,7,He,Western Australia,,per-per,PRON,PROPN-PROPN,nsubj,compound-pobj,PRP,NNP-NNP,3,1
6476,4611.0,15,July,0,4,13,9,3,1,-4,13,Art Center College of Design,Pasadena,org-org-org-org-org,,PROPN-PROPN-PROPN-ADP-PROPN,PROPN,compound-compound-appos-prep-compound,compound,NNP-NNP-NNP-IN-NNP,NNP,3,1
6477,4612.0,24,is,9,1,19,18,0,4,8,10,Nicanor Duarte,Paraguay,org-org,,PROPN-PROPN,PROPN,compound-compound,pobj,NNP-NNP,NNP,5,1
6478,12733.0,33,put,17,2,19,17,1,13,15,2,Nicanor Duarte,Paraguay,-,per,PROPN-PROPN,PROPN,compound-nsubj,dobj,NNP-NNP,NNP,2,1
6479,4613.0,21,elected,6,3,19,16,2,1,3,13,Christopher J. Dodd,Connecticut,--,per,PROPN-PROPN-PROPN,PROPN,compound-compound-appos,compound,NNP-NNP-NNP,NNP,5,1
6480,5553.0,15,running,11,5,10,5,4,4,6,-1,Christopher J. Dodd,Connecticut,per-per-per,,PROPN-PROPN-PROPN,PROPN,compound-compound-compound,pobj,NNP-NNP-NNP,NNP,4,1
6481,4614.0,16,ran,8,1,15,14,0,0,7,7,Kershaw,Louisiana,org,,PROPN,PROPN,nsubj,pobj,NNP,NNP,4,1
6482,4616.0,34,mentions,2,1,15,14,0,18,1,13,Gavin Rossdale,Bush,org-org,,PROPN-PROPN,PROPN,compound-nsubj,appos,NNP-NNP,NNP,6,1
6483,5451.0,21,met,1,7,20,13,6,0,-6,19,Gavin Rossdale,Bush,-,per,PROPN-PROPN,PROPN,compound-nsubj,attr,NNP-NNP,NNP,3,1
6484,7106.0,40,says,38,19,25,6,18,14,19,-13,Gavin Rossdale,Bush,per-per,,PROPN-PROPN,PROPN,compound-nsubj,dobj,NNP-NNP,NNP,2,1
6485,4617.0,29,Knight,0,19,26,7,18,2,-19,26,Dr. Dre,Death Row,-,org-org,PROPN-PROPN,PROPN-PROPN,compound-dobj,compound-compound,NNP-NNP,NNP-NNP,1,1
6486,12559.0,44,ensued,42,2,15,13,1,28,40,-27,Dr. Dre,Death Row,org-org,-,PROPN-PROPN,PROPN-PROPN,compound-pobj,compound-compound,NNP-NNP,NNP-NNP,6,1
6487,4618.0,25,received,6,4,4,0,3,20,2,-2,Fairchild Media Group,Fairchild TV,per-per-per,-,PROPN-PROPN-PROPN,PROPN-PROPN,compound-compound-nsubj,compound-dobj,NNP-NNP-NNP,NNP-NNP,0,1
6488,4619.0,22,founded,9,8,18,10,7,3,1,9,TANGS,CK Tang,,org-org,PROPN,PROPN-PROPN,pobj,compound-pobj,NNP,NNP-NNP,8,1
6489,4621.0,62,has,1,1,54,53,0,7,0,53,BUIE,Bankura,org,,PROPN,PROPN,nsubj,compound,NNP,NNP,-1,1
6490,4623.0,33,),2,17,22,5,16,10,-15,20,Randi Weingarten,United Federation of Teachers,org-org,---,PROPN-PROPN,PROPN-PROPN-ADP-PROPN,compound-compound,compound-pobj-prep-pobj,NNP-NNP,NNP-NNP-IN-NNPS,3,1
6491,4626.0,35,was,21,20,34,14,19,0,1,13,Chris Watson,Australia,-,per,PROPN-PROPN,PROPN,compound-pobj,pobj,NNP-NNP,NNP,5,1
6492,4627.0,28,dictator,2,1,5,4,0,22,1,3,Ioannis Metaxas,Greece,org-org,,PROPN-PROPN,PROPN,compound-compound,pobj,NNP-NNP,NNP,2,1
6493,4628.0,28,features,1,23,27,4,22,0,-22,26,Chino Moreno,Deftones,org-org,,PROPN-PROPN,PROPN,compound-conj,pobj,NNP-NNPS,NNPS,4,1
6494,4968.0,37,features,1,15,18,3,14,18,-14,17,Chino Moreno,Deftones,-,org,PROPN-PROPN,PROPN,compound-pobj,compound,NNP-NNPS,NNP,3,1
6495,4629.0,17,announced,6,6,15,9,5,1,0,9,Havoc,G-Unit,,per,PROPN,PROPN,conj,punct,NNP,NNP,4,1
6496,4630.0,21,Zamora,2,1,9,8,0,11,1,7,Jaime Paz Zamora,Bolivia,--,org,PROPN-PROPN-PROPN,PROPN,compound-compound-ROOT,pobj,NNP-NNP-NNP,NNP,5,1
6497,4631.0,49,named,27,33,44,11,32,4,-6,17,George M. Bibb,Treasury,--,org,PROPN-PROPN-PROPN,PROPN,compound-compound-compound,pobj,NNP-NNP-NNP,NNP,8,1
6498,4633.0,33,said,17,24,31,7,23,1,-7,14,Funcom,Oslo,,org,PROPN,PROPN,pobj,compound,NNP,NNP,3,1
6499,4634.0,46,*,0,21,31,10,20,14,-21,31,Australia,Telstra,org,,PROPN,PROPN,pobj,compound,NNP,NNP,7,1
6500,4635.0,13,kicks,2,1,5,4,0,7,1,3,George Michael,London,-,per,PROPN-PROPN,PROPN,compound-nsubj,poss,NNP-NNP,NNP,4,1
6501,4636.0,44,owns,2,2,8,6,1,35,0,6,Macau,Air Macau,,per-per,PROPN,PROPN-PROPN,nsubj,compound-pobj,NNP,NNP-NNP,2,1
6502,4637.0,37,took,1,25,31,6,24,5,-24,30,Harold Wilson,Prime Minister,per-per,-,PROPN-PROPN,PROPN-PROPN,compound-nsubj,compound-attr,NNP-NNP,NNP-NNP,3,1
6503,4638.0,23,was,1,9,14,5,8,8,-8,13,Dublin,Royal Irish Academy of Music,org,----,PROPN,PROPN-PROPN-PROPN-ADP-PROPN,pobj,compound-compound-pobj-prep-pobj,NNP,NNP-NNP-NNP-IN-NNP,5,1
6504,4639.0,45,attended,8,5,30,25,4,14,3,22,British Columbia,his,per-per,,PROPN-PROPN,DET,compound-poss,poss,NNP-NNP,PRP$,10,1
6505,4640.0,26,Felix,7,5,15,10,4,10,2,8,Australia,Lisa Gerrard,per,-,PROPN,PROPN-PROPN,compound,ROOT-compound,NNP,NNP-NNP,5,1
6506,4641.0,8,was,1,1,6,5,0,1,0,5,He,Angelina Jolie,per,-,PRON,PROPN-PROPN,nsubj,compound-pobj,PRP,NNP-NNP,3,1
6507,4642.0,32,claimed,3,15,23,8,14,8,-12,20,The Guardian,Alan Rusbridger,per-per,-,DET-PROPN,PROPN-PROPN,det-pobj,compound-dobj,DT-NNP,NNP-NNP,2,1
6508,6421.0,34,included,7,6,21,15,5,12,1,14,The Guardian,Alan Rusbridger,-,org-org,DET-PROPN,PROPN-PROPN,det-pobj,compound-pobj,DT-NNP,NNP-NNP,8,1
6509,4643.0,20,opened,7,13,18,5,12,1,-6,11,State for Education and Science,Margaret Thatcher,per-per-per-per-per,-,PROPN-ADP-PROPN-CCONJ-PROPN,PROPN-PROPN,pobj-prep-pobj-cc-compound,compound-conj,NNP-IN-NNP-CC-NNP,NNP-NNP,2,1
6510,4644.0,29,purchased,6,4,17,13,3,11,2,11,Aims Community College,Colorado,per-per-per,,VERB-PROPN-PROPN,PROPN,compound-compound-nsubj,compound,VBZ-NNP-NNP,NNP,6,1
6511,4645.0,36,said,9,1,6,5,0,29,8,-3,Michael Gravelle,Northern Development and Mines,org-org,---,PROPN-PROPN,PROPN-PROPN-CCONJ-PROPN,compound-nsubj,compound-pobj-cc-conj,NNP-NNP,NNP-NNP-CC-NNP,3,1
6512,4646.0,39,attempted,18,11,13,2,10,25,7,-5,State Broadcaster,TVE2,org-org,,PROPN-PROPN,PROPN,compound-compound,pobj,NNP-NNP,NNP,2,1
6513,4647.0,26,McRae,0,9,11,2,8,14,-9,11,University of Missouri,Missouri,--,org,PROPN-ADP-PROPN,PROPN,pobj-prep-compound,pobj,NNP-IN-NNP,NNP,1,1
6514,4648.0,28,visited,3,5,26,21,4,1,-2,23,Dr. Dre,Aftermath,org-org,,PROPN-PROPN,PROPN,compound-dobj,compound,NNP-NNP,NNP,6,1
6515,6538.0,14,is,1,7,10,3,6,3,-6,9,Dr. Dre,Aftermath,org-org,,PROPN-PROPN,PROPN,compound-poss,compound,NNP-NNP,NNP,2,1
6516,8841.0,40,left,15,6,9,3,5,30,9,-6,Dr. Dre,Aftermath,-,per,PROPN-PROPN,PROPN,compound-poss,compound,NNP-NNP,NNP,2,1
6517,10704.0,18,meant,4,11,16,5,10,1,-7,12,Dr. Dre,Aftermath,-,per,PROPN-PROPN,PROPN,compound-pobj,compound,NNP-NNP,NNP,5,1
6518,11517.0,44,helped,6,24,32,8,23,11,-18,26,Dr. Dre,Aftermath,org-org,,PROPN-PROPN,PROPN,compound-appos,compound,NNP-NNP,NNP,5,1
6519,4650.0,61,said,13,15,20,5,14,40,-2,7,Sara Nelson,Publishers Weekly,-,org-org,PROPN-PROPN,PROPN-PROPN,compound-nsubj,compound-pobj,NNP-NNP,NNP-NNP,3,1
6520,4652.0,38,Adams,4,2,4,2,1,33,2,0,Sussex,Chris Adams,,org-org,PROPN,PROPN-PROPN,compound,compound-ROOT,NNP,NNP-NNP,1,1
6521,4653.0,35,was,12,1,25,24,0,9,11,13,Terry Brain,South Melbourne,per-per,-,PROPN-PROPN,PROPN-PROPN,compound-nsubj,compound-pobj,NNP-NNP,NNP-NNP,7,1
6522,4655.0,25,marked,1,1,18,17,0,6,0,17,Namibia,Hifikepunye Pohamba,per,-,PROPN,PROPN-PROPN,nsubj,compound-pobj,NNP,NNP-NNP,4,1
6523,4656.0,25,organized,4,3,23,20,2,1,1,19,Japanese,P. Laurel,per,-,ADJ,PROPN-PROPN,amod,compound-pobj,JJ,NNP-NNP,9,1
6524,7385.0,58,Note,0,35,45,10,34,12,-35,45,Japanese,P. Laurel,per,-,PROPN,PROPN-PROPN,pobj,compound-pobj,NNPS,NNP-NNP,5,1
6525,4657.0,26,became,1,1,5,4,0,20,0,4,He,Latvia,per,,PRON,PROPN,nsubj,pobj,PRP,NNP,1,1
6526,4658.0,42,directed,19,30,34,4,29,7,-11,15,Canadian Broadcasting Corporation,CBC Television,per-per-per,-,PROPN-PROPN-PROPN,PROPN-PROPN,compound-compound-pobj,compound-pobj,NNP-NNP-NNP,NNP-NNP,2,1
6527,4659.0,44,designated,29,23,27,4,22,16,6,-2,Interior,James G. Watt,,org-org-org,PROPN,PROPN-PROPN-PROPN,pobj,compound-compound-appos,NNP,NNP-NNP-NNP,4,1
6528,7182.0,88,have,77,4,5,1,3,82,73,-72,Interior,James G. Watt,org,--,PROPN,PROPN-PROPN-PROPN,pobj,compound-compound-nsubj,NNP,NNP-NNP-NNP,2,1
6529,12518.0,25,voted,6,10,12,2,9,12,-4,6,Interior,James G. Watt,,per-per-per,PROPN,PROPN-PROPN-PROPN,compound,compound-compound-dobj,NNP,NNP-NNP-NNP,2,1
6530,13812.0,22,served,1,13,15,2,12,6,-12,14,Interior,James G. Watt,,per-per-per,PROPN,PROPN-PROPN-PROPN,pobj,compound-compound-pobj,NNP,NNP-NNP-NNP,2,1
6531,13899.0,49,is,5,15,46,31,14,2,-10,41,Interior,James G. Watt,org,--,PROPN,PROPN-PROPN-PROPN,pobj,compound-compound-pobj,NNP,NNP-NNP-NNP,10,1
6532,4660.0,17,is,4,1,8,7,0,8,3,4,Emera,Nova Scotia,org,-,NOUN,PROPN-PROPN,compound,compound-nmod,NN,NNP-NNP,3,1
6533,4661.0,27,is,4,6,16,10,5,10,-2,12,Rod Stewart,Riva,-,org,PROPN-PROPN,PROPN,compound-poss,compound,NNP-NNP,NNP,4,1
6534,4662.0,30,is,13,1,12,11,0,17,12,-1,Brian Keith,USA,per-per,,PROPN-PROPN,PROPN,compound-compound,pobj,NNP-NNP,NNP,2,1
6535,4663.0,27,appointed,3,5,12,7,4,14,-2,9,Perkins,Labor,org,,PROPN,PROPN,dobj,pobj,NNP,NNP,3,1
6536,4664.0,37,is,16,1,16,15,0,20,15,0,Andre DeSean Wicker,Dresta,per-per-per,,PROPN-PROPN-PROPN,PROPN,compound-compound-nsubj,nsubj,NNP-NNP-NNP,NNP,2,1
6537,4665.0,36,provided,24,19,22,3,18,13,5,-2,Cartoon Network,October 1 1992,-,org-org-org,PROPN-PROPN,PROPN-NUM-NUM,compound-pobj,pobj-nummod-nummod,NNP-NNP,NNP-CD-CD,5,1
6538,10038.0,10,initiated,1,3,7,4,2,2,-2,6,Cartoon Network,October 1 1992,per-per,--,PROPN-PROPN,PROPN-NUM-NUM,compound-dobj,npadvmod-nummod-nummod,NNP-NNP,NNP-CD-CD,3,1
6539,4668.0,41,Operated,0,4,4,0,3,36,-4,4,San Francisco Municipal Railway,San Francisco Municipal Transportation Agency,per-per-per-per,----,PROPN-PROPN-PROPN-PROPN,PROPN-PROPN-PROPN-PROPN-PROPN,compound-compound-compound-pobj,compound-compound-compound-compound-pobj,NNP-NNP-NNP-NNP,NNP-NNP-NNP-NNP-NNP,0,1
6540,8697.0,33,is,2,8,8,0,7,24,-6,6,San Francisco Municipal Railway,San Francisco Municipal Transportation Agency,per-per-per-per,----,PROPN-PROPN-PROPN-PROPN,PROPN-PROPN-PROPN-PROPN-PROPN,compound-compound-compound-pobj,compound-compound-compound-compound-pobj,NNP-NNP-NNP-NNP,NNP-NNP-NNP-NNP-NNP,0,1
6541,4669.0,19,fell,3,3,18,15,2,0,0,15,HSBC,London,org,,PROPN,PROPN,pobj,pobj,NNP,NNP,1,1
6542,6144.0,24,is,9,1,21,20,0,2,8,12,HSBC,London,org,,PROPN,PROPN,compound,compound,NNP,NNP,7,1
6543,4670.0,26,says,14,11,13,2,10,12,3,-1,Democratic Kampuchea,Khieu Samphan,-,per-per,ADJ-PROPN,PROPN-PROPN,compound-compound,compound-pobj,JJ-NNP,NNP-NNP,1,1
6544,8970.0,40,offers,13,12,20,8,11,19,1,7,Democratic Kampuchea,Khieu Samphan,-,per-per,ADJ-PROPN,PROPN-PROPN,compound-pobj,compound-nsubj,JJ-NNP,NNP-NNP,10,1
6545,10219.0,32,appeared,15,14,22,8,13,9,1,7,Democratic Kampuchea,Khieu Samphan,per-per,-,PROPN-PROPN,PROPN-PROPN,compound-pobj,compound-nsubjpass,NNP-NNP,NNP-NNP,7,1
6546,13189.0,30,offers,14,10,20,10,9,9,4,6,Democratic Kampuchea,Khieu Samphan,-,per-per,ADJ-PROPN,PROPN-PROPN,compound-pobj,compound-nsubj,JJ-NNP,NNP-NNP,10,1
6547,4671.0,28,received,12,2,4,2,1,23,10,-8,actor,Ben Kingsley,org,-,NOUN,PROPN-PROPN,compound,compound-nsubj,NN,NNP-NNP,1,1
6548,4672.0,47,said,8,13,31,18,12,15,-5,23,John Negroponte,State,per-per,,PROPN-PROPN,PROPN,compound-conj,compound,NNP-NNP,NNP,8,1
6549,4674.0,18,met,1,7,14,7,6,3,-6,13,Joan Jett,The Runaways,org-org,-,PROPN-PROPN,DET-PROPN,compound-pobj,det-pobj,NNP-NNP,DT-NNPS,6,1
6550,4675.0,22,realized,4,4,16,12,3,5,0,12,Quirino,National Defence,per,-,PROPN,PROPN-PROPN,nsubj,compound-pobj,NNP,NNP-NNP,5,1
6551,4677.0,19,convoyed,3,14,17,3,13,1,-11,14,Mediterranean fleet,Horatio Nelson,-,org-org,PROPN-NOUN,PROPN-PROPN,amod-dobj,compound-pobj,NNP-NN,NNP-NNP,3,1
6552,4678.0,27,is,11,1,6,5,0,20,10,-5,Tallinn,Lennart Meri,,per-per,PROPN,PROPN-PROPN,compound,compound-compound,NNP,NNP-NNP,2,1
6553,4679.0,28,acquired,10,3,10,7,2,17,7,0,Couche-Tard,Quebec,,per,PROPN,PROPN,pobj,pobj,NNP,NNP,4,1
6554,5067.0,29,held,2,1,11,10,0,17,1,9,Couche-Tard,Quebec,per,,PROPN,PROPN,nsubj,pobj,NNP,NNP,5,1
6555,4681.0,17,migrated,4,3,10,7,2,6,1,6,El Greco,Toledo,-,per,PROPN-PROPN,PROPN,compound-nsubj,pobj,NNP-NNP,NNP,5,1
6556,4682.0,39,was,2,1,11,10,0,27,1,9,DC Comics,Time Warner,-,per-per,PROPN-PROPN,PROPN-PROPN,compound-pobj,compound-compound,NNP-NNP,NNP-NNP,6,1
6557,4683.0,37,cancelled,30,5,15,10,4,21,25,-15,Western,Bellingham,,per,PROPN,PROPN,nsubj,compound,NNP,NNP,4,1
6558,4684.0,18,was,11,1,14,13,0,3,10,3,Benjamin Davis Wilson,California,per-per-per,,PROPN-PROPN-PROPN,PROPN,compound-compound-nsubj,compound,NNP-NNP-NNP,NNP,3,1
6559,4685.0,21,is,1,1,15,14,0,5,0,14,HSAS,Kenny Aaronson,org,-,NOUN,PROPN-PROPN,nsubj,compound-dobj,NN,NNP-NNP,3,1
6560,4686.0,13,is,1,1,7,6,0,5,0,6,It,Botswana,,per,PRON,PROPN,nsubj,pobj,PRP,NNP,5,1
6561,4687.0,23,appointed,2,9,21,12,8,1,-7,19,Nova Scotia,Pierre Trudeau,org-org,-,PROPN-PROPN,PROPN-PROPN,compound-compound,compound-pobj,NNP-NNP,NNP-NNP,7,1
6562,6628.0,24,appointed,2,10,22,12,9,1,-8,20,Nova Scotia,Pierre Trudeau,-,org-org,PROPN-PROPN,PROPN-PROPN,compound-compound,compound-pobj,NNP-NNP,NNP-NNP,9,1
6563,4688.0,33,was,1,25,30,5,24,2,-24,29,Harvey,Fremantle Football Club,per,--,PROPN,PROPN-PROPN-PROPN,nsubjpass,compound-compound-pobj,NNP,NNP-NNP-NNP,4,1
6564,4690.0,26,named,17,12,15,3,11,10,5,-2,Australian,Geoff Lawson,per,-,ADJ,PROPN-PROPN,amod,compound-nsubjpass,JJ,NNP-NNP,2,1
6565,4692.0,23,featured,7,9,14,5,8,8,-2,7,Margaret Thatcher,State for Education and Science,org-org,----,PROPN-PROPN,PROPN-ADP-PROPN-CCONJ-PROPN,compound-dobj,pobj-prep-pobj-cc-conj,NNP-NNP,NNP-IN-NNP-CC-NNP,2,1
6566,4695.0,17,heading,8,1,7,6,0,9,7,-1,Ahmad Shah Durrani,Afghanistan,--,org,PROPN-PROPN-PROPN,PROPN,compound-compound-nsubj,pobj,NNP-NNP-NNP,NNP,3,1
6567,11306.0,45,approached,9,1,8,7,0,36,8,-1,Ahmad Shah Durrani,Afghanistan,per-per-per,,PROPN-PROPN-PROPN,PROPN,compound-compound-nsubj,pobj,NNP-NNP-NNP,NNP,2,1
6568,4696.0,32,used,7,3,17,14,2,14,4,10,Balearic Islands,University of the Balearic Islands,org-org,----,PROPN-PROPN,PROPN-ADP-DET-PROPN-PROPN,compound-compound,pobj-prep-det-compound-poss,NNP-NNPS,NNP-IN-DT-NNP-NNPS,7,1
6569,4697.0,29,represented,6,3,9,6,2,19,3,3,Connecticut Huskies,University of Connecticut,-,per-per-per,PROPN-PROPN,PROPN-ADP-PROPN,compound-compound,dobj-prep-pobj,NNP-NNP,NNP-IN-NNP,4,1
6570,6901.0,13,represents,7,2,10,8,1,2,5,3,Connecticut Huskies,University of Connecticut,org-org,--,PROPN-PROPN,PROPN-ADP-PROPN,nmod-nmod,dobj-prep-pobj,NNP-NNPS,NNP-IN-NNP,3,1
6571,12887.0,26,represents,6,3,9,6,2,16,3,3,Connecticut Huskies,University of Connecticut,per-per,--,PROPN-PROPN,PROPN-ADP-PROPN,compound-compound,dobj-prep-pobj,NNP-NNP,NNP-IN-NNP,4,1
6572,4698.0,50,According,0,12,19,7,11,30,-12,19,Samuel P. Harn Museum of Art,Gainesville Florida,-----,per-per,PROPN-PROPN-PROPN-PROPN-ADP-PROPN,PROPN-PROPN,compound-compound-compound-pobj-prep-pobj,pobj-ROOT,NNP-NNP-NNP-NNP-IN-NNP,NNP-NNP,4,1
6573,4699.0,21,In,0,6,17,11,5,3,-6,17,Romania,Nicolae Ceau?esc,per,-,PROPN,PROPN-NOUN,dobj,compound-pobj,NNP,NNP-NN,6,1
6574,4700.0,31,said,3,1,8,7,0,22,2,5,HSBC,Michael Geoghegan,,per-per,PROPN,PROPN-PROPN,nsubj,compound-nsubj,NNP,NNP-NNP,5,1
6575,4701.0,75,is,2,2,9,7,1,65,0,7,Falls,University of Sioux Falls,per,---,PROPN,PROPN-ADP-PROPN-PROPN,nsubj,appos-prep-pobj-compound,NNP,NNP-IN-NNP-NNP,5,1
6576,4702.0,51,featured,8,19,22,3,18,28,-11,14,Tennessee,Uncle Dave Macon,per,--,PROPN,PROPN-PROPN-PROPN,pobj,compound-compound-compound,NNP,NNP-NNP-NNP,4,1
6577,4703.0,52,was,3,1,17,16,0,34,2,14,MK Airlines,2006,-,per,PROPN-PROPN,NUM,compound-compound,pobj,NNP-NNPS,CD,5,1
6578,4704.0,23,joined,2,19,21,2,18,1,-17,19,Miles Davis,Betty Davis,org-org,-,PROPN-PROPN,PROPN-PROPN,compound-compound,compound-pobj,NNP-NNP,NNP-NNP,3,1
6579,4705.0,26,was,1,15,21,6,14,4,-14,20,Jean-Marie Bockel,Modern Left,-,per-per,PROPN-PROPN,PROPN-PROPN,compound-pobj,compound-dobj,NNP-NNP,NNP-NNP,8,1
6580,4706.0,22,produces,3,11,18,7,10,3,-8,15,Singapore,MediaCorp TV Channel 5,org,---,PROPN,PROPN-PROPN-PROPN-NUM,poss,compound-compound-pobj-nummod,NNP,NNP-NNP-NNP-CD,2,1
6581,4707.0,30,depicts,2,6,6,0,5,23,-4,4,New Zealand,New Zealand Defence Force,-,per-per-per-per,PROPN-PROPN,PROPN-PROPN-PROPN-PROPN,nmod-nmod,compound-compound-compound-pobj,NNP-NNP,NNP-NNP-NNP-NNP,0,1
6582,4709.0,25,has,2,2,20,18,1,4,0,18,Dundee,Scotland,,org,PROPN,PROPN,nsubj,pobj,NNP,NNP,3,1
6583,4710.0,21,controlled,7,2,14,12,1,6,5,7,foundation,Bill Gates,org,-,NOUN,PROPN-PROPN,nsubjpass,compound-compound,NN,NNP-NNP,3,1
6584,4711.0,26,became,1,1,10,9,0,15,0,9,He,Slovak Republic,per,-,PRON,PROPN-PROPN,nsubj,compound-pobj,PRP,NNP-NNP,5,1
6585,4712.0,24,established,3,2,12,10,1,11,1,9,University,1853,org,,PROPN,NUM,nsubjpass,nummod,NNP,CD,2,1
6586,4713.0,30,been,2,7,24,17,6,5,-5,22,Japan,Toshiki Kaifu,per,-,PROPN,PROPN-PROPN,poss,compound-pobj,NNP,NNP-NNP,12,1
6587,10607.0,41,hosted,2,24,29,5,23,11,-22,27,Japan,Toshiki Kaifu,,per-per,PROPN,PROPN-PROPN,poss,compound-appos,NNP,NNP-NNP,2,1
6588,4714.0,41,Sitting,0,23,29,6,22,11,-23,29,Jamaica,Brown,,per,PROPN,PROPN,compound,poss,NNP,NNP,8,1
6589,4715.0,41,evolved,3,9,12,3,8,28,-6,9,Canadian Radio,Television,-,org,PROPN-PROPN,PROPN,nmod-nmod,conj,NNP-NNP,NNP,1,1
6590,4716.0,39,considered,5,8,21,13,7,17,-3,16,Idaho Air National Guard,United States,---,org-org,PROPN-PROPN-PROPN-PROPN,PROPN-PROPN,compound-compound-compound-poss,compound-compound,NNP-NNP-NNP-NNP,NNP-NNP,8,1
6591,4717.0,26,added,24,1,17,16,0,8,23,-7,Fernando,Democratic Party,,per-per,PROPN,PROPN-PROPN,compound,compound-pobj,NNP,NNP-NNP,5,1
6592,4718.0,55,follows,1,1,20,19,0,34,0,19,HDIL,Housing Development,,per-per,PROPN,PROPN-PROPN,nsubj,compound-nsubj,NNP,NNP-NNP,-1,1
6593,4719.0,26,is,9,1,8,7,0,17,8,-1,Velvet,2005,per,,PROPN,NUM,compound,appos,NNP,CD,3,1
6594,10218.0,13,discovered,2,1,5,4,0,7,1,3,Velvet,2005,per,,PROPN,NUM,nsubjpass,pobj,NNP,CD,2,1
6595,4720.0,22,represented,8,3,3,0,2,18,5,-5,San Diego State Aztecs,San Diego State University,---,per-per-per-per,PROPN-PROPN-PROPN-PROPN,PROPN-PROPN-PROPN-PROPN,compound-compound-compound-compound,compound-compound-compound-dobj,NNP-NNP-NNP-NNP,NNP-NNP-NNP-NNP,0,1
6596,4770.0,27,is,7,2,2,0,1,24,5,-5,San Diego State Aztecs,San Diego State University,---,per-per-per-per,PROPN-PROPN-PROPN-PROPN,PROPN-PROPN-PROPN-PROPN,compound-compound-compound-compound,compound-compound-compound-dobj,NNP-NNP-NNP-NNP,NNP-NNP-NNP-NNP,0,1
6597,4721.0,24,shot,16,7,11,4,6,12,9,-5,Jamaica,Bob Marley,per,-,PROPN,PROPN-PROPN,pobj,compound-pobj,NNP,NNP-NNP,3,1
6598,4722.0,35,said,33,7,11,4,6,23,26,-22,John Sununu,he,per-per,,PROPN-PROPN,PRON,compound-pobj,nsubj,NNP-NNP,PRP,5,1
6599,4723.0,31,told,13,12,21,9,11,9,1,8,Anand Panyarachun,Thailand,-,org,PROPN-PROPN,PROPN,compound-nsubj,pobj,NNP-NNP,NNP,4,1
6600,5029.0,91,is,1,84,90,6,83,0,-83,89,Anand Panyarachun,Thailand,-,per,PROPN-PROPN,PROPN,compound-oprd,pobj,NNP-NNP,NNP,13,1
6601,5366.0,32,told,14,13,22,9,12,9,1,8,Anand Panyarachun,Thailand,-,per,PROPN-PROPN,PROPN,compound-nsubj,pobj,NNP-NNP,NNP,4,1
6602,4724.0,45,is,6,23,33,10,22,11,-17,27,Evangelical Lutheran Church of Finland,orthodox,----,org,PROPN-PROPN-PROPN-ADP-PROPN,ADJ,compound-compound-pobj-prep-pobj,amod,NNP-NNP-NNP-IN-NNP,JJ,6,1
6603,4725.0,32,said,5,4,24,20,3,7,1,19,General Motors,division Opel/Vauxhall,org-org,-,PROPN-PROPN,NOUN-PROPN,compound-appos,dobj-npadvmod,NNP-NNPS,NN-NNP,6,1
6604,4726.0,9,makes,4,1,4,3,0,4,3,0,Amgen,California,,per,PROPN,PROPN,nsubj,pobj,NNP,NNP,2,1
6605,4727.0,32,induct,4,14,25,11,13,6,-10,21,Philadelphia International,The O'Jays,-,per-per,PROPN-PROPN,DET-PROPN,compound-compound,det-compound,NNP-NNP,DT-NNP,7,1
6606,4728.0,26,coasted,3,2,11,9,1,14,1,8,Rob Portman,Ohio,org-org,,PROPN-PROPN,PROPN,compound-nsubj,compound,NNP-NNP,NNP,7,1
6607,8354.0,26,elected,10,1,16,15,0,9,9,6,Rob Portman,Ohio,org-org,,PROPN-PROPN,PROPN,amod-nsubjpass,pobj,NNP-NNP,NNP,4,1
6608,4729.0,46,appeared,3,38,41,3,37,4,-35,38,Fear Factory,Dino Cazares,-,org-org,PROPN-PROPN,PROPN-PROPN,compound-compound,compound-pobj,NNP-NNP,NNP-NNPS,2,1
6609,4730.0,34,said,10,1,3,2,0,30,9,-7,Azerbaijan,Ilham Aliyev,,per-per,PROPN,PROPN-PROPN,poss,compound-nsubj,NNP,NNP-NNP,2,1
6610,4731.0,41,make,4,12,18,6,11,22,-8,14,Deep Springs College,California,org-org-org,,PROPN-PROPN-PROPN,PROPN,compound-compound-nsubj,pobj,NNP-NNPS-NNP,NNP,3,1
6611,4732.0,32,produced,1,1,9,8,0,22,0,8,He,Benassi Bros.,,per-per,PRON,PROPN-PROPN,nsubj,compound-oprd,PRP,NNP-NNP,3,1
6612,4733.0,23,written,8,17,21,4,16,1,-9,13,Oregon State University,OR,--,org,PROPN-PROPN-PROPN,CCONJ,compound-compound-compound,cc,NNP-NNP-NNP,CC,3,1
6613,4734.0,18,University,2,1,10,9,0,7,1,8,Belarusian State University,Minsk,--,org,PROPN-PROPN-PROPN,PROPN,compound-compound-ROOT,compound,NNP-NNP-NNP,NNP,-1,1
6614,4735.0,21,licensed,4,3,7,4,2,13,1,3,Infogrames,Atari Interactive,,org-org,PROPN,PROPN-PROPN,compound,compound-pobj,NNPS,NNP-NNP,2,1
6615,8528.0,42,named,12,21,11,-10,20,30,-9,-1,Infogrames,Atari Interactive,org,-,PROPN,PROPN-PROPN,compound,compound-compound,NNP,NNP-NNP,7,1
6616,4736.0,41,is,10,19,35,16,18,5,-9,25,Bolivia,his,,per,PROPN,DET,compound,poss,NNP,PRP$,4,1
6617,4737.0,43,said,17,8,17,9,7,25,9,0,Zambia,Kaunda,org,,PROPN,PROPN,conj,nsubj,NNP,NNP,5,1
6618,4738.0,83,include,6,48,54,6,47,28,-42,48,MBDA,BAE Systems,org,-,PROPN,PROPN-PROPN,appos,compound-pobj,NNP,NNP-NNP,3,1
6619,9819.0,20,owned,3,1,6,5,0,13,2,3,MBDA,BAE Systems,per,-,PROPN,PROPN-PROPN,nsubjpass,compound-nmod,NNP,NNP-NNPS,3,1
6620,4739.0,28,play,4,10,26,16,9,1,-6,22,St. Louis Rams,NFL Network,per-per-per,-,PROPN-PROPN-PROPN,PROPN-PROPN,compound-compound-pobj,compound-pobj,NNP-NNP-NNPS,NNP-NNP,8,1
6621,4740.0,21,won,12,3,9,6,2,11,9,-3,Kuomintang,Ma,org,,PROPN,PROPN,nmod,pobj,NNP,NNP,5,1
6622,4741.0,23,is,1,13,21,8,12,1,-12,20,Sun Caged,Lion Music,-,per-per,PROPN-PROPN,PROPN-PROPN,compound-pobj,compound-pobj,NNP-NNP,NNP-NNP,6,1
6623,4742.0,17,has,1,1,15,14,0,1,0,14,Ontario,Grade,,per,PROPN,PROPN,nsubj,pobj,NNP,NNP,2,1
6624,4743.0,49,provided,7,4,26,22,3,22,3,19,Wizards,KC,,org,PROPN,PROPN,compound,compound,NNPS,NNP,6,1
6625,4744.0,76,introduced,7,63,66,3,62,9,-56,59,Arlen Specter,Pennsylvania,org-org,,PROPN-PROPN,PROPN,compound-pobj,compound,NNP-NNP,NNP,3,1
6626,4746.0,25,released,2,21,23,2,20,1,-19,21,his,Autumn Records,org,-,DET,PROPN-PROPN,poss,compound-pobj,PRP$,NNP-NNPS,1,1
6627,4747.0,24,is,7,1,18,17,0,5,6,11,Tzu Chi University,Taiwan,org-org-org,,PROPN-PROPN-PROPN,PROPN,compound-compound-nsubj,pobj,NNP-NNP-NNP,NNP,7,1
6628,4748.0,24,is,3,12,21,9,11,2,-9,18,Pakistan,Radio Pakistan,,org-org,PROPN,PROPN-PROPN,pobj,compound-appos,NNP,NNP-NNP,6,1
6629,4749.0,42,stepped,13,31,38,7,30,3,-18,25,North Melbourne Football Club,James Brayshaw,---,per-per,PROPN-PROPN-PROPN-PROPN,PROPN-PROPN,compound-compound-compound-compound,compound-appos,NNP-NNP-NNP-NNP,NNP-NNP,6,1
6630,4750.0,11,born,2,1,10,9,0,0,1,8,Newhart,USA,,per,PROPN,PROPN,nsubjpass,pobj,NNP,NNP,2,1
6631,4751.0,14,says,2,4,6,2,3,7,-2,4,Akbank,Citigroup,per,,PROPN,PROPN,nsubj,conj,NNP,NNP,3,1
6632,4752.0,41,is,7,3,5,2,2,35,4,-2,1933,Hang Seng Bank,org,--,NUM,PROPN-PROPN-PROPN,pobj,compound-compound-nsubj,CD,NNP-NNP-NNP,2,1
6633,4753.0,48,referred,8,1,1,0,0,46,7,-7,Antony,Antony and the Johnsons,org,---,PROPN,PROPN-CCONJ-DET-PROPN,compound,pobj-cc-det-conj,NNP,NNP-CC-DT-NNPS,0,1
6634,11368.0,24,co-produced,9,12,12,0,11,11,-3,3,Antony,Antony and the Johnsons,per,---,PROPN,PROPN-CCONJ-DET-PROPN,compound,pobj-cc-det-conj,NNP,NNP-CC-DT-NNPS,0,1
6635,13285.0,25,adds,18,9,9,0,8,15,9,-9,Antony,Antony and the Johnsons,per,---,PROPN,PROPN-CCONJ-DET-PROPN,nsubj,pobj-cc-det-conj,NNP,NNP-CC-DT-NNPS,0,1
6636,4756.0,35,is,9,1,2,1,0,32,8,-7,Ubisoft,Red Storm Entertainment,per,--,PROPN,PROPN-PROPN-PROPN,compound,compound-compound-appos,NNP,NNP-NNP-NNP,1,1
6637,4758.0,95,ceremony,1,45,48,3,44,46,-44,47,Antonio Saca,El Salvador,-,per-per,PROPN-PROPN,PROPN-PROPN,compound-conj,compound-pobj,NNP-NNP,NNP-NNP,2,1
6638,5630.0,55,included,1,28,31,3,27,23,-27,30,Antonio Saca,El Salvador,-,per-per,PROPN-PROPN,PROPN-PROPN,compound-pobj,compound-compound,NNP-NNP,NNP-NNP,5,1
6639,7032.0,45,attended,9,19,22,3,18,22,-10,13,Antonio Saca,El Salvador,org-org,-,PROPN-PROPN,PROPN-PROPN,compound-appos,compound-pobj,NNP-NNP,NNP-NNP,2,1
6640,9230.0,25,came,19,15,18,3,14,6,4,-1,Antonio Saca,El Salvador,-,per-per,PROPN-PROPN,PROPN-PROPN,compound-conj,compound-pobj,NNP-NNP,NNP-NNP,2,1
6641,12305.0,27,told,5,4,12,8,3,14,1,7,Antonio Saca,El Salvador,-,org-org,PROPN-PROPN,PROPN-PROPN,compound-nsubj,compound-nsubj,NNP-NNP,NNP-NNP,3,1
6642,13482.0,35,described,4,3,16,13,2,18,1,12,Antonio Saca,El Salvador,per-per,-,PROPN-PROPN,PROPN-PROPN,compound-nsubj,compound-poss,NNP-NNP,NNP-NNP,5,1
6643,4760.0,42,began,1,13,15,2,12,26,-12,14,University of Szeged,Szeged,per-per-per,,PROPN-ADP-PROPN,PROPN,appos-prep-pobj,pobj,NNP-IN-NNP,NNP,7,1
6644,4761.0,58,punk,42,14,26,12,13,31,28,-16,New Orleans,Soilent Green,org-org,-,PROPN-PROPN,PROPN-PROPN,compound-appos,compound-compound,NNP-NNP,NNP-NNP,6,1
6645,4762.0,25,meet,6,1,23,22,0,1,5,17,1854,Republican Party,org,-,PUNCT,PROPN-PROPN,meta,compound-attr,LS,NNP-NNP,8,1
6646,4765.0,36,Jordan,2,1,3,2,0,32,1,1,Air Arabia,Jordan,-,per,PROPN-PROPN,PROPN,compound-compound,ROOT,NNP-NNP,NNP,3,1
6647,4766.0,21,include,2,6,11,5,5,9,-4,9,University,TX,,org,PROPN,PROPN,nsubjpass,pobj,NNP,NNP,2,1
6648,4768.0,41,represent,3,6,21,15,5,19,-3,18,University of Richmond,Atlantic 10 Conference,--,per-per-per,PROPN-ADP-PROPN,PROPN-NUM-PROPN,nmod-prep-pobj,nmod-nummod-pobj,NNP-IN-NNP,NNP-CD-NNP,7,1
6649,4771.0,44,demonstrated,17,7,11,4,6,32,10,-6,John Cocke,IBM,org-org,,PROPN-PROPN,PROPN,compound-appos,pobj,NNP-NNP,NNP,2,1
6650,4772.0,21,is,10,1,19,18,0,1,9,9,Nigel Griggs,Split Enz,per-per,-,PROPN-PROPN,PROPN-PROPN,compound-nsubj,compound-pobj,NNP-NNP,NNP-NNP,5,1
6651,4773.0,52,regarded,1,5,27,22,4,24,-4,26,actor,Ryan Gosling,per,-,NOUN,PROPN-PROPN,compound,compound-conj,NN,NNP-NNP,3,1
6652,4774.0,14,recommends,7,1,5,4,0,8,6,-2,Los Angeles,Michael D. Antonovich,per-per,--,PROPN-PROPN,PROPN-PROPN-PROPN,compound-compound,compound-compound-nsubj,NNP-NNP,NNP-NNP-NNP,4,1
6653,4775.0,33,spent,1,7,13,6,6,19,-6,12,France,Roger Vadim,org,-,PROPN,PROPN-PROPN,pobj,compound-pobj,NNP,NNP-NNP,3,1
6654,4776.0,18,emigrated,3,1,6,5,0,11,2,3,Kalnoky,Czechoslovakia,,org,PROPN,PROPN,poss,pobj,NNP,NNP,4,1
6655,4778.0,46,received,1,6,9,3,5,36,-5,8,Furman University,Greenville,per-per,,PROPN-PROPN,PROPN,compound-pobj,pobj,NNP-NNP,NNP,3,1
6656,4779.0,19,were,6,2,4,2,1,14,4,-2,University,Pittsburgh,,org,PROPN,PROPN,nmod,pobj,NNP,NNP,3,1
6657,5930.0,41,established,7,26,28,2,25,12,-19,21,University,Pittsburgh,,per,PROPN,PROPN,pobj,pobj,NNP,NNP,5,1
6658,4780.0,24,is,2,1,10,9,0,13,1,8,The Tidings,Roman Catholic Archdiocese of Los Angeles,-,org-org-org-org-org-org,DET-PROPN,ADJ-PROPN-PROPN-ADP-PROPN-PROPN,det-nsubj,compound-compound-pobj-prep-compound-pobj,DT-NNPS,JJ-NNP-NNP-IN-NNP-NNP,6,1
6659,4781.0,33,worked,2,5,8,3,4,24,-3,6,Studio One,Coxsone Dodd,-,org-org,PROPN-NUM,PROPN-PROPN,pobj-nummod,compound-pobj,NNP-CD,NNP-NNP,4,1
6660,4782.0,39,was,1,15,22,7,14,16,-14,21,Ted Turner,Jane Fonda,org-org,-,PROPN-PROPN,PROPN-PROPN,compound-nsubj,compound-pobj,NNP-NNP,NNP-NNP,4,1
6661,4783.0,43,signed,3,8,14,6,7,28,-5,11,Way Out West,England,--,per,NOUN-PROPN-PROPN,PROPN,compound-compound-compound,pobj,NN-NNP-NNP,NNP,5,1
6662,9284.0,27,are,3,1,16,15,0,10,2,13,Way Out West,England,per-per-per,,PROPN-ADV-PROPN,PROPN,nmod-prep-nsubj,pobj,NNP-RB-NNP,NNP,5,1
6663,4784.0,23,are,8,16,22,6,15,0,-8,14,University of Lethbridge,Canada,--,org,PROPN-ADP-PROPN,PROPN,dobj-prep-pobj,pobj,NNP-IN-NNP,NNP,5,1
6664,4785.0,16,ran,9,2,9,7,1,6,7,0,Max Cleland,Georgia,org-org,,PROPN-PROPN,PROPN,compound-nsubj,pobj,NNP-NNP,NNP,1,1
6665,4786.0,21,hosts,10,2,17,15,1,3,8,7,University of the Pacific,Stockton,per-per-per-per,,PROPN-ADP-DET-PROPN,PROPN,nsubj-prep-det-compound,compound,NNP-IN-DT-NNP,NNP,5,1
6666,4787.0,26,blamed,5,1,3,2,0,22,4,-2,Prime Minister,Louis St. Laurent,-,org-org-org,PROPN-PROPN,PROPN-PROPN-PROPN,compound-compound,compound-compound-nsubj,NNP-NNP,NNP-NNP-NNP,2,1
6667,4788.0,18,purchased,13,3,6,3,2,11,10,-7,Redding,Atlantic Records,org,-,VERB,PROPN-PROPN,poss,compound-compound,VBG,NNP-NNPS,4,1
6668,4789.0,20,returned,1,1,4,3,0,15,0,3,He,Canada,,per,PRON,PROPN,nsubj,nsubj,PRP,NNP,1,1
6669,5414.0,10,seemed,1,1,9,8,0,0,0,8,He,Canada,per,,PRON,PROPN,nsubj,pobj,PRP,NNP,1,1
6670,6888.0,18,belonged,1,1,7,6,0,10,0,6,He,Canada,per,,PRON,PROPN,nsubj,nsubj,PRP,NNP,4,1
6671,7443.0,21,was,1,1,18,17,0,2,0,17,He,Canada,per,,PRON,PROPN,nsubj,pobj,PRP,NNP,1,1
6672,8618.0,8,born,2,1,7,6,0,0,1,5,He,Canada,,org,PRON,PROPN,nsubjpass,pobj,PRP,NNP,2,1
6673,4790.0,32,include,18,6,11,5,5,20,12,-7,Albania,Hoxha,,org,PROPN,PROPN,pobj,nsubjpass,NNP,NNP,3,1
6674,4791.0,33,established,12,29,31,2,28,1,-17,19,Belfast,QUB,,per,PROPN,PROPN,nmod,pobj,NNP,NNP,3,1
6675,4792.0,25,was,16,1,11,10,0,13,15,-5,Gable,Carole Lombard,,per-per,PROPN,PROPN-PROPN,poss,compound-nsubj,NNP,NNP-NNP,4,1
6676,4793.0,20,reaped,14,2,12,10,1,7,12,-2,his,Kentucky,org,,DET,PROPN,poss,nsubj,PRP$,NNP,3,1
6677,4794.0,23,nominated,15,10,12,2,9,10,5,-3,University of Montpellier,Montpellier,org-org-org,,PROPN-ADP-PROPN,PROPN,pobj-prep-compound,pobj,NNP-IN-NNP,NNP,1,1
6678,4795.0,26,directed,2,12,17,5,11,8,-10,15,Tina Fey,Jeff Richmond,org-org,-,PROPN-PROPN,PROPN-PROPN,compound-conj,compound-ROOT,NNP-NNP,NNP-NNP,-1,1
6679,10937.0,27,be,3,1,20,19,0,6,2,17,Tina Fey,Jeff Richmond,per-per,-,PROPN-PROPN,PROPN-PROPN,compound-nsubj,compound-conj,NNP-NNP,NNP-NNP,4,1
6680,4796.0,27,were,18,5,15,10,4,11,13,-3,Jonathan Williams,Richmond,-,org,PROPN-PROPN,PROPN,compound-nsubj,compound,NNP-NNP,NNP,3,1
6681,4798.0,20,directed,4,1,17,16,0,2,3,13,Jorge Montt,Chilean,-,org,PROPN-PROPN,PROPN,compound-nsubj,compound,NNP-NNP,NNP,6,1
6682,4799.0,25,was,1,19,23,4,18,1,-18,22,Delft University of Technology,The Netherlands,per-per-per-per,-,PROPN-PROPN-ADP-PROPN,DET-PROPN,compound-pobj-prep-pobj,det-ROOT,NNP-NNP-IN-NNP,DT-NNP,2,1
6683,4800.0,26,was,7,1,11,10,0,14,6,4,His,Chile,per,,DET,PROPN,poss,pobj,PRP$,NNP,2,1
6684,4801.0,12,spend,2,1,11,10,0,0,1,9,Streisand,Columbia,,per,PROPN,PROPN,nsubj,pobj,NNP,NNP,2,1
6685,4802.0,19,merged,3,3,3,0,2,15,0,0,Imperial,Imperial College of Science Technology Medicine,,per-per-per-per-per-per,PROPN,PROPN-PROPN-ADP-PROPN-PROPN-PROPN,nsubj,compound-attr-prep-compound-compound-pobj,NNP,NNP-NNP-IN-NNP-NNP-NNP,0,1
6686,4803.0,34,joined,2,4,4,0,3,29,-2,2,Jamia Millia Islamia,Jamia,--,per,PROPN-PROPN-PROPN,PROPN,compound-compound-compound,dobj,NNP-NNP-NNP,NNP,0,1
6687,4804.0,24,applied,15,10,14,4,9,9,5,-1,Merritt College,California,per-per,,PROPN-PROPN,PROPN,compound-pobj,pobj,NNP-NNP,NNP,5,1
6688,4806.0,34,strengthened,5,23,32,9,22,1,-18,27,Frances Perkins,Labor,org-org,,PROPN-PROPN,PROPN,compound-pobj,compound,NNP-NNP,NNP,4,1
6689,4807.0,21,ordered,5,1,4,3,0,16,4,-1,Philippine Airlines,PAL,org-org,,PROPN-PROPN,PROPN,compound-nsubj,appos,NNP-NNPS,NNP,2,1
6690,4809.0,26,is,4,1,13,12,0,12,3,9,Finnair,Finland,,per,PROPN,PROPN,compound,pobj,NNP,NNP,3,1
6691,4810.0,22,was,3,10,9,-1,9,12,-7,6,Kentucky,Western Kentucky University,,per-per-per,PROPN,ADJ-PROPN-PROPN,compound,compound-compound-nmod,NNP,JJ-NNP-NNP,2,1
6692,4811.0,23,Title,0,10,17,7,9,5,-10,17,Francis Marion University Location,United States,org-org-org-org,-,PROPN-PROPN-PROPN-PROPN,PROPN-PROPN,compound-compound-compound-ROOT,compound-nsubj,NNP-NNP-NNP-NNP,NNP-NNP,3,1
6693,4812.0,40,target,1,17,32,15,16,7,-16,31,Daihatsu,Katsuaki Watanabe,org,-,PROPN,PROPN-PROPN,conj,compound-nsubj,NNP,NNP-NNP,3,1
6694,4813.0,19,branded,5,1,17,16,0,1,4,12,Manipal University,Karnataka,per-per,,PROPN-PROPN,PROPN,compound-pobj,compound,NNP-NNP,NNP,6,1
6695,4816.0,12,born,2,1,5,4,0,6,1,3,Armstrong,Australia,per,,PROPN,PROPN,nsubjpass,compound,NNP,NNP,4,1
6696,4817.0,26,written,3,8,12,4,7,13,-5,9,Tamara Jenkins,Jim Taylor,per-per,-,PROPN-PROPN,PROPN-PROPN,compound-pobj,compound-nsubj,NNP-NNP,NNP-NNP,3,1
6697,4818.0,53,marked,3,15,25,10,14,27,-12,22,Thabo Mbeki,ANC,-,per,PROPN-PROPN,PROPN,compound-pobj,appos,NNP-NNP,NNP,3,1
6698,4820.0,32,were,5,28,31,3,27,0,-23,26,Festus Mogae,Botswana,per-per,,PROPN-PROPN,PROPN,compound-ROOT,pobj,NNP-NNP,NNP,7,1
6699,4821.0,23,acquired,4,3,18,15,2,4,1,14,Doreen Bird,college,per-per,,PROPN-PROPN,NOUN,compound-nsubj,poss,NNP-NNP,NN,7,1
6700,4822.0,29,lead,3,17,27,10,16,1,-14,24,Germany,Joseph Wirth,org,-,PROPN,PROPN-PROPN,compound,compound-pobj,NNP,NNP-NNP,9,1
6701,4823.0,26,is,10,1,13,12,0,12,9,3,William Howard Taft,attorney,--,per,PROPN-PROPN-PROPN,NOUN,compound-compound-compound,attr,NNP-NNP-NNP,NN,5,1
6702,4824.0,23,said,2,17,19,2,16,3,-15,17,Guangzhou,his,per,,PROPN,DET,pobj,poss,NNP,PRP$,4,1
6703,4826.0,27,was,1,1,4,3,0,22,0,3,Mehsud,Taliban,per,,PROPN,PROPN,nsubj,compound,NNP,NNP,1,1
6704,9268.0,36,went,8,4,25,21,3,10,4,17,Mehsud,Taliban,org,,PROPN,PROPN,poss,compound,NNP,NNP,9,1
6705,4827.0,13,is,2,1,8,7,0,4,1,6,Fort Defiance,Augusta County,org-org,-,PROPN-PROPN,PROPN-PROPN,compound-nsubj,compound-compound,NNP-NNP,NNP-NNP,5,1
6706,4828.0,18,is,4,2,17,15,1,0,2,13,Myx,Philippines,per,,PROPN,PROPN,compound,pobj,NNP,NNP,3,1
6707,4829.0,36,generated,1,12,18,6,11,17,-11,17,Barack Obama,Illinois,per-per,,PROPN-PROPN,PROPN,compound-poss,poss,NNP-NNP,NNP,5,1
6708,4831.0,53,used,2,49,52,3,48,0,-47,50,Bell TV,Canada,org-org,,PROPN-PROPN,PROPN,conj-pobj,pobj,NNP-NNP,NNP,3,1
6709,4832.0,30,sung,1,1,16,15,0,13,0,15,She,France,org,,PRON,PROPN,nsubj,pobj,PRP,NNP,4,1
6710,6598.0,20,was,1,1,19,18,0,0,0,18,She,France,org,,PRON,PROPN,nsubj,pobj,PRP,NNP,1,1
6711,4833.0,82,had,20,16,10,-6,15,71,4,-10,New Zealand,Auckland,-,per,PROPN-PROPN,PROPN,compound-pobj,nsubj,NNP-NNP,NNP,5,1
6712,4834.0,28,was,1,22,26,4,21,1,-21,25,Egypt,Hosni Mubarak,per,-,PROPN,PROPN-PROPN,poss,compound-dobj,NNP,NNP-NNP,3,1
6713,7882.0,25,visits,11,13,19,6,12,5,-2,8,Egypt,Hosni Mubarak,org,-,PROPN,PROPN-PROPN,dobj,compound-dobj,NNP,NNP-NNP,2,1
6714,8650.0,75,During,0,62,69,7,61,5,-62,69,Egypt,Hosni Mubarak,,org-org,PROPN,PROPN-PROPN,dobj,compound-pobj,NNP,NNP-NNP,3,1
6715,10373.0,22,visited,9,11,15,4,10,6,-2,6,Egypt,Hosni Mubarak,org,-,PROPN,PROPN-PROPN,dobj,compound-conj,NNP,NNP-NNP,2,1
6716,13816.0,14,meets,7,2,12,10,1,1,5,5,Egypt,Hosni Mubarak,,per-per,PROPN,PROPN-PROPN,nsubj,compound-pobj,NNP,NNP-NNP,4,1
6717,4835.0,29,became,1,15,23,8,14,5,-14,22,Earle Page,Australia,org-org,,PROPN-PROPN,PROPN,compound-pobj,pobj,NNP-NNP,NNP,4,1
6718,5040.0,44,stands,1,24,37,13,23,6,-23,36,Earle Page,Australia,-,org,PROPN-PROPN,PROPN,compound-compound,pobj,NNP-NNP,NNP,3,1
6719,4836.0,28,was,6,3,19,16,2,8,3,13,Nebraska Cornhuskers,Big,-,per,PROPN-PROPN,PROPN,compound-compound,compound,NNP-NNP,NNP,7,1
6720,4837.0,24,went,3,6,17,11,5,6,-3,14,England,Richard of Dover,org,--,PROPN,PROPN-ADP-PROPN,pobj,pobj-prep-pobj,NNP,NNP-IN-NNP,6,1
6721,4838.0,20,funded,4,14,19,5,13,0,-10,15,Mark Lefanowicz,E-Loan,-,org,PROPN-PROPN,PROPN,nmod-conj,pobj,NNP-NNP,NNP,6,1
6722,4840.0,27,participated,10,1,20,19,0,6,9,10,RAAF,No. 1 Squadron RAAF,org,---,NOUN,NOUN-NUM-PROPN-PROPN,compound,nmod-nummod-compound-pobj,NN,NN-CD-NNP-NNP,6,1
6723,4841.0,18,is,11,1,15,14,0,2,10,4,Steve Molitor,Canadian,org-org,,PROPN-PROPN,ADJ,compound-nsubj,amod,NNP-NNP,JJ,3,1
6724,4842.0,16,participate,11,1,7,6,0,8,10,-4,Swindon,Stagecoach in Swindon,per,--,PROPN,PROPN-ADP-PROPN,poss,appos-prep-pobj,NNP,NNP-IN-NNP,3,1
6725,7136.0,25,is,8,1,10,9,0,14,7,2,Swindon,Stagecoach in Swindon,,per-per-per,PROPN,PROPN-ADP-PROPN,poss,attr-prep-pobj,NNP,NNP-IN-NNP,5,1
6726,4843.0,20,is,7,1,13,12,0,6,6,6,Greyhound Canada,FirstGroup,-,per,PROPN-PROPN,PROPN,compound-nsubj,nsubj,NNP-NNP,NNP,4,1
6727,4844.0,23,guarded,4,2,17,15,1,5,2,13,Vatican City,Swiss Guard,per-per,-,PROPN-PROPN,PROPN-PROPN,compound-nsubjpass,compound-appos,NNP-NNP,NNP-NNP,4,1
6728,5867.0,22,guarded,4,2,17,15,1,4,2,13,Vatican City,Swiss Guard,-,per-per,PROPN-PROPN,PROPN-PROPN,compound-nsubjpass,compound-appos,NNP-NNP,NNP-NNP,2,1
6729,4845.0,29,is,8,1,14,13,0,14,7,6,Brian Melo,Hamilton,-,per,PROPN-PROPN,PROPN,compound-nsubj,compound,NNP-NNP,NNP,3,1
6730,4846.0,17,born,2,7,15,8,6,1,-5,13,Rochester,Eastman Kodak,per,-,PROPN,PROPN-PROPN,compound,compound-pobj,NNP,NNP-NNP,4,1
6731,4847.0,132,meant,8,43,43,0,42,88,-35,35,American Export Airlines,American Overseas Airlines,--,per-per-per,PROPN-PROPN-PROPN,PROPN-PROPN-PROPN,compound-compound-pobj,compound-compound-appos,NNP-NNP-NNP,NNP-NNP-NNPS,0,1
6732,4848.0,20,reversed,2,1,17,16,0,2,1,15,He,Illinois,per,,PRON,PROPN,nsubjpass,compound,PRP,NNP,9,1
6733,4849.0,37,said,32,23,30,7,22,6,9,-2,Wolfgang Dehen,Siemens,-,org,PROPN-PROPN,PROPN,compound-pobj,compound,NNP-NNP,NNP,7,1
6734,4850.0,13,ruled,3,5,10,5,4,2,-2,7,Nicaragua,Ortega,,per,PROPN,PROPN,dobj,pobj,NNP,NNP,2,1
6735,5400.0,18,remains,3,5,12,7,4,5,-2,9,Nicaragua,Ortega,,per,PROPN,PROPN,poss,conj,NNP,NNP,4,1
6736,9499.0,39,listed,7,9,20,11,8,18,-2,13,Nicaragua,Ortega,per,,PROPN,PROPN,dobj,conj,NNP,NNP,5,1
6737,4851.0,22,became,2,1,17,16,0,4,1,15,He,Polish United Workers ' Party,per,----,PRON,PROPN-PROPN-PROPN-PART-PROPN,nsubj,compound-compound-poss-case-pobj,PRP,NNP-NNP-NNP-POS-NNP,6,1
6738,4852.0,20,is,3,11,18,7,10,1,-8,15,Nina Simone,Bethlehem,-,per,PROPN-PROPN,PROPN,compound-ROOT,compound,NNP-NNP,NNP,3,1
6739,4853.0,22,headed,4,7,15,8,6,6,-3,11,Roberto Colaninno,Piaggio,per-per,,PROPN-PROPN,PROPN,compound-compound,pobj,NNP-NNP,NNP,6,1
6740,4854.0,27,attended,1,16,22,6,15,4,-15,21,Lancaster-Lebanon League,Nittany Lion,per-per,-,PROPN-PROPN,PROPN-PROPN,amod-nsubj,compound-compound,NNP-NNP,NNP-NNP,5,1
6741,4855.0,26,represented,14,4,17,13,3,8,10,3,Crimson Tide,University of Alabama,org-org,--,PROPN-PROPN,PROPN-ADP-PROPN,compound-compound,dobj-prep-pobj,NNP-NNP,NNP-IN-NNP,4,1
6742,4857.0,32,have,18,15,24,9,14,7,3,6,South African,Fugard,per-per,,ADJ-ADJ,PROPN,amod-amod,pobj,JJ-JJ,NNP,8,1
6743,4858.0,34,complained,9,3,4,1,2,29,6,-5,Education,Joseph Korto,,per-per,PROPN,PROPN-PROPN,pobj,compound-nsubj,NNP,NNP-NNP,1,1
6744,8947.0,20,said,14,16,18,2,15,1,-2,4,Education,Joseph Korto,per,-,PROPN,PROPN-PROPN,compound,compound-nsubj,NNP,NNP-NNP,1,1
6745,4859.0,26,failed,3,18,20,2,17,5,-15,17,Labor,Joseph Lyons,org,-,PROPN,PROPN-PROPN,poss,compound-pobj,NNP,NNP-NNP,2,1
6746,4860.0,31,Leading,0,20,23,3,19,7,-20,23,Elin Nordegren,Sweden,per-per,,PROPN-PROPN,PROPN,compound-appos,pobj,NNP-NNP,NNP,2,1
6747,4861.0,21,is,8,1,19,18,0,1,7,11,Pininfarina,Cambiano,,org,PROPN,PROPN,nsubj,compound,NNP,NNP,4,1
6748,4862.0,57,Lima,0,52,55,3,51,1,-52,55,Rossall School,Lancashire,-,per,PROPN-PROPN,PROPN,compound-conj,compound,NNP-NNP,NNP,2,1
6749,4863.0,33,said,4,3,16,13,2,16,1,12,Gilles Duceppe,Canadian,org-org,,PROPN-PROPN,PROPN,compound-nsubj,amod,NNP-NNP,NNP,6,1
6750,4864.0,24,founded,6,2,10,8,1,13,4,4,Guyana,Desmond Hoyte,,org-org,PROPN,PROPN-PROPN,compound,compound-pobj,NNP,NNP-NNP,3,1
6751,4866.0,54,sold,2,25,27,2,24,26,-23,25,UK,International Power,,org-org,PROPN,PROPN-PROPN,compound,compound-compound,NNP,NNP-NNP,2,1
6752,4867.0,47,=,0,25,44,19,24,2,-25,44,ExxonMobil,Standard Oil,org,-,PROPN,PROPN-PROPN,ROOT,compound-compound,NNP,NNP-NNP,6,1
6753,4868.0,64,introduced,1,52,56,4,51,7,-51,55,Kevin Rudd,Australian Labor Party,org-org,--,PROPN-PROPN,PROPN-PROPN-PROPN,compound-pobj,compound-compound-nsubj,NNP-NNP,NNP-NNP-NNP,10,1
6754,4869.0,42,reserves,2,2,2,0,1,39,0,0,CSKA,CSKA,per,,PROPN,PROPN,nsubj,poss,NNP,NNP,0,1
6755,4870.0,38,make,11,7,33,26,6,4,4,22,Gold Coast Football Club,Danny Stanley,---,org-org,PROPN-PROPN-PROPN-PROPN,PROPN-PROPN,compound-compound-compound-nsubj,compound-conj,NNP-NNP-NNP-NNP,NNP-NNP,6,1
6756,4871.0,16,appointed,11,2,13,11,1,2,9,2,Berry Bros. Rudd,BBR,--,org,PROPN-PROPN-PROPN,PROPN,compound-compound-nsubj,compound,NNP-NNP-NNP,NNP,5,1
6757,4872.0,21,led,8,5,7,2,4,13,3,-1,Nicaragua,Violeta Chamorro,,org-org,PROPN,PROPN-PROPN,poss,compound-conj,NNP,NNP-NNP,2,1
6758,4873.0,42,was,1,1,17,16,0,24,0,16,Bayh,Indiana,per,,PROPN,PROPN,nsubj,pobj,NNP,NNP,6,1
6759,8684.0,41,announced,2,2,30,28,1,10,0,28,Bayh,Indiana,org,,PROPN,PROPN,nsubj,pobj,NNP,NNP,9,1
6760,4875.0,27,met,4,4,21,17,3,5,0,17,Honeyman-Scott,Hereford,,org,PROPN,PROPN,pobj,pobj,NNP,NNP,6,1
6761,4876.0,32,Developed,0,17,30,13,16,1,-17,30,Lamborghini,Volkswagen Group,per,-,PROPN,PROPN-PROPN,pobj,compound-pobj,NNP,NNP-NNP,9,1
6762,4877.0,26,returned,5,5,19,14,4,6,0,14,unit,Fourth Air Force,,org-org-org,NOUN,PROPN-PROPN-PROPN,nsubj,compound-compound-pobj,NN,NNP-NNP-NNP,4,1
6763,4878.0,26,approved,9,9,9,0,8,16,0,0,Kuwait,Kuwait Airways,,per-per,PROPN,PROPN-PROPN,pobj,compound-compound,NNP,NNP-NNP,0,1
6764,4879.0,43,arranged,10,6,8,2,5,34,4,-2,Trojan,Brown,per,,PROPN,PROPN,compound,pobj,NNP,NNP,2,1
6765,4881.0,25,was,10,1,23,22,0,1,9,13,John Foster McCreight,British Columbia,--,org-org,PROPN-PROPN-PROPN,PROPN-PROPN,compound-compound-compound,compound-pobj,NNP-NNP-NNP,NNP-NNP,8,1
6766,4883.0,36,produces,8,2,22,20,1,13,6,14,New Zealand,Ministry of Transport,-,org-org-org,PROPN-PROPN,PROPN-ADP-PROPN,compound-poss,pobj-prep-pobj,NNP-NNP,NNP-IN-NNP,7,1
6767,4884.0,58,Crossing,3,1,1,0,0,56,2,-2,San Diego Metropolitan Transit System,San Diego,----,per-per,PROPN-PROPN-PROPN-PROPN-PROPN,PROPN-PROPN,compound-compound-compound-compound-compound,compound-compound,NNP-NNP-NNP-NNP-NNP,NNP-NNP,0,1
6768,4885.0,15,released,6,3,6,3,2,8,3,0,John,Kiss,,per,PROPN,PROPN,pobj,pobj,NNP,NNP,3,1
6769,4886.0,19,holds,1,15,18,3,14,0,-14,17,Acharya Nagarjuna University,Guntur,--,per,PROPN-PROPN-PROPN,PROPN,compound-compound-compound,pobj,NNP-NNP-NNP,NNP,10,1
6770,4887.0,28,dominated,11,21,26,5,20,1,-10,15,Bakersfield,Merle Haggard,,per-per,PROPN,PROPN-PROPN,compound,compound-pobj,NNP,NNP-NNP,4,1
6771,4888.0,31,returned,1,22,29,7,21,1,-21,28,Free Association of German Trade Unions,FVdG,per-per-per-per-per-per,,PROPN-PROPN-ADP-PROPN-PROPN-PROPN,PROPN,compound-dobj-prep-compound-compound-pobj,subtok,NNP-NNP-IN-NNP-NNP-NNPS,NNP,4,1
6772,4889.0,39,organize,2,1,5,4,0,33,1,3,He,Council,org,,PRON,PROPN,nsubj,dobj,PRP,NNP,3,1
6773,4890.0,16,is,9,3,14,11,2,1,6,5,Maria Sole Tognazzi,film director,org-org-org,-,PROPN-PROPN-PROPN,NOUN-NOUN,compound-compound-appos,compound-appos,NNP-NNP-NNP,NN-NN,6,1
6774,4892.0,15,is,3,5,5,0,4,9,-2,2,Virgin Money,Virgin Group,-,per-per,PROPN-PROPN,PROPN-PROPN,compound-attr,compound-appos,NNP-NNP,NNP-NNP,0,1
6775,4893.0,27,became,3,19,22,3,18,4,-16,19,Radical Party,leader,-,per,PROPN-PROPN,NOUN,compound-dobj,pobj,NNP-NNP,NN,2,1
6776,4895.0,12,educated,2,5,5,0,4,6,-3,3,Mildenhall College of Technology,Mildenhall,---,org,PROPN-PROPN-ADP-PROPN,PROPN,compound-pobj-prep-pobj,compound,NNP-NNP-IN-NNP,NNP,0,1
6777,4896.0,33,born,4,1,12,11,0,20,3,8,Michel Marcel Navratil,France,per-per-per,,PROPN-PROPN-PROPN,PROPN,compound-compound-nsubjpass,pobj,NNP-NNP-NNP,NNP,3,1
6778,4898.0,40,said,7,1,6,5,0,33,6,-1,Michael Phelps,The Advocate,-,per-per,PROPN-PROPN,DET-PROPN,nsubj-nsubj,det-pobj,NNP-NNP,DT-NNP,3,1
6779,4899.0,23,is,1,15,20,5,14,2,-14,19,C-Train,Calgary,,org,PROPN,PROPN,nummod,compound,NNP,NNP,3,1
6780,4900.0,28,inherited,1,1,13,12,0,14,0,12,Brooke,Vincent Astor,,per-per,PROPN,PROPN-PROPN,nsubj,compound-compound,NNP,NNP-NNP,5,1
6781,4901.0,16,was,0,7,15,8,6,0,-7,15,Eggerz,Iceland,per,,PROPN,PROPN,pobj,pobj,NNP,NNP,8,1
6782,8626.0,31,was,9,1,13,12,0,17,8,4,Eggerz,Iceland,,per,PROPN,PROPN,nsubj,pobj,NNP,NNP,4,1
6783,4903.0,61,reckoned,38,9,18,9,8,42,29,-20,Stax,Otis,per,,PROPN,PROPN,compound,compound,NNP,NNP,5,1
6784,4904.0,60,was,6,48,54,6,47,5,-42,48,Mexico,Clemente Orozco,,org-org,PROPN,PROPN-PROPN,pobj,compound-dobj,NNP,NNP-NNP,2,1
6785,4905.0,24,accused,9,3,8,5,2,15,6,-1,BBC,Thoday,,org,PROPN,PROPN,compound,nsubjpass,NNP,NNP,5,1
6786,4906.0,34,founded,17,8,23,15,7,10,9,6,NUIM,1997,,org,PROPN,NUM,appos,nummod,NNP,CD,-1,1
6787,4908.0,17,is,1,1,12,11,0,4,0,11,He,Nicaragua,,per,PRON,PROPN,nsubj,poss,PRP,NNP,4,1
6788,4909.0,23,founded,3,8,17,9,7,5,-5,14,North Chili,Roberts Wesleyan College,per-per,--,PROPN-PROPN,PROPN-PROPN-PROPN,compound-compound,compound-compound-pobj,NNP-NNP,NNP-NNP-NNP,7,1
6789,4910.0,12,Is,0,2,7,5,1,4,-2,7,Gary Rossington,Lynyrd Skynyrd,per-per,-,PROPN-PROPN,PROPN-PROPN,compound-nsubj,compound-compound,NNP-NNP,NNP-NNP,4,1
6790,4911.0,24,awarded,2,12,12,0,11,11,-10,10,Florida,Florida Department of Education,,org-org-org-org,PROPN,PROPN-PROPN-ADP-PROPN,pobj,compound-pobj-prep-pobj,NNP,NNP-NNP-IN-NNP,0,1
6791,8599.0,33,After,0,10,10,0,9,22,-10,10,Florida,Florida Department of Education,org,---,PROPN,PROPN-PROPN-ADP-PROPN,compound,compound-pobj-prep-pobj,NNP,NNP-NNP-IN-NNP,0,1
6792,12145.0,37,provided,21,2,2,0,1,34,19,-19,Florida,Florida Department of Education,,per-per-per-per,PROPN,PROPN-PROPN-ADP-PROPN,poss,compound-nsubj-prep-pobj,NNP,NNP-NNP-IN-NNP,0,1
6793,4912.0,19,was,2,4,12,8,3,6,-2,10,Bonnie Pink,Pony Canyon,org-org,-,PROPN-PROPN,PROPN-PROPN,compound-poss,compound-compound,NNP-NNP,NNP-NNP,7,1
6794,4913.0,21,attended,1,6,11,5,5,9,-5,10,Nauset Regional High School,Eastham,---,org,PROPN-PROPN-PROPN-PROPN,PROPN,compound-compound-compound-pobj,compound,NNP-NNP-NNP-NNP,NNP,3,1
6795,4914.0,130,felt,8,1,54,53,0,75,7,46,Alberta,Herbert Greenfield,org,-,PROPN,PROPN-PROPN,nsubjpass,compound-poss,NNP,NNP-NNP,-1,1
6796,10325.0,32,served,3,11,30,19,10,1,-8,27,Alberta,Herbert Greenfield,,per-per,PROPN,PROPN-PROPN,pobj,compound-pobj,NNP,NNP-NNP,7,1
6797,4916.0,10,CA,4,1,3,2,0,6,3,-1,John Smith,Los Angeles,org-org,-,PROPN-PROPN,PROPN-PROPN,compound-compound,compound-compound,NNP-NNP,NNP-NNP,2,1
6798,4917.0,32,is,3,11,27,16,10,4,-8,24,Ami Suzuki,Japan,per-per,,PROPN-PROPN,PROPN,compound-pobj,pobj,NNP-NNP,NNP,10,1
6799,9754.0,28,released,17,15,25,10,14,2,2,8,Ami Suzuki,Japan,per-per,,PROPN-PROPN,PROPN,compound-conj,pobj,NNP-NNP,NNP,10,1
6800,11734.0,19,is,2,11,18,7,10,0,-9,16,Ami Suzuki,Japan,-,org,PROPN-PROPN,PROPN,compound-pobj,pobj,NNP-NNP,NNP,2,1
6801,4918.0,39,went,1,14,30,16,13,8,-13,29,Earth,University,per,,PROPN,PROPN,compound,pobj,NNP,NNP,5,1
6802,4919.0,18,is,2,2,6,4,1,11,0,4,Miossec,singer,,org,PROPN,NOUN,nsubj,attr,NNP,NN,2,1
6803,4920.0,15,are,2,2,11,9,1,3,0,9,Lovebugs,Switzerland,per,,NOUN,PROPN,nsubj,pobj,NNS,NNP,2,1
6804,12453.0,17,chosen,4,3,8,5,2,8,1,4,Lovebugs,Switzerland,org,,NOUN,PROPN,nsubjpass,dobj,NNS,NNP,3,1
6805,4921.0,19,taken,10,9,14,5,8,4,1,4,CCTV-9,CCTV,,org,PROPN,PROPN,nsubjpass,poss,NNP,NNP,4,1
6806,4922.0,22,influenced,3,1,18,17,0,3,2,15,Tousignant,Montreal,org,,PROPN,PROPN,nsubjpass,pobj,NNP,NNP,2,1
6807,4923.0,29,said,15,21,26,5,20,2,-6,11,Royal Veterinary College,University of London,--,per-per-per,PROPN-PROPN-PROPN,PROPN-ADP-PROPN,compound-compound-pobj,pobj-prep-pobj,NNP-NNP-NNP,NNP-IN-NNP,4,1
6808,4924.0,22,felt,6,10,19,9,9,2,-4,13,Saladin,Syria,org,,PROPN,PROPN,nsubj,pobj,NNP,NNP,6,1
6809,4926.0,49,replace,20,22,40,18,21,8,-2,20,Mike Johanns,Nebraska,-,per,PROPN-PROPN,PROPN,compound-dobj,compound,NNP-NNP,NNP,7,1
6810,5267.0,23,were,7,19,22,3,18,0,-12,15,Mike Johanns,Nebraska,-,org,PROPN-PROPN,PROPN,compound-conj,pobj,NNP-NNP,NNP,5,1
6811,13339.0,22,leading,14,10,13,3,9,8,4,-1,Mike Johanns,Nebraska,-,org,PROPN-PROPN,PROPN,compound-conj,pobj,NNP-NNP,NNP,3,1
6812,13915.0,36,came,4,21,27,6,20,8,-17,23,Mike Johanns,Nebraska,-,per,PROPN-PROPN,PROPN,compound-conj,pobj,NNP-NNP,NNP,4,1
6813,4928.0,18,March,0,6,15,9,5,2,-6,15,Barnes Noble,NY,-,org,NOUN-PROPN,PROPN,compound-nmod,ROOT,NNS-NNP,NNP,-1,1
6814,4929.0,30,paid,5,16,7,-9,15,22,-11,2,f Serbi,a Boris Tadi,org-org,--,X-PROPN,DET-PROPN-PROPN,appos-nsubj,det-compound-appos,XX-NNP,DT-NNP-NNP,-1,1
6815,4930.0,31,rector,4,9,16,7,8,14,-5,12,Colegio de San Juan de Letran,Intramuros,per-per-per-per-per-per,,PROPN-PROPN-PROPN-PROPN-X-PROPN,PROPN,nmod-nmod-compound-compound-compound-pobj,compound,NNP-NNP-NNP-NNP-FW-NNP,NNP,3,1
6816,4931.0,21,is,7,6,19,13,5,1,1,12,Wales TUC,Cardiff,per-per,,PROPN-PROPN,PROPN,compound-pobj,compound,NNP-NNP,NNP,7,1
6817,4932.0,31,The,0,9,27,18,8,3,-9,27,Alberta,Edmonton Social Planning Council,,per-per-per-per,PROPN,PROPN-PROPN-PROPN-PROPN,pobj,compound-compound-compound-conj,NNP,NNP-NNP-NNP-NNP,10,1
6818,4933.0,32,was,10,22,29,7,21,2,-12,19,Edward,Philippa of Hainault,,per-per-per,PROPN,PROPN-ADP-PROPN,compound,conj-prep-pobj,NNP,NNPS-IN-NNP,3,1
6819,4934.0,20,re-debuted,5,10,18,8,9,1,-5,13,himself,Dolph Ziggler,,per-per,PRON,PROPN-PROPN,dobj,compound-appos,PRP,NNP-NNP,4,1
6820,4936.0,12,crowned,9,7,11,4,6,0,2,2,Thirumalai Nayak,king,org-org,,PROPN-PROPN,NOUN,compound-appos,dobj,NNP-NNP,NN,4,1
6821,4937.0,40,reassigned,19,15,38,23,14,1,4,19,Japanese,Hideki Tj,,per-per,PROPN,PROPN-PROPN,pobj,compound-pobj,NNP,NNP-NNP,7,1
6822,4939.0,12,founded,3,1,10,9,0,1,2,7,Pearl River,Philadelphia,-,org,PROPN-PROPN,PROPN,compound-nsubjpass,compound,NNP-NNP,NNP,3,1
6823,4940.0,32,forecast,11,7,9,2,6,22,4,-2,Australia,Toll Holdings,per,-,PROPN,PROPN-PROPN,poss,compound-compound,NNP,NNP-NNPS,3,1
6824,4941.0,45,resulted,16,28,32,4,27,12,-12,16,Vangelis,1978,,org,PROPN,NUM,poss,pobj,NNP,CD,3,1
6825,4942.0,11,Sweden,3,7,9,2,6,1,-4,6,Leslie,France,per,,PROPN,PROPN,compound,appos,NNP,NNP,2,1
6826,4943.0,43,Title,0,16,25,9,15,17,-16,25,Chapel Hill,University of North Carolina at Chapel Hill,org-org,------,PROPN-PROPN,PROPN-ADP-PROPN-PROPN-ADP-PROPN-PROPN,compound-compound,appos-prep-compound-pobj-prep-compound-compound,NNP-NNP,NNP-IN-NNP-NNP-IN-NNP-NNP,4,1
6827,4944.0,57,touted,22,20,28,8,19,28,2,6,Louisville,Mitch McConnell,,per-per,PROPN,PROPN-PROPN,pobj,compound-conj,NNP,NNP-NNP,5,1
6828,4946.0,26,lampooned,4,10,19,9,9,6,-6,15,Mark Thomas,UK,per-per,,PROPN-PROPN,PROPN,compound-pobj,compound,NNP-NNP,NNP,6,1
6829,4947.0,41,offered,11,1,30,29,0,10,10,19,Natalie Wood,Robert Wagner,per-per,-,PROPN-PROPN,PROPN-PROPN,compound-nsubjpass,compound-conj,NNP-NNP,NNP-NNP,6,1
6830,4948.0,27,After,0,8,10,2,7,16,-8,10,Max Roach,she,-,org,PROPN-PROPN,PRON,compound-dobj,nsubj,NNP-NNP,PRP,4,1
6831,4949.0,28,ordered,4,13,20,7,12,7,-9,16,Brian Mulroney,Canada,per-per,,PROPN-PROPN,PROPN,compound-pobj,pobj,NNP-NNP,NNP,3,1
6832,12847.0,29,set,7,6,9,3,5,19,1,2,Brian Mulroney,Canada,-,per,PROPN-PROPN,PROPN,compound-nsubj,dobj,NNP-NNP,NNP,2,1
6833,4950.0,15,is,0,7,11,4,6,3,-7,11,Wayne Shorter,Verve,per-per,,PROPN-PROPN,PROPN,compound-pobj,compound,NNP-NNP,NNP,5,1
6834,6767.0,19,is,4,11,15,4,10,3,-7,11,Wayne Shorter,Verve,-,per,PROPN-PROPN,PROPN,compound-pobj,compound,NNP-NNP,NNP,5,1
6835,4951.0,17,led,8,1,10,9,0,6,7,2,His,Indonesia,,org,DET,PROPN,poss,dobj,PRP$,NNP,3,1
6836,4952.0,24,left,12,3,14,11,2,9,9,2,he,Living Sacrifice,per,-,PRON,PROPN-PROPN,nsubj,compound-dobj,PRP,NNP-NNP,1,1
6837,4953.0,20,is,4,1,18,17,0,1,3,14,The College of William Mary,Williamsburg,----,org,DET-PROPN-ADP-PROPN-PROPN,PROPN,det-pobj-prep-compound-pobj,compound,DT-NNP-IN-NNP-NNP,NNP,7,1
6838,4954.0,38,was,8,28,36,8,27,1,-20,28,Chile,Manuel Montt,per,-,PROPN,PROPN-PROPN,nmod,compound-pobj,NNP,NNP-NNP,3,1
6839,6318.0,26,born,2,6,17,11,5,8,-4,15,Chile,Manuel Montt,per,-,PROPN,PROPN-PROPN,pobj,compound-compound,NNP,NNP-NNP,5,1
6840,4956.0,30,transferred,1,5,27,22,4,2,-4,26,University of South Florida,Big East,per-per-per-per,-,PROPN-ADP-PROPN-PROPN,PROPN-PROPN,pobj-prep-compound-pobj,compound-compound,NNP-IN-NNP-NNP,NNP-NNP,7,1
6841,9651.0,18,represented,3,3,15,12,2,2,0,12,University of South Florida,Big East,org-org-org-org,-,PROPN-ADP-PROPN-PROPN,PROPN-PROPN,conj-prep-compound-pobj,compound-compound,NNP-IN-NNP-NNP,NNP-NNP,3,1
6842,4957.0,45,said,6,2,4,2,1,40,4,-2,Thailand,Channel 9,,per-per,PROPN,PROPN-NUM,poss,nmod-nummod,NNP,NNP-CD,4,1
6843,4959.0,30,were,23,1,10,9,0,19,22,-13,Chaim Weizmann,Israel,-,per,PROPN-VERB,PROPN,compound-nsubj,pobj,NNP-VBP,NNP,4,1
6844,4960.0,20,is,5,13,17,4,12,2,-8,12,King Abdulaziz University,Jeddah,org-org-org,,PROPN-PROPN-PROPN,PROPN,compound-compound-pobj,pobj,NNP-NNP-NNP,NNP,4,1
6845,4961.0,21,has,2,1,7,6,0,13,1,5,It,Ontario,org,,PRON,PROPN,nsubj,compound,PRP,NNP,5,1
6846,4962.0,31,has,1,1,20,19,0,10,0,19,Lindt,Gloggnitz,,org,PROPN,PROPN,nsubj,compound,NNP,NNP,3,1
6847,4963.0,27,founded,4,3,3,0,2,23,1,-1,Dick Smith,Dick Smith Electronics,-,per-per-per,PROPN-PROPN,PROPN-PROPN-PROPN,compound-nsubj,compound-compound-dobj,NNP-NNP,NNP-NNP-NNP,0,1
6848,4964.0,21,considered,3,1,12,11,0,8,2,9,Konstantinos Karamanlis,Greek,per-per,,PROPN-PROPN,ADJ,compound-nsubjpass,amod,NNP-NNP,JJ,6,1
6849,4965.0,28,founded,3,2,7,5,1,20,1,4,company,Richard Branson,per,-,NOUN,PROPN-PROPN,nsubjpass,compound-pobj,NN,NNP-NNP,3,1
6850,4966.0,15,Bank,1,1,4,3,0,10,0,3,HSBC Bank,China,per-per,,PROPN-PROPN,PROPN,nmod-ROOT,appos,NNP-NNP,NNP,2,1
6851,14118.0,32,said,19,25,28,3,24,3,-6,9,HSBC Bank,China,-,org,PROPN-PROPN,PROPN,nmod-nmod,nmod,NNP-NNP,NNP,2,1
6852,4967.0,26,is,12,7,5,-2,6,20,5,-7,UCI,Irvine,,per,PROPN,PROPN,compound,appos,NNP,NNP,2,1
6853,4969.0,44,was,6,5,4,-1,4,39,1,-2,John Sherman,State,per-per,,PROPN-PROPN,PROPN,compound-nsubj,pobj,NNP-NNP,NNP,1,1
6854,4971.0,35,are,4,4,20,16,3,14,0,16,Peart,Rush,per,,PROPN,PROPN,conj,compound,NNP,NNP,3,1
6855,4972.0,28,installing,11,3,10,7,2,17,8,-1,Barbara Boxer,California,per-per,,PROPN-PROPN,PROPN,compound-nsubj,dobj,NNP-NNP,NNP,2,1
6856,5586.0,36,asked,13,9,12,3,8,23,4,-1,Barbara Boxer,California,-,per,PROPN-PROPN,PROPN,compound-pobj,pobj,NNP-NNP,NNP,3,1
6857,4973.0,71,gave,1,62,37,-25,61,33,-61,36,Mexico,Carlos Salinas de Gortari,,org-org-org-org,PROPN,PROPN-PROPN-ADP-PROPN,compound,compound-compound-compound-conj,NNP,NNP-NNP-IN-NNP,-1,1
6858,4974.0,36,turned,5,8,10,2,7,25,-3,5,Utes,Mountain West Conference,,per-per-per,PROPN,PROPN-PROPN-PROPN,dobj,compound-compound-compound,NNPS,NNP-NNP-NNP,3,1
6859,4976.0,20,reached,14,6,11,5,5,8,8,-3,Silent Majority Group,Candlebox,per-per-per,,PROPN-PROPN-PROPN,PROPN,compound-compound-compound,appos,NNP-NNP-NNP,NNP,3,1
6860,4977.0,18,was,10,1,16,15,0,1,9,6,Gary Morton,Lucille Ball,per-per,-,PROPN-PROPN,PROPN-PROPN,compound-nsubj,compound-pobj,NNP-NNP,NNP-NNP,4,1
6861,4978.0,24,is,7,1,22,21,0,1,6,15,Algonquin College,Ontario,-,per,PROPN-PROPN,PROPN,compound-nsubj,compound,NNP-NNP,NNP,5,1
6862,4979.0,24,Head,0,6,9,3,5,14,-6,9,Wells Cathedral School,Somerset,per-per-per,,PROPN-PROPN-PROPN,PROPN,compound-compound-compound,compound,NNP-NNP-NNP,NNP,2,1
6863,4980.0,40,formed,26,7,28,21,6,11,19,2,David Winters,Action International Pictures,per-per,--,PROPN-PROPN,PROPN-PROPN-PROPN,compound-appos,compound-compound-dobj,NNP-NNP,NNP-NNP-NNPS,7,1
6864,4981.0,43,is,1,1,22,21,0,20,0,21,France,Renault,per,,PROPN,PROPN,nsubj,compound,NNP,NNP,1,1
6865,4982.0,26,considered,3,10,15,5,9,10,-7,12,Germany,Darmstadt University of Technology,per,---,PROPN,PROPN-PROPN-ADP-PROPN,pobj,compound-pobj-prep-pobj,NNP,NNP-NNP-IN-NNP,4,1
6866,4983.0,31,lists,6,2,5,3,1,25,4,-1,Creighton University,Omaha,org-org,,PROPN-PROPN,PROPN,compound-nsubj,compound,NNP-NNP,NNP,1,1
6867,4984.0,40,folded,8,17,38,21,16,1,-9,30,English Premier Ice Hockey League,Guildford Flames,----,per-per,PROPN-PROPN-PROPN-PROPN-PROPN,PROPN-PROPN,compound-compound-compound-compound-pobj,compound-dobj,NNP-NNP-NNP-NNP-NNP,NNP-NNP,-1,1
6868,4985.0,10,is,2,1,2,1,0,7,1,0,Camp,Geiger,,per,PROPN,PROPN,compound,nsubj,NNP,NNP,1,1
6869,4986.0,40,named,3,1,7,6,0,32,2,4,Dick Monfort,University of Northern Colorado,-,org-org-org-org,PROPN-PROPN,PROPN-ADP-PROPN-PROPN,compound-nsubjpass,nmod-prep-pobj-compound,NNP-NNP,NNP-IN-NNP-NNP,4,1
6870,4987.0,34,said,9,5,9,4,4,24,4,0,Philippines,TUCP,,org,PROPN,PROPN,compound,appos,NNP,NNP,6,1
6871,4988.0,11,became,5,3,10,7,2,0,2,5,Ian,Botswana,per,,PROPN,PROPN,appos,pobj,NNP,NNP,4,1
6872,4989.0,25,continues,3,3,21,18,2,3,0,18,Japan,Top League,per,-,PROPN,PROPN-PROPN,pobj,compound-compound,NNP,NNP-NNP,11,1
6873,4992.0,24,As,0,10,15,5,9,8,-10,15,Nintendo,Future US,org,-,PROPN,PROPN-PROPN,nsubj,compound-pobj,NNP,NNP-NNP,2,1
6874,4993.0,31,see,25,2,3,1,1,27,23,-22,his,Brunswick,,org,DET,PROPN,poss,compound,PRP$,NNP,1,1
6875,4995.0,33,is,11,17,26,9,16,6,-6,15,Canada,Front Line Assembly,org,--,PROPN,PROPN-PROPN-PROPN,npadvmod,compound-compound-compound,NNP,NNP-NNP-NNP,8,1
6876,4996.0,31,released,2,9,17,8,8,13,-7,15,Big Machine,Swift,org-org,,PROPN-PROPN,PROPN,compound-compound,poss,NNP-NNP,NNP,9,1
6877,4998.0,30,known,2,1,12,11,0,17,1,10,He,Ark,per,,PRON,PROPN,nsubjpass,dobj,PRP,NNP,2,1
6878,4999.0,51,After,0,38,42,4,37,8,-38,42,France,Alain,per,,PROPN,PROPN,pobj,poss,NNP,NNP,5,1
6879,5000.0,26,is,3,1,25,24,0,0,2,22,The Beat Club,Florida,--,per,DET-PROPN-PROPN,PROPN,det-compound-nsubj,pobj,DT-NNP-NNP,NNP,9,1
6880,5001.0,34,graduated,1,25,33,8,24,0,-24,32,Norwegian School of Economics and Business Administration,1936,per-per-per-per-per-per-per,,PROPN-PROPN-ADP-PROPN-CCONJ-PROPN-PROPN,NUM,compound-pobj-prep-pobj-cc-conj-pobj,pobj,NNP-NNP-IN-NNP-CC-NNP-NNP,CD,6,1
6881,5002.0,15,signed,3,2,9,7,1,5,1,6,band,Chemikal Underground,per,-,NOUN,PROPN-PROPN,nsubjpass,compound-appos,NN,NNP-NNP,3,1
6882,5003.0,32,named,2,5,28,23,4,3,-3,26,Harold Brown,Defense,-,per,PROPN-PROPN,PROPN,compound-pobj,pobj,NNP-NNP,NNP,8,1
6883,5004.0,46,was,14,1,24,23,0,21,13,10,Pierre de Fermat,France,--,org,PROPN-PROPN-PROPN,PROPN,compound-nmod-nsubj,conj,NNP-NNP-NNP,NNP,8,1
6884,6053.0,56,is,2,4,15,11,3,40,-2,13,Pierre de Fermat,France,--,per,PROPN-PROPN-PROPN,PROPN,compound-compound-attr,nsubj,NNP-NNP-NNP,NNP,6,1
6885,7825.0,83,be,3,9,14,5,8,68,-6,11,Pierre de Fermat,France,per-per-per,,PROPN-PROPN-PROPN,PROPN,nmod-nmod-nsubj,nsubj,NNP-NNP-NNP,NNP,4,1
6886,5005.0,19,is,4,1,10,9,0,8,3,6,Springton Lake Middle School,Media,per-per-per-per,,PROPN-PROPN-PROPN-PROPN,PROPN,compound-compound-compound-nsubj,compound,NNP-NNP-NNP-NNP,NNP,5,1
6887,5006.0,42,sell,16,6,8,2,5,33,10,-8,1860,Guardian Life Insurance Company of America,org,-----,NUM,PROPN-PROPN-PROPN-PROPN-ADP-PROPN,pobj,compound-compound-compound-appos-prep-pobj,CD,NNP-NNP-NNP-NNP-IN-NNP,3,1
6888,5007.0,54,went,1,1,11,10,0,42,0,10,Thompson,London,per,,PROPN,PROPN,nsubj,compound,NNP,NNP,3,1
6889,5008.0,22,is,10,1,21,20,0,0,9,11,Dilian Francisca Toro,Colombia,org-org-org,,ADJ-PROPN-PROPN,PROPN,compound-compound-compound,pobj,JJ-NNP-NNP,NNP,3,1
6890,5009.0,22,1887,0,3,12,9,2,9,-3,12,Chiang Kai-shek,China,org-org,,PROPN-PROPN,PROPN,compound-nsubjpass,pobj,NNP-NNP,NNP,5,1
6891,5012.0,34,is,6,2,20,18,1,13,4,14,Khalifa bin Zayed Al Nahyan,United Arab Emirates,----,org-org-org,PROPN-PROPN-PROPN-PROPN-PROPN,PROPN-PROPN-PROPN,compound-compound-compound-compound-nsubj,compound-compound-pobj,NNP-NNP-NNP-NNP-NNP,NNP-NNP-NNPS,8,1
6892,6063.0,36,is,2,8,19,11,7,16,-6,17,Khalifa bin Zayed Al Nahyan,United Arab Emirates,per-per-per-per-per,--,PROPN-PROPN-PROPN-PROPN-PROPN,PROPN-PROPN-PROPN,compound-compound-compound-compound-pobj,compound-compound-pobj,NNP-NNP-NNP-NNP-NNP,NNP-NNP-NNPS,8,1
6893,5013.0,32,revealed,6,4,17,13,3,14,2,11,Hilton Hotels Corporation,Blackstone Group,org-org-org,-,PROPN-PROPN-PROPN,PROPN-PROPN,compound-compound-nsubj,compound-pobj,NNP-NNPS-NNP,NNP-NNP,6,1
6894,5014.0,31,is,5,1,13,12,0,17,4,8,de,Montreal,org,,X,PROPN,nsubj,pobj,FW,NNP,4,1
6895,5016.0,21,maintained,3,7,20,13,6,0,-4,17,Department of Foreign Affairs and Trade,Austrade,-----,org,PROPN-ADP-PROPN-PROPN-CCONJ-PROPN,PROPN,pobj-prep-compound-pobj-cc-conj,pobj,NNP-IN-NNP-NNPS-CC-NNP,NNP,4,1
6896,6071.0,19,produced,3,7,18,11,6,0,-4,15,Department of Foreign Affairs and Trade,Austrade,-----,per,PROPN-ADP-PROPN-PROPN-CCONJ-PROPN,PROPN,pobj-prep-nmod-pobj-cc-conj,conj,NNP-IN-NNP-NNPS-CC-NNP,NNP,4,1
6897,5017.0,37,was,1,7,11,4,6,25,-6,10,de Oliveira Salazar,Portugal,--,org,PROPN-PROPN-PROPN,PROPN,compound-compound-nsubj,dobj,NNP-NNP-NNP,NNP,5,1
6898,5187.0,43,influenced,4,27,31,4,26,11,-23,27,de Oliveira Salazar,Portugal,--,org,PROPN-PROPN-PROPN,PROPN,nmod-compound-conj,pobj,NNP-NNP-NNP,NNP,7,1
6899,8121.0,43,built,3,21,32,11,20,10,-18,29,de Oliveira Salazar,Portugal,--,per,ADP-PROPN-PROPN,PROPN,compound-compound-appos,pobj,IN-NNP-NNP,NNP,9,1
6900,5020.0,20,went,6,11,18,7,10,1,-5,12,Sonic Youth,Kim Gordon,org-org,-,PROPN-PROPN,PROPN-PROPN,compound-dobj,compound-pobj,NNP-NNP,NNP-NNP,7,1
6901,5021.0,32,had,1,9,27,18,8,4,-8,26,Big 12,Missouri,per-per,,ADJ-NUM,PROPN,dobj-nummod,compound,JJ-CD,NNP,6,1
6902,5022.0,34,appointed,16,15,23,8,14,10,1,7,Gurgenidze,Supervisory Board,,org-org,PROPN,PROPN-PROPN,pobj,compound-pobj,NNP,NNP-NNP,5,1
6903,5023.0,40,said,14,1,13,12,0,26,13,-1,Than Shwe,SPDC,-,org,ADP-PROPN,PROPN,compound-compound,appos,IN-NNP,NNP,4,1
6904,12115.0,14,need,6,1,5,4,0,8,5,-1,Than Shwe,SPDC,org-org,,ADP-PROPN,PROPN,dep-nsubj,compound,IN-NNP,NNP,2,1
6905,5024.0,22,posed,1,1,21,20,0,0,0,20,She,Athens,per,,PRON,PROPN,nsubj,pobj,PRP,NNP,1,1
6906,5025.0,28,announced,9,2,7,5,1,20,7,-2,Manuel Montt,Chile,-,org,PROPN-PROPN,PROPN,compound-nsubj,pobj,NNP-NNP,NNP,2,1
6907,5026.0,34,saw,4,9,25,16,8,8,-5,21,Ho,Vietnam,,per,PROPN,PROPN,pobj,pobj,NNP,NNP,8,1
6908,12041.0,22,relocated,6,1,6,5,0,15,5,0,Ho,Vietnam,per,,PROPN,PROPN,poss,pobj,NNP,NNP,3,1
6909,13228.0,26,declared,4,3,11,8,2,14,1,7,Ho,Vietnam,,org,PROPN,PROPN,nsubj,pobj,NNP,NNP,4,1
6910,5028.0,42,is,9,1,2,1,0,39,8,-7,45 Commando,Commando Brigade Royal Marines,per-per,---,NUM-PROPN,PROPN-PROPN-PROPN-PROPN,nummod-compound,compound-compound-compound-pobj,CD-NNP,NNP-NNP-NNP-NNPS,2,1
6911,5030.0,16,Legend,1,9,13,4,8,2,-8,12,Lee Greenwood,MCA,org-org,,PROPN-PROPN,PROPN,compound-compound,compound,NNP-NNP,NNP,4,1
6912,10172.0,14,Performed,3,7,11,4,6,2,-4,8,Lee Greenwood,MCA,org-org,,PROPN-PROPN,PROPN,compound-compound,compound,NNP-NNP,NNP,4,1
6913,5032.0,21,was,4,7,13,6,6,7,-3,9,New Haven,Yale Law School,-,org-org-org,PROPN-PROPN,PROPN-PROPN-PROPN,compound-pobj,compound-compound-pobj,NNP-NNP,NNP-NNP-NNP,6,1
6914,5033.0,33,launched,9,18,21,3,17,11,-9,12,LRA,Joseph Kony,per,-,PROPN,PROPN-PROPN,pobj,compound-appos,NNP,NNP-NNP,2,1
6915,5035.0,14,convinced,4,1,3,2,0,10,3,-1,Henry,Anne,org,,PROPN,PROPN,nsubj,conj,NNP,NNP,3,1
6916,5038.0,43,Lee,2,2,42,40,1,0,0,40,Richard Lee I,Virginia,per-per-per,,PROPN-PROPN-PRON,PROPN,compound-ROOT-nsubj,pobj,NNP-NNP-PRP,NNP,12,1
6917,5039.0,40,are,6,15,24,9,14,15,-9,18,Sudan,Sadiq al-Mahdi,per,-,PROPN,PROPN-VERB,compound,compound-conj,NNP,NNP-VBP,5,1
6918,5041.0,9,is,2,1,8,7,0,0,1,6,Naio Ssaion,Slovenia,-,per,PROPN-PROPN,PROPN,compound-nsubj,pobj,NNP-NNP,NNP,2,1
6919,5042.0,31,is,7,10,17,7,9,13,-3,10,VFA-103,Jolly Rogers,per,-,NOUN,PROPN-PROPN,compound,compound-appos,NN,NNP-NNP,2,1
6920,5043.0,18,represented,7,3,3,0,2,14,4,-4,West Virginia,West Virginia University,-,org-org-org,PROPN-PROPN,PROPN-PROPN-PROPN,compound-compound,compound-compound-dobj,NNP-NNP,NNP-NNP-NNP,0,1
6921,5044.0,24,travelled,4,16,3,-13,15,20,-12,-1,Henry,Catherine of Valois,org,--,PROPN,PROPN-ADP-PROPN,compound,pobj-prep-pobj,NNP,NNP-IN-NNP,6,1
6922,12824.0,49,be,2,11,14,3,10,34,-9,12,Henry,Catherine of Valois,,org-org-org,PROPN,PROPN-ADP-PROPN,compound,nsubj-prep-pobj,NNP,NNP-IN-NNP,2,1
6923,5045.0,30,admitted,21,2,18,16,1,11,19,-3,UAMS,1879,per,,PROPN,NUM,compound,pobj,NNP,CD,5,1
6924,5046.0,27,is,1,12,15,3,11,11,-11,14,United States,Manhattan Project,-,org-org,PROPN-PROPN,PROPN-PROPN,compound-poss,nmod-compound,NNP-NNP,NNP-NNP,1,1
6925,5047.0,20,affiliated,12,11,19,8,10,0,1,7,BMC,1997,per,,PROPN,NUM,pobj,pobj,NNP,CD,2,1
6926,5048.0,20,centrale,17,6,18,12,5,1,11,1,Centrale Graduate School,centrale de,--,org-org,PROPN-PROPN-PROPN,ADJ-X,compound-compound-compound,ROOT-advmod,NNP-NNP-NNP,JJ-FW,8,1
6927,5049.0,42,arrested,37,19,20,1,18,21,18,-17,Sabah,Joseph Pairin Kitingan,,org-org-org,PROPN,PROPN-PROPN-PROPN,pobj,nmod-nmod-nmod,NNP,NNP-NNP-NNP,2,1
6928,5050.0,27,played,1,4,15,11,3,11,-3,14,Defensor Sporting Club,France national football team,--,per-per-per-per,PROPN-PROPN-PROPN,PROPN-ADJ-NOUN-NOUN,compound-compound-pobj,nmod-amod-compound-pobj,NNP-NNP-NNP,NNP-JJ-NN-NN,8,1
6929,5051.0,24,appointed,14,12,19,7,11,4,2,5,Yehude Simon,Peru,org-org,,PROPN-PROPN,PROPN,compound-pobj,pobj,NNP-NNP,NNP,6,1
6930,11241.0,14,is,1,6,8,2,5,5,-5,7,Yehude Simon,Peru,per-per,,PROPN-PROPN,PROPN,compound-compound,poss,NNP-NNP,NNP,2,1
6931,5053.0,20,September,0,4,18,14,3,1,-4,18,Karan,India,per,,PROPN,PROPN,compound,compound,NNP,NNP,5,1
6932,5054.0,31,heads,10,1,3,2,0,27,9,-7,Luxembourg,Juncker,per,,PROPN,PROPN,poss,nsubj,NNP,NNP,4,1
6933,5055.0,40,received,4,11,21,10,10,18,-7,17,Lee Soo Man,SM Entertainment,per-per-per,-,PROPN-PROPN-PROPN,PROPN-PROPN,compound-compound-compound,compound-dobj,NNP-NNP-NNP,NNP-NNP,4,1
6934,5056.0,15,spoke,6,3,5,2,2,9,3,-1,Motown,Stubbs,per,,PROPN,PROPN,compound,nsubj,NNP,NNP,3,1
6935,10924.0,44,helped,17,7,13,6,6,30,10,-4,Motown,Stubbs,,per,PROPN,PROPN,compound,poss,NNP,NNP,7,1
6936,5057.0,19,is,12,1,8,7,0,10,11,-4,Anthony Doyle,England,per-per,,PROPN-PROPN,PROPN,compound-compound,dobj,NNP-NNP,NNP,4,1
6937,5058.0,32,reported,6,13,15,2,12,16,-7,9,Crawl,James Reyne,per,-,PROPN,PROPN-PROPN,compound,compound-pobj,NNP,NNP-NNP,3,1
6938,5059.0,17,confirmed,2,9,12,3,8,4,-7,10,Henry,Anne of Cleves,,org-org-org,PROPN,PROPN-ADP-PROPN,compound,conj-prep-pobj,NNP,NNP-IN-NNPS,2,1
6939,5060.0,62,is,1,20,34,14,19,27,-19,33,Loja,Universidad Particular de Loja,per,---,PROPN,PROPN-PROPN-ADP-PROPN,pobj,nmod-nmod-nmod-appos,NNP,NNP-NNP-IN-NNP,-1,1
6940,7089.0,36,On,0,8,10,2,7,25,-8,10,Loja,Universidad Particular de Loja,org,---,PROPN,PROPN-PROPN-ADP-PROPN,pobj,nmod-nmod-nmod-ROOT,NNP,NNP-NNP-IN-NNP,2,1
6941,5061.0,8,graduated,1,4,4,0,3,3,-3,3,Ithaca College,Ithaca,per-per,,PROPN-PROPN,PROPN,compound-compound,compound,NNP-NNP,NNP,0,1
6942,5062.0,68,presented,5,17,19,2,16,48,-12,14,Canadian Forces,Air Command,-,per-per,PROPN-PROPN,PROPN-PROPN,compound-compound,compound-oprd,NNP-NNPS,NNP-NNP,1,1
6943,5063.0,52,been,2,37,51,14,36,0,-35,49,Malcolm McLaren,London,-,org,PROPN-PROPN,PROPN,compound-appos,pobj,NNP-NNP,NNP,7,1
6944,5064.0,36,changes,2,1,18,17,0,17,1,16,Panama,Flex,org,,NOUN,PROPN,compound,nsubj,NN,NNP,6,1
6945,5065.0,120,include,10,18,3,-15,17,116,-8,-7,Albert Margai,Sierra Leone,org-org,-,PROPN-PROPN,PROPN-PROPN,compound-appos,compound-compound,NNP-NNP,NNP-NNP,5,1
6946,5066.0,18,continued,3,6,12,6,5,5,-3,9,Poland,Polish National Bank,,per-per-per,PROPN,PROPN-PROPN-PROPN,poss,compound-compound-nsubj,NNP,NNP-NNP-NNP,5,1
6947,5068.0,38,is,6,10,20,10,9,17,-4,14,ABC,Patricia Wettig,,per-per,PROPN,PROPN-PROPN,compound,compound-nsubj,NNP,NNP-NNP,7,1
6948,5069.0,22,made,6,6,11,5,5,10,0,5,Lloyd,Georgia,per,,PROPN,PROPN,nsubj,compound,NNP,NNP,4,1
6949,5070.0,29,moved,3,6,24,18,5,4,-3,21,Vienna,Theodor,,per,PROPN,PROPN,compound,pobj,NNP,NNP,10,1
6950,5072.0,26,lives,2,7,7,0,6,18,-5,5,Indiana,Indiana State University,per,--,PROPN,PROPN-PROPN-PROPN,pobj,compound-compound-pobj,NNP,NNP-NNP-NNP,0,1
6951,5073.0,20,are,4,2,17,15,1,2,2,13,Transperth Trains,Perth,org-org,,PROPN-PROPN,PROPN,compound-pobj,compound,NNP-NNP,NNP,10,1
6952,5074.0,14,greeted,4,8,12,4,7,1,-4,8,Archbishop,George Carey,,org-org,PROPN,PROPN-PROPN,pobj,compound-ROOT,NNP,NNP-NNP,2,1
6953,5075.0,41,is,1,14,27,13,13,13,-13,26,MobiFone,VNPT,,per,PROPN,PROPN,conj,appos,NNP,NNP,4,1
6954,5077.0,30,Rockefeller,0,5,8,3,4,21,-5,8,Standard Oil,New Jersey,-,org-org,PROPN-PROPN,PROPN-PROPN,compound-dobj,compound-pobj,NNP-NNP,NNP-NNP,3,1
6955,7795.0,13,acquired,3,6,9,3,5,3,-3,6,Standard Oil,New Jersey,-,per-per,PROPN-PROPN,PROPN-PROPN,compound-pobj,compound-pobj,NNP-NNP,NNP-NNP,2,1
6956,11643.0,29,compromised,15,24,27,3,23,1,-9,12,Standard Oil,New Jersey,-,per-per,PROPN-PROPN,PROPN-PROPN,compound-pobj,compound-pobj,NNP-NNP,NNP-NNP,4,1
6957,5078.0,19,were,4,10,17,7,9,1,-6,13,Thomas Jefferson,Charlottesville,org-org,,PROPN-PROPN,PROPN,compound-pobj,compound,NNP-NNP,NNP,7,1
6958,9148.0,13,Interment,0,3,11,8,2,1,-3,11,Thomas Jefferson,Charlottesville,-,per,PROPN-PROPN,PROPN,compound-poss,compound,NNP-NNP,NNP,3,1
6959,5080.0,23,signed,1,18,22,4,17,0,-17,21,his,G-Unit,,per,DET,PUNCT,poss,punct,PRP$,.,3,1
6960,5082.0,23,said,7,1,4,3,0,18,6,-3,NBC,Jeff Zucker,per,-,PROPN,PROPN-PROPN,compound,compound-nsubj,NNP,NNP-NNP,2,1
6961,5083.0,40,formed,3,19,31,12,18,8,-16,28,Finland,Urho Kekkonen,,per-per,PROPN,PROPN-PROPN,pobj,compound-pobj,NNP,NNP-NNP,8,1
6962,7141.0,31,invited,10,22,23,1,21,7,-12,13,Finland,Urho Kekkonen,,per-per,PROPN,PROPN-PROPN,compound,compound-pobj,NNP,NNP-NNP,1,1
6963,5086.0,17,purchased,9,8,16,8,7,0,1,7,NBC,RCTV,,org,PROPN,PROPN,nsubj,pobj,NNP,NNP,2,1
6964,5087.0,36,is,1,1,9,8,0,26,0,8,It,Harford County,,per-per,PRON,PROPN-PROPN,nsubj,compound-compound,PRP,NNP-NNP,6,1
6965,5088.0,36,met,1,8,15,7,7,20,-7,14,Ferrara,University of Ferrara,per,--,PROPN,PROPN-ADP-PROPN,pobj,pobj-prep-pobj,NNP,NNP-IN-NNP,4,1
6966,5089.0,42,released,6,26,30,4,25,11,-20,24,Trevor Jackson,Playgroup,-,per,PROPN-PROPN,PROPN,compound-appos,pobj,NNP-NNP,NNP,3,1
6967,5090.0,44,received,10,13,43,30,12,0,-3,33,SEAT,Spain,,per,PROPN,PROPN,compound,pobj,NNP,NNP,7,1
6968,5091.0,16,conducts,4,11,15,4,10,0,-7,11,Uttar Pradesh Technical University,Lucknow,---,org,PROPN-PROPN-PROPN-PROPN,PROPN,compound-compound-compound-compound,pobj,NNP-NNP-NNP-NNP,NNP,6,1
6969,6386.0,19,imparts,1,14,18,4,13,0,-13,17,Uttar Pradesh Technical University,Lucknow,---,per,PROPN-PROPN-PROPN-PROPN,PROPN,compound-compound-compound-compound,pobj,NNP-NNP-NNP-NNP,NNP,2,1
6970,5092.0,46,came,19,1,18,17,0,27,18,-1,The Walt Disney Company,United States,org-org-org-org,-,DET-PROPN-PROPN-PROPN,PROPN-PROPN,det-compound-compound-poss,compound-pobj,DT-NNP-NNP-NNP,NNP-NNP,10,1
6971,5094.0,27,is,11,2,2,0,1,24,9,-9,Hong Kong Institute of Education,Hong Kong,per-per-per-per-per,-,PROPN-PROPN-PROPN-ADP-PROPN,PROPN-PROPN,compound-compound-nsubj-prep-pobj,compound-pobj,NNP-NNP-NNP-IN-NNP,NNP-NNP,0,1
6972,5095.0,52,included,3,1,12,11,0,39,2,9,UBC,Canada,,per,PROPN,PROPN,nsubjpass,pobj,NNP,NNP,5,1
6973,5096.0,37,faced,8,10,29,19,9,7,-2,21,Maryland,Daniel Brewster,per,-,PROPN,PROPN-PROPN,compound,compound-conj,NNP,NNP-NNP,6,1
6974,5097.0,26,are,4,8,14,6,7,11,-4,10,Dean Martin,Arizona,-,org,PROPN-PROPN,PROPN,compound-nmod,nmod,NNP-NNP,NNP,2,1
6975,13926.0,12,was,2,1,5,4,0,6,1,3,Dean Martin,Arizona,-,org,PROPN-PROPN,PROPN,compound-nsubj,compound,NNP-NNP,NNP,3,1
6976,5098.0,28,began,1,1,14,13,0,13,0,13,She,North Tyneside Council,org,--,PRON,PROPN-PROPN-PROPN,nsubj,compound-nmod-nmod,PRP,NNP-NNP-NNP,5,1
6977,5099.0,24,expected,6,13,23,10,12,0,-7,17,Sellapan Ramanathan,Singapore,-,per,PROPN-PROPN,PROPN,compound-pobj,pobj,NNP-NNP,NNP,3,1
6978,7607.0,79,presented,0,47,51,4,46,27,-47,51,Sellapan Ramanathan,Singapore,org-org,,PROPN-PROPN,PROPN,compound-compound,pobj,NNP-NNP,NNP,2,1
6979,5101.0,35,working,2,19,28,9,18,6,-17,26,Big Machine,Taylor Swift,-,per-per,PROPN-PROPN,PROPN-PROPN,compound-compound,compound-pobj,NNP-NNP,NNP-NNP,4,1
6980,8374.0,26,released,2,9,21,12,8,4,-7,19,Big Machine,Taylor Swift,-,per-per,PROPN-PROPN,PROPN-PROPN,compound-compound,compound-pobj,NNP-NNP,NNP-NNP,8,1
6981,12217.0,21,is,3,1,8,7,0,12,2,5,Big Machine,Taylor Swift,org-org,-,ADJ-PROPN,PROPN-PROPN,amod-nsubj,compound-pobj,JJ-NNP,NNP-NNP,4,1
6982,13177.0,29,moved,2,5,10,5,4,18,-3,8,Big Machine,Taylor Swift,per-per,-,ADJ-PROPN,PROPN-PROPN,compound-compound,compound-pobj,JJ-NNP,NNP-NNP,4,1
6983,5102.0,21,began,3,3,19,16,2,1,0,16,he,Editions Mego,per,-,PRON,PROPN-PROPN,nsubj,compound-pobj,PRP,NNPS-NNP,6,1
6984,5104.0,9,is,2,1,8,7,0,0,1,6,Topi,Albania,org,,PROPN,PROPN,nsubj,pobj,NNP,NNP,3,1
6985,13797.0,26,expressed,1,1,21,20,0,4,0,20,Topi,Albania,per,,PROPN,PROPN,nsubj,nsubj,NNP,NNP,3,1
6986,5105.0,18,is,5,1,9,8,0,8,4,4,Xavier College,Roman Catholic,-,per-per,PROPN-PROPN,PROPN-PROPN,compound-compound,nmod-nmod,NNP-NNP,NNP-NNP,5,1
6987,5106.0,15,England,1,2,5,3,1,9,-1,4,England,Amir Khan,,org-org,PROPN,PROPN-PROPN,ROOT,compound-dobj,NNP,NNP-NNP,2,1
6988,5107.0,53,is,1,9,14,5,8,38,-8,13,Freddie Hubbard,Columbia,per-per,,PROPN-PROPN,PROPN,compound-pobj,compound,NNP-NNP,NNP,5,1
6989,5108.0,17,was,2,2,13,11,1,3,0,11,Gayoom,Maldives,org,,PROPN,PROPN,nsubj,compound,NNP,NNP,4,1
6990,11669.0,39,said,27,1,19,18,0,19,26,-8,Gayoom,Maldives,,org,PROPN,PROPN,nsubj,dobj,NNP,NNPS,4,1
6991,5109.0,25,created,2,21,24,3,20,0,-19,22,University of Potsdam,Germany,per-per-per,,PROPN-ADP-PROPN,PROPN,nmod-prep-pobj,pobj,NNP-IN-NNP,NNP,2,1
6992,5110.0,16,is,1,7,14,7,6,1,-6,13,Willie Nelson,Island,org-org,,PROPN-PROPN,PROPN,compound-pobj,compound,NNP-NNP,NNP,5,1
6993,5111.0,22,ruled,8,11,12,1,10,9,-3,4,actor,Heath Ledger,per,-,NOUN,PROPN-PROPN,compound,compound-nsubj,NN,NNP-NNP,2,1
6994,5112.0,23,graduated,1,14,18,4,13,4,-13,17,Northern Arizona University,Flagstaff,per-per-per,,PROPN-PROPN-PROPN,PROPN,compound-compound-pobj,compound,NNP-NNP-NNP,NNP,3,1
6995,11454.0,17,was,5,8,16,8,7,0,-3,11,Northern Arizona University,Flagstaff,--,org,PROPN-PROPN-PROPN,PROPN,compound-compound-pobj,pobj,NNP-NNP-NNP,NNP,6,1
6996,5113.0,22,is,9,2,1,-1,1,20,7,-8,Medical University,Kunming,org-org,,PROPN-PROPN,PROPN,compound-nsubj,compound,NNP-NNP,NNP,1,1
6997,5114.0,25,appears,1,6,11,5,5,13,-5,10,VMware,1998,,per,PROPN,NUM,pobj,pobj,NNP,CD,2,1
6998,5115.0,25,left,6,8,16,8,7,8,-2,10,RCA,SWV,,per,PROPN,PROPN,dobj,poss,NNP,NNP,7,1
6999,5151.0,23,signed,15,12,14,2,11,8,3,-1,RCA,SWV,org,,PROPN,PROPN,compound,pobj,NNP,NNP,9,1
7000,5116.0,31,attracted,7,9,14,5,8,16,-2,7,Hollywood,Orson,,per,PROPN,PROPN,compound,compound,NNP,NNP,4,1
7001,11247.0,17,befriended,1,3,6,3,2,10,-2,5,Hollywood,Orson,org,,PROPN,PROPN,compound,compound,NNP,NNP,2,1
7002,5117.0,33,formed,1,6,31,25,5,1,-5,30,Kentucky Ramblers,Patsy Montana,org-org,-,PROPN-PROPN,PROPN-PROPN,compound-appos,compound-pobj,NNP-NNPS,NNP-NNP,5,1
7003,5118.0,22,Industries,2,6,19,13,5,2,-4,17,Subaru,Japan,per,,PROPN,PROPN,compound,pobj,NNP,NNP,5,1
7004,5119.0,9,lived,4,2,8,6,1,0,2,4,his,Ontario,,org,DET,PROPN,poss,pobj,PRP$,NNP,3,1
7005,5120.0,41,wilderness,17,20,38,18,19,2,-3,21,Hudson,Zellers,,per,PROPN,PROPN,poss,conj,NNP,NNP,8,1
7006,5121.0,25,became,8,8,11,3,7,13,0,3,Frank,Germany,org,,PROPN,PROPN,nsubj,poss,NNP,NNP,3,1
7007,5123.0,31,remained,3,20,27,7,19,3,-17,24,Charlotte,Queens University of Charlotte,org,---,PROPN,PROPN-PROPN-ADP-PROPN,compound,compound-attr-prep-pobj,NNP,NNP-NNP-IN-NNP,8,1
7008,5124.0,24,met,3,14,17,3,13,6,-11,14,Switzerland,Richard Burton,per,-,PROPN,PROPN-PROPN,pobj,compound-nsubj,NNP,NNP-NNP,2,1
7009,5125.0,16,Brandon,3,3,6,3,2,9,0,3,Jim Brandon,Robert Conrad,org-org,-,PROPN-PROPN,PROPN-PROPN,compound-ROOT,compound-appos,NNP-NNP,NNP-NNP,1,1
7010,5127.0,32,Force,3,2,22,20,1,9,1,19,Special Task Force,Sri Lanka Police,--,per-per-per,PROPN-PROPN-PROPN,PROPN-PROPN-PROPN,compound-compound-ROOT,compound-compound-compound,NNP-NNP-NNP,NNP-NNP-NNP,-1,1
7011,5128.0,27,is,19,1,18,17,0,8,18,-1,Mihail Mihailov,Misho Shamara,per-per,-,PROPN-PROPN,PROPN-PROPN,compound-nsubj,compound-nsubj,NNP-NNP,NNP-NNP,2,1
7012,5129.0,50,Team,1,13,28,15,12,21,-12,27,Savannah State University,Tigers,per-per-per,,PROPN-PROPN-PROPN,PROPN,compound-compound-nsubjpass,nsubj,NNP-NNP-NNP,NNPS,8,1
7013,5130.0,19,declared,7,11,18,7,10,0,-4,11,Georgios Papadopoulos,Greece,per-per,,PROPN-PROPN,PROPN,compound-nsubj,pobj,NNP-NNP,NNP,3,1
7014,5131.0,36,performed,3,9,7,-2,8,28,-6,4,Layzie Bone,Bone Thugs-n-Harmony,-,per-per,PROPN-PROPN,PROPN-PROPN,compound-conj,compound-pobj,NNP-NNP,NNP-NNP,2,1
7015,5132.0,7,studied,1,4,6,2,3,0,-3,5,Mahinda College,Galle,-,per,PROPN-PROPN,PROPN,compound-compound,pobj,NNP-NNP,NNP,4,1
7016,8245.0,26,was,3,19,21,2,18,4,-16,18,Mahinda College,Galle,org-org,,PROPN-PROPN,PROPN,compound-compound,pobj,NNP-NNP,NNP,2,1
7017,5133.0,20,gets,7,2,7,5,1,12,5,0,Barry Adrian Reese,Cassidy,per-per-per,,PROPN-PROPN-PROPN,PROPN,compound-compound-compound,nsubj,NNP-NNP-NNP,NNP,4,1
7018,7927.0,27,is,16,1,16,15,0,10,15,0,Barry Adrian Reese,Cassidy,--,per,PROPN-PROPN-PROPN,PROPN,compound-amod-nsubj,nsubj,NNP-NNP-NNP,NNP,2,1
7019,5134.0,14,inaugurated,3,1,9,8,0,4,2,6,Armando Guebuza,Mozambique,org-org,,PROPN-PROPN,PROPN,compound-nsubjpass,pobj,NNP-NNP,NNP,2,1
7020,5135.0,21,is,8,1,19,18,0,1,7,11,Firth Park Community Arts College,Sheffield,per-per-per-per-per,,PROPN-PROPN-PROPN-PROPN-PROPN,PROPN,compound-compound-compound-compound-nsubj,compound,NNP-NNP-NNP-NNP-NNP,NNP,9,1
7021,5138.0,24,is,3,10,22,12,9,1,-7,19,Mahathir bin Mohamad,Prime Minister,per-per-per,-,PROPN-PROPN-PROPN,PROPN-PROPN,compound-compound-pobj,compound-attr,NNP-NNP-NNP,NNP-NNP,8,1
7022,5139.0,18,Glykeria,0,1,14,13,0,3,-1,14,Glykeria,Greece,per,,PROPN,PROPN,ROOT,pobj,NNP,NNP,4,1
7023,8554.0,45,released,4,4,40,36,3,4,0,36,Glykeria,Greece,,org,PROPN,PROPN,nsubj,pobj,NNP,NNP,-1,1
7024,5140.0,29,maintained,5,5,8,3,4,20,0,3,Venezuela,she,org,,PROPN,PRON,pobj,nsubj,NNP,PRP,1,1
7025,5141.0,33,reported,7,4,10,6,3,22,3,3,San Francisco,Levi Strauss Co.,per-per,--,PROPN-PROPN,PROPN-PROPN-PROPN,compound-compound,compound-compound-nsubj,NNP-NNP,NNP-NNP-NNP,5,1
7026,5143.0,54,called,3,26,28,2,25,25,-23,25,CMT,Viacom,org,,PROPN,PROPN,conj,nsubj,NNP,NNP,3,1
7027,5144.0,28,nominated,15,12,27,15,11,0,3,12,Patrick Hillery,Ireland,org-org,,PROPN-PROPN,PROPN,compound-pobj,pobj,NNP-NNP,NNP,5,1
7028,5145.0,25,is,1,5,9,4,4,15,-4,8,Dark Tranquillity,Martin Henriksson,org-org,-,PROPN-PROPN,PROPN-PROPN,compound-compound,compound-nsubj,NNP-NNP,NNP-NNP,3,1
7029,5146.0,19,shifted,8,11,15,4,10,3,-3,7,Bangalore,Indian Institute of Astrophysics,,per-per-per-per,PROPN,PROPN-PROPN-ADP-PROPN,pobj,compound-dobj-prep-pobj,NNP,NNP-NNP-IN-NNP,3,1
7030,5148.0,19,is,8,1,18,17,0,0,7,10,Mahamakut Buddhist University,Thailand,--,per,PROPN-PROPN-PROPN,PROPN,compound-compound-nsubj,pobj,NNP-NNP-NNP,NNP,3,1
7031,5149.0,23,lost,1,20,22,2,19,0,-19,21,Republika Srpska,Nikola,org-org,,PROPN-PROPN,PROPN,compound-compound,pobj,NNP-NNP,NNP,9,1
7032,5150.0,21,moved,14,11,19,8,10,1,3,5,Simmering-Graz-Pauker,Vienna,per,,PROPN,PROPN,compound,compound,NNP,NNP,7,1
7033,5152.0,57,is,1,39,39,0,38,17,-38,38,Bridgepoint Capital,Bridgepoint,per-per,,PROPN-PROPN,PROPN,compound-pobj,compound,NNP-NNP,NNP,0,1
7034,5153.0,22,was,2,1,1,0,0,20,1,-1,Delta Express,Delta,-,per,PROPN-PROPN,PROPN,compound-nsubj,compound,NNP-NNP,NNP,0,1
7035,5154.0,21,Be,7,2,6,4,1,14,5,-1,Misbourne School,Buckinghamshire,-,org,PROPN-PROPN,PROPN,compound-nsubj,appos,NNP-NNP,NNP,2,1
7036,5155.0,82,sold,18,6,16,10,5,65,12,-2,CHUM Limited,A-Channel,-,per,PROPN-PROPN,PROPN,compound-pobj,compound,NNP-NNP,NNP,5,1
7037,5156.0,22,returned,1,9,9,0,8,12,-8,8,Montana,Montana Army National Guard,,per-per-per-per,PROPN,PROPN-PROPN-PROPN-PROPN,pobj,compound-compound-compound-pobj,NNP,NNP-NNP-NNP-NNP,0,1
7038,5157.0,20,stated,8,5,7,2,4,12,3,-1,Colorado Rapids,Gary Smith,per-per,-,PROPN-PROPN,PROPN-PROPN,compound-compound,compound-pobj,NNP-NNPS,NNP-NNP,1,1
7039,5159.0,17,written,5,10,14,4,9,2,-5,9,as Chu,or Jeo,-,per-per,ADP-PROPN,CCONJ-PROPN,prep-compound,cc-compound,IN-NNP,CC-NNP,3,1
7040,5160.0,34,been,19,9,23,14,8,10,10,4,Taiwan,Chiang Ching-kuo,org,-,PROPN,PROPN-PROPN,pobj,appos-nummod,NNP,NNP-NNP,9,1
7041,5161.0,36,said,31,23,31,8,22,4,8,0,Samarco,BHP,per,,PROPN,PROPN,pobj,nsubj,NNP,NNP,10,1
7042,5162.0,39,After,0,4,35,31,3,3,-4,35,Rough Trade,their,per-per,,PROPN-PROPN,DET,compound-compound,poss,NNP-NNP,PRP$,17,1
7043,5163.0,35,born,2,21,28,7,20,6,-19,26,Henrietta Maria of France,Charles,org-org-org-org,,PROPN-PROPN-ADP-PROPN,PROPN,compound-nmod-prep-pobj,pobj,NNP-NNP-IN-NNP,NNP,4,1
7044,13619.0,36,was,6,26,32,6,25,3,-20,26,Henrietta Maria of France,Charles,---,per,PROPN-PROPN-ADP-PROPN,PROPN,compound-conj-prep-pobj,pobj,NNP-NNP-IN-NNP,NNP,6,1
7045,5165.0,44,indicates,3,21,31,10,20,12,-18,28,LPI,The Advocate,per,-,PROPN,DET-NOUN,poss,det-ROOT,NNP,DT-NN,5,1
7046,5166.0,18,is,2,1,5,4,0,12,1,3,Marshall Aerospace,Cambridge Airport,org-org,-,PROPN-PROPN,PROPN-PROPN,compound-nsubj,compound-pobj,NNP-NNP,NNP-NNP,3,1
7047,5167.0,22,run,3,12,21,9,11,0,-9,18,Birla Institute of Technology and Science,Pilani,-----,org,PROPN-PROPN-ADP-PROPN-CCONJ-PROPN,PROPN,compound-pobj-prep-pobj-cc-conj,ROOT,NNP-NNP-IN-NNP-CC-NNP,NNP,5,1
7048,7958.0,21,is,1,12,19,7,11,1,-11,18,Birla Institute of Technology and Science,Pilani,-----,org,PROPN-PROPN-ADP-PROPN-CCONJ-PROPN,PROPN,compound-nmod-prep-pobj-cc-conj,pobj,NNP-NNP-IN-NNP-CC-NNP,NNP,7,1
7049,5169.0,20,became,1,12,16,4,11,3,-11,15,Jo Grimond,Leader,per-per,,PROPN-PROPN,PROPN,compound-appos,oprd,NNP-NNP,NNP,4,1
7050,5170.0,26,altered,12,8,18,10,7,7,4,6,Malaysia,Malaysian Indian Congress,per,--,PROPN,ADJ-PROPN-PROPN,pobj,amod-compound-conj,NNP,JJ-NNP-NNP,5,1
7051,5171.0,16,is,1,7,14,7,6,1,-6,13,Edward Fox,Joanna David,-,per-per,PROPN-PROPN,PROPN-PROPN,compound-pobj,compound-appos,NNP-NNP,NNP-NNP,5,1
7052,5172.0,26,been,2,18,24,6,17,1,-16,22,Gene Wilder,Gilda Radner,-,org-org,PROPN-PROPN,PROPN-PROPN,compound-pobj,compound-pobj,NNP-NNP,NNP-NNP,4,1
7053,5176.0,21,is,5,2,20,18,1,0,3,15,Niagara Falls High School,USA,---,per,PROPN-PROPN-PROPN-PROPN,PROPN,compound-compound-compound-nsubj,pobj,NNP-NNP-NNP-NNP,NNP,3,1
7054,5177.0,51,are,7,9,18,9,8,32,-2,11,Asianet,Indiavision,,org,PROPN,PROPN,compound,compound,NNP,NNP,4,1
7055,5178.0,22,teaches,5,10,19,9,9,2,-5,14,Emily Carr University of Art and Design,British Columbia,------,per-per,PROPN-PROPN-PROPN-ADP-PROPN-CCONJ-PROPN,PROPN-PROPN,compound-compound-pobj-prep-pobj-cc-conj,compound-compound,NNP-NNP-NNP-IN-NNP-CC-NNP,NNP-NNP,4,1
7056,5179.0,30,impacted,7,2,17,15,1,12,5,10,Australia,Optus,org,,PROPN,PROPN,pobj,nsubj,NNP,NNP,4,1
7057,5180.0,16,earned,1,8,14,6,7,1,-7,13,Stanford University,Daphne Koller,-,per-per,PROPN-PROPN,PROPN-PROPN,compound-pobj,compound-pobj,NNP-NNP,NNP-NNP,6,1
7058,5181.0,16,are,5,1,15,14,0,0,4,10,Sadeq Chubak,Bushehr,org-org,,PROPN-PROPN,PROPN,compound-nsubj,pobj,NNP-NNP,NNP,2,1
7059,5183.0,34,In,0,23,33,10,22,0,-23,33,he,Belize,org,,PRON,PROPN,nsubj,pobj,PRP,NNP,1,1
7060,5185.0,15,lobbied,6,8,10,2,7,4,-2,4,Prime Minister,Shimon Peres,org-org,-,PROPN-PROPN,PROPN-PROPN,compound-compound,compound-dobj,NNP-NNP,NNP-NNP,1,1
7061,5186.0,18,founded,2,5,15,10,4,2,-3,13,1978,Greens,org,,NUM,PROPN,pobj,pobj,CD,NNP,3,1
7062,5188.0,20,returned,1,4,12,8,3,7,-3,11,Venezuela,Juan Vicente,org,-,PROPN,PROPN-PROPN,pobj,compound-pobj,NNP,NNP-NNP,5,1
7063,5189.0,30,reported,28,6,24,18,5,5,22,-4,Pakistan,Shaukat Aziz,per,-,PROPN,PROPN-PROPN,poss,nmod-nmod,NNP,NNP-NNP,10,1
7064,13292.0,22,said,15,11,14,3,10,7,4,-1,Pakistan,Shaukat Aziz,per,-,PROPN,PROPN-PROPN,compound,compound-pobj,NNP,NNP-NNP,2,1
7065,5190.0,19,represented,3,7,17,10,6,1,-4,14,Ontario University Athletics,Guelph Gryphons,per-per-per,-,PROPN-PROPN-PROPN,PROPN-PROPN,compound-compound-pobj,compound-pobj,NNP-NNP-NNP,NNP-NNPS,4,1
7066,5191.0,81,ranked,7,63,64,1,62,16,-56,57,Argentina,Fed Cup,,per-per,PROPN,PROPN-PROPN,compound,compound-compound,NNP,NNP-NNP,2,1
7067,5192.0,60,'',0,7,3,-4,6,56,-7,3,Socialism,Socialist Party of Canada,,org-org-org-org,PROPN,PROPN-PROPN-ADP-PROPN,pobj,compound-pobj-prep-pobj,NNP,NNP-NNP-IN-NNP,1,1
7068,5193.0,15,is,2,8,12,4,7,2,-6,10,Linfield College,Oregon,-,per,PROPN-PROPN,PROPN,compound-pobj,compound,NNP-NNP,NNP,4,1
7069,5194.0,32,protracted,2,14,15,1,13,16,-12,13,President,Laurent Gbagbo,per,-,PROPN,PROPN-PROPN,compound,compound-nsubj,NNP,NNP-NNP,2,1
7070,12911.0,22,movement,2,7,10,3,6,11,-5,8,President,Laurent Gbagbo,org,-,PROPN,PROPN-PROPN,pobj,compound-pobj,NNP,NNP-NNP,5,1
7071,5195.0,12,s,2,1,6,5,0,5,1,4,Albania,Bamir Topi,per,-,PROPN,PROPN-PROPN,nsubj,compound-nsubjpass,NNP,NNP-NNP,3,1
7072,6052.0,44,awarded,6,4,5,1,3,38,2,-1,Albania,Bamir Topi,org,-,PROPN,PROPN-PROPN,pobj,compound-nsubj,NNP,NNP-NNP,1,1
7073,10086.0,21,received,5,17,19,2,16,1,-12,14,Albania,Bamir Topi,,per-per,PROPN,PROPN-PROPN,compound,compound-pobj,NNP,NNP-NNP,2,1
7074,11519.0,33,elected,4,1,6,5,0,26,3,2,Albania,Bamir Topi,per,-,PROPN,PROPN-PROPN,poss,compound-dobj,NNP,NNP-NNP,4,1
7075,13107.0,22,reaffirmed,8,1,5,4,0,16,7,-3,Albania,Bamir Topi,,org-org,PROPN,PROPN-PROPN,poss,compound-appos,NNP,NNP-NNP,3,1
7076,14104.0,47,was,19,30,31,1,29,15,-11,12,Albania,Bamir Topi,,per-per,PROPN,PROPN-PROPN,compound,compound-pobj,NNP,NNP-NNP,1,1
7077,5197.0,24,was,11,1,3,2,0,20,10,-8,Manuel Trucco,Franzani,org-org,,PROPN-PROPN,PROPN,compound-compound,nsubj,NNP-NNP,NNP,3,1
7078,5198.0,39,formed,2,1,14,13,0,24,1,12,Mastodon,Bill Kelliher,org,-,PROPN,PROPN-PROPN,nsubjpass,compound-conj,NNP,NNP-NNP,4,1
7079,5199.0,22,began,1,10,19,9,9,2,-9,18,Sebastian,Ed Banger Records,per,--,PROPN,PROPN-PROPN-PROPN,conj,compound-compound-pobj,NNP,NNP-NNP-NNPS,6,1
7080,5200.0,23,went,1,9,17,8,8,5,-8,16,Ohio,University of Cincinnati College of Law,,org-org-org-org-org-org,PROPN,PROPN-ADP-PROPN-PROPN-ADP-PROPN,pobj,nmod-prep-pobj-pobj-prep-pobj,NNP,NNP-IN-NNP-NNP-IN-NNP,7,1
7081,5201.0,54,said,7,15,23,8,14,30,-8,16,Albuquerque,Domenici,per,,PROPN,PROPN,compound,dobj,NNP,NNP,4,1
7082,5202.0,34,told,2,1,17,16,0,16,1,15,Finland,Patria,,org,PROPN,PROPN,nsubj,nsubj,NNP,NNP,4,1
7083,5203.0,39,Justice,2,5,7,2,4,31,-3,5,Australia,Anthony Mason,,per-per,PROPN,PROPN-PROPN,pobj,compound-nsubj,NNP,NNP-NNP,1,1
7084,5205.0,34,After,0,25,28,3,24,5,-25,28,Robert White,company,-,per,PROPN-PROPN,NOUN,compound-pobj,nsubj,NNP-NNP,NN,3,1
7085,5206.0,57,Making,0,7,19,12,6,37,-7,19,Bermudez,Dancing Wolf,,per-per,PROPN,PROPN-PROPN,nsubj,compound-pobj,NNP,NNP-NNP,6,1
7086,5207.0,43,proposed,27,26,27,1,25,15,1,0,President,Alan,org,,PROPN,PROPN,compound,nsubj,NNP,NNP,1,1
7087,5208.0,22,announced,10,6,13,7,5,8,4,3,Roman Catholic Archdiocese of Philadelphia,school,org-org-org-org-org,,ADJ-ADJ-PROPN-ADP-PROPN,NOUN,compound-compound-nsubj-prep-pobj,nsubj,JJ-JJ-NNP-IN-NNP,NN,4,1
7088,5209.0,15,has,1,1,6,5,0,8,0,5,Dundee,University of Abertay Dundee,,org-org-org-org,PROPN,PROPN-ADP-PROPN-PROPN,nsubj,conj-prep-compound-pobj,NNP,NNP-IN-NNP-NNP,3,1
7089,5210.0,51,promoted,43,35,36,1,34,14,8,-7,VMI,Board of Visitors,org,--,PROPN,PROPN-ADP-PROPN,compound,pobj-prep-pobj,NNP,NNP-IN-NNPS,1,1
7090,5211.0,27,contended,3,7,11,4,6,15,-4,8,Army,27th Division,,org-org,PROPN,ADJ-PROPN,compound,compound-nsubj,NNP,JJ-NNP,4,1
7091,5212.0,27,are,22,1,4,3,0,22,21,-18,Michael McDermott,Chicago,-,per,PROPN-PROPN,PROPN,compound-nsubj,compound,NNP-NNP,NNP,1,1
7092,5213.0,52,is,1,1,16,15,0,35,0,15,Craft,United States,per,-,PROPN,PROPN-PROPN,nsubj,compound-pobj,NNP,NNP-NNP,5,1
7093,5214.0,22,signed,9,5,19,14,4,2,4,10,Delta Air Lines,SkyTeam,per-per-per,,PROPN-PROPN-PROPN,PROPN,compound-compound-pobj,dobj,NNP-NNP-NNP,NNP,11,1
7094,5215.0,37,incorporated,8,15,22,7,14,14,-7,14,Public Enlightenment and Propaganda,Joseph Goebbels,per-per-per-per,-,PROPN-PROPN-CCONJ-PROPN,PROPN-PROPN,compound-pobj-cc-conj,compound-pobj,NNP-NNP-CC-NNP,NNP-NNP,5,1
7095,8819.0,22,refurbished,6,14,20,6,13,1,-8,14,Public Enlightenment and Propaganda,Joseph Goebbels,per-per-per-per,-,PROPN-PROPN-CCONJ-PROPN,PROPN-PROPN,compound-pobj-cc-conj,compound-pobj,NNP-NNP-CC-NNP,NNP-NNP,7,1
7096,5216.0,27,said,25,1,4,3,0,22,24,-21,Kosovo,Bajram Rexhepi,,per-per,PROPN,PROPN-PROPN,compound,compound-nsubj,NNP,NNP-NNP,2,1
7097,10351.0,28,formed,7,4,20,16,3,7,3,13,Kosovo,Bajram Rexhepi,,per-per,PROPN,PROPN-PROPN,poss,compound-conj,NNP,NNP-NNP,7,1
7098,5217.0,23,represented,9,4,17,13,3,5,5,8,Duke University,NCAA,-,per,PROPN-PROPN,PROPN,compound-dobj,compound,NNP-NNP,NNP,6,1
7099,12641.0,21,beat,2,4,15,11,3,5,-2,13,Duke University,NCAA,per-per,,PROPN-PROPN,PROPN,compound-compound,compound,NNP-NNP,NNP,6,1
7100,13593.0,22,represented,9,4,17,13,3,4,5,8,Duke University,NCAA,org-org,,PROPN-PROPN,PROPN,compound-dobj,compound,NNP-NNP,NNP,6,1
7101,5218.0,14,opposed,10,2,5,3,1,8,8,-5,Russ Feingold,Wisconsin,-,org,PROPN-PROPN,PROPN,compound-appos,pobj,NNP-NNP,NNP,1,1
7102,10400.0,52,had,3,30,33,3,29,18,-27,30,Russ Feingold,Wisconsin,per-per,,PROPN-PROPN,PROPN,compound-ccomp,compound,NNP-NNP,NNP,1,1
7103,5219.0,39,expected,2,15,17,2,14,21,-13,15,CDU,Angela Merkel,per,-,PROPN,PROPN-PROPN,compound,compound-nsubj,NNP,NNP-NNP,1,1
7104,5220.0,25,'re,1,21,22,1,20,2,-20,21,actor,Jeff Bridges,,per-per,NOUN,PROPN-PROPN,compound,compound-compound,NN,NNP-NNP,1,1
7105,5221.0,31,had,19,4,18,14,3,12,15,-1,United States,George Washington,-,per-per,PROPN-PROPN,PROPN-PROPN,compound-pobj,compound-pobj,NNP-NNP,NNP-NNP,4,1
7106,5222.0,20,is,3,6,14,8,5,5,-3,11,American,Charles Addams,,per-per,ADJ,PROPN-PROPN,amod,compound-poss,JJ,NNP-NNP,7,1
7107,5223.0,26,denied,3,12,16,4,11,9,-9,13,his,Minister,,org,DET,PROPN,poss,compound,PRP$,NNP,4,1
7108,5224.0,15,developed,6,9,14,5,8,0,-3,8,Ericsson,Sweden,org,,PROPN,PROPN,poss,pobj,NNP,NNP,5,1
7109,5225.0,45,suspended,6,20,26,6,19,18,-14,20,Entertainment Software Rating Board,United States,org-org-org-org,-,PROPN-PROPN-PROPN-PROPN,PROPN-PROPN,compound-compound-compound-pobj,compound-pobj,NNP-NNP-NNP-NNP,NNP-NNP,3,1
7110,5226.0,24,are,2,2,19,17,1,4,0,17,Sugababes,Mutya Buena,,per-per,PROPN,PROPN-PROPN,nsubj,compound-appos,NNPS,NNP-NNP,5,1
7111,5227.0,25,held,5,5,24,19,4,0,0,19,Annie,Norway,,per,PROPN,PROPN,nsubj,pobj,NNP,NNP,-1,1
7112,5229.0,24,enrolled,4,7,7,0,6,16,-3,3,Mount Allison University,Mount Allison Mounties,per-per-per,--,PROPN-PROPN-PROPN,PROPN-PROPN-PROPN,compound-compound-pobj,compound-compound-compound,NNP-NNP-NNP,NNP-NNP-NNP,0,1
7113,5230.0,22,be,3,8,16,8,7,5,-5,13,Kiss,Mark St. John,,per-per-per,ADJ,PROPN-PROPN-PROPN,compound,compound-compound-dobj,JJ,NNP-NNP-NNP,4,1
7114,5231.0,30,takes,15,14,27,13,13,2,1,12,Athol Fugard,South African,per-per,-,PROPN-PROPN,ADJ-ADJ,compound-nsubj,amod-amod,NNP-NNP,JJ-JJ,7,1
7115,12235.0,29,Fugard,1,1,5,4,0,23,0,4,Athol Fugard,South African,-,org-org,PROPN-PROPN,ADJ-ADJ,compound-ROOT,amod-amod,NNP-NNP,JJ-JJ,2,1
7116,5232.0,29,known,7,4,18,14,3,10,3,11,Cougars,University of Houston,,org-org-org,PROPN,PROPN-ADP-PROPN,compound,dobj-prep-pobj,NNP,NNP-IN-NNP,4,1
7117,5234.0,53,known,4,19,23,4,18,29,-15,19,Empire of Japan,Imperial Japanese Navy,--,org-org-org,PROPN-ADP-PROPN,ADJ-ADJ-PROPN,pobj-prep-pobj,amod-amod-compound,NNP-IN-NNP,JJ-JJ-NNP,9,1
7118,5886.0,43,abolished,17,6,22,16,5,20,11,5,Empire of Japan,Imperial Japanese Navy,--,org-org-org,PROPN-ADP-PROPN,ADJ-ADJ-PROPN,pobj-prep-pobj,amod-amod-pobj,NNP-IN-NNP,JJ-JJ-NNP,8,1
7119,11088.0,24,was,1,8,18,10,7,5,-7,17,Empire of Japan,Imperial Japanese Navy,org-org-org,--,PROPN-ADP-PROPN,PROPN-ADJ-PROPN,pobj-prep-pobj,amod-amod-pobj,NNP-IN-NNP,NNP-JJ-NNP,9,1
7120,11697.0,30,built,16,8,14,6,7,15,8,-2,Empire of Japan,Imperial Japanese Navy,per-per-per,--,PROPN-ADP-PROPN,PROPN-PROPN-PROPN,pobj-prep-pobj,amod-amod-nsubj,NNP-IN-NNP,NNP-NNP-NNP,7,1
7121,5235.0,40,Led,0,5,21,16,4,18,-5,21,Jonathan Morduch,Initiative,-,per,PROPN-PROPN,PROPN,compound-pobj,nsubj,NNP-NNP,NNP,-1,1
7122,5237.0,29,said,27,6,11,5,5,17,21,-16,Nigeria,Ibrahim Babangida,,org-org,PROPN,PROPN-PROPN,poss,compound-appos,NNP,NNP-NNP,3,1
7123,11869.0,27,was,5,13,25,12,12,1,-8,20,Nigeria,Ibrahim Babangida,per,-,PROPN,PROPN-PROPN,pobj,compound-pobj,NNP,NNP-NNP,5,1
7124,5238.0,33,started,1,9,9,0,8,23,-8,8,Kent and Sussex Courier,Kent,per-per-per-per,,PROPN-CCONJ-PROPN-PROPN,PROPN,conj-cc-compound-compound,compound,NNP-CC-NNP-NNP,NNP,0,1
7125,5239.0,30,had,13,19,26,7,18,3,-6,13,Joseph Cook,New South Wales,-,per-per-per,PROPN-PROPN,PROPN-PROPN-PROPN,compound-conj,compound-compound-compound,NNP-NNP,NNP-NNP-NNP,7,1
7126,5240.0,41,said,11,5,10,5,4,30,6,-1,Frank Knox,Navy,-,org,PROPN-PROPN,PROPN,compound-compound,pobj,NNP-NNP,NNP,5,1
7127,11080.0,42,asked,6,8,14,6,7,27,-2,8,Frank Knox,Navy,-,per,PROPN-PROPN,PROPN,compound-dobj,pobj,NNP-NNP,NNP,3,1
7128,5241.0,18,produced,2,5,8,3,4,9,-3,6,Brett Gurewitz,Bad Religion,-,org-org,PROPN-PROPN,PROPN-PROPN,compound-pobj,compound-compound,NNP-NNP,NNP-NNP,3,1
7129,5242.0,19,born,3,1,17,16,0,1,2,14,Aram Khachaturian,Armenian,-,org,PROPN-PROPN,ADJ,compound-nsubjpass,amod,NNP-NNP,JJ,3,1
7130,5243.0,24,took,1,1,21,20,0,2,0,20,Nickelodeon,Viacom,org,,PROPN,PROPN,nsubj,pobj,NNP,NNP,9,1
7131,5244.0,23,visiting,2,4,21,17,3,1,-2,19,Paris,Jacques Chirac,per,-,PROPN,PROPN-PROPN,poss,compound-conj,NNP,NNP-NNP,7,1
7132,7445.0,58,is,10,9,25,16,8,32,1,15,Paris,Jacques Chirac,,per-per,PROPN,PROPN-PROPN,pobj,compound-pobj,NNP,NNP-NNP,8,1
7133,14162.0,32,deciding,4,1,19,18,0,12,3,15,Paris,Jacques Chirac,per,-,PROPN,PROPN-PROPN,compound,compound-conj,NNP,NNP-NNP,8,1
7134,5245.0,14,was,2,9,12,3,8,1,-7,10,Takeru Kobayashi,Nagano,org-org,,PROPN-PROPN,PROPN,compound-appos,compound,NNP-NNP,NNP,2,1
7135,5246.0,30,was,1,1,8,7,0,21,0,7,He,Rhythm Devils,,org-org,PRON,PROPN-PROPN,nsubj,compound-pobj,PRP,NNP-NNP,3,1
7136,5247.0,27,said,1,1,22,21,0,4,0,21,Ryanair,Dublin,,per,NOUN,PROPN,nsubj,pobj,NN,NNP,11,1
7137,5248.0,20,grew,1,14,19,5,13,0,-13,18,Perse School for Girls,Cambridge,---,per,PROPN-PROPN-ADP-PROPN,PROPN,compound-pobj-prep-pobj,pobj,NNP-NNP-IN-NNP,NNP,4,1
7138,5250.0,45,indicated,3,2,19,17,1,25,1,16,Johannes Rau,Chancellor,per-per,,PROPN-PROPN,PROPN,compound-nsubj,compound,NNP-NNP,NNP,6,1
7139,5251.0,22,represented,7,3,3,0,2,18,4,-4,Oklahoma State Cowboys,Oklahoma State University,--,per-per-per,PROPN-PROPN-PROPN,PROPN-PROPN-PROPN,compound-compound-compound,compound-compound-dobj,NNP-NNP-NNPS,NNP-NNP-NNP,0,1
7140,7056.0,21,represented,7,3,3,0,2,17,4,-4,Oklahoma State Cowboys,Oklahoma State University,--,org-org-org,PROPN-PROPN-PROPN,PROPN-PROPN-PROPN,compound-compound-compound,compound-compound-dobj,NNP-NNP-NNPS,NNP-NNP-NNP,0,1
7141,10350.0,22,represented,7,3,3,0,2,18,4,-4,Oklahoma State Cowboys,Oklahoma State University,per-per-per,--,PROPN-PROPN-PROPN,PROPN-PROPN-PROPN,compound-compound-compound,compound-compound-dobj,NNP-NNP-NNPS,NNP-NNP-NNP,0,1
7142,5252.0,25,was,6,20,21,1,19,3,-14,15,Canada,Sir John,,per-per,PROPN,PROPN-PROPN,pobj,compound-compound,NNP,NNP-NNP,2,1
7143,5253.0,18,refers,3,11,16,5,10,1,-8,13,Australia,John Curtin,,per-per,PROPN,PROPN-PROPN,pobj,compound-pobj,NNP,NNP-NNP,2,1
7144,8523.0,20,Named,0,8,9,1,7,10,-8,9,Australia,John Curtin,,org-org,PROPN,PROPN-PROPN,pobj,compound-appos,NNP,NNP-NNP,1,1
7145,5257.0,43,began,7,17,24,7,16,18,-10,17,The Academy Is . .,William Beckett,org-org-org-org-org,-,DET-PROPN-VERB-PUNCT-PUNCT,PROPN-PROPN,det-conj-ROOT-punct-punct,compound-ROOT,DT-NNP-VBZ-.-.,NNP-NNP,-1,1
7146,5258.0,19,born,2,1,10,9,0,8,1,8,Oramas,Cuba,org,,PROPN,PROPN,nsubjpass,pobj,NNP,NNP,5,1
7147,5260.0,18,report,4,4,6,2,3,11,0,2,NHK,Japan,per,,PROPN,PROPN,compound,nsubj,NNP,NNP,2,1
7148,5261.0,34,carrying,3,15,29,14,14,4,-12,26,teacher,Christa McAuliffe,org,-,NOUN,PROPN-PROPN,appos,compound-dobj,NN,NNP-NNP,9,1
7149,5262.0,63,were,8,37,51,14,36,11,-29,43,e Gheorghe Gheorghiu-De,f Romani,--,per-per,DET-VERB-NOUN,PROPN-PROPN,compound-compound-compound,det-nsubj,DT-VBN-NN,NNP-NNP,-1,1
7150,5263.0,34,given,7,18,28,10,17,5,-11,21,Berkshire Hathaway,Warren Buffett,per-per,-,PROPN-PROPN,PROPN-PROPN,compound-compound,compound-pobj,NNP-NNP,NNP-NNP,5,1
7151,5264.0,38,appointed,4,28,34,6,27,3,-24,30,South Africa,Prince Arthur of Connaught,-,org-org-org-org,PROPN-PROPN,PROPN-PROPN-ADP-PROPN,compound-pobj,compound-appos-prep-pobj,NNP-NNP,NNP-NNP-IN-NNP,8,1
7152,5265.0,37,said,17,19,26,7,18,10,-2,9,Jim Whitaker,Fairbanks North Star Borough,per-per,---,PROPN-PROPN,PROPN-PROPN-PROPN-PROPN,compound-nsubj,compound-compound-compound-pobj,NNP-NNP,NNP-NNP-NNP-NNP,4,1
7153,5266.0,36,began,10,28,34,6,27,1,-18,24,Spectrum,United Cable,org,-,PROPN,PROPN-PROPN,compound,compound-pobj,NNP,NNP-NNP,3,1
7154,5268.0,37,found,2,1,23,22,0,13,1,21,She,Johnny Cash,per,-,PRON,PROPN-PROPN,nsubj,compound-appos,PRP,NNP-NNP,10,1
7155,5271.0,35,number,2,9,12,3,8,22,-7,10,Bates College,Maine,per-per,,PROPN-PROPN,PROPN,compound-pobj,compound,NNP-NNP,NNP,3,1
7156,5273.0,43,is,5,1,5,4,0,37,4,0,Alliance Atlantis,Toronto,per-per,,PROPN-PROPN,PROPN,compound-nsubj,pobj,NNP-NNP,NNP,1,1
7157,5275.0,30,presented,9,6,21,15,5,8,3,12,host,Cat Deeley,org,-,NOUN,PROPN-PROPN,dobj,compound-compound,NN,NNP-NNP,6,1
7158,5277.0,29,has,2,2,14,12,1,14,0,12,McConnell,Kentucky,per,,PROPN,PROPN,nsubj,pobj,NNP,NNP,5,1
7159,10191.0,25,born,2,1,12,11,0,12,1,10,McConnell,Kentucky,org,,PROPN,PROPN,nsubjpass,pobj,NNP,NNP,5,1
7160,11910.0,38,amounted,2,9,16,7,8,21,-7,14,McConnell,Kentucky,org,,PROPN,PROPN,poss,compound,NNP,NNP,8,1
7161,5278.0,26,located,18,11,22,11,10,3,7,4,Madras Christian College,Chennai,per-per-per,,PROPN-PROPN-PROPN,PROPN,compound-compound-nsubjpass,compound,NNP-NNP-NNP,NNP,-1,1
7162,5279.0,25,decided,9,7,24,17,6,0,2,15,Bueno,Argentina,org,,PROPN,PROPN,poss,pobj,NNP,NNP,15,1
7163,5280.0,29,defeated,2,15,27,12,14,1,-13,25,Churchill Cup,Ireland,org-org,,PROPN-PROPN,PROPN,compound-compound,compound,NNP-NNP,NNP,9,1
7164,5281.0,43,band,5,1,8,7,0,34,4,3,Junior Campbell,Marmalade,-,org,PROPN-PROPN,PROPN,compound-nsubj,dobj,NNP-NNP,NNP,2,1
7165,5283.0,30,is,2,8,17,9,7,12,-6,15,Building Society,Norwich and Peterborough Building Society,org-org,----,PROPN-PROPN,PROPN-CCONJ-PROPN-PROPN-PROPN,compound-compound,appos-cc-compound-compound-compound,NNP-NNP,NNP-CC-NNP-NNP-NNP,8,1
7166,11895.0,30,is,2,8,20,12,7,9,-6,18,Building Society,Norwich and Peterborough Building Society,org-org,----,PROPN-PROPN,PROPN-CCONJ-PROPN-PROPN-PROPN,compound-compound,pobj-cc-compound-compound-conj,NNP-NNP,NNP-CC-NNP-NNP-NNP,8,1
7167,5284.0,63,killed,25,10,55,45,9,7,15,30,the Broadway,New York,-,per-per,DET-PROPN,PROPN-PROPN,det-compound,compound-pobj,DT-NNP,NNP-NNP,11,1
7168,5285.0,26,was,1,21,22,1,20,3,-20,21,Slovakia,Michal,,per,PROPN,PROPN,compound,pobj,NNP,NNP,2,1
7169,5286.0,16,founded,4,1,1,0,0,14,3,-3,Boise State University,Boise,--,org,PROPN-PROPN-PROPN,PROPN,compound-compound-nsubjpass,compound,NNP-NNP-NNP,NNP,0,1
7170,5288.0,20,'re,1,9,12,3,8,7,-8,11,Marshall Islands,Litokwa Tomeing,-,per-per,PROPN-PROPN,PROPN-PROPN,compound-compound,compound-dobj,NNP-NNP,NNP-NNP,2,1
7171,9441.0,25,appears,7,2,6,4,1,18,5,-1,Marshall Islands,Litokwa Tomeing,-,org-org,PROPN-PROPN,PROPN-PROPN,nmod-nmod,compound-nsubj,NNP-NNP,NNP-NNP,2,1
7172,5289.0,8,born,3,1,7,6,0,0,2,4,Giorgio Napolitano,Italy,-,per,PROPN-PROPN,PROPN,compound-nsubjpass,pobj,NNP-NNP,NNP,2,1
7173,8284.0,21,issued,6,1,5,4,0,15,5,-1,Giorgio Napolitano,Italy,per-per,,PROPN-PROPN,PROPN,compound-compound,pobj,NNP-NNP,NNP,3,1
7174,5290.0,20,is,2,1,17,16,0,2,1,15,Speakeasy,Washington,per,,PROPN,PROPN,compound,compound,NNP,NNP,8,1
7175,5291.0,10,Sandiford,3,2,7,5,1,2,1,4,Lloyd Erskine Sandiford,Sir,--,per,PROPN-PROPN-PROPN,PROPN,compound-compound-ROOT,compound,NNP-NNP-NNP,NNP,3,1
7176,5292.0,17,is,3,11,16,5,10,0,-8,13,Michael Kiske,Helloween,org-org,,PROPN-PROPN,PROPN,compound-conj,pobj,NNP-NNP,NNP,6,1
7177,5294.0,57,born,2,13,14,1,12,42,-11,12,Airdrie,Scotland,per,,PROPN,PROPN,compound,pobj,NNP,NNP,5,1
7178,5295.0,25,established,3,13,20,7,12,4,-10,17,Rachel Yanait,Yitzhak Ben-Zvi,org-org,-,PROPN-PROPN,PROPN-PROPN,compound-compound,compound-pobj,NNP-NNP,NNP-NNP,5,1
7179,5296.0,25,BKC-LEMOYNE,0,3,10,7,2,14,-3,10,Syracuse,Le Moyne College,,per-per-per,PROPN,PROPN-PROPN-PROPN,compound,compound-compound-nsubj,NNP,NNP-NNP-NNP,-1,1
7180,5297.0,9,won,4,1,2,1,0,6,3,-2,Democrat,Alan J. Dixon,per,--,PROPN,PROPN-PROPN-PROPN,compound,compound-compound-nsubj,NNP,NNP-NNP-NNP,2,1
7181,5298.0,4,University,2,1,2,1,0,1,1,0,Seoul,National University,,org-org,PROPN,PROPN-PROPN,compound,compound-ROOT,NNP,NNP-NNP,1,1
7182,5299.0,26,sold,7,5,24,19,4,1,2,17,Ozzy Osbourne,Black Sabbath,per-per,-,PROPN-PROPN,PROPN-PROPN,compound-nsubj,compound-pobj,NNP-NNP,NNP-NNP,5,1
7183,5300.0,12,attended,1,3,7,4,2,4,-2,6,Mesa High School,Arizona,per-per-per,,PROPN-PROPN-PROPN,PROPN,compound-compound-dobj,pobj,NNP-NNP-NNP,NNP,3,1
7184,5301.0,32,said,3,2,14,12,1,17,1,11,Mikheil Saakashvili,Georgia,per-per,,PROPN-PROPN,PROPN,compound-nsubj,pobj,NNP-NNP,NNP,4,1
7185,5302.0,31,union,4,10,30,20,9,0,-6,26,Brotherhood of Locomotive Engineers,1863,org-org-org-org,,PROPN-ADP-PROPN-PROPN,NUM,dobj-prep-compound-pobj,pobj,NNP-IN-NNP-NNPS,CD,3,1
7186,5303.0,30,was,2,8,13,5,7,16,-6,11,V2 Records,band,org-org,,PROPN-PROPN,NOUN,compound-pobj,nsubj,NNP-NNPS,NN,2,1
7187,5304.0,45,moved,16,7,37,30,6,7,9,21,Ohio,Northwest High School,,per-per-per,PROPN,PROPN-PROPN-PROPN,pobj,compound-compound-compound,NNP,NNP-NNP-NNP,11,1
7188,5305.0,26,said,23,21,22,1,20,3,2,-1,Chancellor,Angela Merkel,org,-,PROPN,PROPN-PROPN,compound,compound-nsubj,NNP,NNP-NNP,1,1
7189,5307.0,44,Magistrate,2,14,22,8,13,21,-12,20,Quanta Computer,Taiwan,-,per,PROPN-PROPN,PROPN,subtok-subtok,compound,NNP-NNP,NNP,-1,1
7190,5308.0,36,Jr.,3,30,34,4,29,1,-27,31,Northwestern State University,Natchitoches,per-per-per,,PROPN-PROPN-PROPN,PROPN,compound-compound-pobj,compound,NNP-NNP-NNP,NNP,2,1
7191,8215.0,35,Director,3,12,16,4,11,18,-9,13,Northwestern State University,Natchitoches,per-per-per,,PROPN-PROPN-PROPN,PROPN,compound-compound-ROOT,pobj,NNP-NNP-NNP,NNP,9,1
7192,5309.0,22,retired,1,1,20,19,0,1,0,19,She,Frederick County,per,-,PRON,PROPN-PROPN,nsubj,compound-pobj,PRP,NNP-NNP,11,1
7193,5310.0,38,Jones's,0,22,33,11,21,4,-22,33,Stax,Rufus Thomas,org,-,PROPN,PROPN-PROPN,attr,compound-pobj,NNP,NNP-NNP,-1,1
7194,9492.0,20,was,3,7,1,-6,6,18,-4,-2,Stax,Rufus Thomas,org,-,PROPN,PROPN-PROPN,compound,compound-pobj,NNP,NNP-NNP,5,1
7195,13759.0,49,became,1,18,30,12,17,18,-17,29,Stax,Rufus Thomas,org,-,PROPN,PROPN-PROPN,pobj,compound-compound,NNP,NNP-NNP,5,1
7196,5311.0,39,bidding,2,1,9,8,0,29,1,7,Griffin,England,per,,PROPN,PROPN,nsubj,pobj,NNP,NNP,2,1
7197,5312.0,14,had,1,7,12,5,6,1,-6,11,Quinebaug Valley Community College,Danielson,org-org-org-org,,PROPN-PROPN-PROPN-PROPN,PROPN,compound-compound-compound-pobj,compound,NNP-NNP-NNP-NNP,NNP,2,1
7198,5314.0,50,said,7,21,24,3,20,25,-14,17,Plaid Cymru,Ieuan Wyn Jones,-,per-per-per,PROPN-PROPN,PROPN-PROPN-PROPN,compound-compound,compound-compound-nsubj,NNP-NNP,NNP-NNP-NNP,3,1
7199,5315.0,43,Bernardino,5,2,8,6,1,34,3,3,California State University,CSUSB,org-org-org,,PROPN-PROPN-PROPN,PROPN,compound-compound-compound,appos,NNP-NNP-NNP,NNP,4,1
7200,5316.0,22,created,5,5,7,2,4,14,0,2,Eddie,Untouchables Entertainment,org,-,PROPN,PROPN-PROPN,nsubj,compound-dobj,NNP,NNP-NNP,1,1
7201,5318.0,45,included,6,11,32,21,10,12,-5,26,Antoinette Spaak,Belgium,org-org,,PROPN-PROPN,PROPN,compound-dobj,pobj,NNP-NNP,NNP,8,1
7202,5319.0,22,returned,4,4,18,14,3,3,0,14,Thanom,Bangkok,org,,PROPN,PROPN,nsubj,poss,NNP,NNP,9,1
7203,5321.0,40,formed,9,15,25,10,14,14,-6,16,Excelsior Recordings,Caesar,per-per,,PROPN-PROPN,PROPN,compound-nsubj,compound,NNP-NNP,NNP,11,1
7204,5323.0,45,sided,5,1,4,3,0,40,4,-1,Sun,Soong Ching-ling,per,-,PROPN,PROPN-PROPN,poss,compound-nsubj,NNP,NNP-NNP,5,1
7205,5324.0,64,were,9,7,27,20,6,36,2,18,Canada,TransAlta,per,,PROPN,PROPN,pobj,conj,NNP,NNP,8,1
7206,5325.0,47,seen,3,25,28,3,24,18,-22,25,Phil Selway,Radiohead,-,per,PROPN-PROPN,PROPN,compound-conj,pobj,NNP-NNP,NNP,2,1
7207,5326.0,61,went,2,1,24,23,0,36,1,22,Nothing Records,Marilyn Manson,org-org,-,NOUN-PROPN,PROPN-PROPN,compound-nsubj,compound-pobj,NN-NNPS,NNP-NNP,5,1
7208,5327.0,60,abandoned,8,7,7,0,6,52,1,-1,San Francisco State Normal School,San Francisco State University,----,per-per-per-per,PROPN-PROPN-PROPN-PROPN-PROPN,PROPN-PROPN-PROPN-PROPN,compound-compound-compound-compound-pobj,compound-compound-compound-conj,NNP-NNP-NNP-NNP-NNP,NNP-NNP-NNP-NNP,0,1
7209,5329.0,30,was,4,17,18,1,16,11,-13,14,actress,Jana,,per,NOUN,PROPN,compound,compound,NN,NNP,1,1
7210,5330.0,16,kick-started,6,5,13,8,4,2,1,7,Dale Chihuly,Washington,org-org,,PROPN-PROPN,PROPN,compound-pobj,compound,NNP-NNP,NNP,5,1
7211,5334.0,19,joined,3,3,6,3,2,12,0,3,Boltzmann,University of Vienna,org,--,PROPN,PROPN-ADP-PROPN,nsubj,dobj-prep-pobj,NNP,NNP-IN-NNP,2,1
7212,5335.0,21,found,1,7,20,13,6,0,-6,19,15th division,Prussia,-,per,ADJ-NOUN,PROPN,amod-pobj,pobj,JJ-NN,NNP,4,1
7213,5336.0,34,inducted,5,3,9,6,2,24,2,4,Sammy Kershaw,Louisiana,-,org,PROPN-PROPN,PROPN,compound-nsubjpass,compound,NNP-NNP,NNP,4,1
7214,5337.0,83,was,3,28,2,-26,27,80,-25,-1,9th Wonder,Justus League,-,per-per,NOUN-NOUN,PROPN-PROPN,nsubj-compound,compound-pobj,NN-NN,NNP-NNP,-1,1
7215,5338.0,33,cancelled,6,3,3,0,2,29,3,-3,China,China Southern Airlines,,per-per-per,PROPN,PROPN-PROPN-PROPN,compound,compound-compound-nsubj,NNP,NNP-NNP-NNPS,0,1
7216,5339.0,31,is,9,1,1,0,0,29,8,-8,Oak Park and River Forest High School,Oak Park,org-org-org-org-org-org-org,-,PROPN-PROPN-CCONJ-PROPN-PROPN-PROPN-PROPN,PROPN-PROPN,compound-nsubj-cc-compound-compound-compound-conj,compound-compound,NNP-NNP-CC-NNP-NNP-NNP-NNP,NNP-NNP,0,1
7217,10898.0,41,Prior,0,19,19,0,18,21,-19,19,Oak Park and River Forest High School,Oak Park,org-org-org-org-org-org-org,-,PROPN-PROPN-CCONJ-PROPN-PROPN-PROPN-PROPN,PROPN-PROPN,compound-conj-cc-compound-compound-compound-conj,compound-compound,NNP-NNP-CC-NNP-NNP-NNP-NNP,NNP-NNP,0,1
7218,5341.0,46,appointed,4,7,19,12,6,26,-3,15,Ohio,Rutherford B. Hayes,per,--,PROPN,PROPN-PROPN-PROPN,compound,compound-compound-poss,NNP,NNP-NNP-NNP,6,1
7219,5342.0,17,operates,1,11,16,5,10,0,-10,15,Henry Moore,England,-,per,PROPN-PROPN,PROPN,compound-compound,pobj,NNP-NNP,NNP,5,1
7220,12119.0,12,studied,2,8,11,3,7,0,-6,9,Henry Moore,England,per-per,,PROPN-PROPN,PROPN,compound-pobj,pobj,NNP-NNP,NNP,3,1
7221,5343.0,20,born,3,15,17,2,14,2,-12,14,Margaret Beaufort,Countess,per-per,,PROPN-PROPN,PROPN,compound-compound,pobj,NNP-NNP,NNP,1,1
7222,5344.0,66,declared,7,40,45,5,39,20,-33,38,Jordin Sparks,Arizona,org-org,,PROPN-PROPN,PROPN,compound-nsubj,pobj,NNP-NNP,NNP,2,1
7223,5345.0,22,merged,6,4,9,5,3,12,2,3,Bank,National Bank of Greece,per,---,PROPN,PROPN-PROPN-ADP-PROPN,nsubj,compound-pobj-prep-pobj,NNP,NNP-NNP-IN-NNP,4,1
7224,10703.0,43,are,27,5,8,3,4,34,22,-19,Bank,National Bank of Greece,,per-per-per-per,PROPN,PROPN-PROPN-ADP-PROPN,pobj,compound-pobj-prep-pobj,NNP,NNP-NNP-IN-NNP,1,1
7225,5346.0,40,said,14,1,13,12,0,26,13,-1,Thomson Reuters,New York,org-org,-,PROPN-PROPN,PROPN-PROPN,compound-nsubj,compound-pobj,NNP-NNP,NNP-NNP,5,1
7226,9724.0,22,has,8,1,7,6,0,14,7,-1,Thomson Reuters,New York,-,per-per,PROPN-PROPN,PROPN-PROPN,compound-nsubj,compound-pobj,NNP-NNP,NNP-NNP,3,1
7227,10887.0,18,has,8,1,7,6,0,10,7,-1,Thomson Reuters,New York,per-per,-,PROPN-PROPN,PROPN-PROPN,compound-nsubj,compound-pobj,NNP-NNP,NNP-NNP,3,1
7228,5348.0,34,is,9,2,8,6,1,25,7,-1,Defence Research and Development Organisation,DRDO,per-per-per-per-per,,PROPN-PROPN-CCONJ-PROPN-PROPN,PROPN,nmod-nmod-cc-conj-nsubj,appos,NNP-NNP-CC-NNP-NNP,NNP,3,1
7229,5349.0,27,owns,3,1,9,8,0,17,2,6,Providence Equity Partners,Newport Television,per-per-per,-,PROPN-PROPN-PROPN,PROPN-PROPN,compound-compound-nsubj,compound-pobj,NNP-NNP-NNPS,NNP-NNP,5,1
7230,5350.0,18,born,2,5,12,7,4,5,-3,10,California,Beau Bridges,per,-,PROPN,PROPN-PROPN,pobj,compound-pobj,NNP,NNP-NNPS,4,1
7231,5351.0,25,tipped,10,16,7,-9,15,17,-6,-3,Jamie Childers,Towson Tigers,per-per,-,PROPN-PROPN,PROPN-PROPN,compound-nsubj,compound-pobj,NNP-NNPS,NNP-NNP,6,1
7232,5352.0,60,has,9,1,6,5,0,53,8,-3,Sari Nusseibeh,al-Quds University,per-per,-,PROPN-PROPN,PROPN-PROPN,compound-nsubj,compound-pobj,NNP-NNP,NNP-NNP,5,1
7233,5353.0,20,was,2,1,9,8,0,10,1,7,ADC Airlines,Aviation Development Company,-,per-per-per,PROPN-PROPN,PROPN-PROPN-PROPN,compound-nsubj,compound-compound-compound,NNP-NNPS,NNP-NNP-NNP,6,1
7234,5354.0,39,committed,1,1,10,9,0,28,0,9,He,England,per,,PRON,PROPN,nsubj,pobj,PRP,NNP,1,1
7235,9045.0,32,reached,1,1,19,18,0,12,0,18,He,England,,per,PRON,PROPN,nsubj,nsubj,PRP,NNP,6,1
7236,10949.0,16,was,1,1,11,10,0,4,0,10,He,England,,org,PRON,PROPN,nsubj,pobj,PRP,NNP,2,1
7237,5356.0,25,began,6,16,21,5,15,3,-10,15,Mike Gordon,Spenard,per-per,,PROPN-PROPN,PROPN,compound-pobj,compound,NNP-NNP,NNP,6,1
7238,5357.0,47,came,1,11,32,21,10,14,-10,31,Nova,Osaka,,org,PROPN,PROPN,pobj,pobj,NNP,NNP,8,1
7239,5359.0,57,are,13,29,41,12,28,15,-16,28,Bundeswehr,Luftwaffe,,per,PROPN,PROPN,nsubjpass,ROOT,NNP,NNP,3,1
7240,5360.0,28,is,1,1,8,7,0,19,0,7,TAT,London,,org,PROPN,PROPN,nsubj,compound,NNP,NNP,3,1
7241,5361.0,30,terminated,14,8,8,0,7,21,6,-6,Paris,Paris Centre,,per-per,PROPN,PROPN-PROPN,compound,compound-conj,NNP,NNP-NNP,0,1
7242,5363.0,34,purchased,5,9,19,10,8,14,-4,14,Go-Ahead Group,Southeastern,per-per,,PROPN-PROPN,PROPN,compound-nmod,amod,NNP-NNP,NNP,7,1
7243,5364.0,29,said,16,24,28,4,23,0,-8,12,DnB NOR,Oslo,-,per,NOUN-CCONJ,PROPN,compound-compound,pobj,NN-CC,NNP,4,1
7244,5367.0,38,were,2,2,15,13,1,22,0,13,Revols,Richard Manuel,per,-,PROPN,PROPN-PROPN,nsubj,compound-pobj,NNPS,NNP-NNP,4,1
7245,5368.0,38,is,7,1,34,33,0,3,6,27,UCL,England,org,,PROPN,PROPN,poss,pobj,NNP,NNP,12,1
7246,5369.0,33,seems,1,4,24,20,3,8,-3,23,Uriburu,Argentina,per,,PROPN,PROPN,nsubj,pobj,NNPS,NNP,4,1
7247,5370.0,29,included,2,22,27,5,21,1,-20,25,de Trabajadores de Venezuela,CTV,per-per-per-per,,ADP-PROPN-PROPN-PROPN,PROPN,nmod-compound-compound-conj,appos,IN-NNP-NNP-NNP,NNP,3,1
7248,5371.0,43,getting,9,1,2,1,0,40,8,-7,Singer,Andy Bell,,org-org,PROPN,PROPN-PROPN,compound,compound-nsubj,NNP,NNP-NNP,1,1
7249,5372.0,18,donated,6,5,12,7,4,5,1,6,park,Vladivostok,org,,NOUN,PROPN,pobj,pobj,NN,NNP,5,1
7250,5373.0,31,is,14,6,26,20,5,4,8,12,Joseph Pairin Kitingan,Sabah,per-per-per,,PROPN-PROPN-PROPN,PROPN,compound-compound-nsubj,pobj,NNP-NNP-NNP,NNP,6,1
7251,8345.0,36,joined,32,19,29,10,18,6,13,-3,Joseph Pairin Kitingan,Sabah,per-per-per,,PROPN-PROPN-PROPN,PROPN,compound-compound-pobj,pobj,NNP-NNP-NNP,NNP,5,1
7252,5374.0,21,is,16,1,13,12,0,7,15,-3,An?ej De?,4; Sloven,-,per-per,PROPN-PROPN,NUM-PROPN,punct-nsubj,compound-pobj,NNP-NNP,CD-NNP,-1,1
7253,5375.0,31,were,5,5,22,17,4,8,0,17,Australia,Alfred Deakin,org,-,PROPN,PROPN-PROPN,pobj,compound-pobj,NNP,NNP-NNP,6,1
7254,6667.0,26,was,2,8,15,7,7,10,-6,13,Australia,Alfred Deakin,org,-,PROPN,PROPN-PROPN,pobj,compound-nsubj,NNP,NNP-NNP,3,1
7255,6764.0,29,included,6,16,21,5,15,7,-10,15,Australia,Alfred Deakin,per,-,PROPN,PROPN-PROPN,pobj,compound-compound,NNP,NNP-NNP,2,1
7256,5376.0,32,Title,0,25,26,1,24,5,-25,26,CA,United States,per,-,PROPN,PROPN-PROPN,compound,compound-nsubj,NNP,NNP-NNP,1,1
7257,5944.0,23,Title,0,16,17,1,15,5,-16,17,CA,United States,org,-,PROPN,PROPN-PROPN,compound,compound-nsubj,NNP,NNP-NNP,1,1
7258,5377.0,24,is,9,2,4,2,1,19,7,-5,University of Chittagong,Chittagong University,per-per-per,-,PROPN-ADP-PROPN,PROPN-PROPN,nsubj-prep-pobj,compound-compound,NNP-IN-NNP,NNP-NNP,3,1
7259,5379.0,37,held,9,17,19,2,16,17,-8,10,Prime Minister,Prachanda,org-org,,PROPN-PROPN,PROPN,compound-compound,pobj,NNP-NNP,NNP,2,1
7260,12627.0,42,said,21,19,21,2,18,20,2,0,Prime Minister,Prachanda,org-org,,PROPN-PROPN,PROPN,compound-compound,nsubj,NNP-NNP,NNP,2,1
7261,5380.0,40,include,5,30,34,4,29,5,-25,29,Dortmund University of Technology,Germany,per-per-per-per,,PROPN-PROPN-ADP-PROPN,PROPN,nmod-nmod-prep-pobj,conj,NNP-NNP-IN-NNP,NNP,2,1
7262,5381.0,76,lived,3,9,14,5,8,61,-6,11,Smith Thompson,Navy,org-org,,PROPN-PROPN,PROPN,compound-pobj,pobj,NNP-NNP,NNP,2,1
7263,5864.0,37,showed,1,9,21,12,8,15,-8,20,Smith Thompson,Navy,-,per,PROPN-PROPN,PROPN,compound-nsubjpass,compound,NNP-NNP,NNP,4,1
7264,13663.0,18,was,8,3,17,14,2,0,5,9,Smith Thompson,Navy,per-per,,PROPN-PROPN,PROPN,compound-nsubj,pobj,NNP-NNP,NNP,5,1
7265,5382.0,36,told,11,5,10,5,4,25,6,-1,National Development and Reform Commission,Zhang Ping,org-org-org-org-org,-,PROPN-PROPN-CCONJ-PROPN-PROPN,PROPN-PROPN,nmod-nmod-cc-conj-compound,compound-pobj,NNP-NNP-CC-NNP-NNP,NNP-NNP,2,1
7266,5384.0,26,is,3,9,9,0,8,16,-6,6,Fifth Third Bancorp,Fifth Third Bank,--,org-org-org,PROPN-PROPN-PROPN,PROPN-PROPN-PROPN,compound-compound-pobj,compound-compound-attr,NNP-NNP-NNP,NNP-NNP-NNP,0,1
7267,5385.0,40,Like,0,18,23,5,17,16,-18,23,Iftekhar,actor,,org,PROPN,NOUN,nsubj,attr,NNP,NN,3,1
7268,5386.0,25,is,1,1,10,9,0,14,0,9,Flipper,California,,org,NOUN,PROPN,nsubj,pobj,NN,NNP,3,1
7269,5387.0,22,was,11,1,19,18,0,2,10,8,Giulio Andreotti,Christian Democracy,per-per,-,PROPN-PROPN,PROPN-PROPN,compound-nsubj,compound-compound,NNP-NNP,NNP-NNP,5,1
7270,5388.0,16,played,2,1,14,13,0,1,1,12,It,United States,,per-per,PRON,PROPN-PROPN,nsubjpass,compound-pobj,PRP,NNP-NNP,5,1
7271,10036.0,31,republished,4,1,8,7,0,22,3,4,It,United States,per,-,PRON,PROPN-PROPN,nsubjpass,compound-pobj,PRP,NNP-NNP,3,1
7272,5389.0,47,revealed,9,1,5,4,0,41,8,-4,Shuhei Yoshida,Sony Computer Entertainment,per-per,--,PROPN-PROPN,PROPN-PROPN-PROPN,compound-compound,compound-compound-compound,NNP-NNP,NNP-NNP-NNP,5,1
7273,5390.0,39,Li,0,17,37,20,16,1,-17,37,China,Wu Guanzhong,org,-,PROPN,PROPN-PROPN,pobj,compound-pobj,NNP,NNP-NNP,-1,1
7274,5391.0,31,placed,1,24,26,2,23,4,-23,25,Schule Schloss Salem,Salem,org-org-org,,PROPN-PROPN-PROPN,PROPN,compound-compound-pobj,pobj,NNP-NNP-NNP,NNP,2,1
7275,5392.0,16,is,1,6,9,3,5,6,-5,8,Randolph-Macon College,Ashland,org-org,,PROPN-PROPN,PROPN,compound-pobj,compound,NNP-NNP,NNP,3,1
7276,5393.0,28,Is,3,16,22,6,15,5,-13,19,Darby Crash,Los Angeles,org-org,-,PROPN-PROPN,PROPN-PROPN,compound-compound,compound-compound,NNP-NNP,NNP-NNP,4,1
7277,5394.0,25,been,16,7,23,16,6,1,9,7,William Friedkin,Jeanne Moreau,-,org-org,PROPN-PROPN,PROPN-PROPN,compound-ccomp,compound-pobj,NNP-NNP,NNP-NNP,6,1
7278,5397.0,31,is,8,2,30,28,1,0,6,22,University of Central Florida,USA,org-org-org-org,,PROPN-ADP-PROPN-PROPN,PROPN,nsubj-prep-compound-compound,pobj,NNP-IN-NNP-NNP,NNP,9,1
7279,5398.0,28,is,2,11,5,-6,10,22,-9,3,2003,British Biotech,per,-,NUM,PROPN-PROPN,pobj,amod-pobj,CD,NNP-NNP,3,1
7280,5399.0,24,is,15,1,5,4,0,18,14,-10,HSC,Rockville,per,,PROPN,PROPN,nsubjpass,nmod,NNP,NNP,4,1
7281,5401.0,27,is,2,1,24,23,0,2,1,22,Lv,n Latvi,org,-,INTJ,CCONJ-PROPN,dep,compound-compound,UH,CC-NNP,3,1
7282,5403.0,29,dovish,1,3,7,4,2,21,-2,6,Liberal Democratic Party,Yasuo Fukuda,org-org-org,-,PROPN-PROPN-PROPN,PROPN-PROPN,compound-compound-compound,compound-dobj,NNP-NNP-NNP,NNP-NNP,2,1
7283,5404.0,19,is,3,1,12,11,0,6,2,9,Blackford High School,Indiana,--,per,PROPN-PROPN-PROPN,PROPN,compound-compound-nsubj,pobj,NNP-NNP-NNP,NNP,5,1
7284,13392.0,29,had,9,3,16,13,2,12,6,7,Blackford High School,Indiana,--,per,PROPN-PROPN-PROPN,PROPN,compound-compound-compound,compound,NNP-NNP-NNP,NNP,7,1
7285,5405.0,25,were,4,1,18,17,0,6,3,14,His,Mexico,per,,DET,PROPN,poss,pobj,PRP$,NNP,8,1
7286,5407.0,30,is,11,22,14,-8,21,15,-11,3,Premier Soccer League,South Africa,per-per-per,-,PROPN-PROPN-PROPN,PROPN-PROPN,compound-compound-compound,compound-conj,NNP-NNP-NNP,NNP-NNP,7,1
7287,5408.0,32,is,4,1,13,12,0,18,3,9,Es Vive-series,Fierce Angel,-,per-per,PROPN-NOUN,PROPN-PROPN,compound-compound,compound-pobj,NNP-NNS,NNP-NNP,5,1
7288,5410.0,21,represents,6,9,15,6,8,5,-3,9,University of Houston,NCAA,--,org,PROPN-ADP-PROPN,PROPN,dobj-prep-pobj,compound,NNP-IN-NNP,NNP,4,1
7289,7930.0,29,rooting,4,8,23,15,7,5,-4,19,University of Houston,NCAA,--,per,PROPN-ADP-PROPN,PROPN,nmod-prep-compound,compound,NNP-IN-NNP,NNP,10,1
7290,10651.0,19,represents,6,9,13,4,8,5,-3,7,University of Houston,NCAA,per-per-per,,PROPN-ADP-PROPN,PROPN,dobj-prep-pobj,compound,NNP-IN-NNP,NNP,3,1
7291,13299.0,29,known,7,18,24,6,17,4,-11,17,University of Houston,NCAA,--,per,PROPN-ADP-PROPN,PROPN,dobj-prep-pobj,compound,NNP-IN-NNP,NNP,6,1
7292,5411.0,34,was,1,13,27,14,12,6,-12,26,Minnesota,Alexander Ramsey,per,-,PROPN,PROPN-PROPN,compound,compound-nsubj,NNP,NNP-NNP,5,1
7293,5412.0,16,held,5,7,11,4,6,4,-2,6,its,Baghdad,,per,DET,PROPN,poss,pobj,PRP$,NNP,3,1
7294,5413.0,38,merged,4,19,23,4,18,14,-15,19,Guangzhou,China Southern Airlines,org,--,PROPN,PROPN-PROPN-PROPN,conj,compound-compound-conj,NNP,NNP-NNP-NNPS,7,1
7295,5415.0,24,is,12,1,22,21,0,1,11,10,Rosy Lamb,Paris,org-org,,PROPN-PROPN,PROPN,compound-nsubj,compound,NNP-NNP,NNP,5,1
7296,5417.0,45,chose,4,19,26,7,18,18,-15,22,Gloucester,George III of the United Kingdom,org,-----,PROPN,PROPN-PROPN-ADP-DET-PROPN-PROPN,pobj,compound-pobj-prep-det-compound-pobj,NNP,NNP-NNP-IN-DT-NNP-NNP,3,1
7297,5419.0,26,worked,8,7,15,8,6,10,1,7,State,James Baker,per,-,PROPN,PROPN-PROPN,pobj,compound-pobj,NNP,NNP-NNP,7,1
7298,13601.0,31,decided,8,6,7,1,5,23,2,-1,State,James Baker,,org-org,PROPN,PROPN-PROPN,pobj,compound-nsubj,NNP,NNP-NNP,1,1
7299,5420.0,17,operates,2,2,9,7,1,7,0,7,India,Bharat Petroleum,per,-,PROPN,PROPN-PROPN,nsubj,compound-nsubj,NNP,NNP-NNP,2,1
7300,10746.0,31,houses,1,15,24,9,14,6,-14,23,India,Bharat Petroleum,,org-org,PROPN,PROPN-PROPN,pobj,compound-compound,NNP,NNP-NNP,5,1
7301,5421.0,18,paid,3,13,15,2,12,2,-10,12,school,Cheshire,per,,NOUN,PROPN,pobj,compound,NN,NNP,2,1
7302,5422.0,34,told,30,4,12,8,3,21,26,-18,Mbeki,president,,org,PROPN,NOUN,dobj,conj,NNP,NN,6,1
7303,5423.0,19,is,9,1,18,17,0,0,8,9,Montcalm Community College,Michigan,--,per,PROPN-PROPN-PROPN,PROPN,compound-compound-nsubj,pobj,NNP-NNP-NNP,NNP,7,1
7304,5424.0,31,had,4,2,17,15,1,13,2,13,International Academy,Michigan,per-per,,PROPN-PROPN,PROPN,compound-nsubj,pobj,NNP-NNP,NNP,8,1
7305,5426.0,24,is,5,3,15,12,2,8,2,10,Mostransavto,Moscow,per,,PROPN,PROPN,appos,pobj,NNP,NNP,5,1
7306,5427.0,24,was,8,17,19,2,16,4,-9,11,Canada,VisionTV,,per,PROPN,NOUN,poss,pobj,NNP,NN,5,1
7307,5428.0,43,homered,2,5,23,18,4,19,-3,21,Robinson Cano,Major League Baseball,org-org,--,PROPN-PROPN,PROPN-PROPN-PROPN,compound-nsubj,compound-compound-compound,NNP-NNP,NNP-NNP-NNP,6,1
7308,5429.0,24,is,1,1,18,17,0,5,0,17,He,Toronto,org,,PRON,PROPN,nsubj,pobj,PRP,NNP,4,1
7309,5430.0,27,suffered,3,3,13,10,2,13,0,10,Shad,London,org,,PROPN,PROPN,nsubj,pobj,NNP,NNP,4,1
7310,5431.0,35,stressed,5,1,4,3,0,30,4,-1,Puma,Jochen Zeitz,,org-org,PROPN,PROPN-PROPN,compound,compound-nsubj,NNP,NNP-NNP,2,1
7311,5432.0,14,transferred,6,8,12,4,7,1,-2,6,Tolmie,British Columbia,org,-,PROPN,PROPN-PROPN,dobj,compound-pobj,NNP,NNP-NNP,4,1
7312,5433.0,12,is,2,1,11,10,0,0,1,9,Quebecor Media,Canada,-,per,PROPN-PROPN,PROPN,compound-nsubj,pobj,NNP-NNP,NNP,2,1
7313,5434.0,20,were,10,1,1,0,0,18,9,-9,Tata Consultancy Services,Tata Group,per-per-per,-,PROPN-PROPN-PROPN,PROPN-PROPN,compound-compound-nsubj,compound-pobj,NNP-NNP-NNP,NNP-NNP,0,1
7314,5435.0,43,was,9,1,12,11,0,30,8,3,Ion Storm Inc.,Texas,--,per,PROPN-PROPN-PROPN,PROPN,compound-compound-nsubj,npadvmod,NNP-NNP-NNP,NNP,4,1
7315,5436.0,20,recorded,4,4,18,14,3,1,0,14,Bernard,Jin,,per,PROPN,PROPN,nsubj,compound,NNP,NNP,5,1
7316,5437.0,13,released,8,3,11,8,2,1,5,3,Living Sacrifice,R.E.X. Records,org-org,-,PROPN-PROPN,PROPN-PROPN,compound-poss,compound-pobj,NNP-NNP,NNP-NNPS,3,1
7317,5438.0,61,was,21,6,15,9,5,45,15,-6,East India Company,Haileybury and Imperial Service College,per-per-per,----,PROPN-PROPN-PROPN,PROPN-CCONJ-PROPN-PROPN-PROPN,compound-compound-compound,pobj-cc-compound-compound-conj,NNP-NNP-NNP,NNP-CC-NNP-NNP-NNP,9,1
7318,7392.0,28,passed,1,9,13,4,8,14,-8,12,East India Company,Haileybury and Imperial Service College,--,org-org-org-org-org,PROPN-PROPN-PROPN,PROPN-CCONJ-PROPN-PROPN-PROPN,compound-compound-pobj,pobj-cc-compound-compound-conj,NNP-NNP-NNP,NNP-CC-NNP-NNP-NNP,4,1
7319,5439.0,43,is,5,2,11,9,1,31,3,6,Windsor and Hantsport Railway,Nova Scotia,---,per-per,PROPN-CCONJ-PROPN-PROPN,PROPN-PROPN,nmod-cc-conj-nsubj,compound-pobj,NNP-CC-NNP-NNP,NNP-NNP,7,1
7320,5440.0,26,educates,15,9,2,-7,8,23,6,-13,Denmark,Royal Danish Navy,org,--,PROPN,PROPN-PROPN-PROPN,pobj,compound-compound-pobj,NNP,NNP-NNP-NNP,3,1
7321,5442.0,49,hosts,3,24,24,0,23,24,-21,21,Ontario Lottery and Gaming Corporation,Ontario,per-per-per-per-per,,PROPN-PROPN-CCONJ-PROPN-PROPN,PROPN,compound-nmod-cc-compound-conj,pobj,NNP-NNP-CC-NNP-NNP,NNP,0,1
7322,12201.0,38,had,3,17,17,0,16,20,-14,14,Ontario Lottery and Gaming Corporation,Ontario,----,per,PROPN-PROPN-CCONJ-PROPN-PROPN,PROPN,compound-nmod-cc-compound-conj,ROOT,NNP-NNP-CC-NNP-NNP,NNP,0,1
7323,5444.0,38,used,7,11,15,4,10,22,-4,8,Bundeswehr,Heer,,per,PROPN,PROPN,compound,nmod,NNP,NNP,4,1
7324,5445.0,27,born,3,1,2,1,0,24,2,-1,Jimmy James,James Casey,org-org,-,PROPN-PROPN,PROPN-PROPN,compound-nsubjpass,compound-dobj,NNP-NNP,NNP-NNP,2,1
7325,5446.0,27,elected,6,5,11,6,4,15,1,5,Temaru,French Polynesia,,org-org,PROPN,PROPN-PROPN,nsubjpass,amod-pobj,NNP,NNP-NNP,5,1
7326,9779.0,46,was,1,4,8,4,3,37,-3,7,Temaru,French Polynesia,per,-,PROPN,PROPN-PROPN,poss,amod-nsubj,NNP,NNP-NNP,6,1
7327,11880.0,19,described,8,8,15,7,7,3,0,7,Temaru,French Polynesia,,per-per,PROPN,PROPN-PROPN,pobj,amod-pobj,NNP,NNP-NNP,3,1
7328,5447.0,33,studied,14,5,27,22,4,5,9,13,Brno,Masaryk University,per,-,PROPN,PROPN-PROPN,compound,compound-pobj,NNP,NNP-NNP,6,1
7329,5448.0,25,gotten,11,5,10,5,4,14,6,-1,Paasikivi,Finland,per,,PROPN,PROPN,poss,nsubj,NNP,NNP,2,1
7330,10530.0,18,moved,8,8,15,7,7,2,0,7,Paasikivi,Finland,org,,PROPN,PROPN,nsubj,poss,NNP,NNP,6,1
7331,5449.0,36,believed,3,6,8,2,5,27,-3,5,Ontario,George A. Drew,,per-per-per,PROPN,PROPN-PROPN-PROPN,compound,compound-compound-nsubj,NNP,NNP-NNP-NNP,2,1
7332,5450.0,20,released,13,11,16,5,10,3,2,3,Bing Crosby,Decca,-,per,PROPN-PROPN,PROPN,compound-pobj,compound,NNP-NNP,NNP,7,1
7333,13030.0,34,introduced,2,21,24,3,20,9,-19,22,Bing Crosby,Decca,-,per,PROPN-PROPN,PROPN,compound-pobj,pobj,NNP-NNP,NNP,3,1
7334,5453.0,24,elected,12,2,5,3,1,18,10,-7,Pat Binns,Progressive Conservative,-,org-org,PROPN-PROPN,PROPN-PROPN,compound-poss,compound-compound,NNP-NNP,NNP-NNP,2,1
7335,5454.0,26,spun,1,8,11,3,7,14,-7,10,Zink,2005,org,,PROPN,NUM,compound,pobj,NNP,CD,4,1
7336,5455.0,35,threw,1,1,13,12,0,21,0,12,France,Luc Besson,per,-,PROPN,PROPN-PROPN,nsubj,compound-nsubj,NNP,NNP-NNP,2,1
7337,5771.0,39,continued,2,34,36,2,33,2,-32,34,France,Luc Besson,org,-,PROPN,PROPN-PROPN,poss,compound-pobj,NNP,NNP-NNP,2,1
7338,5457.0,32,was,1,8,20,12,7,11,-7,19,United Nations Monitoring Verification and Inspection Commission,Hans Blix,org-org-org-org-org-org-org,-,PROPN-PROPN-PROPN-PROPN-CCONJ-PROPN-PROPN,PROPN-PROPN,compound-nmod-nmod-nmod-cc-conj-pobj,compound-dobj,NNP-NNP-NNP-NNP-CC-NNP-NNP,NNP-NNP,5,1
7339,7356.0,64,replaced,4,7,25,18,6,38,-3,21,United Nations Monitoring Verification and Inspection Commission,Hans Blix,org-org-org-org-org-org-org,-,PROPN-PROPN-PROPN-PROPN-CCONJ-PROPN-PROPN,PROPN-PROPN,compound-nmod-nmod-nmod-cc-conj-appos,compound-pobj,NNP-NNP-NNP-NNP-CC-NNP-NNP,NNP-NNP,5,1
7340,5458.0,36,After,0,9,35,26,8,0,-9,35,National Tertiary Education Union,1993,---,per,PROPN-PROPN-PROPN-PROPN,NUM,compound-compound-compound-compound,pobj,NNP-NNP-NNP-NNP,CD,13,1
7341,5460.0,17,studies,1,8,14,6,7,2,-7,13,de,Carabins,,org,NOUN,PROPN,pobj,compound,NN,NNPS,5,1
7342,5462.0,77,said,8,6,7,1,5,69,2,-1,Italy,Francesco Cossiga,per,-,PROPN,PROPN-PROPN,compound,compound-pobj,NNP,NNP-NNP,1,1
7343,10568.0,63,convened,22,13,21,8,12,41,9,-1,Italy,Francesco Cossiga,per,-,PROPN,PROPN-PROPN,pobj,compound-pobj,NNP,NNP-NNP,5,1
7344,12390.0,44,were,3,9,10,1,8,33,-6,7,Italy,Francesco Cossiga,per,-,PROPN,PROPN-PROPN,compound,compound-pobj,NNP,NNP-NNP,1,1
7345,5463.0,34,elected,4,3,22,19,2,11,1,18,he,Peru,per,,PRON,PROPN,nsubjpass,pobj,PRP,NNP,3,1
7346,9263.0,39,became,5,3,26,23,2,12,2,21,he,Peru,org,,PRON,PROPN,nsubjpass,pobj,PRP,NNP,4,1
7347,5464.0,35,got,1,17,17,0,16,17,-16,16,Kansas State Wildcats,Kansas,org-org-org,,PROPN-PROPN-PROPN,PROPN,compound-compound-pobj,pobj,NNP-NNP-NNPS,NNP,0,1
7348,5466.0,20,set,8,14,15,1,13,4,-6,7,Liberal,Democratic Party,org,-,PROPN,PROPN-PROPN,compound,compound-poss,NNP,NNP-NNP,2,1
7349,5468.0,31,University,3,1,3,2,0,27,2,0,Ho Chi Minh,Minh Cit,org-org-org,-,PROPN-PROPN-PROPN,PROPN-PROPN,compound-compound-compound,compound-pobj,NNP-NNP-NNP,NNP-NNP,2,1
7350,5469.0,30,founded,1,19,20,1,18,9,-18,19,President,Manuel Balmaceda,per,-,PROPN,PROPN-PROPN,compound,compound-dobj,NNP,NNP-NNP,1,1
7351,5470.0,31,sentenced,6,1,5,4,0,25,5,-1,Raymond Bingham,Grooverider,-,org,PROPN-PROPN,PROPN,compound-compound,nsubjpass,NNP-NNP,NNP,3,1
7352,5472.0,34,called,7,5,12,7,4,21,2,5,Ryan Miller,USA,org-org,,PROPN-PROPN,PROPN,compound-nsubjpass,nmod,NNP-NNP,NNP,5,1
7353,5473.0,54,Speaking,0,7,14,7,6,39,-7,14,World Wide Web Foundation,Tim Berners-Lee,---,org-org,PROPN-PROPN-PROPN-PROPN,PROPN-PROPN,compound-compound-compound-poss,compound-ROOT,NNP-NNP-NNP-NNP,NNP-NNP,3,1
7354,5474.0,36,turned,3,12,26,14,11,9,-9,23,Ten,Gary Hughes,per,-,NUM,PROPN-PROPN,nsubj,compound-pobj,CD,NNP-NNP,-1,1
7355,5476.0,45,ensnared,5,34,44,10,33,0,-29,39,Franklin D. Roosevelt,Navy,per-per-per,,PROPN-PROPN-PROPN,PROPN,compound-compound-pobj,pobj,NNP-NNP-NNP,NNP,7,1
7356,5477.0,36,established,3,6,6,0,5,29,-3,3,Tennessee Valley Authority,Tennessee,org-org-org,,PROPN-PROPN-PROPN,PROPN,compound-compound-dobj,compound,NNP-NNP-NNP,NNP,0,1
7357,5478.0,43,was,9,28,40,12,27,2,-19,31,Malaysia,Universiti Sains Malaysia,per,--,PROPN,PROPN-PROPN-PROPN,pobj,compound-compound-pobj,NNP,NNP-NNP-NNP,4,1
7358,5480.0,28,was,10,8,9,1,7,18,2,-1,artist,Jimmy Cauty,,org-org,NOUN,PROPN-PROPN,conj,compound-nsubj,NN,NNP-NNP,1,1
7359,5482.0,42,known,10,1,23,22,0,18,9,13,Samir Arora,NetObjects,-,per,PROPN-PROPN,PROPN,compound-nsubjpass,compound,NNP-NNP,NNPS,6,1
7360,5483.0,27,apply,19,3,22,19,2,4,16,3,New York,RSD,per-per,,PROPN-PROPN,PROPN,compound-compound,pobj,NNP-NNP,NNP,5,1
7361,5485.0,22,admitted,3,1,14,13,0,7,2,11,Louis St. Laurent,Quebec,per-per-per,,PROPN-PROPN-PROPN,PROPN,compound-compound-nsubj,pobj,NNP-NNP-NNP,NNP,7,1
7362,5486.0,38,energizes,4,18,36,18,17,1,-14,32,Chess,Chuck Berry,per,-,PROPN,PROPN-PROPN,compound,compound-conj,NNP,NNP-NNP,7,1
7363,5487.0,31,became,3,7,16,9,6,14,-4,13,American,Eileen Collins,org,-,ADJ,PROPN-PROPN,amod,compound-nsubj,JJ,NNP-NNP,3,1
7364,5488.0,23,named,4,9,15,6,8,7,-5,11,Edison State College,Florida,--,per,PROPN-PROPN-PROPN,PROPN,compound-compound-appos,nmod,NNP-NNP-NNP,NNP,4,1
7365,5489.0,28,met,15,11,27,16,10,0,4,12,Willi Stoph,Germany,-,per,PROPN-PROPN,PROPN,compound-nsubj,pobj,NNP-NNP,NNP,2,1
7366,5491.0,30,transformed,11,10,17,7,9,12,1,6,Finland,Risto Ryti,org,-,PROPN,PROPN-PROPN,conj,compound-pobj,NNP,NNP-NNP,5,1
7367,5492.0,29,nexsound,2,1,16,15,0,12,1,14,Zavoloka,Kyiv,,per,PROPN,PROPN,compound,compound,NNP,NNP,7,1
7368,5494.0,35,is,6,8,13,5,7,21,-2,7,Alessandro Profumo,UniCredit,-,per,PROPN-PROPN,PROPN,nmod-nmod,nmod,NNP-NNP,NNP,4,1
7369,5495.0,23,urged,14,8,11,3,7,11,6,-3,Piero Fassino,Italy,-,per,PROPN-PROPN,PROPN,compound-pobj,pobj,NNP-NNP,NNP,3,1
7370,5496.0,30,was,1,10,14,4,9,15,-9,13,B-Tight,Aggro Berlin,per,-,PROPN,PROPN-PROPN,nummod,compound-pobj,NNP,NNP-NNP,3,1
7371,5497.0,23,moved,4,10,15,5,9,7,-6,11,Montreal,Tim Hecker,org,-,PROPN,PROPN-PROPN,compound,compound-pobj,NNP,NNP-NNP,4,1
7372,5498.0,27,Siege,2,11,22,11,10,4,-9,20,Moses Blah,Liberia,per-per,,PROPN-PROPN,PROPN,compound-nsubj,pobj,NNP-NNP,NNP,4,1
7373,5927.0,36,is,16,1,16,15,0,19,15,0,Moses Blah,Liberia,per-per,,PROPN-PROPN,PROPN,compound-nsubj,pobj,NNP-NNP,NNP,1,1
7374,5500.0,33,was,1,1,12,11,0,20,0,11,Gnarkill,Pennsylvania,,per,PROPN,PROPN,nsubj,pobj,NNP,NNP,3,1
7375,5501.0,17,became,1,6,13,7,5,3,-5,12,Caucasian Front,Caucasus Emirate,org-org,-,PROPN-PROPN,PROPN-PROPN,compound-pobj,compound-dobj,NNP-NNP,NNP-NNP,5,1
7376,5502.0,36,Lighthouse,6,12,29,17,11,6,-6,23,New York,Ambrose,-,per,PROPN-PROPN,PROPN,compound-compound,compound,NNP-NNP,NNP,10,1
7377,5503.0,25,located,14,18,1,-17,17,23,-4,-13,Afghanistan,Kabul University,,per-per,PROPN,PROPN-PROPN,pobj,compound-pobj,NNP,NNP-NNP,3,1
7378,5504.0,13,build,5,1,3,2,0,9,4,-2,Finland,Stora Enso,org,-,PROPN,PROPN-PROPN,poss,compound-nsubj,NNP,NNP-NNP,2,1
7379,5506.0,24,born,2,5,13,8,4,10,-3,11,Los Angeles,Albert Hammond,org-org,-,PROPN-PROPN,PROPN-PROPN,compound-compound,compound-ROOT,NNP-NNP,NNP-NNP,6,1
7380,5508.0,17,engaged,5,8,9,1,7,7,-3,4,singer,Wayne Newton,,per-per,NOUN,PROPN-PROPN,xcomp,compound-dobj,NN,NNP-NNP,1,1
7381,5510.0,20,was,1,9,6,-3,8,13,-8,5,England,Crompton House,org,-,PROPN,PROPN-PROPN,pobj,compound-compound,NNP,NNP-NNP,2,1
7382,5511.0,31,is,7,7,18,11,6,12,0,11,Peru,University of the Pacific,,org-org-org-org,PROPN,PROPN-ADP-DET-PROPN,pobj,nsubj-prep-det-pobj,NNP,NNP-IN-DT-NNP,4,1
7383,5512.0,14,featured,2,5,9,4,4,4,-3,7,Black Sabbath,Tony Iommi,org-org,-,PROPN-PROPN,PROPN-PROPN,compound-dobj,compound-appos,NNP-NNP,NNP-NNP,2,1
7384,5513.0,18,born,13,1,10,9,0,7,12,-3,Colgate-Palmolive,Ian M. Cook,,per-per-per,ADJ,PROPN-PROPN-PROPN,amod,compound-compound-conj,JJ,NNP-NNP-NNP,6,1
7385,5514.0,40,held,3,36,39,3,35,0,-33,36,9th Division,Tobruk,-,per,NOUN-PROPN,PROPN,compound-dobj,pobj,NN-NNP,NNP,9,1
7386,5515.0,19,held,1,7,10,3,6,8,-6,9,France,Gouin,,org,PROPN,PROPN,pobj,compound,NNP,NNP,4,1
7387,5516.0,23,formed,2,5,20,15,4,2,-3,18,Moldova,Military of Moldova,,org-org-org,PROPN,PROPN-ADP-PROPN,poss,pobj-prep-pobj,NNP,NNP-IN-NNP,9,1
7388,5517.0,38,is,3,1,17,16,0,20,2,14,Barrick Gold,Toronto,per-per,,PROPN-PROPN,PROPN,compound-compound,compound,NNP-NNP,NNP,7,1
7389,5518.0,39,was,14,29,37,8,28,1,-15,23,Standard Oil,ExxonMobil,-,per,PROPN-PROPN,PROPN,compound-compound,appos,NNP-NNP,NNP,7,1
7390,5519.0,18,joined,3,5,7,2,4,10,-2,4,Joey Boy,Thailand,per-per,,PROPN-PROPN,PROPN,compound-compound,poss,NNP-NNP,NNP,2,1
7391,5520.0,41,ship,5,26,29,3,25,11,-21,24,Kenyatta University,Nairobi,-,per,PROPN-PROPN,PROPN,compound-pobj,pobj,NNP-NNP,NNP,4,1
7392,6462.0,14,was,9,5,8,3,4,5,4,-1,Kenyatta University,Nairobi,org-org,,PROPN-PROPN,PROPN,compound-pobj,pobj,NNP-NNP,NNP,2,1
7393,5521.0,28,has,2,1,11,10,0,16,1,9,She,Henry,,per,PRON,PROPN,nsubj,pobj,PRP,NNP,8,1
7394,5522.0,24,left,3,13,20,7,12,3,-10,17,Australia,National Rugby League,org,--,PROPN,PROPN-PROPN-PROPN,pobj,compound-compound-compound,NNP,NNP-NNP-NNP,5,1
7395,5523.0,24,funded,5,3,13,10,2,10,2,8,Hopkins School,New Haven,per-per,-,PROPN-PROPN,PROPN-PROPN,compound-pobj,compound-compound,NNP-NNP,NNP-NNP,11,1
7396,5525.0,29,visited,4,3,12,9,2,16,1,8,Hamid Karzai,Afghanistan,-,per,PROPN-PROPN,PROPN,compound-nsubj,pobj,NNP-NNP,NNP,2,1
7397,5527.0,60,ruled,23,10,36,26,9,23,13,13,Michigan,Trustees,per,,PROPN,PROPN,compound,pobj,NNP,NNPS,7,1
7398,5528.0,35,Florin,1,19,30,11,18,4,-18,29,he I,ia Davis C,-,org-org-org,PRON-PRON,VERB-PROPN-PROPN,dobj-nmod,ROOT-compound-ROOT,PRP-PRP,VBD-NNP-NNP,6,1
7399,5529.0,17,is,2,9,15,6,8,1,-7,13,Margaret Becker,Sparrow Records,per-per,-,PROPN-PROPN,PROPN-PROPN,compound-pobj,compound-pobj,NNP-NNP,NNP-NNPS,5,1
7400,5530.0,23,founded,2,19,22,3,18,0,-17,20,Jahangirnagar University,Bangladesh,per-per,,PROPN-PROPN,PROPN,compound-pobj,pobj,NNP-NNP,NNP,8,1
7401,5531.0,20,owns,3,1,1,0,0,18,2,-2,Air China Cargo,Air China,--,per-per,PROPN-PROPN-PROPN,PROPN-PROPN,compound-compound-nsubj,compound-poss,NNP-NNP-NNP,NNP-NNP,0,1
7402,5532.0,44,signed,20,1,3,2,0,40,19,-17,Singapore,Nanyang Technological University,per,--,PROPN,PROPN-PROPN-PROPN,poss,compound-compound-nsubj,NNP,NNP-NNP-NNP,3,1
7403,5533.0,19,represented,3,1,6,5,0,12,2,3,Sykes,England,per,,PROPN,PROPN,nsubj,dobj,NNP,NNP,2,1
7404,7064.0,40,gained,13,1,19,18,0,20,12,6,Sykes,England,per,,NOUN,PROPN,nsubj,compound,NNS,NNP,6,1
7405,9334.0,20,earned,3,1,5,4,0,14,2,2,Sykes,England,per,,PROPN,PROPN,nsubj,compound,NNP,NNP,2,1
7406,5534.0,14,is,1,7,13,6,6,0,-6,12,Rock Bridge High School,Missouri,per-per-per-per,,PROPN-PROPN-PROPN-PROPN,PROPN,compound-compound-compound-pobj,pobj,NNP-NNP-NNP-NNP,NNP,5,1
7407,5535.0,31,scored,14,8,14,6,7,16,6,0,Isabelle Delobel,France,-,org,PROPN-PROPN,PROPN,compound-nsubj,pobj,NNP-NNP,NNP,2,1
7408,5536.0,11,York,3,1,2,1,0,8,2,-1,Michael Bloomberg,Bloomberg L.P.,-,per-per,PROPN-PROPN,PROPN-PROPN,compound-compound,compound-ROOT,NNP-NNP,NNP-NNP,2,1
7409,5538.0,49,named,6,11,28,17,10,20,-5,22,Michigan,GVSU,,org,PROPN,PROPN,compound,poss,NNP,NNP,10,1
7410,5540.0,7,40:45.938,5,1,4,3,0,2,4,-1,Mike Di Meglio,France,--,per,PROPN-PROPN-PROPN,PROPN,compound-compound-compound,compound,NNP-NNP-NNP,NNP,2,1
7411,5541.0,104,opens,5,3,3,0,2,100,2,-2,DGSE Companies,DGSE,per-per,,PROPN-PROPN,PROPN,compound-compound,compound,NNP-NNPS,NNP,0,1
7412,5542.0,36,was,2,31,32,1,30,3,-29,30,director,Joe Mantello,,per-per,NOUN,PROPN-PROPN,compound,compound-pobj,NN,NNP-NNP,1,1
7413,5543.0,20,playing,3,1,5,4,0,14,2,2,ETSU,Division I,per,-,PROPN,PROPN-PRON,nsubj,dobj-nsubj,NNP,NNP-PRP,3,1
7414,5544.0,32,was,7,27,30,3,26,1,-20,23,Allianz,Munich,,org,PROPN,PROPN,compound,compound,NNP,NNP,2,1
7415,5545.0,36,was,3,16,17,1,15,18,-13,14,Batumongke,Dayan Khan,,org-org,PROPN,PROPN-PROPN,compound,compound-pobj,NNP,NNP-NNP,1,1
7416,5546.0,38,opened,8,1,11,10,0,26,7,3,Khyber Teaching Hospital,1976,--,per,PROPN-PROPN-PROPN,NUM,compound-compound-nsubj,pobj,NNP-NNP-NNP,CD,3,1
7417,5548.0,26,encourages,17,9,16,7,8,9,8,-1,Northeast Normal University,Jilin,org-org-org,,PROPN-PROPN-PROPN,PROPN,compound-compound-nmod,compound,NNP-NNP-NNP,NNP,5,1
7418,5549.0,16,Prior,0,8,11,3,7,4,-8,11,Funkhouser,Kansas City,,per-per,PROPN,PROPN-PROPN,appos,compound-poss,NNP,NNP-NNP,5,1
7419,5550.0,39,born,6,19,28,9,18,10,-13,22,ent Hosni Muba,of Eg,--,org-org,NOUN-PROPN-PROPN,ADP-PROPN,advmod-compound-compound,prep-pobj,NN-NNP-NNP,IN-NNP,8,1
7420,5551.0,29,Takkenberg,1,1,15,14,0,13,0,14,Henrik Takkenberg,songwriter,org-org,,PROPN-PROPN,NOUN,compound-ROOT,compound,NNP-NNP,NN,2,1
7421,5554.0,29,investigating,6,1,10,9,0,18,5,4,Canada,University of Ottawa,org,--,PROPN,PROPN-ADP-PROPN,poss,nmod-prep-pobj,NNP,NNP-IN-NNP,7,1
7422,5555.0,13,served,2,7,12,5,6,0,-5,10,Hewlett-Packard,Compaq,per,,PROPN,PROPN,compound,dobj,NNP,NNP,6,1
7423,5556.0,96,include,12,19,68,49,18,27,-7,56,Republican,Dwight D. Eisenhower,,org-org-org,ADJ,PROPN-PROPN-PROPN,amod,compound-compound-pobj,JJ,NNP-NNP-NNP,11,1
7424,5557.0,23,was,10,1,18,17,0,4,9,8,George Zames,McGill University,org-org,-,PROPN-PROPN,PROPN-PROPN,compound-nsubj,compound-compound,NNP-NNP,NNP-NNP,6,1
7425,5559.0,29,made,9,5,22,17,4,6,4,13,Ian Smith,Rhodesia,per-per,,PROPN-PROPN,PROPN,compound-nsubj,pobj,NNP-NNP,NNP,2,1
7426,8407.0,50,died,35,1,8,7,0,41,34,-27,Ian Smith,Rhodesia,per-per,,PROPN-PROPN,PROPN,compound-nsubj,pobj,NNP-NNP,NNP,3,1
7427,12589.0,21,formed,1,7,14,7,6,6,-6,13,Ian Smith,Rhodesia,org-org,,PROPN-PROPN,PROPN,compound-pobj,pobj,NNP-NNP,NNP,3,1
7428,5561.0,22,is,5,12,20,8,11,1,-7,15,Arab Strap,Chemikal Underground,-,org-org,PROPN-PROPN,PROPN-PROPN,compound-pobj,compound-pobj,NNP-NNP,NNP-NNP,5,1
7429,5563.0,22,is,8,2,2,0,1,19,6,-6,South Carolina State Guard,South Carolina,per-per-per-per,-,PROPN-PROPN-PROPN-PROPN,PROPN-PROPN,compound-compound-compound-nsubj,compound-compound,NNP-NNP-NNP-NNP,NNP-NNP,0,1
7430,5564.0,96,have,4,72,75,3,71,20,-68,71,Mark Chesnutt,Beaumont,org-org,,PROPN-PROPN,PROPN,nmod-ROOT,appos,NNP-NNP,NNP,1,1
7431,5565.0,37,initiated,2,9,16,7,8,20,-7,14,Pravind Jugnauth,MSM,-,org,PROPN-PROPN,PROPN,compound-appos,pobj,NNP-NNP,NNP,3,1
7432,5566.0,25,Born,0,10,15,5,9,9,-10,15,IRIN,United Nations,,org-org,PROPN,PROPN-PROPN,compound,compound-compound,NNP,NNP-NNP,4,1
7433,7046.0,29,comes,2,7,24,17,6,4,-5,22,IRIN,United Nations,org,-,PROPN,PROPN-PROPN,pobj,compound-pobj,NNP,NNP-NNP,8,1
7434,7252.0,57,quot,0,3,18,15,2,38,-3,18,IRIN,United Nations,,per-per,PROPN,PROPN-PROPN,nsubj,compound-pobj,NNP,NNP-NNP,5,1
7435,5567.0,26,received,3,10,12,2,9,13,-7,9,his,Epic,per,,DET,PROPN,poss,compound,PRP$,NNP,2,1
7436,5568.0,29,M.D.,3,24,27,3,23,1,-21,24,Harvard Medical School,Boston,org-org-org,,PROPN-PROPN-PROPN,PROPN,compound-compound-compound,compound,NNP-NNP-NNP,NNP,2,1
7437,5571.0,49,elected,2,29,30,1,28,18,-27,28,Governor,Thomas Lee,,per-per,PROPN,PROPN-PROPN,compound,compound-compound,NNP,NNP-NNP,2,1
7438,5572.0,63,jpg,0,26,23,-3,25,39,-26,23,Italy,Amintore Fanfani,,org-org,PROPN,PROPN-PROPN,compound,nsubj-compound,NNP,NNP-NNP,4,1
7439,5573.0,72,named,13,48,52,4,47,19,-35,39,Hayao Miyazaki,studio Ghibli,-,per-per,PROPN-PROPN,NOUN-PROPN,compound-pobj,compound-appos,NNP-NNP,NN-NNP,2,1
7440,5574.0,31,were,1,17,20,3,16,10,-16,19,Anote Tong.Phil Mercer,Kiribati,per-per-per,,PROPN-PROPN-PROPN,PROPN,compound-appos-compound,compound,NNP-NNP-NNP,NNP,-1,1
7441,5575.0,41,said,20,2,5,3,1,35,18,-15,Green Party,Peter Eriksson,org-org,-,PROPN-PROPN,PROPN-PROPN,compound-compound,compound-appos,NNP-NNP,NNP-NNP,2,1
7442,5576.0,23,died,11,6,10,4,5,12,5,-1,Susan Stranks,Robin Ray,-,per-per,PROPN-PROPN,PROPN-PROPN,compound-nsubj,compound-pobj,NNP-NNP,NNP-NNP,5,1
7443,5577.0,21,established,3,1,1,0,0,19,2,-2,Hainan Airlines,Hainan,-,org,PROPN-PROPN,PROPN,compound-nsubjpass,pobj,NNP-NNPS,NNP,0,1
7444,11761.0,37,However,0,3,3,0,2,33,-3,3,Hainan Airlines,Hainan,org-org,,PROPN-PROPN,PROPN,compound-compound,compound,NNP-NNPS,NNP,0,1
7445,5578.0,78,fled,57,66,76,10,65,1,-9,19,Idi Amin,Saudi Arabia,org-org,-,PROPN-PROPN,PROPN-PROPN,compound-nsubj,compound-pobj,NNP-NNP,NNP-NNP,4,1
7446,5579.0,33,said,29,27,28,1,26,4,2,-1,minister,Frank Heemskerk,,per-per,NOUN,PROPN-PROPN,compound,compound-conj,NN,NNP-NNP,1,1
7447,5580.0,19,born,4,1,12,11,0,6,3,8,Rodrigo Alejandro Bueno,Argentina,org-org-org,,PROPN-PROPN-PROPN,PROPN,compound-compound-nsubjpass,pobj,NNP-NNP-NNP,NNP,3,1
7448,5581.0,21,stepped,4,15,20,5,14,0,-11,16,Alfred Apaka,Hawaii,per-per,,PROPN-PROPN,PROPN,compound-pobj,pobj,NNP-NNP,NNP,5,1
7449,5582.0,21,matriculated,3,1,12,11,0,8,2,9,Educated Rapper,UTFO,org-org,,VERB-PROPN,PROPN,compound-nsubj,nsubj,VBN-NNP,NNP,2,1
7450,5583.0,38,worked,8,29,32,3,28,5,-21,24,Sheffield Hallam University,United Kingdom,per-per-per,-,PROPN-PROPN-PROPN,PROPN-PROPN,compound-compound-compound,compound-pobj,NNP-NNP-NNP,NNP-NNP,4,1
7451,5584.0,20,says,3,13,14,1,12,5,-10,11,President,Mahinda Rajapaksa,per,-,PROPN,PROPN-PROPN,compound,compound-pobj,NNP,NNP-NNP,1,1
7452,7945.0,21,completed,3,13,14,1,12,6,-10,11,President,Mahinda Rajapaksa,per,-,PROPN,PROPN-PROPN,compound,compound-pobj,NNP,NNP-NNP,1,1
7453,5585.0,33,is,12,11,27,16,10,5,1,15,Finland,University of Helsinki,per,--,PROPN,PROPN-ADP-PROPN,pobj,pobj-prep-pobj,NNP,NNP-IN-NNP,9,1
7454,5587.0,24,was,12,11,22,11,10,1,1,10,Tasmania,Tasmanian Tigers,per,-,PROPN,PROPN-PROPN,pobj,compound-pobj,NNP,NNP-NNPS,7,1
7455,5588.0,33,announced,17,10,28,18,9,4,7,11,Orange Twin Records,Mangum,--,org,PROPN-PROPN-PROPN,PROPN,compound-compound-pobj,nsubj,NNP-NNP-NNPS,NNP,9,1
7456,5589.0,34,took,15,20,24,4,19,9,-5,9,England,Winslet,org,,PROPN,PROPN,pobj,conj,NNP,NNP,1,1
7457,5590.0,42,lived,1,8,16,8,7,25,-7,15,Le Mans,Fillon,-,per,PROPN-PROPN,PROPN,compound-compound,nsubj,NNP-NNPS,NNP,4,1
7458,5592.0,27,was,3,1,14,13,0,12,2,11,Alitalia,Rome,,per,PROPN,PROPN,compound,compound,NNP,NNP,6,1
7459,11156.0,19,was,3,1,10,9,0,8,2,7,Alitalia,Rome,per,,PROPN,PROPN,compound,compound,NNP,NNP,5,1
7460,5593.0,21,were,11,10,19,9,9,1,1,8,Ames Brothers,Coral,per-per,,PROPN-PROPN,PROPN,compound-nsubj,compound,NNP-NNPS,NNP,5,1
7461,5595.0,44,saved,12,4,20,16,3,23,8,8,Jakarta,Sutan Sjahrir,per,-,PROPN,PROPN-PROPN,pobj,compound-pobj,NNP,NNP-NNP,5,1
7462,10000.0,41,spent,26,10,25,15,9,15,16,-1,Jakarta,Sutan Sjahrir,per,-,PROPN,PROPN-PROPN,pobj,compound-pobj,NNP,NNP-NNP,6,1
7463,5596.0,21,became,1,11,13,2,10,7,-10,12,Sweden,his,,per,PROPN,DET,pobj,poss,NNP,PRP$,2,1
7464,5597.0,43,made,8,14,20,6,13,22,-6,12,Anwar El Sadat,Egypt,org-org-org,,PROPN-PROPN-PROPN,PROPN,compound-compound-pobj,pobj,NNP-NNP-NNP,NNP,5,1
7465,8230.0,24,was,3,13,19,6,12,4,-10,16,Anwar El Sadat,Egypt,org-org-org,,PROPN-PROPN-PROPN,PROPN,compound-compound-dobj,pobj,NNP-NNP-NNP,NNP,8,1
7466,5598.0,45,During,0,11,17,6,10,27,-11,17,Central Military Commission,Hua,per-per-per,,PROPN-PROPN-PROPN,PROPN,compound-compound-compound,conj,NNP-NNP-NNP,NNP,6,1
7467,5599.0,33,emigrated,5,11,15,4,10,17,-6,10,Brampton,Turner Fenton Secondary School,,org-org-org-org,PROPN,PROPN-PROPN-PROPN-PROPN,pobj,compound-compound-compound-dobj,NNP,NNP-NNP-NNP-NNP,3,1
7468,5600.0,10,s,2,1,4,3,0,5,1,2,Japan,Suzuki,,org,PROPN,PROPN,nsubj,nsubj,NNP,NNP,-1,1
7469,5887.0,26,joined,12,11,12,1,10,13,1,0,Japan,Suzuki,,org,PROPN,PROPN,compound,dobj,NNP,NNP,5,1
7470,5601.0,31,attended,1,17,17,0,16,13,-16,16,Oswego High School,Oswego,per-per-per,,PROPN-PROPN-PROPN,PROPN,compound-compound-pobj,compound,NNP-NNP-NNP,NNP,0,1
7471,5603.0,40,born,2,1,12,11,0,27,1,10,Odinga,Kenya,,per,PROPN,PROPN,nsubjpass,pobj,NNP,NNP,5,1
7472,13420.0,22,supported,12,7,21,14,6,0,5,9,Odinga,Kenya,,per,PROPN,PROPN,conj,pobj,NNP,NNP,4,1
7473,5604.0,47,requested,32,13,27,14,12,19,19,-5,Cyprus,European Central Bank,per,--,PROPN,PROPN-PROPN-PROPN,pobj,compound-compound-pobj,NNP,NNP-NNP-NNP,7,1
7474,5605.0,11,is,3,1,10,9,0,0,2,7,Bowie High School,Arizona,--,per,PROPN-PROPN-PROPN,PROPN,compound-compound-nsubj,pobj,NNP-NNP-NNP,NNP,3,1
7475,5607.0,41,born,2,5,18,13,4,22,-3,16,Shreveport,his,,org,PROPN,DET,pobj,poss,NNP,PRP$,5,1
7476,5608.0,29,is,10,23,27,4,22,1,-13,17,his,Tammy Grimes,per,-,DET,PROPN-PROPN,poss,compound-pobj,PRP$,NNP-NNP,3,1
7477,5609.0,29,moved,5,15,18,3,14,10,-10,13,Scott Carpenter,Florence Noxon Carpenter,org-org,--,PROPN-PROPN,PROPN-PROPN-NOUN,compound-appos,compound-compound-conj,NNP-NNP,NNP-NNP-NN,2,1
7478,5610.0,20,returned,7,7,19,12,6,0,0,12,she,SWT,per,,PRON,PROPN,nsubj,pobj,PRP,NNP,1,1
7479,5611.0,22,is,8,7,18,11,6,3,1,10,HM-15,Naval Station Norfolk,org,--,PROPN,PROPN-PROPN-PROPN,subtok,compound-compound-compound,NNP,NNP-NNP-NNP,7,1
7480,5612.0,24,founded,2,1,7,6,0,16,1,5,It,Dean Zelinsky,per,-,PRON,PROPN-PROPN,nsubjpass,compound-pobj,PRP,NNP-NNP,3,1
7481,5614.0,26,is,8,1,22,21,0,3,7,14,Gandhi,India,per,,PROPN,PROPN,nsubj,pobj,NNP,NNP,8,1
7482,5615.0,15,is,1,6,11,5,5,3,-5,10,West Virginia State University,Booker T. Washington Park,per-per-per-per,---,PROPN-PROPN-PROPN-PROPN,PROPN-PROPN-PROPN-PROPN,compound-compound-compound-pobj,compound-compound-compound-appos,NNP-NNP-NNP-NNP,NNP-NNP-NNP-NNP,8,1
7483,5859.0,19,took,2,6,11,5,5,7,-4,9,West Virginia State University,Booker T. Washington Park,per-per-per-per,---,PROPN-PROPN-PROPN-PROPN,PROPN-PROPN-PROPN-PROPN,compound-compound-compound-poss,compound-compound-compound-pobj,NNP-NNP-NNP-NNP,NNP-NNP-NNP-NNP,3,1
7484,5616.0,33,recounts,3,11,20,9,10,12,-8,17,Palembang,Parameswara,per,,PROPN,PROPN,dobj,compound,NNP,NNP,-1,1
7485,5707.0,12,was,2,9,11,2,8,0,-7,9,Palembang,Parameswara,per,,PROPN,PROPN,compound,pobj,NNP,NNP,2,1
7486,5618.0,25,went,9,15,21,6,14,3,-6,12,Southern California Institute of Architecture,SCI-Arc,----,per,PROPN-PROPN-PROPN-ADP-PROPN,NOUN,compound-compound-dobj-prep-pobj,parataxis,NNP-NNP-NNP-IN-NNP,NN,3,1
7487,5619.0,38,declared,20,15,20,5,14,17,5,0,Midlake,Denton,,org,PROPN,PROPN,pobj,pobj,NNP,NNP,7,1
7488,5621.0,33,is,11,5,32,27,4,0,6,21,Birmingham,England,,org,PROPN,PROPN,compound,pobj,NNP,NNP,4,1
7489,5622.0,27,noted,4,2,7,5,1,19,2,3,Giaconda,Australia,,per,PROPN,PROPN,compound,poss,NNP,NNP,5,1
7490,5623.0,19,was,1,7,14,7,6,4,-6,13,People,Partido Popular,,per-per,PROPN,PROPN-PROPN,poss,compound-appos,NNPS,NNP-NNP,7,1
7491,5624.0,33,is,0,17,23,6,16,9,-17,23,Kami,Japan,,per,PROPN,PROPN,appos,ROOT,NNP,NNP,10,1
7492,5626.0,23,nominated,3,13,15,2,12,7,-10,12,Ugandan,Idi Amin,org,-,PROPN,PROPN-PROPN,compound,compound-pobj,NNP,NNP-NNP,2,1
7493,5627.0,41,is,9,21,27,6,20,13,-12,18,Australia,National Basketball League,,org-org-org,PROPN,PROPN-PROPN-PROPN,pobj,compound-compound-nmod,NNP,NNP-NNP-NNP,6,1
7494,5628.0,31,founded,3,2,11,9,1,19,1,8,airline,Grupo Marsans,per,-,NOUN,PROPN-PROPN,nsubjpass,compound-pobj,NN,NNP-NNPS,3,1
7495,5631.0,46,was,9,22,28,6,21,17,-13,19,National Institute of Mental Health,Bethesda,per-per-per-per-per,,PROPN-PROPN-ADP-PROPN-PROPN,PROPN,compound-pobj-prep-compound-pobj,compound,NNP-NNP-IN-NNP-NNP,NNP,2,1
7496,5632.0,57,co-founded,1,14,26,12,13,30,-13,25,Radovan Karad?i,he Republika Srps,-,per-per-per,PROPN-NUM,PRON-PROPN-PROPN,nsubj-advcl,compound-compound-appos,NNP-CD,PRP-NNP-NNP,-1,1
7497,5634.0,23,rewarded,8,20,21,1,19,1,-12,13,Interior,Carl Schurz,,per-per,PROPN,PROPN-PROPN,pobj,compound-pobj,NNP,NNP-NNP,1,1
7498,5635.0,24,is,2,1,17,16,0,6,1,15,Carroll University,Waukesha,org-org,,PROPN-PROPN,PROPN,compound-nsubj,pobj,NNP-NNP,NNP,7,1
7499,5636.0,60,created,12,9,19,10,8,40,3,7,Arizona,tuff,,per,PROPN,NOUN,compound,pobj,NNP,NN,11,1
7500,5637.0,28,represented,14,3,17,14,2,10,11,3,Tennessee Volunteers,University of Tennessee,per-per,--,PROPN-PROPN,PROPN-ADP-PROPN,compound-compound,dobj-prep-pobj,NNP-NNP,NNP-IN-NNP,4,1
7501,11479.0,24,represented,12,3,15,12,2,8,9,3,Tennessee Volunteers,University of Tennessee,org-org,--,PROPN-PROPN,PROPN-ADP-PROPN,compound-nsubj,dobj-prep-pobj,NNP-NNPS,NNP-IN-NNP,3,1
7502,5638.0,20,lawyer,0,3,7,4,2,12,-3,7,New Jersey,Theodore Frelinghuysen,-,org-org,PROPN-PROPN,PROPN-PROPN,compound-compound,compound-conj,NNP-NNP,NNP-NNP,3,1
7503,5639.0,51,was,12,3,50,47,2,0,9,38,Tyrone Guthrie,Ireland,org-org,,PROPN-PROPN,PROPN,compound-nsubj,pobj,NNP-NNP,NNP,9,1
7504,10836.0,62,collaborated,2,34,38,4,33,23,-32,36,Tyrone Guthrie,Ireland,per-per,,PROPN-PROPN,PROPN,compound-compound,nmod,NNP-NNP,NNP,-1,1
7505,5640.0,21,was,2,1,16,15,0,4,1,14,Air,Mariehamn,,per,PROPN,PROPN,compound,compound,NNP,NNP,9,1
7506,5641.0,20,served,1,1,17,16,0,2,0,16,Mitchell,Ohio,,per,PROPN,PROPN,nsubj,compound,NNP,NNP,3,1
7507,5642.0,26,Founded,0,4,8,4,3,17,-4,8,Pierre Panos,Fresh to Order,per-per,--,PROPN-PROPN,PROPN-PART-PROPN,compound-pobj,nsubj-prep-pobj,NNP-NNP,NNP-TO-NNP,5,1
7508,5643.0,38,are,3,20,21,1,19,16,-17,18,artist,BT,per,,NOUN,PROPN,compound,dobj,NN,NNP,5,1
7509,5644.0,32,came,8,20,31,11,19,0,-12,23,France,Grappelli,per,,PROPN,PROPN,pobj,conj,NNP,NNP,3,1
7510,5645.0,15,is,1,1,9,8,0,5,0,8,It,Greece,org,,PRON,PROPN,nsubj,pobj,PRP,NNP,1,1
7511,5646.0,33,was,2,11,31,20,10,1,-9,29,Belgium,Paul-Henri Spaak,org,-,PROPN,PROPN-PROPN,compound,compound-pobj,NNP,NNP-NNP,11,1
7512,14142.0,37,born,29,7,8,1,6,28,22,-21,Belgium,Paul-Henri Spaak,per,-,PROPN,PROPN-PROPN,pobj,amod-compound,NNP,NNP-NNP,2,1
7513,5647.0,25,won,5,4,19,15,3,5,1,14,Omar al-Bashir,Sudan,per-per,,PROPN-PROPN,PROPN,compound-nsubj,poss,NNP-NNP,NNP,4,1
7514,11095.0,60,reappointed,5,4,14,10,3,45,1,9,Omar al-Bashir,Sudan,org-org,,PROPN-PROPN,PROPN,compound-appos,pobj,NNP-NNP,NNP,5,1
7515,12039.0,32,appointed,5,10,25,15,9,6,-5,20,Omar al-Bashir,Sudan,-,per,PROPN-PROPN,PROPN,compound-pobj,poss,NNP-NNP,NNP,8,1
7516,13243.0,8,is,2,1,7,6,0,0,1,5,Omar al-Bashir,Sudan,-,per,PROPN-PROPN,PROPN,compound-nsubj,pobj,NNP-NNP,NNP,4,1
7517,5648.0,24,was,5,1,22,21,0,1,4,17,Apse,Acuarela Discos,per,-,PROPN,PROPN-PROPN,nsubj,compound-appos,NNP,NNP-NNP,8,1
7518,10975.0,16,signed,7,6,10,4,5,5,1,3,Apse,Acuarela Discos,per,-,PROPN,PROPN-PROPN,pobj,compound-pobj,NNP,NNP-NNP,3,1
7519,5650.0,21,entered,9,11,16,5,10,4,-2,7,Georgia,Wesleyan College,,org-org,PROPN,PROPN-PROPN,compound,compound-appos,NNP,NNP-NNP,2,1
7520,5651.0,15,was,1,7,11,4,6,3,-6,10,Judith of Swabia,W?adys?aw I Herm,org-org-org,--,PROPN-ADP-PROPN,VERB-PRON-VERB,pobj-prep-pobj,conj-nsubj-ROOT,NNP-IN-NNP,VBP-PRP-VBP,7,1
7521,5652.0,52,?eljko,0,1,8,7,0,43,-1,8,?eljko,he Presiden,org,-,PUNCT,PRON-VERB,ROOT,nsubj-appos,",",PRP-VBD,-1,1
7522,5653.0,13,University,4,3,5,2,2,7,1,1,Mathematics Department,University of Waterloo,org-org,--,PROPN-PROPN,PROPN-ADP-PROPN,compound-compound,ROOT-prep-pobj,NNP-NNP,NNP-IN-NNP,2,1
7523,5654.0,29,has,1,1,13,12,0,15,0,12,Evansville,University of Southern Indiana,,org-org-org-org,PROPN,PROPN-ADP-PROPN-PROPN,nsubj,conj-prep-compound-pobj,NNP,NNP-IN-NNP-NNP,3,1
7524,5655.0,30,said,19,26,28,2,25,1,-7,9,Shanghai,Fudan University,org,-,PROPN,PROPN-PROPN,poss,compound-pobj,NNP,NNP-NNP,3,1
7525,5656.0,20,is,2,2,12,10,1,7,0,10,CFGC,China,org,,PROPN,PROPN,nsubj,pobj,NNP,NNP,2,1
7526,5657.0,37,is,4,1,19,18,0,17,3,15,OCBC Securities Private Limited,Singapore Exchange,org-org-org-org,-,PROPN-PROPN-PROPN-PROPN,PROPN-PROPN,compound-compound-compound-nsubj,compound-compound,NNP-NNPS-NNP-NNP,NNP-NNP,7,1
7527,5658.0,29,is,7,1,5,4,0,23,6,-2,Epicenter Studios,Sherman Oaks,per-per,-,NOUN-NOUN,PROPN-PROPN,compound-nsubj,compound-compound,NN-NNS,NNP-NNP,4,1
7528,5659.0,34,secessionists,14,2,24,22,1,9,12,10,19 December 1990,r Army of the Republic of Bosnia and Herzegovin,--,per-per-per-per-per-per-per-per-per,NUM-PROPN-NUM,DET-PROPN-ADP-DET-PROPN-ADP-PROPN-CCONJ-PROPN,nummod-nmod-nummod,compound-appos-prep-det-pobj-prep-pobj-cc-conj,CD-NNP-CD,DT-NNP-IN-DT-NNP-IN-NNP-CC-NNP,7,1
7529,5660.0,10,Mordente,8,5,8,3,4,1,3,0,Rivera,Tony Mordente,,per-per,PROPN,PROPN-PROPN,nmod,compound-ROOT,NNP,NNP-NNP,2,1
7530,5661.0,30,won,4,3,25,22,2,4,1,21,Alison Redford,Alberta,-,org,PROPN-PROPN,PROPN,compound-nsubj,poss,NNP-NNP,NNP,6,1
7531,12248.0,32,sworn,12,2,21,19,1,10,10,9,Alison Redford,Alberta,-,org,PROPN-PROPN,PROPN,compound-nsubj,compound,NNP-NNP,NNP,7,1
7532,5664.0,14,born,3,1,9,8,0,4,2,6,Auguste Comte,France,per-per,,PROPN-PROPN,PROPN,compound-nsubjpass,pobj,NNP-NNP,NNP,2,1
7533,5665.0,24,promoted,3,2,21,19,1,2,1,18,club,Division,org,,NOUN,PROPN,nsubjpass,dobj,NN,NNP,4,1
7534,5666.0,53,saw,3,8,18,10,7,34,-5,15,Tales of the Supernatural Volume,Fantom,per-per-per-per-per,,PROPN-ADP-DET-PROPN-PROPN,PROPN,pobj-prep-det-compound-pobj,compound,NNPS-IN-DT-NNP-NNP,NNP,7,1
7535,5668.0,23,is,3,1,1,0,0,21,2,-2,Puyallup High School,Puyallup School District,--,per-per-per,PROPN-PROPN-PROPN,PROPN-PROPN-PROPN,compound-compound-nsubj,compound-compound-nmod,NNP-NNP-NNP,NNP-NNP-NNP,0,1
7536,5669.0,23,regarded,2,1,14,13,0,8,1,12,It,Netherlands,org,,PRON,PROPN,nsubjpass,pobj,PRP,NNP,4,1
7537,5671.0,96,are,14,56,79,23,55,16,-42,65,Universidad Piloto de Colombia,Pilot University of Colombia,---,org-org-org-org,PROPN-PROPN-ADP-PROPN,PROPN-PROPN-ADP-PROPN,nmod-nmod-nmod-ROOT,compound-ROOT-prep-pobj,NNP-NNP-IN-NNP,NNP-NNP-IN-NNP,7,1
7538,5672.0,40,referred,6,6,21,15,5,18,0,15,Anderson,singer,,per,PROPN,NOUN,pobj,nsubjpass,NNP,NN,5,1
7539,5674.0,17,is,8,2,15,13,1,1,6,7,Chief,ROK Navy,org,-,PROPN,PROPN-PROPN,nsubj,compound-pobj,NNP,NNP-NNP,6,1
7540,5675.0,36,began,4,14,24,10,13,11,-10,20,Liberia,Taylor,per,,PROPN,PROPN,pobj,nsubjpass,NNP,NNP,6,1
7541,5678.0,46,have,5,26,32,6,25,13,-21,27,General Electric,Engine Alliance,-,per-per,PROPN-PROPN,PROPN-PROPN,compound-conj,compound-compound,NNP-NNP,NNP-NNP,7,1
7542,5679.0,26,is,5,2,23,21,1,2,3,18,Ateneo de Naga University,Camarines Sur,per-per-per-per,-,PROPN-PROPN-PROPN-PROPN,PROPN-PROPN,compound-compound-compound-nsubj,compound-compound,NNPS-NNP-NNP-NNP,NNP-NNP,9,1
7543,12878.0,23,located,4,13,21,8,12,1,-9,17,Ateneo de Naga University,Camarines Sur,per-per-per-per,-,PROPN-PROPN-PROPN-PROPN,PROPN-PROPN,nmod-compound-compound-pobj,compound-appos,NNP-NNP-NNP-NNP,NNP-NNP,6,1
7544,5680.0,62,running,19,13,30,17,12,31,6,11,Griffith College Cork,HETAC,--,per,PROPN-PROPN-PROPN,NOUN,compound-compound-pobj,appos,NNP-NNP-NNP,NN,6,1
7545,5681.0,31,may,28,16,30,14,15,0,12,2,Eagle,1998,per,,PROPN,NUM,compound,npadvmod,NNP,CD,4,1
7546,5683.0,22,started,6,6,13,7,5,8,0,7,Ghana,Kwame Nkrumah University of Science and Technology,per,------,PROPN,PROPN-PROPN-PROPN-ADP-PROPN-CCONJ-PROPN,pobj,compound-compound-pobj-prep-pobj-cc-conj,NNP,NNP-NNP-NNP-IN-NNP-CC-NNP,4,1
7547,5684.0,20,enjoyed,6,2,19,17,1,0,4,13,Colleyville Heritage Panther Band,1996,---,org,PROPN-PROPN-PROPN-PROPN,NUM,compound-compound-compound-nsubj,pobj,NNP-NNP-NNP-NNP,CD,3,1
7548,5685.0,24,played,1,7,14,7,6,9,-6,13,Hillcrest High School,Illinois,--,per,PROPN-PROPN-PROPN,PROPN,compound-compound-pobj,appos,NNP-NNP-NNP,NNP,5,1
7549,5686.0,48,has,1,15,14,-1,14,33,-14,13,Jeremiah S. Black,State,per-per-per,,PROPN-PROPN-PROPN,PROPN,compound-compound-nsubj,pobj,NNP-NNP-NNP,NNP,2,1
7550,5688.0,21,has,1,6,17,11,5,3,-5,16,Afghanistan,Afghan National Army,,org-org-org,PROPN,PROPN-PROPN-PROPN,pobj,compound-compound-compound,NNP,NNP-NNP-NNP,6,1
7551,5689.0,52,signed,9,9,32,23,8,19,0,23,Starr,Atlantic,,org,PROPN,PROPN,pobj,compound,NNP,NNP,4,1
7552,5691.0,38,been,1,12,17,5,11,20,-11,16,Noble and Greenough School,Dedham,---,org,PROPN-CCONJ-PROPN-PROPN,PROPN,nmod-cc-conj-pobj,compound,NNP-CC-NNP-NNP,NNP,4,1
7553,5692.0,50,said,19,5,12,7,4,37,14,-7,Bun Rany,Hun Sen,org-org,-,PROPN-PROPN,PROPN-PROPN,compound-compound,compound-pobj,NNP-NNP,NNP-NNP,3,1
7554,5693.0,27,released,5,16,26,10,15,0,-11,21,Shady,Cashis,,org,PROPN,PROPN,compound,conj,NNP,NNP,5,1
7555,5695.0,27,criticized,3,18,25,7,17,1,-15,22,he,Gabon,per,,PRON,PROPN,nsubj,dobj,PRP,NNP,4,1
7556,5697.0,35,Coalition,0,4,20,16,3,14,-4,20,Montenegro,nce in Monteneg,,per-per-per,PROPN,NOUN-ADP-PROPN,pobj,attr-prep-pobj,NNP,NN-IN-NNP,-1,1
7557,5698.0,16,says,7,1,6,5,0,9,6,-1,Hustler,Larry Flynt,per,-,PROPN,PROPN-PROPN,compound,compound-appos,NNP,NNP-NNP,3,1
7558,12324.0,34,ruled,8,30,32,2,29,1,-22,24,Hustler,Larry Flynt,,per-per,PROPN,PROPN-PROPN,compound,compound-appos,NNP,NNP-NNP,1,1
7559,5699.0,27,was,11,1,17,16,0,9,10,6,Jean-Jacques Bertrand,Quebec,-,org,PROPN-PROPN,PROPN,compound-nsubj,compound,NNP-NNP,NNP,5,1
7560,7018.0,32,Born,0,17,6,-11,16,25,-17,6,Jean-Jacques Bertrand,Quebec,per-per,,VERB-PROPN,PROPN,compound-dobj,pobj,VBZ-NNP,NNP,3,1
7561,8993.0,37,presented,6,5,15,10,4,21,1,9,Jean-Jacques Bertrand,Quebec,-,per,NOUN-PROPN,PROPN,compound-nsubj,pobj,NNS-NNP,NNP,7,1
7562,5700.0,28,acquired,5,22,27,5,21,0,-17,22,McDonnell Douglas,Missouri,-,org,PROPN-PROPN,PROPN,compound-pobj,pobj,NNP-NNP,NNP,4,1
7563,5701.0,38,He,0,23,33,10,22,4,-23,33,Japan,Emperor Meiji,,per-per,PROPN,PROPN-PROPN,pobj,compound-pobj,NNP,NNP-NNP,3,1
7564,13982.0,46,cut,2,7,12,5,6,33,-5,10,Japan,Emperor Meiji,per,-,PROPN,PROPN-PROPN,pobj,compound-poss,NNP,NNP-NNP,6,1
7565,5702.0,26,formed,4,7,20,13,6,5,-3,16,Perth,the Triffids,,org-org,PROPN,DET-PROPN,pobj,det-compound,NNP,DT-NNP,6,1
7566,5703.0,33,said,5,4,5,1,3,27,1,0,Exchequer,Brown,per,,PROPN,PROPN,pobj,nsubj,NNP,NNP,1,1
7567,5706.0,25,Cook,2,1,24,23,0,0,1,22,Alicia Keys,actress,per-per,,PROPN-PROPN,NOUN,compound-nsubj,conj,NNP-NNP,NN,5,1
7568,5708.0,28,was,5,2,26,24,1,1,3,21,Kamala Sankrityayan,Rahul Sankrityayan,-,org-org,PROPN-PROPN,PROPN-PROPN,compound-nsubj,compound-pobj,NNP-NNP,NNP-NNP,7,1
7569,5709.0,28,is,8,1,21,20,0,6,7,13,Irene Pivetti,Chamber,-,per,PROPN-PROPN,PROPN,compound-nsubj,pobj,NNP-NNP,NNP,7,1
7570,5710.0,36,mentioned,2,11,14,3,10,21,-9,12,The Globe and Mail,Mail,org-org-org-org,,DET-PROPN-CCONJ-PROPN,PROPN,det-pobj-cc-conj,conj,DT-NNP-CC-NNP,NNP,5,1
7571,5711.0,28,represent,11,4,14,10,3,13,7,3,Notre Dame Fighting Irish,University of Notre Dame,per-per-per-per,---,PROPN-PROPN-VERB-ADJ,PROPN-ADP-PROPN-PROPN,compound-nsubj-acl-amod,nmod-prep-pobj-dobj,NNP-NNP-VBG-JJ,NNP-IN-NNP-NNP,4,1
7572,5712.0,17,commissioned,2,12,16,4,11,0,-10,14,European Central Bank,Frankfurt,org-org-org,,PROPN-PROPN-PROPN,PROPN,compound-compound-pobj,pobj,NNP-NNP-NNP,NNP,6,1
7573,5713.0,17,04,2,4,4,0,3,12,-2,2,Providence,Providence College,org,-,PROPN,PROPN-PROPN,compound,compound-dobj,NNP,NNP-NNP,0,1
7574,5714.0,66,is,2,1,9,8,0,56,1,7,Tata Tea,India,org-org,,PROPN-PROPN,PROPN,compound-nsubj,compound,NNP-NNP,NNP,3,1
7575,5715.0,40,performed,5,20,39,19,19,0,-15,34,Bud Shank,Four,org-org,,PROPN-PROPN,PROPN,compound-conj,nummod,NNP-NNP,NNP,4,1
7576,5716.0,49,stop,2,9,18,9,8,30,-7,16,Canada,Alma Duncan,per,-,PROPN,PROPN-PROPN,compound,compound-pobj,NNP,NNP-NNP,8,1
7577,5717.0,17,1987,0,12,15,3,11,1,-12,15,Louis Malle,France,-,org,PROPN-PROPN,PROPN,nmod-pobj,appos,NNP-NNP,NNP,1,1
7578,5718.0,20,is,7,1,13,12,0,6,6,6,Northern India Engineering College,Delhi,org-org-org-org,,ADJ-PROPN-PROPN-PROPN,PROPN,amod-compound-compound-nsubj,compound,JJ-NNP-NNP-NNP,NNP,5,1
7579,5719.0,16,resigned,10,3,8,5,2,7,7,-2,William Cautley,Waimea,org-org,,PROPN-PROPN,PROPN,compound-conj,pobj,NNP-NNP,NNP,1,1
7580,5720.0,20,gets,4,14,16,2,13,3,-10,12,Channel NewsAsia,Singapore,per-per,,PROPN-PROPN,PROPN,compound-compound,appos,NNP-NNP,NNP,4,1
7581,5721.0,24,scored,4,9,12,3,8,11,-5,8,Uganda,Africa Cup,,org-org,PROPN,PROPN-PROPN,pobj,compound-nmod,NNP,NNP-NNP,4,1
7582,5722.0,12,became,6,4,4,0,3,7,2,-2,Kerala,Kerala Police,,org-org,PROPN,PROPN-PROPN,pobj,compound-pobj,NNP,NNP-NNP,0,1
7583,5724.0,21,voted,7,6,11,5,5,9,1,4,Ivan,Russian,org,,PROPN,ADJ,nsubjpass,amod,NNP,JJ,4,1
7584,5725.0,23,has,2,8,14,6,7,8,-6,12,Fordham University School of Law,New York,org-org-org-org-org,-,PROPN-PROPN-PROPN-ADP-PROPN,PROPN-PROPN,compound-compound-pobj-prep-pobj,compound-pobj,NNP-NNP-NNP-IN-NNP,NNP-NNP,3,1
7585,5727.0,18,excommunicated,2,11,12,1,10,5,-9,10,King,Richard I of England,,per-per-per-per,PROPN,PROPN-PRON-ADP-PROPN,compound,compound-dobj-prep-pobj,NNP,NNP-PRP-IN-NNP,2,1
7586,5728.0,25,selected,3,20,24,4,19,0,-17,21,her,Arizona,,org,DET,PROPN,poss,pobj,PRP$,NNP,7,1
7587,5729.0,38,performed,1,1,25,24,0,12,0,24,Soundgarden,Washington,per,,PROPN,PROPN,nsubj,pobj,NNP,NNP,5,1
7588,5730.0,20,defended,3,1,19,18,0,0,2,16,Johan Larsson,Sweden,-,per,PROPN-PROPN,PROPN,compound-compound,pobj,NNP-NNP,NNP,3,1
7589,5732.0,10,headquartered,4,1,7,6,0,2,3,3,MICROS Systems,Columbia,org-org,,PROPN-PROPN,PROPN,compound-compound,compound,NNP-NNPS,NNP,5,1
7590,5733.0,26,was,1,9,19,10,8,6,-8,18,Miami Hurricanes,Coral Gables,per-per,-,PROPN-PROPN,PROPN-PROPN,compound-compound,compound-compound,NNP-NNP,NNP-NNPS,8,1
7591,5734.0,43,said,20,1,11,10,0,31,19,-9,Kevin C. Kiley,Army,org-org-org,,PROPN-PROPN-PROPN,PROPN,compound-compound-nsubj,poss,NNP-NNP-NNP,NNP,6,1
7592,5735.0,30,followed,2,6,20,14,5,9,-4,18,Talent,Missouri,,per,PROPN,PROPN,poss,compound,NNP,NNP,9,1
7593,5737.0,37,ran,5,21,29,8,20,7,-16,24,Badakhshan,Rabbani,,per,PROPN,PROPN,compound,pobj,NNP,NNP,12,1
7594,5738.0,25,comes,2,7,13,6,6,11,-5,11,India,Bharti Airtel,per,-,PROPN,PROPN-PROPN,poss,compound-compound,NNP,NNP-NNP,3,1
7595,5739.0,51,maintained,4,26,28,2,25,22,-22,24,Puerto Rico,Rivero,-,per,PROPN-PROPN,PROPN,compound-compound,pobj,NNP-NNP,NNP,2,1
7596,6082.0,32,held,5,10,27,17,9,4,-5,22,Puerto Rico,Rivero,-,org,PROPN-PROPN,PROPN,compound-pobj,pobj,NNP-NNP,NNP,8,1
7597,5740.0,44,is,16,18,42,24,17,1,-2,26,Peter G. Peterson,Blackstone Group,per-per-per,-,PROPN-PROPN-PROPN,PROPN-PROPN,nmod-nmod-attr,compound-pobj,NNP-NNP-NNP,NNP-NNP,8,1
7598,9296.0,65,In,0,50,57,7,49,7,-50,57,Peter G. Peterson,Blackstone Group,per-per-per,-,PROPN-PROPN-PROPN,PROPN-PROPN,compound-compound-conj,compound-pobj,NNP-NNP-NNP,NNP-NNP,6,1
7599,12387.0,32,is,5,2,26,24,1,5,3,21,Peter G. Peterson,Blackstone Group,--,org-org,PROPN-PROPN-PROPN,PROPN-PROPN,compound-compound-compound,compound-pobj,NNP-NNP-NNP,NNP-NNP,9,1
7600,5741.0,25,is,10,1,8,7,0,16,9,-2,Max Biaggi,Aprilia,-,per,PROPN-PROPN,PROPN,compound-nsubj,compound,NNP-NNP,NNP,4,1
7601,5742.0,41,began,5,10,15,5,9,25,-5,10,Eugene Oregon,Dynamix,-,per,PROPN-PROPN,PROPN,compound-compound,appos,NNP-NNP,NNP,4,1
7602,5743.0,20,created,1,13,18,5,12,1,-12,17,United States,lightning bolt,per-per,-,PROPN-PROPN,NOUN-NOUN,compound-pobj,compound-dobj,NNP-NNP,NN-NN,8,1
7603,5744.0,28,is,2,10,15,5,9,12,-8,13,Ireland,Tesco Ireland,org,-,PROPN,PROPN-PROPN,poss,compound-appos,NNP,NNP-NNP,3,1
7604,5745.0,27,sent,7,15,26,11,14,0,-8,19,Spanish Army,Grande,-,org,ADJ-PROPN,PROPN,compound-pobj,pobj,JJ-NNP,NNP,3,1
7605,5746.0,22,appointed,4,3,11,8,2,10,1,7,he,Senate,org,,PRON,PROPN,nsubjpass,poss,PRP,NNP,7,1
7606,5747.0,17,ranked,4,1,13,12,0,3,3,9,Eastern,United States,,org-org,PROPN,PROPN-PROPN,nsubjpass,compound-pobj,NNP,NNP-NNP,5,1
7607,5748.0,7,Ekaterina,0,1,4,3,0,2,-1,4,Ekaterina Pushkash/Jonathan Guerreiro,Russia,org-org-org,,ADV-PROPN-PROPN,PROPN,ROOT-prep-pobj,npadvmod,RB-NNP-NNP,NNP,2,1
7608,5749.0,39,moved,14,24,37,13,23,1,-10,23,1974,Trondheim Trafikkselskap,per,-,NUM,PROPN-PROPN,pobj,compound-pobj,CD,NNP-NNP,4,1
7609,5750.0,37,was,2,1,10,9,0,26,1,8,Starz,Liberty Media,,per-per,NOUN,PROPN-PROPN,nsubj,compound-conj,NNS,NNP-NNP,4,1
7610,5751.0,32,is,10,2,17,15,1,14,8,7,Anglo Colombian School,Bogota,per-per-per,,PROPN-PROPN-PROPN,PROPN,amod-compound-nsubj,compound,NNP-NNP-NNP,NNP,4,1
7611,5752.0,31,hosted,4,22,22,0,21,8,-18,18,Boston and Albany Railroad,Boston,org-org-org-org,,PROPN-CCONJ-PROPN-PROPN,PROPN,appos-cc-compound-conj,compound,NNP-CC-NNP-NNP,NNP,0,1
7612,5753.0,28,Visiting,6,19,26,7,18,1,-13,20,Johns Hopkins University School of Medicine,Baltimore,-----,org,PROPN-PROPN-PROPN-PROPN-ADP-PROPN,PROPN,compound-compound-compound-pobj-prep-pobj,compound,NNP-NNP-NNP-NNP-IN-NNP,NNP,4,1
7613,5754.0,39,charged,2,20,36,16,19,2,-18,34,Federal Home Loan Mortgage Corporation,Freddie Mac,per-per-per-per-per,-,PROPN-PROPN-PROPN-PROPN-PROPN,PROPN-PROPN,compound-compound-compound-compound-conj,compound-appos,NNP-NNP-NNP-NNP-NNP,NNP-NNP,3,1
7614,5755.0,22,is,2,15,21,6,14,0,-13,19,Gackt,Japan,org,,PROPN,PROPN,pobj,pobj,NNP,NNP,6,1
7615,5757.0,80,provides,21,8,13,5,7,66,13,-8,United Kingdom,Victoria of the United Kingdom,-,org-org-org-org-org,PROPN-PROPN,PROPN-ADP-DET-PROPN-PROPN,compound-pobj,appos-prep-det-compound-pobj,NNP-NNP,NNP-IN-DT-NNP-NNP,8,1
7616,5758.0,44,established,4,1,17,16,0,26,3,13,HSBC,The Hongkong and Shanghai Banking Corporation,per,-----,PROPN,DET-PROPN-CCONJ-PROPN-PROPN-PROPN,compound,det-nmod-cc-compound-compound-pobj,NNP,DT-NNP-CC-NNP-NNP-NNP,6,1
7617,5759.0,49,Haramaty,1,15,18,3,14,30,-14,17,VocalTec,1989,per,,PROPN,NUM,compound,appos,NNP,CD,5,1
7618,5760.0,23,became,3,7,21,14,6,1,-4,18,Computer Sciences Corporation,Fletcher Jones,org-org-org,-,PROPN-PROPN-PROPN,PROPN-PROPN,compound-compound-pobj,compound-conj,NNP-NNPS-NNP,NNP-NNP,8,1
7619,5761.0,35,released,2,1,7,6,0,27,1,5,The Fall,Permanent,-,per,DET-PROPN,PROPN,det-nsubj,compound,DT-NNP,NNP,4,1
7620,5762.0,16,said,11,8,10,2,7,5,3,-1,Nova Scotia,Murray,-,per,PROPN-PROPN,PROPN,compound-compound,pobj,NNP-NNP,NNP,2,1
7621,5763.0,22,is,2,1,11,10,0,10,1,9,Stan Kinsey,Iwerks Entertainment,per-per,-,PROPN-PROPN,PROPN-PROPN,compound-nsubj,compound-pobj,NNP-NNP,NNP-NNP,4,1
7622,5765.0,43,said,1,1,13,12,0,29,0,12,Saleh,Yemen,per,,PROPN,PROPN,nsubj,poss,NNP,NNP,6,1
7623,5766.0,34,re-incorporated,6,3,9,6,2,24,3,3,Gulf + Western,Paramount Communications,per-per-per,-,PROPN-SYM-PROPN,PROPN-PROPN,nsubjpass-cc-nsubjpass,compound-pobj,NNP-SYM-NNP,NNP-NNP,5,1
7624,5768.0,17,opened,3,1,6,5,0,10,2,3,Lincoln High School,1869,org-org-org,,PROPN-PROPN-PROPN,NUM,compound-compound-nsubj,pobj,NNP-NNP-NNP,CD,3,1
7625,5769.0,27,earned,5,10,12,2,9,14,-5,7,Wheaton College,Illinois,-,org,PROPN-PROPN,PROPN,compound-compound,pobj,NNP-NNP,NNP,4,1
7626,5772.0,18,represents,6,3,9,6,2,8,3,3,Louisville Cardinals,University of Louisville,-,per-per-per,PROPN-PROPN,PROPN-ADP-PROPN,compound-compound,dobj-prep-pobj,NNP-NNPS,NNP-IN-NNP,4,1
7627,9272.0,18,represented,6,3,9,6,2,8,3,3,Louisville Cardinals,University of Louisville,org-org,--,PROPN-PROPN,PROPN-ADP-PROPN,compound-compound,dobj-prep-pobj,NNP-NNPS,NNP-IN-NNP,4,1
7628,5773.0,27,contains,2,8,10,2,7,16,-6,8,Montpelier,James Madison,,org-org,PROPN,PROPN-PROPN,compound,compound-poss,NNP,NNP-NNP,1,1
7629,5774.0,36,rose,8,8,23,15,7,12,0,15,Deng,Communist Party,,per-per,PROPN,PROPN-PROPN,nsubj,compound-pobj,NNP,NNP-NNP,4,1
7630,5776.0,22,is,15,1,13,12,0,8,14,-2,Zhang Li,Guangzhou,-,org,PROPN-PROPN,PROPN,compound-nsubj,compound,NNP-NNP,NNP,4,1
7631,5777.0,36,opened,28,2,27,25,1,8,26,-1,Escuela Nacional Preparatoria,UNAM,--,org,PROPN-PROPN-PROPN,PROPN,compound-compound-nsubj,appos,NNP-NNP-NNP,NNP,6,1
7632,5778.0,16,founded,10,8,12,4,7,3,2,2,Eizo,Irem,,per,PROPN,PROPN,compound,compound,NNP,NNP,4,1
7633,5779.0,16,is,4,2,13,11,1,2,2,9,Franklin High School,Pennsylvania,--,org,PROPN-PROPN-PROPN,PROPN,compound-compound-nsubj,compound,NNP-NNP-NNP,NNP,7,1
7634,5780.0,19,played,7,4,12,8,3,6,3,5,University of Miami,Hurricanes,--,org,PROPN-ADP-PROPN,PROPN,nmod-prep-pobj,compound,NNP-IN-NNP,NNP,7,1
7635,5781.0,18,is,1,11,17,6,10,0,-10,16,Western Connecticut State University,Danbury,per-per-per-per,,PROPN-PROPN-PROPN-PROPN,PROPN,compound-compound-compound-dobj,pobj,NNP-NNP-NNP-NNP,NNP,4,1
7636,5782.0,21,is,9,15,18,3,14,2,-6,9,Bristol Community College,Fall River,org-org-org,-,PROPN-PROPN-PROPN,PROPN-PROPN,compound-compound-compound,compound-compound,NNP-NNP-NNP,NNP-NNP,2,1
7637,5783.0,24,was,2,17,19,2,16,4,-15,17,Jawaharlal Nehru,India,per-per,,PROPN-PROPN,PROPN,compound-compound,poss,NNP-NNP,NNP,4,1
7638,11268.0,22,was,2,15,17,2,14,4,-13,15,Jawaharlal Nehru,India,per-per,,PROPN-PROPN,PROPN,compound-compound,poss,NNP-NNP,NNP,7,1
7639,12366.0,37,claimed,14,6,31,25,5,5,8,17,Jawaharlal Nehru,India,per-per,,PROPN-PROPN,PROPN,compound-compound,pobj,NNP-NNP,NNP,10,1
7640,5785.0,29,Follow,0,11,27,16,10,1,-11,27,Nikki Webster,Gotham,-,org,PROPN-PROPN,PROPN,compound-pobj,compound,NNP-NNP,NNP,6,1
7641,9978.0,31,is,5,4,29,25,3,1,1,24,Nikki Webster,Gotham,org-org,,PROPN-PROPN,PROPN,compound-pobj,compound,NNP-NNP,NNP,6,1
7642,5786.0,29,chanted,3,11,14,3,10,14,-8,11,British,he,org,,ADJ,PRON,amod,nsubj,JJ,PRP,2,1
7643,5789.0,28,began,5,24,27,3,23,0,-19,22,Jean Delannoy,France,-,org,PROPN-PROPN,PROPN,compound-conj,pobj,NNP-NNP,NNP,4,1
7644,5790.0,32,filmed,5,4,12,8,3,19,1,7,Damon,Salisbury,per,,PROPN,PROPN,nsubjpass,pobj,NNP,NNP,2,1
7645,5791.0,21,was,5,2,12,10,1,8,3,7,Carlsson,Sweden,,per,PROPN,PROPN,poss,pobj,NNP,NNP,4,1
7646,5792.0,29,stood,1,20,24,4,19,4,-19,23,Anerood Jugnauth,MSM,-,per,PROPN-PROPN,PROPN,compound-pobj,pobj,NNP-NNP,NNP,6,1
7647,5793.0,12,born,3,1,11,10,0,0,2,8,Natalia,Spain,org,,PROPN,PROPN,compound,pobj,NNP,NNP,2,1
7648,5794.0,27,initiated,11,8,25,17,7,1,3,14,The Starting Line,Kenny Vasoli,org-org-org,-,DET-PROPN-NOUN,PROPN-PROPN,det-compound-attr,compound-dobj,DT-NNP-NN,NNP-NNP,8,1
7649,5797.0,39,controls,15,18,24,6,17,14,-3,9,Danfoss,Nordborg,,per,PROPN,PROPN,compound,compound,NNP,NNP,3,1
7650,5800.0,21,is,5,11,20,9,10,0,-6,15,Mexico,Televisa,per,,PROPN,PROPN,compound,pobj,NNP,NNP,5,1
7651,5801.0,18,helped,1,9,16,7,8,1,-8,15,Rudolph Valentino,Natacha Rambova,-,org-org,PROPN-PROPN,PROPN-PROPN,compound-poss,compound-conj,NNP-NNP,NNP-NNP,3,1
7652,5802.0,12,was,2,8,10,2,7,1,-6,8,Annihilator,Jeff Waters,per,-,PROPN,PROPN-PROPN,pobj,compound-dobj,NNP,NNP-NNP,1,1
7653,5803.0,26,decreed,8,6,7,1,5,18,2,-1,Navy,Frank Knox,org,-,PROPN,PROPN-PROPN,compound,compound-pobj,NNP,NNP-NNP,1,1
7654,8286.0,23,tells,3,12,13,1,11,9,-9,10,Navy,Frank Knox,,per-per,PROPN,PROPN-PROPN,pobj,compound-dobj,NNP,NNP-NNP,1,1
7655,8859.0,27,fired,14,10,11,1,9,15,4,-3,Navy,Frank Knox,org,-,PROPN,PROPN-PROPN,pobj,compound-nsubj,NNP,NNP-NNP,1,1
7656,9178.0,24,inspected,9,16,17,1,15,6,-7,8,Navy,Frank Knox,,per-per,PROPN,PROPN-PROPN,pobj,compound-conj,NNP,NNP-NNP,1,1
7657,10431.0,31,commended,7,4,5,1,3,25,3,-2,Navy,Frank Knox,org,-,PROPN,PROPN-PROPN,pobj,compound-nsubj,NNP,NNP-NNP,1,1
7658,11223.0,95,II,2,25,26,1,24,68,-23,24,Navy,Frank Knox,,org-org,PROPN,PROPN-PROPN,pobj,compound-pobj,NNP,NNP-NNP,1,1
7659,14126.0,28,speculated,2,14,15,1,13,12,-12,13,Navy,Frank Knox,,per-per,PROPN,PROPN-PROPN,compound,compound-poss,NNP,NNP-NNP,6,1
7660,5804.0,44,tried,3,22,7,-15,21,36,-19,4,Calgary,Brownlee,org,,PROPN,NOUN,pobj,compound,NNP,NN,8,1
7661,5805.0,43,was,35,7,8,1,6,34,28,-27,President,Francesco Cossiga,,per-per,PROPN,PROPN-PROPN,compound,compound-pobj,NNP,NNP-NNP,1,1
7662,5806.0,27,said,25,17,21,4,16,5,8,-4,Canada,Public Health Agency of Canada,,per-per-per-per-per,PROPN,PROPN-PROPN-PROPN-ADP-PROPN,pobj,compound-compound-pobj-prep-pobj,NNP,NNP-NNP-NNP-IN-NNP,2,1
7663,5807.0,23,May,0,4,4,0,3,18,-4,4,Air China,Air China Cargo,-,org-org-org,PROPN-PROPN,PROPN-PROPN-PROPN,compound-nsubj,compound-compound-pobj,NNP-NNP,NNP-NNP-NNP,0,1
7664,5809.0,25,was,1,18,20,2,17,4,-17,19,Vice President,Lee Teng-hui,per-per,-,PROPN-PROPN,PROPN-PROPN,compound-compound,compound-dobj,NNP-NNP,NNP-NNP,2,1
7665,5810.0,86,released,10,73,45,-28,72,40,-63,35,Iraqi National Congress,Iraq,--,per,PROPN-PROPN-PROPN,PROPN,compound-compound-pobj,pobj,NNP-NNP-NNP,NNP,9,1
7666,5811.0,29,offering,14,1,11,10,0,17,13,-3,RES - The School for Renewable Energy Science,Akureyri,per-per-per-per-per-per-per-per,,PROPN-PUNCT-DET-PROPN-ADP-PROPN-PROPN-PROPN,PROPN,compound-punct-det-nsubj-prep-compound-compound-pobj,compound,NNP-:-DT-NNP-IN-NNP-NNP-NNP,NNP,8,1
7667,5812.0,51,reported,6,17,20,3,16,30,-11,14,Idaho,Steve Symms,,org-org,PROPN,PROPN-PROPN,compound,compound-pobj,NNP,NNP-NNP,2,1
7668,5813.0,23,served,1,1,12,11,0,10,0,11,He,State,,org,PRON,PROPN,nsubj,pobj,PRP,NNP,1,1
7669,5815.0,40,occur,26,1,8,7,0,31,25,-18,Taft,Ohio,org,,PROPN,PROPN,poss,compound,NNP,NNP,6,1
7670,5816.0,9,relocated,3,2,6,4,1,2,1,3,his,Des Moines,org,-,DET,PROPN-PROPN,poss,compound-compound,PRP$,NNP-NNP,4,1
7671,5817.0,19,left,9,4,8,4,3,10,5,-1,Pillar,Michael Wittig,org,-,PROPN,PROPN-PROPN,pobj,compound-nsubj,NNP,NNP-NNP,4,1
7672,5818.0,35,was,2,11,27,16,10,7,-9,25,Belgium,Leopold III of Belgium,per,---,PROPN,PROPN-PROPN-ADP-PROPN,pobj,compound-pobj-prep-pobj,NNP,NNP-NNP-IN-NNP,2,1
7673,5819.0,32,represents,7,2,19,17,1,12,5,12,Penn State Nittany Lions,Division I,---,per-per,PROPN-PROPN-PROPN-PROPN,PROPN-PROPN,compound-compound-compound-compound,pobj-compound,NNP-NNP-NNP-NNP,NNP-NNP,8,1
7674,5820.0,17,created,1,1,7,6,0,9,0,6,Taschereau,Quebec,per,,PROPN,PROPN,nsubj,compound,NNP,NNP,2,1
7675,5821.0,42,did,2,37,41,4,36,0,-35,39,University of Redlands,California,--,per,PROPN-ADP-PROPN,PROPN,pobj-prep-pobj,pobj,NNP-IN-NNP,NNP,2,1
7676,5823.0,18,is,6,1,9,8,0,8,5,3,John Lee,American,-,per,PROPN-PROPN,ADJ,compound-nsubj,amod,NNP-NNP,JJ,5,1
7677,5824.0,27,In,0,3,8,5,2,18,-3,8,W?adys?aw I Herm,ed Judith of Swab,per-per-per,---,NOUN-PRON-VERB,NOUN-PROPN-ADP-PROPN,pobj-nsubj-ROOT,dobj-appos-prep-pobj,NN-PRP-VBP,NN-NNP-IN-NNP,3,1
7678,5825.0,29,folded,23,2,7,5,1,21,21,-16,1979,New Jersey Transit,per,--,NUM,PROPN-PROPN-PROPN,pobj,compound-compound-compound,CD,NNP-NNP-NNP,6,1
7679,5826.0,55,came,6,25,29,4,24,25,-19,23,Burundi,Pierre Nkurunziza,per,-,PROPN,PROPN-PROPN,poss,compound-appos,NNP,NNP-NNP,3,1
7680,9470.0,39,speaking,2,24,26,2,23,12,-22,24,Burundi,Pierre Nkurunziza,per,-,PROPN,PROPN-PROPN,compound,compound-compound,NNP,NNP-NNP,1,1
7681,10436.0,26,said,5,22,24,2,21,1,-17,19,Burundi,Pierre Nkurunziza,org,-,PROPN,PROPN-PROPN,amod,compound-conj,NNP,NNP-NNP,3,1
7682,10639.0,32,fired,3,27,30,3,26,1,-24,27,Burundi,Pierre Nkurunziza,per,-,PROPN,PROPN-PROPN,pobj,compound-attr,NNP,NNP-NNP,5,1
7683,11384.0,31,needs,11,8,23,15,7,7,3,12,Burundi,Pierre Nkurunziza,org,-,PROPN,PROPN-PROPN,poss,compound-pobj,NNP,NNP-NNP,10,1
7684,13838.0,22,attend,9,3,20,17,2,1,6,11,Burundi,Pierre Nkurunziza,per,-,PROPN,PROPN-PROPN,poss,compound-pobj,NNP,NNP-NNP,10,1
7685,13839.0,28,signed,7,1,4,3,0,23,6,-3,Burundi,Pierre Nkurunziza,per,-,PROPN,PROPN-PROPN,poss,compound-nsubj,NNP,NNP-NNP,3,1
7686,13930.0,25,held,14,13,23,10,12,1,1,9,Burundi,Pierre Nkurunziza,org,-,PROPN,PROPN-PROPN,pobj,compound-pobj,NNP,NNP-NNP,6,1
7687,5827.0,50,formed,5,33,37,4,32,12,-28,32,John B. Fairfax,Rural Press,per-per-per,-,PROPN-PROPN-PROPN,PROPN-PROPN,compound-compound-pobj,compound-pobj,NNP-NNP-NNP,NNP-NNP,3,1
7688,5828.0,33,was,27,5,25,20,4,7,22,-2,his,South Africa,per,-,DET,PROPN-PROPN,poss,compound-pobj,PRP$,NNP-NNP,9,1
7689,5829.0,42,taught,20,16,32,16,15,9,4,12,Chicago,Martin H. Kennelly,,per-per-per,PROPN,PROPN-PROPN-PROPN,compound,compound-compound-compound,NNP,NNP-NNP-NNP,-1,1
7690,5830.0,35,In,0,18,30,12,17,4,-18,30,Cold Chillin,Kool G. Rap,-,per-per-per,PROPN-PROPN,PROPN-PROPN-PROPN,compound-poss,compound-compound-conj,NNP-NNP,NNP-NNP-NNP,9,1
7691,5831.0,22,founded,16,1,5,4,0,16,15,-11,KCCLA,Los Angeles,per,-,PROPN,PROPN-PROPN,nsubjpass,compound-compound,NNP,NNP-NNP,4,1
7692,5832.0,22,had,2,15,20,5,14,1,-13,18,State for Wales,John Redwood,org-org-org,-,PROPN-ADP-PROPN,PROPN-PROPN,pobj-prep-pobj,compound-appos,NNP-IN-NNP,NNP-NNP,2,1
7693,5833.0,41,is,8,1,24,23,0,16,7,16,Anthony Corrie,Collingwood Football Club,-,per-per-per,PROPN-PROPN,PROPN-PROPN-PROPN,compound-nsubj,compound-compound-conj,NNP-NNP,NNP-NNP-NNP,7,1
7694,5835.0,16,is,2,1,15,14,0,0,1,13,de Saint-Laurent,Quebec,-,org,X-PROPN,PROPN,nmod-nsubj,pobj,FW-NNP,NNP,7,1
7695,5836.0,40,recruited,3,16,39,23,15,0,-13,36,Royal New Zealand Infantry Regiment,Army,----,per,PROPN-PROPN-PROPN-PROPN-PROPN,PROPN,compound-compound-compound-compound-nsubj,pobj,NNP-NNP-NNP-NNP-NNP,NNP,8,1
7696,5837.0,17,recorded,6,1,4,3,0,12,5,-2,Steve Albini,Big Black,-,per-per,PROPN-PROPN,PROPN-PROPN,compound-nsubj,compound-appos,NNP-NNP,NNP-NNP,1,1
7697,5838.0,28,denounced,16,13,15,2,12,12,3,-1,Liberal,Gerry Byrne,,per-per,PROPN,PROPN-PROPN,compound,compound-nsubj,NNP,NNP-NNP,1,1
7698,5839.0,43,published,3,2,17,15,1,25,1,14,New York,Doris Duke,-,per-per,PROPN-PROPN,PROPN-PROPN,compound-nsubj,compound-compound,NNP-NNP,NNP-NNP,5,1
7699,5840.0,25,tried,9,7,24,17,6,0,2,15,Hayao Miyazaki,herself,-,per,PROPN-PROPN,PRON,compound-pobj,appos,NNP-NNP,PRP,4,1
7700,5841.0,82,In,0,64,80,16,63,1,-64,80,HT Media Ltd,Delhi,--,org,PROPN-PROPN-PROPN,PROPN,compound-compound-pobj,compound,NNP-NNP-NNP,NNP,6,1
7701,5842.0,13,introduced,7,4,6,2,3,6,3,-1,Prime Minister,William Gladstone,org-org,-,PROPN-PROPN,PROPN-PROPN,compound-compound,compound-nsubj,NNP-NNP,NNP-NNP,1,1
7702,5843.0,46,were,13,1,22,21,0,23,12,9,The Byrds,Crosby,org-org,,DET-PROPN,PROPN,det-poss,conj,DT-NNPS,NNP,6,1
7703,5844.0,37,been,6,13,17,4,12,19,-7,11,University of Kansas,Lawrence,--,per,PROPN-ADP-PROPN,PROPN,pobj-prep-pobj,pobj,NNP-IN-NNP,NNP,2,1
7704,9189.0,22,Society,2,14,18,4,13,3,-12,16,University of Kansas,Lawrence,--,per,PROPN-ADP-PROPN,PROPN,conj-prep-pobj,appos,NNP-IN-NNP,NNP,6,1
7705,5845.0,23,is,3,14,16,2,13,6,-11,13,Pantera,Dimebag Darrell,org,-,PROPN,PROPN-PROPN,conj,compound-compound,NNP,NNP-NNP,3,1
7706,6196.0,20,track,1,14,18,4,13,1,-13,17,Pantera,Dimebag Darrell,per,-,PROPN,PROPN-PROPN,nmod,compound-pobj,NNP,NNP-NNP,4,1
7707,5846.0,19,is,3,1,16,15,0,2,2,13,The Linfield Review,Oregon,org-org-org,,DET-PROPN-PROPN,PROPN,det-compound-nsubj,compound,DT-NNP-NNP,NNP,10,1
7708,5847.0,38,aims,7,19,11,-8,18,26,-12,4,Democratic Progressive Party,Taiwan,--,per,PROPN-PROPN-PROPN,PROPN,compound-compound-compound,compound,NNP-NNP-NNP,NNP,8,1
7709,5848.0,44,constituted,3,1,19,18,0,24,2,16,Sulla,Roman Republic,per,-,PROPN,PROPN-PROPN,poss,compound-pobj,NNP,NNP-NNP,12,1
7710,5849.0,28,streamline,3,15,8,-7,14,19,-12,5,Taiwan Police Administration,National Police Agency,--,per-per-per,PROPN-PROPN-PROPN,PROPN-PROPN-PROPN,compound-compound-pobj,compound-compound-dobj,NNP-NNPS-NNP,NNP-NNP-NNP,5,1
7711,5850.0,28,was,11,1,25,24,0,2,10,14,Sheikh Mukhtar Mohamed Hussein,Somalia,per-per-per-per,,PROPN-PROPN-PROPN-PROPN,PROPN,compound-compound-compound-nsubj,pobj,NNP-NNP-NNP-NNP,NNP,5,1
7712,5851.0,13,is,2,1,11,10,0,1,1,9,Spring Airlines,Travel Service,per-per,-,PROPN-PROPN,PROPN-PROPN,compound-nsubj,compound-pobj,NNP-NNPS,NNP-NNP,4,1
7713,5852.0,29,is,11,8,8,0,7,20,3,-3,Tel Aviv,Tel Aviv University,org-org,--,PROPN-PROPN,PROPN-PROPN-PROPN,compound-compound,compound-compound-pobj,NNP-NNP,NNP-NNP-NNP,0,1
7714,5854.0,41,was,14,33,20,-13,32,20,-19,6,Communications and Electronics Branch,Canadian Forces,---,org-org,PROPN-CCONJ-PROPN-PROPN,PROPN-PROPN,nmod-cc-conj-conj,compound-pobj,NNPS-CC-NNPS-NNP,NNP-NNPS,7,1
7715,7359.0,19,came,7,11,17,6,10,1,-4,10,Communications and Electronics Branch,Canadian Forces,org-org-org-org,-,PROPN-CCONJ-PROPN-PROPN,PROPN-PROPN,nmod-cc-conj-pobj,compound-pobj,NNPS-CC-NNPS-NNP,NNP-NNPS,4,1
7716,5856.0,37,retired,11,5,8,3,4,28,6,-3,British Airways,airline,org-org,,PROPN-PROPN,NOUN,compound-pobj,poss,NNP-NNP,NN,4,1
7717,5857.0,20,said,4,16,18,2,15,1,-12,14,Enoksen,Siumut,per,,PROPN,PROPN,poss,compound,NNP,NNP,2,1
7718,5858.0,21,said,15,1,5,4,0,15,14,-10,Saad,Denmark,per,,PROPN,PROPN,nsubj,poss,NNP,NNP,6,1
7719,5860.0,25,created,11,17,23,6,16,1,-6,12,England,James Edwards,,org-org,PROPN,PROPN-PROPN,pobj,compound-pobj,NNP,NNP-NNP,3,1
7720,5861.0,23,was,11,1,22,21,0,0,10,11,Pedro Romero,Spain,-,per,PROPN-PROPN,PROPN,compound-nsubj,pobj,NNP-NNP,NNP,2,1
7721,12289.0,30,born,5,1,9,8,0,20,4,4,Pedro Romero,Spain,per-per,,PROPN-PROPN,PROPN,compound-compound,pobj,NNP-NNP,NNP,2,1
7722,5863.0,16,song,3,7,8,1,6,7,-4,5,singer,Amanda Lear,per,-,NOUN,PROPN-PROPN,compound,compound-pobj,NN,NNP-NNP,1,1
7723,5865.0,15,was,10,1,14,13,0,0,9,4,Gilbert Ryle,philosopher,-,per,PROPN-PROPN,NOUN,compound-nsubj,attr,NNP-NNP,NN,2,1
7724,5866.0,26,exchanged,5,11,14,3,10,11,-6,9,Latvia,Valdis Zatlers,org,-,PROPN,PROPN-PROPN,poss,compound-nsubj,NNP,NNP-NNP,3,1
7725,6075.0,24,awarded,8,6,7,1,5,16,2,-1,Latvia,Valdis Zatlers,,per-per,PROPN,PROPN-PROPN,compound,compound-pobj,NNP,NNP-NNP,1,1
7726,11912.0,27,vowed,3,3,25,22,2,1,0,22,Latvia,Valdis Zatlers,org,-,PROPN,PROPN-PROPN,conj,compound-pobj,NNP,NNP-NNP,6,1
7727,5868.0,23,contains,1,9,16,7,8,6,-8,15,; Empress Teime,( Hirohi,per-per-per,-,PUNCT-PROPN-PROPN,PUNCT-NOUN,punct-compound-npadvmod,punct-appos,:-NNP-NNP,-LRB--NN,3,1
7728,5870.0,90,dissolve,8,58,74,16,57,15,-50,66,: Preside,nt Boris Tad,per-per,--,PUNCT-NOUN,ADV-PROPN-PROPN,punct-ROOT,intj-compound-compound,:-NN,RB-NNP-NNP,7,1
7729,5871.0,20,owns,6,3,17,14,2,2,3,11,Mirant,PowerGen,,org,PROPN,PROPN,appos,compound,NNP,NNP,7,1
7730,5872.0,34,was,7,16,23,7,15,10,-9,16,Alberto Jardim,Regional Government,per-per,-,PROPN-PROPN,PROPN-PROPN,compound-conj,compound-pobj,NNP-NNP,NNP-NNP,4,1
7731,5874.0,45,was,18,26,32,6,25,12,-8,14,Grand Forks,University of North Dakota,-,per-per-per-per,PROPN-PROPN,PROPN-ADP-PROPN-PROPN,compound-compound,pobj-prep-compound-pobj,NNP-NNP,NNP-IN-NNP-NNP,6,1
7732,5875.0,12,is,1,7,10,3,6,1,-6,9,Australian,Paul Keating,,per-per,ADJ,PROPN-PROPN,amod,compound-pobj,JJ,NNP-NNP,2,1
7733,5876.0,12,is,1,9,10,1,8,1,-8,9,composer,Eve Beglarian,org,-,NOUN,PROPN-PROPN,compound,compound-pobj,NN,NNP-NNP,1,1
7734,5878.0,24,insisted,10,6,14,8,5,9,4,4,Andrew Cheng,Hong Kong,-,per-per,PROPN-PROPN,PROPN-PROPN,compound-pobj,compound-poss,NNP-NNP,NNP-NNP,4,1
7735,5879.0,27,is,9,15,19,4,14,7,-6,10,author,Khon Kaen University,org,--,NOUN,PROPN-PROPN-PROPN,compound,compound-compound-poss,NN,NNP-NNP-NNP,5,1
7736,5880.0,25,started,2,1,16,15,0,8,1,14,He,Mexico,,per,PRON,PROPN,nsubj,poss,PRP,NNP,7,1
7737,12604.0,8,was,1,1,7,6,0,0,0,6,He,Mexico,,per,PRON,PROPN,nsubj,oprd,PRP,NNP,2,1
7738,5881.0,17,completed,4,11,16,5,10,0,-7,12,University of Southern Queensland,Toowoomba,org-org-org-org,,PROPN-ADP-PROPN-PROPN,PROPN,pobj-prep-compound-pobj,pobj,NNP-IN-NNP-NNP,NNP,5,1
7739,5882.0,15,founded,3,1,11,10,0,3,2,8,Matrix Games,Staten Island,org-org,-,PROPN-PROPN,PROPN-PROPN,compound-nsubjpass,compound-compound,NNP-NNPS,NNP-NNP,4,1
7740,5883.0,17,occurred,3,11,14,3,10,2,-8,11,Chicago,LaSalle National Bank,per,--,PROPN,PROPN-PROPN-PROPN,npadvmod,compound-compound-pobj,NNP,NNP-NNP-NNP,2,1
7741,5884.0,22,featured,3,16,1,-15,15,20,-13,-2,Atlantic Records,The Gufs,-,org-org,PROPN-PROPN,DET-PROPN,compound-compound,det-pobj,NNP-NNPS,DT-NNP,4,1
7742,5885.0,30,referred,8,5,25,20,4,4,3,17,San Antonio Unido,Chile,per-per-per,,PROPN-PROPN-PROPN,PROPN,compound-compound-nsubj,pobj,NNP-NNP-NNP,NNP,5,1
7743,5888.0,24,served,1,10,19,9,9,4,-9,18,Federated States,Tosiwo Nakayama,-,per-per,PROPN-PROPN,PROPN-PROPN,compound-pobj,compound-pobj,NNP-NNPS,NNP-NNP,8,1
7744,5890.0,52,ranked,3,1,49,48,0,2,2,46,Wateen Telecom,Pakistan,per-per,,PROPN-PROPN,PROPN,compound-pobj,compound,NNP-NNP,NNP,9,1
7745,5891.0,11,issued,2,7,10,3,6,0,-5,8,Vargas,Brazil,org,,PROPN,PROPN,compound,pobj,NNP,NNP,3,1
7746,5892.0,28,owned,15,4,9,5,3,18,11,-6,Big Boi,Atlanta,per-per,,PROPN-PROPN,PROPN,compound-compound,compound,NNP-NNP,NNP,8,1
7747,5893.0,31,launched,9,5,12,7,4,18,4,3,TMN,February 1 1983,per,--,PROPN,PROPN-NUM-NUM,nsubjpass,pobj-nummod-nummod,NNP,NNP-CD-CD,7,1
7748,5894.0,48,helps,28,11,14,3,10,33,17,-14,Air Force,Michael B. Donley,org-org,--,PROPN-PROPN,PROPN-PROPN-PROPN,compound-compound,compound-compound-pobj,NNP-NNP,NNP-NNP-NNP,3,1
7749,12790.0,41,said,11,6,9,3,5,31,5,-2,Air Force,Michael B. Donley,-,org-org-org,PROPN-PROPN,PROPN-PROPN-PROPN,compound-compound,compound-compound-nsubj,NNP-NNP,NNP-NNP-NNP,4,1
7750,5895.0,30,said,16,18,20,2,17,9,-2,4,Whitehouse,Rhode Island,,per-per,PROPN,PROPN-PROPN,nsubj,compound-compound,NNP,NNP-NNP,2,1
7751,5896.0,25,provide,6,3,18,15,2,6,3,12,Marouf al-Bakhit,Jordan,per-per,,PROPN-PROPN,PROPN,compound-nsubj,poss,NNP-NNP,NNP,4,1
7752,5897.0,33,anchored,3,17,19,2,16,13,-14,16,Grimsby,New York,per,-,PROPN,PROPN-PROPN,dobj,compound-compound,NNP,NNP-NNP,2,1
7753,5902.0,13,is,1,1,9,8,0,3,0,8,Ezio,England,,org,PROPN,PROPN,nsubj,pobj,NNP,NNP,2,1
7754,5903.0,27,clashed,1,11,15,4,10,11,-10,14,o Macedoni,d Lazar,per-per,-,X-PROPN,NOUN-PROPN,appos-ROOT,nummod-compound,XX-NNP,NN-NNP,4,1
7755,5904.0,36,ROCK,0,28,30,2,27,5,-28,30,Gossip,Beth Ditto,per,-,PROPN,PROPN-PROPN,compound,compound-dobj,NNP,NNP-NNP,3,1
7756,5906.0,15,educated,6,3,3,0,2,11,3,-3,Wolverhampton,Wolverhampton Grammar School,,per-per-per,PROPN,PROPN-PROPN-PROPN,compound,compound-compound-pobj,NNP,NNP-NNP-NNP,0,1
7757,5907.0,68,ran,5,34,38,4,33,29,-29,33,W. T. Cosgrave,Executive Council,org-org-org,-,PROPN-PROPN-PROPN,PROPN-PROPN,compound-compound-poss,compound-nsubj,NNP-NNP-NNP,NNP-NNP,2,1
7758,10982.0,36,gave,2,15,29,14,14,6,-13,27,W. T. Cosgrave,Executive Council,--,org-org,PROPN-PROPN-PROPN,PROPN-PROPN,compound-compound-dobj,compound-conj,NNP-NNP-NNP,NNP-NNP,2,1
7759,12334.0,26,Born,0,9,17,8,8,8,-9,17,W. T. Cosgrave,Executive Council,org-org-org,-,PROPN-PROPN-PROPN,PROPN-PROPN,compound-compound-pobj,compound-pobj,NNP-NNP-NNP,NNP-NNP,6,1
7760,5908.0,27,been,4,1,10,9,0,16,3,6,The Tampa Tribune,1895,per-per-per,,DET-PROPN-PROPN,NUM,det-compound-nsubj,pobj,DT-NNP-NNP,CD,3,1
7761,5909.0,31,is,15,6,30,24,5,0,9,15,University of San Agustin,Philippines,per-per-per-per,,PROPN-ADP-PROPN-PROPN,PROPN,nmod-prep-compound-pobj,pobj,NNP-IN-NNP-NNP,NNP,-1,1
7762,5910.0,20,designs,2,1,16,15,0,3,1,14,Cisco Systems,Linksys,-,org,PROPN-PROPN,PROPN,compound-nsubj,appos,NNP-NNP,NNP,6,1
7763,5911.0,45,renamed,5,11,16,5,10,28,-6,11,Panteion University,Political Sciences,-,per-per,PROPN-PROPN,PROPN-PROPN,compound-appos,conj-pobj,NNP-NNP,NNP-NNPS,3,1
7764,5912.0,15,is,8,1,11,10,0,3,7,3,Manfred Clynes,scientist,-,per,ADJ-PROPN,ADJ,compound-nsubj,compound,JJ-NNPS,JJ,2,1
7765,5913.0,11,released,7,7,9,2,6,1,0,2,Canada,Alannah Myles,,per-per,PROPN,PROPN-PROPN,pobj,compound-dobj,NNP,NNP-NNPS,1,1
7766,5916.0,57,belongs,1,21,37,16,20,19,-20,36,Switzerland,UBS AG,per,-,PROPN,PROPN-PROPN,dobj,compound-dobj,NNP,NNP-NNP,6,1
7767,5917.0,40,announced,4,1,7,6,0,32,3,3,Connecticut,he,org,,PROPN,PRON,compound,nsubj,NNP,PRP,4,1
7768,5918.0,27,released,10,14,20,6,13,6,-4,10,Berlin-based,Bass Sultan Hengzt,org,--,VERB,PROPN-PROPN-PROPN,amod,compound-compound-pobj,VBN,NNP-NNP-NNP,6,1
7769,5919.0,21,is,7,1,18,17,0,2,6,11,Queen Elizabeth Sixth Form College,County Durham,----,org-org,PROPN-PROPN-PROPN-PROPN-PROPN,PROPN-PROPN,compound-compound-compound-compound-nsubj,compound-compound,NNP-NNP-NNP-NNP-NNP,NNP-NNP,7,1
7770,5920.0,28,Recorded,0,23,26,3,22,1,-23,26,Bright Eyes,Mike Mogis,org-org,-,PROPN-PROPN,PROPN-PROPN,compound-poss,compound-pobj,NNP-NNPS,NNP-NNP,1,1
7771,13758.0,30,signed,3,1,23,22,0,6,2,20,Bright Eyes,Mike Mogis,-,per-per,ADJ-PROPN,PROPN-PROPN,compound-nsubjpass,compound-conj,JJ-NNPS,NNP-NNP,9,1
7772,5921.0,52,estimated,4,21,35,14,20,16,-17,31,Warner Bros.,United States,org-org,-,PROPN-PROPN,PROPN-PROPN,compound-dobj,compound-pobj,NNP-NNPS,NNP-NNP,9,1
7773,5922.0,36,need,6,20,32,12,19,3,-14,26,Robert Redford,California,-,org,PROPN-PROPN,PROPN,compound-nsubj,pobj,NNP-NNP,NNP,5,1
7774,5923.0,20,represented,7,3,9,6,2,10,4,2,TCU Horned Frogs,Texas Christian University,--,per-per-per,PROPN-VERB-PROPN,PROPN-PROPN-PROPN,compound-compound-compound,compound-compound-dobj,NNP-VBD-NNP,NNP-NNP-NNP,5,1
7775,5924.0,35,responded,8,5,7,2,4,27,3,-1,SpaceX,Elon Musk,,per-per,PROPN,PROPN-PROPN,compound,compound-appos,NNP,NNP-NNP,1,1
7776,8567.0,28,founded,2,1,13,12,0,14,1,11,SpaceX,Elon Musk,,per-per,PROPN,PROPN-PROPN,nsubjpass,compound-appos,NNP,NNP-NNP,3,1
7777,5925.0,23,broadcast,6,3,9,6,2,13,3,3,United States,BBC America,-,per-per,PROPN-PROPN,PROPN-PROPN,compound-pobj,compound-pobj,NNP-NNP,NNP-NNP,4,1
7778,5926.0,35,entered,1,7,30,23,6,4,-6,29,Catherine of Valois,England,org-org-org,,PROPN-ADP-PROPN,PROPN,pobj-prep-pobj,pobj,NNP-IN-NNP,NNP,9,1
7779,12838.0,44,chosen,3,10,18,8,9,25,-7,15,Catherine of Valois,England,--,per,PROPN-ADP-PROPN,PROPN,pobj-prep-compound,pobj,NNP-IN-NNP,NNP,5,1
7780,5928.0,46,are,10,6,40,34,5,5,4,30,Santa Clara Law,California,org-org-org,,PROPN-PROPN-PROPN,PROPN,compound-compound-pobj,compound,NNP-NNP-NNP,NNP,-1,1
7781,5929.0,14,said,1,3,9,6,2,4,-2,8,Lohan,United States,org,-,PROPN,PROPN-PROPN,nsubj,compound-pobj,NNP,NNP-NNP,4,1
7782,5931.0,27,known,12,10,16,6,9,10,2,4,Romania,Romanian Armed Forces,per,--,PROPN,PROPN-PROPN-PROPN,pobj,compound-compound-pobj,NNP,NNP-NNP-NNPS,4,1
7783,5932.0,17,is,6,1,2,1,0,14,5,-4,Saipa,Alborz Football Club,per,--,PROPN,PROPN-PROPN-PROPN,compound,compound-compound-nsubj,NNP,NNP-NNP-NNP,2,1
7784,5933.0,26,went,4,17,25,8,16,0,-13,21,Halifax,Instruments,per,,PROPN,PROPN,compound,conj,NNP,NNPS,8,1
7785,5935.0,30,was,6,3,12,9,2,17,3,6,Alexander Mitchell,Wisconsin,-,per,PROPN-PROPN,PROPN,compound-nsubj,pobj,NNP-NNP,NNP,4,1
7786,5936.0,21,died,2,15,19,4,14,1,-13,17,Ulster Hospital,Northern Ireland,-,per-per,PROPN-PROPN,PROPN-PROPN,compound-pobj,compound-pobj,NNP-NNP,NNP-NNP,4,1
7787,5937.0,22,headed,2,1,5,4,0,16,1,3,He,NCNC,,org,PRON,PROPN,nsubj,compound,PRP,NNP,4,1
7788,5938.0,39,parted,1,1,19,18,0,19,0,18,Hayes,Powdered Sugar,per,-,PROPN,PROPN-PROPN,nsubj,compound-appos,NNP,NNP-NNP,3,1
7789,5939.0,21,assisted,2,15,18,3,14,2,-13,16,Commerce,Ron Brown,,per-per,PROPN,PROPN-PROPN,compound,compound-dobj,NNP,NNP-NNP,2,1
7790,11928.0,25,plane,3,7,9,2,6,15,-4,6,Commerce,Ron Brown,,per-per,PROPN,PROPN-PROPN,compound,compound-dobj,NNP,NNP-NNP,1,1
7791,5940.0,12,became,3,3,9,6,2,2,0,6,Kerr,New York,,per-per,PROPN,PROPN-PROPN,nsubj,compound-compound,NNP,NNP-NNP,4,1
7792,5941.0,25,was,1,13,23,10,12,1,-12,22,China,Campbell,org,,PROPN,PROPN,conj,nsubj,NNP,NNP,1,1
7793,5942.0,30,contains,4,4,22,18,3,7,0,18,Capodichino,United States Sixth Fleet,,org-org-org-org,PROPN,PROPN-PROPN-PROPN-PROPN,pobj,compound-compound-compound-nsubj,NNP,NNP-NNP-NNP-NNP,6,1
7794,5943.0,45,renovated,6,31,31,0,30,13,-25,25,Gettysburg College,Gettysburg,per-per,,PROPN-PROPN,PROPN,compound-compound,compound,NNP-NNP,NNP,0,1
7795,5945.0,29,studied,8,5,11,6,4,17,3,3,; Japa,t Sophia Universit,org-org,--,PUNCT-PROPN,NOUN-PROPN-PROPN,punct-nmod,compound-compound-dobj,:-NNP,NN-NNP-NNP,4,1
7796,5947.0,27,is,4,11,16,5,10,10,-7,12,Erasure,Mute Records,org,-,PROPN,PROPN-PROPN,pobj,compound-pobj,NNP,NNP-NNPS,2,1
7797,12154.0,18,is,1,7,13,6,6,4,-6,12,Erasure,Mute Records,per,-,PROPN,PROPN-PROPN,pobj,compound-pobj,NNP,NNP-NNPS,4,1
7798,5948.0,42,killed,18,4,10,6,3,31,14,-8,Royal Army Medical Corps,British Army,per-per-per-per,-,PROPN-PROPN-PROPN-PROPN,ADJ-PROPN,compound-compound-compound-pobj,compound-pobj,NNP-NNP-NNP-NNP,JJ-NNP,3,1
7799,5949.0,27,become,6,4,12,8,3,14,2,6,Henri Christophe,Haiti,-,per,PROPN-PROPN,PROPN,compound-nsubj,pobj,NNP-NNP,NNP,3,1
7800,5950.0,17,collaborated,4,7,10,3,6,6,-3,6,Hanyang University,South Korea,per-per,-,PROPN-PROPN,PROPN-PROPN,compound-pobj,compound-appos,NNP-NNP,NNP-NNP,1,1
7801,5951.0,14,purchased,5,4,10,6,3,3,1,5,LibLime,US,org,,PROPN,PROPN,nsubjpass,compound,NNP,NNP,6,1
7802,5952.0,18,publishes,2,1,5,4,0,12,1,3,Ark Records,Jeff Johnson,-,org-org,PROPN-PROPN,PROPN-PROPN,compound-nsubj,compound-poss,NNP-NNPS,NNP-NNP,3,1
7803,5953.0,23,approached,5,4,8,4,3,14,1,3,Jacobson,Chicago,,per,PROPN,PROPN,nsubjpass,compound,NNP,NNP,3,1
7804,5954.0,27,recommended,5,4,5,1,3,21,1,0,State,Paulus,,per,PROPN,PROPN,pobj,nsubj,NNP,NNP,1,1
7805,5955.0,17,Curated,0,3,7,4,2,9,-3,7,Mark Williams,New Zealand,org-org,-,PROPN-PROPN,PROPN-PROPN,compound-pobj,compound-compound,NNP-NNP,NNP-NNP,5,1
7806,5956.0,21,has,3,8,8,0,7,12,-5,5,United Food and Commercial Workers,United States,----,per-per,PROPN-PROPN-CCONJ-PROPN-PROPN,PROPN-PROPN,compound-nmod-cc-conj-pobj,compound-pobj,NNP-NNP-CC-NNP-NNPS,NNP-NNP,0,1
7807,5957.0,37,started,12,10,17,7,9,19,2,5,the Godwinns,United States Wrestling Association,org-org,---,DET-PROPN,PROPN-PROPN-PROPN-PROPN,det-pobj,compound-compound-compound-pobj,DT-NNP,NNP-NNP-NNP-NNP,5,1
7808,5958.0,43,attended,1,33,41,8,32,1,-32,40,Los Angeles,Jerry Goldsmith,per-per,-,PROPN-PROPN,PROPN-PROPN,compound-pobj,compound-pobj,NNP-NNP,NNP-NNP,5,1
7809,5960.0,95,News,26,1,1,0,0,93,25,-25,TV,TV 2 Sport,org,--,NOUN,NOUN-NUM-PROPN,nmod,nmod-nummod-dep,NN,NN-CD-NNP,0,1
7810,5961.0,51,scaled,2,14,22,8,13,28,-12,20,New Mexico,Darren White,-,org-org,PROPN-PROPN,PROPN-PROPN,compound-poss,compound-nsubj,NNP-NNP,NNP-NNP,-1,1
7811,5962.0,19,began,1,1,18,17,0,0,0,17,Freightliner,2007,per,,PROPN,NUM,nsubj,nummod,NNP,CD,1,1
7812,5963.0,37,established,10,1,3,2,0,33,9,-7,Ekiti,University of Ado Ekiti,per,---,PROPN,PROPN-ADP-PROPN-PROPN,compound,nsubjpass-prep-compound-pobj,NNP,NNP-IN-NNP-NNP,2,1
7813,12829.0,80,changed,3,24,8,-16,23,71,-21,5,Ekiti,University of Ado Ekiti,,per-per-per-per,PROPN,PROPN-ADP-PROPN-PROPN,compound,appos-prep-pobj-appos,NNP,NNP-IN-NNP-NNP,4,1
7814,5964.0,46,Upon,0,3,13,10,2,32,-3,13,Austrian,Wilhelm Miklas,org,-,PROPN,PROPN-PROPN,compound,compound-pobj,NNP,NNP-NNP,3,1
7815,5965.0,42,is,3,1,13,12,0,28,2,10,Telopea Park School,ACT,per-per-per,,PROPN-PROPN-PROPN,PROPN,compound-compound-nsubj,pobj,NNP-NNP-NNP,NNP,5,1
7816,5966.0,25,altered,7,10,13,3,9,11,-3,6,William Ackerman,Windham Hill,org-org,-,PROPN-PROPN,PROPN-PROPN,compound-nsubj,compound-compound,NNP-NNP,NNP-NNP,4,1
7817,5967.0,36,began,5,16,27,11,15,8,-11,22,Santa Monica,Dennis,-,org,PROPN-PROPN,PROPN,compound-pobj,poss,NNP-NNP,NNP,4,1
7818,5969.0,60,http://nymag.com/news/business/52603/,0,9,26,17,8,33,-9,26,Lehman Brothers,United States,-,per-per,PROPN-PROPN,PROPN-PROPN,compound-compound,compound-compound,NNP-NNPS,NNP-NNP,11,1
7819,5972.0,87,was,5,11,11,0,10,75,-6,6,Budapest Stock Exchange,Budapest,org-org-org,,PROPN-PROPN-PROPN,PROPN,compound-compound-pobj,compound,NNP-NNP-NNP,NNP,0,1
7820,5973.0,27,sold,16,10,15,5,9,11,6,-1,Yukos,Moscow,per,,PROPN,PROPN,pobj,pobj,NNPS,NNP,3,1
7821,5974.0,42,handle,3,25,32,7,24,9,-22,29,Firewind,Gus G,per,-,PROPN,PROPN-PROPN,pobj,compound-pobj,NNP,NNP-NNP,4,1
7822,5975.0,17,went,8,8,15,7,7,1,0,7,Johnson,Stonewall,,per,PROPN,PROPN,nsubj,compound,NNP,NNP,5,1
7823,5976.0,21,founded,2,11,13,2,10,7,-9,11,Senate of Serampore College,Serampore,per-per-per-per,,PROPN-ADP-PROPN-PROPN,PROPN,pobj-prep-compound-nmod,compound,NNP-IN-NNP-NNP,NNP,1,1
7824,5977.0,24,is,4,8,23,15,7,0,-4,19,she,Baltimore,,per,PRON,PROPN,nsubj,pobj,PRP,NNP,2,1
7825,5978.0,28,is,4,11,17,6,10,10,-7,13,England,Wainwright,,org,PROPN,PROPN,pobj,pobj,NNP,NNP,1,1
7826,5982.0,60,play,13,19,25,6,18,34,-6,12,Teru,Japan,,per,PROPN,PROPN,compound,pobj,NNP,NNP,2,1
7827,7199.0,24,participated,4,2,10,8,1,13,2,6,Teru,Japan,,per,PROPN,PROPN,nsubj,compound,NNP,NNP,4,1
7828,11956.0,7,Saiki,1,1,5,4,0,1,0,4,Teru,Japan,per,,PROPN,PROPN,compound,conj,NNP,NNP,1,1
7829,5983.0,48,Vice-Chairman,2,1,6,5,0,41,1,4,Maung Aye,State Peace and Development Council,-,org-org-org-org-org,PROPN-PROPN,PROPN-PROPN-CCONJ-PROPN-PROPN,compound-compound,nmod-nmod-cc-conj-pobj,NNP-NNP,NNP-NNP-CC-NNP-NNP,4,1
7830,5984.0,20,released,18,6,15,9,5,4,12,-3,G-Unit,Young Buck,,org-org,PROPN,PROPN-PROPN,punct,compound-conj,NNP,NNP-NNP,4,1
7831,6989.0,28,features,1,7,15,8,6,12,-6,14,G-Unit,Young Buck,per,-,PROPN,PROPN-PROPN,punct,compound-dobj,NNP,NNP-NNP,7,1
7832,9488.0,23,Former,0,2,4,2,1,18,-2,4,G-Unit,Young Buck,per,-,PROPN,PROPN-PROPN,punct,compound-nsubj,NNP,NNP-NNP,1,1
7833,11008.0,34,after,1,16,18,2,15,15,-15,17,G-Unit,Young Buck,org,-,PROPN,PROPN-PROPN,punct,compound-nsubj,NNP,NNP-NNP,2,1
7834,13085.0,20,After,0,8,13,5,7,6,-8,13,G-Unit,Young Buck,,org-org,PROPN,PROPN-PROPN,punct,compound-dobj,NNP,NNP-NNP,7,1
7835,5985.0,73,nominated,3,19,28,9,18,44,-16,25,Actor,Abhishek Bachchan,per,-,PROPN,PROPN-PROPN,conj,compound-ROOT,NNP,NNP-NNP,-1,1
7836,5987.0,39,graduated,1,19,22,3,18,16,-18,21,Federal University of Rio de Janeiro,Rio de Janeiro,org-org-org-org-org-org,--,PROPN-PROPN-ADP-PROPN-PROPN-PROPN,PROPN-PROPN-PROPN,compound-pobj-prep-compound-compound-pobj,compound-compound-compound,NNP-NNP-IN-NNP-NNP-NNP,NNP-NNP-NNP,3,1
7837,5988.0,22,include,12,8,20,12,7,1,4,8,London,Shakespears Sister,,per-per,PROPN,PROPN-PROPN,compound,compound-conj,NNP,NNPS-NNP,3,1
7838,9403.0,39,opted,14,12,24,12,11,14,2,10,London,Shakespears Sister,,per-per,PROPN,PROPN-PROPN,compound,compound-nsubjpass,NNP,NNPS-NNP,11,1
7839,5989.0,29,put,5,14,16,2,13,12,-9,11,Reliance Communications,India,per-per,,PROPN-PROPN,PROPN,compound-compound,poss,NNP-NNPS,NNP,5,1
7840,5990.0,32,represented,2,1,5,4,0,26,1,3,Italy,Domenico Modugno,,per-per,PROPN,PROPN-PROPN,nsubjpass,compound-pobj,NNP,NNP-NNP,3,1
7841,5991.0,21,saw,3,8,8,0,7,12,-5,5,Virgin Unite,Virgin Group,per-per,-,PROPN-PROPN,PROPN-PROPN,compound-compound,compound-poss,NNP-NNP,NNP-NNP,0,1
7842,5992.0,26,book,8,4,21,17,3,4,4,13,Nocelli,Infinite Trend Productions,org,--,PROPN,PROPN-PROPN-PROPN,poss,compound-compound-compound,NNP,NNP-NNP-NNPS,5,1
7843,5993.0,33,born,6,1,4,3,0,28,5,-2,Jon Coghill,Jonathan Robert Coghill,-,org-org-org,PROPN-PROPN,PROPN-PROPN-PROPN,compound-nsubj,compound-compound-appos,NNP-NNP,NNP-NNP-NNP,3,1
7844,5995.0,19,chosen,2,1,6,5,0,12,1,4,Dana,Israel,per,,PROPN,PROPN,nsubjpass,dobj,NNP,NNP,3,1
7845,5996.0,30,directed,15,11,14,3,10,15,4,-1,Sacramento,ARC,org,,PROPN,PROPN,compound,conj,NNP,NNP,3,1
7846,5997.0,59,has,3,1,3,2,0,55,2,0,Swansea Metropolitan University,University of Wales,--,per-per-per,PROPN-PROPN-PROPN,PROPN-ADP-PROPN,compound-compound-nsubj,nmod-prep-pobj,NNP-NNP-NNP,NNP-IN-NNP,2,1
7847,5998.0,17,began,3,13,15,2,12,1,-10,12,Ontario,George Weston,org,-,PROPN,PROPN-PROPN,pobj,compound-pobj,NNP,NNP-NNP,1,1
7848,6000.0,17,given,3,1,7,6,0,9,2,4,Tori Amos,American,-,per,PROPN-PROPN,PROPN,compound-nsubj,compound,NNP-NNP,NNP,4,1
7849,6001.0,19,succeeded,4,6,12,6,5,6,-2,8,Viggo Kampmann,leader,-,org,PROPN-PROPN,NOUN,compound-dobj,conj,NNP-NNP,NN,5,1
7850,6002.0,20,Bradley,0,1,16,15,0,3,-1,16,Bradley,Los Angeles,per,-,NOUN,PROPN-PROPN,ROOT,compound-compound,NN,NNP-NNP,-1,1
7851,6003.0,17,chosen,2,1,12,11,0,4,1,10,He,Ireland,,per,PRON,PROPN,nsubjpass,poss,PRP,NNP,6,1
7852,6004.0,52,was,1,7,49,42,6,2,-6,48,Leopold III of Belgium,Astrid of Sweden,per-per-per-per,--,PROPN-PROPN-ADP-PROPN,PROPN-ADP-PROPN,compound-pobj-prep-pobj,conj-prep-pobj,NNP-NNP-IN-NNP,NNP-IN-NNP,11,1
7853,6005.0,52,broadcast,16,13,37,24,12,14,3,21,CCTV,CCTV-9,org,,PROPN,PROPN,compound,compound,NNP,NNP,5,1
7854,6007.0,31,founded,2,1,17,16,0,13,1,15,Blackstone,Stephen A. Schwarzman,,per-per-per,PROPN,PROPN-PROPN-PROPN,nsubjpass,compound-compound-conj,NNP,NNP-NNP-NNP,7,1
7855,12719.0,25,been,22,9,11,2,8,13,13,-11,Blackstone,Stephen A. Schwarzman,per,--,PROPN,PROPN-PROPN-PROPN,poss,compound-compound-conj,NNP,NNP-NNP-NNP,3,1
7856,6008.0,27,were,2,14,19,5,13,7,-12,17,Dictator,Lucius Cornelius Sulla,org,--,PROPN,PROPN-PROPN-PROPN,pobj,compound-compound-pobj,NNP,NNP-NNP-NNP,9,1
7857,6011.0,14,was,5,5,7,2,4,6,0,2,Representative,Javier Solana,per,-,PROPN,PROPN-PROPN,nsubj,compound-attr,NNP,NNP-NNP,1,1
7858,6012.0,45,given,8,1,22,21,0,22,7,14,Fianna,Brian Cowen,org,-,PROPN,PROPN-PROPN,compound,compound-nsubj,NNP,NNP-NNP,4,1
7859,6013.0,26,angered,5,9,14,5,8,11,-4,9,Anton Haus,Austro-Hungarian Navy,per-per,-,PROPN-PROPN,ADJ-PROPN,compound-compound,amod-pobj,NNP-NNP,JJ-NNP,5,1
7860,6014.0,34,sold,20,15,15,0,14,18,5,-5,Mitsubishi Motors,Mitsubishi Motors Australia,-,per-per-per,PROPN-PROPN,PROPN-PROPN-PROPN,compound-pobj,compound-compound-compound,NNP-NNPS,NNP-NNPS-NNP,0,1
7861,6015.0,56,came,29,20,25,5,19,30,9,-4,Phil Spector,Philles Records,per-per,-,PROPN-PROPN,PROPN-PROPN,compound-poss,compound-pobj,NNP-NNP,NNP-NNPS,3,1
7862,6016.0,18,is,5,2,11,9,1,6,3,6,Air Force,Brazilian Air Force,-,per-per-per,PROPN-PROPN,PROPN-PROPN-PROPN,compound-compound,compound-compound-pobj,NNP-NNP,NNP-NNP-NNP,6,1
7863,6018.0,24,survived,7,5,23,18,4,0,2,16,Pete Candoli,Mishawaka,per-per,,PROPN-PROPN,PROPN,compound-pobj,pobj,NNP-NNP,NNP,5,1
7864,6019.0,45,told,4,36,43,7,35,1,-32,39,Rob Portman,Cincinnati,per-per,,PROPN-PROPN,PROPN,compound-pobj,compound,NNP-NNP,NNP,3,1
7865,6020.0,47,described,1,1,21,20,0,25,0,20,Michael,Sony,,per,PROPN,PROPN,nsubj,pobj,NNP,NNP,4,1
7866,6021.0,31,is,2,1,11,10,0,19,1,9,KBS World,Japan,-,per,PROPN-PROPN,PROPN,compound-nsubj,pobj,NNP-NNP,NNP,4,1
7867,6022.0,33,span,8,19,30,11,18,2,-11,22,West Virginia,Glenville State College,-,per-per-per,PROPN-PROPN,PROPN-PROPN-PROPN,compound-pobj,compound-compound-conj,NNP-NNP,NNP-NNP-NNP,12,1
7868,6023.0,51,revealed,8,18,20,2,17,30,-10,12,New Zealand,Government Communications Security Bureau,org-org,---,PROPN-PROPN,PROPN-PROPN-PROPN-PROPN,compound-compound,compound-compound-compound-appos,NNP-NNP,NNP-NNPS-NNP-NNP,4,1
7869,6024.0,63,is,1,1,1,0,0,61,0,0,Birmingham,Birmingham City University,,per-per-per,PROPN,PROPN-PROPN-PROPN,nsubj,compound-compound-ROOT,NNP,NNP-NNP-NNP,0,1
7870,6025.0,31,buy,4,14,22,8,13,8,-10,18,Maverick,Guy Oseary,org,-,PROPN,PROPN-PROPN,poss,compound-nsubj,NNP,NNP-NNP,8,1
7871,6027.0,41,known,3,1,28,27,0,12,2,25,He,Elefant Traks,,org-org,PRON,PROPN-PROPN,nsubjpass,compound-compound,PRP,NNP-NNP,4,1
7872,6028.0,36,is,2,12,19,7,11,16,-10,17,Judas Priest,Rob Halford,per-per,-,PROPN-PROPN,PROPN-PROPN,compound-pobj,compound-compound,NNP-NNP,NNP-NNP,7,1
7873,10353.0,49,made,1,18,29,11,17,19,-17,28,Judas Priest,Rob Halford,org-org,-,PROPN-PROPN,PROPN-PROPN,compound-appos,compound-pobj,NNP-NNP,NNP-NNP,13,1
7874,6029.0,35,said,7,5,33,28,4,1,2,26,Korean,Park Chung-hee,per,-,ADJ,PROPN-PROPN,compound,pobj-nummod,JJ,NNP-NNP,8,1
7875,6030.0,28,moved,1,4,17,13,3,10,-3,16,London,Mike Lindup,,org-org,PROPN,PROPN-PROPN,pobj,compound-pobj,NNP,NNP-NNP,3,1
7876,6031.0,43,jpg,0,4,26,22,3,16,-4,26,Apolinario Mabini,Philippines,per-per,,PROPN-PROPN,PROPN,compound-npadvmod,pobj,NNP-NNP,NNP,7,1
7877,12915.0,52,|,1,4,23,19,3,28,-3,22,Apolinario Mabini,Philippines,org-org,,PROPN-PROPN,PROPN,compound-pobj,compound,NNP-NNP,NNP,-1,1
7878,14060.0,35,modified,7,15,27,12,14,7,-8,20,Apolinario Mabini,Philippines,-,org,PROPN-PROPN,PROPN,compound-pobj,dobj,NNP-NNP,NNPS,3,1
7879,6033.0,33,commented,2,5,11,6,4,21,-3,9,US Airways,Star Alliance,org-org,-,PROPN-PROPN,PROPN-PROPN,compound-poss,compound-pobj,NNP-NNP,NNP-NNP,3,1
7880,6035.0,35,collaborated,5,10,11,1,9,23,-5,6,composer,Armando Manzanero,per,-,NOUN,PROPN-PROPN,pobj,compound-appos,NN,NNP-NNP,1,1
7881,6036.0,13,moved,2,1,5,4,0,7,1,3,Her,Los Angeles,per,-,DET,PROPN-PROPN,poss,compound-pobj,PRP$,NNP-NNP,3,1
7882,6037.0,12,was,2,1,8,7,0,3,1,6,Peter McMartin,Jersey City,per-per,-,PROPN-PROPN,PROPN-PROPN,compound-nsubj,compound-compound,NNP-NNP,NNP-NNP,5,1
7883,6038.0,23,acquired,3,3,21,18,2,1,0,18,HSBC,Mumbai,per,,PROPN,PROPN,nsubj,appos,NNP,NNP,5,1
7884,6039.0,32,was,8,19,30,11,18,1,-11,22,Mali,Alpha Oumar,per,-,PROPN,PROPN-PROPN,pobj,compound-pobj,NNP,NNP-NNP,3,1
7885,6040.0,17,work,2,5,16,11,4,0,-3,14,Iran Khodro,Tehran,per-per,,PROPN-PROPN,PROPN,compound-poss,pobj,NNP-NNP,NNP,5,1
7886,6041.0,29,is,6,1,24,23,0,4,5,18,Esperanza High School,Placentia-Yorba Linda Unified School District,org-org-org,----,PROPN-PROPN-PROPN,PROPN-PROPN-PROPN-PROPN-PROPN,compound-compound-nsubj,amod-compound-compound-compound-pobj,NNP-NNP-NNP,NNP-NNP-NNP-NNP-NNP,7,1
7887,6043.0,28,known,6,4,12,8,3,15,2,6,Robert Wagner,Jill St. John,org-org,--,PROPN-PROPN,PROPN-PROPN-PROPN,compound-nsubjpass,compound-compound-appos,NNP-NNP,NNP-NNP-NNP,4,1
7888,6044.0,50,was,45,15,33,18,14,16,30,-12,Democratic Party,Walter Veltroni,-,per-per,PROPN-PROPN,PROPN-PROPN,compound-pobj,compound-appos,NNP-NNP,NNP-NNP,10,1
7889,6045.0,21,serves,3,1,15,14,0,5,2,12,Somon Air,Tajikistan,org-org,,PROPN-PROPN,PROPN,compound-nsubj,pobj,NNP-NNP,NNP,4,1
7890,6046.0,16,formed,8,2,3,1,1,12,6,-5,1997,College of the North Atlantic,,per-per-per-per-per,NUM,PROPN-ADP-DET-PROPN-PROPN,pobj,nsubjpass-prep-det-compound-pobj,CD,NNP-IN-DT-NNP-NNP,1,1
7891,6047.0,43,*,0,33,34,1,32,8,-33,34,Rutgers,The State University of New Jersey,,per-per-per-per-per-per,PROPN,DET-PROPN-PROPN-ADP-PROPN-PROPN,ROOT,det-compound-nmod-prep-compound-pobj,NNP,DT-NNP-NNP-IN-NNP-NNP,2,1
7892,6048.0,15,Like,0,6,8,2,5,6,-6,8,Europe,he,org,,PROPN,PRON,compound,nsubj,NNP,PRP,1,1
7893,6050.0,35,encompasses,4,3,3,0,2,31,1,-1,Evergreen Group,Evergreen Marine,org-org,-,PROPN-PROPN,PROPN-PROPN,compound-nsubj,compound-compound,NNP-NNP,NNP-NNP,0,1
7894,6051.0,35,received,2,2,8,6,1,26,0,6,school,1998,per,,NOUN,NUM,nsubj,nummod,NN,CD,1,1
7895,6054.0,30,Muzyka,6,16,18,2,15,11,-10,12,BioWare,Electronic Arts,per,-,PROPN,PROPN-PROPN,nmod,compound-compound,NNP,NNP-NNPS,2,1
7896,7547.0,44,became,9,3,5,2,2,38,6,-4,BioWare,Electronic Arts,,per-per,PROPN,PROPN-PROPN,dobj,compound-pobj,NNP,NNP-NNPS,1,1
7897,6056.0,26,represented,9,4,12,8,3,13,5,3,New Hampshire Wildcats,University of New Hampshire,per-per-per,---,PROPN-PROPN-PROPN,PROPN-ADP-PROPN-PROPN,compound-compound-compound,dobj-prep-compound-pobj,NNP-NNP-NNPS,NNP-IN-NNP-NNP,4,1
7898,6057.0,33,selling,8,1,18,17,0,14,7,10,Tate Lyle,Spain,org-org,,PROPN-PROPN,PROPN,compound-nsubj,pobj,NNP-NNP,NNP,5,1
7899,6058.0,34,stressed,24,20,24,4,19,9,4,0,People,China,,org,PROPN,PROPN,poss,nsubj,NNPS,NNP,3,1
7900,6059.0,42,directed,10,13,40,27,12,1,-3,30,D. W. Griffith,Linda Arvidson,--,org-org,PROPN-PROPN-PROPN,PROPN-PROPN,compound-compound-pobj,compound-conj,NNP-NNP-NNP,NNP-NNP,12,1
7901,6060.0,30,resigned,12,6,20,14,5,9,6,8,Zafarullah Khan Jamali,Pakistan Muslim League,--,org-org-org,PROPN-PROPN-PROPN,PROPN-PROPN-PROPN,compound-compound-appos,compound-compound-compound,NNP-NNP-NNP,NNP-NNP-NNP,9,1
7902,6061.0,39,Cope,3,30,37,7,29,1,-27,34,Dominican School of Philosophy and Theology,Berkeley,org-org-org-org-org-org,,PROPN-PROPN-ADP-PROPN-CCONJ-PROPN,PROPN,compound-dobj-prep-pobj-cc-conj,compound,NNP-NNP-IN-NNP-CC-NNP,NNP,2,1
7903,6062.0,33,graduated,22,4,19,15,3,13,18,-3,Edward Waters College,Florida,per-per-per,,PROPN-PROPN-PROPN,PROPN,compound-compound-pobj,pobj,NNP-NNP-NNP,NNP,8,1
7904,6064.0,21,is,6,14,20,6,13,0,-8,14,New York,NY1,-,per,PROPN-PROPN,PROPN,compound-poss,pobj,NNP-NNP,NNP,1,1
7905,8712.0,37,says,34,1,36,35,0,0,33,2,New York,NY1,per-per,,PROPN-PROPN,PROPN,compound-compound,nsubj,NNP-NNP,NNP,5,1
7906,6066.0,15,Smith,0,9,13,4,8,1,-9,13,Central State University,Wilberforce,--,per,PROPN-PROPN-PROPN,PROPN,compound-compound-pobj,compound,NNP-NNP-NNP,NNP,5,1
7907,6067.0,65,characters,1,7,10,3,6,54,-6,9,Franklin D. Roosevelt,Eleanor Roosevelt,org-org-org,-,PROPN-PROPN-PROPN,PROPN-PROPN,compound-compound-compound,compound-compound,NNP-NNP-NNP,NNP-NNP,2,1
7908,13109.0,46,include,6,10,13,3,9,32,-4,7,Franklin D. Roosevelt,Eleanor Roosevelt,per-per-per,-,PROPN-PROPN-PROPN,PROPN-PROPN,compound-compound-compound,compound-dobj,NNP-NNP-NNP,NNP-NNP,2,1
7909,6069.0,75,File,0,5,22,17,4,52,-5,22,Samsung Engineering,Seoul,-,org,PROPN-PROPN,PROPN,compound-pobj,compound,NNP-NNP,NNP,-1,1
7910,6070.0,16,structured,3,8,9,1,7,6,-5,6,DSV,Road,,per,PROPN,PROPN,compound,compound,NNP,NNP,2,1
7911,6072.0,18,is,9,1,14,13,0,3,8,5,Nguy?n T?n,er of Vi,per-per,--,PROPN-PROPN,PROPN-ADP-PROPN,compound-compound,intj-prep-pobj,NNP-NNP,NNP-IN-NNP,4,1
7912,6073.0,64,withdrawn,12,48,56,8,47,7,-36,44,Cabinet,Prachanda,per,,PROPN,PROPN,pobj,pobj,NNP,NNP,5,1
7913,6074.0,27,in,0,4,4,0,3,22,-4,4,Patna College,Patna University,org-org,-,PROPN-PROPN,PROPN-PROPN,compound-pobj,compound-pobj,NNP-NNP,NNP-NNP,0,1
7914,6076.0,39,said,17,26,38,12,25,0,-9,21,Pakistan,Sharif,org,,PROPN,PROPN,pobj,pobj,NNP,NNP,12,1
7915,6077.0,58,is,13,34,37,3,33,20,-21,24,Buffalo Springfield,Stephen Stills,-,org-org,PROPN-PROPN,PROPN-PROPN,compound-appos,compound-compound,NNP-NNP,NNP-NNP,6,1
7916,6078.0,23,is,9,17,2,-15,16,20,-8,-7,Air Force,312th Aeronautical Systems Wing,-,per-per-per-per,PROPN-PROPN,PROPN-PROPN-PROPN-PROPN,compound-compound,compound-compound-compound-pobj,NNP-NNP,NNP-NNP-NNPS-NNP,7,1
7917,6079.0,33,held,4,7,12,5,6,20,-3,8,Chang Jung Christian University,Tainan County,per-per-per-per,-,PROPN-PROPN-PROPN-PROPN,PROPN-PROPN,compound-compound-compound-pobj,compound-poss,NNP-NNP-NNP-NNP,NNP-NNP,4,1
7918,6081.0,34,invited,8,15,33,18,14,0,-7,25,SUAS,squadron,org,,PROPN,NOUN,pobj,pobj,NNP,NN,3,1
7919,6083.0,18,is,3,1,13,12,0,4,2,10,South Crest School,Muntinlupa City,org-org-org,-,PROPN-PROPN-PROPN,PROPN-PROPN,compound-compound-nsubj,compound-pobj,NNP-NNP-NNP,NNP-NNP,5,1
7920,6084.0,26,returned,8,8,12,4,7,13,0,4,Cocker,Sheffield,,per,PROPN,PROPN,pobj,pobj,NNP,NNP,4,1
7921,6085.0,29,met,13,2,3,1,1,25,11,-10,President,Mohamed Ould Abdel Aziz,per,---,PROPN,PROPN-PROPN-PROPN-PROPN,compound,compound-compound-compound-nsubj,NNP,NNP-NNP-NNP-NNP,2,1
7922,6087.0,22,received,2,2,8,6,1,13,0,6,band,Netherlands,org,,NOUN,PROPN,nsubj,pobj,NN,NNP,1,1
7923,6088.0,16,is,1,1,6,5,0,9,0,5,Vrangsinn,Misantrof ANTIRecords,,per-per,PROPN,PROPN-PROPN,nsubj,compound-pobj,NNP,NNP-NNP,3,1
7924,6090.0,30,wrote,25,21,24,3,20,5,4,-1,Six Flags,New York,-,org-org,NUM-PROPN,PROPN-PROPN,compound-pobj,compound-pobj,CD-NNPS,NNP-NNP,4,1
7925,7152.0,21,filed,6,1,5,4,0,15,5,-1,Six Flags,New York,-,per-per,NUM-NOUN,PROPN-PROPN,nummod-nsubj,compound-pobj,CD-NNS,NNP-NNP,3,1
7926,6091.0,25,said,11,1,7,6,0,17,10,-4,Jeff Halper,Israeli Committee Against House Demolitions,per-per,----,PROPN-PROPN,ADJ-PROPN-PROPN-PROPN-PROPN,compound-nsubj,amod-pobj-prep-compound-pobj,NNP-NNP,JJ-NNP-NNP-NNP-NNPS,3,1
7927,6092.0,24,grew,1,5,21,16,4,2,-4,20,Launceston,Scotch Oakburn College,,org-org-org,PROPN,PROPN-PROPN-PROPN,pobj,compound-compound-pobj,NNP,NNP-NNP-NNP,7,1
7928,6094.0,16,is,4,3,7,4,2,8,1,3,Amber Stevens,actress,org-org,,PROPN-PROPN,NOUN,compound-appos,attr,NNP-NNP,NN,4,1
7929,6095.0,14,operates,1,1,8,7,0,5,0,7,Metrorail,Cape Town,per,-,PROPN,PROPN-PROPN,nsubj,compound-pobj,NNP,NNP-NNP,3,1
7930,6096.0,27,said,24,22,23,1,21,3,2,-1,Chairman,Christopher Cox,per,-,PROPN,PROPN-PROPN,compound,compound-pobj,NNP,NNP-NNP,1,1
7931,6097.0,40,made,3,9,25,16,8,14,-6,22,Legal Council of the League of Nations,he,org-org-org-org-org-org-org,,PROPN-PROPN-ADP-DET-PROPN-ADP-PROPN,PRON,compound-pobj-prep-det-nmod-prep-pobj,nsubj,NNP-NNP-IN-DT-NNP-IN-NNPS,PRP,3,1
7932,6098.0,37,founded,2,1,7,6,0,29,1,5,FSG,New England Sports Ventures,org,---,PROPN,PROPN-PROPN-PROPN-PROPN,nsubjpass,compound-compound-compound-pobj,NNP,NNP-NNP-NNPS-NNPS,4,1
7933,6099.0,28,complain,3,8,12,4,7,15,-5,9,Mike Nichols,Diane Sawyer,per-per,-,PROPN-PROPN,PROPN-PROPN,compound-pobj,compound-appos,NNP-NNP,NNP-NNP,3,1
7934,6101.0,26,played,7,23,24,1,22,1,-16,17,President,Hu Jintao,org,-,PROPN,PROPN-PROPN,compound,compound-pobj,NNP,NNP-NNP,1,1
7935,9758.0,15,unveils,5,12,13,1,11,1,-7,8,President,Hu Jintao,,per-per,PROPN,PROPN-PROPN,compound,compound-pobj,NNP,NNP-NNP,1,1
7936,10198.0,18,arrived,4,2,3,1,1,14,2,-1,President,Hu Jintao,,per-per,PROPN,PROPN-PROPN,compound,compound-nsubj,NNP,NNP-NNP,1,1
7937,6103.0,28,said,4,12,14,2,11,13,-8,10,Health,Pascal Couchepin,per,-,PROPN,PROPN-PROPN,compound,compound-nsubj,NNP,NNP-NNP,1,1
7938,6104.0,32,said,6,4,26,22,3,5,2,20,Abbas El Fassi,Morocco,--,per,PROPN-PROPN-PROPN,PROPN,compound-compound-nsubj,poss,NNP-NNP-NNP,NNP,10,1
7939,9003.0,31,said,29,3,10,7,2,20,26,-19,Abbas El Fassi,Morocco,per-per-per,,PROPN-PROPN-PROPN,PROPN,compound-compound-nsubj,poss,NNP-NNP-NNP,NNP,8,1
7940,11702.0,29,spoke,6,3,9,6,2,19,3,3,Abbas El Fassi,Morocco,per-per-per,,PROPN-PROPN-PROPN,PROPN,compound-compound-conj,poss,NNP-NNP-NNP,NNP,7,1
7941,6105.0,16,released,8,2,14,12,1,1,6,6,Rogue Wave,Brushfire Records,org-org,-,PROPN-PROPN,PROPN-PROPN,compound-poss,compound-pobj,NNP-NNP,NNP-NNPS,3,1
7942,6107.0,33,leased,1,14,25,11,13,7,-13,24,Ted Turner,TBS,-,org,PROPN-PROPN,PROPN,compound-pobj,parataxis,NNP-NNP,NNP,8,1
7943,6108.0,22,attended,1,4,9,5,3,12,-3,8,University of Southern California,USC Trojans,per-per-per-per,-,PROPN-ADP-PROPN-PROPN,PROPN-PROPN,dobj-prep-compound-pobj,nmod-nmod,NNP-IN-NNP-NNP,NNP-NNPS,2,1
7944,6109.0,18,wrote,8,14,16,2,13,1,-6,8,Chinese,Jiang Zemin,,per-per,ADJ,PROPN-PROPN,amod,compound-pobj,JJ,NNP-NNP,1,1
7945,6110.0,41,received,1,12,16,4,11,24,-11,15,Royal Academy of Music,University of London,---,org-org-org,PROPN-PROPN-ADP-PROPN,PROPN-ADP-PROPN,compound-pobj-prep-compound,pobj-prep-pobj,NNP-NNP-IN-NNP,NNP-IN-NNP,3,1
7946,6111.0,17,acquired,2,1,4,3,0,12,1,2,Viacom,MTV Networks,,per-per,PROPN,PROPN-PROPN,nsubj,compound-dobj,NNP,NNP-NNPS,2,1
7947,6112.0,48,located,23,12,14,2,11,33,11,-9,University of Pittsburgh School of Medicine,Pittsburgh,-----,per,PROPN-ADP-PROPN-PROPN-ADP-PROPN,PROPN,nmod-prep-pobj-nmod-prep-pobj,pobj,NNP-IN-NNP-NNP-IN-NNP,NNP,2,1
7948,6115.0,30,purchased,15,9,18,9,8,11,6,3,Famous-Barr,Federated Department Stores,org,--,PROPN,PROPN-PROPN-PROPN,nmod,compound-compound-pobj,NNP,NNP-NNP-NNPS,4,1
7949,6116.0,28,have,11,10,25,15,9,2,1,14,West,Santa Fe trails,,per-per-per,PROPN,PROPN-PROPN-NOUN,pobj,compound-conj-pobj,NNP,NNP-NNP-NNS,8,1
7950,6117.0,22,returned,2,12,12,0,11,9,-10,10,Augusta,Augusta State University,,org-org-org,PROPN,PROPN-PROPN-PROPN,compound,compound-compound-appos,NNP,NNP-NNP-NNP,0,1
7951,6118.0,27,announced,6,8,15,7,7,11,-2,9,Lyric Street,Covington,-,per,PROPN-PROPN,PROPN,compound-compound,nsubjpass,NNP-NNP,NNP,5,1
7952,6119.0,17,is,4,1,15,14,0,1,3,11,Universal Music Group,Vivendi,org-org-org,,PROPN-PROPN-PROPN,PROPN,compound-compound-pobj,appos,NNP-NNP-NNP,NNP,7,1
7953,6121.0,12,is,1,1,11,10,0,0,0,10,Spangles,Kansas,,per,PROPN,PROPN,nsubj,pobj,NNP,NNP,5,1
7954,6122.0,24,moved,1,4,9,5,3,14,-3,8,New York City,Bear Stearns,--,per-per,PROPN-PROPN-PROPN,PROPN-PROPN,compound-compound-pobj,compound-pobj,NNP-NNP-NNP,NNP-NNP,6,1
7955,6123.0,25,returning,19,1,2,1,0,22,18,-17,Actor,Kellan Lutz,per,-,PROPN,PROPN-PROPN,compound,compound-nsubj,NNP,NNP-NNP,1,1
7956,6124.0,29,was,3,1,9,8,0,19,2,6,Papandreou,Greece,per,,PROPN,PROPN,poss,pobj,NNP,NNP,7,1
7957,6125.0,49,replaced,7,2,17,15,1,31,5,10,Canadian Hockey League,Canada,--,per,PROPN-PROPN-PROPN,PROPN,compound-compound-nsubj,pobj,NNP-NNP-NNP,NNP,5,1
7958,6126.0,38,selected,26,15,19,4,14,18,11,-7,Lincoln High School,Tallahassee,org-org-org,,PROPN-PROPN-PROPN,PROPN,compound-compound-pobj,pobj,NNP-NNP-NNP,NNP,2,1
7959,6127.0,33,performed,4,24,26,2,23,6,-20,22,Israel,Shiri Maimon,,org-org,PROPN,PROPN-PROPN,poss,compound-dobj,NNP,NNP-NNP,2,1
7960,6128.0,26,announced,24,2,4,2,1,21,22,-20,Prime Minister,Romano Prodi,-,org-org,PROPN-PROPN,PROPN-PROPN,compound-compound,compound-nsubj,NNP-NNP,NNP-NNP,1,1
7961,6129.0,57,lived,3,17,56,39,16,0,-14,53,Orellana,Chile,,per,PROPN,PROPN,nsubj,pobj,NNP,NNP,5,1
7962,6130.0,17,=,0,10,15,5,9,1,-10,15,Swami Records,John Reis,per-per,-,PROPN-PROPN,PROPN-PROPN,compound-appos,compound-pobj,NNP-NNPS,NNP-NNP,3,1
7963,6131.0,34,won,6,1,3,2,0,30,5,-3,India,Reliance Energy,org,-,PROPN,PROPN-PROPN,poss,compound-compound,NNP,NNP-NNP,3,1
7964,6134.0,27,is,5,15,17,2,14,9,-10,12,Idlewild,Roddy Woomble,org,-,ADJ,PROPN-PROPN,compound,compound-nsubj,JJ,NNP-NNP,1,1
7965,6137.0,44,Destruction,2,1,25,24,0,18,1,23,Merzbow,Masami Akita,,per-per,PROPN,PROPN-PROPN,compound,compound-appos,NNP,NNP-NNP,-1,1
7966,6138.0,41,was,9,3,11,8,2,29,6,2,Columbia,Stafford,per,,PROPN,PROPN,compound,poss,NNP,NNP,6,1
7967,6139.0,42,created,2,6,11,5,5,30,-4,9,Japan,Yoshiki,,per,PROPN,PROPN,poss,pobj,NNP,NNP,5,1
7968,6140.0,38,charting,24,18,21,3,17,16,6,-3,Arthur Mutambara,MDC-M,per-per,,PROPN-PROPN,PROPN,compound-conj,appos,NNP-NNP,NNP,2,1
7969,6141.0,19,Founded,0,3,13,10,2,5,-3,13,1912,University of Oregon,per,--,NUM,PROPN-ADP-PROPN,pobj,pobj-prep-poss,CD,NNP-IN-NNP,5,1
7970,6142.0,40,was,1,1,26,25,0,13,0,25,Cardiff,University of Wales,,per-per-per,PROPN,PROPN-ADP-PROPN,nsubj,nmod-prep-pobj,NNP,NNP-IN-NNP,7,1
7971,6143.0,19,attended,1,5,9,4,4,9,-4,8,Hart High School,Newhall,--,org,PROPN-PROPN-PROPN,PROPN,compound-compound-dobj,compound,NNP-NNP-NNP,NNP,3,1
7972,6145.0,13,is,4,1,12,11,0,0,3,8,Lake Local School District,Ohio,---,per,PROPN-PROPN-PROPN-PROPN,PROPN,compound-compound-compound-nsubj,pobj,NNP-NNP-NNP-NNP,NNP,4,1
7973,6146.0,53,elected,9,16,23,7,15,29,-7,14,John Quincy Adams,United States,--,org-org,PROPN-PROPN-PROPN,PROPN-PROPN,compound-compound-nsubjpass,compound-compound,NNP-NNP-NNP,NNP-NNP,6,1
7974,6147.0,36,established,3,12,35,23,11,0,-9,32,Egypt,EgyptAir,org,,PROPN,PROPN,pobj,appos,NNP,NNP,6,1
7975,6148.0,34,said,31,9,11,2,8,22,22,-20,Singapore,Tiger Aviation,org,-,PROPN,PROPN-PROPN,poss,compound-pobj,NNP,NNP-NNP,3,1
7976,6151.0,27,names,2,13,13,0,12,13,-11,11,CBS Radio,CBS Corporation,-,org-org,PROPN-PROPN,PROPN-PROPN,compound-compound,compound-compound,NNP-NNP,NNP-NNP,0,1
7977,6152.0,21,asked,1,1,6,5,0,14,0,5,He,Nepal,org,,PRON,PROPN,nsubj,nsubj,PRP,NNP,2,1
7978,11827.0,13,said,1,1,8,7,0,4,0,7,He,Nepal,,org,PRON,PROPN,nsubj,pobj,PRP,NNP,2,1
7979,6153.0,20,named,6,5,14,9,4,5,1,8,she,Ontario,,org,PRON,PROPN,nsubjpass,compound,PRP,NNP,5,1
7980,9606.0,14,served,4,4,10,6,3,3,0,6,she,Ontario,per,,PRON,PROPN,nsubj,compound,PRP,NNP,5,1
7981,6154.0,27,went,3,6,13,7,5,13,-3,10,Hong Kong,Golden Harvest,-,per-per,PROPN-PROPN,PROPN-PROPN,compound-pobj,compound-pobj,NNP-NNP,NNP-NNP,4,1
7982,6155.0,44,came,5,13,19,6,12,24,-8,14,Atlanta,Jermaine Dupri,,org-org,PROPN,PROPN-PROPN,compound,compound-compound,NNP,NNP-NNP,7,1
7983,6156.0,107,include,5,52,53,1,51,53,-47,48,Grenada,Keith Mitchell,,per-per,PROPN,PROPN-PROPN,pobj,compound-appos,NNP,NNP-NNP,1,1
7984,6157.0,26,introduced,3,3,14,11,2,11,0,11,Anderson,Maryland,org,,PROPN,PROPN,nsubj,nmod,NNP,NNP,7,1
7985,12989.0,15,was,1,1,11,10,0,3,0,10,Anderson,Maryland,,org,PROPN,PROPN,nsubj,poss,NNP,NNP,7,1
7986,6158.0,13,been,5,1,4,3,0,8,4,-1,Suggs,Madness,,org,NOUN,PROPN,nsubj,dobj,NN,NNP,3,1
7987,6159.0,21,helped,1,1,12,11,0,8,0,11,She,Chicago,,per,PRON,PROPN,nsubj,poss,PRP,NNP,2,1
7988,6160.0,22,completed,4,1,9,8,0,12,3,5,Michael Learns to Rock,Denmark,per-per-per-per,,PROPN-VERB-ADP-PROPN,PROPN,compound-nsubj-prep-pobj,dobj,NNP-VBZ-IN-NNP,NNP,4,1
7989,6161.0,16,located,2,11,11,0,10,4,-9,9,Syracuse NY,Syracuse University,org-org,-,PROPN-PROPN,PROPN-PROPN,compound-pobj,compound-attr,NNP-NNP,NNP-NNP,0,1
7990,6162.0,40,said,33,6,11,5,5,28,27,-22,Council for National Security,Sonthi Boonyaratglin,org-org-org-org,-,PROPN-ADP-PROPN-PROPN,PROPN-PROPN,nsubjpass-prep-compound-compound,compound-pobj,NNP-IN-NNP-NNP,NNP-NNP,1,1
7991,7736.0,19,appointed,2,9,17,8,8,1,-7,15,Council for National Security,Sonthi Boonyaratglin,per-per-per-per,-,PROPN-ADP-PROPN-PROPN,PROPN-PROPN,pobj-prep-compound-pobj,compound-pobj,NNP-IN-NNP-NNP,NNP-NNP,6,1
7992,7867.0,34,Chief,2,8,15,7,7,18,-6,13,Council for National Security,Sonthi Boonyaratglin,---,org-org,PROPN-ADP-PROPN-PROPN,PROPN-PROPN,pobj-prep-compound-pobj,compound-nsubj,NNP-IN-NNP-NNP,NNP-NNP,-1,1
7993,8044.0,37,submitted,17,23,29,6,22,7,-6,12,Council for National Security,Sonthi Boonyaratglin,per-per-per-per,-,PROPN-ADP-PROPN-PROPN,PROPN-PROPN,pobj-prep-compound-compound,compound-pobj,NNP-IN-NNP-NNP,NNP-NNP,1,1
7994,6163.0,70,sold,3,53,61,8,52,8,-50,58,NYSE,Merck Co.,,per-per,PROPN,PROPN-PROPN,appos,compound-pobj,NNP,NNP-NNP,1,1
7995,6164.0,23,was,9,4,4,0,3,18,5,-5,International,International Confederation of Free Trade Unions,,per-per-per-per-per-per,PROPN,PROPN-PROPN-ADP-PROPN-PROPN-PROPN,compound,compound-pobj-prep-compound-compound-pobj,NNP,NNP-NNP-IN-NNP-NNP-NNPS,0,1
7996,6165.0,35,run,17,15,29,14,14,5,2,12,Taiwan,Public Television Service,per,--,PROPN,PROPN-PROPN-PROPN,pobj,compound-compound-pobj,NNP,NNP-NNP-NNP,5,1
7997,6166.0,18,released,8,1,4,3,0,13,7,-4,Atlantic,Sam Dave,,per-per,PROPN,PROPN-PROPN,compound,compound-poss,NNP,NNP-NNP,2,1
7998,6169.0,94,File,0,40,40,0,39,53,-40,40,Montreal,Montreal Symphony Orchestra,,per-per-per,PROPN,PROPN-PROPN-PROPN,compound,compound-compound-pobj,NNP,NNP-NNP-NNP,0,1
7999,6170.0,36,Recap,0,15,21,6,14,14,-15,21,Seawolves,Division I,,per-per,PROPN,PROPN-PRON,nsubj,pobj-nsubj,NNPS,NNP-PRP,-1,1
8000,6172.0,7,is,3,1,5,4,0,1,2,2,Freeman,Myrna Colley-Lee,,per-per,PROPN,PROPN-NOUN,poss,compound-attr,NNP,NNP-NN,5,1
8001,6174.0,26,voted,2,14,17,3,13,8,-12,15,Helix High School,La Mesa,--,per-per,PROPN-PROPN-PROPN,PROPN-PROPN,compound-compound-compound,compound-compound,NNP-NNP-NNP,NNP-NNP,3,1
8002,6175.0,21,played,12,1,9,8,0,11,11,-3,Tim Commerford,Rage Against the Machine,-,per-per-per-per,PROPN-PROPN,NOUN-ADP-DET-PROPN,compound-nsubj,pobj-prep-det-pobj,NNP-NNP,NN-IN-DT-NNP,3,1
8003,6176.0,15,is,3,2,13,11,1,1,1,10,Forest School,West Sussex,-,org-org,PROPN-PROPN,PROPN-PROPN,compound-nsubj,compound-pobj,NNP-NNP,NNP-NNP,6,1
8004,6177.0,21,said,5,1,4,3,0,16,4,-1,Social Solidarity,Paolo Ferrero,-,org-org,PROPN-PROPN,PROPN-PROPN,compound-compound,compound-nsubj,NNP-NNP,NNP-NNP,2,1
8005,6178.0,16,lost,1,10,11,1,9,4,-9,10,Italian,Stefano Zoff,,org-org,ADJ,PROPN-PROPN,compound,compound-pobj,JJ,NNP-NNP,1,1
8006,6179.0,58,hosted,2,5,20,15,4,37,-3,18,Tacoma Sabercats,West Coast Hockey League,org-org,---,PROPN-PROPN,PROPN-PROPN-PROPN-PROPN,compound-pobj,compound-compound-compound-pobj,NNP-NNPS,NNP-NNP-NNP-NNP,8,1
8007,6180.0,90,married,1,18,36,18,17,53,-17,35,France,Jeanne III of Navarre,org,---,PROPN,PROPN-PROPN-ADP-PROPN,pobj,compound-pobj-prep-pobj,NNP,NNP-NNP-IN-NNP,5,1
8008,6181.0,44,helped,12,32,27,-5,31,16,-20,15,Saybana Sankoh,Sierra Leone,org-org,-,PROPN-PROPN,PROPN-PROPN,compound-appos,compound-pobj,NNP-NNP,NNP-NNP,3,1
8009,6182.0,22,licensed,3,9,18,9,8,3,-6,15,The Walt Disney Company,its,per-per-per-per,,DET-PROPN-PROPN-PROPN,DET,det-compound-compound-compound,poss,DT-NNP-NNP-NNP,PRP$,4,1
8010,6184.0,57,is,1,53,55,2,52,1,-52,54,Cinergy,Cincinnati,,org,PROPN,PROPN,pobj,compound,NNP,NNP,5,1
8011,6185.0,46,ordered,34,1,7,6,0,38,33,-27,Correa,Ecuador,,per,PROPN,PROPN,nsubj,poss,NNP,NNP,6,1
8012,9600.0,24,complained,1,1,13,12,0,10,0,12,Correa,Ecuador,,org,PROPN,PROPN,nsubj,nsubj,NNP,NNP,3,1
8013,10730.0,27,earned,12,1,5,4,0,21,11,-7,Correa,Ecuador,org,,PROPN,PROPN,nsubj,poss,NNP,NNP,4,1
8014,13739.0,28,stated,8,8,15,7,7,12,0,7,Correa,Ecuador,,per,PROPN,PROPN,pobj,poss,NNP,NNP,7,1
8015,6187.0,53,was,7,10,22,12,9,30,-3,15,American,James K. Polk,,org-org-org,PROPN,PROPN-PROPN-PROPN,amod,compound-compound-pobj,NNP,NNP-NNP-NNP,6,1
8016,6842.0,46,sent,10,4,8,4,3,37,6,-2,American,James K. Polk,,per-per-per,PROPN,PROPN-PROPN-PROPN,compound,compound-compound-nsubj,NNP,NNP-NNP-NNP,4,1
8017,12481.0,39,live,9,28,31,3,27,7,-19,22,American,James K. Polk,org,--,PROPN,PROPN-PROPN-PROPN,compound,compound-compound-nsubj,NNP,NNP-NNP-NNP,5,1
8018,6189.0,31,waved,19,4,18,14,3,12,15,-1,Hong Kong,Szeto Wah,per-per,-,PROPN-PROPN,PROPN-PROPN,compound-compound,compound-appos,NNP-NNP,NNP-NNP,6,1
8019,6190.0,58,met,6,13,25,12,12,32,-7,19,Thein Sein,SPDC,-,org,PROPN-PROPN,PROPN,compound-compound,parataxis,NNP-NNP,NNP,3,1
8020,6191.0,28,performed,2,7,27,20,6,0,-5,25,Production I.G,XEBEC,-,per,PROPN-PROPN,PROPN,compound-pobj,pobj,NNP-NNP,NNP,10,1
8021,6193.0,41,met,4,1,9,8,0,31,3,5,Obama,Chicago,per,,PROPN,PROPN,nsubj,compound,NNP,NNP,6,1
8022,6194.0,21,is,6,4,20,16,3,0,2,14,Ugo Tognazzi,Italy,per-per,,PROPN-PROPN,PROPN,compound-appos,pobj,NNP-NNP,NNP,3,1
8023,6195.0,26,holds,14,3,22,19,2,3,11,8,Nebraska,JCI Ralston,per,-,PROPN,PROPN-PROPN,nsubjpass,compound-nsubj,NNP,NNP-NNP,5,1
8024,6197.0,27,was,8,6,14,8,5,12,2,6,Ahmad Zia Massoud,Afghanistan,--,org,PROPN-PROPN-PROPN,PROPN,compound-compound-appos,pobj,NNP-NNP-NNP,NNP,5,1
8025,6198.0,18,merged,6,9,17,8,8,0,-3,11,Sampo,Group,,per,PROPN,PROPN,compound,dobj,NNP,NNP,4,1
8026,6199.0,24,is,3,1,22,21,0,1,2,19,The Hutchins School,Tasmania,org-org-org,,DET-PROPN-PROPN,PROPN,det-compound-nsubj,compound,DT-NNP-NNP,NNP,5,1
8027,6200.0,41,consist,7,7,19,12,6,21,0,12,Malaysia,International Islamic University Malaysia,,org-org-org-org,PROPN,PROPN-PROPN-PROPN-PROPN,pobj,compound-compound-nmod-nmod,NNP,NNP-NNP-NNP-NNP,5,1
8028,6201.0,34,spent,2,2,33,31,1,0,0,31,he,England,,org,PRON,PROPN,nsubj,pobj,PRP,NNP,1,1
8029,13876.0,17,studied,2,2,11,9,1,5,0,9,he,England,,per,PRON,PROPN,nsubj,pobj,PRP,NNP,1,1
8030,6202.0,29,bought,8,3,7,4,2,21,5,-1,Burbank,Disney,,per,PROPN,PROPN,pobj,pobj,NNP,NNP,3,1
8031,12197.0,49,For,0,9,13,4,8,35,-9,13,Burbank,Disney,,org,PROPN,PROPN,ROOT,nsubj,NNP,NNP,6,1
8032,6203.0,16,merged,12,1,11,10,0,4,11,-1,Hafslund,Oslo,org,,PROPN,PROPN,nsubjpass,pobj,NNP,NNP,3,1
8033,6204.0,20,Laboratories,1,1,4,3,0,15,0,3,Hamdard Laboratories,Waqf,org-org,,PROPN-PROPN,PROPN,compound-ROOT,appos,NNP-NNP,NNP,2,1
8034,6205.0,25,attended,1,6,6,0,5,18,-5,5,Florida,Florida Gators baseball,,org-org-org,PROPN,PROPN-PROPN-NOUN,appos,compound-compound-compound,NNP,NNP-NNPS-NN,0,1
8035,6206.0,22,is,1,7,20,13,6,1,-6,19,American,Black Francis,,org-org,ADJ,PROPN-PROPN,amod,compound-dobj,JJ,NNP-NNP,7,1
8036,6207.0,37,is,10,3,18,15,2,18,7,8,Warfare Combatant-Craft Crewman,United States Navy,--,per-per-per,PROPN-PROPN-PROPN,PROPN-PROPN-PROPN,compound-amod-nsubj,compound-compound-pobj,NNP-NNP-NNP,NNP-NNP-NNP,8,1
8037,6208.0,44,houses,1,24,36,12,23,7,-23,35,Mississippi,Millsaps College,per,-,PROPN,PROPN-PROPN,compound,compound-appos,NNP,NNP-NNP,5,1
8038,6209.0,19,is,7,1,1,0,0,17,6,-6,Mt. Angel School District,Mt. Angel,---,per-per,PROPN-PROPN-PROPN-PROPN,PROPN-PROPN,compound-compound-compound-nsubj,compound-compound,NNP-NNP-NNP-NNP,NNP-NNP,0,1
8039,6211.0,31,was,2,8,11,3,7,19,-6,9,Spector,Philles Records,per,-,PROPN,PROPN-PROPN,poss,compound-compound,NNP,NNP-NNP,4,1
8040,6212.0,28,graduated,1,19,19,0,18,8,-18,18,Warsaw,Warsaw School of Economics,org,---,PROPN,PROPN-PROPN-ADP-PROPN,pobj,compound-parataxis-prep-pobj,NNP,NNP-NNP-IN-NNP,0,1
8041,6213.0,27,met,15,14,26,12,13,0,1,11,Franklin Carmichael,Toronto,-,per,PROPN-PROPN,PROPN,compound-conj,pobj,NNP-NNP,NNP,3,1
8042,6214.0,13,worked,1,1,5,4,0,7,0,4,Ryan,Utah,,per,PROPN,PROPN,nsubj,compound,NNP,NNP,2,1
8043,6215.0,26,continue,9,9,23,14,8,2,0,14,Ruston,Louisiana Tech University,,org-org-org,PROPN,PROPN-PROPN-PROPN,pobj,compound-compound-pobj,NNP,NNP-NNP-NNP,9,1
8044,6216.0,13,recorded,3,6,12,6,5,0,-3,9,J Mascis,Massachusetts,org-org,,PROPN-PROPN,PROPN,compound-poss,pobj,NNP-NNP,NNP,4,1
8045,6218.0,37,is,1,1,7,6,0,29,0,6,He,Los Angeles County Board,per,---,PRON,PROPN-PROPN-PROPN-PROPN,nsubj,compound-compound-compound-pobj,PRP,NNP-NNP-NNP-NNP,5,1
8046,6219.0,37,founded,1,4,10,6,3,26,-3,9,Yale,Connecticut,org,,PROPN,PROPN,compound,pobj,NNP,NNP,2,1
8047,6221.0,27,sang,15,23,2,-21,22,24,-8,-13,Janet Weiss,Sleater-Kinney,org-org,,PROPN-PROPN,PROPN,compound-pobj,pobj,NNP-NNP,NNP,7,1
8048,6222.0,18,established,3,6,15,9,5,2,-3,12,London,Institute of Education,per,--,PROPN,PROPN-ADP-PROPN,pobj,pobj-prep-pobj,NNP,NNP-IN-NNP,5,1
8049,6223.0,33,built,22,5,17,12,4,15,17,-5,Taylor Swift,Big Machine,-,per-per,PROPN-PROPN,PROPN-PROPN,compound-appos,compound-compound,NNP-NNP,NNP-NNP,5,1
8050,6224.0,17,became,2,1,8,7,0,8,1,6,Bio,Sierra Leone,,per-per,PROPN,PROPN-PROPN,nsubj,compound-compound,NNP,NNP-NNP,6,1
8051,6225.0,20,served,9,1,15,14,0,4,8,6,Joseph Sinde Warioba,Tanzania,per-per-per,,PROPN-PROPN-PROPN,PROPN,compound-compound-nsubj,pobj,NNP-NNP-NNP,NNP,3,1
8052,6226.0,20,attended,1,3,8,5,2,11,-2,7,Dundee-Crown High School,Illinois,--,per,PROPN-PROPN-PROPN,PROPN,amod-compound-dobj,pobj,NNP-NNP-NNP,NNP,4,1
8053,6228.0,23,founded,6,4,9,5,3,13,2,3,University of,1780,-,org,PROPN-ADP,NUM,nsubjpass-prep,pobj,NNP-IN,CD,3,1
8054,6229.0,16,fostered,5,9,13,4,8,2,-4,8,his,Montana,,per,DET,PROPN,poss,pobj,PRP$,NNP,4,1
8055,6230.0,25,Trouble,0,9,20,11,8,4,-9,20,John Mellencamp,Columbia,per-per,,PROPN-PROPN,PROPN,compound-poss,compound,NNP-NNP,NNP,4,1
8056,6231.0,22,is,8,1,21,20,0,0,7,13,Alim Qasimov,Azerbaijan,per-per,,PROPN-PROPN,PROPN,compound-nsubj,pobj,NNP-NNP,NNP,2,1
8057,6232.0,41,fought,14,20,24,4,19,16,-6,10,David C. Broderick,California,--,org,PROPN-PROPN-PROPN,PROPN,compound-compound-pobj,pobj,NNP-NNP-NNP,NNP,2,1
8058,6234.0,33,expressed,10,10,21,11,9,11,0,11,Culp,actor,per,,PROPN,NOUN,pobj,pobj,NNP,NN,3,1
8059,6236.0,19,labelled,13,1,13,12,0,5,12,0,Dickinson,England,org,,PROPN,PROPN,nsubj,pobj,NNP,NNP,3,1
8060,6237.0,26,bought,2,12,13,1,11,12,-10,11,Bill Dundee,Dundee,-,org,PROPN-PROPN,PROPN,compound-pobj,nsubj,NNP-NNP,NNP,2,1
8061,6238.0,37,cited,6,15,27,12,14,9,-9,21,General Motors,Opel,per-per,,PROPN-PROPN,PROPN,compound-nsubj,dobj,NNP-NNPS,NNP,3,1
8062,6239.0,26,is,9,1,1,0,0,24,8,-8,Dalian University of Technology,Dalian,---,org,PROPN-PROPN-ADP-PROPN,PROPN,compound-nmod-prep-pobj,compound,NNP-NNP-IN-NNP,NNP,0,1
8063,6240.0,53,list,7,18,32,14,17,20,-11,25,Canada,UBC,per,,PROPN,PROPN,pobj,compound,NNP,NNP,6,1
8064,6241.0,19,is,2,1,17,16,0,1,1,15,Mark Randel,Terminal Reality,per-per,-,PROPN-PROPN,PROPN-PROPN,compound-nsubj,compound-pobj,NNP-NNP,NNP-NNP,5,1
8065,6242.0,25,had,11,5,17,12,4,7,6,6,Mary Cassatt,France,org-org,,PROPN-PROPN,PROPN,compound-appos,pobj,NNP-NNP,NNP,6,1
8066,6243.0,42,founded,3,2,10,8,1,31,1,7,group,Mikhail Fridman,,org-org,NOUN,PROPN-PROPN,nsubjpass,compound-pobj,NN,NNP-NNP,2,1
8067,6244.0,24,told,21,18,20,2,17,3,3,-1,Vogue,Alexandra Shulman,,per-per,PROPN,PROPN-PROPN,compound,compound-nsubj,NNP,NNP-NNP,3,1
8068,6247.0,32,is,15,15,25,10,14,6,0,10,Janez,Slovenia,org,,PROPN,PROPN,pobj,pobj,NNP,NNP,3,1
8069,9062.0,16,known,2,8,12,4,7,3,-6,10,Janez,Slovenia,per,,PROPN,PROPN,nmod,pobj,NNP,NNP,2,1
8070,6248.0,21,is,5,7,18,11,6,2,-2,13,Tiverton Town F.C.,One,per-per-per,,PROPN-PROPN-PROPN,NUM,compound-compound-attr,nummod,NNP-NNP-NNP,CD,6,1
8071,6249.0,21,fled,3,1,5,4,0,15,2,2,Hajjar,Lebanon,per,,PROPN,PROPN,poss,dobj,NNP,NNP,4,1
8072,6250.0,29,named,12,16,20,4,15,8,-4,8,Theodore Roosevelt,United States,-,org-org,PROPN-PROPN,PROPN-PROPN,compound-pobj,compound-compound,NNP-NNP,NNP-NNP,5,1
8073,6251.0,30,faced,11,2,23,21,1,6,9,12,Kabila,Democratic Republic,per,-,PROPN,PROPN-PROPN,nsubj,compound-dobj,NNP,NNP-NNP,6,1
8074,6252.0,24,attended,1,3,3,0,2,20,-2,2,Texas University,Texas Aggies,per-per,-,PROPN-PROPN,PROPN-PROPN,compound-dobj,compound-compound,NNP-NNP,NNP-NNP,0,1
8075,6253.0,19,is,3,16,18,2,15,0,-13,15,DreamWorks,SKG,,org,PROPN,PROPN,compound,pobj,NNP,NNP,9,1
8076,6254.0,37,border,1,14,21,7,13,15,-13,20,Charles Taylor,Liberia,per-per,,PROPN-PROPN,PROPN,compound-poss,pobj,NNP-NNP,NNP,2,1
8077,6256.0,24,resides,2,6,14,8,5,9,-4,12,Texas,University of Texas of the Permian Basin,per,------,PROPN,PROPN-ADP-PROPN-ADP-DET-PROPN-PROPN,pobj,appos-prep-pobj-prep-det-compound-compound,NNP,NNP-IN-NNP-IN-DT-NNP-NNP,4,1
8078,6258.0,24,is,7,2,15,13,1,8,5,8,10th Mountain Division,United States Army,--,org-org-org,ADJ-PROPN-PROPN,PROPN-PROPN-PROPN,amod-compound-compound,compound-compound-pobj,JJ-NNP-NNP,NNP-NNP-NNP,8,1
8079,6259.0,12,aged,9,2,5,3,1,6,7,-4,American,Isaac Hayes,per,-,ADJ,PROPN-PROPN,amod,compound-nsubj,JJ,NNP-NNP,2,1
8080,6261.0,24,was,1,4,21,17,3,2,-3,20,Lebanon,Fiji Infantry Regiment,per,--,PROPN,PROPN-PROPN-PROPN,pobj,compound-compound-pobj,NNP,NNP-NNP-NNP,7,1
8081,6264.0,29,remained,12,19,24,5,18,4,-7,12,Liberal Party,Partido Liberal,org-org,-,PROPN-PROPN,PROPN-PROPN,compound-npadvmod,compound-compound,NNP-NNP,NNP-NNP,2,1
8082,11293.0,27,Party,2,2,9,7,1,17,0,7,Liberal Party,Partido Liberal,per-per,-,PROPN-PROPN,PROPN-PROPN,compound-ROOT,compound-compound,NNP-NNP,NNP-NNP,2,1
8083,6265.0,19,began,4,14,17,3,13,1,-10,13,Gallaudet University,Washington,-,per,PROPN-PROPN,PROPN,compound-nmod,pobj,NNP-NNP,NNP,4,1
8084,7211.0,16,attend,5,7,10,3,6,5,-2,5,Gallaudet University,Washington,org-org,,PROPN-PROPN,PROPN,compound-dobj,compound,NNP-NNP,NNP,1,1
8085,6266.0,27,played,8,1,4,3,0,22,7,-4,Mick Taylor,Rolling Stones,org-org,-,PROPN-PROPN,PROPN-PROPN,compound-nsubj,compound-poss,NNP-NNP,NNP-NNPS,2,1
8086,6268.0,23,Kim,0,1,9,8,0,13,-1,9,Kim,Presidium,per,,PROPN,PROPN,ROOT,pobj,NNP,NNP,6,1
8087,6269.0,23,Graduating,0,15,15,0,14,7,-15,15,Kanazawa University,Kanazawa,per-per,,PROPN-PROPN,PROPN,compound-compound,compound,NNP-NNP,NNP,0,1
8088,6270.0,20,assert,2,5,12,7,4,7,-3,10,Peterson,MPS,per,,PROPN,PROPN,poss,pobj,NNP,NNP,4,1
8089,6271.0,30,said,13,15,20,5,14,9,-2,7,Wu Dingfu,China Insurance Regulatory Commission,-,per-per-per-per,PROPN-PROPN,PROPN-PROPN-PROPN-PROPN,compound-compound,compound-compound-compound-pobj,NNP-NNP,NNP-NNP-NNP-NNP,4,1
8090,6272.0,33,was,1,10,18,8,9,14,-9,17,West Chester,Brandon DiCamillo,per-per,-,PROPN-PROPN,PROPN-PROPN,compound-compound,compound-compound,NNP-NNP,NNP-NNP,9,1
8091,6274.0,27,arrested,2,12,25,13,11,1,-10,23,National Police,Marseilles,per-per,,PROPN-PROPN,PROPN,compound-conj,compound,NNP-NNPS,NNP,7,1
8092,6275.0,32,said,2,15,24,9,14,7,-13,22,Stephen Green,HSBC,per-per,,PROPN-PROPN,PROPN,compound-dobj,compound,NNP-NNP,NNP,6,1
8093,6276.0,58,based,3,9,15,6,8,42,-6,12,Jeff Zucker,NBC,org-org,,PROPN-PROPN,PROPN,compound-compound,compound,NNP-NNP,NNP,5,1
8094,6277.0,30,continued,7,21,25,4,20,4,-14,18,Consolidated Rail Corporation,Conrail,org-org-org,,PROPN-PROPN-PROPN,PROPN,compound-compound-pobj,oprd,NNP-NNP-NNP,NNP,5,1
8095,6279.0,61,was,10,1,44,43,0,16,9,34,Stella Adler,Los Angeles,-,org-org,PROPN-PROPN,PROPN-PROPN,compound-nsubj,compound-pobj,NNP-NNP,NNP-NNP,6,1
8096,6280.0,23,shared,1,13,21,8,12,1,-12,20,Michael Hillegas,United States,per-per,-,PROPN-PROPN,PROPN-PROPN,compound-pobj,compound-pobj,NNP-NNP,NNP-NNP,5,1
8097,6281.0,38,been,2,13,15,2,12,22,-11,13,Kansas,Eastern Kentucky University,org,--,PROPN,PROPN-PROPN-PROPN,pobj,compound-compound-conj,NNP,NNP-NNP-NNP,3,1
8098,6282.0,34,opened,2,1,25,24,0,8,1,23,US,Packard,org,,PROPN,PROPN,compound,conj,NNP,NNP,2,1
8099,6283.0,41,was,15,5,12,7,4,28,10,-3,Chuck Berry,Atco,per-per,,PROPN-PROPN,PROPN,compound-compound,compound,NNP-NNP,NNP,4,1
8100,6284.0,75,are,1,14,49,35,13,25,-13,48,UCL,UK,,per,PROPN,PROPN,poss,pobj,NNP,NNP,9,1
8101,6285.0,30,songs,3,19,21,2,18,8,-16,18,Tokyo,LITE,per,,PROPN,PROPN,compound,pobj,NNP,NNP,6,1
8102,6286.0,15,started,2,1,7,6,0,7,1,5,Air Manchester,1982,-,org,PROPN-PROPN,NUM,compound-nsubj,nummod,NNP-NNP,CD,2,1
8103,6287.0,28,is,3,2,22,20,1,5,1,19,Subaru,Fuji Heavy Industries,per,--,PROPN,PROPN-PROPN-PROPN,compound,compound-compound-pobj,NNP,NNP-NNP-NNPS,7,1
8104,6288.0,23,was,13,1,22,21,0,0,12,9,Margaret of Anjou,England,per-per-per,,PROPN-ADP-PROPN,PROPN,nsubj-prep-pobj,pobj,NNP-IN-NNP,NNP,3,1
8105,6289.0,35,includes,2,10,13,3,9,21,-8,11,Marion,Indiana Wesleyan University,per,--,PROPN,PROPN-PROPN-PROPN,pobj,compound-compound-appos,NNP,NNP-NNP-NNP,2,1
8106,6290.0,27,is,10,1,13,12,0,13,9,3,Maria Pereira Neves,Cape Verde,--,org-org,PROPN-PROPN-PROPN,PROPN-PROPN,compound-compound-dep,compound-pobj,NNP-NNP-NNPS,NNP-NNP,4,1
8107,6291.0,26,demanded,11,4,18,14,3,7,7,7,Southern Rhodesia,Ian Smith,org-org,-,PROPN-PROPN,PROPN-PROPN,compound-nsubj,compound-pobj,NNP-NNP,NNP-NNP,6,1
8108,13594.0,31,was,10,9,23,14,8,7,1,13,Southern Rhodesia,Ian Smith,-,per-per,PROPN-PROPN,PROPN-PROPN,compound-nsubj,compound-pobj,NNP-NNP,NNP-NNP,7,1
8109,6292.0,36,stolen,3,17,23,6,16,12,-14,20,University of East Anglia,England,per-per-per-per,,PROPN-ADP-PROPN-PROPN,PROPN,pobj-prep-compound-pobj,pobj,NNP-IN-NNP-NNP,NNP,6,1
8110,6293.0,17,presented,2,1,11,10,0,5,1,9,He,VRT,,org,PRON,PROPN,nsubj,compound,PRP,NNP,4,1
8111,6294.0,33,began,11,9,21,12,8,11,2,10,Sanctuary,Dave Mustaine,,org-org,PROPN,PROPN-PROPN,compound,compound-compound,NNP,NNP-NNP,10,1
8112,6295.0,18,born,2,1,4,3,0,13,1,2,Edwards,James Keith,,org-org,PROPN,PROPN-PROPN,nsubjpass,compound-compound,NNP,NNP-NNP,2,1
8113,6297.0,33,amalgamated,3,15,31,16,14,1,-12,28,Royal Mercian and Lancastrian Yeomanry,Territorial Army,----,per-per,PROPN-PROPN-CCONJ-PROPN-PROPN,PROPN-PROPN,compound-dobj-cc-compound-conj,compound-pobj,NNP-NNP-CC-NNP-NNP,NNP-NNP,8,1
8114,6298.0,38,is,6,1,24,23,0,13,5,18,Spare Change,Homeless Empowerment Project,-,per-per-per,PROPN-PROPN,PROPN-PROPN-PROPN,compound-compound,compound-compound-pobj,NNP-NNP,NNP-NNP-NNP,10,1
8115,6299.0,36,is,2,2,17,15,1,18,0,15,ANA,Italy,,org,PROPN,PROPN,nsubj,pobj,NNP,NNP,2,1
8116,6300.0,69,are,1,9,9,0,8,59,-8,8,Cork Institute of Technology,Cork,---,per,PROPN-PROPN-ADP-PROPN,PROPN,compound-conj-prep-pobj,poss,NNP-NNP-IN-NNP,NNP,0,1
8117,6302.0,72,continued,2,14,23,9,13,48,-12,21,Tran and Vi,ny stars,--,org-org,PROPN-CCONJ-PROPN,ADP-NOUN,nmod-cc-compound,compound-attr,NNP-CC-NNP,IN-NNS,-1,1
8118,6303.0,21,returned,4,4,7,3,3,13,0,3,she,Chile,org,,PRON,PROPN,nsubj,pobj,PRP,NNP,2,1
8119,6304.0,34,known,11,15,25,10,14,8,-4,14,Willa Ford,singer,org-org,,PROPN-PROPN,NOUN,compound-pobj,compound,NNP-NNP,NN,8,1
8120,6305.0,20,teamed,2,13,18,5,12,1,-11,16,Wilson Pickett,Atlantic,per-per,,PROPN-PROPN,PROPN,compound-nsubj,compound,NNP-NNP,NNP,8,1
8121,6307.0,33,established,10,5,16,11,4,16,5,6,Florida,university,per,,PROPN,NOUN,compound,dobj,NNP,NN,6,1
8122,6308.0,27,is,1,7,11,4,6,15,-6,10,Mount Sinai Hospital,Toronto,org-org-org,,PROPN-PROPN-PROPN,PROPN,compound-compound-pobj,pobj,NNP-NNP-NNP,NNP,5,1
8123,6309.0,26,became,1,13,19,6,12,6,-12,18,National College of Arts,Lahore,per-per-per-per,,PROPN-PROPN-ADP-PROPN,PROPN,compound-appos-prep-pobj,pobj,NNP-NNP-IN-NNP,NNP,3,1
8124,6310.0,22,is,8,2,2,0,1,19,6,-6,Goa Institute of Management,Goa,---,org,PROPN-PROPN-ADP-PROPN,PROPN,compound-nsubj-prep-pobj,pobj,NNP-NNP-IN-NNP,NNP,0,1
8125,6311.0,29,scored,5,11,17,6,10,11,-6,12,Boston University,Rick Pitino,-,per-per,PROPN-PROPN,PROPN-PROPN,compound-pobj,compound-dobj,NNP-NNP,NNP-NNP,4,1
8126,6312.0,24,replaced,7,16,19,3,15,4,-9,12,The Dicks,Texas,per-per,,DET-PROPN,PROPN,det-pobj,compound,DT-NNP,NNP,1,1
8127,6313.0,20,flew,9,6,8,2,5,11,3,-1,Kuomintang,Chiang Kai-shek,org,-,PROPN,PROPN-PROPN,compound,compound-nsubj,NNP,NNP-NNP,2,1
8128,9179.0,38,fled,6,4,17,13,3,20,2,11,Kuomintang,Chiang Kai-shek,per,-,PROPN,PROPN-PROPN,nmod,compound-pobj,NNP,NNP-NNP,6,1
8129,6314.0,23,created,11,2,3,1,1,19,9,-8,1952,Atomic Energy of Canada Limited,,org-org-org-org-org,NUM,PROPN-PROPN-ADP-PROPN-PROPN,pobj,compound-nsubjpass-prep-compound-pobj,CD,NNP-NNP-IN-NNP-NNP,1,1
8130,6315.0,22,is,11,9,17,8,8,4,2,6,school,Las Vegas,,org-org,NOUN,PROPN-PROPN,nsubjpass,compound-poss,NN,NNP-NNP,8,1
8131,6316.0,23,p.,1,6,8,2,5,14,-5,7,1927,Peru national football team,org,---,NUM,PROPN-ADJ-NOUN-NOUN,pobj,nmod-amod-compound-nsubj,CD,NNP-JJ-NN-NN,2,1
8132,6317.0,41,was,18,3,6,3,2,34,15,-12,Vietnam national football team,team of,---,per-per,PROPN-ADJ-NOUN-NOUN,NOUN-ADP,nmod-amod-compound-nsubj,attr-prep,NNP-JJ-NN-NN,NN-IN,4,1
8133,6319.0,50,Without,0,15,34,19,14,15,-15,34,Tom,Los Angeles,per,-,PROPN,PROPN-PROPN,nsubj,compound-compound,NNP,NNP-NNP,5,1
8134,6320.0,29,sign,4,12,12,0,11,16,-8,8,San Diego State University,San Diego State Aztecs,---,org-org-org-org,PROPN-PROPN-PROPN-PROPN,PROPN-PROPN-PROPN-PROPN,compound-compound-compound-dobj,compound-compound-compound-compound,NNP-NNP-NNP-NNP,NNP-NNP-NNP-NNP,0,1
8135,6321.0,28,was,1,7,15,8,6,12,-6,14,Graduate Institute of International and Development Studies,Geneva,------,org,PROPN-PROPN-ADP-PROPN-CCONJ-PROPN-PROPN,PROPN,compound-pobj-prep-nmod-cc-conj-pobj,pobj,NNP-NNP-IN-NNP-CC-NNP-NNPS,NNP,3,1
8136,6322.0,36,said,18,11,16,5,10,19,7,-2,American Motors,Beijing Jeep,per-per,-,PROPN-PROPN,PROPN-PROPN,compound-poss,compound-compound,NNP-NNPS,NNP-NNP,4,1
8137,6323.0,22,became,3,8,9,1,7,12,-5,6,Manchester,Polytechnic,org,,PROPN,PROPN,compound,pobj,NNP,NNP,4,1
8138,6324.0,28,is,11,18,18,0,17,9,-7,7,Genoa,Genoa C.F.C.,,org-org,PROPN,PROPN-PROPN,poss,compound-conj,NNP,NNP-NNP,0,1
8139,6326.0,19,called,9,6,8,2,5,10,3,-1,Soviet Union,Mikhail Gorbachev,-,org-org,PROPN-PROPN,PROPN-PROPN,compound-compound,compound-pobj,NNP-NNP,NNP-NNP,1,1
8140,6328.0,33,was,3,13,23,10,12,9,-10,20,22nd Marine Expeditionary Unit,United States Marine Corps,---,org-org-org-org,ADJ-PROPN-PROPN-PROPN,PROPN-PROPN-PROPN-PROPN,amod-compound-compound-pobj,compound-compound-compound-pobj,JJ-NNP-NNP-NNP,NNP-NNP-NNP-NNP,4,1
8141,7765.0,41,Marines,5,10,27,17,9,13,-5,22,22nd Marine Expeditionary Unit,United States Marine Corps,---,org-org-org-org,ADJ-PROPN-PROPN-PROPN,PROPN-PROPN-PROPN-PROPN,amod-compound-compound-pobj,compound-compound-compound-compound,JJ-NNP-NNP-NNP,NNP-NNP-NNP-NNP,7,1
8142,6330.0,44,documentary,1,27,35,8,26,8,-26,34,Micheline Presle,France,-,per,PROPN-PROPN,PROPN,compound-nsubjpass,pobj,NNP-NNP,NNP,10,1
8143,6331.0,18,is,4,2,7,5,1,10,2,3,Howard Miller Company,Zeeland,org-org-org,,PROPN-PROPN-PROPN,PROPN,compound-compound-nsubj,compound,NNP-NNP-NNP,NNP,5,1
8144,6332.0,24,Patrick,2,18,22,4,17,1,-16,20,Army,2nd Division,per,-,PROPN,ADJ-PROPN,compound,compound-dobj,NNP,JJ-NNP,2,1
8145,6334.0,32,born,3,19,28,9,18,3,-16,25,Orlando,Oak Ridge High School,,per-per-per-per,PROPN,PROPN-PROPN-PROPN-PROPN,compound,compound-compound-compound-conj,NNP,NNP-NNP-NNP-NNP,4,1
8146,6335.0,27,took,11,5,22,17,4,4,6,11,University College London,Ear Hospital,per-per-per,-,PROPN-PROPN-PROPN,PROPN-PROPN,compound-compound-compound,compound-conj,NNP-NNP-NNP,NNP-NNP,6,1
8147,6336.0,99,left,0,7,13,6,6,85,-7,13,Edmund Barton,Australia,per-per,,PROPN-PROPN,PROPN,compound-nsubj,pobj,NNP-NNP,NNP,1,1
8148,6337.0,25,The,0,4,20,16,3,4,-4,20,Arkansas State Red Wolves,Division I,per-per-per-per,-,PROPN-PROPN-PROPN-PROPN,PROPN-PRON,compound-npadvmod-compound-compound,pobj-nsubj,NNP-NNP-NNP-NNP,NNP-PRP,5,1
8149,11251.0,23,been,2,7,16,9,6,6,-5,14,Arkansas State Red Wolves,Division I,org-org-org-org,-,PROPN-PROPN-PROPN-PROPN,PROPN-PROPN,compound-nmod-compound-compound,pobj-nmod,NNP-NNP-NNP-NNP,NNP-NNP,4,1
8150,6338.0,46,educated,7,17,29,12,16,16,-10,22,Downe House School,Berkshire,org-org-org,,PROPN-PROPN-PROPN,PROPN,compound-compound-pobj,pobj,NNP-NNP-NNP,NNP,5,1
8151,6339.0,17,University,2,1,7,6,0,9,1,5,Irkutsk State University,?,org-org-org,,PROPN-PROPN-PROPN,PUNCT,compound-compound-ROOT,punct,NNP-NNP-NNP,.,-1,1
8152,6340.0,34,contributes,2,10,22,12,9,11,-8,20,Unitaid,Philippe Douste-Blazy,org,-,PROPN,PROPN-PROPN,pobj,compound-appos,NNP,NNP-NNP,5,1
8153,6341.0,31,is,7,2,17,15,1,13,5,10,Ulverston Victoria High School,Cumbria,per-per-per-per,,PROPN-PROPN-PROPN-PROPN,PROPN,compound-compound-compound-compound,compound,NNP-NNP-NNP-NNP,NNP,7,1
8154,6342.0,34,say,4,11,32,21,10,1,-7,28,Antioch,Yellow Springs,per,-,PROPN,PROPN-PROPN,compound,compound-pobj,NNP,NNP-NNP,5,1
8155,6343.0,31,is,8,14,17,3,13,13,-6,9,Ross,Deacon Blue,per,-,PROPN,PROPN-PROPN,nsubj,compound-compound,NNP,NNP-NNP,4,1
8156,6345.0,33,is,2,1,27,26,0,5,1,25,HBOS plc,Bank of Scotland,per-per,--,PROPN-NOUN,PROPN-ADP-PROPN,compound-nsubj,pobj-prep-pobj,NNP-NN,NNP-IN-NNP,9,1
8157,6346.0,24,deserted,3,1,12,11,0,11,2,9,Maine,Gould,,per,PROPN,PROPN,compound,pobj,NNP,NNP,2,1
8158,6347.0,81,htmlhttp,0,10,11,1,9,69,-10,11,1986,JUST,,org,NUM,PROPN,pobj,nsubj,CD,NNP,2,1
8159,6348.0,23,derives,2,7,11,4,6,11,-5,9,Pat Harrison,Mississippi,org-org,,PROPN-PROPN,PROPN,compound-pobj,dobj,NNP-NNP,NNP,2,1
8160,6349.0,32,said,9,20,25,5,19,6,-11,16,Jiro,Japan,org,,PROPN,PROPN,compound,compound,NNP,NNP,6,1
8161,6350.0,18,is,1,3,16,13,2,1,-2,15,Unsane,Ipecac Recordings,org,-,PROPN,PROPN-PROPN,poss,compound-pobj,NNP,NNP-NNPS,7,1
8162,6352.0,32,remained,9,16,25,9,15,6,-7,16,Ahmed Ouyahia,RND,per-per,,PROPN-PROPN,PROPN,compound-compound,appos,NNP-NNP,NNP,4,1
8163,6354.0,41,released,5,25,38,13,24,2,-20,33,22-20s,Wellington,,org,NUM,PROPN,pobj,pobj,CD,NNP,9,1
8164,6355.0,21,is,6,10,15,5,9,5,-4,9,r in Vie,h of Ho Chi,org-org-org,---,NOUN-ADP-PROPN,DET-ADP-PROPN-PROPN,attr-prep-pobj,dobj-prep-compound-compound,NN-IN-NNP,DT-IN-NNP-NNP,4,1
8165,6356.0,46,explained,31,4,17,13,3,28,27,-14,Adolf,Austria,,org,PROPN,PROPN,nsubjpass,pobj,NNP,NNP,5,1
8166,10155.0,38,Kyrle,1,19,25,6,18,12,-18,24,Adolf,Austria,org,,PROPN,PROPN,pobj,pobj,NNP,NNP,2,1
8167,6357.0,61,ruled,5,30,5,-25,29,55,-25,0,Malawi,Banda,org,,PROPN,PROPN,poss,nsubj,NNP,NNP,-1,1
8168,6358.0,36,recorded,4,16,22,6,15,13,-12,18,singer,Rushdi,,per,NOUN,PROPN,pobj,nsubj,NN,NNP,9,1
8169,6359.0,53,supported,2,17,25,8,16,27,-15,23,Hekmatyar,Afghanistan,per,,PROPN,PROPN,nsubj,pobj,NNP,NNP,3,1
8170,11253.0,21,believed,2,1,9,8,0,11,1,7,Hekmatyar,Afghanistan,per,,PROPN,PROPN,nsubjpass,pobj,NNP,NNP,5,1
8171,11310.0,29,leads,1,1,18,17,0,10,0,17,Hekmatyar,Afghanistan,,per,PROPN,PROPN,nsubj,pobj,NNP,NNP,5,1
8172,6360.0,24,divided,1,1,22,21,0,1,0,21,He,Kansas City,org,-,PRON,PROPN-PROPN,nsubj,compound-pobj,PRP,NNP-NNP,5,1
8173,6361.0,18,nominated,3,1,17,16,0,0,2,14,He,Bajofondo,org,,PRON,PROPN,nsubjpass,pobj,PRP,NNP,8,1
8174,6362.0,30,Colonel,0,1,5,4,0,24,-1,5,Colonel Israel Angell,2nd Rhode Island Regiment,org-org-org,---,PROPN-PROPN-PROPN,ADJ-PROPN-PROPN-PROPN,ROOT-compound-poss,compound-compound-compound-nsubj,NNP-NNP-NNP,JJ-NNP-NNP-NNP,4,1
8175,6363.0,20,broadcast,4,7,10,3,6,9,-3,6,SPORT1,RTL,,per,PROPN,PROPN,pobj,pobj,NNP,NNP,3,1
8176,6364.0,27,was,12,1,25,24,0,1,11,13,Florian Pilkington-Miksa,Curved Air,-,org-org,ADJ-PROPN,PROPN-PROPN,amod-nsubj,compound-appos,JJ-NNP,NNP-NNP,8,1
8177,6365.0,23,is,8,6,20,14,5,2,2,12,Angelo State University,San Angelo,per-per-per,-,PROPN-PROPN-PROPN,PROPN-PROPN,compound-compound-pobj,compound-compound,NNP-NNP-NNP,NNP-NNP,11,1
8178,6366.0,27,is,4,1,25,24,0,1,3,21,Toyota,Shoichiro Toyoda,,per-per,PROPN,PROPN-PROPN,poss,compound-pobj,NNP,NNP-NNP,6,1
8179,6367.0,9,is,6,1,2,1,0,6,5,-4,Actress,Stacey Dash,,per-per,PROPN,PROPN-PROPN,compound,compound-nsubj,NNP,NNP-NNP,1,1
8180,6369.0,40,was,7,7,12,5,6,27,0,5,network,Melbourne,,per,NOUN,PROPN,dobj,pobj,NN,NNP,1,1
8181,6370.0,54,released,3,3,50,47,2,3,0,47,Stuart,Machete Records,per,-,PROPN,PROPN-PROPN,poss,compound-pobj,NNP,NNP-NNPS,-1,1
8182,6373.0,38,reported,14,11,13,2,10,24,3,-1,Russian,Ivan Pavlov,per,-,ADJ,PROPN-PROPN,amod,compound-nsubj,JJ,NNP-NNP,1,1
8183,6374.0,16,was,4,3,14,11,2,1,1,10,Alec Douglas-Home,Conservative,-,org,PROPN-PROPN,PROPN,compound-nsubj,compound,NNP-NNP,NNP,8,1
8184,6375.0,29,befriended,1,3,24,21,2,4,-2,23,Wilson,Athens,org,,PROPN,PROPN,poss,pobj,NNP,NNP,5,1
8185,6376.0,84,is,2,11,14,3,10,69,-9,12,NCAA,Georgia State University,per,--,PROPN,PROPN-PROPN-PROPN,compound,compound-compound-pobj,NNP,NNP-NNP-NNP,-1,1
8186,6377.0,37,competed,5,2,12,10,1,24,3,7,Owls,Conference USA,,org-org,PROPN,PROPN-PROPN,nsubj,compound-conj,NNP,NNP-NNP,3,1
8187,6378.0,25,AL,5,5,11,6,4,13,0,6,Alabama,Marion Military Institute,org,--,PROPN,PROPN-PROPN-PROPN,compound,compound-compound-nsubj,NNP,NNP-NNP-NNP,-1,1
8188,6379.0,36,reached,4,11,34,23,10,1,-7,30,Public Schools,Solihull School,org-org,-,PROPN-PROPN,PROPN-PROPN,compound-poss,compound-pobj,NNP-NNPS,NNP-NNP,8,1
8189,6380.0,37,said,4,1,27,26,0,9,3,23,The Philippine Star,Philippines,org-org-org,,DET-PROPN-PROPN,PROPN,det-compound-compound,pobj,DT-NNP-NNP,NNP,7,1
8190,6381.0,43,studied,1,31,39,8,30,3,-30,38,Haas School of Business,California,org-org-org-org,,PROPN-PROPN-ADP-PROPN,PROPN,compound-pobj-prep-pobj,pobj,NNP-NNP-IN-NNP,NNP,2,1
8191,12877.0,34,is,12,6,29,23,5,4,6,17,Haas School of Business,California,---,per,PROPN-PROPN-ADP-PROPN,PROPN,compound-pobj-prep-pobj,poss,NNP-NNP-IN-NNP,NNP,12,1
8192,6382.0,26,merged,3,16,25,9,15,0,-13,22,Scottish and Southern Energy,1998,org-org-org-org,,ADJ-CCONJ-PROPN-PROPN,NUM,amod-cc-compound-conj,nummod,JJ-CC-NNP-NNP,CD,5,1
8193,6383.0,29,carried,12,23,23,0,22,5,-11,11,DnB NOR,DnB NORD,per-per,-,NOUN-CCONJ,PROPN-PROPN,compound-ROOT,compound-pobj,NN-CC,NNP-NNP,0,1
8194,6385.0,103,competed,2,10,32,22,9,70,-8,30,Michelle Bachelet,Health,org-org,,PROPN-PROPN,PROPN,compound-compound,pobj,NNP-NNP,NNP,5,1
8195,6387.0,22,appointed,14,2,9,7,1,12,12,-5,Thailand,Sanya Dharmasakti,,org-org,PROPN,PROPN-PROPN,poss,compound-pobj,NNP,NNP-NNP,5,1
8196,6389.0,28,consist,10,7,24,17,6,3,3,14,Highschool Football League,Pei Men,per-per-per,-,PROPN-PROPN-PROPN,PROPN-PROPN,compound-compound-pobj,compound-appos,NNP-NNP-NNP,NNP-NNPS,7,1
8197,6391.0,21,was,3,1,10,9,0,10,2,7,William Blount,Tennessee,per-per,,PROPN-PROPN,PROPN,compound-compound,poss,NNP-NNP,NNP,7,1
8198,6392.0,31,re-elected,2,1,17,16,0,13,1,15,Cotler,Quebec,per,,PROPN,PROPN,nsubjpass,pobj,NNP,NNP,7,1
8199,6394.0,15,was,3,2,11,9,1,3,1,8,1919,American Society of Cinematographers,per,---,NUM,PROPN-PROPN-ADP-PROPN,pobj,compound-pobj-prep-pobj,CD,NNP-NNP-IN-NNPS,6,1
8200,6396.0,42,became,5,25,40,15,24,1,-20,35,Rajai,prime minister,per,-,PROPN,ADJ-NOUN,nsubj,amod-attr,NNP,JJ-NN,7,1
8201,6397.0,34,attended,2,12,19,7,11,14,-10,17,Philadelphia,Charles Grafly,,per-per,PROPN,PROPN-PROPN,pobj,compound-pobj,NNP,NNP-NNP,4,1
8202,6398.0,23,disestablished,2,5,9,4,4,13,-3,7,Air Combat Command,ACC,--,per,PROPN-PROPN-PROPN,PROPN,compound-compound-nsubj,pobj,NNP-NNP-NNP,NNP,2,1
8203,6399.0,66,acts,40,9,17,8,8,48,31,-23,Canada,Deborah Cox,per,-,PROPN,PROPN-PROPN,nmod,compound-pobj,NNP,NNP-NNP,4,1
8204,6401.0,24,ordered,1,1,19,18,0,4,0,18,Indonesia,Indonesian Air Force,per,--,PROPN,PROPN-PROPN-PROPN,nsubj,compound-compound-dobj,NNP,NNP-NNP-NNP,6,1
8205,6402.0,25,Following,0,5,9,4,4,15,-5,9,she,EMI,,org,PRON,PROPN,nsubjpass,pobj,PRP,NNP,3,1
8206,6403.0,35,was,11,18,26,8,17,8,-7,15,United States,he,org-org,,PROPN-PROPN,PRON,compound-pobj,nsubj,NNP-NNP,PRP,4,1
8207,6404.0,17,defeated,11,5,15,10,4,1,6,4,Oregon,Gordon Smith,per,-,PROPN,PROPN-PROPN,poss,compound-dobj,NNP,NNP-NNP,6,1
8208,6407.0,37,considered,18,17,28,11,16,8,1,10,Igor,Spanish,,per,PROPN,ADJ,nsubj,amod,NNP,JJ,3,1
8209,6409.0,14,founded,3,2,8,6,1,5,1,5,1937,T. Rowe Price,org,--,NUM,PROPN-PROPN-PROPN,pobj,compound-compound-appos,CD,NNP-NNP-NNP,4,1
8210,6410.0,20,widowed,2,1,13,12,0,6,1,11,Theodore,Philippa of Armenia,per,--,PROPN,PROPN-ADP-PROPN,nsubjpass,pobj-prep-pobj,NNP,NNPS-IN-NNP,7,1
8211,6412.0,22,became,4,3,4,1,2,17,1,0,Ahmed,Guinea,,per,PROPN,PROPN,compound,pobj,NNP,NNP,2,1
8212,6413.0,26,is,7,1,17,16,0,8,6,10,Sir Peter Scott,Kingston University,--,per-per,PROPN-PROPN-PROPN,PROPN-PROPN,compound-compound-nsubj,compound-pobj,NNP-NNP-NNP,NNP-NNP,7,1
8213,6414.0,29,included,4,17,23,6,16,5,-13,19,Stevens Institute of Technology,NJ,per-per-per-per,,PROPN-PROPN-ADP-PROPN,PROPN,compound-conj-prep-pobj,pobj,NNP-NNP-IN-NNP,NNP,3,1
8214,7192.0,81,were,5,53,59,6,52,21,-48,54,Stevens Institute of Technology,NJ,per-per-per-per,,PROPN-PROPN-ADP-PROPN,PROPN,compound-pobj-prep-pobj,appos,NNP-NNP-IN-NNP,NNP,3,1
8215,6415.0,71,rush,35,45,48,3,44,22,-10,13,Martin Looney,New Haven,per-per,-,PROPN-PROPN,PROPN-PROPN,compound-pobj,compound-compound,NNP-NNP,NNP-NNP,2,1
8216,6416.0,25,attended,1,3,6,3,2,18,-2,5,Jubilee School,Amman,org-org,,PROPN-PROPN,PROPN,compound-dobj,pobj,NNP-NNP,NNP,3,1
8217,6418.0,26,Posted,21,6,19,13,5,6,15,-2,English Department Location,CT,--,org,PROPN-PROPN-PROPN,PROPN,compound-compound-appos,compound,NNP-NNP-NNP,NNP,5,1
8218,6419.0,27,is,11,1,19,18,0,7,10,8,Francis Scott Key High School,Union Bridge,org-org-org-org-org,-,PROPN-PROPN-PROPN-PROPN-PROPN,PROPN-PROPN,compound-compound-compound-compound-nsubj,compound-pobj,NNP-NNP-NNP-NNP-NNP,NNP-NNP,4,1
8219,6420.0,30,testified,7,1,5,4,0,24,6,-2,Peru,Jorge Del Castillo,org,--,PROPN,PROPN-PROPN-PROPN,poss,compound-compound-appos,NNP,NNP-NNP-NNP,5,1
8220,7697.0,24,appointed,14,19,21,2,18,2,-5,7,Peru,Jorge Del Castillo,,org-org-org,PROPN,PROPN-PROPN-PROPN,pobj,compound-compound-dobj,NNP,NNP-NNP-NNP,2,1
8221,6422.0,34,announced,8,11,15,4,10,18,-3,7,Nuclear Blast,Destruction,org-org,,PROPN-PROPN,PROPN,compound-compound,nsubj,NNP-NNP,NNP,5,1
8222,6423.0,31,replaced,19,1,30,29,0,0,18,11,PBS KIDS Sprout,2005,--,org,PROPN-PROPN-PROPN,NUM,compound-compound-pobj,nummod,NNP-NNP-NNP,CD,7,1
8223,6424.0,25,surrendered,15,5,14,9,4,10,10,-1,Black Hawk,British Band,-,org-org,PROPN-PROPN,PROPN-PROPN,compound-compound,compound-pobj,NNP-NNP,NNP-NNP,4,1
8224,6425.0,17,is,8,1,11,10,0,5,7,3,Lea DeLaria,American,per-per,,PROPN-PROPN,ADJ,compound-nsubj,amod,NNP-NNP,JJ,3,1
8225,6426.0,25,In,0,6,21,15,5,3,-6,21,her,American,org,,DET,ADJ,poss,amod,PRP$,JJ,10,1
8226,6427.0,24,took,16,6,15,9,5,8,10,-1,Switzerland,Swissair,,per,PROPN,PROPN,poss,appos,NNP,NNP,7,1
8227,6428.0,37,occurred,7,17,21,4,16,15,-10,14,Italy,Alcide De Gasperi,org,--,PROPN,PROPN-PROPN-PROPN,poss,compound-compound-appos,NNP,NNP-NNP-NNP,4,1
8228,12181.0,50,returned,1,12,19,7,11,30,-11,18,Italy,Alcide De Gasperi,,per-per-per,PROPN,PROPN-PROPN-PROPN,pobj,compound-compound-conj,NNP,NNP-NNP-NNP,5,1
8229,14052.0,17,opened,2,13,14,1,12,2,-11,12,Italy,Alcide De Gasperi,,per-per-per,PROPN,PROPN-PROPN-PROPN,pobj,compound-compound-pobj,NNP,NNP-NNP-NNP,2,1
8230,6429.0,23,is,2,1,20,19,0,2,1,18,Downend School,South Gloucestershire,org-org,-,PROPN-PROPN,PROPN-PROPN,compound-nsubj,compound-compound,NNP-NNP,NNP-NNP,8,1
8231,6432.0,13,is,1,5,11,6,4,1,-4,10,Megadeth,Nick Menza,per,-,PROPN,PROPN-PROPN,compound,compound-dobj,NNP,NNP-NNP,3,1
8232,6433.0,29,MILAN,0,3,26,23,2,2,-3,26,Italy,Mario Draghi,per,-,PROPN,PROPN-PROPN,nsubj,compound-nsubj,NNP,NNP-NNP,4,1
8233,6434.0,26,said,14,16,22,6,15,3,-2,8,Ajit Kumar Doval,India,--,org,PROPN-PROPN-PROPN,PROPN,compound-nmod-nmod,poss,NNP-NNP-NNP,NNP,6,1
8234,6436.0,18,plans,4,4,14,10,3,3,0,10,Fiat,Sergio Marchionne,per,-,PROPN,PROPN-PROPN,appos,compound-nsubj,NNP,NNP-NNP,4,1
8235,6437.0,17,said,7,4,16,12,3,0,3,9,Novo Nordisk,Denmark,-,per,PROPN-PROPN,PROPN,compound-compound,pobj,NNP-NNP,NNP,5,1
8236,6438.0,11,served,1,1,4,3,0,6,0,3,He,Omaha,org,,PRON,PROPN,nsubj,compound,PRP,NNP,2,1
8237,6439.0,37,requested,15,3,14,11,2,22,12,-1,Albanian,Enver Hoxha,,per-per,ADJ,PROPN-PROPN,amod,compound-pobj,JJ,NNP-NNP,7,1
8238,13017.0,17,houses,6,12,15,3,11,1,-6,9,Albanian,Enver Hoxha,org,-,ADJ,PROPN-PROPN,amod,compound-pobj,JJ,NNP-NNP,2,1
8239,6440.0,19,is,12,1,2,1,0,16,11,-10,Sondra,Blinky,per,,PROPN,PROPN,compound,compound,NNP,NNP,1,1
8240,6441.0,24,is,5,9,19,10,8,4,-4,14,New Mexico State University,Las Cruces,---,org-org,PROPN-PROPN-PROPN-PROPN,PROPN-PROPN,compound-compound-compound-poss,compound-compound,NNP-NNP-NNP-NNP,NNP-NNP,6,1
8241,9432.0,17,Mexico,15,9,13,4,8,3,6,-2,New Mexico State University,Las Cruces,---,org-org,PROPN-PROPN-PROPN-PROPN,PROPN-PROPN,compound-compound-compound-compound,compound-compound,NNP-NNP-NNP-NNP,NNP-NNP,3,1
8242,6442.0,13,been,2,8,12,4,7,0,-6,10,university,1973,per,,NOUN,NUM,poss,pobj,NN,CD,6,1
8243,6443.0,14,was,2,1,7,6,0,6,1,5,John Newman,Bayonne,-,per,PROPN-PROPN,PROPN,compound-nsubj,compound,NNP-NNP,NNP,5,1
8244,6445.0,52,begun,14,10,33,23,9,18,4,19,Nino Taranto,Italy,per-per,,PROPN-PROPN,PROPN,compound-pobj,pobj,NNP-NNP,NNP,5,1
8245,6447.0,18,is,4,14,4,-10,13,13,-10,0,Prime Minister,Golda Meir,per-per,-,PROPN-PROPN,PROPN-PROPN,compound-compound,compound-pobj,NNP-NNP,NNP-NNP,1,1
8246,6448.0,26,was,16,16,18,2,15,7,0,2,Smith,Southern Rhodesia,,per-per,PROPN,PROPN-PROPN,pobj,compound-poss,NNP,NNP-NNP,2,1
8247,6449.0,20,succeeded,4,2,17,15,1,2,2,13,Shinz Ab,f Japa,-,org-org,PROPN-PROPN,PROPN-PROPN,compound-compound,det-subtok,NNP-NNP,NNP-NNP,2,1
8248,6450.0,23,founded,1,13,20,7,12,2,-12,19,United States,RCA,per-per,,PROPN-PROPN,PROPN,compound-pobj,pobj,NNP-NNP,NNP,7,1
8249,6451.0,23,is,4,16,2,-14,15,20,-12,-2,musician,Joe Arroyo,,per-per,ADJ,PROPN-PROPN,amod,compound-pobj,JJ,NNP-NNP,7,1
8250,6452.0,30,was,11,1,15,14,0,14,10,4,John French Sloan,painter,per-per-per,,PROPN-PROPN-PROPN,NOUN,compound-amod-nsubj,attr,NNP-NNP-NNP,NN,4,1
8251,6453.0,16,is,1,1,10,9,0,5,0,9,She,Pakistan,,org,PRON,PROPN,nsubj,compound,PRP,NNP,9,1
8252,6454.0,30,left,12,5,10,5,4,19,7,-2,Pakistan,Bhutto,org,,PROPN,PROPN,compound,poss,NNP,NNP,6,1
8253,6455.0,32,Title,0,12,26,14,11,5,-12,26,Auburn University,United States,per-per,-,PROPN-PROPN,PROPN-PROPN,compound-compound,compound-nsubj,NNP-NNP,NNP-NNP,2,1
8254,7570.0,29,Title,0,11,23,12,10,5,-11,23,Auburn University,United States,-,org-org,PROPN-PROPN,PROPN-PROPN,compound-compound,compound-nsubj,NNP-NNP,NNP-NNP,3,1
8255,13297.0,40,was,1,22,27,5,21,12,-21,26,Auburn University,United States,org-org,-,PROPN-PROPN,PROPN-PROPN,compound-compound,compound-pobj,NNP-NNP,NNP-NNP,3,1
8256,6456.0,45,Institute,1,24,44,20,23,0,-23,43,Visvesvaraya National Institute of Technology,Nagpur,org-org-org-org-org,,PROPN-PROPN-PROPN-ADP-PROPN,PROPN,compound-compound-pobj-prep-pobj,pobj,NNP-NNP-NNP-IN-NNP,NNP,3,1
8257,6457.0,30,Title,0,14,23,9,13,6,-14,23,Iowa State University,IA,per-per-per,,PROPN-PROPN-PROPN,PROPN,compound-compound-compound,compound,NNP-NNP-NNP,NNP,6,1
8258,7315.0,31,_____________________,0,10,21,11,9,9,-10,21,Iowa State University,IA,--,org,PROPN-PROPN-PROPN,PROPN,nmod-compound-ROOT,dep,NNP-NNP-NNP,NNP,-1,1
8259,6458.0,17,is,2,1,10,9,0,6,1,8,Takashi Murakami,Japanese,org-org,,PROPN-PROPN,ADJ,compound-nsubj,amod,NNP-NNP,JJ,5,1
8260,6459.0,31,is,4,1,6,5,0,24,3,2,Eden Park Northern Lodge,NMIT,org-org-org-org,,PROPN-PROPN-PROPN-PROPN,PROPN,compound-compound-compound-nsubj,poss,NNP-NNP-NNP-NNP,NNP,5,1
8261,6460.0,25,included,3,5,13,8,4,11,-2,10,Mario Menocal,Cuba,-,per,PROPN-PROPN,PROPN,compound-dobj,pobj,NNP-NNP,NNP,5,1
8262,12898.0,22,placed,13,8,12,4,7,9,5,-1,Mario Menocal,Cuba,-,per,PROPN-PROPN,PROPN,compound-compound,pobj,NNP-NNP,NNP,4,1
8263,6461.0,23,lead,3,1,6,5,0,16,2,3,My Morning Jacket,Jim James,org-org-org,-,DET-PROPN-PROPN,PROPN-PROPN,poss-compound-nsubj,compound-nsubj,PRP$-NNP-NNP,NNP-NNP,4,1
8264,6463.0,38,is,12,11,18,7,10,19,1,6,England,The Jam,org,-,PROPN,DET-PROPN,pobj,det-pobj,NNP,DT-NNP,6,1
8265,6465.0,40,is,1,27,30,3,26,9,-26,29,Sam Brownback,Kansas,per-per,,PROPN-PROPN,PROPN,compound-pobj,compound,NNP-NNP,NNP,2,1
8266,6466.0,36,nominated,5,16,34,18,15,1,-11,29,she,Blake Edwards,per,-,PRON,PROPN-PROPN,nsubj,compound-pobj,PRP,NNP-NNP,10,1
8267,6467.0,32,sampled,6,1,4,3,0,27,5,-2,Miami,2 Live Crew,,org-org-org,PROPN,PUNCT-PROPN-PROPN,compound,nummod-compound-appos,NNP,",-NNP-NNP",3,1
8268,13629.0,30,is,9,2,6,4,1,23,7,-3,Miami,2 Live Crew,,org-org-org,PROPN,NUM-PROPN-PROPN,compound,nummod-compound-nsubj,NNP,CD-NNP-NNP,4,1
8269,6468.0,20,graduated,9,14,19,5,13,0,-5,10,North Carolina Central University,Durham,---,per,PROPN-PROPN-PROPN-PROPN,PROPN,compound-compound-compound-pobj,pobj,NNP-NNP-NNP-NNP,NNP,4,1
8270,6469.0,13,saw,4,1,6,5,0,6,3,2,Indonesia,him,org,,PROPN,PRON,poss,nsubj,NNP,PRP,4,1
8271,6470.0,45,remained,11,8,27,19,7,17,3,16,Joseph Biden,Wilmington,per-per,,PROPN-PROPN,PROPN,compound-compound,compound,NNP-NNP,NNP,6,1
8272,6471.0,34,was,2,7,15,8,6,18,-5,13,Silvio Berlusconi,People,per-per,,PROPN-PROPN,PROPN,compound-compound,conj,NNP-NNP,NNPS,5,1
8273,6472.0,8,formed,5,4,7,3,3,0,1,2,2004,BlueLithium,,per,NUM,PROPN,nummod,dobj,CD,NNP,2,1
8274,6473.0,35,said,15,22,30,8,21,4,-7,15,Hubert Humphrey,University of Minnesota,-,per-per-per,PROPN-PROPN,PROPN-ADP-PROPN,compound-compound,pobj-prep-pobj,NNP-NNP,NNP-IN-NNP,6,1
8275,6475.0,16,was,2,1,11,10,0,4,1,9,His,Ohio,per,,DET,PROPN,poss,pobj,PRP$,NNP,2,1
8276,6476.0,17,sworn,2,1,7,6,0,9,1,5,Ban Ki-moon,UN,org-org,,PROPN-PROPN,PROPN,compound-nsubj,compound,NNP-NNP,NNP,5,1
8277,6478.0,23,named,4,1,6,5,0,16,3,2,Brian C. Mitchell,Bucknell University,per-per-per,-,PROPN-PROPN-PROPN,PROPN-PROPN,compound-compound-nsubjpass,compound-compound,NNP-NNP-NNP,NNP-NNP,4,1
8278,6479.0,18,studied,1,1,17,16,0,0,0,16,He,Chile,,per,PRON,PROPN,nsubj,pobj,PRP,NNP,1,1
8279,8023.0,22,born,2,1,7,6,0,14,1,5,He,Chile,,org,PRON,PROPN,nsubjpass,pobj,PRP,NNP,5,1
8280,10168.0,20,was,1,1,15,14,0,4,0,14,He,Chile,org,,PRON,PROPN,nsubj,pobj,PRP,NNP,2,1
8281,6482.0,20,agreed,11,10,16,6,9,3,1,5,Blackstone Group,Weather Channel,org-org,-,PROPN-PROPN,PROPN-PROPN,compound-conj,compound-dobj,NNP-NNP,NNP-NNP,4,1
8282,6483.0,27,was,7,10,11,1,9,15,-3,4,Bobby Lashley,Lashley,per-per,,PROPN-PROPN,PROPN,compound-pobj,nsubj,NNP-NNP,NNP,1,1
8283,6484.0,49,known,5,4,9,5,3,39,1,4,Troy,University of Southern California,,per-per-per-per,PROPN,PROPN-ADP-PROPN-PROPN,pobj,pobj-prep-compound-pobj,NNP,NNP-IN-NNP-NNP,6,1
8284,6489.0,26,required,4,9,10,1,8,15,-5,6,Gatwick-based,Air Europe,per,-,PROPN,PROPN-PROPN,compound,compound-dobj,NNP,NNP-NNP,2,1
8285,6490.0,23,was,3,5,22,17,4,0,-2,19,Joseph Jenkins Roberts,Liberia,--,org,PROPN-PROPN-PROPN,PROPN,compound-compound-attr,pobj,NNP-NNP-NNP,NNP,3,1
8286,6491.0,32,questioned,2,5,25,20,4,6,-3,23,Blackstone,Peter G. Peterson,,per-per-per,PROPN,PROPN-PROPN-PROPN,poss,compound-compound-conj,NNP,NNP-NNP-NNP,6,1
8287,6493.0,33,produced,16,12,15,3,11,17,4,-1,Windham Hill,William Ackerman,per-per,-,PROPN-PROPN,PROPN-PROPN,compound-compound,compound-pobj,NNP-NNP,NNP-NNP,2,1
8288,6494.0,86,On,0,23,12,-11,22,73,-23,12,EMS Battalion Captain,Los Angeles Fire Department,--,per-per-per-per,PROPN-PROPN-PROPN,PROPN-PROPN-PROPN-PROPN,compound-compound-nmod,compound-compound-compound-compound,NNP-NNP-NNP,NNP-NNP-NNP-NNP,5,1
8289,6495.0,18,added,1,1,4,3,0,13,0,3,He,China,org,,PRON,PROPN,nsubj,nsubj,PRP,NNP,2,1
8290,6496.0,13,is,3,1,10,9,0,2,2,7,Edge Hill University,Ormskirk,org-org-org,,PROPN-PROPN-PROPN,PROPN,compound-compound-nsubj,compound,NNP-NNP-NNP,NNP,5,1
8291,6497.0,26,remain,2,4,23,19,3,2,-2,21,his,Jamaica,org,,DET,PROPN,poss,pobj,PRP$,NNP,3,1
8292,6498.0,28,filed,3,8,11,3,7,16,-5,8,Island Records,Wailers,per-per,,PROPN-PROPN,PROPN,compound-pobj,poss,NNP-NNPS,NNPS,6,1
8293,6499.0,42,found,22,13,21,8,12,20,9,-1,Triumph Motorcycles,Meriden,-,org,PROPN-PROPN,PROPN,compound-poss,pobj,NNP-NNP,NNP,4,1
8294,6500.0,37,went,1,1,22,21,0,14,0,21,She,England,per,,PRON,PROPN,nsubj,pobj,PRP,NNP,2,1
8295,6501.0,67,led,8,19,32,13,18,34,-11,24,IWF,Barbara Olson,,per-per,PROPN,PROPN-PROPN,appos,compound-compound,NNP,NNP-NNP,4,1
8296,6502.0,21,is,2,1,15,14,0,5,1,13,Dennis Publishing,Maxim,org-org,,PROPN-PROPN,PROPN,compound-pobj,compound,NNP-NNP,NNP,7,1
8297,10317.0,28,pursued,3,22,27,5,21,0,-19,24,Dennis Publishing,Maxim,-,org,PROPN-PROPN,PROPN,compound-pobj,appos,NNP-NNP,NNP,4,1
8298,6503.0,32,seen,5,2,24,22,1,7,3,19,her,Brazilian,,per,DET,ADJ,poss,amod,PRP$,JJ,9,1
8299,6504.0,15,is,1,1,14,13,0,0,0,13,He,Poland,per,,PRON,PROPN,nsubj,pobj,PRP,NNP,1,1
8300,6505.0,17,was,6,1,4,3,0,12,5,-2,Sky Movies,New Zealand,per-per,-,PROPN-PROPN,PROPN-PROPN,compound-nsubj,compound-appos,NNP-NNP,NNP-NNP,1,1
8301,6506.0,31,dropped,6,11,21,10,10,9,-5,15,Bohemia and Moravia,Reinhard Heydrich,per-per-per,-,PROPN-CCONJ-PROPN,PROPN-PROPN,pobj-cc-conj,compound-dobj,NNP-CC-NNP,NNP-NNP,6,1
8302,6508.0,15,is,10,1,9,8,0,5,9,-1,Marija Naumova,Latvia,org-org,,PROPN-PROPN,PROPN,compound-nsubj,pobj,NNP-NNP,NNP,2,1
8303,6509.0,22,signed,7,6,17,11,5,4,1,10,Islom Karimov,Uzbekistan,-,per,PROPN-PROPN,PROPN,compound-nsubj,pobj,NNP-NNP,NNP,4,1
8304,6510.0,41,reduced,25,10,23,13,9,17,15,-2,Colombia,Olaya Herrera,per,-,PROPN,PROPN-PROPN,pobj,compound-conj,NNP,NNP-NNP,7,1
8305,6511.0,32,honored,12,1,7,6,0,24,11,-5,Arabian Business,ITP Publishing Group,-,org-org-org,PROPN-PROPN,PROPN-PROPN-PROPN,compound-compound,compound-compound-pobj,NNP-NNP,NNP-NNP-NNP,5,1
8306,6513.0,34,said,11,4,25,21,3,8,7,14,Canada,Brian Mulroney,,org-org,PROPN,PROPN-PROPN,poss,compound-pobj,NNP,NNP-NNP,13,1
8307,7302.0,25,affected,4,6,23,17,5,1,-2,19,Canada,Brian Mulroney,,org-org,PROPN,PROPN-PROPN,dobj,compound-pobj,NNP,NNP-NNP,5,1
8308,9696.0,19,introduced,10,9,17,8,8,1,1,7,Canada,Brian Mulroney,,org-org,PROPN,PROPN-PROPN,pobj,compound-pobj,NNP,NNP-NNP,3,1
8309,6514.0,27,released,5,16,22,6,15,4,-11,17,Shady,Stat Quo,per,-,PROPN,PROPN-PROPN,compound,compound-compound,NNP,NNP-NNP,5,1
8310,6515.0,30,run,5,4,10,6,3,19,1,5,Berkshire Hathaway,Warren E. Buffett,per-per,--,PROPN-PROPN,PROPN-PROPN-PROPN,compound-nsubj,compound-compound-pobj,NNP-NNP,NNP-NNP-NNP,4,1
8311,6517.0,25,Young,2,15,20,5,14,4,-13,18,Dr. Dre,record producer,-,org-org,PROPN-PROPN,NOUN-NOUN,compound-nsubj,compound-compound,NNP-NNP,NN-NN,3,1
8312,6519.0,46,served,10,1,17,16,0,28,9,7,Agostinho Neto,Angola,per-per,,PROPN-PROPN,PROPN,compound-nsubj,pobj,NNP-NNP,NNP,6,1
8313,9850.0,51,stressed,1,34,43,9,33,7,-33,42,Agostinho Neto,Angola,per-per,,PROPN-PROPN,PROPN,compound-appos,pobj,NNP-NNP,NNP,9,1
8314,6520.0,40,is,9,1,2,1,0,37,8,-7,Larry Graham,Graham,-,per,PROPN-PROPN,PROPN,compound-compound,compound,NNP-NNP,NNP,1,1
8315,6521.0,28,served,6,13,25,12,12,2,-7,19,Alberta,Peter Lougheed,,org-org,PROPN,PROPN-PROPN,pobj,compound-compound,NNP,NNP-NNP,4,1
8316,6522.0,27,broke,4,21,25,4,20,1,-17,21,Ahmed Ben Bella,FLN,org-org-org,,PROPN-PROPN-PROPN,PROPN,compound-compound-poss,compound,NNP-NNP-NNP,NNP,2,1
8317,6523.0,31,announced,4,3,3,0,2,27,1,-1,Cox Enterprises,Cox Communications,per-per,-,PROPN-PROPN,PROPN-PROPN,compound-nsubj,compound-appos,NNP-NNP,NNP-NNP,0,1
8318,6524.0,32,is,9,5,17,12,4,14,4,8,TDE,Ulrich Kiesow,,org-org,PROPN,PROPN-PROPN,appos,compound-pobj,NNP,NNP-NNP,7,1
8319,6525.0,20,developed,12,8,8,0,7,11,4,-4,Osaka,Osaka University,,per-per,PROPN,PROPN-PROPN,compound,compound-pobj,NNP,NNP-NNP,0,1
8320,10772.0,20,elected,12,5,5,0,4,14,7,-7,Osaka,Osaka University,per,-,PROPN,PROPN-PROPN,pobj,compound-pobj,NNP,NNP-NNP,0,1
8321,6526.0,23,was,1,17,21,4,16,1,-16,20,he,Capitol Records,,per-per,PRON,PROPN-PROPN,nsubj,compound-pobj,PRP,NNP-NNPS,3,1
8322,6527.0,36,situated,13,4,30,26,3,5,9,17,Vancouver,Joyce Murray,,per-per,PROPN,PROPN-PROPN,compound,compound-pobj,NNP,NNP-NNP,8,1
8323,6529.0,39,became,5,5,10,5,4,28,0,5,Blair,British,,org,PROPN,ADJ,nsubj,amod,NNP,JJ,2,1
8324,6530.0,17,won,4,13,15,2,12,1,-9,11,film director,Lee Tamahori,per-per,-,NOUN-NOUN,PROPN-PROPN,compound-compound,compound-pobj,NN-NN,NNP-NNP,1,1
8325,6531.0,30,called,1,7,14,7,6,15,-6,13,United Arab Emirates,Khalifa bin Zayed Al Nahyan,org-org-org,----,PROPN-PROPN-PROPN,PROPN-PROPN-PROPN-PROPN-PROPN,compound-compound-pobj,compound-compound-compound-compound-ROOT,NNP-NNP-NNPS,NNP-NNP-NNP-NNP-NNP,3,1
8326,9713.0,39,said,13,1,9,8,0,29,12,-4,United Arab Emirates,Khalifa bin Zayed Al Nahyan,--,org-org-org-org-org,PROPN-PROPN-PROPN,PROPN-PROPN-PROPN-PROPN-PROPN,compound-compound-nsubj,compound-compound-compound-compound-appos,NNP-NNP-NNPS,NNP-NNP-NNP-NNP-NNP,3,1
8327,10115.0,41,won,5,18,33,15,17,7,-13,28,United Arab Emirates,Khalifa bin Zayed Al Nahyan,--,org-org-org-org-org,PROPN-PROPN-PROPN,PROPN-PROPN-PROPN-PROPN-PROPN,compound-compound-pobj,compound-compound-compound-compound-conj,NNP-NNP-NNP,NNP-NNP-NNP-NNP-NNP,9,1
8328,12065.0,27,brother,2,17,22,5,16,4,-15,20,United Arab Emirates,Khalifa bin Zayed Al Nahyan,per-per-per,----,PROPN-PROPN-PROPN,PROPN-PROPN-PROPN-PROPN-PROPN,compound-compound-compound,compound-compound-compound-compound-appos,NNP-NNP-NNPS,NNP-NNP-NNP-NNP-NNP,4,1
8329,6532.0,22,appeared,1,4,14,10,3,7,-3,13,Bridget Pastoor,Alberta,per-per,,PROPN-PROPN,PROPN,compound-pobj,compound,NNP-NNP,NNP,7,1
8330,6533.0,41,established,1,16,27,11,15,13,-15,26,P. V. Narasimha Rao,India,---,per,PROPN-PROPN-PROPN-PROPN,PROPN,compound-compound-compound-appos,pobj,NNP-NNP-NNP-NNP,NNP,5,1
8331,6534.0,42,upheld,13,10,18,8,9,23,3,5,Minnesota,Chaudhary,,org,PROPN,PROPN,compound,poss,NNP,NNP,9,1
8332,6535.0,28,was,1,8,24,16,7,3,-7,23,Fuad I of Egypt,Nazli Sabri,per-per-per-per,-,PROPN-PRON-ADP-PROPN,PROPN-PROPN,compound-pobj-prep-pobj,compound-appos,NNP-PRP-IN-NNP,NNP-NNP,5,1
8333,6539.0,18,spent,5,10,13,3,9,4,-5,8,Converse College,Spartanburg,org-org,,PROPN-PROPN,PROPN,compound-pobj,compound,NNP-NNP,NNP,2,1
8334,6540.0,36,has,5,23,31,8,22,4,-18,26,George M. Robeson,Navy,per-per-per,,PROPN-PROPN-PROPN,PROPN,compound-compound-compound,pobj,NNP-NNP-NNP,NNP,5,1
8335,6542.0,76,had,41,7,15,8,6,60,34,-26,Consul,Lucius Cornelius Sulla,org,--,PROPN,PROPN-PROPN-PROPN,compound,compound-compound-nsubjpass,NNP,NNP-NNP-NNP,7,1
8336,6545.0,26,was,5,7,22,15,6,3,-2,17,Major James Van Fleet,Florida Gators,org-org-org-org,-,PROPN-PROPN-PROPN-PROPN,PROPN-PROPN,compound-compound-compound-poss,compound-compound,NNP-NNP-NNP-NNP,NNP-NNP,7,1
8337,6546.0,26,founded,20,1,22,21,0,3,19,2,Jay Adelson,Revision3,-,per,PROPN-PROPN,PROPN,compound-nsubj,dobj,NNP-NNP,NNP,1,1
8338,6548.0,24,became,1,6,17,11,5,6,-5,16,Andrew Fisher,Labor,per-per,,PROPN-PROPN,PROPN,compound-nsubj,compound,NNP-NNP,NNP,5,1
8339,6549.0,27,began,1,14,19,5,13,7,-13,18,Winnipeg,Brad Roberts,per,-,PROPN,PROPN-PROPN,pobj,compound-appos,NNP,NNP-NNP,2,1
8340,6550.0,46,was,15,8,28,20,7,17,7,13,Indiana,Benjamin Harrison,,per-per,PROPN,PROPN-PROPN,appos,compound-pobj,NNP,NNP-NNP,7,1
8341,6552.0,34,started,19,18,26,8,17,7,1,7,British Airways,OpenSkies,-,per,PROPN-PROPN,PROPN,compound-nsubj,oprd,NNP-NNPS,NNP,3,1
8342,6555.0,49,supported,3,29,1,-28,28,47,-26,-2,Johnny O'keefe,The Dee Jays,org-org,--,PROPN-PROPN,DET-PROPN-PROPN,conj-amod,det-compound-nsubj,NNP-NNP,DT-NNP-NNPS,4,1
8343,6556.0,34,is,3,24,32,8,23,1,-21,29,Albania,Fatos Nano,per,-,PROPN,PROPN-PROPN,pobj,compound-pobj,NNP,NNP-NNP,2,1
8344,6557.0,16,set,7,3,4,1,2,11,4,-3,Land Rover,Rover Company,per-per,-,PROPN-PROPN,PROPN-PROPN,compound-compound,compound-pobj,NNP-NNP,NNP-NNP,2,1
8345,6558.0,39,said,1,4,14,10,3,24,-3,13,ministry,NPA,per,,NOUN,PROPN,nsubj,poss,NN,NNP,5,1
8346,6560.0,36,was,1,16,31,15,15,4,-15,30,GMM Grammy,Hub Ho Hin,per-per,--,PROPN-PROPN,PROPN-PROPN-PROPN,compound-poss,compound-compound-compound,NNP-NNP,NNP-NNP-NNP,2,1
8347,6562.0,18,interviewed,12,8,10,2,7,7,4,-2,Enron,Kenneth Lay,per,-,PROPN,PROPN-PROPN,compound,compound-nsubjpass,NNP,NNP-NNP,3,1
8348,6563.0,21,was,13,1,20,19,0,0,12,7,Harold Godwinson,England,org-org,,PROPN-PROPN,PROPN,compound-nsubj,pobj,NNP-NNP,NNP,3,1
8349,9730.0,41,be,8,13,20,7,12,20,-5,12,Harold Godwinson,England,per-per,,PROPN-PROPN,PROPN,compound-pobj,pobj,NNP-NNP,NNP,4,1
8350,6566.0,15,worked,2,5,6,1,4,8,-3,4,director,Philip Kaufman,per,-,NOUN,PROPN-PROPN,compound,compound-pobj,NN,NNP-NNP,1,1
8351,6567.0,16,is,8,1,11,10,0,4,7,3,Karen Kilimnik,American,-,per,PROPN-PROPN,ADJ,compound-nsubj,amod,NNP-NNP,JJ,2,1
8352,6568.0,30,was,5,5,10,5,4,19,0,5,Bethpage,Grumman,per,,PROPN,PROPN,nsubj,compound,NNP,NNP,5,1
8353,6569.0,17,graduated,1,9,14,5,8,2,-8,13,MO,Missouri State University,per,--,PROPN,PROPN-PROPN-PROPN,pobj,compound-compound-dobj,NNP,NNP-NNP-NNP,4,1
8354,6571.0,35,In,0,14,20,6,13,14,-14,20,Enya,Clannad,,per,PROPN,PROPN,compound,appos,NNP,NNP,8,1
8355,6572.0,15,born,2,7,13,6,6,1,-5,11,Canada,Ken Danby,per,-,PROPN,PROPN-PROPN,pobj,compound-pobj,NNP,NNP-NNP,3,1
8356,6573.0,18,is,8,1,15,14,0,2,7,7,Central Mindanao University,Maramag,per-per-per,,PROPN-PROPN-PROPN,PROPN,compound-compound-compound,compound,NNP-NNP-NNP,NNP,7,1
8357,6574.0,21,caught,2,12,15,3,11,5,-10,13,Cudi,GOOD Music,,per-per,PROPN,ADJ-PROPN,dobj,compound-compound,NNP,JJ-NNP,2,1
8358,6576.0,25,served,3,11,21,10,10,3,-8,18,Medco Health Solutions,Franklin Lakes,--,per-per,PROPN-PROPN-PROPN,PROPN-PROPN,compound-compound-pobj,compound-compound,NNP-NNP-NNPS,NNP-NNP,8,1
8359,6578.0,46,said,12,8,11,3,7,34,4,-1,Haikou,Hainan Airlines,per,-,PROPN,PROPN-PROPN,compound,compound-compound,NNP,NNP-NNPS,2,1
8360,6580.0,20,is,1,1,12,11,0,7,0,11,He,French Polynesia,per,-,PRON,PROPN-PROPN,nsubj,compound-poss,PRP,NNP-NNP,5,1
8361,6581.0,13,played,2,6,5,-1,5,7,-4,3,Stingers,Concordia University,org,-,PROPN,PROPN-PROPN,pobj,compound-pobj,NNPS,NNP-NNP,1,1
8362,6582.0,24,displayed,7,12,18,6,11,5,-5,11,England,Harringay Racers,,per-per,PROPN,PROPN-PROPN,pobj,compound-pobj,NNP,NNP-NNPS,5,1
8363,6583.0,14,was,2,1,8,7,0,5,1,6,Henry Campbell-Bannerman,United Kingdom,per-per,-,PROPN-PROPN,PROPN-PROPN,compound-nsubj,compound-pobj,NNP-NNP,NNP-NNP,6,1
8364,6585.0,22,is,3,1,12,11,0,9,2,9,Yellow Rat Bastard,New York,--,org-org,PROPN-PROPN-PROPN,PROPN-PROPN,compound-compound-nsubj,compound-nmod,NNP-NNP-NNP,NNP-NNP,9,1
8365,6586.0,21,was,8,6,7,1,5,13,2,-1,State,Robert Lansing,,org-org,PROPN,PROPN-PROPN,pobj,compound-nsubj,NNP,NNP-NNP,1,1
8366,6587.0,38,moved,16,10,21,11,9,16,6,5,Gene Hawkins,she,-,per,PROPN-PROPN,PRON,compound-appos,nsubj,NNP-NNP,PRP,4,1
8367,6588.0,32,called,2,19,6,-13,18,25,-17,4,1886,Federation of Organized Trades and Labor Unions,per,------,NUM,PROPN-ADP-PROPN-PROPN-CCONJ-PROPN-PROPN,pobj,appos-prep-compound-pobj-cc-compound-conj,CD,NNP-IN-NNP-NNPS-CC-NNP-NNPS,5,1
8368,6589.0,48,started,1,5,28,23,4,19,-4,27,New York,Martin Landau,-,per-per,PROPN-PROPN,PROPN-PROPN,compound-pobj,compound-appos,NNP-NNP,NNP-NNP,11,1
8369,6590.0,22,play,2,6,18,12,5,3,-4,16,Serbian League West,Serbia,--,per,PROPN-PROPN-PROPN,PROPN,compound-compound-pobj,poss,NNP-NNP-NNP,NNP,6,1
8370,6591.0,31,is,1,1,9,8,0,21,0,8,Williamsport,Pennsylvania College of Technology,,org-org-org-org,PROPN,PROPN-PROPN-ADP-PROPN,nsubj,compound-conj-prep-pobj,NNP,NNP-NNP-IN-NNP,4,1
8371,6592.0,27,joined,4,14,22,8,13,4,-10,18,Canada,Matt Mays,org,-,PROPN,PROPN-PROPN,pobj,compound-appos,NNP,NNP-NNP,4,1
8372,6593.0,25,see,4,14,17,3,13,7,-10,13,Starr,Apple,per,,PROPN,PROPN,poss,compound,NNP,NNP,4,1
8373,6595.0,45,was,9,1,21,20,0,23,8,12,Gyula,Council,per,,NOUN,PROPN,nsubj,pobj,NN,NNP,10,1
8374,6596.0,29,emigrated,3,12,24,12,11,4,-9,21,Pittsburgh,his,,per,PROPN,DET,pobj,poss,NNP,PRP$,7,1
8375,6597.0,56,attended,41,3,15,12,2,40,38,-26,UTS,University of Toronto,org,--,PROPN,PROPN-ADP-PROPN,compound,nmod-prep-pobj,NNP,NNP-IN-NNP,6,1
8376,10292.0,22,became,3,3,10,7,2,11,0,7,UTS,University of Toronto,per,--,PROPN,PROPN-ADP-PROPN,nsubj,pobj-prep-pobj,NNP,NNP-IN-NNP,4,1
8377,6599.0,14,played,2,2,12,10,1,1,0,10,Commodores,Nashville,,org,PROPN,PROPN,nsubj,compound,NNPS,NNP,5,1
8378,6600.0,13,is,2,1,1,0,0,11,1,-1,York College,York,org-org,,PROPN-PROPN,PROPN,compound-nsubj,compound,NNP-NNP,NNP,0,1
8379,9697.0,27,is,2,1,1,0,0,25,1,-1,York College,York,per-per,,PROPN-PROPN,PROPN,compound-nsubj,compound,NNP-NNP,NNP,0,1
8380,6601.0,34,went,14,14,20,6,13,13,0,6,Polk,Tennessee,,per,PROPN,PROPN,nsubj,compound,NNP,NNP,4,1
8381,12009.0,30,is,1,12,28,16,11,1,-11,27,Polk,Tennessee,,per,PROPN,PROPN,appos,appos,NNP,NNP,3,1
8382,6602.0,22,founded,4,9,20,11,8,1,-5,16,Jack Friedman,Jakks Pacific,org-org,-,PROPN-PROPN,PROPN-PROPN,compound-pobj,compound-conj,NNP-NNP,NNP-NNP,3,1
8383,6603.0,13,held,4,7,11,4,6,1,-3,7,Lakeview High School,September 1975,per-per-per,-,PROPN-PROPN-PROPN,PROPN-NUM,compound-compound-pobj,pobj-nummod,NNP-NNP-NNP,NNP-CD,6,1
8384,6604.0,31,come,2,5,7,2,4,23,-3,5,Prime Minister,Abdullah Ahmad Badawi,per-per,--,PROPN-PROPN,PROPN-PROPN-PROPN,compound-compound,compound-compound-nsubj,NNP-NNP,NNP-NNP-NNP,3,1
8385,8622.0,49,pose,1,18,21,3,17,27,-17,20,Prime Minister,Abdullah Ahmad Badawi,-,org-org-org,PROPN-PROPN,PROPN-PROPN-PROPN,compound-compound,compound-compound-conj,NNP-NNP,NNP-NNP-NNP,3,1
8386,6606.0,13,is,4,1,11,10,0,1,3,7,Atran,Moscow,,per,ADJ,PROPN,compound,compound,JJ,NNP,5,1
8387,6607.0,31,is,8,21,29,8,20,1,-13,21,Brandi Carlile,Columbia,per-per,,PROPN-PROPN,PROPN,compound-appos,compound,NNP-NNP,NNP,5,1
8388,6608.0,26,made,3,3,12,9,2,13,0,9,Walker,Columbia,,org,PROPN,PROPN,nsubj,compound,NNP,NNP,4,1
8389,6609.0,11,Telefonica,1,7,9,2,6,1,-6,8,Vivo,Portugal Telecom,,org-org,PROPN,PROPN-PROPN,dobj,compound-pobj,NNP,NNP-NNP,1,1
8390,6610.0,38,is,2,9,1,-8,8,36,-7,-1,Darlington F.C.,The Quakers,per-per,-,PROPN-PROPN,DET-PROPN,compound-appos,det-pobj,NNP-NNP,DT-NNP,5,1
8391,6611.0,16,says,2,1,10,9,0,5,1,8,General Motors,Hummer,per-per,,PROPN-PROPN,PROPN,compound-nsubj,compound,NNP-NNP,NNP,4,1
8392,6612.0,30,debuted,3,11,19,8,10,10,-8,16,Raf Vallone,Italy,-,per,PROPN-PROPN,PROPN,compound-pobj,pobj,NNP-NNP,NNP,2,1
8393,6613.0,32,was,1,12,3,-9,11,28,-11,2,TelstraClear,New Zealand,org,-,PROPN,PROPN-PROPN,conj,compound-pobj,NNP,NNP-NNP,4,1
8394,6614.0,28,is,1,1,11,10,0,16,0,10,Haley,South Carolina,per,-,PROPN,PROPN-PROPN,nsubj,compound-pobj,NNP,NNP-NNP,6,1
8395,8986.0,22,represented,7,7,13,6,6,8,0,6,Haley,South Carolina,org,-,PROPN,PROPN-PROPN,pobj,compound-compound,NNP,NNP-NNP,3,1
8396,6615.0,8,Benkiser,6,3,6,3,2,1,3,0,Republican Party,Tina Benkiser,-,per-per,PROPN-PROPN,PROPN-PROPN,compound-compound,compound-ROOT,NNP-NNP,NNP-NNP,2,1
8397,6616.0,26,represented,10,4,21,17,3,4,6,11,Florida Gulf Coast University,Division I,org-org-org-org,-,PROPN-PROPN-PROPN-PROPN,PROPN-PRON,compound-compound-compound-dobj,pobj-nsubj,NNP-NNP-NNP-NNP,NNP-PRP,5,1
8398,6617.0,16,assassinated,10,1,8,7,0,7,9,-2,Solomon Bandaranaike,Sri Lanka,-,per-per,PROPN-PROPN,PROPN-PROPN,compound-nsubj,compound-pobj,NNP-NNP,NNP-NNP,3,1
8399,6618.0,34,handpicked,3,3,28,25,2,5,0,25,Letterman,Worldwide Pants Incorporated,,org-org-org,PROPN,PROPN-PROPN-PROPN,poss,compound-compound-pobj,NNP,NNP-NNPS-NNP,6,1
8400,6619.0,28,In,0,3,12,9,2,15,-3,12,Marvel Comics,Roberto Aguirre-Sacasa,-,per-per,PROPN-PROPN,PROPN-PROPN,compound-poss,compound-nsubj,NNP-NNPS,NNP-NNP,2,1
8401,6620.0,23,is,1,10,22,12,9,0,-9,21,MxPx,Washington,per,,PROPN,PROPN,pobj,pobj,NNP,NNP,5,1
8402,6622.0,36,Institute,8,2,4,2,1,31,6,-4,University of Alberta Hospital,Alberta,---,org,PROPN-ADP-PROPN-PROPN,PROPN,nmod-prep-pobj-compound,compound,NNP-IN-NNP-NNP,NNP,2,1
8403,6623.0,32,told,8,6,26,20,5,5,2,18,Sonthi Boonyaratglin,Prime Minister,per-per,-,PROPN-PROPN,PROPN-PROPN,compound-appos,compound-compound,NNP-NNP,NNP-NNP,10,1
8404,6624.0,15,renamed,6,3,5,2,2,9,3,-1,The Walt Disney Company,Disney Interactive Studios,---,per-per-per,DET-PROPN-PROPN-PROPN,PROPN-PROPN-NOUN,det-compound-compound-nsubj,compound-compound-pobj,DT-NNP-NNP-NNP,NNP-NNP-NNS,1,1
8405,6625.0,30,located,18,2,5,3,1,24,16,-13,Islamia University,Bahawalpur,org-org,,PROPN-PROPN,PROPN,compound-nsubjpass,pobj,NNP-NNP,NNP,2,1
8406,6626.0,22,moved,8,12,15,3,11,6,-4,7,Western Australia,Jon,-,per,PROPN-PROPN,PROPN,compound-pobj,dobj,NNP-NNP,NNP,4,1
8407,6627.0,27,was,6,5,26,21,4,0,1,20,Jackson Beardy,Canada,-,per,PROPN-PROPN,PROPN,compound-nsubj,appos,NNP-NNP,NNP,4,1
8408,6629.0,37,hailed,2,23,35,12,22,1,-21,33,American,James Madison,,per-per,PROPN,PROPN-PROPN,compound,compound-pobj,NNP,NNP-NNP,8,1
8409,6630.0,33,launched,7,24,31,7,23,1,-17,24,Republic Airways Holdings,Chautauqua Airlines,org-org-org,-,PROPN-PROPN-PROPN,PROPN-PROPN,compound-compound-pobj,compound-pobj,NNP-NNP-NNPS,NNP-NNPS,4,1
8410,6631.0,28,filmed,5,3,22,19,2,5,2,17,Jackson,US,,org,PROPN,PROPN,nsubj,nmod,NNP,NNP,8,1
8411,6633.0,33,ensured,18,5,11,6,4,21,13,-7,Civil Aviation Authority of Singapore,CAAS,----,per,PROPN-PROPN-PROPN-ADP-PROPN,PROPN,compound-compound-pobj-prep-pobj,appos,NNP-NNP-NNP-IN-NNP,NNP,5,1
8412,6634.0,22,Medal,2,9,16,7,8,5,-7,14,New York,School of Visual Arts,per-per,---,PROPN-PROPN,PROPN-ADP-PROPN-PROPN,compound-compound,conj-prep-compound-compound,NNP-NNP,NNP-IN-NNP-NNP,3,1
8413,6635.0,80,adapted,7,40,53,13,39,26,-33,46,TX,Houston Cougars,per,-,PROPN,PROPN-PROPN,pobj,compound-conj,NNP,NNP-NNPS,-1,1
8414,6636.0,33,was,1,10,27,17,9,5,-9,26,West Chester,Jess Margera,per-per,-,PROPN-PROPN,PROPN-PROPN,compound-compound,compound-dobj,NNP-NNP,NNP-NNP,7,1
8415,6637.0,20,expanded,2,8,17,9,7,2,-6,15,1948,Western European Union,,per-per-per,NUM,PROPN-PROPN-PROPN,pobj,amod-compound-dobj,CD,NNP-NNP-NNP,4,1
8416,6640.0,39,commissioned,20,10,18,8,9,20,10,-2,Rome,Raphael,org,,PROPN,PROPN,pobj,nsubjpass,NNP,NNP,5,1
8417,6641.0,31,acquired,8,15,26,11,14,4,-7,18,TW,company,org,,PROPN,NOUN,compound,dobj,NNP,NN,6,1
8418,6642.0,40,founded,4,1,8,7,0,31,3,4,West Buckland School,Devon,per-per-per,,PROPN-PROPN-PROPN,PROPN,compound-compound-nsubjpass,compound,NNP-NNP-NNP,NNP,5,1
8419,6643.0,23,is,11,11,18,7,10,4,0,7,California,Health,,org,PROPN,PROPN,pobj,nmod,NNP,NNP,5,1
8420,6645.0,13,sought,1,1,10,9,0,2,0,9,Patrick,California,,per,PROPN,PROPN,nsubj,pobj,NNP,NNP,1,1
8421,6646.0,22,signed,1,1,17,16,0,4,0,16,Talbot,UK,,org,NOUN,PROPN,nsubj,pobj,NN,NNP,2,1
8422,6647.0,23,went,1,11,12,1,10,10,-10,11,Melton,Mowbray College,per,-,PROPN,PROPN-PROPN,compound,compound-pobj,NNP,NNP-NNP,3,1
8423,6648.0,32,was,4,10,30,20,9,1,-6,26,Switzerland,Commerce.Kreis,per,,PROPN,PROPN,pobj,pobj,NNP,NNP,8,1
8424,6649.0,44,was,2,1,11,10,0,32,1,9,Dynamix,1984,per,,PROPN,NUM,compound,pobj,NNP,CD,4,1
8425,6650.0,13,chosen,3,2,10,8,1,2,1,7,Hagen,United States,,org-org,PROPN,PROPN-PROPN,nsubjpass,compound-compound,NNP,NNP-NNP,6,1
8426,6651.0,27,bought,4,3,24,21,2,2,1,20,DHL,ASTAR Air Cargo,org,--,PROPN,PROPN-PROPN-PROPN,compound,compound-compound-pobj,NNP,NNP-NNP-NNP,7,1
8427,13855.0,31,Ohio,1,4,18,14,3,12,-3,17,DHL,ASTAR Air Cargo,,per-per-per,VERB,PROPN-PROPN-PROPN,appos,compound-compound-pobj,VB,NNP-NNP-NNP,7,1
8428,6652.0,35,was,3,1,24,23,0,10,2,21,Sha Tin Station,MTR,org-org-org,,PROPN-PROPN-PROPN,PROPN,compound-compound-nsubj,pobj,NNP-NNP-NNP,NNP,7,1
8429,6654.0,12,meets,6,4,5,1,3,6,2,-1,President,Tarja Halonen,,org-org,PROPN,PROPN-PROPN,compound,compound-nsubj,NNP,NNP-NNP,1,1
8430,6656.0,28,is,7,17,4,-13,16,23,-10,-3,U2,the Edge,,per-per,PROPN,DET-PROPN,poss,det-pobj,NNP,DT-NNP,10,1
8431,6657.0,28,was,10,2,9,7,1,18,8,-1,National Brotherhood of Workers of America,NBWA,-----,org,PROPN-PROPN-ADP-PROPN-ADP-PROPN,PROPN,compound-nsubj-prep-pobj-prep-pobj,appos,NNP-NNP-IN-NNPS-IN-NNP,NNP,1,1
8432,6658.0,24,warming,7,12,16,4,11,7,-5,9,Peru,Alberto Fujimori,per,-,PROPN,PROPN-PROPN,poss,compound-appos,NNP,NNP-NNP,3,1
8433,11153.0,31,leads,4,12,20,8,11,10,-8,16,Peru,Alberto Fujimori,per,-,PROPN,PROPN-PROPN,poss,compound-poss,NNP,NNP-NNP,7,1
8434,11294.0,15,extended,1,9,13,4,8,1,-8,12,Peru,Alberto Fujimori,,org-org,PROPN,PROPN-PROPN,poss,compound-appos,NNP,NNP-NNP,2,1
8435,12801.0,14,rejects,2,4,10,6,3,3,-2,8,Peru,Alberto Fujimori,org,-,PROPN,PROPN-PROPN,poss,compound-poss,NNP,NNP-NNP,5,1
8436,13795.0,19,says,4,1,17,16,0,1,3,13,Peru,Alberto Fujimori,per,-,PROPN,PROPN-PROPN,poss,compound-pobj,NNP,NNP-NNP,8,1
8437,6659.0,20,was,2,1,10,9,0,9,1,8,Gilbert Collins,New Jersey,-,org-org,PROPN-PROPN,PROPN-PROPN,compound-nsubj,compound-pobj,NNP-NNP,NNP-NNP,3,1
8438,6660.0,19,FABRAP,0,1,6,5,0,12,-1,6,FABRAP,Rothschild,org,,PROPN,PROPN,ROOT,nsubj,NNP,NNP,3,1
8439,6661.0,25,declined,2,1,13,12,0,11,1,11,Jim Talent,Missouri,per-per,,PROPN-PROPN,PROPN,compound-nsubj,compound,NNP-NNP,NNP,5,1
8440,7339.0,53,sign,9,23,26,3,22,26,-14,17,Jim Talent,Missouri,per-per,,PROPN-PROPN,PROPN,compound-conj,compound,NNP-NNP,NNP,5,1
8441,12634.0,20,worked,5,12,19,7,11,0,-7,14,Jim Talent,Missouri,per-per,,PROPN-PROPN,PROPN,compound-pobj,pobj,NNP-NNP,NNP,5,1
8442,6662.0,75,returned,1,37,49,12,36,25,-36,48,Greece,Xenophon Zolotas,org,-,PROPN,PROPN-PROPN,pobj,compound-pobj,NNP,NNP-NNP,8,1
8443,6663.0,35,joined,18,1,9,8,0,25,17,-9,August,The Edge,org,-,PROPN,DET-PROPN,compound,det-compound,NNP,DT-NNP,5,1
8444,6664.0,28,produced,2,1,10,9,0,17,1,8,William Conrad,Los Angeles,per-per,-,PROPN-PROPN,PROPN-PROPN,compound-nsubj,compound-pobj,NNP-NNP,NNP-NNP,4,1
8445,6665.0,30,announced,11,7,16,9,6,13,4,5,Purdue University,France A.,per-per,-,PROPN-PROPN,PROPN-NOUN,compound-compound,compound-pobj,NNP-NNP,NNP-NN,5,1
8446,6666.0,16,was,6,9,14,5,8,1,-3,8,French,Jacques-Louis David,org,-,ADJ,PROPN-PROPN,amod,compound-pobj,JJ,NNP-NNP,2,1
8447,6668.0,15,trained,3,10,13,3,9,1,-7,10,Killer Kowalski,Malden,-,per,PROPN-PROPN,PROPN,compound-conj,compound,NNP-NNP,NNP,5,1
8448,13038.0,25,began,1,5,8,3,4,16,-4,7,Killer Kowalski,Malden,org-org,,PROPN-PROPN,PROPN,compound-pobj,compound,NNP-NNP,NNP,4,1
8449,6669.0,36,launched,6,2,5,3,1,30,4,-1,3 August 2009,ESPN Classic,per-per-per,-,NUM-PROPN-NUM,PROPN-PROPN,nummod-nmod-nummod,pobj-nsubj,CD-NNP-CD,NNP-NNP,3,1
8450,6670.0,23,is,3,13,20,7,12,2,-10,17,Mint Royale,Faith Hope,-,per-per,PROPN-PROPN,PROPN-PROPN,compound-pobj,compound-compound,NNP-NNP,NNP-NNP,6,1
8451,12613.0,21,Is,1,10,18,8,9,2,-9,17,Mint Royale,Faith Hope,org-org,-,PROPN-PROPN,PROPN-PROPN,compound-pobj,compound-compound,NNP-NNP,NNP-NNP,6,1
8452,6671.0,50,was,1,1,24,23,0,25,0,23,Boni,Benin,,per,PROPN,PROPN,nsubj,compound,NNP,NNP,-1,1
8453,6672.0,87,outlined,1,62,69,7,61,17,-61,68,Rudolf,Austria,org,,PROPN,PROPN,pobj,pobj,NNP,NNP,6,1
8454,6673.0,35,find,1,19,34,15,18,0,-18,33,University of Edinburgh,Scotland,per-per-per,,PROPN-ADP-PROPN,PROPN,nsubj-prep-poss,pobj,NNP-IN-NNP,NNP,3,1
8455,9405.0,17,is,2,12,15,3,11,1,-10,13,University of Edinburgh,Scotland,org-org-org,,PROPN-ADP-PROPN,PROPN,nmod-prep-pobj,compound,NNP-IN-NNP,NNP,3,1
8456,9961.0,36,is,3,21,24,3,20,11,-18,21,University of Edinburgh,Scotland,org-org-org,,PROPN-ADP-PROPN,PROPN,nmod-prep-pobj,pobj,NNP-IN-NNP,NNP,3,1
8457,10361.0,70,has,3,8,68,60,7,1,-5,65,University of Edinburgh,Scotland,--,org,PROPN-ADP-PROPN,PROPN,appos-prep-pobj,pobj,NNP-IN-NNP,NNP,7,1
8458,12182.0,38,are,1,9,36,27,8,1,-8,35,University of Edinburgh,Scotland,per-per-per,,PROPN-ADP-PROPN,PROPN,pobj-prep-pobj,compound,NNP-IN-NNP,NNP,4,1
8459,14130.0,28,became,1,7,24,17,6,3,-6,23,University of Edinburgh,Scotland,--,per,PROPN-ADP-PROPN,PROPN,pobj-prep-pobj,pobj,NNP-IN-NNP,NNP,8,1
8460,6674.0,41,was,6,23,39,16,22,1,-17,33,Puerto Rico,Nydia Caro,per-per,-,PROPN-PROPN,PROPN-PROPN,compound-compound,compound-conj,NNP-NNP,NNP-NNP,6,1
8461,6675.0,39,said,23,25,30,5,24,8,-2,7,Robert Zubrin,Mars Society,org-org,-,PROPN-PROPN,PROPN-PROPN,compound-compound,compound-pobj,NNP-NNP,NNP-NNP,5,1
8462,6676.0,12,is,1,1,10,9,0,1,0,9,Unsane,Matador Records,org,-,PROPN,PROPN-PROPN,nsubj,compound-pobj,NNP,NNP-NNPS,5,1
8463,6677.0,21,formed,4,4,8,4,3,12,0,4,SAS,Star Alliance,,org-org,PROPN,PROPN-PROPN,nsubj,compound-compound,NNP,NNP-NNP,2,1
8464,6678.0,35,is,13,22,30,8,21,4,-9,17,Firaxis Games,Hunt Valley,-,per-per,PROPN-PROPN,PROPN-PROPN,compound-pobj,compound-compound,NNP-NNPS,NNP-NNP,7,1
8465,6679.0,27,was,15,1,5,4,0,21,14,-10,Bobby Darin,Walden Robert Cassotto,-,org-org-org,PROPN-PROPN,PROPN-PROPN-PROPN,compound-nsubj,compound-compound-dobj,NNP-NNP,NNP-NNP-NNP,3,1
8466,6681.0,32,offered,9,9,31,22,8,0,0,22,Benedetti,Colombia,per,,PROPN,PROPN,nsubj,dobj,NNP,NNP,8,1
8467,6682.0,15,clashed,2,8,9,1,7,5,-6,7,Interior,Ethan A. Hitchcock,,per-per-per,PROPN,PROPN-NOUN-PROPN,pobj,compound-compound-pobj,NNP,NNP-NN-NNP,2,1
8468,6683.0,116,sends,83,55,106,51,54,9,28,23,New Orleans,Preservation Hall Jazz Band,-,org-org-org-org,PROPN-PROPN,PROPN-PROPN-PROPN-PROPN,compound-compound,compound-compound-compound-dobj,NNP-NNP,NNP-NNP-NNP-NNP,10,1
8469,6684.0,26,grew,6,4,5,1,3,20,2,-1,Japan,Lisa Furukawa,org,-,PROPN,PROPN-PROPN,pobj,compound-nsubj,NNP,NNP-NNP,1,1
8470,6685.0,17,released,1,1,15,14,0,1,0,14,Belle,Pendulum Records,,org-org,PROPN,PROPN-PROPN,nsubj,compound-pobj,NNP,NNP-NNPS,3,1
8471,6686.0,12,Prior,0,5,11,6,4,0,-5,11,Midway Airlines,Morrisville,per-per,,PROPN-PROPN,PROPN,compound-nsubj,pobj,NNP-NNPS,NNP,2,1
8472,6687.0,25,got,9,4,5,1,3,19,5,-4,the Washington Examiner,Washington Examiner,per-per-per,-,DET-PROPN-PROPN,PROPN-PROPN,det-compound-pobj,compound-appos,DT-NNP-NNP,NNP-NNP,1,1
8473,6688.0,25,carried,8,8,19,11,7,5,0,11,Enbridge,Alberta,per,,PROPN,PROPN,appos,compound,NNP,NNP,4,1
8474,6689.0,35,moved,3,7,17,10,6,17,-4,14,Idaho,College of Idaho,,org-org-org,PROPN,PROPN-ADP-PROPN,pobj,pobj-prep-pobj,NNP,NNP-IN-NNP,5,1
8475,6690.0,40,founded,5,20,32,12,19,7,-15,27,Henry Jarvis Raymond,Republican National Committee,--,org-org-org,PROPN-PROPN-PROPN,PROPN-PROPN-PROPN,compound-compound-pobj,compound-compound-pobj,NNP-NNP-NNP,NNP-NNP-NNP,9,1
8476,6691.0,27,told,14,13,23,10,12,3,1,9,Norway,Jens Stoltenberg,org,-,PROPN,PROPN-PROPN,compound,compound-pobj,NNP,NNP-NNP,7,1
8477,9917.0,19,has,5,16,17,1,15,1,-11,12,Norway,Jens Stoltenberg,,org-org,PROPN,PROPN-PROPN,pobj,compound-pobj,NNP,NNP-NNP,1,1
8478,6692.0,29,contributed,24,10,2,-8,9,26,14,-22,Airlift Wing,Air National Guard,per-per,--,PROPN-PROPN,PROPN-PROPN-PROPN,compound-compound,compound-compound-appos,NNP-NNP,NNP-NNP-NNP,3,1
8479,6693.0,29,NC,4,10,11,1,9,17,-6,7,Florida,Institute for Simulation and Training,,org-org-org-org-org,PROPN,PROPN-ADP-PROPN-CCONJ-PROPN,compound,pobj-prep-pobj-cc-conj,NNP,NNP-IN-NNP-CC-NNP,3,1
8480,6694.0,26,attended,3,12,13,1,11,12,-9,10,Treasury,Benjamin Bristow,org,-,PROPN,PROPN-PROPN,pobj,compound-compound,NNP,NNP-NNP,1,1
8481,6695.0,20,re-elected,4,3,8,5,2,11,1,4,Scotty,Nauru,,per,PROPN,PROPN,nsubjpass,pobj,NNP,NNP,2,1
8482,13676.0,30,ousted,3,2,14,12,1,15,1,11,Scotty,Nauru,per,,PROPN,PROPN,nsubjpass,compound,NNP,NNP,7,1
8483,6696.0,33,replaced,4,21,21,0,20,11,-17,17,Hong Kong Sanatorium and Hospital,Hong Kong,----,per-per,PROPN-PROPN-PROPN-CCONJ-PROPN,PROPN-PROPN,compound-compound-pobj-cc-conj,compound-pobj,NNP-NNP-NNP-CC-NNP,NNP-NNP,0,1
8484,6697.0,25,announced,5,11,11,0,10,13,-6,6,Just Group,Just Jeans,org-org,-,PROPN-PROPN,ADV-PROPN,compound-pobj,compound-dobj,NNP-NNP,RB-NNPS,0,1
8485,12925.0,20,acquires,4,2,2,0,1,17,2,-2,Just Group,Just Jeans,per-per,-,PROPN-PROPN,ADV-PROPN,compound-nsubj,compound-compound,NNP-NNP,RB-NNPS,0,1
8486,6698.0,18,attended,5,5,14,9,4,3,0,9,Blodgett,Los Angeles,,per-per,PROPN,PROPN-PROPN,pobj,compound-pobj,NNP,NNP-NNP,4,1
8487,6699.0,28,be,8,17,23,6,16,4,-9,15,Italian,Giulio Tremonti,,org-org,ADJ,PROPN-PROPN,amod,compound-nsubj,JJ,NNP-NNP,3,1
8488,6700.0,32,seen,22,9,19,10,8,12,13,-3,Millet,Worpswede,,per,PROPN,PROPN,pobj,compound,NNP,NNP,5,1
8489,6702.0,16,represents,6,2,2,0,1,13,4,-4,Texas,Texas University,org,-,PROPN,PROPN-PROPN,nmod,compound-nmod,NNP,NNP-NNP,0,1
8490,6703.0,13,is,1,1,11,10,0,1,0,10,Felice,Breed 77,per,-,PROPN,PROPN-NUM,nsubj,pobj-nummod,NNP,NNP-CD,7,1
8491,6704.0,21,was,13,1,4,3,0,16,12,-9,Billy Curtis,Luigi Curto,-,per-per,PROPN-PROPN,PROPN-PROPN,compound-nsubj,compound-nsubj,NNP-NNP,NNP-NNP,2,1
8492,6705.0,32,founded,4,7,21,14,6,10,-3,17,St. Petersburg,Lenfilm,-,per,PROPN-PROPN,PROPN,compound-pobj,nsubj,NNP-NNP,NNP,4,1
8493,6706.0,20,coming,6,1,13,12,0,6,5,7,Paul McCartney,The Beatles,per-per,-,PROPN-PROPN,DET-PROPN,compound-nsubj,det-dobj,NNP-NNP,DT-NNPS,3,1
8494,6708.0,39,coupled,2,27,34,7,26,4,-25,32,band,Shatterproof,,per,NOUN,PROPN,nsubj,pobj,NN,NNP,2,1
8495,6709.0,13,is,4,2,12,10,1,0,2,8,Winston Churchill,England,-,per,PROPN-PROPN,PROPN,compound-compound,pobj,NNP-NNP,NNP,3,1
8496,6711.0,10,has,1,1,9,8,0,0,0,8,It,Malaysia,,org,PRON,PROPN,nsubj,pobj,PRP,NNP,1,1
8497,6712.0,41,announced,1,10,13,3,9,27,-9,12,Philippines,Cebu Pacific,,org-org,PROPN,PROPN-PROPN,nmod,compound-conj,NNP,NNP-NNP,2,1
8498,6713.0,21,is,2,1,9,8,0,11,1,7,Philippine Airlines,Philippines,per-per,,PROPN-PROPN,PROPN,compound-nsubj,pobj,NNP-NNPS,NNPS,4,1
8499,6714.0,26,became,3,3,10,7,2,15,0,7,he,Serbian Royal Academy,per,--,PRON,PROPN-PROPN-PROPN,nsubj,compound-compound-pobj,PRP,NNP-NNP-NNP,4,1
8500,6715.0,12,Telekom,1,1,5,4,0,6,0,4,Deutsche Telekom,T-Mobile,org-org,,PROPN-PROPN,PROPN,compound-ROOT,nsubj,NNP-NNP,NNP,4,1
8501,6716.0,43,located,1,8,25,17,7,17,-7,24,Norfolk,Sentara Norfolk General Hospital,,per-per-per-per,PROPN,PROPN-PROPN-PROPN-PROPN,pobj,compound-compound-compound-compound,NNP,NNP-NNP-NNP-NNP,-1,1
8502,6717.0,41,remain,27,4,20,16,3,20,23,-7,African Party for the Independence of Guinea and Cape Verde,1956,---------,per,PROPN-PROPN-ADP-DET-PROPN-ADP-PROPN-CCONJ-PROPN-PROPN,NUM,compound-nsubjpass-prep-det-pobj-prep-pobj-cc-compound-conj,pobj,NNP-NNP-IN-DT-NNP-IN-NNP-CC-NNP-NNP,CD,2,1
8503,6718.0,29,nexsound,2,1,18,17,0,10,1,16,Zavoloka,Ukraine,,org,PROPN,PROPN,compound,pobj,NNP,NNP,6,1
8504,6719.0,39,was,1,13,18,5,12,20,-12,17,Tuesday Weld,he,per-per,,PROPN-PROPN,PRON,compound-appos,nsubj,NNP-NNP,PRP,2,1
8505,6721.0,21,was,11,1,18,17,0,2,10,7,Christos Stefanopoulos,of Pyrg,org-org,-,PROPN-PROPN,ADP-PROPN,compound-nsubj,prep-pobj,NNP-NNP,IN-NNP,4,1
8506,6723.0,25,gained,12,5,18,13,4,6,7,6,Canada,National Bank of Canada,per,---,PROPN,PROPN-PROPN-ADP-PROPN,pobj,compound-nsubj-prep-pobj,NNP,NNP-NNP-IN-NNP,3,1
8507,6725.0,29,include,1,8,10,2,7,18,-7,9,CBS Corporation,Leslie Moonves,-,per-per,PROPN-PROPN,PROPN-PROPN,compound-compound,compound-compound,NNP-NNP,NNP-NNP,3,1
8508,12628.0,37,led,1,4,24,20,3,12,-3,23,CBS Corporation,Leslie Moonves,org-org,-,PROPN-PROPN,PROPN-PROPN,compound-compound,compound-nsubj,NNP-NNP,NNP-NNPS,3,1
8509,6726.0,45,Along,0,7,12,5,6,32,-7,12,Jerry Salley,Cordle Jackson Salley,-,per-per-per,PROPN-PROPN,PROPN-PROPN-PROPN,compound-conj,compound-compound-appos,NNP-NNP,NNP-NNP-NNP,7,1
8510,6727.0,31,represented,5,11,16,5,10,14,-6,11,Ethan Hawke,Uma Thurman,-,per-per,PROPN-PROPN,PROPN-PROPN,compound-compound,compound-conj,NNP-NNP,NNP-NNP,2,1
8511,6729.0,31,formed,5,2,8,6,1,22,3,3,University of Potsdam,1991,org-org-org,,PROPN-ADP-PROPN,NUM,nsubjpass-prep-pobj,pobj,NNP-IN-NNP,CD,3,1
8512,6730.0,42,day,2,30,41,11,29,0,-28,39,Franklin Knight Lane,Interior,org-org-org,,PROPN-PROPN-PROPN,PROPN,compound-compound-pobj,pobj,NNP-NNP-NNP,NNP,7,1
8513,6731.0,28,formed,4,11,26,15,10,1,-7,22,Pete Wentz,Chicago,org-org,,PROPN-PROPN,PROPN,compound-pobj,compound,NNP-NNP,NNP,6,1
8514,6733.0,64,has,1,11,18,7,10,45,-10,17,Boston,Akrobatik,per,,PROPN,PROPN,compound,compound,NNP,NNP,6,1
8515,6734.0,22,founded,5,2,15,13,1,6,3,10,University of Kiel,1665,--,per,PROPN-ADP-PROPN,NUM,nsubjpass-prep-pobj,nummod,NNP-IN-NNP,CD,3,1
8516,6736.0,18,built,9,2,12,10,1,5,7,3,Glasgow Subway,1896,-,org,PROPN-PROPN,NUM,compound-nsubjpass,pobj,NNP-NNP,CD,2,1
8517,6737.0,38,Title,0,22,32,10,21,5,-22,32,North Carolina State University,United States,---,per-per,PROPN-PROPN-PROPN-PROPN,PROPN-PROPN,compound-compound-compound-appos,compound-appos,NNP-NNP-NNP-NNP,NNP-NNP,4,1
8518,6738.0,94,named,2,71,79,8,70,14,-69,77,Taiwan,National Chiao Tung University,per,---,PROPN,PROPN-PROPN-PROPN-PROPN,pobj,compound-compound-compound-pobj,NNP,NNP-NNP-NNP-NNP,8,1
8519,6739.0,41,urge,1,18,22,4,17,18,-17,21,Joseph Kony,LRA,org-org,,PROPN-PROPN,NOUN,compound-dobj,conj,NNP-NNP,NN,2,1
8520,6740.0,52,said,7,5,17,12,4,34,2,10,President,Mwai Kibaki,org,-,PROPN,PROPN-PROPN,compound,compound-pobj,NNP,NNP-NNP,7,1
8521,6741.0,24,attended,17,1,14,13,0,9,16,-3,Tanzania,Joseph Sinde Warioba,per,--,PROPN,PROPN-PROPN-PROPN,poss,compound-compound-conj,NNP,NNP-NNP-NNP,5,1
8522,6743.0,30,provided,3,2,14,12,1,15,1,11,Wings,United States,per,-,PROPN,PROPN-PROPN,nsubj,compound-pobj,NNP,NNP-NNP,6,1
8523,6744.0,21,is,10,2,20,18,1,0,8,10,Laurentian Bank of Canada,Quebec,---,per,PROPN-PROPN-ADP-PROPN,PROPN,compound-nsubj-prep-pobj,pobj,NNP-NNP-IN-NNP,NNP,2,1
8524,6745.0,21,became,2,15,20,5,14,0,-13,18,his,Massachusetts,,org,DET,PROPN,poss,pobj,PRP$,NNP,6,1
8525,6746.0,24,took,17,1,10,9,0,13,16,-7,Joe Clark,Alberta,per-per,,PROPN-PROPN,PROPN,compound-poss,compound,NNP-NNP,NNP,3,1
8526,6747.0,20,is,3,8,19,11,7,0,-5,16,Thea Gilmore,Sanctuary,per-per,,PROPN-PROPN,PROPN,compound-pobj,pobj,NNP-NNP,NNP,4,1
8527,6748.0,28,was,6,4,6,2,3,21,2,0,Hastings Banda,Malawi,-,org,PROPN-PROPN,PROPN,compound-compound,pobj,NNP-NNP,NNP,4,1
8528,7652.0,29,declared,5,3,27,24,2,1,2,22,Hastings Banda,Malawi,-,org,PROPN-PROPN,PROPN,compound-nsubjpass,pobj,NNP-NNP,NNP,8,1
8529,8511.0,32,emerged,2,12,15,3,11,16,-10,13,Hastings Banda,Malawi,-,org,PROPN-PROPN,PROPN,compound-nsubj,pobj,NNP-NNP,NNP,1,1
8530,13672.0,27,was,6,4,6,2,3,20,2,0,Hastings Banda,Malawi,per-per,,PROPN-PROPN,PROPN,compound-compound,pobj,NNP-NNP,NNP,4,1
8531,6749.0,26,is,18,13,25,12,12,0,5,7,Freddie Aguilar,Philippines,per-per,,PROPN-PROPN,PROPN,compound-pobj,pobj,NNP-NNP,NNP,5,1
8532,6750.0,15,divides,2,2,12,10,1,2,0,10,DHL,Astar Air Cargo,,per-per-per,PROPN,PROPN-PROPN-PROPN,nsubj,compound-compound-conj,NNP,NNP-NNP-NNP,6,1
8533,6752.0,58,OPTION,0,11,22,11,10,35,-11,22,Vietnam,HO CHI MINH,org,--,PROPN,PROPN-PROPN-PROPN,nsubjpass,compound-compound-compound,NNP,NNP-NNP-NNP,5,1
8534,6753.0,77,designed,9,20,22,2,19,54,-11,13,UK,Bristol Aeroplane Company,per,--,PROPN,PROPN-PROPN-PROPN,pobj,compound-compound-nsubj,NNP,NNP-NNP-NNP,2,1
8535,6755.0,20,said,18,4,13,9,3,6,14,-5,OceanAir,Efromovich,,org,PROPN,PROPN,nsubj,appos,NNP,NNP,5,1
8536,6756.0,107,were,9,97,100,3,96,6,-88,91,Hubert Humphrey,Minnesota,org-org,,PROPN-PROPN,PROPN,compound-dobj,compound,NNP-NNP,NNP,4,1
8537,6757.0,32,graduated,1,1,7,6,0,24,0,6,Graham,New Brunswick,per,-,PROPN,PROPN-PROPN,nsubj,compound-pobj,NNP,NNP-NNP,4,1
8538,6758.0,23,is,6,1,14,13,0,8,5,8,Centaurus High School,Colorado,org-org-org,,PROPN-PROPN-PROPN,PROPN,compound-compound-nsubj,pobj,NNP-NNP-NNP,NNP,4,1
8539,6760.0,11,named,3,8,10,2,7,0,-5,7,Dutch,Rembrandt,org,,ADJ,PROPN,amod,pobj,JJ,NNP,4,1
8540,6761.0,41,was,30,3,22,19,2,18,27,-8,Texas Tech,Big 12 Conference,per-per,--,PROPN-PROPN,PROPN-NUM-PROPN,compound-conj,amod-nummod-conj,NNP-NNP,NNP-CD-NNP,6,1
8541,6762.0,19,is,1,6,15,9,5,3,-5,14,England,Federation Shield,,per-per,PROPN,PROPN-PROPN,compound,compound-pobj,NNP,NNP-NNP,5,1
8542,6763.0,33,elected,2,1,10,9,0,22,1,8,Clark,December 1993,,org-org,PROPN,PROPN-NUM,nsubjpass,pobj-nummod,NNP,NNP-CD,4,1
8543,6766.0,16,is,3,2,3,1,1,12,1,0,Polytechnique de,de,org-org,,PROPN-X,X,compound-nsubj,pobj,NNP-FW,FW,1,1
8544,6768.0,37,is,3,13,35,22,12,1,-10,32,Mastodon,Warner Bros,org,-,PROPN,PROPN-PROPN,appos,compound-pobj,NNP,NNP-NNP,6,1
8545,6769.0,19,is,8,1,17,16,0,1,7,9,Woodstock Academy,United States,per-per,-,PROPN-PROPN,PROPN-PROPN,compound-nsubj,compound-pobj,NNP-NNP,NNP-NNP,5,1
8546,6770.0,19,worked,5,13,16,3,12,2,-8,11,Ohio,William B. Saxbe,per,--,PROPN,PROPN-PROPN-PROPN,compound,compound-compound-pobj,NNP,NNP-NNP-NNP,3,1
8547,6772.0,24,found,1,1,16,15,0,7,0,15,Lithuania,he,org,,PROPN,PRON,nsubj,nsubj,NNP,PRP,1,1
8548,6773.0,24,earned,2,10,14,4,9,9,-8,12,Johnson Wales University,Providence,per-per-per,,PROPN-PROPN-PROPN,PROPN,compound-compound-pobj,compound,NNP-NNP-NNP,NNP,3,1
8549,6774.0,17,are,1,10,14,4,9,2,-9,13,Czechoslovakia,d Jan,per,-,PROPN,ADJ-PROPN,pobj,amod-appos,NNP,JJ-NNP,3,1
8550,6775.0,21,is,5,16,19,3,15,1,-11,14,Thailand,Modern Dog,org,-,PROPN,PROPN-PROPN,pobj,compound-dobj,NNP,NNP-NNP,5,1
8551,6776.0,37,petitioned,9,6,30,24,5,6,3,21,Joaquim de Almeida,Portugal,--,per,PROPN-PROPN-PROPN,PROPN,compound-compound-appos,pobj,NNP-NNP-NNP,NNP,7,1
8552,6777.0,22,represented,7,3,15,12,2,6,4,8,Grambling State Tigers,SWAC,org-org-org,,PROPN-PROPN-PROPN,PROPN,compound-compound-compound,pobj,NNP-NNP-NNP,NNP,4,1
8553,6778.0,58,Midfilders,0,6,8,2,5,49,-6,8,Defensor Sporting,Uruguay,-,per,PROPN-PROPN,PROPN,compound-compound,parataxis,NNP-NNP,NNP,2,1
8554,8737.0,37,played,5,32,35,3,31,1,-27,30,Defensor Sporting,Uruguay,org-org,,PROPN-PROPN,PROPN,compound-conj,appos,NNP-NNP,NNP,3,1
8555,9970.0,12,Sporting,1,1,4,3,0,7,0,3,Defensor Sporting,Uruguay,org-org,,PROPN-PROPN,PROPN,compound-ROOT,appos,NNP-NNP,NNP,2,1
8556,6779.0,20,formed,3,2,6,4,1,13,1,3,MSEB,June 20 1960,org,--,PROPN,PROPN-NUM-NUM,nsubjpass,pobj-nummod-nummod,NNP,NNP-CD-CD,5,1
8557,6780.0,20,is,1,12,12,0,11,7,-11,11,Gazprom Media,Gazprom,org-org,,PROPN-PROPN,PROPN,compound-compound,pobj,NNP-NNP,NNP,0,1
8558,6781.0,24,resides,3,2,21,19,1,2,1,18,Bucky Pizzarelli,his,-,org,PROPN-PROPN,DET,compound-nsubj,poss,NNP-NNP,PRP$,3,1
8559,6782.0,14,is,4,1,11,10,0,2,3,7,Philip Morris,Altria Group,-,org-org,PROPN-PROPN,PROPN-PROPN,compound-compound,compound-compound,NNP-NNP,NNP-NNP,6,1
8560,12568.0,16,changed,8,5,13,8,4,2,3,5,Philip Morris,Altria Group,-,per-per,PROPN-PROPN,PROPN-PROPN,compound-compound,compound-compound,NNP-NNP,NNP-NNP,5,1
8561,6783.0,26,had,2,14,15,1,13,10,-12,13,Sultan,Selim I,,per-per,PROPN,PROPN-PRON,compound,npadvmod-nsubj,NNP,NNP-PRP,2,1
8562,6785.0,20,won,14,2,5,3,1,14,12,-9,Missouri,Jim Talent,,per-per,PROPN,PROPN-PROPN,nmod,compound-pobj,NNP,NNP-NNP,2,1
8563,6786.0,34,release,1,3,22,19,2,11,-2,21,Demons Down,Sean McNabb,org-org,-,PROPN-PROPN,PROPN-PROPN,compound-nsubj,compound-ROOT,NNP-NNP,NNP-NNP,-1,1
8564,6787.0,31,founded,7,10,29,19,9,1,-3,22,Toronto,Christopher Plummer,org,-,PROPN,PROPN-PROPN,pobj,compound-conj,NNP,NNP-NNP,8,1
8565,6788.0,25,made,1,1,10,9,0,14,0,9,Guard,Roots Music Group,per,--,PROPN,PROPN-PROPN-PROPN,nsubj,compound-compound-pobj,NNP,NNP-NNP-NNP,5,1
8566,6790.0,40,merged,22,6,10,4,5,29,16,-12,Lithuania,Antanas Smetona,per,-,PROPN,PROPN-PROPN,pobj,compound-compound,NNP,NNP-NNP,5,1
8567,6791.0,7,Thompson,5,3,5,2,2,1,2,0,Wisconsin,Tommy Thompson,per,-,PROPN,PROPN-PROPN,compound,compound-ROOT,NNP,NNP-NNP,1,1
8568,8129.0,27,joined,20,4,19,15,3,7,16,-1,Wisconsin,Tommy Thompson,,per-per,PROPN,PROPN-PROPN,compound,compound-pobj,NNP,NNP-NNP,1,1
8569,9922.0,20,requested,4,1,3,2,0,16,3,-1,Wisconsin,Tommy Thompson,,org-org,PROPN,PROPN-PROPN,compound,compound-nsubj,NNP,NNP-NNP,1,1
8570,10412.0,32,appointed,4,15,17,2,14,14,-11,13,Wisconsin,Tommy Thompson,per,-,PROPN,PROPN-PROPN,compound,compound-pobj,NNP,NNP-NNP,1,1
8571,12109.0,26,declared,5,8,10,2,7,15,-3,5,Wisconsin,Tommy Thompson,,per-per,PROPN,PROPN-PROPN,compound,compound-nsubj,NNP,NNP-NNP,1,1
8572,6792.0,47,made,8,16,16,0,15,30,-8,8,Royal Norwegian Navy Air Service,Royal Norwegian Navy,per-per-per-per-per,--,PROPN-PROPN-PROPN-PROPN-PROPN,PROPN-PROPN-PROPN,compound-compound-compound-compound-pobj,compound-compound-poss,NNP-NNP-NNP-NNP-NNP,NNP-NNP-NNP,0,1
8573,6793.0,24,founded,3,2,22,20,1,1,1,19,company,George Lucas,org,-,NOUN,PROPN-PROPN,nsubjpass,compound-pobj,NN,NNP-NNP,6,1
8574,6795.0,26,is,3,1,9,8,0,16,2,6,Air Niugini,Papua New Guinea,-,per-per-per,PROPN-PROPN,PROPN-PROPN-PROPN,compound-compound,compound-compound-pobj,NNP-NNP,NNP-NNP-NNP,6,1
8575,6796.0,36,said,7,24,30,6,23,5,-17,23,CompuServe,1969,,org,PROPN,NUM,pobj,pobj,NNP,CD,3,1
8576,6797.0,38,made,2,24,28,4,23,9,-22,26,Migros,Switzerland,,per,PROPN,PROPN,compound,pobj,NNP,NNP,3,1
8577,6798.0,26,said,24,5,24,19,4,1,19,0,Fastweb,Swisscom,org,,PROPN,PROPN,compound,nsubj,NNP,NNP,8,1
8578,6801.0,34,Desai,2,15,25,10,14,8,-13,23,NPk was a notable Indi,fourth,org-org-org-org-org,,NOUN-VERB-DET-ADJ-PROPN,ADJ,nsubj-ROOT-det-amod-attr,amod,NNS-VBD-DT-JJ-NNP,JJ,3,1
8579,6802.0,27,sold,13,16,12,-4,15,14,-3,-1,British Aerospace,Rover Group,per-per,-,PROPN-PROPN,PROPN-PROPN,compound-pobj,compound-pobj,NNP-NNP,NNP-NNP,3,1
8580,6803.0,66,Probably,0,39,44,5,38,21,-39,44,Frank Uwe Laysiepen,Ulay,--,per,PROPN-PROPN-PROPN,PROPN,compound-compound-appos,pobj,NNP-NNP-NNP,NNP,2,1
8581,6804.0,44,are,4,10,19,9,9,24,-6,15,Florida,A. Crawford Mosley High School,,org-org-org-org-org,PROPN,NOUN-PROPN-PROPN-PROPN-PROPN,compound,compound-compound-compound-compound-compound,NNP,NN-NNP-NNP-NNP-NNP,-1,1
8582,6805.0,25,helped,14,9,17,8,8,7,5,3,MTU,Huskies,,org,PROPN,PROPN,dobj,dobj,NNP,NNPS,6,1
8583,6806.0,42,be,26,28,40,12,27,1,-2,14,John Butler,Jarrah,per-per,,PROPN-PROPN,PROPN,compound-compound,compound,NNP-NNP,NNP,6,1
8584,6807.0,16,grew,10,3,14,11,2,1,7,4,A Guy Called Gerald,Moss Side,---,per-per,DET-PROPN-VERB-PROPN,PROPN-PROPN,det-nsubj-acl-oprd,compound-pobj,DT-NNP-VBN-NNP,NNP-NNP,4,1
8585,6809.0,40,time,2,1,18,17,0,21,1,16,Muluzi,Malawi,,org,PROPN,PROPN,poss,poss,NNP,NNP,10,1
8586,6810.0,39,explained,12,11,26,15,10,12,1,14,Stephen Malkmus,UK,per-per,,PROPN-PROPN,PROPN,compound-pobj,compound,NNP-NNP,NNP,13,1
8587,6814.0,19,include,2,4,18,14,3,0,-2,16,Katie Grand,Pop,org-org,,PROPN-PROPN,PROPN,compound-dobj,dobj,NNP-NNP,NNP,2,1
8588,6816.0,39,known,7,20,25,5,19,13,-13,18,United States Army Air Forces,Fourteenth Air Force,org-org-org-org-org,--,PROPN-PROPN-PROPN-PROPN-PROPN,PROPN-PROPN-PROPN,compound-compound-compound-compound-compound,compound-compound-pobj,NNP-NNP-NNP-NNP-NNPS,NNP-NNP-NNP,5,1
8589,6817.0,24,match,1,1,16,15,0,7,0,15,Liga,FC Bayern Munich II,,per-per-per-per,ADJ,PROPN-PROPN-PROPN-PROPN,nsubj,compound-compound-compound-pobj,JJ,NNP-NNP-NNP-NNP,5,1
8590,6818.0,48,Holes,4,7,9,2,6,38,-3,5,David McComb,The Triffids,-,per-per,PROPN-PROPN,DET-PROPN,compound-ROOT,det-npadvmod,NNP-NNP,DT-NNP,-1,1
8591,6819.0,53,held,32,3,10,7,2,42,29,-22,CNN,Klein,per,,PROPN,PROPN,compound,nsubjpass,NNP,NNP,4,1
8592,6820.0,38,was,7,1,22,21,0,15,6,15,His,Queen,,org,DET,PROPN,poss,pobj,PRP$,NNP,3,1
8593,6822.0,18,studied,1,1,10,9,0,7,0,9,Davis,Toronto,org,,PROPN,PROPN,nsubj,pobj,NNP,NNP,1,1
8594,6823.0,37,was,11,1,21,20,0,15,10,10,Nickel Creek,Chris Thile,org-org,-,PROPN-PROPN,PROPN-PROPN,compound-nsubj,compound-pobj,NNP-NNP,NNP-NNP,6,1
8595,6824.0,31,born,11,1,9,8,0,21,10,-2,Herbert Morse,Barry,-,per,PROPN-PROPN,PROPN,compound-nsubjpass,pobj,NNP-NNP,NNP,2,1
8596,6825.0,28,has,2,1,16,15,0,11,1,14,Omaha,Metz Brewery,,org-org,PROPN,PROPN-PROPN,nsubj,compound-pobj,NNP,NNP-NNP,7,1
8597,6826.0,30,were,4,26,28,2,25,1,-22,24,University Press,1998,-,per,PROPN-PROPN,NUM,compound-ROOT,nummod,NNP-NNP,CD,2,1
8598,6828.0,29,following,1,9,15,6,8,13,-8,14,Butthole Surfers,Touch,-,per,PROPN-PROPN,NOUN,compound-pobj,nsubj,NNP-NNPS,NN,5,1
8599,11993.0,32,resulted,20,16,29,13,15,2,4,9,Butthole Surfers,Touch,org-org,,PROPN-PROPN,PROPN,compound-pobj,pobj,NNP-NNPS,NNP,10,1
8600,12740.0,23,Sees,2,11,19,8,10,3,-9,17,Butthole Surfers,Touch,org-org,,PROPN-PROPN,PROPN,compound-pobj,pobj,NNP-NNPS,NNP,2,1
8601,6830.0,14,argued,2,2,11,9,1,2,0,9,Khan,Pakistan,,per,PROPN,PROPN,nsubj,poss,NNP,NNP,6,1
8602,6831.0,44,WASHINGTON,0,13,32,19,12,11,-13,32,Enron,Houston,per,,PROPN,PROPN,compound,pobj,NNP,NNP,10,1
8603,6833.0,40,recorded,2,14,18,4,13,21,-12,16,N.W.A,Ruthless,,org,PROPN,PROPN,advmod,pobj,NNP,NNP,3,1
8604,6834.0,18,born,2,4,6,2,3,11,-2,4,Morgan Lily,Gross,-,per,PROPN-PROPN,PROPN,compound-compound,oprd,NNP-NNP,NNP,2,1
8605,6836.0,15,is,2,1,11,10,0,3,1,9,Edgewater Technology,Wakefield,org-org,,PROPN-PROPN,PROPN,compound-nsubj,compound,NNP-NNP,NNP,6,1
8606,6838.0,45,was,1,6,23,17,5,21,-5,22,Watts,London,org,,PROPN,PROPN,nsubj,nmod,NNP,NNP,5,1
8607,6839.0,29,born,2,5,7,2,4,21,-3,5,London,his,org,,PROPN,DET,pobj,poss,NNP,PRP$,2,1
8608,6840.0,31,led,7,22,6,-16,21,24,-15,-1,Amul,Anand,org,,PROPN,PROPN,dobj,compound,NNP,NNP,5,1
8609,6841.0,25,wanted,11,10,4,-6,9,20,1,-7,Atlanta Georgia,Turner Broadcasting System,-,org-org-org,PROPN-PROPN,PROPN-PROPN-PROPN,compound-pobj,compound-compound-pobj,NNP-NNP,NNP-NNP-NNP,3,1
8610,6843.0,29,changed,2,7,14,7,6,14,-5,12,Diana Serra Cary,Gordon Ayres,per-per-per,-,PROPN-PROPN-PROPN,PROPN-PROPN,compound-compound-pobj,compound-appos,NNP-NNP-NNP,NNP-NNP,8,1
8611,6845.0,20,voiced,2,5,13,8,4,6,-3,11,Ch?,Yichi N,org,-,NOUN,PROPN-PROPN,pobj,compound-compound,NNS,NNP-NNP,-1,1
8612,6846.0,35,declared,4,1,13,12,0,21,3,9,Maine,he,,per,PROPN,PRON,poss,nsubj,NNP,PRP,4,1
8613,6847.0,38,started,5,22,36,14,21,1,-17,31,his,Windham Hill,org,-,DET,PROPN-PROPN,poss,compound-pobj,PRP$,NNP-NNP,9,1
8614,6849.0,47,took,2,13,38,25,12,8,-11,36,Barry Goldwater,Arizona,per-per,,PROPN-PROPN,PROPN,compound-nsubj,pobj,NNP-NNP,NNP,10,1
8615,6850.0,16,holds,3,12,15,3,11,0,-9,12,Anahuac University,Mexico,per-per,,PROPN-PROPN,PROPN,compound-pobj,pobj,NNP-NNP,NNP,3,1
8616,6851.0,31,left,1,17,23,6,16,7,-16,22,California,Michael Modest,,per-per,PROPN,PROPN-PROPN,pobj,compound-pobj,NNP,NNP-NNP,3,1
8617,6852.0,44,retired,5,14,26,12,13,17,-9,21,Fleet Air Arm,6,per-per-per,,PROPN-PROPN-PROPN,NUM,compound-compound-compound,nummod,NNP-NNP-NNP,CD,7,1
8618,6853.0,54,recorded,3,16,19,3,15,34,-13,16,Franz Ferdinand,Alex Kapranos,per-per,-,PROPN-PROPN,PROPN-PROPN,compound-poss,compound-pobj,NNP-NNP,NNP-NNP,1,1
8619,6854.0,34,was,3,20,23,3,19,10,-17,20,Duran Duran,John Taylor,per-per,-,PROPN-PROPN,PROPN-PROPN,compound-compound,compound-conj,NNP-NNP,NNP-NNP,2,1
8620,6855.0,64,released,11,28,38,10,27,25,-17,27,Latino Buggerveil,Butthole Surfers,per-per,-,PROPN-PROPN,PROPN-PROPN,compound-nsubj,compound-nsubj,NNP-NNP,NNP-NNP,-1,1
8621,6856.0,16,has,10,9,13,4,8,2,1,3,Northwestern University,Chicago,-,per,PROPN-PROPN,PROPN,compound-pobj,compound,NNP-NNP,NNP,4,1
8622,6858.0,36,suggested,6,3,6,3,2,29,3,0,Suffolk University,Massachusetts,-,per,PROPN-PROPN,PROPN,compound-pobj,pobj,NNP-NNP,NNP,3,1
8623,6860.0,32,founded,3,1,6,5,0,25,2,3,Bigelow Aerospace,Robert Bigelow,org-org,-,PROPN-PROPN,PROPN-PROPN,compound-nsubjpass,compound-pobj,NNP-NNP,NNP-NNP,3,1
8624,6861.0,27,appointed,4,18,25,7,17,1,-14,21,London District,Great Britain,per-per,-,PROPN-PROPN,PROPN-PROPN,compound-pobj,compound-pobj,NNP-NNP,NNP-NNP,4,1
8625,6863.0,14,is,2,1,9,8,0,4,1,7,Broomfield Hospital,England,per-per,,PROPN-PROPN,PROPN,compound-nsubj,pobj,NNP-NNP,NNP,5,1
8626,6866.0,32,featured,5,2,13,11,1,18,3,8,Conference USA,SMU Mustangs,-,per-per,PROPN-PROPN,PROPN-PROPN,compound-compound,compound-pobj,NNP-NNP,NNP-NNP,6,1
8627,6867.0,21,is,2,1,19,18,0,1,1,17,Villanova College,Queensland,-,per,PROPN-PROPN,PROPN,compound-nsubj,compound,NNP-NNP,NNP,5,1
8628,6869.0,36,is,7,26,30,4,25,5,-19,23,Institute of Technology,RMIT University,org-org-org,-,PROPN-ADP-PROPN,PROPN-PROPN,pobj-prep-pobj,compound-appos,NNP-IN-NNP,NNP-NNP,2,1
8629,6870.0,51,reported,27,5,22,17,4,28,22,-5,BMI,Bmibaby,,per,PROPN,PROPN,pobj,dobj,NNP,NNP,4,1
8630,8028.0,25,set,3,3,9,6,2,15,0,6,BMI,Bmibaby,org,,PROPN,PROPN,nsubj,appos,NNP,NNP,2,1
8631,10463.0,36,lowered,27,10,13,3,9,22,17,-14,BMI,Bmibaby,,per,PROPN,PROPN,compound,conj,NNP,NNP,2,1
8632,6872.0,32,said,10,1,6,5,0,25,9,-4,Singapore Airlines,Chew Choon Seng,per-per,--,PROPN-PROPN,PROPN-PROPN-PROPN,compound-poss,compound-compound-appos,NNP-NNPS,NNP-NNP-NNP,3,1
8633,6873.0,35,announced,13,9,16,7,8,18,4,3,China,CNPC,per,,PROPN,PROPN,poss,pobj,NNP,NNP,6,1
8634,6874.0,14,is,1,1,13,12,0,0,0,12,RAID,France,org,,NOUN,PROPN,nsubj,pobj,NN,NNP,1,1
8635,6875.0,11,married,1,1,3,2,0,7,0,2,Hayfron,Robert Mugabe,,org-org,PROPN,PROPN-PROPN,nsubj,compound-dobj,NNP,NNP-NNP,1,1
8636,6878.0,34,In,0,23,27,4,22,6,-23,27,House,Kyprianou,,per,PROPN,PROPN,pobj,conj,NNP,NNP,5,1
8637,6879.0,34,was,1,6,5,-1,5,28,-5,4,Empress Kju,of Jap,org-org,-,PROPN-PROPN,ADP-PROPN,compound-compound,prep-pobj,NNP-NNP,IN-NNP,1,1
8638,6880.0,17,producing,4,10,15,5,9,1,-6,11,Becca,Portland,per,,PROPN,PROPN,dobj,compound,NNP,NNP,2,1
8639,6882.0,56,was,12,4,10,6,3,45,8,-2,Western Australia,John Curtin,-,per-per,PROPN-PROPN,PROPN-PROPN,compound-pobj,compound-compound,NNP-NNP,NNP-NNP,5,1
8640,6883.0,31,said,14,1,12,11,0,18,13,-2,Elizabeth Edwards,John Edwards,org-org,-,PROPN-PROPN,PROPN-PROPN,compound-nsubj,compound-conj,NNP-NNP,NNP-NNP,3,1
8641,6884.0,59,362,0,4,13,9,3,45,-4,13,Mercury,Welles,,org,PROPN,PROPN,compound,nsubj,NNP,NNP,6,1
8642,6885.0,21,convened,3,14,17,3,13,3,-11,14,All Hallows College,Drumcondra,--,per,DET-PROPN-PROPN,PROPN,det-compound-compound,pobj,DT-NNP-NNP,NNP,4,1
8643,6886.0,75,include,6,71,74,3,70,0,-65,68,Unum,Chattanooga,per,,PROPN,PROPN,conj,pobj,NNP,NNP,3,1
8644,6889.0,24,engineered,1,4,23,19,3,0,-3,22,Activision Blizzard,2008,-,per,PROPN-PROPN,NUM,compound-nsubj,nummod,NNP-NNP,CD,3,1
8645,6890.0,35,was,1,18,32,14,17,2,-17,31,Giuseppe Mazzini,Italy,per-per,,PROPN-PROPN,PROPN,nmod-pobj,pobj,NNP-NNP,NNP,3,1
8646,6891.0,36,records,18,1,15,14,0,20,17,-3,Grady,Morehouse School of Medicine,per,---,PROPN,PROPN-PROPN-ADP-PROPN,nsubj,compound-conj-prep-pobj,NNP,NNP-NNP-IN-NNP,6,1
8647,6892.0,20,was,1,9,18,9,8,1,-8,17,Dalit Bahujan Shramik Union,Andhra Pradesh,per-per-per-per,-,PROPN-PROPN-PROPN-PROPN,PROPN-PROPN,compound-compound-compound-pobj,compound-pobj,NNP-NNP-NNP-NNP,NNP-NNP,5,1
8648,6893.0,16,started,1,1,7,6,0,8,0,6,Choclair,Greenhouse Music,org,-,PROPN,PROPN-PROPN,nsubj,compound-appos,NNP,NNP-NNP,1,1
8649,6894.0,20,became,1,3,8,5,2,11,-2,7,President,Faure,,per,PROPN,PROPN,attr,nsubj,NNP,NNP,3,1
8650,6895.0,29,returned,4,7,27,20,6,1,-3,23,Florida,Mike Graham,org,-,PROPN,PROPN-PROPN,pobj,compound-pobj,NNP,NNP-NNP,5,1
8651,9835.0,17,challenged,2,5,11,6,4,5,-3,9,Florida,Mike Graham,,org-org,PROPN,PROPN-PROPN,compound,compound-conj,NNP,NNP-NNP,2,1
8652,6896.0,24,said,10,12,16,4,11,7,-2,6,Vincent Cheng,HSBC,-,per,PROPN-PROPN,PROPN,compound-compound,poss,NNP-NNP,NNP,6,1
8653,6897.0,36,said,28,8,12,4,7,23,20,-16,Ortega,Rosario Murillo,,per-per,PROPN,PROPN-PROPN,nsubj,compound-appos,NNP,NNP-NNP,3,1
8654,6899.0,19,was,3,9,17,8,8,1,-6,14,Peterson,Ontario,org,,PROPN,PROPN,poss,compound,NNP,NNP,6,1
8655,6900.0,55,expanded,2,10,12,2,9,42,-8,10,China,American International School of Guangzhou,per,----,PROPN,PROPN-PROPN-PROPN-ADP-PROPN,pobj,compound-compound-appos-prep-compound,NNP,NNP-NNP-NNP-IN-NNP,2,1
8656,6904.0,21,born,2,1,20,19,0,0,1,18,He,Hungary,,org,PRON,PROPN,nsubjpass,pobj,PRP,NNP,2,1
8657,6905.0,13,was,2,1,6,5,0,6,1,4,De Leede,Dutch,-,per,PROPN-PROPN,ADJ,compound-nsubj,amod,NNP-NNP,JJ,2,1
8658,6906.0,31,ISLAMABAD,0,13,14,1,12,16,-13,14,President,Pervez Musharraf,org,-,PROPN,PROPN-PROPN,compound,compound-nsubj,NNP,NNP-NNP,1,1
8659,6907.0,45,made,1,7,42,35,6,2,-6,41,England,Six Nations Championship,per,--,PROPN,NUM-PROPN-PROPN,compound,compound-compound-pobj,NNP,CD-NNPS-NNP,11,1
8660,6909.0,28,donated,9,8,22,14,7,5,1,13,Doris Duke,New York,org-org,-,PROPN-PROPN,PROPN-PROPN,compound-conj,compound-compound,NNP-NNP,NNP-NNP,7,1
8661,6910.0,32,had,4,3,13,10,2,18,1,9,Japan,; Yasuo Fukud,org,--,PROPN,PUNCT-PROPN-PROPN,nsubj,punct-compound-appos,NNP,:-NNP-NNP,5,1
8662,6911.0,35,needed,11,8,11,3,7,23,3,0,Chinese,Sun,,per,ADJ,PROPN,amod,nsubj,JJ,NNP,1,1
8663,6912.0,27,moved,5,9,14,5,8,12,-4,9,United States,College of Southern Idaho,-,org-org-org-org,PROPN-PROPN,PROPN-ADP-PROPN-PROPN,compound-pobj,dobj-prep-compound-pobj,NNP-NNP,NNP-IN-NNP-NNP,5,1
8664,6916.0,50,were,6,16,26,10,15,23,-10,20,WBA,Riddick Bowe,,org-org,PROPN,PROPN-PROPN,pobj,compound-dobj,NNP,NNP-NNP,9,1
8665,6918.0,34,complained,9,1,4,3,0,29,8,-5,Minister,Joseph Korto,per,-,PROPN,PROPN-PROPN,nmod,compound-nsubj,NNP,NNP-NNP,2,1
8666,6919.0,29,incorporated,3,1,8,7,0,20,2,5,United Copper,F. Augustus Heinze,per-per,--,PROPN-PROPN,PROPN-PROPN-PROPN,compound-nsubjpass,nmod-compound-pobj,NNP-NNP,NNP-NNP-NNP,4,1
8667,6920.0,18,located,11,1,15,14,0,2,10,4,Mar Baselios College of Engineering and Technology,Trivandrum,------,per,PROPN-PROPN-PROPN-ADP-PROPN-CCONJ-PROPN,PROPN,compound-compound-nsubjpass-prep-pobj-cc-conj,compound,NNP-NNP-NNP-IN-NNP-CC-NNP,NNP,5,1
8668,6921.0,67,returned,26,5,23,18,4,43,21,-3,John Tyndall,National Party,-,per-per,PROPN-PROPN,PROPN-PROPN,compound-pobj,compound-pobj,NNP-NNP,NNP-NNP,11,1
8669,6923.0,71,proclaimed,1,18,23,5,17,47,-17,22,Reid,Canada,per,,PROPN,PROPN,conj,pobj,NNP,NNP,2,1
8670,6924.0,32,told,6,2,18,16,1,13,4,12,Interscope,Eminem,,per,PROPN,PROPN,compound,nsubj,NNP,NNP,9,1
8671,8211.0,40,produced,30,2,7,5,1,32,28,-23,Interscope,Eminem,org,,PROPN,PROPN,nsubj,poss,NNP,NNP,4,1
8672,6928.0,26,was,1,1,24,23,0,1,0,23,Washington,Continental Army,org,-,PROPN,PROPN-PROPN,nsubj,compound-pobj,NNP,NNP-NNP,8,1
8673,7094.0,35,is,2,8,10,2,7,24,-6,8,Washington,Continental Army,,org-org,PROPN,PROPN-PROPN,poss,compound-pobj,NNP,NNP-NNP,3,1
8674,8831.0,37,is,9,12,24,12,11,12,-3,15,Washington,Continental Army,per,-,PROPN,PROPN-PROPN,nsubj,compound-nsubj,NNP,NNP-NNP,4,1
8675,10003.0,42,were,13,31,36,5,30,5,-18,23,Washington,Continental Army,per,-,PROPN,PROPN-PROPN,nsubj,compound-dobj,NNP,NNP-NNP,2,1
8676,10529.0,32,considered,9,5,22,17,4,9,4,13,Washington,Continental Army,org,-,PROPN,PROPN-PROPN,pobj,compound-pobj,NNP,NNP-NNP,8,1
8677,12713.0,71,is,1,41,46,5,40,24,-40,45,Washington,Continental Army,per,-,PROPN,PROPN-PROPN,appos,compound-pobj,NNP,NNP-NNP,3,1
8678,6929.0,19,published,4,1,7,6,0,11,3,3,my Paper,1 June 2006,org-org,--,DET-PROPN,NUM-PROPN-NUM,poss-nsubjpass,nummod-pobj-nummod,PRP$-NNP,CD-NNP-CD,3,1
8679,6930.0,24,stands,2,1,14,13,0,9,1,12,Nick Griffin,England,per-per,,PROPN-PROPN,PROPN,compound-nsubj,pobj,NNP-NNP,NNP,7,1
8680,6932.0,25,is,8,18,22,4,17,2,-10,14,Bermuda Hogges,USL Second Division,org-org,--,PROPN-PROPN,PROPN-PROPN-PROPN,compound-pobj,compound-compound-pobj,NNP-NNP,NNP-NNP-NNP,3,1
8681,6933.0,23,named,4,11,20,9,10,2,-7,16,Treasury,George M. Bibb,per,--,PROPN,PROPN-PROPN-PROPN,pobj,compound-compound-ROOT,NNP,NNP-NNP-NNP,-1,1
8682,6934.0,18,is,5,1,17,16,0,0,4,12,Sabertooth Games,2001,per-per,,PROPN-PROPN,NUM,compound-nsubj,pobj,NNP-NNPS,CD,2,1
8683,6935.0,11,Music,0,3,6,3,2,4,-3,6,COC,Pepper Keenan,org,-,PROPN,PROPN-PROPN,compound,compound-pobj,NNP,NNP-NNP,4,1
8684,6936.0,49,ran,13,20,24,4,19,24,-7,11,Republican,Rod Grams,per,-,ADJ,PROPN-PROPN,amod,compound-pobj,JJ,NNP-NNP,2,1
8685,6937.0,14,was,4,10,12,2,9,1,-6,8,Prime Minister,Paul Martin,-,per-per,PROPN-PROPN,PROPN-PROPN,compound-compound,compound-pobj,NNP-NNP,NNP-NNP,2,1
8686,7047.0,33,sent,12,9,11,2,8,21,3,-1,Prime Minister,Paul Martin,-,org-org,PROPN-PROPN,PROPN-PROPN,compound-compound,compound-nsubj,NNP-NNP,NNP-NNP,1,1
8687,6939.0,14,is,2,9,11,2,8,2,-7,9,Listener,Dan Smith,,org-org,PROPN,PROPN-PROPN,pobj,compound-appos,NNP,NNP-NNP,1,1
8688,6941.0,32,moved,2,5,27,22,4,4,-3,25,Ottawa,Canadian Union of Public Employees,per,----,PROPN,PROPN-PROPN-ADP-PROPN-PROPN,pobj,compound-pobj-prep-compound-pobj,NNP,NNP-NNP-IN-NNP-NNPS,3,1
8689,6942.0,38,wrapped,8,33,36,3,32,1,-25,28,Sudan,Omar al-Bashir,per,-,PROPN,PROPN-PROPN,poss,compound-dobj,NNP,NNP-NNP,4,1
8690,8064.0,39,resumed,32,9,14,5,8,24,23,-18,Sudan,Omar al-Bashir,,org-org,PROPN,PROPN-PROPN,pobj,compound-pobj,NNP,NNP-NNP,3,1
8691,9686.0,58,spoke,12,10,11,1,9,46,2,-1,Sudan,Omar al-Bashir,org,-,PROPN,PROPN-PROPN,pobj,compound-pobj,NNP,NNP-NNP,2,1
8692,6943.0,22,manufactured,10,7,17,10,6,4,3,7,Gibson Guitar Corporation,Wurlitzer,--,org,PROPN-PROPN-PROPN,PROPN,compound-compound-pobj,compound,NNP-NNP-NNP,NNP,8,1
8693,6944.0,16,located,3,9,10,1,8,5,-6,7,Saint-Lambert,Quebec,,org,PROPN,PROPN,amod,compound,NNP,NNP,1,1
8694,6947.0,22,was,1,5,16,11,4,5,-4,15,Island,Pete Shelley,per,-,PROPN,PROPN-PROPN,compound,compound-dobj,NNP,NNP-NNP,3,1
8695,6949.0,37,offered,10,9,16,7,8,20,1,6,he,New York Botanical Garden,,per-per-per-per,PRON,PROPN-PROPN-PROPN-PROPN,nsubjpass,compound-compound-compound-pobj,PRP,NNP-NNP-NNP-NNP,5,1
8696,6950.0,44,tasked,17,9,9,0,8,34,8,-8,Japan Self-Defense Forces,Japan,--,org,PROPN-PROPN-PROPN,PROPN,compound-pobj-nsubjpass,compound,NNP-NNP-NNPS,NNP,0,1
8697,6951.0,59,is,41,27,33,6,26,25,14,-8,Essex Kent Scottish Regiment,Windsor,per-per-per-per,,PROPN-PROPN-PROPN-PROPN,PROPN,compound-compound-compound-pobj,compound,NNP-NNP-NNP-NNP,NNP,3,1
8698,6952.0,18,achieved,11,4,17,13,3,0,7,6,Deborah Cox,Canada,per-per,,PROPN-PROPN,PROPN,compound-compound,pobj,NNP-NNP,NNP,5,1
8699,6953.0,34,introduced,1,8,9,1,7,24,-7,8,War,Patrick J. Hurley,,per-per-per,PROPN,PROPN-PROPN-PROPN,pobj,compound-compound-dobj,NNP,NNP-NNP-NNP,2,1
8700,6954.0,120,is,5,14,119,105,13,0,-9,114,Mar Athanasius College of Engineering,1961,----,per,PROPN-PROPN-PROPN-ADP-PROPN,NUM,compound-compound-appos-prep-pobj,pobj,NNP-NNP-NNP-IN-NNP,CD,-1,1
8701,6955.0,11,headed,1,1,4,3,0,6,0,3,Tupper,Nova Scotia,,org-org,PROPN,PROPN-PROPN,nsubj,compound-compound,NNP,NNP-NNP,2,1
8702,8903.0,18,led,1,1,4,3,0,13,0,3,Tupper,Nova Scotia,per,-,PROPN,PROPN-PROPN,nsubj,compound-compound,NNP,NNP-NNP,1,1
8703,12608.0,29,was,8,2,15,13,1,13,6,7,Tupper,Nova Scotia,org,-,PROPN,PROPN-PROPN,nsubj,compound-compound,NNP,NNP-NNP,5,1
8704,6957.0,34,was,3,19,26,7,18,7,-16,23,Air Canada Centre,Maple Leaf Sports Entertainment,per-per-per,---,PROPN-PROPN-PROPN,PROPN-PROPN-PROPN-PROPN,compound-compound-conj,compound-compound-compound-compound,NNP-NNP-NNP,NNP-NNP-NNPS-NNP,9,1
8705,6958.0,37,reflected,1,15,30,15,14,6,-14,29,Kaupthing Bank,Iceland,per-per,,PROPN-PROPN,PROPN,compound-appos,pobj,NNP-NNP,NNP,8,1
8706,10914.0,39,announced,7,6,17,11,5,21,1,10,Kaupthing Bank,Iceland,org-org,,PROPN-PROPN,PROPN,compound-appos,poss,NNP-NNP,NNP,4,1
8707,6960.0,17,is,7,2,15,13,1,1,5,8,UCSF,San Francisco,org,-,PROPN,PROPN-PROPN,compound,compound-appos,NNP,NNP-NNP,5,1
8708,6961.0,17,was,1,1,8,7,0,8,0,7,Pratt,Brisbane Lions,,per-per,PROPN,PROPN-PROPN,nsubj,compound-pobj,NNP,NNP-NNPS,4,1
8709,6962.0,24,brings,2,10,11,1,9,12,-8,9,Ryanair,Holdings PLC,org,-,PROPN,PROPN-PROPN,compound,compound-pobj,NNP,NNPS-NNP,2,1
8710,6963.0,31,came,1,9,11,2,8,19,-8,10,Yanukovych,Party of Regions,org,--,PROPN,PROPN-ADP-PROPN,poss,nsubj-prep-pobj,NNP,NNP-IN-NNPS,3,1
8711,6964.0,26,is,1,17,18,1,16,7,-16,17,157th Air Refueling Wing,Air National Guard,per-per-per-per,--,ADJ-PROPN-PROPN-PROPN,PROPN-PROPN-PROPN,compound-compound-compound-compound,compound-compound-pobj,JJ-NNP-NNP-NNP,NNP-NNP-NNP,1,1
8712,6965.0,28,submitted,5,13,7,-6,12,20,-8,2,Kuomintang,his,,per,PROPN,DET,pobj,poss,NNP,PRP$,2,1
8713,6966.0,34,is,9,3,20,17,2,13,6,11,Turner Broadcasting,Cartoon Network,per-per,-,PROPN-PROPN,PROPN-PROPN,compound-pobj,compound-poss,NNP-NNP,NNP-NNP,7,1
8714,6967.0,19,spent,1,1,10,9,0,8,0,9,He,South Carolina,,per-per,PRON,PROPN-PROPN,nsubj,compound-pobj,PRP,NNP-NNP,5,1
8715,6968.0,53,include,6,14,23,9,13,29,-8,17,Stratford,Dayna Manning,per,-,PROPN,PROPN-PROPN,nsubj,compound-compound,NNP,NNP-NNP,-1,1
8716,6969.0,39,joined,3,3,9,6,2,29,0,6,he,Slovakia,,org,PRON,PROPN,nsubj,pobj,PRP,NNP,2,1
8717,6970.0,34,aired,3,20,20,0,19,13,-17,17,TVNZ 6,TVNZ,-,per,ADV-NUM,PROPN,appos-nummod,conj,RB-CD,NNP,0,1
8718,6973.0,19,More,0,6,13,7,5,5,-6,13,Kenya,Mwai Kibaki,org,-,PROPN,PROPN-PROPN,poss,compound-nsubjpass,NNP,NNP-NNP,7,1
8719,6974.0,29,believe,1,3,10,7,2,18,-2,9,her,California,per,,DET,PROPN,poss,poss,PRP$,NNP,6,1
8720,6975.0,30,aired,6,9,10,1,8,19,-3,4,SportsNet New York,New York Mets,org-org-org,--,PROPN-PROPN-PROPN,PROPN-PROPN-PROPN,compound-compound-pobj,compound-compound-conj,NNP-NNP-NNP,NNP-NNP-NNPS,1,1
8721,8505.0,43,hired,6,14,15,1,13,27,-8,9,SportsNet New York,New York Mets,--,org-org-org,PROPN-PROPN-PROPN,PROPN-PROPN-PROPN,compound-compound-pobj,compound-compound-poss,NNP-NNP-NNP,NNP-NNP-NNPS,1,1
8722,6976.0,34,2001,0,19,28,9,18,5,-19,28,Vertical Bore fMRI Magnet System,company,----,org,PROPN-PROPN-PROPN-PROPN-PROPN,NOUN,compound-compound-compound-compound-appos,poss,NNP-NNP-NNP-NNP-NNP,NN,6,1
8723,6977.0,61,affiliated,5,2,2,0,1,58,3,-3,Texas AgriLife Extension Service,Texas,---,per,PROPN-PROPN-PROPN-PROPN,PROPN,compound-compound-compound-compound,compound,NNP-NNP-NNP-NNP,NNP,0,1
8724,6978.0,19,attended,1,3,8,5,2,10,-2,7,Woodford County High School,Versailles,org-org-org-org,,PROPN-PROPN-PROPN-PROPN,PROPN,compound-compound-compound-dobj,pobj,NNP-NNP-NNP-NNP,NNP,5,1
8725,6979.0,40,became,9,8,21,13,7,18,1,12,Portuguese,Catherine of Braganza,,per-per-per,ADJ,PROPN-ADP-PROPN,amod,appos-prep-pobj,JJ,NNP-IN-NNP,10,1
8726,10210.0,32,acquired,3,22,24,2,21,7,-19,21,Portuguese,Catherine of Braganza,,org-org-org,ADJ,PROPN-ADP-PROPN,amod,appos-prep-pobj,JJ,NNP-IN-NNP,2,1
8727,6980.0,17,purchased,3,3,11,8,2,5,0,8,Vega,Boston,,per,PROPN,PROPN,nsubj,pobj,NNP,NNP,1,1
8728,6982.0,33,scheduled,2,9,29,20,8,3,-7,27,Ehud Barak,Israel,-,per,PROPN-PROPN,PROPN,compound-conj,compound,NNP-NNP,NNP,11,1
8729,6984.0,31,nominated,6,10,17,7,9,13,-4,11,Richard Nixon,United States,-,org-org,PROPN-PROPN,PROPN-PROPN,compound-pobj,compound-compound,NNP-NNP,NNP-NNP,7,1
8730,7965.0,34,was,5,8,15,7,7,18,-3,10,Richard Nixon,United States,per-per,-,PROPN-PROPN,PROPN-PROPN,compound-attr,compound-pobj,NNP-NNP,NNP-NNP,5,1
8731,6986.0,28,served,5,5,11,6,4,16,0,6,he,Salem,,per,PRON,PROPN,nsubj,compound,PRP,NNP,4,1
8732,6987.0,24,rooted,3,8,17,9,7,6,-5,14,Turner Broadcasting System,Ted Turner,org-org-org,-,PROPN-PROPN-PROPN,PROPN-PROPN,compound-compound-nsubjpass,compound-poss,NNP-NNP-NNP,NNP-NNP,5,1
8733,6988.0,36,emigrated,3,1,6,5,0,29,2,3,His,o Slovaki,org,-,DET,NOUN-PROPN,poss,ROOT-pobj,PRP$,NN-NNP,2,1
8734,6990.0,38,said,36,31,35,4,30,2,5,-1,Government Accountability Office,GAO,--,per,PROPN-PROPN-PROPN,PROPN,compound-compound-nsubj,appos,NNP-NNP-NNP,NNP,2,1
8735,6991.0,20,was,12,1,18,17,0,1,11,6,James Vincent,New York,-,per-per,PROPN-PROPN,PROPN-PROPN,compound-compound,compound-pobj,NNP-NNP,NNP-NNP,5,1
8736,6992.0,29,is,9,23,26,3,22,2,-14,17,Russian,Gazprom,,per,ADJ,PROPN,amod,nsubj,JJ,NNP,5,1
8737,6993.0,24,formed,18,1,14,13,0,9,17,-4,Statik Selektah,Massachusetts,per-per,,PROPN-PROPN,PROPN,compound-nsubjpass,pobj,NNP-NNP,NNP,6,1
8738,6994.0,25,boasted,9,1,4,3,0,20,8,-5,Pat Robertson,Regent University,org-org,-,PROPN-PROPN,PROPN-PROPN,compound-poss,compound-nsubj,NNP-NNP,NNP-NNP,1,1
8739,6996.0,39,held,5,8,20,12,7,18,-3,15,French Polynesia,Gaston Tong Sang,per-per,--,PROPN-PROPN,PROPN-PROPN-PROPN,amod-pobj,compound-compound-pobj,NNP-NNP,NNP-NNP-NNP,8,1
8740,12598.0,21,traveled,8,1,5,4,0,15,7,-3,French Polynesia,Gaston Tong Sang,-,org-org-org,PROPN-PROPN,PROPN-PROPN-PROPN,amod-poss,compound-compound-nsubj,NNP-NNP,NNP-NNP-NNP,3,1
8741,13983.0,36,party,8,2,5,3,1,30,6,-3,French Polynesia,Gaston Tong Sang,-,org-org-org,PROPN-PROPN,PROPN-PROPN-PROPN,amod-compound,compound-compound-poss,NNP-NNP,NNP-NNP-NNP,3,1
8742,6997.0,12,established,3,5,8,3,4,3,-2,5,Albert College,Belleville,-,per,PROPN-PROPN,PROPN,compound-dobj,compound,NNP-NNP,NNP,1,1
8743,7000.0,43,asked,15,6,11,5,5,31,9,-4,Queensland,University of Queensland,per,--,PROPN,PROPN-ADP-PROPN,compound,pobj-prep-pobj,NNP,NNP-IN-NNP,6,1
8744,7001.0,14,works,1,7,13,6,6,0,-6,12,Langara College,Canada,-,org,PROPN-PROPN,PROPN,compound-pobj,pobj,NNP-NNP,NNP,5,1
8745,7002.0,29,was,5,18,22,4,17,6,-13,17,Parachute Training School,HMAS Albatross,org-org-org,-,PROPN-PROPN-PROPN,PROPN-PROPN,compound-compound-conj,compound-pobj,NNP-NNP-NNP,NNP-NNP,2,1
8746,7003.0,19,is,6,2,18,16,1,0,4,12,Liberty University,Virginia,per-per,,PROPN-PROPN,PROPN,compound-dobj,pobj,NNP-NNP,NNP,8,1
8747,7004.0,13,was,1,6,7,1,5,5,-5,6,King,Henry II of England,org,---,PROPN,PROPN-PROPN-ADP-PROPN,compound,compound-appos-prep-pobj,NNP,NNP-NNP-IN-NNP,2,1
8748,12288.0,43,began,9,38,39,1,37,3,-29,30,King,Henry II of England,org,---,PROPN,PROPN-PROPN-ADP-PROPN,compound,compound-pobj-prep-pobj,NNP,NNP-NNP-IN-NNP,1,1
8749,7005.0,31,held,14,2,22,20,1,8,12,8,Philippines,University of the Philippines,per,---,PROPN,PROPN-ADP-DET-PROPN,compound,pobj-prep-det-compound,NNP,NNP-IN-DT-NNP,4,1
8750,7006.0,41,studied,1,1,16,15,0,24,0,15,He,Leningrad,org,,PRON,PROPN,nsubj,appos,PRP,NNP,6,1
8751,7007.0,36,arrested,11,11,13,2,10,22,0,2,Colombia,Gomez Gallo,per,-,PROPN,PROPN-PROPN,pobj,compound-dobj,NNP,NNP-NNP,1,1
8752,7009.0,25,came,7,7,15,8,6,9,0,8,Actress,Meena,,per,PROPN,PROPN,nsubj,pobj,NNP,NNP,5,1
8753,7010.0,24,comes,2,2,11,9,1,12,0,9,USA,Ryan Miller,org,-,PROPN,PROPN-PROPN,nsubj,compound-pobj,NNP,NNP-NNP,5,1
8754,7012.0,64,.,0,25,29,4,24,34,-25,29,NJ,St. Joseph High School,,per-per-per-per,PROPN,PROPN-PROPN-PROPN-PROPN,compound,compound-compound-compound-compound,NNP,NNP-NNP-NNP-NNP,-1,1
8755,7013.0,16,composed,4,2,11,9,1,4,2,7,TUP,Manila,per,,PROPN,PROPN,compound,compound,NNP,NNP,7,1
8756,7014.0,21,became,4,10,18,8,9,2,-6,14,Prime Minister,Yoshir Mor,-,org-org,PROPN-PROPN,PROPN-PROPN,compound-pobj,compound-compound,NNP-NNP,NNP-NNP,4,1
8757,7015.0,17,said,1,1,10,9,0,6,0,9,Grondona,South African Airways,,per-per-per,PROPN,PROPN-PROPN-PROPN,nsubj,compound-compound-pobj,NNP,NNP-NNP-NNPS,5,1
8758,7016.0,27,included,2,5,24,19,4,2,-3,22,Redding,Volt,per,,PROPN,PROPN,poss,compound,NNP,NNP,9,1
8759,7017.0,41,attended,12,15,32,17,14,8,-3,20,Virginia Military Institute,US Army,--,per-per,PROPN-PROPN-PROPN,PROPN-PROPN,compound-compound-dobj,compound-pobj,NNP-NNP-NNP,NNP-NNP,7,1
8760,7019.0,26,was,1,11,22,11,10,3,-10,21,Frida Kahlo,Mexico,-,org,PROPN-PROPN,PROPN,compound-compound,poss,NNP-NNP,NNP,5,1
8761,9535.0,36,obtained,4,9,34,25,8,1,-5,30,Frida Kahlo,Mexico,org-org,,PROPN-PROPN,PROPN,compound-pobj,compound,NNP-NNP,NNP,10,1
8762,7021.0,48,said,3,32,36,4,31,11,-29,33,British Midland Airways,bmi,--,org,PROPN-PROPN-PROPN,NOUN,compound-compound-conj,conj,NNP-NNP-NNP,NN,8,1
8763,7022.0,36,is,1,8,23,15,7,12,-7,22,Indiana Hoosiers,Bloomington,org-org,,PROPN-PROPN,PROPN,compound-nmod,compound,NNP-NNP,NNP,5,1
8764,7023.0,41,established,7,10,32,22,9,8,-3,25,University of Montenegro,1974,org-org-org,,PROPN-ADP-PROPN,NUM,ROOT-prep-pobj,npadvmod,NNP-IN-NNP,CD,-1,1
8765,7024.0,35,headlined,5,7,16,9,6,18,-2,11,Anaheim,Eden Espinosa,,per-per,PROPN,PROPN-PROPN,compound,compound-pobj,NNP,NNP-NNP,4,1
8766,7025.0,35,Spencer-Churchill,18,16,17,1,15,17,2,-1,Sir Winston Leonard Spencer-Churchill,Winston Churchill,org-org-org-org,-,PROPN-PROPN-PROPN-NOUN,PROPN-PROPN,compound-compound-appos-ROOT,compound-compound,NNP-NNP-NNP-NN,NNP-NNP,2,1
8767,7026.0,30,is,14,2,11,9,1,18,12,-3,University of Missouri,Columbia Regional Hospital,--,per-per-per,PROPN-ADP-PROPN,PROPN-PROPN-PROPN,nsubj-prep-nmod,compound-compound-appos,NNP-IN-NNP,NNP-NNP-NNP,4,1
8768,7027.0,41,said,6,14,39,25,13,1,-8,33,she,Erica Wright,per,-,PRON,PROPN-PROPN,nsubj,compound-attr,PRP,NNP-NNP,6,1
8769,7028.0,36,known,12,10,20,10,9,15,2,8,Frost,California,,per,PROPN,PROPN,pobj,conj,NNP,NNP,2,1
8770,7029.0,17,is,7,2,15,13,1,1,5,8,New England Review,Middlebury College,per-per-per,-,PROPN-PROPN-PROPN,PROPN-PROPN,compound-compound-nsubj,compound-pobj,NNP-NNP-NNP,NNP-NNP,6,1
8771,7030.0,15,is,9,3,14,11,2,0,6,5,University,Sweden,,per,PROPN,PROPN,nsubj,pobj,NNP,NNP,3,1
8772,10507.0,19,University,0,1,18,17,0,0,-1,18,University,Sweden,,org,PROPN,PROPN,ROOT,conj,NNP,NNP,4,1
8773,7031.0,14,born,2,1,13,12,0,0,1,11,He,Belgium,per,,PRON,PROPN,nsubjpass,pobj,PRP,NNP,2,1
8774,7033.0,33,is,8,1,21,20,0,11,7,13,Debbie Riddle,Representatives,per-per,,PROPN-PROPN,PROPN,compound-nsubj,pobj,NNP-NNP,NNPS,3,1
8775,7036.0,23,confused,14,1,3,2,0,19,13,-11,AccuWeather,Joel N. Myers,per,--,PROPN,PROPN-PROPN-PROPN,compound,compound-compound-nsubj,NNP,NNP-NNP-NNP,2,1
8776,11219.0,21,founded,2,1,7,6,0,13,1,5,AccuWeather,Joel N. Myers,per,--,PROPN,PROPN-PROPN-PROPN,nsubjpass,compound-compound-pobj,NNP,NNP-NNP-NNP,4,1
8777,7037.0,27,is,10,1,19,18,0,7,9,9,Roberto,WarCry,,org,PROPN,PROPN,nsubj,nsubj,NNP,NNP,5,1
8778,7038.0,41,grown,6,30,30,0,29,10,-24,24,Aberystwyth University,Aberystwyth,per-per,,PROPN-PROPN,PROPN,compound-compound,pobj,NNP-NNP,NNP,0,1
8779,7039.0,37,born,2,1,6,5,0,30,1,4,Schell,Austria,,org,PROPN,PROPN,nsubjpass,pobj,NNP,NNP,5,1
8780,7040.0,76,bet,2,56,71,15,55,4,-54,69,Radha Mitchell,Australia,-,per,PROPN-PROPN,PROPN,compound-pobj,pobj,NNP-NNP,NNP,2,1
8781,7041.0,33,established,7,15,23,8,14,9,-8,16,Daytona Beach,International Speedway Corporation,-,per-per-per,PROPN-PROPN,PROPN-PROPN-PROPN,compound-compound,compound-compound-pobj,NNP-NNP,NNP-NNP-NNP,8,1
8782,7042.0,21,concluded,1,10,12,2,9,8,-9,11,Toshiba,Atsutoshi Nishida,org,-,PROPN,PROPN-PROPN,compound,compound-nsubj,NNP,NNP-NNP,1,1
8783,7043.0,29,earned,1,1,12,11,0,16,0,11,He,Hawaii,org,,PRON,PROPN,nsubj,pobj,PRP,NNP,4,1
8784,7044.0,19,is,9,1,17,16,0,1,8,8,Marymount Academy,Quebec,-,per,PROPN-PROPN,PROPN,compound-nsubj,compound,NNP-NNP,NNP,4,1
8785,7045.0,21,installed,3,15,19,4,14,1,-12,16,Purdue University Calumet,Hammond,--,org,PROPN-PROPN-PROPN,PROPN,compound-compound-pobj,compound,NNP-NNP-NNP,NNP,8,1
8786,7049.0,40,established,30,4,29,25,3,10,26,-1,1908,university,,per,NUM,NOUN,nummod,pobj,CD,NN,5,1
8787,7051.0,32,is,7,1,1,0,0,30,6,-6,Gosford High School,Gosford,per-per-per,,PROPN-PROPN-PROPN,PROPN,compound-compound-nsubj,compound,NNP-NNP-NNP,NNP,0,1
8788,7052.0,46,was,11,18,34,16,17,11,-7,23,Australian Secret Intelligence Service,Australia,---,per,ADJ-PROPN-PROPN-PROPN,PROPN,compound-compound-compound-pobj,compound,JJ-NNP-NNP-NNP,NNP,-1,1
8789,7054.0,34,was,20,1,11,10,0,22,19,-9,Mitr Chaibancha,934 in Ph,-,per-per-per,PROPN-PROPN,NUM-ADP-PROPN,compound-nsubj,nummod-prep-compound,NNP-NNP,CD-IN-NNP,-1,1
8790,7057.0,33,named,9,15,22,7,14,10,-6,13,de San,Argentina,-,org,PROPN-PROPN,PROPN,nmod-pobj,dobj,NNP-NNP,NNP,1,1
8791,9622.0,30,crossed,15,14,20,6,13,9,1,5,de San,Argentina,-,org,PROPN-PROPN,PROPN,compound-pobj,pobj,NNP-NNP,NNP,9,1
8792,7058.0,36,led,3,16,31,15,15,4,-13,28,Chicago,Art Hodes,org,-,PROPN,NOUN-PROPN,pobj,compound-conj,NNP,NN-NNPS,-1,1
8793,7059.0,43,sailed,4,25,34,9,24,8,-21,30,his,Philippines,,per,DET,PROPN,poss,pobj,PRP$,NNPS,4,1
8794,8079.0,32,switch,11,2,31,29,1,0,9,20,his,Philippines,org,,DET,PROPN,poss,pobj,PRP$,NNP,9,1
8795,7060.0,28,is,8,1,11,10,0,16,7,3,John Fox,Australian water polo,-,org-org-org,PROPN-PROPN,ADJ-NOUN-NOUN,compound-nsubj,amod-compound-compound,NNP-NNP,JJ-NN-NN,4,1
8796,7061.0,32,stated,6,20,23,3,19,8,-14,17,Isaias Afewerki,Eritrean,per-per,,PROPN-PROPN,ADJ,compound-pobj,amod,NNP-NNP,JJ,5,1
8797,7062.0,27,managed,4,1,17,16,0,9,3,13,Ptolemy,her,,org,PROPN,DET,compound,poss,NNP,PRP$,4,1
8798,7063.0,19,located,4,1,11,10,0,7,3,7,Its,England,per,,DET,PROPN,poss,pobj,PRP$,NNP,3,1
8799,7066.0,23,represented,9,4,19,15,3,3,5,10,Florida State Seminoles,Division I,--,org-org,PROPN-PROPN-PROPN,PROPN-PRON,compound-compound-compound,pobj-nsubj,NNP-NNP-NNP,NNP-PRP,5,1
8800,7067.0,35,founded,9,1,7,6,0,27,8,-2,Norwegian Confederation of Trade Unions,LO,org-org-org-org-org,,PROPN-PROPN-ADP-PROPN-PROPN,PROPN,amod-nsubjpass-prep-compound-pobj,nsubjpass,NNP-NNP-IN-NNP-NNPS,NNP,2,1
8801,7068.0,36,started,1,1,19,18,0,16,0,18,He,Cairo,org,,PRON,PROPN,nsubj,pobj,PRP,NNP,4,1
8802,7069.0,42,signed,16,28,37,9,27,4,-12,21,Bow Wow,So So Def,-,per-per-per,PROPN-INTJ,ADV-ADV-PROPN,compound-intj,ROOT-advmod-compound,NNP-UH,RB-RB-NNP,2,1
8803,7070.0,53,had,26,32,43,11,31,9,-6,17,Italy,Luchino Visconti,,per-per,PROPN,PROPN-PROPN,pobj,compound-poss,NNP,NNP-NNP,7,1
8804,12929.0,27,won,2,12,25,13,11,1,-10,23,Italy,Luchino Visconti,org,-,PROPN,PROPN-PROPN,pobj,compound-conj,NNP,NNP-NNP,4,1
8805,7071.0,16,is,3,2,10,8,1,5,1,7,MedicAlert,1956,,org,PROPN,NUM,compound,pobj,NNP,CD,4,1
8806,7072.0,49,Elections,3,10,22,12,9,26,-7,19,Brown,Democratic,per,,PROPN,ADJ,nsubj,amod,NNP,JJ,2,1
8807,7073.0,31,formed,1,1,29,28,0,1,0,28,Claudia,Island,per,,PROPN,PROPN,nsubj,compound,NNP,NNP,-1,1
8808,7074.0,36,said,11,1,10,9,0,25,10,-1,Papua New Guinea,Michael Somare,org-org-org,-,PROPN-PROPN-PROPN,PROPN-PROPN,compound-compound-poss,compound-nsubj,NNP-NNP-NNP,NNP-NNP,4,1
8809,13943.0,35,have,22,5,28,23,4,6,17,6,Papua New Guinea,Michael Somare,--,per-per,PROPN-PROPN-PROPN,PROPN-PROPN,compound-compound-pobj,compound-pobj,NNP-NNP-NNP,NNP-NNP,8,1
8810,7075.0,31,reported,5,1,5,4,0,25,4,0,Russia,Aeroflot,org,,PROPN,PROPN,poss,nsubj,NNP,NNP,3,1
8811,7078.0,25,provided,1,1,20,19,0,4,0,19,AccessAir,Iowa,per,,PROPN,PROPN,nsubj,pobj,NNP,NNP,1,1
8812,7079.0,32,completed,2,7,16,9,6,15,-5,14,Welcomgroup Graduate School of Hotel Administration,WGSHA,-----,per,PROPN-PROPN-PROPN-ADP-PROPN-PROPN,PRON,compound-compound-pobj-prep-compound-pobj,compound,NNP-NNP-NNP-IN-NNP-NNP,PRP,6,1
8813,7080.0,35,was,1,17,34,17,16,0,-16,33,Rafferty,Australia,,per,PROPN,PROPN,npadvmod,pobj,NNP,NNP,7,1
8814,7081.0,16,graduated,1,4,4,0,3,11,-3,3,Hanover College,Hanover,org-org,,PROPN-PROPN,PROPN,compound-pobj,poss,NNP-NNP,NNP,0,1
8815,7082.0,36,constructs,12,4,4,0,3,31,8,-8,Georgia,Georgia Department of Transportation,per,---,PROPN,PROPN-PROPN-ADP-PROPN,pobj,compound-appos-prep-pobj,NNP,NNP-NNP-IN-NNP,0,1
8816,7085.0,23,is,2,13,20,7,12,2,-11,18,Jumeirah,United Arab Emirates,per,--,PROPN,PROPN-PROPN-PROPN,compound,compound-compound-pobj,NNP,NNP-NNP-NNPS,4,1
8817,7086.0,36,renamed,1,5,5,0,4,30,-4,4,Rothesay,Rothesay Netherwood School,,org-org-org,PROPN,PROPN-PROPN-PROPN,compound,compound-compound-attr,NNP,NNP-NNP-NNP,0,1
8818,7087.0,21,sponsored,2,5,14,9,4,6,-3,12,Allied Irish Bank,AIB,org-org-org,,PROPN-PROPN-PROPN,PROPN,compound-compound-pobj,compound,NNP-NNP-NNP,NNP,9,1
8819,7090.0,17,has,2,1,16,15,0,0,1,14,Air Burkina,Ouagadougou,org-org,,PROPN-PROPN,PROPN,compound-nsubj,pobj,NNP-NNP,NNP,2,1
8820,7092.0,33,takes,2,1,32,31,0,0,1,30,Golden Circle,Australia,-,per,PROPN-PROPN,PROPN,compound-nsubj,pobj,NNP-NNP,NNP,2,1
8821,7093.0,34,stepped,5,30,32,2,29,1,-25,27,Russia,Maria Butyrskaya,,per-per,PROPN,PROPN-PROPN,poss,compound-conj,NNP,NNP-NNP,2,1
8822,7095.0,63,gif,0,8,41,33,7,21,-8,41,United States,20th Special Forces Group,per-per,---,PROPN-PROPN,ADJ-PROPN-PROPN-PROPN,compound-appos,amod-compound-compound-ROOT,NNP-NNP,JJ-NNP-NNPS-NNP,-1,1
8823,7096.0,35,historian,1,1,33,32,0,1,0,32,Ohio,Robert Taft,org,-,PROPN,PROPN-PROPN,compound,compound-pobj,NNP,NNP-NNP,-1,1
8824,7097.0,33,receives,4,21,21,0,20,11,-17,17,Henry,Henry V of England,org,---,PROPN,PROPN-PROPN-ADP-PROPN,pobj,compound-appos-prep-pobj,NNP,NNP-NNP-IN-NNP,0,1
8825,7098.0,80,Institute,1,10,33,23,9,46,-9,32,Massachusetts,Harvard Medical School,,per-per-per,PROPN,PROPN-PROPN-PROPN,compound,compound-compound-conj,NNP,NNP-NNP-NNP,7,1
8826,7099.0,17,moved,1,9,13,4,8,3,-8,12,Maverick Films,Guy Oseary,per-per,-,PROPN-PROPN,PROPN-PROPN,compound-pobj,compound-pobj,NNP-NNP,NNP-NNP,3,1
8827,7100.0,33,provided,8,21,23,2,20,9,-13,15,Baku,Stepan Shahumyan,,per-per,PROPN,PROPN-PROPN,compound,compound-pobj,NNP,NNP-NNP,1,1
8828,7101.0,34,was,16,1,25,24,0,8,15,9,Pol Pot,Khmer Rouge,-,org-org,PROPN-PROPN,PROPN-PROPN,compound-nsubj,compound-dobj,NNP-NNP,NNP-NNP,4,1
8829,7102.0,21,made,1,11,3,-8,10,17,-10,2,Atlantic,his,per,,PROPN,DET,compound,poss,NNP,PRP$,5,1
8830,7104.0,43,Association,2,14,32,18,13,10,-12,30,International University of Business Agriculture and technology,IUBAT,per-per-per-per-per-per-per,,PROPN-PROPN-ADP-PROPN-PROPN-CCONJ-NOUN,NOUN,nmod-nmod-prep-pobj-nsubj-cc-conj,appos,NNP-NNP-IN-NNP-NNP-CC-NN,NN,6,1
8831,7105.0,31,culminated,1,9,17,8,8,13,-8,16,ABC Studios,Disney,-,org,PROPN-PROPN,PROPN,compound-pobj,compound,NNP-NNPS,NNP,10,1
8832,7107.0,33,Dossen,2,24,31,7,23,1,-22,29,Liberia,Arthur Barclay,,per-per,PROPN,PROPN-PROPN,pobj,compound-pobj,NNP,NNP-NNP,4,1
8833,7108.0,47,set,23,9,13,4,8,33,14,-10,American,Smagorinsky,org,,PROPN,PROPN,compound,nsubj,NNP,NNP,8,1
8834,7109.0,44,came,3,1,19,18,0,24,2,16,Ikea,Ingvar Kamprad,per,-,PROPN,PROPN-PROPN,poss,compound-appos,NNP,NNP-NNP,13,1
8835,7110.0,34,has,3,1,30,29,0,3,2,27,Great Western Bank,Sioux Falls,per-per-per,-,PROPN-PROPN-PROPN,PROPN-PROPN,compound-compound-nsubj,compound-compound,NNP-NNP-NNP,NNP-NNP,5,1
8836,7111.0,81,decided,66,5,21,16,4,59,61,-45,Di Pietro,Italy,-,org,PROPN-PROPN,PROPN,compound-conj,conj,NNP-NNP,NNP,9,1
8837,7113.0,30,Limited,15,2,18,16,1,11,13,3,The Walt Disney Company,Pixar Animation Studios,per-per-per-per,--,DET-PROPN-PROPN-PROPN,PROPN-PROPN-PROPN,det-compound-compound-nsubj,compound-compound-dobj,DT-NNP-NNP-NNP,NNP-NNP-NNPS,4,1
8838,7114.0,15,remarked,7,6,14,8,5,0,1,7,Thailand,Sundaravej,per,,PROPN,PROPN,pobj,dobj,NNP,NNP,2,1
8839,7116.0,49,came,2,10,12,2,9,36,-8,10,Qatar,Hamad bin Khalifa,org,--,PROPN,PROPN-PROPN-PROPN,pobj,compound-compound-compound,NNP,NNP-NNP-NNP,2,1
8840,7117.0,39,contacted,11,19,37,18,18,1,-8,26,Specialty,Little Richard,per,-,PROPN,PROPN-PROPN,compound,compound-pobj,NNP,NNP-NNP,12,1
8841,7119.0,69,was,2,41,45,4,40,23,-39,43,Kendall,England,,per,PROPN,PROPN,nsubj,pobj,NNP,NNP,-1,1
8842,7120.0,38,started,18,35,36,1,34,1,-17,18,member,Afa Anoa'i,,org-org,NOUN,PROPN-PROPN,compound,compound-pobj,NN,NNP-NNP,1,1
8843,7121.0,29,is,3,14,23,9,13,5,-11,20,Mos Def,Geffen,-,per,PROPN-PROPN,PROPN,compound-pobj,compound,NNP-NNP,NNP,7,1
8844,7122.0,28,is,13,2,25,23,1,2,11,12,Eastern Michigan Eagles,Ypsilanti,--,per,PROPN-PROPN-PROPN,PROPN,compound-compound-compound,compound,NNP-NNP-NNP,NNP,9,1
8845,7123.0,24,returned,4,4,20,16,3,3,0,16,he,Maldives,org,,PRON,PROPN,nsubj,pobj,PRP,NNP,7,1
8846,7124.0,47,was,20,8,17,9,7,29,12,-3,Block Communications,Buckeye CableSystem,org-org,-,PROPN-PROPN,PROPN-PROPN,compound-pobj,conj-pobj,NNP-NNP,NNP-NNP,4,1
8847,7125.0,20,commented,11,1,8,7,0,11,10,-3,Grant Woods,Arizona,per-per,,PROPN-PROPN,PROPN,compound-nsubj,pobj,NNP-NNP,NNP,2,1
8848,8742.0,13,agreed,11,1,5,4,0,7,10,-6,Grant Woods,Arizona,per-per,,PROPN-PROPN,PROPN,compound-nsubj,compound,NNP-NNP,NNP,2,1
8849,10602.0,31,said,19,22,28,6,21,2,-3,9,Grant Woods,Arizona,org-org,,PROPN-PROPN,PROPN,compound-nsubj,compound,NNP-NNP,NNP,4,1
8850,7126.0,53,proposes,2,51,52,1,50,0,-49,50,Dutch,Navy,org,,PROPN,PROPN,compound,pobj,NNP,NNP,2,1
8851,7127.0,14,are,4,4,8,4,3,5,0,4,SunExpress,Turkish Airlines,,org-org,PROPN,PROPN-PROPN,pobj,compound-attr,NNP,NNP-NNPS,2,1
8852,7128.0,78,interrupted,52,15,33,18,14,44,37,-19,Romania,Gheorghe Gheorghiu-Dej,per,-,PROPN,PROPN-PROPN,pobj,compound-pobj,NNP,NNP-NNP,7,1
8853,13536.0,33,become,2,16,31,15,15,1,-14,29,Romania,Gheorghe Gheorghiu-Dej,per,-,PROPN,PROPN-NOUN,pobj,compound-appos,NNP,NNP-NNS,4,1
8854,7129.0,42,strengthened,6,22,23,1,21,18,-16,17,Sellinger,School of Business and Management,per,----,PROPN,PROPN-ADP-PROPN-CCONJ-PROPN,compound,pobj-prep-pobj-cc-conj,NNP,NNP-IN-NNP-CC-NNP,1,1
8855,7130.0,50,teamed,3,2,14,12,1,35,1,11,1994,Endemol UK,org,-,NUM,PROPN-PROPN,pobj,compound-pobj,CD,NNP-NNP,6,1
8856,7131.0,23,went,5,16,22,6,15,0,-11,17,AFL Queensland,2000,-,org,PROPN-PROPN,NUM,compound-appos,pobj,NNP-NNP,CD,7,1
8857,7132.0,29,founded,16,1,21,20,0,7,15,5,Monmouth College,1853,org-org,,PROPN-PROPN,NUM,compound-nsubjpass,pobj,NNP-NNP,CD,2,1
8858,7133.0,24,known,6,2,22,20,1,1,4,16,University of West Florida,United States,---,per-per,PROPN-ADP-PROPN-PROPN,PROPN-PROPN,nmod-prep-pobj-nsubj,compound-pobj,NNP-IN-NNP-NNP,NNP-NNP,8,1
8859,7134.0,43,worked,3,2,21,19,1,21,1,18,Smithson,San Diego,,org-org,PROPN,PROPN-PROPN,nsubj,compound-pobj,NNP,NNP-NNP,7,1
8860,7135.0,18,recorded,8,7,13,6,6,4,1,5,Ella Fitzgerald,Capitol,org-org,,PROPN-PROPN,PROPN,compound-nsubj,compound,NNP-NNP,NNP,3,1
8861,7137.0,28,was,12,2,27,25,1,0,10,15,he,Richmond,org,,PRON,PROPN,nsubj,conj,PRP,NNP,2,1
8862,7138.0,31,It's,0,26,28,2,25,2,-26,28,Vivendi,Universal Music Group,,per-per-per,PROPN,PROPN-PROPN-PROPN,compound,compound-compound-conj,NNP,NNP-NNP-NNP,2,1
8863,11724.0,26,required,4,13,15,2,12,10,-9,11,Vivendi,Universal Music Group,,org-org-org,PROPN,PROPN-PROPN-PROPN,compound,compound-compound-compound,NNP,NNP-NNP-NNP,3,1
8864,7139.0,36,known,4,9,14,5,8,21,-5,10,her,Nicaragua,per,,DET,PROPN,poss,pobj,PRP$,NNP,6,1
8865,7142.0,36,Shimbun,2,26,34,8,25,1,-24,32,Taro Aso,House,-,per,PROPN-PROPN,PROPN,compound-nsubj,compound,NNP-NNP,NNP,6,1
8866,8313.0,20,decided,5,4,11,7,3,8,1,6,Taro Aso,House,-,org,PROPN-PROPN,PROPN,compound-nsubj,dobj,NNP-NNP,NNP,4,1
8867,7143.0,24,are,4,2,12,10,1,11,2,8,Air Force Falcons,United States Air Force Academy,--,org-org-org-org-org,PROPN-PROPN-PROPN,PROPN-PROPN-PROPN-PROPN-PROPN,compound-compound-nsubj,compound-compound-compound-compound-pobj,NNP-NNP-NNPS,NNP-NNP-NNP-NNP-NNP,6,1
8868,10181.0,23,represented,7,3,10,7,2,12,4,3,Air Force Falcons,United States Air Force Academy,per-per-per,----,PROPN-PROPN-PROPN,PROPN-PROPN-PROPN-PROPN-PROPN,compound-compound-compound,compound-compound-compound-compound-dobj,NNP-NNP-NNPS,NNP-NNP-NNP-NNP-NNP,5,1
8869,7144.0,30,known,4,1,1,0,0,28,3,-3,Las Vegas Transit,Las Vegas,org-org-org,-,PROPN-PROPN-PROPN,PROPN-PROPN,compound-compound-nsubj,compound-compound,NNP-NNP-NNP,NNP-NNP,0,1
8870,7145.0,19,is,4,1,17,16,0,1,3,13,Arkansas State University System,Jonesboro,---,per,PROPN-PROPN-PROPN-PROPN,PROPN,compound-compound-compound-poss,compound,NNP-NNP-NNP-NNP,NNP,6,1
8871,7147.0,22,was,0,10,15,5,9,6,-10,15,Chaim Weizmann,President,-,per,PROPN-PROPN,PROPN,compound-conj,appos,NNP-NNP,NNP,2,1
8872,7148.0,22,began,8,6,20,14,5,1,2,12,Los Angeles,Allan McCollum,-,per-per,PROPN-PROPN,PROPN-PROPN,compound-pobj,compound-conj,NNP-NNP,NNP-NNP,8,1
8873,7149.0,61,divided,10,6,49,43,5,11,4,39,Irving Oil,Saint John,org-org,-,PROPN-PROPN,PROPN-PROPN,compound-pobj,compound-compound,NNP-NNP,NNP-NNP,10,1
8874,7150.0,27,stars,1,8,11,3,7,15,-7,10,British,Tony Blair,,org-org,ADJ,PROPN-PROPN,amod,compound-pobj,JJ,NNP-NNP,2,1
8875,13318.0,22,called,6,2,5,3,1,16,4,-1,British,Tony Blair,org,-,ADJ,PROPN-PROPN,amod,compound-nsubj,JJ,NNP-NNP,2,1
8876,7151.0,36,reported,34,13,16,3,12,19,21,-18,Ne Win,Burma,per-per,,PROPN-PROPN,PROPN,compound-poss,compound,NNP-NNP,NNP,2,1
8877,7154.0,46,praised,7,2,30,28,1,15,5,23,Zack de la Rocha,Rage Against the Machine,org-org-org-org,---,NOUN-PROPN-X-PROPN,NOUN-ADP-DET-PROPN,compound-nmod-compound-compound,nsubj-prep-det-pobj,NN-NNP-FW-NNP,NN-IN-DT-NNP,5,1
8878,7155.0,32,is,7,16,19,3,15,12,-9,12,Army,USAR,org,,PROPN,PROPN,compound,appos,NNP,NNP,2,1
8879,7156.0,16,served,5,1,1,0,0,14,4,-4,Sault Ste. Marie,Sault Transit Services,per-per-per,--,PROPN-PROPN-PROPN,PROPN-PROPN-PROPN,compound-compound-nsubjpass,compound-compound-conj,NNP-NNP-NNP,NNP-NNP-NNPS,0,1
8880,7157.0,12,Faculty,3,1,10,9,0,1,2,7,Seoul National University,South Korea,per-per-per,-,PROPN-PROPN-PROPN,PROPN-PROPN,compound-compound-compound,compound-appos,NNP-NNP-NNP,NNP-NNP,2,1
8881,7158.0,29,left,5,7,25,18,6,3,-2,20,New York,his,-,org,PROPN-PROPN,DET,compound-dobj,poss,NNP-NNP,PRP$,9,1
8882,7160.0,28,released,5,2,11,9,1,16,3,6,France,Francis Cabrel,,per-per,PROPN,PROPN-PROPN,pobj,compound-nsubj,NNP,NNP-NNP,6,1
8883,7161.0,44,occupied,13,7,9,2,6,34,6,-4,UWCSEA,Dover,per,,PROPN,PROPN,poss,compound,NNP,NNP,2,1
8884,7162.0,50,slated,3,11,48,37,10,1,-8,45,United International Pictures,Universal Studios,--,per-per,PROPN-PROPN-PROPN,PROPN-PROPN,compound-compound-pobj,compound-pobj,NNP-NNP-NNPS,NNP-NNP,12,1
8885,7163.0,23,founded,6,14,21,7,13,1,-8,15,Rough Trade,The Libertines,-,per-per,PROPN-PROPN,DET-PROPN,compound-compound,det-dobj,NNP-NNP,DT-NNP,5,1
8886,13844.0,25,issued,4,3,13,10,2,11,1,9,Rough Trade,The Libertines,org-org,-,PROPN-PROPN,DET-PROPN,compound-nsubj,det-pobj,NNP-NNP,DT-NNP,-1,1
8887,14184.0,25,signed,2,5,15,10,4,9,-3,13,Rough Trade,The Libertines,-,per-per,PROPN-PROPN,DET-PROPN,compound-compound,det-dobj,NNP-NNP,DT-NNP,6,1
8888,7164.0,14,include,4,7,12,5,6,1,-3,8,St. Louis Community College,Forest Park,---,per-per,PROPN-PROPN-PROPN-PROPN,PROPN-PROPN,compound-compound-compound-dobj,compound-pobj,NNP-NNP-NNP-NNP,NNP-NNP,3,1
8889,7165.0,14,is,5,2,9,7,1,4,3,4,474th Tactical Fighter Wing,United States,per-per-per-per,-,ADJ-PROPN-PROPN-PROPN,PROPN-PROPN,compound-compound-compound-nsubj,compound-compound,JJ-NNP-NNP-NNP,NNP-NNP,5,1
8890,7166.0,35,stated,9,1,7,6,0,27,8,-2,Kerry Ganofsky,High Voltage Software,-,per-per-per,PROPN-PROPN,PROPN-PROPN-PROPN,compound-compound,compound-compound-pobj,NNP-NNP,NNP-NNP-NNP,5,1
8891,7167.0,39,had,15,8,22,14,7,16,7,7,Mexican League,Mexico,per-per,,PROPN-PROPN,PROPN,compound-pobj,compound,NNP-NNP,NNP,8,1
8892,7168.0,30,met,5,5,12,7,4,17,0,7,Ng,Singapore,org,,PROPN,PROPN,nsubj,pobj,NNP,NNP,3,1
8893,7169.0,19,had,7,1,5,4,0,13,6,-2,Altria Group,Philip Morris,per-per,-,PROPN-PROPN,PROPN-PROPN,compound-nsubj,compound-appos,NNP-NNP,NNP-NNP,1,1
8894,12122.0,19,owns,3,1,8,7,0,10,2,5,Altria Group,Philip Morris,per-per,-,PROPN-PROPN,PROPN-PROPN,compound-compound,compound-compound,NNP-NNP,NNP-NNP,7,1
8895,7170.0,33,released,2,8,20,12,7,12,-6,18,BMG Greece,Peggy Zina,org-org,-,PROPN-PROPN,PROPN-PROPN,compound-pobj,compound-appos,NNP-NNP,NNP-NNP,5,1
8896,7171.0,21,born,3,1,10,9,0,10,2,7,Candy Dulfer,Amsterdam,per-per,,PROPN-PROPN,PROPN,compound-nsubjpass,pobj,NNP-NNP,NNP,2,1
8897,7173.0,28,said,9,1,5,4,0,22,8,-4,T-Mobile,Deutsche Telekom,,org-org,NOUN,PROPN-PROPN,nummod,compound-compound,NN,NNP-NNP,3,1
8898,7174.0,19,closed,4,3,4,1,2,14,1,0,Issaquah-based,Costco,,per,PROPN,PROPN,compound,pobj,NNP,NNP,1,1
8899,7175.0,34,Smith,1,10,32,22,9,1,-9,31,Pressure,Australia,,org,PROPN,PROPN,appos,compound,NNP,NNP,7,1
8900,7176.0,14,serviced,4,1,12,11,0,1,3,8,Its,New York,,org-org,DET,PROPN-PROPN,poss,compound-pobj,PRP$,NNP-NNP,5,1
8901,7177.0,15,appeared,2,1,11,10,0,3,1,9,Big Hawk,Houston,org-org,,PROPN-PROPN,PROPN,compound-nsubj,nmod,NNP-NNP,NNP,4,1
8902,7180.0,48,returned,6,4,9,5,3,38,2,3,Roy D. Chapin,Hudson,per-per-per,,PROPN-PROPN-PROPN,PROPN,compound-compound-nsubj,pobj,NNP-NNP-NNP,NNP,3,1
8903,7183.0,21,spent,1,1,10,9,0,10,0,9,Groves,Minnesota,per,,NOUN,PROPN,nsubj,pobj,NNS,NNP,1,1
8904,7185.0,36,Tracks,0,21,29,8,20,6,-21,29,Penny Rimbaud,Crass Records,per-per,-,PROPN-PROPN,PROPN-PROPN,compound-pobj,compound-pobj,NNP-NNP,NNP-NNPS,3,1
8905,7186.0,27,were,23,6,8,2,5,18,17,-15,Gatineau,Marc Bureau,,per-per,PROPN,PROPN-PROPN,compound,compound-compound,NNP,NNP-NNP,1,1
8906,7187.0,92,were,5,30,35,5,29,56,-25,30,Roberto Formigoni,Lombardy,-,per,PROPN-PROPN,PROPN,compound-ROOT,pobj,NNP-NNP,NNP,3,1
8907,7270.0,47,formed,2,15,21,6,14,25,-13,19,Roberto Formigoni,Lombardy,-,per,PROPN-PROPN,PROPN,compound-conj,pobj,NNP-NNP,NNP,5,1
8908,7189.0,29,captured,4,10,14,4,9,14,-6,10,Mohamed Farrah Aidid,United Somali Congress,--,org-org-org,PROPN-PROPN-PROPN,PROPN-PROPN-PROPN,compound-compound-poss,compound-compound-pobj,NNP-NNP-NNP,NNP-NNP-NNP,3,1
8909,7190.0,29,is,10,1,5,4,0,23,9,-5,Minnesota Life College,MLC,org-org-org,,PROPN-PROPN-PROPN,PROPN,compound-compound-nsubj,conj,NNP-NNP-NNP,NNP,3,1
8910,7194.0,27,opened,7,1,2,1,0,24,6,-5,President,John Kufuor,,per-per,PROPN,PROPN-PROPN,compound,compound-nsubj,NNP,NNP-NNP,1,1
8911,7196.0,26,include,6,4,25,21,3,0,2,19,Golden Rule Airlines,Bishkek,--,per,PROPN-PROPN-PROPN,PROPN,compound-compound-pobj,pobj,NNP-NNP-NNPS,NNP,-1,1
8912,7197.0,15,played,2,2,13,11,1,1,0,11,Mountaineers,North Carolina,per,-,PROPN,PROPN-PROPN,nsubj,compound-pobj,NNPS,NNP-NNP,5,1
8913,7198.0,19,finalized,4,8,11,3,7,7,-4,7,1998,National Post,org,-,NUM,PROPN-PROPN,nummod,compound-conj,CD,NNP-NNP,3,1
8914,7200.0,14,compete,5,1,8,7,0,5,4,3,Obertas,Russian,per,,NOUN,ADJ,nsubj,amod,NNS,JJ,4,1
8915,7202.0,43,founded,3,1,6,5,0,36,2,3,Bond Wireless,Queensland,-,org,PROPN-PROPN,PROPN,compound-nsubjpass,compound,NNP-NNP,NNP,3,1
8916,7203.0,48,narrated,29,33,41,8,32,6,-4,12,David Attenborough,London,org-org,,PROPN-PROPN,PROPN,compound-pobj,pobj,NNP-NNP,NNP,7,1
8917,7204.0,42,produced,4,9,38,29,8,3,-5,34,he,Landlord,,per,PRON,PROPN,nsubj,ROOT,PRP,NNP,7,1
8918,7205.0,39,nominated,4,34,37,3,33,1,-30,33,South Carolina,Jim DeMint,per-per,-,PROPN-PROPN,PROPN-PROPN,compound-compound,compound-pobj,NNP-NNP,NNP-NNP,2,1
8919,7206.0,30,set,4,19,28,9,18,1,-15,24,Delhi,Kamaladevi Chattopadhyay,,per-per,PROPN,PROPN-PROPN,pobj,compound-pobj,NNP,NNP-NNP,4,1
8920,7207.0,19,were,14,6,13,7,5,5,8,-1,Peter Munk,Barrick Gold,org-org,-,PROPN-PROPN,PROPN-PROPN,compound-pobj,compound-pobj,NNP-NNP,NNP-NNP,3,1
8921,7208.0,18,described,6,8,12,4,7,5,-2,6,Australia,Mary MacKillop,,org-org,PROPN,PROPN-PROPN,poss,compound-appos,NNP,NNP-NNP,3,1
8922,7209.0,20,is,3,1,15,14,0,4,2,12,Simonds Catholic College,Melbourne,org-org-org,,VERB-PROPN-PROPN,PROPN,compound-compound-nsubj,compound,VBZ-NNP-NNP,NNP,8,1
8923,7210.0,19,serving,3,1,15,14,0,3,2,12,George,Housing and Urban Development,org,---,PROPN,PROPN-CCONJ-PROPN-PROPN,nsubj,pobj-cc-compound-conj,NNP,NNP-CC-NNP-NNP,7,1
8924,7213.0,35,released,1,19,22,3,18,12,-18,21,Philles Records,Phil Spector,org-org,-,PROPN-PROPN,PROPN-PROPN,compound-compound,compound-poss,NNPS-NNP,NNP-NNP,2,1
8925,9316.0,28,was,2,1,11,10,0,16,1,9,Philles Records,Phil Spector,per-per,-,PROPN-PROPN,PROPN-PROPN,compound-nsubj,compound-pobj,NNP-NNPS,NNP-NNP,5,1
8926,7214.0,39,Department,1,19,38,19,18,0,-18,37,School of Engineering,USA,per-per-per,,PROPN-ADP-PROPN,PROPN,nsubj-prep-pobj,pobj,NNP-IN-NNP,NNP,3,1
8927,7216.0,29,helped,5,2,26,24,1,2,3,21,Kummer,University of Breslau,,per-per-per,PROPN,PROPN-ADP-PROPN,poss,pobj-prep-pobj,NNP,NNP-IN-NNP,9,1
8928,7217.0,31,spend,4,23,26,3,22,4,-19,22,George Washington,Mount Vernon,per-per,-,PROPN-PROPN,PROPN-PROPN,compound-poss,compound-compound,NNP-NNP,NNP-NNP,4,1
8929,7218.0,41,represented,8,3,22,19,2,18,5,14,Kent State Golden Flashes,Division I,org-org-org-org,-,PROPN-PROPN-PROPN-PROPN,PROPN-NUM,compound-compound-compound-compound,ROOT-appos,NNP-NNP-NNP-NNPS,NNP-CD,-1,1
8930,7219.0,37,said,31,15,18,3,14,18,16,-13,Bio-Rad,Valdemoro,,org,PROPN,PROPN,compound,nsubj,NNP,NNP,3,1
8931,7220.0,29,featured,17,5,26,21,4,2,12,9,Dale Evans,Roy Rogers,-,org-org,PROPN-PROPN,PROPN-PROPN,compound-appos,compound-compound,NNP-NNP,NNP-NNP,5,1
8932,7222.0,19,represented,6,3,3,0,2,15,3,-3,Valparaiso,Valparaiso University,org,-,PROPN,PROPN-PROPN,compound,compound-dobj,NNP,NNP-NNP,0,1
8933,7223.0,16,attended,1,3,3,0,2,12,-2,2,Patna Science College,Patna University,per-per-per,-,PROPN-PROPN-PROPN,PROPN-PROPN,compound-compound-dobj,compound-pobj,NNP-NNP-NNP,NNP-NNP,0,1
8934,10750.0,14,at,0,7,7,0,6,6,-7,7,Patna Science College,Patna University,--,org-org,PROPN-PROPN-PROPN,PROPN-PROPN,compound-compound-pobj,compound-appos,NNP-NNP-NNP,NNP-NNP,0,1
8935,7224.0,12,was,3,9,10,1,8,1,-6,7,actress,Elizabeth Farren,,per-per,NOUN,PROPN-PROPN,compound,compound-pobj,NN,NNP-NNP,1,1
8936,7225.0,17,are,12,8,16,8,7,0,4,4,Vietnam,city,org,,PROPN,NOUN,pobj,pobj,NNP,NN,7,1
8937,7226.0,21,omitted,3,13,18,5,12,2,-10,15,Denmark,TV 2 Sport,per,--,PROPN,NOUN-NUM-PROPN,pobj,nmod-nummod-pobj,NNP,NN-CD-NNP,3,1
8938,7227.0,24,was,11,5,20,15,4,3,6,9,Sierra Leone,him,per-per,,PROPN-PROPN,PRON,compound-compound,dobj,NNP-NNP,PRP,11,1
8939,7228.0,32,began,11,18,31,13,17,0,-7,20,Combined Joint Task Force - Horn of Africa,Djibouti,-------,per,PROPN-PROPN-PROPN-PROPN-PUNCT-PROPN-ADP-PROPN,PROPN,compound-compound-compound-compound-punct-pobj-prep-pobj,pobj,NNP-NNP-NNP-NNP-HYPH-NNP-IN-NNP,NNP,6,1
8940,7230.0,34,Initiated,0,17,22,5,16,11,-17,22,University of the Basque Country,Bilbao,----,per,PROPN-ADP-DET-PROPN-PROPN,PROPN,pobj-prep-det-compound-pobj,compound,NNP-IN-DT-NNP-NNP,NNP,2,1
8941,7231.0,39,sought,4,14,14,0,13,24,-10,10,Hampton Normal,Hampton University,per-per,-,PROPN-PROPN,PROPN-PROPN,nmod-nmod,compound-appos,NNP-NNP,NNP-NNP,0,1
8942,7232.0,22,is,8,16,20,4,15,1,-8,12,Raiders,Gerald Myers,,per-per,PROPN,PROPN-PROPN,compound,compound-pobj,NNPS,NNP-NNP,3,1
8943,7233.0,19,attacked,14,5,13,8,4,5,9,-1,Infantry Division,2nd Division,per-per,-,PROPN-PROPN,PROPN-PROPN,compound-nsubj,compound-pobj,NNP-NNP,NNP-NNP,6,1
8944,7234.0,27,served,4,7,17,10,6,9,-3,13,Annapolis,United States Naval Academy,,per-per-per-per,PROPN,PROPN-PROPN-PROPN-PROPN,compound,compound-compound-compound-pobj,NNP,NNP-NNP-NNP-NNP,7,1
8945,7235.0,38,stayed,12,7,26,19,6,11,5,14,Jackson,Devon,per,,PROPN,PROPN,compound,compound,NNP,NNP,3,1
8946,7236.0,17,succeeded,2,6,16,10,5,0,-4,14,Jan,Czechoslovakia,org,,PROPN,PROPN,pobj,pobj,NNP,NNP,3,1
8947,7237.0,96,Leech,30,6,13,7,5,82,24,-17,Libertarian Party of Ohio,Mark Noble,---,per-per,PROPN-PROPN-ADP-PROPN,PROPN-PROPN,compound-pobj-prep-pobj,compound-pobj,NNP-NNP-IN-NNP,NNP-NNP,4,1
8948,7238.0,33,reports,2,8,10,2,7,22,-6,8,Liberia,Joseph Jenkins Roberts,org,--,PROPN,PROPN-PROPN-PROPN,pobj,compound-compound-conj,NNP,NNP-NNP-NNP,3,1
8949,7240.0,32,sought,12,2,7,5,1,24,10,-5,his,Australian Theatre for Young People,,per-per-per-per-per,DET,PROPN-PROPN-ADP-ADJ-PROPN,poss,compound-pobj-prep-compound-compound,PRP$,NNP-NNP-IN-JJ-NNPS,3,1
8950,7241.0,20,merged,7,2,11,9,1,8,5,4,1 January 2004,University of KwaZulu-Natal,per-per-per,--,NUM-PROPN-NUM,PROPN-ADP-PROPN,nummod-pobj-nummod,dobj-prep-pobj,CD-NNP-CD,NNP-IN-NNP,5,1
8951,7242.0,21,Use,2,1,19,18,0,1,1,17,Japan,Hitotsubashi University,org,-,PROPN,PROPN-PROPN,poss,compound-pobj,NNP,NNP-NNP,8,1
8952,7244.0,17,born,3,1,14,13,0,2,2,11,Riki Lindhome,Portville,-,org,PROPN-PROPN,PROPN,compound-nsubjpass,compound,NNP-NNP,NNP,5,1
8953,7245.0,38,traces,3,19,26,7,18,11,-16,23,Mashimo,Bee Train,per,-,PROPN,PROPN-PROPN,conj,compound-dobj,NNP,NNP-NNP,7,1
8954,7246.0,12,is,2,1,6,5,0,5,1,4,Kevin Smith,screenwriter,per-per,,PROPN-PROPN,NOUN,compound-nsubj,compound,NNP-NNP,NN,3,1
8955,7247.0,51,said,9,2,7,5,1,43,7,-2,GM,Frederick A. Henderson,,per-per-per,PROPN,PROPN-PROPN-PROPN,poss,compound-compound-appos,NNP,NNP-NNP-NNP,6,1
8956,7248.0,24,was,7,4,4,0,3,19,3,-3,Russian,Russian Liberation Army,org,--,ADJ,PROPN-PROPN-PROPN,amod,compound-compound-dobj,JJ,NNP-NNP-NNP,0,1
8957,7250.0,15,is,7,1,1,0,0,13,6,-6,Popular Action,Popular,per-per,,PROPN-PROPN,PROPN,amod-nsubj,appos,NNP-NNP,NNP,0,1
8958,7253.0,37,is,4,1,25,24,0,11,3,21,Trenton Central High School,New Jersey,---,org-org,PROPN-PROPN-PROPN-PROPN,PROPN-PROPN,compound-compound-compound-nsubj,compound-compound,NNP-NNP-NNP-NNP,NNP-NNP,10,1
8959,11408.0,38,is,5,1,26,25,0,11,4,21,Trenton Central High School,New Jersey,per-per-per-per,-,PROPN-PROPN-PROPN-PROPN,PROPN-PROPN,compound-compound-compound-compound,compound-compound,NNP-NNP-NNP-NNP,NNP-NNP,11,1
8960,7254.0,38,faced,2,1,17,16,0,20,1,15,He,President,,per,PRON,PROPN,nsubj,appos,PRP,NNP,5,1
8961,8529.0,25,elected,2,1,4,3,0,20,1,2,He,President,per,,PRON,PROPN,nsubjpass,oprd,PRP,NNP,2,1
8962,7255.0,21,was,13,1,15,14,0,5,12,2,Charles Proteus Steinmetz,a mathematicia,org-org-org,-,PROPN-PROPN-PROPN,DET-NOUN,compound-compound-nsubj,det-nmod,NNP-NNP-NNP,DT-NN,4,1
8963,7256.0,37,broadcast,22,2,25,23,1,11,20,3,Poland,Telewizja Polska,per,-,PROPN,PROPN-PROPN,nsubj,compound-pobj,NNP,NNP-NNP,5,1
8964,7258.0,34,compiled,11,8,24,16,7,9,3,13,Jaguars,Sun Belt,,per-per,PROPN,PROPN-PROPN,compound,compound-compound,NNP,NNP-NNP,7,1
8965,7259.0,23,coined,17,2,4,2,1,18,15,-13,Woodie Flowers,FIRST,-,per,PROPN-PROPN,PROPN,compound-nsubj,compound,NNP-NNPS,NNP,3,1
8966,7260.0,30,enjoyed,9,3,22,19,2,7,6,13,Indonesia,Indonesian air force,org,--,PROPN,ADJ-NOUN-NOUN,conj,amod-compound-compound,NNP,JJ-NN-NN,6,1
8967,7261.0,29,is,13,1,1,0,0,27,12,-12,Alan Skidmore,Alan Richard James Skidmore,-,per-per-per-per,PROPN-PROPN,PROPN-PROPN-PROPN-PROPN,compound-nsubj,compound-compound-compound-appos,NNP-NNP,NNP-NNP-NNP-NNP,0,1
8968,7262.0,26,found,7,10,15,5,9,10,-3,8,Crown College,Washington,per-per,,PROPN-PROPN,PROPN,compound-nsubj,compound,NNP-NNP,NNP,4,1
8969,7263.0,22,called,4,1,19,18,0,2,3,15,Christopher Dodd,University of Louisville,per-per,--,PROPN-PROPN,PROPN-ADP-PROPN,compound-nsubj,pobj-prep-pobj,NNP-NNP,NNP-IN-NNP,7,1
8970,7265.0,37,is,4,2,27,25,1,9,2,23,Redlight Children Campaign,2002,org-org-org,,PROPN-PROPN-PROPN,NUM,compound-compound-nsubj,pobj,NNP-NNP-NNP,CD,5,1
8971,7268.0,45,was,4,13,41,28,12,3,-9,37,f Bosnia and Herzegovin,nt Alija Izetbegov,---,org-org-org,X-PROPN-CCONJ-PROPN,ADP-PROPN-PROPN,intj-appos-cc-conj,advmod-compound-subtok,XX-NNP-CC-NNP,IN-NNP-NNP,-1,1
8972,7269.0,39,mandated,6,6,16,10,5,22,0,10,ISA,Iran,,org,PROPN,PROPN,nsubj,pobj,NNP,NNP,3,1
8973,7271.0,32,elected,2,1,6,5,0,25,1,4,He,Pennsylvania,,per,PRON,PROPN,nsubjpass,compound,PRP,NNP,3,1
8974,7272.0,15,attended,1,1,6,5,0,8,0,5,Gillard,Ohio,,org,PROPN,PROPN,nsubj,pobj,NNP,NNP,1,1
8975,7274.0,24,is,2,1,21,20,0,2,1,19,The Send,Tooth Nail Records,org-org,--,DET-PROPN,PROPN-PROPN-PROPN,det-nsubj,compound-compound-pobj,DT-NNP,NNP-NNP-NNPS,4,1
8976,7275.0,25,sang,4,3,24,21,2,0,1,20,Morris Albert,Brazil,per-per,,PROPN-PROPN,PROPN,compound-nsubj,pobj,NNP-NNP,NNP,9,1
8977,7276.0,55,After,0,32,36,4,31,18,-32,36,Max Bergmann,Kaiser Wilhelm Institute for Leather Research,org-org,-----,PROPN-PROPN,PROPN-PROPN-PROPN-ADP-PROPN-PROPN,compound-pobj,compound-compound-pobj-prep-compound-pobj,NNP-NNP,NNP-NNP-NNP-IN-NNP-NNP,3,1
8978,7277.0,14,was,4,1,11,10,0,2,3,7,The Broken Family Band,Cambridge,---,org,DET-PROPN-PROPN-PROPN,PROPN,det-compound-compound-nsubj,pobj,DT-NNP-NNP-NNP,NNP,6,1
8979,7278.0,43,faced,1,4,26,22,3,16,-3,25,Mexican,Juan Manuel,org,-,PROPN,PROPN-PROPN,compound,compound-pobj,NNP,NNP-NNP,8,1
8980,7280.0,55,moved,1,13,21,8,12,33,-12,20,Arkansas Razorbacks,Fayetteville,-,org,PROPN-PROPN,PROPN,compound-pobj,compound,NNP-NNP,NNP,6,1
8981,7281.0,22,led,12,3,19,16,2,2,9,7,Angola,Angolan Armed Forces,per,--,PROPN,PROPN-PROPN-PROPN,compound,compound-compound-pobj,NNP,NNP-NNP-NNPS,11,1
8982,7282.0,25,served,1,1,7,6,0,17,0,6,Shevardnadze,Georgia,per,,PROPN,PROPN,nsubj,poss,NNP,NNP,4,1
8983,7283.0,30,was,2,6,12,6,5,17,-4,10,Columbia,Springsteen,org,,PROPN,PROPN,compound,dobj,NNP,NNP,4,1
8984,7285.0,22,served,3,2,20,18,1,1,1,17,California,Art Pepper,per,-,PROPN,PROPN-PROPN,pobj,compound-pobj,NNP,NNP-NNP,5,1
8985,7286.0,15,are,4,2,2,0,1,12,2,-2,Grambling State Tigers,Grambling State University,per-per-per,--,PROPN-PROPN-PROPN,PROPN-PROPN-PROPN,compound-compound-nsubj,compound-compound-dobj,NNP-NNP-NNPS,NNP-NNP-NNP,0,1
8986,7288.0,26,put,4,9,16,7,8,9,-5,12,Indira Gandhi,Indian,-,org,PROPN-PROPN,PROPN,compound-pobj,compound,NNP-NNP,NNP,6,1
8987,7291.0,35,puts,2,1,4,3,0,30,1,2,His,Florida,,org,DET,PROPN,poss,compound,PRP$,NNP,4,1
8988,7292.0,23,1974,0,5,9,4,4,13,-5,9,Konstantinos Karamanlis,Athens,per-per,,PROPN-PROPN,PROPN,compound-nsubj,pobj,NNP-NNP,NNP,2,1
8989,7293.0,19,was,1,1,7,6,0,11,0,6,Louise,Wilton Welch,org,-,PROPN,PROPN-PROPN,nsubj,compound-pobj,NNP,NNP-NNP,3,1
8990,7295.0,48,organizes,4,2,19,17,1,28,2,15,PLM,Manila,,per,PROPN,PROPN,compound,compound,NNP,NNP,5,1
8991,7297.0,23,was,7,17,21,4,16,1,-10,14,Liberal Party,Dunedin,-,per,PROPN-PROPN,PROPN,compound-pobj,compound,NNP-NNP,NNP,4,1
8992,7299.0,38,charged,4,6,23,17,5,14,-2,19,Pom Wonderful,Los Angeles,org-org,-,PROPN-PROPN,PROPN-PROPN,compound-dobj,compound-pobj,NNP-NNP,NNP-NNP,7,1
8993,7300.0,16,produced,5,8,15,7,7,0,-3,10,Blue Bird,Georgia,per-per,,PROPN-PROPN,PROPN,compound-pobj,pobj,NNP-NNP,NNP,3,1
8994,7751.0,15,are,9,1,14,13,0,0,8,5,Blue Bird,Georgia,-,per,PROPN-PROPN,PROPN,compound-poss,pobj,NNP-NNP,NNP,3,1
8995,7301.0,42,is,10,16,16,0,15,25,-6,6,Florida National Guard,Florida,per-per-per,,PROPN-PROPN-PROPN,PROPN,compound-compound-pobj,pobj,NNP-NNP-NNP,NNP,0,1
8996,7303.0,17,played,1,12,16,4,11,0,-11,15,Memphis Maniax,XFL,per-per,,PROPN-PROPN,NOUN,compound-conj,pobj,NNP-NNP,NN,4,1
8997,7304.0,41,she's,18,1,10,9,0,30,17,-8,Carlile,Columbia,,org,PROPN,PROPN,poss,compound,NNP,NNP,4,1
8998,7308.0,39,was,30,9,27,18,8,11,21,-3,Ackerman,Windham Hill,org,-,PROPN,PROPN-PROPN,poss,compound-compound,NNP,NNP-NNP,7,1
8999,7490.0,11,ran,1,1,6,5,0,4,0,5,Ackerman,Windham Hill,per,-,PROPN,PROPN-PROPN,nsubj,compound-compound,NNP,NNP-NNP,2,1
9000,7309.0,14,Rui,0,1,13,12,0,0,-1,13,Rui En,Singapore,per-per,,PROPN-PROPN,PROPN,ROOT-nsubj,pobj,NNP-NNP,NNP,2,1
9001,7310.0,15,has,3,2,8,6,1,6,1,5,chain,Australia,per,,NOUN,PROPN,nsubj,pobj,NN,NNP,4,1
9002,7311.0,19,am,1,11,15,4,10,3,-10,14,Lincoln,Little Rock,org,-,PROPN,PROPN-PROPN,nsubj,compound-pobj,NNP,NNP-NNP,2,1
9003,7312.0,27,says,5,2,13,11,1,13,3,8,his,BSP,per,,DET,NOUN,poss,pobj,PRP$,NN,6,1
9004,7313.0,41,said,34,1,31,30,0,9,33,-3,Lukoil,Moscow,,org,PROPN,PROPN,nsubj,npadvmod,NNP,NNP,4,1
9005,7314.0,32,editor,4,1,6,5,0,25,3,2,The Real News,Paul Jay,--,per-per,DET-PROPN-PROPN,PROPN-PROPN,det-nmod-nmod,compound-appos,DT-NNP-NNP,NNP-NNP,3,1
9006,7316.0,23,taught,2,10,16,6,9,6,-8,14,Paris,Guy de Rothschild,per,--,PROPN,PROPN-X-PROPN,pobj,compound-nmod-pobj,NNP,NNP-FW-NNP,4,1
9007,7317.0,19,were,15,1,10,9,0,8,14,-5,Gusty Spence,UVF,per-per,,PROPN-PROPN,PROPN,compound-compound,pobj,NNP-NNP,NNP,3,1
9008,7318.0,25,served,1,6,8,2,5,16,-5,7,Bowdoin College,Brunswick,per-per,,PROPN-PROPN,PROPN,compound-compound,compound,NNP-NNP,NNP,1,1
9009,7319.0,19,is,1,7,15,8,6,3,-6,14,Democratic Action Party,Pakatan Rakyat,--,per-per,PROPN-PROPN-PROPN,PROPN-PROPN,amod-nmod-pobj,compound-compound,NNP-NNP-NNP,NNP-NNP,5,1
9010,7320.0,39,ble,6,14,36,22,13,2,-8,30,Visakhapatnam,Andhra Pradesh,per,-,PROPN,PROPN-PROPN,compound,compound-compound,NNP,NNP-NNP,6,1
9011,7321.0,41,lost,13,4,28,24,3,12,9,15,Chinese Super League,Shandong Luneng,per-per-per,-,PROPN-PROPN-PROPN,PROPN-PROPN,compound-compound-compound,compound-pobj,NNP-NNP-NNP,NNP-NNP,-1,1
9012,7322.0,34,comes,2,12,24,12,11,9,-10,22,University of Massachusetts,UMass,per-per-per,,PROPN-ADP-PROPN,PROPN,conj-prep-pobj,subtok,NNP-IN-NNP,NNP,3,1
9013,7323.0,37,was,16,1,32,31,0,4,15,16,Chiang Ching-kuo,Taiwan,per-per,,PROPN-PROPN,PROPN,compound-pobj,pobj,NNP-NNP,NNP,7,1
9014,7325.0,24,Graduated,0,3,7,4,2,16,-3,7,Vintage High School,Napa,--,per,PROPN-PROPN-PROPN,PROPN,compound-compound-pobj,compound,NNP-NNP-NNP,NNP,3,1
9015,7327.0,31,nicknamed,4,1,7,6,0,23,3,3,Doane College,Tigers,-,org,PROPN-PROPN,PROPN,compound-nmod,nsubj,NNP-NNP,NNPS,2,1
9016,7328.0,32,was,6,6,15,9,5,16,0,9,Borregaard,Orkla Group,per,-,PROPN,PROPN-PROPN,nsubj,compound-pobj,NNP,NNP-NNP,5,1
9017,7329.0,12,founded,3,1,10,9,0,1,2,7,ABU,Northern Nigeria,,per-per,PROPN,PROPN-PROPN,nsubjpass,compound-pobj,NNP,NNP-NNP,5,1
9018,7330.0,19,named,2,10,18,8,9,0,-8,16,Benito Mussolini,Empire,org-org,,PROPN-PROPN,PROPN,compound-pobj,pobj,NNP-NNP,NNP,5,1
9019,11595.0,84,identified,7,5,60,55,4,23,2,53,Benito Mussolini,Empire,-,per,PROPN-PROPN,PROPN,compound-nsubjpass,pobj,NNP-NNP,NNP,-1,1
9020,7331.0,16,played,2,8,15,7,7,0,-6,13,EuroHockey Nations Championship,Germany,--,per,PROPN-PROPN-PROPN,PROPN,compound-compound-pobj,pobj,NNP-NNPS-NNP,NNP,7,1
9021,9235.0,11,selected,1,5,10,5,4,0,-4,9,EuroHockey Nations Championship,Germany,--,per,PROPN-PROPN-PROPN,PROPN,compound-compound-pobj,pobj,NNP-NNPS-NNP,NNP,4,1
9022,7332.0,28,released,3,1,9,8,0,18,2,6,Epic,Randell,,org,PROPN,PROPN,compound,pobj,NNP,NNP,2,1
9023,7333.0,52,was,37,26,31,5,25,20,11,-6,Socialist Party,Partido Socialista,-,org-org,PROPN-PROPN,PROPN-PROPN,compound-dobj,compound-compound,NNP-NNP,NNP-NNP,6,1
9024,7334.0,42,renamed,13,22,33,11,21,8,-9,20,) by th,Taipei City,per-per-per,-,PUNCT-ADP-DET,PROPN-PROPN,punct-agent-pobj,nmod-nmod,-RRB--IN-PRP$,NNP-NNP,5,1
9025,7335.0,20,is,7,2,18,16,1,1,5,11,Anthony Jackson,London,-,per,PROPN-PROPN,PROPN,compound-nsubj,compound,NNP-NNP,NNP,5,1
9026,7336.0,26,written,8,7,24,17,6,1,1,16,Belgrade,?eljko Joksimovi,per,-,PROPN,PUNCT-NOUN,pobj,punct-npadvmod,NNP,.-NNS,-1,1
9027,7337.0,27,nicknamed,6,2,2,0,1,24,4,-4,Sierra Leone national football team,Sierra Leone,per-per-per-per-per,-,PROPN-PROPN-ADJ-NOUN-NOUN,PROPN-PROPN,nmod-nmod-amod-compound-nsubj,compound-pobj,NNP-NNP-JJ-NN-NN,NNP-NNP,0,1
9028,7338.0,39,was,15,1,1,0,0,37,14,-14,Dana Hill,Dana Lynne Goetz,per-per,--,PROPN-PROPN,PROPN-PROPN-PROPN,compound-nsubj,compound-compound-dobj,NNP-NNP,NNP-NNP-NNP,0,1
9029,7340.0,24,is,2,15,21,6,14,2,-13,19,The Prodigy,Cooking Vinyl,per-per,-,DET-PROPN,PROPN-PROPN,det-appos,compound-compound,DT-NNP,NNP-NNP,7,1
9030,7341.0,32,referred,7,4,27,23,3,4,3,20,Central Philippine University,Jaro District,org-org-org,-,PROPN-PROPN-PROPN,PROPN-PROPN,compound-compound-nsubj,compound-compound,NNP-NNP-NNP,NNP-NNP,8,1
9031,7343.0,20,is,1,1,19,18,0,0,0,18,Constans,Constantine,org,,PROPN,PROPN,nsubj,pobj,NNPS,NNP,1,1
9032,7344.0,28,moved,5,2,8,6,1,19,3,3,University of Northern Colorado,Division I,per-per-per-per,-,PROPN-ADP-PROPN-PROPN,PROPN-PRON,nsubj-prep-compound-pobj,pobj-nsubj,NNP-IN-NNP-NNP,NNP-PRP,3,1
9033,7345.0,33,shook,9,1,8,7,0,24,8,-1,Panasonic,Seiichiro Sano,org,-,PROPN,PROPN-PROPN,amod,compound-conj,NNP,NNP-NNP,2,1
9034,7346.0,18,is,5,7,11,4,6,6,-2,6,Tobias Eigen,Kabissa,org-org,,PROPN-PROPN,PROPN,compound-attr,dobj,NNP-NNP,NNP,3,1
9035,7348.0,32,enjoyed,11,1,2,1,0,29,10,-9,John Sykes,Sykes Enterprises,-,per-per,PROPN-PROPN,PROPN-PROPN,compound-compound,compound-pobj,NNP-NNP,NNP-NNP,1,1
9036,7349.0,60,lived,1,9,15,6,8,44,-8,14,Olivia White,Hood College,-,org-org,PROPN-PROPN,PROPN-PROPN,compound-compound,compound-pobj,NNP-NNP,NNP-NNP,5,1
9037,7350.0,19,is,1,6,15,9,5,3,-5,14,Humboldt State University,California State University,per-per-per,--,PROPN-PROPN-PROPN,PROPN-PROPN-PROPN,compound-compound-pobj,compound-compound-compound,NNP-NNP-NNP,NNP-NNP-NNP,7,1
9038,9810.0,28,is,6,1,15,14,0,12,5,9,Humboldt State University,California State University,--,org-org-org,PROPN-PROPN-PROPN,PROPN-PROPN-PROPN,compound-compound-nsubj,compound-compound-compound,NNP-NNP-NNP,NNP-NNP-NNP,5,1
9039,7351.0,42,suspended,6,10,15,5,9,26,-4,9,Madrid,Endesa,,per,PROPN,PROPN,nmod,poss,NNP,NNP,7,1
9040,7352.0,19,brought,2,1,11,10,0,7,1,9,Prowse,Bristol,,per,PROPN,PROPN,nsubjpass,pobj,NNP,NNP,2,1
9041,7353.0,16,is,11,1,14,13,0,1,10,3,Cassidy,American,,per,PROPN,ADJ,compound,amod,NNP,JJ,3,1
9042,7354.0,25,Career,1,8,19,11,7,5,-7,18,Records,Sheryl Crow,per,-,PROPN,PROPN-PROPN,pobj,compound-compound,NNP,NNP-NNP,7,1
9043,7355.0,26,is,2,1,11,10,0,14,1,9,RHB Capital,Malaysia,per-per,,PROPN-PROPN,PROPN,compound-nsubj,pobj,NNP-NNP,NNP,3,1
9044,7358.0,53,were,3,8,26,18,7,26,-5,23,Ron Braunstein,Necro,per-per,,PROPN-PROPN,PROPN,conj-nsubj,conj,NNP-NNP,NNP,5,1
9045,7360.0,46,said,5,10,14,4,9,31,-5,9,Central Intelligence Agency,CIA,org-org-org,,PROPN-PROPN-PROPN,PROPN,compound-compound-nmod,appos,NNP-NNP-NNP,NNP,2,1
9046,7361.0,18,attended,2,4,17,13,3,0,-2,15,Boston Grammar School,Lincolnshire,org-org-org,,PROPN-PROPN-PROPN,PROPN,compound-compound-dobj,pobj,NNP-NNP-NNP,NNP,3,1
9047,7362.0,28,interviewed,4,6,20,14,5,7,-2,16,They Might Be Giants,John Flansburgh,---,per-per,PRON-VERB-VERB-PROPN,PROPN-PROPN,dobj-aux-ROOT-attr,compound-nsubj,PRP-MD-VB-NNPS,NNP-NNP,4,1
9048,7363.0,50,giving,25,9,14,5,8,35,16,-11,Pete Wentz,Fueled by Ramen,-,org-org-org,PROPN-PROPN,PROPN-ADP-PROPN,compound-poss,pobj-agent-compound,NNP-NNP,NNP-IN-NNP,4,1
9049,7364.0,20,been,2,10,19,9,9,0,-8,17,National Post,1998,org-org,,PROPN-PROPN,NUM,compound-pobj,pobj,NNP-NNP,CD,7,1
9050,7365.0,36,1976,0,3,8,5,2,27,-3,8,Chiang Ching-kuo,Kuomintang,-,org,PROPN-PROPN,PROPN,compound-nummod,compound,NNP-NNP,NNP,5,1
9051,8348.0,47,educated,12,1,5,4,0,41,11,-7,Chiang Ching-kuo,Kuomintang,-,per,PROPN-PROPN,PROPN,compound-nsubj,compound,NNP-NNP,NNP,3,1
9052,7366.0,26,reformed,2,9,22,13,8,3,-7,20,RAF Germany,No. 1 Group RAF,-,org-org-org-org,PROPN-PROPN,PROPN-NUM-PROPN-PROPN,compound-dobj,nmod-nummod-compound-pobj,NNP-NNP,NNP-CD-NNP-NNP,9,1
9053,7367.0,31,emigrated,6,10,3,-7,9,27,-4,-3,United States,Thomas Jefferson High School,org-org,---,PROPN-PROPN,PROPN-PROPN-PROPN-PROPN,compound-pobj,compound-compound-compound-pobj,NNP-NNP,NNP-NNP-NNP-NNP,5,1
9054,7369.0,33,probed,8,13,23,10,12,9,-5,15,Huang Guangyu,Gome Electrical Appliances,per-per,--,PROPN-PROPN,PROPN-PROPN-PROPN,compound-pobj,compound-compound-compound,NNP-NNP,NNP-NNP-NNPS,4,1
9055,8366.0,39,BEIJING,0,8,13,5,7,25,-8,13,Huang Guangyu,Gome Electrical Appliances,-,per-per-per,PROPN-PROPN,PROPN-PROPN-PROPN,compound-nsubj,compound-compound-compound,NNP-NNP,NNP-NNP-NNPS,4,1
9056,9660.0,37,told,32,1,13,12,0,23,31,-19,Huang Guangyu,Gome Electrical Appliances,per-per,--,PROPN-PROPN,PROPN-PROPN-PROPN,compound-poss,compound-compound-pobj,NNP-NNP,NNP-NNP-NNPS,7,1
9057,11032.0,29,conducting,3,8,14,6,7,14,-5,11,Huang Guangyu,Gome Electrical Appliances,per-per,--,PROPN-PROPN,PROPN-PROPN-PROPN,compound-pobj,compound-compound-compound,NNP-NNP,NNP-NNP-NNPS,2,1
9058,12931.0,44,told,39,1,9,8,0,34,38,-30,Huang Guangyu,Gome Electrical Appliances,per-per,--,PROPN-PROPN,PROPN-PROPN-PROPN,compound-poss,compound-compound-pobj,NNP-NNP,NNP-NNP-NNPS,6,1
9059,7371.0,36,chose,3,8,13,5,7,22,-5,10,Guinea,Ahmed,org,,PROPN,PROPN,nsubj,pobj,NNP,NNP,4,1
9060,7372.0,27,formed,5,18,24,6,17,2,-13,19,John D. Rockefeller,Standard Oil,org-org-org,-,PROPN-PROPN-PROPN,PROPN-PROPN,compound-compound-pobj,compound-compound,NNP-NNP-NNP,NNP-NNP,6,1
9061,7373.0,32,won,8,25,31,6,24,0,-17,23,Brian Viloria,Hawaii,org-org,,PROPN-PROPN,PROPN,compound-pobj,pobj,NNP-NNP,NNP,7,1
9062,7374.0,27,commemorated,4,2,14,12,1,12,2,10,Japan,f Empress Kj,,org-org-org,PROPN,X-PROPN-PROPN,pobj,det-compound-compound,NNP,XX-NNP-NNP,6,1
9063,7376.0,54,operated,14,17,25,8,16,28,-3,11,Imperial College Healthcare NHS Trust,Charing Cross Hospital,per-per-per-per-per,--,PROPN-PROPN-PROPN-PROPN-PROPN,PROPN-PROPN-PROPN,compound-compound-compound-compound-pobj,nmod-nmod-compound,NNP-NNP-NNP-NNP-NNP,NNP-NNP-NNP,6,1
9064,7377.0,46,noted,1,32,40,8,31,5,-31,39,Maurice White,Chicago,org-org,,PROPN-PROPN,PROPN,compound-pobj,pobj,NNP-NNP,NNP,4,1
9065,7379.0,38,utilised,10,7,16,9,6,21,3,6,USDOT,Federal Aviation Administration,org,--,PROPN,PROPN-PROPN-PROPN,pobj,compound-compound-nsubj,NNP,NNP-NNP-NNP,6,1
9066,7380.0,28,In,0,3,24,21,2,3,-3,24,BJP-led National Democratic Alliance,PMK,---,per,ADJ-PROPN-PROPN-PROPN,PROPN,nmod-nmod-compound-nmod,conj,JJ-NNP-NNP-NNP,NNP,-1,1
9067,7382.0,28,On,0,7,21,14,6,6,-7,21,Albert Roberts,Shannon,-,per,PROPN-PROPN,PROPN,compound-pobj,nsubj,NNP-NNP,NNP,5,1
9068,7383.0,38,said,14,8,14,6,7,23,6,0,France,Havas,org,,PROPN,PROPN,poss,nsubj,NNP,NNP,3,1
9069,7384.0,43,was,7,31,14,-17,30,28,-24,7,CITIC,China,per,,PROPN,PROPN,compound,pobj,NNP,NNP,8,1
9070,7388.0,33,attacked,5,24,8,-16,23,24,-19,3,King,James I of Scotland,per,---,PROPN,PROPN-PRON-ADP-PROPN,compound,pobj-appos-prep-pobj,NNP,NNP-PRP-IN-NNP,4,1
9071,7391.0,13,was,5,7,12,5,6,0,-2,7,Joey Tempest,Europe,org-org,,PROPN-PROPN,PROPN,compound-attr,pobj,NNP-NNP,NNP,4,1
9072,7393.0,24,comes,2,14,16,2,13,7,-12,14,New Zealand,Massey University,-,per-per,PROPN-PROPN,PROPN-PROPN,compound-nmod,nmod-nmod,NNP-NNP,NNP-NNP,1,1
9073,7394.0,23,announced,4,4,18,14,3,4,0,14,Tebbit,State for Trade and Industry,,org-org-org-org-org,PROPN,PROPN-ADP-PROPN-CCONJ-PROPN,nsubj,pobj-prep-pobj-cc-conj,NNP,NNP-IN-NNP-CC-NNP,4,1
9074,7395.0,21,said,10,1,10,9,0,10,9,0,Seema,London,,org,PROPN,PROPN,compound,pobj,NNP,NNP,1,1
9075,7396.0,76,remains,6,16,33,17,15,42,-10,27,MOH,Ministry of Health,,org-org-org,PROPN,PROPN-ADP-PROPN,pobj,npadvmod-prep-pobj,NNP,NNP-IN-NNP,-1,1
9076,7400.0,30,In,0,17,23,6,16,6,-17,23,Aristide Briand,France,-,per,PROPN-PROPN,PROPN,compound-pobj,pobj,NNP-NNP,NNP,2,1
9077,7401.0,31,reported,4,3,10,7,2,20,1,6,Yedioth Ahronoth,Israel,org-org,,PROPN-PROPN,PROPN,compound-nsubj,nsubj,NNP-NNP,NNP,3,1
9078,7402.0,45,working,15,6,12,6,5,32,9,-3,Baltimore,Jane,,per,PROPN,PROPN,compound,pobj,NNP,NNP,5,1
9079,7403.0,34,assisted,14,7,21,14,6,12,7,7,National Disasters Management Institute,Mozambique,per-per-per-per,,PROPN-PROPN-PROPN-PROPN,PROPN,compound-compound-compound-appos,pobj,NNP-NNPS-NNP-NNP,NNP,6,1
9080,7404.0,47,based,9,8,32,24,7,14,1,23,Pakistan,f Nawaz Shari,,per-per-per,PROPN,X-PROPN-PROPN,pobj,det-compound-appos,NNP,XX-NNP-NNP,3,1
9081,7405.0,30,elected,12,10,14,4,9,15,2,2,States,Walker,,org,PROPN,PROPN,poss,dobj,NNPS,NNP,5,1
9082,7406.0,17,is,4,1,1,0,0,15,3,-3,London Buses,London,org-org,,PROPN-PROPN,PROPN,compound-nsubj,compound,NNP-NNPS,NNP,0,1
9083,7407.0,25,established,13,3,12,9,2,12,10,-1,Hugo Gernsback,Wonder Stories,org-org,-,PROPN-PROPN,PROPN-PROPN,compound-compound,compound-pobj,NNP-NNP,NNP-NNPS,4,1
9084,12563.0,13,sent,1,7,11,4,6,1,-6,10,Hugo Gernsback,Wonder Stories,-,per-per,PROPN-PROPN,PROPN-PROPN,compound-compound,compound-pobj,NNP-NNP,NNP-NNPS,3,1
9085,7408.0,110,IS,0,25,49,24,24,60,-25,49,magician,david copperfield,,per-per,NOUN,ADJ-ADJ,compound,amod-amod,NN,JJ-JJ,-1,1
9086,7409.0,32,joined,8,5,5,0,4,26,3,-3,Ohio,Ohio State University,per,--,PROPN,PROPN-PROPN-PROPN,compound,compound-compound-compound,NNP,NNP-NNP-NNP,0,1
9087,7411.0,41,announced,5,16,36,20,15,4,-11,31,Jamaica Defence Force,Up Park Camp,per-per-per,--,PROPN-PROPN-PROPN,PROPN-PROPN-PROPN,compound-compound-appos,compound-compound-pobj,NNP-NNP-NNP,NNP-NNP-NNP,9,1
9088,7413.0,24,is,3,7,22,15,6,1,-4,19,Christian and Missionary Alliance,New York,---,org-org,PROPN-CCONJ-PROPN-PROPN,PROPN-PROPN,nmod-cc-conj-conj,compound-pobj,NNP-CC-NNP-NNP,NNP-NNP,7,1
9089,7414.0,31,based,13,2,2,0,1,28,11,-11,Nebraska Kansas Colorado Railway,Nebraska,---,per,PROPN-PROPN-PROPN-PROPN,PROPN,compound-compound-compound-nsubjpass,compound,NNP-NNP-NNP-NNP,NNP,0,1
9090,7415.0,35,is,1,14,18,4,13,16,-13,17,f Serbi,r Mi?,-,org-org,X-PROPN,NOUN-PROPN,det-nsubj,appos-compound,XX-NNP,NN-NNP,4,1
9091,7416.0,18,attended,3,5,5,0,4,12,-2,2,Western Kentucky University,Western Kentucky Hilltoppers,org-org-org,--,PROPN-PROPN-PROPN,PROPN-PROPN-PROPN,compound-compound-dobj,compound-compound-compound,NNP-NNP-NNP,NNP-NNP-NNP,0,1
9092,7417.0,17,is,5,11,15,4,10,1,-6,10,American,George Strait,,per-per,ADJ,PROPN-PROPN,amod,compound-pobj,JJ,NNP-NNP,3,1
9093,7418.0,32,elected,2,7,13,6,6,18,-5,11,Chamber,Nilde Iotti,,org-org,PROPN,PROPN-PROPN,pobj,compound-dobj,NNP,NNP-NNP,5,1
9094,7420.0,6,acquits,2,1,4,3,0,1,1,2,Pakistan,ex-PM Sharif,,per-per,PROPN,PROPN-PROPN,compound,nummod-dobj,NNP,NNP-NNP,3,1
9095,7421.0,19,contact,1,13,15,2,12,3,-12,14,ACLU,Kansas,,per,PROPN,PROPN,conj,pobj,NNP,NNP,2,1
9096,7422.0,46,As,0,8,22,14,7,23,-8,22,Steven T. DeKosky,University of Virginia School of Medicine,org-org-org,-----,PROPN-PROPN-PROPN,PROPN-ADP-PROPN-PROPN-ADP-PROPN,compound-compound-nsubj,nmod-prep-pobj-pobj-prep-pobj,NNP-NNP-NNP,NNP-IN-NNP-NNP-IN-NNP,7,1
9097,7424.0,24,is,7,6,10,4,5,13,1,3,VMA-211,United States,,org-org,PROPN,PROPN-PROPN,appos,compound-compound,NNP,NNP-NNP,4,1
9098,7425.0,22,elected,2,5,19,14,4,2,-3,17,California,John V. Tunney,org,--,PROPN,PROPN-PROPN-PROPN,pobj,compound-compound-dobj,NNP,NNP-NNP-NNP,4,1
9099,7427.0,38,said,10,12,15,3,11,22,-2,5,Matthew Weiner,producer,per-per,,PROPN-PROPN,NOUN,compound-amod,nsubj,NNP-NNP,NN,2,1
9100,7428.0,37,adopting,15,12,36,24,11,0,3,21,SAARC,Kathmandu,,per,PROPN,PROPN,compound,pobj,NNP,NNP,2,1
9101,7429.0,29,made,7,1,5,4,0,23,6,-2,Mike Rann,South Australia,-,org-org,PROPN-PROPN,PROPN-PROPN,compound-compound,compound-compound,NNP-NNP,NNP-NNP,4,1
9102,7430.0,25,wrestled,5,13,24,11,12,0,-8,19,MEWF,Baltimore,org,,PROPN,PROPN,poss,pobj,NNP,NNP,8,1
9103,7431.0,22,founded,1,1,6,5,0,15,0,5,Kaiser Aluminum,1946,-,per,PROPN-PROPN,NUM,compound-dobj,pobj,NNP-NNP,CD,1,1
9104,7432.0,24,lectured,2,13,21,8,12,2,-11,19,Andrew Young School of Policy Studies,Georgia State University,-----,per-per-per,PROPN-PROPN-PROPN-ADP-PROPN-PROPN,PROPN-PROPN-PROPN,compound-compound-pobj-prep-compound-pobj,compound-compound-pobj,NNP-NNP-NNP-IN-NNP-NNPS,NNP-NNP-NNP,4,1
9105,7433.0,21,competed,9,8,16,8,7,4,1,7,Mustangs,Conference USA,org,-,PROPN,PROPN-PROPN,nsubj,pobj-nmod,NNPS,NNP-NNP,5,1
9106,11048.0,39,was,5,2,13,11,1,25,3,8,Mustangs,Conference USA,org,-,PROPN,PROPN-PROPN,poss,compound-compound,NNPS,NNP-NNP,4,1
9107,13771.0,27,represented,8,8,15,7,7,11,0,7,Mustangs,Conference USA,per,-,PROPN,PROPN-PROPN,nsubj,compound-compound,NNPS,NNP-NNP,3,1
9108,7434.0,15,became,5,4,11,7,3,3,1,6,Susan Hockfield,Massachusetts Institute of Technology,-,per-per-per-per,PROPN-PROPN,PROPN-PROPN-ADP-PROPN,compound-nsubj,compound-pobj-prep-pobj,NNP-NNP,NNP-NNP-IN-NNP,4,1
9109,7435.0,12,renamed,2,7,10,3,6,1,-5,8,152,RAF Fassberg,org,-,NUM,PROPN-PROPN,nummod,compound-conj,CD,NNP-NNP,3,1
9110,7436.0,21,named,7,5,12,7,4,8,2,5,Joss Whedon,Mutant Enemy Productions,-,per-per-per,PROPN-PROPN,PROPN-PROPN-PROPN,compound-conj,compound-compound-appos,NNP-NNP,NNP-NNP-NNPS,5,1
9111,7437.0,36,was,5,5,16,11,4,19,0,11,he,his,per,,PRON,DET,nsubj,poss,PRP,PRP$,5,1
9112,7438.0,28,wanted,9,8,15,7,7,12,1,6,Rodolfo Graziani,Italian Army,-,org-org,PROPN-PROPN,ADJ-PROPN,compound-conj,amod-appos,NNP-NNP,JJ-NNP,7,1
9113,7440.0,24,represent,9,2,18,16,1,5,7,9,Cornell Big Red,Division I,per-per-per,-,PROPN-PROPN-PROPN,PROPN-PRON,nmod-nmod-nmod,pobj-nmod,NNP-NNP-NNP,NNP-PRP,6,1
9114,7441.0,30,toured,3,7,18,11,6,11,-4,15,England,M.I.A.,per,,PROPN,PROPN,pobj,compound,NNP,NNP,4,1
9115,7442.0,30,was,3,12,19,7,11,10,-9,16,Florida,Jessicka,,org,PROPN,PROPN,pobj,compound,NNP,NNP,6,1
9116,7444.0,48,los,1,15,38,23,14,9,-14,37,Mexico City,Diego Rivera,per-per,-,PROPN-PROPN,PROPN-PROPN,compound-appos,compound-appos,NNP-NNP,NNP-NNP,11,1
9117,7446.0,26,used,15,4,9,5,3,16,11,-6,Government of Western Australia,Department of Environment and Conservation,per-per-per-per,----,PROPN-ADP-PROPN-PROPN,PROPN-ADP-PROPN-CCONJ-PROPN,pobj-prep-compound-poss,pobj-prep-pobj-cc-conj,NNP-IN-NNP-NNP,NNP-IN-NNP-CC-NNP,2,1
9118,7447.0,13,born,2,6,8,2,5,4,-4,6,Indiana,Joseph Jackson,org,-,PROPN,PROPN-PROPN,pobj,compound-pobj,NNP,NNP-NNP,1,1
9119,7448.0,22,recorded,3,6,19,13,5,2,-3,16,Dan,Black Mark,,per-per,PROPN,PROPN-PROPN,pobj,compound-compound,NNP,NNP-NNP,5,1
9120,7450.0,29,Bred,0,3,23,20,2,5,-3,23,Kentucky,Arthur B. Hancock,,per-per-per,PROPN,PROPN-PROPN-PROPN,pobj,compound-compound-compound,NNP,NNP-NNP-NNP,8,1
9121,7453.0,21,studied,1,17,19,2,16,1,-16,18,Jiwaji University,Gwalior,-,org,PROPN-PROPN,PROPN,compound-compound,compound,NNP-NNP,NNP,1,1
9122,11338.0,57,received,1,15,18,3,14,38,-14,17,Jiwaji University,Gwalior,-,org,PROPN-PROPN,PROPN,compound-pobj,compound,NNP-NNP,NNP,1,1
9123,7454.0,47,become,28,3,5,2,2,41,25,-23,German,Jonathan Meese,,per-per,ADJ,PROPN-PROPN,amod,compound-appos,JJ,NNP-NNP,2,1
9124,7455.0,21,is,7,11,15,4,10,5,-4,8,Dell,Alienware,,org,PROPN,PROPN,poss,pobj,NNP,NNP,4,1
9125,7456.0,32,dismissed,15,17,19,2,16,12,-2,4,Kadhafi,United States,per,-,PROPN,PROPN-PROPN,poss,compound-dobj,NNP,NNP-NNP,2,1
9126,7462.0,19,is,8,2,2,0,1,16,6,-6,Shanghai University,Shanghai,-,org,PROPN-PROPN,PROPN,compound-nsubj,compound,NNP-NNP,NNP,0,1
9127,7463.0,19,is,3,1,11,10,0,7,2,8,Eastbourne,East Sussex,,per-per,PROPN,PROPN-PROPN,nsubj,compound-pobj,NNP,NNP-NNP,4,1
9128,7465.0,18,Ndlovu,1,8,8,0,7,9,-7,7,Zimbabwe Congress of Trade Unions,Zimbabwe,----,per,PROPN-PROPN-ADP-PROPN-PROPN,PROPN,compound-appos-prep-compound-pobj,appos,NNP-NNP-IN-NNP-NNPS,NNP,0,1
9129,7466.0,29,attended,13,9,26,17,8,2,4,13,Jorgenson,farmer,,per,PROPN,NOUN,conj,attr,NNP,NN,11,1
9130,7467.0,47,installed,3,12,26,14,11,20,-9,23,Colchester,University,org,,PROPN,PROPN,poss,poss,NNP,NNP,12,1
9131,7468.0,21,released,8,3,7,4,2,13,5,-1,McClelland,Luke Doucet,,org-org,PROPN,PROPN-PROPN,nsubj,compound-appos,NNP,NNP-NNP,3,1
9132,7469.0,34,was,2,10,12,2,9,21,-8,10,NC State Wolfpack,Wolfpack,--,per,PROPN-PROPN-PROPN,PROPN,compound-compound-compound,dobj,NNP-NNP-NNP,NNP,3,1
9133,7470.0,17,reorganized,4,7,10,3,6,6,-3,6,UAL Corporation,United Airlines,-,org-org,PROPN-PROPN,PROPN-PROPN,compound-dobj,compound-pobj,NNP-NNP,NNP-NNP,2,1
9134,7473.0,15,acquired,4,2,7,5,1,7,2,3,company,EMC Corporation,per,-,NOUN,PROPN-PROPN,nsubjpass,compound-pobj,NN,NNP-NNP,3,1
9135,7474.0,52,had,7,7,26,19,6,25,0,19,Nino,Heaven Music,org,-,PROPN,PROPN-PROPN,pobj,compound-pobj,NNP,NNP-NNP,8,1
9136,7475.0,40,said,20,12,34,22,11,5,8,14,Angola,Fernando da Piedade Dias dos Santos,per,-----,PROPN,PROPN-PROPN-PROPN-PROPN-PROPN-PROPN,pobj,compound-compound-compound-compound-compound-pobj,NNP,NNP-NNP-NNP-NNP-NNP-NNP,9,1
9137,13650.0,29,called,2,1,19,18,0,9,1,17,Angola,Fernando da Piedade Dias dos Santos,,per-per-per-per-per-per,PROPN,PROPN-PROPN-PROPN-PROPN-VERB-PROPN,nsubj,compound-compound-compound-compound-compound-dobj,NNP,NNP-NNP-NNP-NNP-VBZ-NNP,5,1
9138,7477.0,28,be,8,20,23,3,19,4,-12,15,Economy and Finance,Giulio Tremonti,org-org-org,-,PROPN-CCONJ-PROPN,PROPN-PROPN,pobj-cc-conj,compound-nsubj,NNP-CC-NNP,NNP-NNP,6,1
9139,7479.0,32,maintains,5,2,18,16,1,13,3,13,United States Air Force,121st Air Refueling Wing,---,org-org-org-org,PROPN-PROPN-PROPN-PROPN,PROPN-PROPN-VERB-PROPN,compound-compound-compound-nsubj,compound-compound-compound-pobj,NNP-NNP-NNP-NNP,NNP-NNP-VBG-NNP,7,1
9140,7480.0,41,agreed,5,11,17,6,10,23,-6,12,Haggard,Capitol,,org,PROPN,PROPN,nsubj,conj,NNP,NNP,7,1
9141,7481.0,29,was,3,1,18,17,0,10,2,15,Eurocypria Airlines,Cyprus,-,org,PROPN-PROPN,PROPN,compound-compound,pobj,NNP-NNP,NNP,6,1
9142,7482.0,18,completed,2,10,16,6,9,1,-8,14,All India Institute of Medical Sciences,New Delhi,-----,org-org,PROPN-PROPN-PROPN-ADP-PROPN-PROPN,PROPN-PROPN,compound-compound-pobj-prep-compound-compound,compound-pobj,NNP-NNP-NNP-IN-NNP-NNPS,NNP-NNP,3,1
9143,7485.0,36,coached,5,12,16,4,11,19,-7,11,Division I,Florida Atlantic University,-,org-org-org,PROPN-PRON,PROPN-PROPN-PROPN,npadvmod-nsubj,compound-compound-pobj,NNP-PRP,NNP-NNP-NNP,4,1
9144,7489.0,23,performed,3,10,12,2,9,10,-7,9,Turkey,Kayahan,,per,PROPN,PROPN,poss,pobj,NNP,NNP,3,1
9145,7491.0,29,won,8,7,19,12,6,9,1,11,Thaksin Shinawatra,Thailand,-,per,PROPN-PROPN,PROPN,compound-pobj,poss,NNP-NNP,NNP,4,1
9146,7492.0,18,represents,7,3,3,0,2,14,4,-4,Indiana Hoosiers,Indiana University,-,per-per,PROPN-PROPN,PROPN-PROPN,compound-compound,compound-dobj,NNP-NNPS,NNP-NNP,0,1
9147,7493.0,22,tried,7,7,21,14,6,0,0,14,Gego,Venezuela,org,,PROPN,PROPN,nsubj,pobj,NNP,NNP,1,1
9148,7494.0,29,begins,2,1,14,13,0,14,1,12,Tech,Red Raiders,,per-per,NOUN,PROPN-PROPN,compound,compound-nsubj,NN,NNP-NNPS,3,1
9149,7495.0,114,involved,3,46,49,3,45,64,-43,46,Chief Executive,SBS,per-per,,PROPN-PROPN,PROPN,compound-pobj,pobj,NNP-NNP,NNP,5,1
9150,7496.0,61,include,43,12,13,1,11,47,31,-30,Army,3rd Infantry Division,per,--,PROPN,PROPN-PROPN-PROPN,compound,compound-compound-pobj,NNP,NNP-NNP-NNP,1,1
9151,7497.0,45,found,8,26,30,4,25,14,-18,22,Stockholm,Robyn,,per,PROPN,PROPN,conj,compound,NNP,NNP,8,1
9152,7498.0,22,studied,1,1,20,19,0,1,0,19,She,Puerto Rico,per,-,PRON,PROPN-PROPN,nsubj,compound-pobj,PRP,NNP-NNP,7,1
9153,7499.0,30,said,28,1,4,3,0,25,27,-24,Ivory Coast,Laurent Gbagbo,per-per,-,PROPN-PROPN,PROPN-PROPN,compound-compound,compound-nsubj,NNP-NNP,NNP-NNP,2,1
9154,7500.0,23,reserved,6,15,20,5,14,2,-9,14,Prime Minister,Mahathir bin Mohamad,org-org,--,PROPN-PROPN,PROPN-PROPN-PROPN,compound-nmod,compound-compound-pobj,NNP-NNP,NNP-NNP-NNP,2,1
9155,7501.0,35,recruited,12,11,17,6,10,17,1,5,Stewart,musician,,per,PROPN,NOUN,nsubjpass,pobj,NNP,NN,4,1
9156,7502.0,38,struggled,14,8,12,4,7,25,6,-2,Michael Joseph,Safaricom,org-org,,PROPN-PROPN,PROPN,compound-pobj,compound,NNP-NNP,NNP,2,1
9157,7503.0,28,led,18,3,21,18,2,6,15,3,Quebec,Jean-Jacques Bertrand,per,-,PROPN,PROPN-PROPN,compound,compound-pobj,NNP,NNP-NNP,7,1
9158,8060.0,31,established,17,16,25,9,15,5,1,8,Quebec,Jean-Jacques Bertrand,,per-per,PROPN,PROPN-PROPN,pobj,compound-pobj,NNP,NNP-NNP,7,1
9159,8083.0,18,defeated,8,2,16,14,1,1,6,8,Quebec,Jean-Jacques Bertrand,org,-,PROPN,PROPN-PROPN,compound,compound-pobj,NNP,NNP-NNP,8,1
9160,7504.0,29,introduced,7,10,13,3,9,15,-3,6,Ireland,Juniper,per,,PROPN,PROPN,pobj,compound,NNP,NNP,1,1
9161,7505.0,40,Wheeling,23,21,24,3,20,15,2,1,West Virginia,Wheeling Central Catholic High School,org-org,----,PROPN-PROPN,PROPN-PROPN-PROPN-PROPN-PROPN,compound-pobj,ROOT-compound-compound-compound-dobj,NNP-NNP,NNP-NNP-NNP-NNP-NNP,10,1
9162,7506.0,25,recruited,2,1,6,5,0,18,1,4,Fielke,West Adelaide,,org-org,PROPN,PROPN-PROPN,nsubjpass,compound-compound,NNP,NNP-NNP,4,1
9163,7508.0,46,was,5,5,18,13,4,27,0,13,Humphrey,Minnesota,per,,PROPN,PROPN,nsubj,pobj,NNP,NNP,3,1
9164,7509.0,27,left,1,1,25,24,0,1,0,24,Schumann,Adelaide,org,,PROPN,PROPN,nsubj,compound,NNP,NNP,8,1
9165,7510.0,51,played,2,8,28,20,7,22,-6,26,Hum,Eric Steckler,,org-org,PROPN,PROPN-PROPN,pobj,compound-appos,NNP,NNP-NNP,6,1
9166,7511.0,48,appear,13,1,12,11,0,35,12,-1,Ramush Haradinaj,Kosovo,-,per,PROPN-PROPN,PROPN,compound-nsubj,pobj,NNP-NNP,NNP,2,1
9167,7512.0,18,is,1,1,15,14,0,2,0,14,She,New York City,org,--,PRON,PROPN-PROPN-PROPN,nsubj,compound-compound-pobj,PRP,NNP-NNP-NNP,4,1
9168,7514.0,37,goes,1,25,32,7,24,4,-24,31,Hawker Siddeley,A.V. Roe Canada,-,org-org-org,PROPN-PROPN,PROPN-PROPN-PROPN,compound-compound,compound-compound-pobj,NNP-NNP,NNP-NNP-NNP,9,1
9169,7515.0,50,sworn,6,12,19,7,11,30,-6,13,Venezuela,Lusinchi,per,,PROPN,PROPN,pobj,nsubj,NNP,NNP,-1,1
9170,7516.0,48,remain,15,5,18,13,4,29,10,3,Orion,Warner Bros.,org,-,PROPN,PROPN-PROPN,poss,compound-pobj,NNP,NNP-NNPS,7,1
9171,7517.0,16,holds,2,10,15,5,9,0,-8,13,Lawrenceville School,NJ,org-org,,PROPN-PROPN,PROPN,compound-pobj,pobj,NNP-NNP,NNP,3,1
9172,7519.0,31,was,3,1,7,6,0,23,2,4,His,waitress,org,,DET,ADJ,poss,attr,PRP$,JJ,5,1
9173,7520.0,34,plans,6,15,22,7,14,11,-9,16,Limited,Fraser and Neave,,org-org-org,PROPN,PROPN-CCONJ-PROPN,pobj,pobj-cc-conj,NNP,NNP-CC-NNP,4,1
9174,7521.0,22,Viloria,0,1,3,2,0,18,-1,3,Viloria,Hawaii,per,,PROPN,PROPN,ROOT,compound,NNP,NNP,1,1
9175,7522.0,17,surrendered,5,11,16,5,10,0,-6,11,himself,Ukraine,,per,PRON,PROPN,nsubj,pobj,PRP,NNP,5,1
9176,7523.0,47,granted,9,1,6,5,0,40,8,-3,De La Salle University,DLSU-D,per-per-per-per,,PROPN-PROPN-PROPN-PROPN,PROPN,compound-compound-compound-nsubjpass,amod,NNP-NNP-NNP-NNP,NNP,3,1
9177,7525.0,33,celebrated,6,2,4,2,1,28,4,-2,1977,University of Houston System,per,---,NUM,PROPN-ADP-PROPN-PROPN,pobj,nmod-prep-pobj-dative,CD,NNP-IN-NNP-NNP,2,1
9178,7526.0,30,featured,18,11,17,6,10,12,7,-1,Colin MacInnes,London,org-org,,PROPN-PROPN,PROPN,compound-poss,compound,NNP-NNPS,NNP,3,1
9179,7527.0,51,noted,44,4,27,23,3,23,40,-17,President,Martti Ahtisaari,per,-,PROPN,PROPN-PROPN,attr,compound-attr,NNP,NNP-NNP,3,1
9180,7528.0,13,contributed,3,1,12,11,0,0,2,9,Its,Greece,org,,DET,PROPN,poss,pobj,PRP$,NNP,2,1
9181,7530.0,40,elected,8,2,24,22,1,15,6,16,United States,Richard Nixon,per-per,-,PROPN-PROPN,PROPN-PROPN,compound-compound,compound-appos,NNP-NNP,NNP-NNP,6,1
9182,7531.0,31,sold,3,9,21,12,8,9,-6,18,OfficeMax,OMX,per,,PROPN,PROPN,compound,appos,NNP,NNP,7,1
9183,7532.0,18,joined,1,5,8,3,4,9,-4,7,Jack Reed,Rhode Island,org-org,-,PROPN-PROPN,PROPN-PROPN,compound-dobj,compound-pobj,NNP-NNP,NNP-NNP,2,1
9184,7533.0,16,said,6,1,5,4,0,10,5,-1,Australian Federal Police,Mick Keelty,--,per-per,PROPN-PROPN-PROPN,PROPN-PROPN,amod-compound-compound,compound-nsubj,NNP-NNP-NNPS,NNP-NNP,2,1
9185,8299.0,43,Police,3,2,9,7,1,33,1,6,Australian Federal Police,Mick Keelty,per-per-per,-,PROPN-PROPN-PROPN,PROPN-PROPN,compound-compound-ROOT,compound-nsubj,NNP-NNP-NNP,NNP-NNP,-1,1
9186,7534.0,15,was,3,6,6,0,5,8,-3,3,Toronto,Toronto Transit Commission,per,--,PROPN,PROPN-PROPN-PROPN,compound,compound-compound-compound,NNP,NNP-NNP-NNP,0,1
9187,7535.0,37,felt,16,1,4,3,0,32,15,-12,Oliver Heaviside,England,-,per,PROPN-PROPN,PROPN,compound-nsubj,pobj,NNP-NNP,NNP,1,1
9188,7536.0,23,is,4,9,20,11,8,2,-5,16,Colorado Springs,American Numismatic Association,-,per-per-per,PROPN-PROPN,PROPN-PROPN-PROPN,compound-compound,compound-compound-pobj,NNP-NNP,NNP-NNP-NNP,9,1
9189,7537.0,26,elected,5,3,13,10,2,12,2,8,Ma Ying-jeou,KMT,per-per,,PROPN-PROPN,PROPN,compound-nsubjpass,pobj,NNP-NNP,NNP,7,1
9190,7538.0,14,attended,6,8,12,4,7,1,-2,6,Mendocino College,Ukiah,per-per,,PROPN-PROPN,PROPN,compound-dobj,compound,NNP-NNP,NNP,3,1
9191,7539.0,16,located,8,1,11,10,0,4,7,3,Valley Regional High School,Deep River,---,org-org,PROPN-PROPN-PROPN-PROPN,PROPN-PROPN,compound-compound-compound-nsubjpass,compound-compound,NNP-NNP-NNP-NNP,NNP-NNP,6,1
9192,7540.0,37,held,17,7,15,8,6,21,10,-2,Nigeria,Abubakar Tafawa Balewa,per,--,PROPN,PROPN-PROPN-PROPN,pobj,compound-compound-nsubj,NNP,NNP-NNP-NNP,-1,1
9193,9385.0,29,severed,15,5,11,6,4,17,10,-4,Nigeria,Abubakar Tafawa Balewa,org,--,PROPN,PROPN-PROPN-PROPN,nsubj,compound-conj-compound,NNP,NNP-NNP-NNP,6,1
9194,10795.0,29,is,1,6,20,14,5,8,-5,19,Nigeria,Abubakar Tafawa Balewa,,org-org-org,PROPN,PROPN-PROPN-PROPN,pobj,compound-compound-poss,NNP,NNP-NNP-NNP,4,1
9195,7542.0,18,collaborated,6,9,11,2,8,6,-3,5,Brooklyn,Yeasayer,,org,PROPN,PROPN,compound,pobj,NNP,NNP,2,1
9196,7543.0,17,am,1,11,16,5,10,0,-10,15,Indian Institute of Technology Delhi,India,org-org-org-org-org,,PROPN-PROPN-ADP-PROPN-PROPN,PROPN,compound-pobj-prep-pobj-compound,pobj,NNP-NNP-IN-NNP-NNP,NNP,6,1
9197,7544.0,11,uses,5,4,4,0,3,6,1,-1,TAP,TAP Portugal,,per-per,PROPN,PROPN-PROPN,compound,compound-compound,NNP,NNP-NNP,0,1
9198,7545.0,30,stars,1,3,19,16,2,10,-2,18,Sandra Dee,California,per-per,,PROPN-PROPN,PROPN,compound-compound,compound,NNP-NNP,NNP,9,1
9199,7546.0,23,released,2,1,21,20,0,1,1,19,He,Capitol,,per,PRON,PROPN,nsubj,compound,PRP,NNP,10,1
9200,7548.0,45,goes,1,26,39,13,25,5,-25,38,actress,Charlie Day,per,-,NOUN,PROPN-PROPN,nsubj,compound-pobj,NN,NNP-NNP,15,1
9201,7549.0,21,added,10,1,7,6,0,13,9,-3,Afghanistan,Kam Air,,org-org,PROPN,PROPN-PROPN,poss,compound-appos,NNP,NNP-NNP,3,1
9202,7550.0,21,went,1,7,11,4,6,9,-6,10,Bond University,Australia,-,per,PROPN-PROPN,PROPN,compound-pobj,pobj,NNP-NNP,NNP,4,1
9203,7552.0,38,died,5,5,25,20,4,12,0,20,Deng,Chinese,,org,PROPN,ADJ,nsubj,amod,NNP,JJ,7,1
9204,7553.0,37,lost,7,2,7,5,1,29,5,0,Barisan Nasional,UMNO,per-per,,PROPN-PROPN,PROPN,compound-compound,pobj,NNP-NNP,NNP,2,1
9205,7554.0,28,is,1,1,9,8,0,18,0,8,Dalriada,Hungary,org,,PROPN,PROPN,nsubj,pobj,NNP,NNP,3,1
9206,7556.0,26,born,2,1,17,16,0,8,1,15,Clinton,Plainfield,per,,PROPN,PROPN,nsubjpass,compound,NNP,NNP,5,1
9207,7558.0,14,elected,2,1,8,7,0,5,1,6,Brown,Kirkcaldy and Cowdenbeath,per,--,PROPN,PROPN-CCONJ-PROPN,nsubjpass,pobj-cc-conj,NNP,NNP-CC-NNP,4,1
9208,7559.0,18,are,7,7,17,10,6,0,0,10,K-os,Canada,per,,PROPN,PROPN,conj,pobj,NNP,NNP,6,1
9209,7561.0,21,is,1,10,19,9,9,1,-9,18,Jonathan Brown,football club,org-org,-,PROPN-PROPN,NOUN-NOUN,compound-pobj,compound-pobj,NNP-NNP,NN-NN,9,1
9210,7562.0,37,School,7,14,16,2,13,20,-7,9,Monash University,Victoria,-,per,PROPN-PROPN,PROPN,compound-ROOT,appos,NNP-NNP,NNP,3,1
9211,7563.0,24,said,13,1,21,20,0,2,12,8,Sessions,Alabama,,org,NOUN,PROPN,poss,compound,NNS,NNP,8,1
9212,7564.0,28,said,13,19,26,7,18,1,-6,13,John Jay College of Criminal Justice,New York,org-org-org-org-org-org,-,PROPN-PROPN-PROPN-ADP-PROPN-PROPN,PROPN-PROPN,compound-compound-pobj-prep-compound-pobj,compound-pobj,NNP-NNP-NNP-IN-NNP-NNP,NNP-NNP,5,1
9213,7565.0,34,told,30,25,29,4,24,4,5,-1,Ministry of Finance,MOF,org-org-org,,PROPN-ADP-PROPN,PROPN,appos-prep-pobj,appos,NNP-IN-NNP,NNP,4,1
9214,7566.0,19,represented,6,3,14,11,2,4,3,8,Ohio Bobcats,Division I,per-per,-,PROPN-PROPN,PROPN-PRON,compound-compound,compound-compound,NNP-NNP,NNP-PRP,5,1
9215,7618.0,19,represented,6,3,14,11,2,4,3,8,Ohio Bobcats,Division I,per-per,-,PROPN-PROPN,PROPN-PRON,compound-compound,compound-compound,NNP-NNP,NNP-PRP,5,1
9216,7568.0,36,told,27,15,27,12,14,8,12,0,Canada,Harper,per,,PROPN,PROPN,pobj,nsubj,NNP,NNP,2,1
9217,7571.0,28,was,21,2,11,9,1,16,19,-10,Nelson,United States,,per-per,PROPN,PROPN-PROPN,nsubj,compound-appos,NNP,NNP-NNP,3,1
9218,10644.0,25,was,10,2,16,14,1,8,8,6,Nelson,United States,,org-org,PROPN,PROPN-PROPN,nsubj,compound-pobj,NNP,NNP-NNP,6,1
9219,12315.0,13,is,1,7,11,4,6,1,-6,10,Nelson,United States,org,-,PROPN,PROPN-PROPN,compound,compound-pobj,NNP,NNP-NNP,2,1
9220,7572.0,13,made,4,3,12,9,2,0,1,8,he,Canada,,org,PRON,PROPN,nsubjpass,pobj,PRP,NNP,2,1
9221,13327.0,38,offered,10,5,34,29,4,3,5,24,he,Canada,org,,PRON,PROPN,nsubj,pobj,PRP,NNP,4,1
9222,7573.0,29,manages,3,12,13,1,11,15,-9,10,GameHouse,RealNetworks,per,,PROPN,PROPN,compound,compound,NNP,NNP,3,1
9223,7574.0,47,emerged,2,28,32,4,27,14,-26,30,Gold Coast Hospital,Queensland,--,per,PROPN-PROPN-PROPN,PROPN,compound-compound-pobj,pobj,NNP-NNP-NNP,NNP,8,1
9224,7575.0,31,represented,2,1,5,4,0,25,1,3,Italy,Romina Power,org,-,PROPN,PROPN-PROPN,nsubjpass,compound-pobj,NNP,NNP-NNP,3,1
9225,7576.0,49,included,34,8,14,6,7,34,26,-20,Erik Larsen,Image Comics,org-org,-,PROPN-PROPN,PROPN-PROPN,compound-poss,compound-pobj,NNP-NNP,NNP-NNP,1,1
9226,7577.0,10,is,3,1,8,7,0,1,2,5,Sandwich Secondary School,LaSalle,--,per,PROPN-PROPN-PROPN,PROPN,compound-compound-nsubj,compound,NNP-NNP-NNP,NNP,5,1
9227,7578.0,23,signed,8,14,18,4,13,4,-6,10,Roberto Maroni,Lega Nord,-,org-org,PROPN-PROPN,PROPN-PROPN,compound-compound,compound-pobj,NNP-NNP,NNP-NNP,3,1
9228,7579.0,18,is,4,1,16,15,0,1,3,12,ZOE Broadcasting Network,Eddie Villanueva,per-per-per,-,PROPN-PROPN-PROPN,PROPN-PROPN,compound-compound-compound,compound-attr,NNP-NNP-NNP,NNP-NNP,4,1
9229,7580.0,30,said,15,1,22,21,0,7,14,7,China,People,org,,PROPN,PROPN,nsubj,poss,NNP,NNPS,7,1
9230,7583.0,20,is,3,1,1,0,0,18,2,-2,Hastings High School,Hastings,--,org,PROPN-PROPN-PROPN,PROPN,compound-compound-nsubj,compound,NNP-NNP-NNP,NNP,0,1
9231,7585.0,26,is,8,19,25,6,18,0,-11,17,HV71,Elitserien,org,,PROPN,PROPN,pobj,pobj,NNP,NNP,5,1
9232,7586.0,38,is,2,1,1,0,0,36,1,-1,Samsung Telecommunications,Samsung Electronics,org-org,-,PROPN-PROPN,PROPN-PROPN,compound-nsubj,compound-pobj,NNP-NNPS,NNP-NNPS,0,1
9233,7587.0,21,claimed,8,3,18,15,2,2,5,10,Italy,volleyball World Cup,,per-per-per,PROPN,NOUN-PROPN-PROPN,nsubj,compound-compound-pobj,NNP,NN-NNP-NNP,5,1
9234,12826.0,16,wins,1,1,6,5,0,9,0,5,Italy,volleyball World Cup,,per-per-per,PROPN,NOUN-PROPN-PROPN,nsubj,compound-compound-compound,NNP,NN-NNP-NNP,2,1
9235,7588.0,46,established,10,23,41,18,22,4,-13,31,India,Sri Jayachamarajendra College of Engineering,per,----,PROPN,PROPN-PROPN-PROPN-ADP-PROPN,compound,conj-compound-conj-prep-pobj,NNP,NNP-NNP-NNP-IN-NNP,-1,1
9236,7590.0,29,won,3,2,7,5,1,21,1,4,Panthers,Big East,org,-,PROPN,PROPN-PROPN,nsubj,compound-nmod,NNPS,NNP-NNP,3,1
9237,7591.0,63,found,26,4,5,1,3,57,22,-21,Dublin,Owens,org,,PROPN,PROPN,compound,nsubj,NNP,NNP,3,1
9238,7592.0,18,demeaned,15,8,17,9,7,0,7,2,he,Venezuela,per,,PRON,PROPN,nsubj,dobj,PRP,NNP,5,1
9239,10737.0,21,appointed,4,3,16,13,2,4,1,12,he,Venezuela,org,,PRON,PROPN,nsubjpass,pobj,PRP,NNP,2,1
9240,7594.0,19,produced,2,10,17,7,9,1,-8,15,Matt Bayles,Seattle,-,org,PROPN-PROPN,PROPN,compound-appos,compound,NNP-NNP,NNP,4,1
9241,7597.0,18,named,4,15,16,1,14,1,-11,12,Education,Richard Riley,org,-,PROPN,PROPN-PROPN,pobj,compound-pobj,NNP,NNP-NNP,1,1
9242,7599.0,22,represent,7,3,17,14,2,4,4,10,Richmond Spiders,Division I,per-per,-,PROPN-PROPN,PROPN-PROPN,compound-compound,pobj-compound,NNP-NNPS,NNP-NNP,6,1
9243,7600.0,14,is,1,1,6,5,0,7,0,5,Tayeb,Israel,,org,PROPN,PROPN,nsubj,pobj,NNP,NNP,4,1
9244,7601.0,33,requisitioned,2,17,30,13,16,2,-15,28,London County Council,Woolverstone Hall School,per-per-per,--,PROPN-PROPN-PROPN,PROPN-PROPN-PROPN,compound-compound-nsubj,compound-compound-appos,NNP-NNP-NNP,NNP-NNP-NNP,6,1
9245,7602.0,29,filmed,23,10,13,3,9,15,13,-10,Lexington,Institute,,per,PROPN,PROPN,pobj,poss,NNP,NNP,3,1
9246,7603.0,17,speak,12,1,4,3,0,12,11,-8,NORML,Allen St. Pierre,per,--,PROPN,PROPN-PROPN-PROPN,compound,compound-compound-nsubj,NNP,NNP-NNP-NNP,3,1
9247,7604.0,34,was,1,31,32,1,30,1,-30,31,Dr.,Tom Prichard,per,-,PROPN,PROPN-PROPN,compound,compound-pobj,NNP,NNP-NNP,1,1
9248,7605.0,27,took,7,13,24,11,12,2,-6,17,Indonesian Super League,AFC,per-per-per,,PROPN-PROPN-PROPN,PROPN,compound-compound-pobj,compound,NNP-NNP-NNP,NNP,9,1
9249,7608.0,23,shows,1,3,16,13,2,6,-2,15,Ciara,Georgia,,org,PROPN,PROPN,nsubj,compound,NNP,NNP,6,1
9250,7609.0,23,is,6,1,5,4,0,17,5,-1,Bank of England,Mervyn King,org-org-org,-,PROPN-ADP-PROPN,PROPN-PROPN,nmod-prep-pobj,compound-nsubj,NNP-IN-NNP,NNP-NNP,3,1
9251,7610.0,23,is,9,2,4,2,1,18,7,-5,Union of Christmas Island Workers,Christmas Island,per-per-per-per-per,-,PROPN-ADP-PROPN-PROPN-PROPN,PROPN-PROPN,nsubj-prep-compound-compound-pobj,compound-pobj,NNP-IN-NNP-NNP-NNPS,NNP-NNP,2,1
9252,7611.0,15,resign,13,1,5,4,0,9,12,-8,Numico,Jan Bennink,org,-,PROPN,PROPN-PROPN,compound,compound-appos,NNP,NNP-NNP,2,1
9253,7612.0,13,plays,2,1,12,11,0,0,1,10,Isabelle Huppert,France,org-org,,PROPN-PROPN,PROPN,compound-nsubj,dobj,NNP-NNP,NNP,3,1
9254,7613.0,23,called,4,3,17,14,2,5,1,13,Jeff Bridges,Los Angeles,-,org-org,PROPN-PROPN,PROPN-PROPN,compound-appos,compound-compound,NNP-NNP,NNP-NNP,7,1
9255,7614.0,22,Carroll,2,2,20,18,1,1,0,18,Mickey Carroll,Crestwood,per-per,,PROPN-PROPN,PROPN,compound-ROOT,compound,NNP-NNP,NNP,6,1
9256,7616.0,66,went,2,1,20,19,0,45,1,18,DJ Pierre,Phuture,org-org,,PROPN-PROPN,PROPN,compound-nsubj,compound,NNP-NNP,NNP,11,1
9257,7617.0,15,makes,3,7,10,3,6,4,-4,7,Dodge,Chrysler,org,,PROPN,PROPN,compound,compound,NNP,NNP,3,1
9258,7620.0,15,located,4,1,1,0,0,13,3,-3,Fallston High School,Fallston,--,org,PROPN-PROPN-PROPN,PROPN,compound-compound-nsubjpass,pobj,NNP-NNP-NNP,NNP,0,1
9259,7621.0,30,is,6,1,3,2,0,26,5,-3,Florian Bollen,Great Wheel Corporation,org-org,--,ADJ-PROPN,PROPN-PROPN-PROPN,amod-compound,compound-compound-compound,JJ-NNP,NNP-NNP-NNP,2,1
9260,7622.0,26,was,7,12,17,5,11,8,-5,10,Leonid Kuchma,Ukraine,-,per,PROPN-PROPN,PROPN,compound-pobj,pobj,NNP-NNP,NNP,1,1
9261,11662.0,41,Herzog,2,24,27,3,23,13,-22,25,Leonid Kuchma,Ukraine,per-per,,PROPN-PROPN,PROPN,compound-conj,pobj,NNP-NNP,NNP,2,1
9262,7623.0,36,were,6,17,31,14,16,4,-11,25,Ottawa,Jim Watson,,org-org,PROPN,PROPN-PROPN,compound,compound-compound,NNP,NNP-NNP,6,1
9263,7625.0,9,moved,3,3,8,5,2,0,0,5,Fluke,Everett,per,,PROPN,PROPN,nsubj,pobj,NNP,NNP,1,1
9264,7626.0,18,educated,2,11,16,5,10,1,-9,14,Diocesan College,Cape Town,org-org,-,PROPN-PROPN,PROPN-PROPN,nmod-nmod,compound-pobj,NNP-NNP,NNP-NNP,5,1
9265,7627.0,40,returned,10,23,27,4,22,12,-13,17,Wan Azizah Wan Ismail,People's Justice Party,---,org-org-org,PROPN-PROPN-PROPN-PROPN,PROPN-PROPN-PROPN,compound-compound-nmod-compound,compound-compound-pobj,NNP-NNP-NNP-NNP,NNP-NNP-NNP,2,1
9266,7628.0,18,is,6,2,2,0,1,15,4,-4,Little Rock Port Authority Railroad,Little Rock Arkansas,----,org-org-org,PROPN-PROPN-PROPN-PROPN-PROPN,PROPN-PROPN-PROPN,compound-compound-compound-compound-nsubj,compound-compound-pobj,NNP-NNP-NNP-NNP-NNP,NNP-NNP-NNP,0,1
9267,7629.0,43,reflect,6,1,13,12,0,29,5,7,The Waterboys,Scott,per-per,,DET-NOUN,PROPN,det-poss,compound,DT-NNS,NNP,5,1
9268,7630.0,48,told,43,3,28,25,2,19,40,-15,Joe Volpe,Canada,org-org,,PROPN-PROPN,PROPN,compound-nsubjpass,pobj,NNP-NNP,NNP,5,1
9269,7631.0,50,are,3,26,34,8,25,15,-23,31,Jacques Santer,European People's Party,per-per,--,PROPN-PROPN,PROPN-PROPN-PROPN,compound-nmod,compound-compound-pobj,NNP-NNP,NNP-NNP-NNP,2,1
9270,7632.0,33,son,1,22,32,10,21,0,-21,31,Rodrigo Bueno,Argentina,-,org,PROPN-PROPN,PROPN,compound-nsubjpass,pobj,NNP-NNP,NNP,3,1
9271,7633.0,17,been,5,7,14,7,6,2,-2,9,Alfred Deakin,Australia,-,org,PROPN-PROPN,PROPN,compound-attr,pobj,NNP-NNP,NNP,3,1
9272,12868.0,22,were,4,10,21,11,9,0,-6,17,Alfred Deakin,Australia,per-per,,PROPN-PROPN,PROPN,compound-conj,pobj,NNP-NNP,NNP,3,1
9273,7634.0,26,run,7,10,16,6,9,9,-3,9,Companhia Paulista de Trens Metropolitanos,CPTM,----,org,PROPN-PROPN-PROPN-PROPN-PROPN,PROPN,compound-nmod-pobj-compound-pobj,appos,NNP-NNP-NNP-NNP-NNP,NNP,3,1
9274,7639.0,31,organized,5,4,5,1,3,25,1,0,Charlie Merrow,Merrow Machine Company,per-per,--,PROPN-PROPN,PROPN-PROPN-PROPN,compound-nsubj,compound-compound-pobj,NNP-NNP,NNP-NNP-NNP,1,1
9275,7640.0,15,was,1,1,9,8,0,5,0,8,She,Nova Scotia,per,-,PRON,PROPN-PROPN,nsubj,compound-pobj,PRP,NNP-NNP,5,1
9276,7641.0,61,has,1,4,22,18,3,38,-3,21,Edge Hill State School,Cairns,per-per-per-per,,PROPN-PROPN-PROPN-PROPN,PROPN,compound-compound-compound-compound,nmod,NNP-NNP-NNP-NNP,NNP,-1,1
9277,7642.0,58,was,6,42,49,7,41,8,-36,43,France,Catherine of Valois,,per-per-per,PROPN,PROPN-ADP-PROPN,pobj,conj-prep-pobj,NNP,NNP-IN-NNP,4,1
9278,7644.0,23,founded,3,8,22,14,7,0,-5,19,Gothenburg,SKF,,per,PROPN,PROPN,compound,pobj,NNP,NNP,-1,1
9279,7645.0,46,reported,2,12,14,2,11,31,-10,12,its,University of Wales,,per-per-per,DET,PROPN-ADP-PROPN,poss,nmod-prep-pobj,PRP$,NNP-IN-NNP,2,1
9280,7646.0,26,announced,5,8,15,7,7,10,-3,10,he,United States,,org-org,PRON,PROPN-PROPN,nsubj,compound-pobj,PRP,NNP-NNP,5,1
9281,8336.0,36,After,0,6,18,12,5,17,-6,18,he,United States,,per-per,PRON,PROPN-PROPN,nsubj,compound-pobj,PRP,NNP-NNP,6,1
9282,11818.0,14,developed,6,6,12,6,5,1,0,6,he,United States,org,-,PRON,PROPN-PROPN,nsubj,compound-pobj,PRP,NNP-NNP,3,1
9283,7647.0,28,grew,1,6,25,19,5,2,-5,24,England,Birmingham City University,per,--,PROPN,PROPN-PROPN-PROPN,pobj,compound-compound-conj,NNP,NNP-NNP-NNP,8,1
9284,7648.0,23,sold,5,11,21,10,10,1,-6,16,The Dominion Post,Fairfax,--,org,DET-PROPN-PROPN,PROPN,det-compound-compound,compound,DT-NNP-NNP,NNP,5,1
9285,7649.0,31,launched,7,1,15,14,0,15,6,8,Hong Kong,Citic Pacific,-,org-org,PROPN-PROPN,PROPN-PROPN,compound-poss,compound-pobj,NNP-NNP,NNP-NNP,5,1
9286,7650.0,50,think,2,26,34,8,25,15,-24,32,East Berlin,Stasi,org-org,,PROPN-PROPN,PROPN,compound-pobj,conj,NNP-NNP,NNP,3,1
9287,7651.0,21,is,8,1,19,18,0,1,7,11,Dan Deacon,Baltimore,-,per,PROPN-PROPN,PROPN,compound-nsubj,compound,NNP-NNP,NNP,6,1
9288,7653.0,28,released,4,4,24,20,3,3,0,20,Nek,Italy,,per,PROPN,PROPN,nsubj,compound,NNP,NNP,-1,1
9289,7654.0,12,Foot,4,1,11,10,0,0,3,7,Iggy Pop,Arista,per-per,,PROPN-PROPN,PROPN,compound-compound,ROOT,NNP-NNP,NNP,6,1
9290,7656.0,23,was,15,1,4,3,0,18,14,-11,Louis Calhern,Carl Henry Vogt,org-org,--,PROPN-PROPN,PROPN-PROPN-PROPN,compound-nsubj,compound-compound-dobj,NNP-NNP,NNP-NNP-NNP,3,1
9291,7657.0,33,was,4,2,13,11,1,19,2,9,Royal Dublin Fusiliers,Army,org-org-org,,PROPN-PROPN-PROPN,PROPN,compound-compound-nsubj,pobj,NNP-NNP-NNPS,NNP,4,1
9292,7659.0,15,born,2,1,10,9,0,4,1,8,He,electrician,per,,PRON,ADJ,nsubjpass,attr,PRP,JJ,4,1
9293,7660.0,39,urge,28,2,15,13,1,23,26,-13,President,Boris Yeltsin,per,-,PROPN,PROPN-PROPN,compound,compound-pobj,NNP,NNP-NNP,4,1
9294,12908.0,21,travel,5,2,17,15,1,3,3,12,President,Boris Yeltsin,,per-per,PROPN,PROPN-PROPN,compound,compound-pobj,NNP,NNP-NNP,6,1
9295,7661.0,31,referred,6,1,16,15,0,14,5,10,Oklahoma State University Stillwater,OSU,per-per-per-per,,PROPN-PROPN-PROPN-PROPN,PROPN,compound-compound-compound-nsubj,conj,NNP-NNP-NNP-NNP,NNP,6,1
9296,7662.0,50,In,0,7,12,5,6,37,-7,12,National Trades Union Congress,NTUC,---,per,PROPN-PROPN-PROPN-PROPN,PROPN,compound-compound-compound-pobj,nsubj,NNP-NNPS-NNP-NNP,NNP,3,1
9297,7663.0,20,did,1,11,11,0,10,8,-10,10,University of Toronto Schools,University of Toronto,---,per-per-per,PROPN-ADP-PROPN-PROPN,PROPN-ADP-PROPN,nmod-prep-pobj-pobj,pobj-prep-pobj,NNP-IN-NNP-NNP,NNP-IN-NNP,0,1
9298,7664.0,35,responded,2,1,11,10,0,23,1,9,Jonny Greenwood,England,-,org,PROPN-PROPN,PROPN,compound-nsubj,pobj,NNP-NNP,NNP,6,1
9299,7665.0,38,taught,1,15,21,6,14,16,-14,20,Stephen F. Austin State University,Nacogdoches,----,org,PROPN-PROPN-PROPN-PROPN-PROPN,PROPN,compound-compound-compound-compound-pobj,pobj,NNP-NNP-NNP-NNP-NNP,NNP,5,1
9300,7666.0,22,filled,3,9,10,1,8,11,-6,7,Alberta,Charles Stewart,,per-per,PROPN,PROPN-PROPN,compound,compound-pobj,NNP,NNP-NNP,1,1
9301,7668.0,17,was,6,3,14,11,2,2,3,8,New York Giants,National Football League,--,org-org-org,PROPN-PROPN-PROPN,PROPN-PROPN-PROPN,compound-compound-compound,compound-compound-pobj,NNP-NNP-NNP,NNP-NNP-NNP,7,1
9302,7669.0,61,As,0,27,32,5,26,28,-27,32,False River Academy,1969,per-per-per,,PROPN-PROPN-PROPN,NUM,compound-compound-compound,pobj,NNP-NNP-NNP,CD,3,1
9303,7670.0,24,decided,1,15,18,3,14,5,-14,17,Democrat,Chuck Robb,,per-per,PROPN,PROPN-PROPN,compound,compound-dobj,NNP,NNP-NNP,1,1
9304,7671.0,38,contacted,11,11,30,19,10,7,0,19,Piedad,Colombia,per,,PROPN,PROPN,appos,pobj,NNP,NNP,6,1
9305,7672.0,21,arrive,4,1,10,9,0,10,3,6,Heath Ledger,Perth,org-org,,PROPN-PROPN,PROPN,compound-poss,pobj,NNP-NNP,NNP,3,1
9306,7673.0,23,is,1,10,14,4,9,8,-9,13,India,University College of Engineering,org,---,PROPN,PROPN-PROPN-ADP-PROPN,pobj,compound-pobj-prep-pobj,NNP,NNP-NNP-IN-NNP,2,1
9307,7674.0,18,is,1,5,11,6,4,6,-4,10,Kaiser Permanente,Oakland,per-per,,PROPN-PROPN,PROPN,compound-compound,pobj,NNP-NNP,NNP,2,1
9308,7675.0,29,voted,8,17,18,1,16,10,-9,10,Colorado,Denver,org,,PROPN,PROPN,compound,pobj,NNP,NNP,1,1
9309,7676.0,25,On,0,7,9,2,6,15,-7,9,Indian,Raman Lamba,,per-per,ADJ,PROPN-PROPN,amod,compound-nsubjpass,JJ,NNP-NNP,1,1
9310,7677.0,36,show,9,18,34,16,17,1,-9,25,Elegant Angel,Patrick Collins,per-per,-,PROPN-PROPN,PROPN-PROPN,compound-compound,compound-conj,NNP-NNP,NNP-NNP,8,1
9311,7678.0,17,played,1,6,14,8,5,2,-5,13,NFL,Evansville Crimson Giants,per,--,PROPN,PROPN-PROPN-PROPN,compound,compound-compound-pobj,NNP,NNP-NNP-NNP,6,1
9312,7681.0,28,demonstrated,6,2,5,3,1,22,4,-1,his,President,org,,DET,PROPN,poss,compound,PRP$,NNP,3,1
9313,7684.0,26,founded,2,1,7,6,0,18,1,5,IKEA,Ingvar Kamprad,,per-per,PROPN,PROPN-PROPN,nsubjpass,compound-pobj,NNP,NNP-NNP,3,1
9314,7685.0,34,said,9,16,25,9,15,8,-7,16,Alaska,Lisa Murkowski,per,-,PROPN,PROPN-PROPN,poss,compound-conj,NNP,NNP-NNP,4,1
9315,7686.0,22,was,3,2,10,8,1,11,1,7,John Jellicoe,Grand Fleet,-,org-org,PROPN-PROPN,PROPN-PROPN,compound-nsubj,compound-pobj,NNP-NNP,NNP-NNP,4,1
9316,7687.0,52,recognized,3,46,50,4,45,1,-43,47,Saint Anselm College,New Hampshire,per-per-per,-,PROPN-PROPN-PROPN,PROPN-PROPN,compound-compound-pobj,compound-pobj,NNP-NNP-NNP,NNP-NNP,4,1
9317,7689.0,20,was,4,2,14,12,1,5,2,10,Anglo European School,Essex,org-org-org,,PROPN-PROPN-PROPN,PROPN,compound-compound-nsubj,pobj,NNP-NNP-NNP,NNP,5,1
9318,7690.0,33,changed,7,10,27,17,9,5,-3,20,JAT,Jat Airways,,per-per,PROPN,PROPN-PROPN,compound,compound-pobj,NNP,NNP-NNP,7,1
9319,7691.0,24,is,3,1,16,15,0,7,2,13,Holy Cross School,Congregation of Holy Cross,--,per-per-per-per,PROPN-PROPN-PROPN,PROPN-ADP-PROPN-PROPN,compound-compound-nsubj,pobj-prep-compound-pobj,NNP-NNP-NNP,NNP-IN-NNP-NNP,7,1
9320,7694.0,43,said,6,10,13,3,9,29,-4,7,e Prime Ministe,r Ecevi,per-per-per,-,NOUN-PROPN-PROPN,NOUN-PROPN,det-compound-compound,dobj-compound,NN-NNP-NNP,NN-NNP,4,1
9321,7695.0,34,found,15,8,14,6,7,19,7,-1,Washington University School of Medicine,St. Louis,----,org-org,PROPN-PROPN-PROPN-ADP-PROPN,PROPN-PROPN,compound-compound-pobj-prep-pobj,compound-pobj,NNP-NNP-NNP-IN-NNP,NNP-NNP,3,1
9322,7696.0,45,is,3,1,25,24,0,19,2,22,Edelweiss Air,Zurich,-,org,PROPN-PROPN,PROPN,compound-compound,compound,NNP-NNP,NNP,6,1
9323,7698.0,15,married,1,1,3,2,0,11,0,2,Scofield,Joy Parker,,org-org,PROPN,PROPN-PROPN,nsubj,compound-dobj,NNP,NNP-NNP,1,1
9324,7699.0,35,combined,9,4,22,18,3,12,5,13,2007,Nokia Siemens Networks,per,--,NUM,PROPN-PROPN-PROPN,nummod,compound-compound-dobj,CD,NNP-NNP-NNP,6,1
9325,7700.0,35,held,5,2,24,22,1,10,3,19,New Zealand,Accident Compensation Corporation,per-per,--,PROPN-PROPN,PROPN-PROPN-PROPN,compound-pobj,compound-compound-pobj,NNP-NNP,NNP-NNP-NNP,8,1
9326,13188.0,32,has,1,23,25,2,22,6,-22,24,New Zealand,Accident Compensation Corporation,per-per,--,PROPN-PROPN,PROPN-PROPN-PROPN,compound-compound,compound-compound-pobj,NNP-NNP,NNP-NNP-NNP,4,1
9327,7701.0,21,became,1,1,5,4,0,15,0,4,Redford,Alberta,per,,PROPN,PROPN,nsubj,pobj,NNP,NNP,2,1
9328,7702.0,21,was,15,9,18,9,8,2,6,3,Dino,Italian,per,,PROPN,ADJ,pobj,amod,NNP,JJ,4,1
9329,7706.0,26,was,1,15,24,9,14,1,-14,23,Tony Rumble,Boston,org-org,,PROPN-PROPN,PROPN,compound-pobj,compound,NNP-NNP,NNP,3,1
9330,7707.0,50,served,1,8,13,5,7,36,-7,12,Provisional Government,Jacques-Charles Dupont de l'Eure,per-per,---,PROPN-PROPN,PROPN-PROPN-PROPN-PROPN,compound-pobj,compound-compound-pobj-punct,NNP-NNP,NNP-NNP-NNP-NNP,5,1
9331,7708.0,18,is,1,8,15,7,7,2,-7,14,Joni Mitchell,musician,-,per,PROPN-PROPN,NOUN,compound-pobj,compound,NNP-NNP,NN,6,1
9332,7709.0,28,voiced,2,16,21,5,15,6,-14,19,Taiwan,University of Delhi,,org-org-org,PROPN,PROPN-ADP-PROPN,compound,pobj-prep-pobj,NNP,NNP-IN-NNP,5,1
9333,7711.0,23,University,2,1,6,5,0,16,1,4,Morehead State University,KY,--,org,PROPN-PROPN-PROPN,PROPN,compound-compound-ROOT,compound,NNP-NNP-NNP,NNP,2,1
9334,7712.0,28,received,6,4,16,12,3,11,2,10,Go North East,Go-Ahead Group,per-per-per,-,PROPN-PROPN-PROPN,PROPN-PROPN,pobj-compound-nsubj,compound-pobj,NNP-NNP-NNP,NNP-NNP,6,1
9335,7713.0,23,was,1,5,10,5,4,12,-4,9,he,The Jades,org,-,PRON,DET-PROPN,nsubj,det-ROOT,PRP,DT-NNPS,2,1
9336,7714.0,26,is,1,13,24,11,12,1,-12,23,New York,Millard Fillmore,-,per-per,PROPN-PROPN,PROPN-PROPN,compound-pobj,compound-pobj,NNP-NNP,NNP-NNP,7,1
9337,7715.0,27,referred,1,17,26,9,16,0,-16,25,State University of New York,USA,----,per,PROPN-PROPN-ADP-PROPN-PROPN,PROPN,compound-appos-prep-compound-pobj,pobj,NNP-NNP-IN-NNP-NNP,NNP,6,1
9338,7716.0,69,went,45,48,12,-36,47,56,-3,-33,Milligan College,Tennessee,-,org,PROPN-PROPN,PROPN,compound-pobj,pobj,NNP-NNP,NNP,6,1
9339,7717.0,54,renewed,6,3,3,0,2,50,3,-3,Norodom Ranariddh,Norodom Ranariddh Party,org-org,--,PROPN-PROPN,PROPN-PROPN-PROPN,compound-nsubj,compound-compound-pobj,NNP-NNP,NNP-NNP-NNP,0,1
9340,7718.0,13,grew,1,1,5,4,0,7,0,4,Hopper,Nyack,,per,NOUN,PROPN,nsubj,compound,NN,NNP,2,1
9341,7719.0,24,supermarkets,1,4,4,0,3,19,-3,3,Kmart Australia,Kmart,per-per,,PROPN-PROPN,PROPN,compound-compound,compound,NNP-NNP,NNP,0,1
9342,7720.0,25,had,1,1,13,12,0,11,0,12,Zeba,Mohammad Ali,per,-,PROPN,PROPN-PROPN,nsubj,compound-dobj,NNP,NNP-NNP,3,1
9343,7721.0,28,is,4,7,13,6,6,14,-3,9,American,Serj Tankian,,org-org,ADJ,PROPN-ADJ,amod,compound-compound,JJ,NNP-JJ,5,1
9344,7722.0,26,owned,3,8,8,0,7,17,-5,5,McGill University,McGill Redmen,org-org,-,PROPN-PROPN,PROPN-PROPN,compound-pobj,compound-compound,NNP-NNP,NNP-NNP,0,1
9345,9372.0,38,owned,2,5,5,0,4,32,-3,3,McGill University,McGill Redmen,-,per-per,PROPN-PROPN,PROPN-PROPN,compound-pobj,compound-conj,NNP-NNP,NNP-NNPS,0,1
9346,7724.0,28,is,9,16,21,5,15,6,-7,12,Charleston Southern University,Division I,--,per-per,PROPN-PROPN-PROPN,PROPN-NUM,compound-compound-pobj,appos-nsubj,NNP-NNP-NNP,NNP-CD,5,1
9347,7725.0,9,Hamilton,1,2,4,2,1,4,-1,3,Hamilton,United States,org,-,PROPN,PROPN-PROPN,ROOT,compound-appos,NNP,NNP-NNP,1,1
9348,7726.0,98,include,4,68,85,17,67,12,-64,81,#44; Pierre-Auguste Re,d in Fr,org-org-org,--,VERB-VERB-ADP,NOUN-ADP-PROPN,nsubj-ccomp-prep,dobj-prep-compound,VBZ-VBP-IN,NN-IN-NNP,8,1
9349,7727.0,17,owned,9,8,14,6,7,2,1,5,1870,Standard Oil,,per-per,NUM,PROPN-PROPN,pobj,compound-compound,CD,NNP-NNP,5,1
9350,12212.0,25,had,9,15,18,3,14,6,-6,9,1870,Standard Oil,org,-,NUM,PROPN-PROPN,nummod,compound-compound,CD,NNP-NNP,2,1
9351,7728.0,27,was,1,10,15,5,9,11,-9,14,Wilberforce University,1856,per-per,,PROPN-PROPN,NUM,compound-dobj,pobj,NNP-NNP,CD,2,1
9352,7729.0,28,headed,6,4,15,11,3,12,2,9,France,Philippe,per,,PROPN,PROPN,compound,dobj,NNP,NNP,3,1
9353,10110.0,28,France,0,1,10,9,0,17,-1,10,France,Philippe,,org,PROPN,PROPN,ROOT,pobj,NNP,NNP,-1,1
9354,7730.0,25,said,7,1,6,5,0,18,6,-1,Austria,Alfred Gusenbauer,,per-per,PROPN,PROPN-PROPN,poss,compound-appos,NNP,NNP-NNP,3,1
9355,12275.0,27,is,4,1,25,24,0,1,3,21,Austria,Alfred Gusenbauer,org,-,PROPN,PROPN-PROPN,poss,compound-pobj,NNP,NNP-NNP,9,1
9356,12487.0,14,paid,7,5,6,1,4,7,2,-1,Austria,Alfred Gusenbauer,,org-org,PROPN,PROPN-PROPN,compound,compound-pobj,NNP,NNP-NNP,1,1
9357,12549.0,27,introduce,2,1,11,10,0,15,1,9,Austria,Alfred Gusenbauer,,org-org,PROPN,PROPN-PROPN,nsubj,compound-nsubj,NNP,NNP-NNP,4,1
9358,13829.0,47,defeated,8,28,42,14,27,4,-20,34,Austria,Alfred Gusenbauer,org,-,PROPN,PROPN-PROPN,pobj,compound-pobj,NNP,NNP-NNP,9,1
9359,7731.0,56,arranged,23,1,8,7,0,47,22,-15,The Black Mages,Nobuo Uematsu,org-org-org,-,DET-PROPN-PROPN,PROPN-PROPN,det-compound-nsubj,compound-pobj,DT-NNP-NNPS,NNP-NNP,5,1
9360,7732.0,28,was,15,4,6,2,3,21,11,-9,Ohio,Paul Newman,org,-,PROPN,PROPN-PROPN,pobj,compound-pobj,NNP,NNP-NNP,1,1
9361,7733.0,23,called,2,7,9,2,6,13,-5,7,President,Abdelaziz Bouteflika,,per-per,PROPN,PROPN-PROPN,pobj,compound-appos,NNP,NNP-NNP,1,1
9362,8932.0,13,inaugurated,2,10,11,1,9,1,-8,9,President,Abdelaziz Bouteflika,org,-,PROPN,PROPN-PROPN,compound,compound-pobj,NNP,NNP-NNP,1,1
9363,10593.0,21,told,13,11,12,1,10,8,2,-1,President,Abdelaziz Bouteflika,org,-,PROPN,PROPN-PROPN,compound,compound-nsubj,NNP,NNP-NNP,1,1
9364,7735.0,43,told,3,18,19,1,17,23,-15,16,actress,Ivana Baquero,org,-,NOUN,PROPN-PROPN,pobj,compound-appos,NN,NNP-NNP,2,1
9365,7737.0,34,WASHINGTON,0,5,10,5,4,23,-5,10,Barack Obama,Democratic,org-org,,PROPN-PROPN,ADJ,compound-nsubj,amod,NNP-NNP,JJ,3,1
9366,7738.0,48,moved,23,12,35,23,11,12,11,12,singer,Melody,,org,NOUN,PROPN,pobj,compound,NN,NNP,12,1
9367,7739.0,48,believed,6,1,31,30,0,16,5,25,Boone,Illinois,org,,VERB,PROPN,nsubj,nsubj,VB,NNP,-1,1
9368,7740.0,21,was,10,1,14,13,0,6,9,4,David Rose,songwriter,per-per,,PROPN-PROPN,NOUN,compound-nsubj,compound,NNP-NNP,NN,3,1
9369,7742.0,20,was,2,1,18,17,0,1,1,16,His,Cambodia,,per,DET,PROPN,poss,compound,PRP$,NNP,5,1
9370,7743.0,31,began,8,4,5,1,3,25,4,-3,Estonia,Urmas Alender,org,-,PROPN,PROPN-PROPN,compound,compound-compound,NNP,NNP-NNP,1,1
9371,7744.0,27,made,8,8,5,-3,7,21,0,-3,Interflug,East Berlin,org,-,PROPN,PROPN-PROPN,appos,compound-dobj,NNP,NNP-NNP,4,1
9372,7745.0,44,built,13,34,40,6,33,3,-21,27,1961,Portland Community College,,per-per-per,NUM,PROPN-PROPN-PROPN,pobj,compound-compound-compound,CD,NNP-NNP-NNP,6,1
9373,7746.0,29,pursued,2,8,15,7,7,13,-6,13,Royal Northern College of Music,University of Manchester,per-per-per-per-per,--,PROPN-PROPN-PROPN-ADP-PROPN,PROPN-ADP-PROPN,compound-compound-pobj-prep-pobj,conj-prep-pobj,NNP-NNP-NNP-IN-NNP,NNP-IN-NNP,3,1
9374,7747.0,27,were,6,17,19,2,16,7,-11,13,Foreign,Willy Brandt,,org-org,PROPN,PROPN-PROPN,compound,compound-dative,NNP,NNP-NNP,1,1
9375,7748.0,26,defeated,4,6,21,15,5,4,-2,17,Proviso East High School,IHSA,---,org,PROPN-PROPN-PROPN-PROPN,PROPN,compound-compound-compound-dobj,compound,NNP-NNP-NNP-NNP,NNP,9,1
9376,7749.0,49,play,3,2,15,13,1,33,1,12,Donovan,UK,per,,PROPN,PROPN,nsubj,ROOT,NNP,NNP,-1,1
9377,7750.0,16,attended,1,3,7,4,2,8,-2,6,Hinds Community College,Raymond,per-per-per,,PROPN-PROPN-PROPN,PROPN,compound-compound-dobj,compound,NNP-NNP-NNP,NNP,3,1
9378,7752.0,82,included,5,22,35,13,21,46,-17,30,Ron Brown,Commerce,-,per,PROPN-PROPN,PROPN,compound-dobj,compound,NNP-NNP,NNP,3,1
9379,11319.0,23,worked,8,11,18,7,10,4,-3,10,Ron Brown,Commerce,per-per,,PROPN-PROPN,PROPN,compound-pobj,pobj,NNP-NNP,NNP,4,1
9380,7756.0,18,enrolled,8,6,8,2,5,9,2,0,1997,school,per,,NUM,NOUN,pobj,nsubj,CD,NN,2,1
9381,7758.0,39,referred,5,1,19,18,0,19,4,14,Cathedral Preparatory School,Erie,per-per-per,,PROPN-PROPN-PROPN,PROPN,compound-compound-nsubj,compound,NNP-NNP-NNP,NNP,4,1
9382,7759.0,28,head,15,3,18,15,2,9,12,3,Dominique de Villepin,Interior,org-org-org,,PROPN-X-PROPN,PROPN,compound-compound-nsubj,compound,NNP-FW-NNP,NNP,4,1
9383,7761.0,25,started,3,22,23,1,21,1,-19,20,Nepal,Narayan Gopal,per,-,PROPN,PROPN-PROPN,compound,compound-pobj,NNP,NNP-NNP,1,1
9384,7762.0,28,said,2,4,4,0,3,23,-2,2,GM Daewoo,GM,-,per,PROPN-PROPN,PROPN,compound-nsubj,poss,NNP-NNP,NNP,0,1
9385,7764.0,28,created,5,1,11,10,0,16,4,6,Journal Communications,MKE,org-org,,PROPN-PROPN,PROPN,compound-nsubj,dobj,NNP-NNP,NNP,4,1
9386,7767.0,15,'s,1,1,5,4,0,9,0,4,He,G-Unit,,org,PRON,PROPN,nsubj,punct,PRP,NNP,3,1
9387,9227.0,24,signed,2,1,9,8,0,14,1,7,He,G-Unit,org,,PRON,PROPN,nsubjpass,punct,PRP,NNP,4,1
9388,7768.0,16,had,3,3,12,9,2,3,0,9,McClymonds,Oakland Unified School District,,per-per-per-per,PROPN,PROPN-PROPN-PROPN-PROPN,nsubj,compound-compound-compound-pobj,NNP,NNP-NNP-NNP-NNP,4,1
9389,7769.0,30,was,5,3,22,19,2,7,2,17,Egyptian,Gamal Abdel Nasser,,per-per-per,PROPN,PROPN-PROPN-PROPN,compound,compound-compound-pobj,NNP,NNP-NNP-NNP,8,1
9390,7770.0,32,said,26,8,25,17,7,6,18,-1,Viktor Yanukovych,Ukraine,org-org,,PROPN-PROPN,PROPN,compound-conj,compound,NNP-NNP,NNP,6,1
9391,7771.0,19,formed,4,1,7,6,0,11,3,3,The Red Chord,Revere,per-per-per,,DET-PROPN-PROPN,PROPN,det-compound-nsubjpass,compound,DT-NNP-NNP,NNP,4,1
9392,7772.0,29,reported,2,7,9,2,6,19,-5,7,Justice,Laurette Onkelinx,,org-org,PROPN,PROPN-PROPN,compound,compound-nsubj,NNP,NNP-NNP,1,1
9393,8899.0,24,Onkelinx,3,1,3,2,0,20,2,0,Justice,Laurette Onkelinx,org,-,PROPN,PROPN-PROPN,compound,compound-ROOT,NNP,NNP-NNP,1,1
9394,7773.0,60,released,7,45,51,6,44,8,-38,44,Nashville,Harold Bradley,per,-,PROPN,PROPN-PROPN,compound,compound-pobj,NNP,NNP-NNP,5,1
9395,7774.0,39,signed,26,25,38,13,24,0,1,12,Spain,Juan,per,,PROPN,PROPN,pobj,appos,NNP,NNP,2,1
9396,7776.0,21,became,10,8,17,9,7,3,2,7,Fresno,Gary Soto,org,-,PROPN,PROPN-PROPN,compound,compound-compound,NNP,NNP-NNP,8,1
9397,7777.0,15,is,3,1,14,13,0,0,2,11,Francisco I. Madero,Mexico,--,per,PROPN-PROPN-PROPN,PROPN,compound-compound-nsubj,pobj,NNP-NNP-NNP,NNP,8,1
9398,8901.0,42,elected,24,3,10,7,2,31,21,-14,Francisco I. Madero,Mexico,per-per-per,,PROPN-PROPN-PROPN,PROPN,compound-compound-nsubjpass,pobj,NNP-NNP-NNP,NNP,4,1
9399,7778.0,27,was,5,4,21,17,3,5,1,16,Yakubu Gowon,Nigeria,-,per,PROPN-PROPN,PROPN,compound-nsubj,pobj,NNP-NNP,NNP,3,1
9400,7779.0,26,Boeing,0,1,24,23,0,1,-1,24,Boeing,Texas,,per,PROPN,PROPN,ROOT,ROOT,NNP,NNP,-1,1
9401,7781.0,12,RECORD,2,5,10,5,4,1,-3,8,JUNIATA COLLEGE,Huntingdon,-,per,PROPN-PROPN,PROPN,compound-pobj,compound,NNP-NNP,NNP,3,1
9402,7782.0,44,introducing,13,32,42,10,31,1,-19,29,John Candy,Toronto,org-org,,PROPN-PROPN,PROPN,compound-conj,compound,NNP-NNP,NNP,7,1
9403,7783.0,45,are,6,22,24,2,21,20,-16,18,Jamshedpur,XLRI,,per,PROPN,PROPN,ROOT,nmod,NNP,NNP,4,1
9404,7784.0,23,help,3,3,7,4,2,15,0,4,she,Dominica,,per,PRON,PROPN,nsubj,nsubj,PRP,NNP,3,1
9405,7785.0,31,worked,2,15,16,1,14,14,-13,14,violinist,Jean-Luc Ponty,per,-,VERB,PROPN-PROPN,compound,compound-compound,VBP,NNP-NNP,2,1
9406,7786.0,54,Meanwhile,0,10,11,1,9,42,-10,11,1st Marine Division,Marine,--,per,PROPN-PROPN-PROPN,PROPN,npadvmod-compound-nsubj,compound,NNP-NNP-NNP,NNP,1,1
9407,11655.0,37,Lopez-Castaneda,3,11,9,-2,10,27,-8,6,1st Marine Division,Marine,org-org-org,,NOUN-PROPN-PROPN,PROPN,compound-compound-compound,compound,NN-NNP-NNP,NNP,3,1
9408,7787.0,35,situated,4,2,19,17,1,15,2,15,University,Middlesbrough,per,,PROPN,PROPN,nsubjpass,pobj,NNP,NNP,8,1
9409,7788.0,26,forced,12,9,11,2,8,14,3,-1,Treasury,John Sherman,per,-,PROPN,PROPN-PROPN,compound,compound-nsubj,NNP,NNP-NNP,1,1
9410,7790.0,30,graduated,1,1,26,25,0,3,0,25,He,National Bank,per,-,PRON,PROPN-PROPN,nsubj,compound-pobj,PRP,NNP-NNP,6,1
9411,7791.0,33,said,7,6,21,15,5,11,1,14,Allen Weinstein,National Archives,-,per-per,PROPN-PROPN,PROPN-PROPN,compound-nsubj,compound-pobj,NNP-NNP,NNP-NNPS,-1,1
9412,7792.0,28,has,12,4,4,0,3,23,8,-8,Dubai,Dubai World,,org-org,PROPN,PROPN-PROPN,poss,compound-poss,NNP,NNP-NNP,0,1
9413,7793.0,34,traced,5,17,19,2,16,14,-12,14,Chinese,Deng Xiaoping,,org-org,ADJ,PROPN-PROPN,amod,compound-pobj,JJ,NNP-NNP,2,1
9414,7794.0,17,presented,8,3,7,4,2,9,5,-1,Williams,Bill Hudson,,org-org,PROPN,PROPN-PROPN,nsubj,compound-conj,NNP,NNP-NNP,3,1
9415,7797.0,49,told,5,16,18,2,15,30,-11,13,President,Josefa Iloilo,per,-,PROPN,PROPN-PROPN,compound,compound-dobj,NNP,NNP-NNP,2,1
9416,7798.0,28,spoke,7,1,4,3,0,23,6,-3,Civic Party,Ronny Tong,org-org,-,PROPN-PROPN,PROPN-PROPN,compound-compound,compound-nsubj,NNP-NNP,NNP-NNP,2,1
9417,7799.0,25,is,6,1,24,23,0,0,5,18,Achy Obejas,Illinois,org-org,,PROPN-PROPN,PROPN,compound-nsubj,pobj,NNP-NNP,NNP,3,1
9418,7800.0,18,joined,3,5,17,12,4,0,-2,14,General Dynamics,Virginia,per-per,,PROPN-PROPN,PROPN,compound-dobj,pobj,NNP-NNPS,NNP,7,1
9419,7802.0,29,is,8,1,11,10,0,17,7,3,Tim Miller,American Hockey League,-,per-per-per,PROPN-PROPN,PROPN-PROPN-PROPN,compound-nsubj,compound-compound-pobj,NNP-NNP,NNP-NNP-NNP,3,1
9420,7803.0,26,Wilke,1,1,5,4,0,20,0,4,Hannah Wilke,Arlene Hannah Butter,-,per-per-per,PROPN-PROPN,PROPN-PROPN-PROPN,compound-ROOT,compound-compound-compound,NNP-NNP,NNP-NNP-NNP,4,1
9421,7804.0,23,Hafermann,2,1,17,16,0,5,1,15,Holly Brook,American,-,org,PROPN-PROPN,ADJ,compound-compound,amod,NNP-NNP,JJ,3,1
9422,7806.0,44,friend,2,5,10,5,4,33,-3,8,William Tubman,Liberia,org-org,,PROPN-PROPN,PROPN,compound-pobj,compound,NNP-NNP,NNP,4,1
9423,7807.0,17,is,1,1,14,13,0,2,0,13,Tosca,1994,per,,PROPN,NUM,nsubj,npadvmod,NNP,CD,3,1
9424,7808.0,11,is,3,1,9,8,0,1,2,6,IRS Airlines,Abuja,-,per,PROPN-PROPN,PROPN,compound-compound,compound,NNP-NNP,NNP,6,1
9425,7809.0,29,is,10,21,23,2,20,5,-11,13,Persepolis,Iran Pro League,,per-per-per,PROPN,PROPN-PROPN-PROPN,pobj,compound-compound-pobj,NNP,NNP-NNP-NNP,2,1
9426,7810.0,34,combined,14,11,12,1,10,21,3,-2,Exchequer,David Lloyd George,,org-org-org,PROPN,PROPN-PROPN-PROPN,pobj,compound-compound-nsubj,NNP,NNP-NNP-NNP,1,1
9427,7811.0,20,met,9,9,18,9,8,1,0,9,Afghanistan,Gulbuddin Hekmatyar,per,-,PROPN,PROPN-PROPN,pobj,compound-pobj,NNP,NNP-NNP,5,1
9428,8413.0,33,met,9,9,18,9,8,14,0,9,Afghanistan,Gulbuddin Hekmatyar,per,-,PROPN,PROPN-PROPN,pobj,compound-pobj,NNP,NNP-NNP,5,1
9429,9777.0,30,says,3,18,28,10,17,1,-15,25,Afghanistan,Gulbuddin Hekmatyar,,per-per,PROPN,PROPN-PROPN,pobj,compound-pobj,NNP,NNP-NNP,3,1
9430,10759.0,47,fighting,20,27,40,13,26,6,-7,20,Afghanistan,Gulbuddin Hekmatyar,,org-org,PROPN,PROPN-PROPN,pobj,compound-appos,NNP,NNP-NNP,5,1
9431,7812.0,53,is,2,17,27,10,16,25,-15,25,Estonia,Tallinn University,,org-org,PROPN,PROPN-PROPN,pobj,compound-appos,NNP,NNP-NNP,-1,1
9432,7814.0,25,supporting,6,2,14,12,1,10,4,8,NY,Antoine Thompson,per,-,PROPN,PROPN-PROPN,pobj,compound-pobj,NNP,NNP-NNP,6,1
9433,7815.0,20,relaunched,4,3,13,10,2,6,1,9,Chevrolet,GM Korea,per,-,PROPN,PROPN-PROPN,nsubjpass,compound-pobj,NNP,NNP-NNP,6,1
9434,7818.0,25,attended,6,12,23,11,11,1,-6,17,Rothesay Netherwood School,New Brunswick,per-per-per,-,PROPN-PROPN-PROPN,PROPN-PROPN,compound-compound-appos,compound-pobj,NNP-NNP-NNP,NNP-NNP,4,1
9435,7819.0,23,set,4,3,3,0,2,19,1,-1,Oslo Sporveier,Oslo trolleybus,per-per,-,PROPN-PROPN,PROPN-NOUN,compound-nsubj,compound-compound,NNP-NNP,NNP-NN,0,1
9436,7820.0,61,approved,6,25,25,0,24,35,-19,19,Schaumburg High School,Schaumburg,--,per,PROPN-PROPN-PROPN,PROPN,compound-compound-pobj,pobj,NNP-NNP-NNP,NNP,0,1
9437,7821.0,28,formed,3,8,12,4,7,15,-5,9,Leeds,Nick Hodgson,,per-per,PROPN,PROPN-PROPN,compound,compound-pobj,NNP,NNP-NNP,4,1
9438,7823.0,38,said,4,4,24,20,3,13,0,20,Li,China,,per,PROPN,PROPN,nsubj,pobj,NNP,NNP,9,1
9439,7826.0,28,was,1,1,3,2,0,24,0,2,Amity,India,per,,PROPN,PROPN,nsubj,poss,NNP,NNP,3,1
9440,7827.0,25,opened,2,1,15,14,0,9,1,13,Electrolux,Stockholm,org,,NOUN,PROPN,compound,compound,NN,NNP,6,1
9441,10864.0,17,fell,3,3,16,13,2,0,0,13,Electrolux,Stockholm,,org,PROPN,PROPN,pobj,pobj,NNP,NNP,1,1
9442,7828.0,32,is,5,1,12,11,0,19,4,7,Dr. James L. Edwards,Anderson University,per-per-per-per,-,PROPN-PROPN-PROPN-PROPN,PROPN-PROPN,compound-compound-compound-nsubj,compound-pobj,NNP-NNP-NNP-NNP,NNP-NNP,-1,1
9443,7831.0,22,born,2,10,15,5,9,6,-8,13,Pertamina,Jakarta,,org,PROPN,PROPN,compound,pobj,NNP,NNP,5,1
9444,7832.0,46,referred,6,29,45,16,28,0,-23,39,Birmingham City University,England,per-per-per,,PROPN-PROPN-PROPN,PROPN,compound-compound-poss,pobj,NNP-NNP-NNP,NNP,8,1
9445,7833.0,30,is,2,2,15,13,1,14,0,13,OPEC,Ecuador,,per,PROPN,PROPN,nsubj,pobj,NNP,NNP,8,1
9446,7834.0,18,is,3,1,17,16,0,0,2,14,Chenab College,Pakistan,-,org,PROPN-PROPN,PROPN,compound-compound,pobj,NNP-NNP,NNP,3,1
9447,7835.0,33,said,31,12,23,11,11,9,19,-8,Nippon Oil,refiner,org-org,,PROPN-PROPN,NOUN,compound-poss,nsubj,NNP-NNP,NN,6,1
9448,7836.0,12,is,3,2,11,9,1,0,1,8,Assam Regiment,Army,-,per,PROPN-PROPN,PROPN,compound-nsubj,pobj,NNP-NNP,NNP,2,1
9449,7837.0,24,was,8,1,7,6,0,16,7,-1,Marine Helicopter Training Squadron 301,HMT-301,per-per-per-per-per,,PROPN-PROPN-PROPN-PROPN-NUM,NOUN,compound-compound-compound-nsubj-nummod,appos,NNP-NNP-NNP-NNP-CD,NN,3,1
9450,8536.0,22,led,4,3,16,13,2,5,1,12,Marine Helicopter Training Squadron 301,HMT-301,----,org,PROPN-PROPN-PROPN-PROPN-NUM,NOUN,compound-compound-compound-pobj-nummod,appos,NNP-NNP-NNP-NNP-CD,NN,8,1
9451,7838.0,33,founded,8,1,15,14,0,17,7,7,Sri Sumangala College,Rankoth Viharaya,per-per-per,-,PROPN-PROPN-PROPN,PROPN-PROPN,compound-compound-nsubjpass,compound-pobj,NNP-NNP-NNP,NNP-NNP,4,1
9452,7839.0,23,reports,2,2,19,17,1,3,0,17,university,University of Wales,,org-org-org,NOUN,PROPN-ADP-PROPN,nsubj,nmod-prep-pobj,NN,NNP-IN-NNP,8,1
9453,7840.0,42,features,2,10,13,3,9,28,-8,11,Whoopi Goldberg,New York,-,org-org,PROPN-PROPN,PROPN-PROPN,compound-pobj,compound-compound,NNP-NNP,NNP-NNP,3,1
9454,7842.0,41,are,9,23,32,9,22,8,-14,23,President,Paul Biya,per,-,PROPN,PROPN-PROPN,conj,nmod-nmod,NNP,NNP-NNP,3,1
9455,7843.0,36,take,8,5,19,14,4,16,3,11,Scripps Networks Interactive,HGTV,org-org-org,,PROPN-PROPN-PROPN,PROPN,compound-compound-oprd,conj,NNP-NNP-NNP,NNP,9,1
9456,7845.0,24,According,0,10,20,10,9,3,-10,20,his,Interior,,per,DET,PROPN,poss,compound,PRP$,NNP,11,1
9457,7846.0,9,offer,5,1,3,2,0,5,4,-2,Malaysia,AirAsia X,,per-per,PROPN,PROPN-NOUN,poss,compound-nsubj,NNP,NNP-NN,2,1
9458,7847.0,20,formed,6,4,4,0,3,15,2,-2,NFU Mutual,NFU,per-per,,PROPN-PROPN,PROPN,compound-nsubjpass,dobj,NNP-NNP,NNP,0,1
9459,7848.0,24,says,5,7,14,7,6,9,-2,9,Ernest Bai Koroma,Sierra Leone,org-org-org,-,PROPN-PROPN-PROPN,PROPN-PROPN,compound-compound-nsubj,compound-compound,NNP-NNP-NNP,NNP-NNP,5,1
9460,7849.0,69,P.S.,0,41,41,0,40,27,-41,41,Henry,Henry IV of England,per,---,PROPN,PROPN-PROPN-ADP-PROPN,compound,compound-nsubj-prep-pobj,NNP,NNP-NNP-IN-NNP,0,1
9461,7850.0,30,is,6,8,16,8,7,13,-2,10,University Health Network,Toronto General Hospital,--,org-org-org,PROPN-PROPN-PROPN,PROPN-PROPN-PROPN,compound-compound-attr,compound-compound-compound,NNP-NNP-NNP,NNP-NNP-NNP,7,1
9462,7851.0,46,written,3,2,15,13,1,30,1,12,Japan,Weekly Shnen Jum,per,--,PROPN,PROPN-PROPN-PROPN,pobj,compound-compound-pobj,NNP,NNP-NNP-NNP,6,1
9463,7852.0,16,coached,5,4,4,0,3,11,1,-1,Idaho,Idaho Falls High School,per,---,PROPN,PROPN-PROPN-PROPN-PROPN,pobj,compound-compound-compound-compound,NNP,NNP-NNP-NNP-NNP,0,1
9464,7854.0,56,criticized,7,5,6,1,4,49,2,-1,Staff,McLarty,per,,PROPN,PROPN,pobj,nmod,NNP,NNP,1,1
9465,7855.0,23,is,6,1,21,20,0,1,5,15,Amanda Noar,Neil Morrissey,org-org,-,PROPN-PROPN,PROPN-PROPN,compound-nsubj,compound-pobj,NNP-NNP,NNP-NNP,5,1
9466,7856.0,11,appointed,2,1,6,5,0,4,1,4,Kim,National Defence Commission,org,--,PROPN,PROPN-PROPN-PROPN,nsubjpass,compound-compound-pobj,NNP,NNP-NNP-NNP,4,1
9467,7857.0,33,said,9,11,25,14,10,7,-2,16,Nokia,Navteq,,org,PROPN,PROPN,nsubjpass,dobj,NNP,NNP,4,1
9468,7859.0,23,signed,3,1,10,9,0,12,2,7,He,Euphonic,,per,PRON,PROPN,nsubjpass,appos,PRP,NNP,5,1
9469,7860.0,21,born,3,1,15,14,0,5,2,12,John Davis,Australian,-,org,PROPN-PROPN,ADJ,compound-nsubjpass,amod,NNP-NNP,JJ,4,1
9470,7862.0,20,represented,6,3,9,6,2,10,3,3,Oklahoma,University of Oklahoma,,per-per-per,PROPN,PROPN-ADP-PROPN,compound,dobj-prep-pobj,NNP,NNP-IN-NNP,4,1
9471,7863.0,31,said,15,26,30,4,25,0,-11,15,National Australia Bank,Melbourne,--,org,PROPN-PROPN-PROPN,PROPN,compound-compound-pobj,pobj,NNP-NNP-NNP,NNP,6,1
9472,7864.0,31,suffered,7,6,14,8,5,16,1,7,Royal Navy,Marines,-,per,PROPN-PROPN,PROPN,compound-nsubj,pobj,NNP-NNP,NNPS,2,1
9473,7865.0,27,is,3,1,10,9,0,16,2,7,Salvador i Solsona,Environment and Housing,per-per-per,--,PROPN-PROPN-PROPN,PROPN-CCONJ-PROPN,compound-nsubj-appos,pobj-cc-conj,NNP-NNP-NNP,NNP-CC-NNP,6,1
9474,7866.0,24,was,5,17,17,0,16,6,-12,12,Nederland,Nederland 3,org,-,PROPN,PROPN-NUM,nmod,conj-nummod,NNP,NNP-CD,0,1
9475,7868.0,32,held,1,1,18,17,0,13,0,17,Sharpton,Brooklyn,org,,PROPN,PROPN,nsubj,pobj,NNP,NNP,2,1
9476,7869.0,26,stated,11,11,25,14,10,0,0,14,Apl.de.Ap,Philippines,,per,NOUN,PROPN,pobj,pobj,NNS,NNP,-1,1
9477,7870.0,34,include,8,6,11,5,5,22,2,3,Skybucket,Dan Sartain,org,-,PROPN,PROPN-PROPN,compound,compound-nsubj,NNP,NNP-NNP,8,1
9478,7871.0,27,elected,4,3,17,14,2,9,1,13,Strijdom,National Party,per,-,PROPN,PROPN-PROPN,nsubjpass,compound-dobj,NNP,NNP-NNP,4,1
9479,7872.0,31,Florida-based,27,23,26,3,22,4,4,-1,Citrix Systems,Fort Lauderdale,org-org,-,PROPN-PROPN,PROPN-PROPN,compound-pobj,compound-nsubj,NNP-NNP,NNP-NNP,3,1
9480,7873.0,29,imprisoned,2,1,28,27,0,0,1,26,Ralph,Australia,per,,PROPN,PROPN,nsubjpass,pobj,NNP,NNP,9,1
9481,7874.0,24,jailed,2,13,16,3,12,7,-11,14,Isabella of France,Queen consort,org-org-org,-,PROPN-ADP-PROPN,PROPN-NOUN,pobj-prep-compound,pobj-pobj,NNP-IN-NNP,NNP-NN,1,1
9482,7875.0,23,represented,8,3,3,0,2,19,5,-5,Georgia Tech Yellow Jackets,Georgia Institute of Technology,org-org-org-org,---,PROPN-PROPN-PROPN-PROPN,PROPN-PROPN-ADP-PROPN,compound-compound-compound-compound,compound-dobj-prep-pobj,NNP-NNP-NNP-NNPS,NNP-NNP-IN-NNP,0,1
9483,9363.0,20,represents,7,2,2,0,1,17,5,-5,Georgia Tech Yellow Jackets,Georgia Institute of Technology,per-per-per-per,---,PROPN-PROPN-PROPN-PROPN,PROPN-PROPN-ADP-PROPN,compound-compound-compound-compound,compound-dobj-prep-pobj,NNP-NNP-NNP-NNPS,NNP-NNP-IN-NNP,0,1
9484,7876.0,49,is,42,34,35,1,33,13,8,-7,Democrat,Carl Levin,,org-org,PROPN,PROPN-PROPN,compound,compound-pobj,NNP,NNP-NNP,1,1
9485,7879.0,37,like,2,12,25,13,11,11,-10,23,Bill Clinton,she,org-org,,PROPN-PROPN,PRON,compound-nsubj,nsubj,NNP-NNP,PRP,-1,1
9486,7880.0,13,attended,1,3,8,5,2,4,-2,7,Bourne Grammar School,Lincolnshire,org-org-org,,PROPN-PROPN-PROPN,PROPN,compound-compound-dobj,pobj,NNP-NNP-NNP,NNP,3,1
9487,7881.0,24,composed,3,10,11,1,9,12,-7,8,Laghdaf,Mauritania,,org,PROPN,PROPN,compound,poss,NNP,NNP,1,1
9488,7883.0,36,said,1,11,25,14,10,10,-10,24,Portland General Electric,Oregon,org-org-org,,PROPN-PROPN-PROPN,PROPN,compound-compound-compound,pobj,NNP-NNP-NNP,NNP,6,1
9489,7884.0,31,appointed,4,3,14,11,2,16,1,10,he,Russia,,org,PRON,PROPN,nsubjpass,pobj,PRP,NNP,5,1
9490,7885.0,13,filed,8,5,12,7,4,0,3,4,South Dakota,Thune,-,org,PROPN-PROPN,PROPN,compound-compound,dobj,NNP-NNP,NNP,5,1
9491,7886.0,24,rejoined,1,1,17,16,0,6,0,16,Wade,PDS,org,,PROPN,PROPN,nsubj,compound,NNP,NNP,3,1
9492,7887.0,22,is,13,2,10,8,1,11,11,-3,Confederation of Trade Unions of the Republic of Moldova,Moldova,org-org-org-org-org-org-org-org-org,,PROPN-ADP-PROPN-PROPN-ADP-DET-PROPN-ADP-PROPN,PROPN,nsubj-prep-compound-pobj-prep-det-pobj-prep-pobj,pobj,NNP-IN-NNP-NNPS-IN-DT-NNP-IN-NNP,NNP,4,1
9493,7888.0,31,was,5,23,25,2,22,5,-18,20,Mexico,Adriana Barraza,per,-,PROPN,PROPN-PROPN,poss,compound-ROOT,NNP,NNP-NNP,2,1
9494,7889.0,17,was,2,1,14,13,0,2,1,12,MOSH mobile,Indiana,-,per,PROPN-NOUN,PROPN,compound-nsubj,compound,NNP-NN,NNP,9,1
9495,7890.0,25,said,4,3,23,20,2,1,1,19,Detroit,GMAC,,per,PROPN,PROPN,compound,compound,NNP,NNP,3,1
9496,7892.0,10,headed,2,1,8,7,0,1,1,6,Francisco,Central America,per,-,PROPN,PROPN-PROPN,nsubj,compound-pobj,NNP,NNP-NNP,4,1
9497,7894.0,35,initiated,7,3,5,2,2,29,4,-2,University of Manchester,Manchester,--,org,PROPN-ADP-PROPN,PROPN,pobj-prep-pobj,compound,NNP-IN-NNP,NNP,4,1
9498,7895.0,23,was,3,14,16,2,13,6,-11,13,China,Wang Lei,,org-org,PROPN,PROPN-PROPN,poss,compound-conj,NNP,NNP-NNP,4,1
9499,8269.0,30,announced,1,1,24,23,0,5,0,23,China,Wang Lei,per,-,PROPN,PROPN-PROPN,nsubj,compound-conj,NNP,NNP-NNP,4,1
9500,7896.0,44,published,6,18,40,22,17,3,-12,34,London,he,per,,PROPN,PRON,pobj,nsubj,NNP,PRP,5,1
9501,7897.0,56,was,4,42,44,2,41,11,-38,40,Gaahl,Kristian Espedal,,per-per,PROPN,PROPN-PROPN,conj,compound-appos,NNP,NNP-NNP,2,1
9502,7898.0,52,is,9,1,15,14,0,36,8,6,Yigal Carmon,er of the Middle East Media Research,org-org,------,PROPN-PROPN,INTJ-ADP-DET-PROPN-PROPN-PROPN-PROPN,compound-nsubj,intj-prep-det-compound-compound-compound-compound,NNP-NNP,UH-IN-DT-NNP-NNP-NNP-NNP,3,1
9503,7899.0,48,is,7,13,28,15,12,19,-6,21,De La Salle Philippines,2006,---,org,PROPN-PROPN-PROPN-PROPN,NUM,compound-compound-compound-pobj,pobj,NNP-NNP-NNP-NNP,CD,8,1
9504,7900.0,37,Be,2,28,35,7,27,1,-26,33,the O'Jays,Bell,-,org,DET-PROPN,PROPN,det-pobj,compound,DT-NNP,NNP,1,1
9505,7901.0,18,known,4,2,3,1,1,14,2,-1,Joventut Badalona,Badalona,org-org,,PROPN-PROPN,PROPN,compound-nsubj,compound,NNP-NNP,NNP,2,1
9506,7902.0,29,traces,2,2,22,20,1,6,0,20,college,Quebec,,per,NOUN,PROPN,nsubj,poss,NN,NNP,11,1
9507,7903.0,32,was,10,7,20,13,6,11,3,10,Florida Army National Guard,1565,---,per,PROPN-PROPN-PROPN-PROPN,NUM,compound-compound-compound-pobj,pobj,NNP-NNP-NNP-NNP,CD,7,1
9508,7904.0,33,began,7,15,21,6,14,11,-8,14,Mikhail Fradkov,Foreign Intelligence Service,per-per,--,PROPN-PROPN,PROPN-PROPN-PROPN,compound-dobj,compound-compound-pobj,NNP-NNP,NNP-NNP-NNP,6,1
9509,7905.0,32,commanded,2,5,28,23,4,3,-3,26,RAAF,Air Combat Group RAAF,,org-org-org-org,PROPN,PROPN-PROPN-PROPN-PROPN,ROOT,compound-compound-compound-conj,NNP,NNP-NNP-NNP-NNP,-1,1
9510,7906.0,34,re-branded,6,9,10,1,8,23,-3,4,Rwandair Express,Express,per-per,,PROPN-PROPN,PROPN,compound-pobj,nsubj,NNP-NNP,NNP,2,1
9511,7907.0,23,is,18,1,13,12,0,9,17,-5,Sergey Aleksandrovich Volkov,Ukraini,per-per-per,,PROPN-PROPN-PROPN,PROPN,compound-compound-nsubj,pobj,NNP-NNP-NNP,NNP,6,1
9512,7908.0,20,was,1,1,5,4,0,14,0,4,She,Gerald Bromfield,per,-,PRON,PROPN-PROPN,nsubj,compound-pobj,PRP,NNP-NNP,3,1
9513,7909.0,20,Looking,0,12,19,7,11,0,-12,19,Stormfront Studios,California,-,per,PROPN-PROPN,PROPN,compound-dobj,pobj,NNP-NNPS,NNP,4,1
9514,7910.0,47,expanded,2,31,37,6,30,9,-29,35,PolyGram Filmed Entertainment,Philips,--,org,PROPN-PROPN-PROPN,PROPN,compound-compound-pobj,appos,NNP-NNP-NNP,NNP,5,1
9515,7913.0,35,occurred,12,1,17,16,0,17,11,5,James Madison,Montpelier,per-per,,PROPN-PROPN,PROPN,compound-poss,pobj,NNP-NNP,NNP,7,1
9516,7914.0,32,was,5,1,5,4,0,26,4,0,St. Louis,Chingy,org-org,,PROPN-PROPN,PROPN,compound-poss,nsubj,NNP-NNP,NNP,2,1
9517,7915.0,47,is,3,35,38,3,34,8,-32,35,Roosevelt Academy,Middelburg,-,per,PROPN-PROPN,PROPN,compound-pobj,pobj,NNP-NNP,NNP,4,1
9518,7918.0,59,noticed,2,24,47,23,23,11,-22,45,actress,Jeff Richmond,,per-per,NOUN,PROPN-PROPN,appos,compound-pobj,NN,NNP-NNP,8,1
9519,7919.0,75,Bilbo,5,25,26,1,24,48,-20,21,Indiana,James Eli Watson,per,--,PROPN,PROPN-PROPN-PROPN,compound,compound-compound-pobj,NNP,NNP-NNP-NNP,2,1
9520,7920.0,28,said,17,19,24,5,18,3,-2,7,Sun Laiyan,China National Space Administration,org-org,---,PROPN-ADJ,PROPN-PROPN-PROPN-PROPN,compound-nsubj,compound-compound-compound-pobj,NNP-JJ,NNP-NNP-NNP-NNP,4,1
9521,7921.0,20,received,1,10,16,6,9,3,-9,15,The Art Institute of Boston,Lesley University,per-per-per-per-per,-,DET-PROPN-PROPN-ADP-PROPN,PROPN-PROPN,det-compound-pobj-prep-pobj,compound-pobj,DT-NNP-NNP-IN-NNP,NNP-NNP,3,1
9522,9812.0,29,dean,2,5,11,6,4,17,-3,9,The Art Institute of Boston,Lesley University,----,per-per,DET-PROPN-PROPN-ADP-PROPN,PROPN-PROPN,det-compound-pobj-prep-pobj,compound-pobj,DT-NNP-NNP-IN-NNP,NNP-NNP,3,1
9523,7923.0,11,was,1,6,9,3,5,1,-5,8,Fort Wayne,Tom Hayhurst,org-org,-,PROPN-PROPN,PROPN-PROPN,compound-compound,compound-dobj,NNP-NNP,NNP-NNP,2,1
9524,7925.0,35,Presented,0,7,20,13,6,14,-7,20,George,Mary of Teck,per,--,PROPN,PROPN-ADP-PROPN,compound,appos-prep-pobj,NNP,NNP-IN-NNP,8,1
9525,13328.0,55,Duchess,2,49,52,3,48,2,-47,50,George,Mary of Teck,,org-org-org,PROPN,PROPN-ADP-PROPN,compound,conj-prep-pobj,NNP,NNP-IN-NNP,2,1
9526,7926.0,31,is,2,12,12,0,11,18,-10,10,United Automobile,United Auto Workers,-,per-per-per,PROPN-PROPN,PROPN-PROPN-PROPN,compound-compound,compound-compound-pobj,NNP-NNP,NNP-NNP-NNPS,0,1
9527,7928.0,36,was,21,1,3,2,0,32,20,-18,Pierre Bruno Hugo Fontana,Hugo del Carril,org-org-org-org,--,PROPN-PROPN-PROPN-PROPN,PROPN-PROPN-PROPN,compound-compound-compound-nsubj,compound-compound-pobj,NNP-NNP-NNP-NNP,NNP-NNP-NNP,1,1
9528,7929.0,27,nationalised,13,21,4,-17,20,22,-8,-9,Aircraft,1977,per,,PROPN,NUM,nmod,nummod,NNP,CD,9,1
9529,7932.0,33,include,12,6,24,18,5,8,6,12,SST,Hub,per,,PROPN,PROPN,compound,ROOT,NNP,NNP,-1,1
9530,7933.0,13,is,6,2,4,2,1,8,4,-2,University of Hamburg,Hamburg,--,per,PROPN-ADP-PROPN,PROPN,nsubj-prep-pobj,compound,NNP-IN-NNP,NNP,3,1
9531,7934.0,16,serving,6,1,4,3,0,11,5,-2,Stanwyck,Robert Taylor,per,-,PROPN,PROPN-PROPN,poss,compound-appos,NNP,NNP-NNP,3,1
9532,7936.0,21,born,2,16,20,4,15,0,-14,18,Bradfield College,England,-,per,PROPN-PROPN,PROPN,compound-pobj,pobj,NNP-NNP,NNP,4,1
9533,7937.0,33,In,0,13,31,18,12,1,-13,31,Stallybrass,Gilmore,org,,PROPN,PROPN,nsubj,pobj,NNP,NNP,6,1
9534,7938.0,53,visited,10,5,9,4,4,43,5,-1,SPDC,Maung Aye,,org-org,PROPN,PROPN-PROPN,compound,compound-nsubj,NNP,NNP-NNP,3,1
9535,13148.0,39,is,1,35,37,2,34,1,-34,36,SPDC,Maung Aye,per,-,PROPN,PROPN-PROPN,compound,compound-pobj,NNP,NNP-NNP,1,1
9536,13999.0,56,attended,12,24,35,11,23,20,-12,23,SPDC,Maung Aye,,org-org,PROPN,PROPN-PROPN,appos,compound-compound,NNP,NNP-NNP,5,1
9537,7939.0,34,said,32,5,23,18,4,10,27,-9,Japan,Marubeni,,per,PROPN,PROPN,poss,pobj,NNP,NNP,7,1
9538,14024.0,11,buys,3,1,3,2,0,7,2,0,Japan,Marubeni,,per,PROPN,PROPN,poss,nsubj,NNP,NNP,3,1
9539,7940.0,37,were,8,21,24,3,20,12,-13,16,Ryan Malcolm,Kingston,per-per,,PROPN-PROPN,PROPN,compound-dobj,compound,NNP-NNP,NNP,5,1
9540,7941.0,23,is,11,1,6,5,0,16,10,-5,Newfoundland Power,St. John's,per-per,-,PROPN-PROPN,PROPN-PROPN,compound-nsubj,compound-npadvmod,NNP-NNP,NNP-NNP,4,1
9541,7942.0,24,filled,4,11,13,2,10,10,-7,9,Tommy Thompson,Health and Human Services,org-org,---,PROPN-PROPN,PROPN-CCONJ-PROPN-PROPN,compound-compound,nmod-cc-compound-compound,NNP-NNP,NNP-CC-NNP-NNPS,2,1
9542,11556.0,42,was,4,9,26,17,8,15,-5,22,Tommy Thompson,Health and Human Services,per-per,---,PROPN-PROPN,PROPN-CCONJ-PROPN-PROPN,compound-pobj,pobj-cc-compound-conj,NNP-NNP,NNP-CC-NNP-NNPS,8,1
9543,12722.0,52,declared,23,7,14,7,6,37,16,-9,Tommy Thompson,Health and Human Services,per-per,---,PROPN-PROPN,PROPN-CCONJ-PROPN-PROPN,compound-nsubj,pobj-cc-compound-conj,NNP-NNP,NNP-CC-NNP-NNPS,6,1
9544,13820.0,24,ran,1,10,20,10,9,3,-9,19,Tommy Thompson,Health and Human Services,org-org,---,PROPN-PROPN,PROPN-CCONJ-PROPN-PROPN,compound-pobj,pobj-cc-compound-conj,NNP-NNP,NNP-CC-NNP-NNPS,8,1
9545,14109.0,75,recognised,3,8,13,5,7,61,-5,10,Tommy Thompson,Health and Human Services,per-per,---,PROPN-PROPN,PROPN-CCONJ-PROPN-PROPN,compound-pobj,pobj-cc-compound-conj,NNP-NNP,NNP-CC-NNP-NNPS,7,1
9546,7944.0,48,swept,6,9,33,24,8,14,-3,27,Socialist Labor Party of America,DeLeon,----,per,PROPN-PROPN-PROPN-ADP-PROPN,PROPN,compound-compound-dobj-prep-pobj,appos,NNP-NNP-NNP-IN-NNP,NNP,6,1
9547,7946.0,29,is,8,1,14,13,0,14,7,6,Beata Moon,composer,-,org,PROPN-PROPN,NOUN,compound-nsubj,conj,NNP-NNP,NN,3,1
9548,7947.0,9,is,1,6,7,1,5,1,-5,6,actor,James Drury,org,-,NOUN,PROPN-PROPN,compound,compound-pobj,NN,NNP-NNP,1,1
9549,7948.0,50,featured,14,28,34,6,27,15,-14,20,Lafayette High School,Williamsburg,per-per-per,,PROPN-PROPN-PROPN,PROPN,compound-compound-compound,compound,NNP-NNP-NNP,NNP,6,1
9550,7950.0,24,graduated,1,4,9,5,3,14,-3,8,Oaks Christian High School,Westlake Village,org-org-org-org,-,PROPN-PROPN-PROPN-PROPN,PROPN-PROPN,compound-compound-compound-pobj,compound-compound,NNP-NNP-NNP-NNP,NNP-NNP,4,1
9551,7951.0,20,blamed,6,1,9,8,0,10,5,3,Spain,European Central Bank,org,--,PROPN,PROPN-PROPN-PROPN,poss,compound-compound-dobj,NNP,NNP-NNP-NNP,5,1
9552,7952.0,22,is,11,5,5,0,4,16,6,-6,Tianjin,Tianjin Metro,per,-,PROPN,PROPN-PROPN,compound,compound-pobj,NNP,NNP-NNP,0,1
9553,7954.0,24,is,11,10,18,8,9,5,1,7,Massachusetts,Boston College Eagles,org,--,PROPN,PROPN-PROPN-PROPN,pobj,compound-compound-pobj,NNP,NNP-NNP-NNPS,6,1
9554,7955.0,13,goes,4,7,11,4,6,1,-3,7,Syd Barrett,Pink Floyd,per-per,-,PROPN-PROPN,PROPN-PROPN,compound-compound,compound-pobj,NNP-NNP,NNP-NNP,3,1
9555,7956.0,12,is,3,8,10,2,7,1,-5,7,Nasr,Cairo,per,,PROPN,PROPN,compound,compound,NNP,NNP,1,1
9556,9236.0,36,died,1,21,24,3,20,11,-20,23,Nasr,Cairo,,per,PROPN,PROPN,compound,compound,NNP,NNP,4,1
9557,10958.0,29,told,8,23,28,5,22,0,-15,20,Nasr,Cairo,org,,PROPN,PROPN,compound,pobj,NNP,NNP,7,1
9558,7959.0,32,operates,7,11,1,-10,10,30,-4,-6,Royal Dutch Shell,Shell Oil Company,org-org-org,--,ADJ-PROPN-PROPN,PROPN-PROPN-PROPN,compound-compound-compound,compound-compound-pobj,JJ-NNP-NNP,NNP-NNP-NNP,7,1
9559,7960.0,36,succeed,2,4,22,18,3,13,-2,20,Klaus Zumwinkel,Telekom,-,per,PROPN-PROPN,PROPN,compound-dobj,poss,NNP-NNP,NNP,8,1
9560,7961.0,35,is,15,1,1,0,0,33,14,-14,GMA Network,GMA Films,per-per,-,PROPN-PROPN,PROPN-PROPN,compound-compound,compound-pobj,NNP-NNP,NNP-NNPS,0,1
9561,7962.0,26,is,6,2,13,11,1,12,4,7,National Police Agency,South Korea,--,per-per,PROPN-PROPN-PROPN,PROPN-PROPN,compound-compound-nsubj,compound-pobj,NNP-NNP-NNP,NNP-NNP,5,1
9562,12754.0,30,is,8,3,17,14,2,12,5,9,National Police Agency,South Korea,org-org-org,-,PROPN-PROPN-PROPN,PROPN-PROPN,compound-compound-nsubj,compound-pobj,NNP-NNP-NNP,NNP-NNP,7,1
9563,7963.0,16,affiliated,3,6,9,3,5,6,-3,6,Vinoba Bhave University,Hazaribagh,org-org-org,,PROPN-PROPN-PROPN,PROPN,compound-compound-compound,pobj,NNP-NNP-NNP,NNP,4,1
9564,7964.0,17,lost,6,12,14,2,11,2,-6,8,National Defense,Fidel V. Ramos,per-per,--,PROPN-PROPN,PROPN-PROPN-PROPN,pobj-compound,compound-compound-pobj,NNP-NNP,NNP-NNP-NNP,4,1
9565,7966.0,20,holds,6,3,5,2,2,14,3,-1,Polshek Partnership,James Polshek,-,per-per,PROPN-PROPN,PROPN-PROPN,compound-compound,compound-pobj,NNP-NNP,NNP-NNP,1,1
9566,7967.0,26,announced,5,5,5,0,4,20,0,0,Brann,Brann Stadion,,per-per,PROPN,PROPN-PROPN,nsubj,compound-pobj,NNP,NNP-NNP,0,1
9567,7970.0,27,performed,4,1,8,7,0,18,3,4,Birds of Tokyo,Perth,--,org,NOUN-ADP-PROPN,PROPN,nsubj-prep-pobj,compound,NNS-IN-NNP,NNP,4,1
9568,11069.0,25,formed,3,1,14,13,0,10,2,11,Birds of Tokyo,Perth,--,per,NOUN-ADP-PROPN,PROPN,nsubj-prep-pobj,compound,NNS-IN-NNP,NNP,3,1
9569,7971.0,22,born,3,1,11,10,0,10,2,8,Louise Laroche,France,-,per,PROPN-PROPN,PROPN,compound-nsubjpass,pobj,NNP-NNP,NNP,2,1
9570,7972.0,28,caught,6,17,22,5,16,5,-11,16,his,Texas,per,,DET,PROPN,poss,pobj,PRP$,NNP,4,1
9571,7973.0,20,met,9,6,9,3,5,10,3,0,Mykola Azarov,Ukraine,-,per,PROPN-PROPN,PROPN,compound-nsubj,pobj,NNP-NNP,NNP,1,1
9572,9884.0,41,On,0,10,18,8,9,22,-10,18,Mykola Azarov,Ukraine,org-org,,PROPN-PROPN,PROPN,compound-compound,pobj,NNP-NNP,NNP,8,1
9573,7976.0,29,is,2,14,22,8,13,6,-12,20,United States,AOL,-,per,PROPN-PROPN,PROPN,compound-pobj,pobj,NNP-NNP,NNP,5,1
9574,7977.0,25,been,4,12,15,3,11,9,-8,11,Birmingham Business School,University of Birmingham,org-org-org,--,PROPN-PROPN-PROPN,PROPN-ADP-PROPN,compound-compound-compound,pobj-prep-pobj,NNP-NNP-NNP,NNP-IN-NNP,3,1
9575,7978.0,28,recorded,1,14,18,4,13,9,-13,17,Manntis,Century Media,,org-org,PROPN,PROPN-PROPN,appos,compound-compound,NNP,NNP-NNP,8,1
9576,7980.0,28,belonged,1,10,20,10,9,7,-9,19,Graphic Data,Royal Bank of Scotland,org-org,---,PROPN-PROPN,PROPN-PROPN-ADP-PROPN,compound-pobj,compound-pobj-prep-compound,NNP-NNP,NNP-NNP-IN-NNP,8,1
9577,7981.0,26,born,3,1,11,10,0,14,2,8,Aditya Narayan,India,org-org,,PROPN-PROPN,PROPN,compound-compound,pobj,NNP-NNP,NNP,6,1
9578,7982.0,23,earned,2,7,10,3,6,12,-5,8,Saint Anselm College,Goffstown,per-per-per,,PROPN-PROPN-PROPN,PROPN,compound-compound-compound,compound,NNP-NNP-NNP,NNP,3,1
9579,7983.0,33,headed,3,8,16,8,7,16,-5,13,Gibraltar,Peter Caruana,per,-,PROPN,PROPN-PROPN,compound,compound-compound,NNP,NNP-NNP,4,1
9580,7984.0,21,was,1,6,18,12,5,2,-5,17,Tokyo,Hitotsubashi University,org,-,PROPN,PROPN-PROPN,compound,compound-appos,NNP,NNP-NNP,3,1
9581,7985.0,24,elected,6,19,21,2,18,2,-13,15,Executive Council,W. T. Cosgrave,-,per-per-per,PROPN-PROPN,PROPN-PROPN-PROPN,compound-compound,compound-compound-pobj,NNP-NNP,NNP-NNP-NNP,4,1
9582,10888.0,29,were,15,11,13,2,10,15,4,-2,Executive Council,W. T. Cosgrave,-,per-per-per,PROPN-PROPN,PROPN-PROPN-PROPN,compound-compound,compound-compound-pobj,NNP-NNP,NNP-NNP-NNP,8,1
9583,7986.0,39,was,30,7,5,-2,6,33,23,-25,Michael Wynne,Air Force,-,per-per,PROPN-PROPN,PROPN-PROPN,compound-pobj,compound-compound,NNP-NNP,NNP-NNP,1,1
9584,7988.0,22,established,9,2,3,1,1,18,7,-6,1982,Raffles Junior College,per,--,NUM,PROPN-PROPN-PROPN,pobj,compound-compound-nsubjpass,CD,NNP-NNP-NNP,2,1
9585,7989.0,17,written,2,7,10,3,6,6,-5,8,This Heat,Charles Bullen,-,org-org,DET-PROPN,PROPN-PROPN,det-pobj,pobj-compound,DT-NNP,NNP-NNP,2,1
9586,7990.0,23,is,2,5,19,14,4,3,-3,17,Long Beach,Bradley Nowell,per-per,-,PROPN-PROPN,PROPN-PROPN,compound-compound,compound-conj,NNP-NNP,NNP-NNP,7,1
9587,7991.0,41,That's,0,18,36,18,17,4,-18,36,Los Angeles,Walter Mosley,per-per,-,PROPN-PROPN,PROPN-PROPN,compound-pobj,compound-poss,NNP-NNP,NNP-NNP,9,1
9588,9579.0,29,included,12,1,22,21,0,6,11,10,Los Angeles,Walter Mosley,per-per,-,PROPN-PROPN,PROPN-PROPN,compound-compound,compound-compound,NNP-NNP,NNP-NNP,8,1
9589,7992.0,25,is,6,1,18,17,0,6,5,12,Daphne Koller,Stanford University,-,per-per,PROPN-PROPN,PROPN-PROPN,compound-nsubj,compound-pobj,NNP-NNP,NNP-NNP,6,1
9590,7993.0,26,came,2,8,19,11,7,6,-6,17,his,Red Lightnin ' Records,,per-per-per-per,DET,PROPN-PROPN-PUNCT-PROPN,poss,compound-pobj-case-compound,PRP$,NNP-NNP-''-NNP,5,1
9591,7994.0,26,was,3,3,22,19,2,3,0,19,Cook,USAA,per,,PROPN,PROPN,nsubj,compound,NNP,NNP,9,1
9592,7995.0,22,is,2,1,16,15,0,5,1,14,Craig Bolton,Sydney Swans,-,per-per,PROPN-PROPN,PROPN-PROPN,compound-nsubj,compound-conj,NNP-NNP,NNP-NNPS,5,1
9593,7996.0,22,saw,1,3,9,6,2,12,-2,8,Karad?i,of Republika Srps,org,--,X,ADP-PROPN-PROPN,xcomp,prep-compound-pobj,ADD,IN-NNP-NNP,-1,1
9594,10755.0,34,Karad?i,0,1,6,5,0,27,-1,6,Karad?i,of Republika Srps,org,--,PUNCT,ADP-PROPN-PROPN,ROOT,prep-compound-pobj,LS,IN-NNP-NNP,-1,1
9595,7998.0,35,featured,8,18,21,3,17,13,-10,13,Tim McIlrath,Rise Against,org-org,-,PROPN-PROPN,PROPN-PROPN,compound-pobj,pobj-prep,NNP-NNP,NNP-NNP,3,1
9596,7999.0,20,was,1,9,12,3,8,7,-8,11,Montana,Colin Meloy,,org-org,PROPN,PROPN-PROPN,pobj,compound-dobj,NNP,NNP-NNP,2,1
9597,8001.0,50,take,5,18,23,5,17,26,-13,18,Shri Mata Vaishno Devi University,Katra,per-per-per-per-per,,PROPN-PROPN-PROPN-PROPN-PROPN,PROPN,compound-compound-compound-compound-compound,pobj,NNP-NNP-NNP-NNP-NNP,NNP,4,1
9598,8002.0,32,incorporated,5,2,8,6,1,23,3,3,College of Arms,1484,--,org,PROPN-ADP-PROPN,NUM,nsubjpass-prep-pobj,pobj,NNP-IN-NNP,CD,3,1
9599,8003.0,65,IsraelNN.com,1,4,8,4,3,56,-3,7,New York,Dov Hikind,per-per,-,PROPN-PROPN,PROPN-PROPN,compound-compound,compound-nsubj,NNP-NNP,NNP-NNP,2,1
9600,8990.0,25,said,11,4,8,4,3,16,7,-3,New York,Dov Hikind,-,per-per,PROPN-PROPN,PROPN-PROPN,compound-compound,compound-nsubj,NNP-NNP,NNP-NNP,2,1
9601,8004.0,30,is,3,2,29,27,1,0,1,26,Fontaine,France,org,,PROPN,PROPN,compound,pobj,NNP,NNP,2,1
9602,8007.0,30,handled,3,16,28,12,15,1,-13,25,Dominici,Dream Theater,,org-org,PROPN,PROPN-PROPN,pobj,compound-oprd,NNP,NNP-NNP,6,1
9603,8008.0,41,died,14,31,40,9,30,0,-17,26,Zalman Shazar,Israel,-,org,PROPN-PROPN,PROPN,compound-pobj,pobj,NNP-NNP,NNP,5,1
9604,8009.0,11,introduced,4,1,8,7,0,2,3,4,Football League Two,2004,--,org,PROPN-PROPN-NUM,NUM,compound-compound-nsubjpass,nummod,NNP-NNP-CD,CD,5,1
9605,8010.0,37,champion,4,2,6,4,1,30,2,2,Major League Soccer,D.C. United,org-org-org,-,PROPN-PROPN-PROPN,PROPN-PROPN,compound-compound-compound,compound-nsubjpass,NNP-NNP-NNP,NNP-NNP,1,1
9606,8011.0,47,wrote,11,28,32,4,27,14,-17,21,India,Savitri,org,,PROPN,PROPN,pobj,compound,NNP,NNPS,3,1
9607,8012.0,48,LONDON,0,15,37,22,14,10,-15,37,Pakistan,Zulfikar Ali Bhutto,,per-per-per,PROPN,PROPN-PROPN-PROPN,dobj,compound-compound-pobj,NNP,NNP-NNP-NNP,2,1
9608,8013.0,18,received,5,12,17,5,11,0,-7,12,Lawrence Technological University,Michigan,per-per-per,,PROPN-PROPN-PROPN,PROPN,compound-compound-pobj,pobj,NNP-NNP-NNP,NNP,4,1
9609,8014.0,30,was,4,7,13,6,6,16,-3,9,Memphis,The Honky Tonk Man,org,---,PROPN,DET-PROPN-PROPN-PROPN,pobj,det-compound-compound-appos,NNP,DT-NNP-NNP-NNP,5,1
9610,8015.0,28,took,4,11,26,15,10,1,-7,22,Amin,Saudi Arabia,per,-,PROPN,PROPN-PROPN,nsubj,compound-pobj,NNP,NNP-NNP,4,1
9611,8016.0,39,Furnish,11,1,19,18,0,19,10,8,Ireland,Westlife,,per,PROPN,PROPN,poss,nsubj,NNP,NNP,8,1
9612,8018.0,43,decided,13,1,6,5,0,36,12,-7,Naviair,Danish Ministry of Transport,per,---,PROPN,PROPN-PROPN-ADP-PROPN,nsubj,compound-pobj-prep-pobj,NNP,NNP-NNP-IN-NNP,3,1
9613,8019.0,28,is,2,8,14,6,7,13,-6,12,Grateful Dead,Phil Lesh,per-per,-,PROPN-PROPN,PROPN-PROPN,compound-pobj,compound-pobj,NNP-NNP,NNP-NNP,3,1
9614,8020.0,24,said,22,1,22,21,0,1,21,0,Austria,Fischer,per,,PROPN,PROPN,nsubj,nsubj,NNP,NNP,1,1
9615,8021.0,23,presented,3,19,21,2,18,1,-16,18,Thailand,Chatichai Choonhavan,per,-,PROPN,PROPN-PROPN,compound,compound-pobj,NNP,NNP-NNP,1,1
9616,9420.0,20,presented,3,16,18,2,15,1,-13,15,Thailand,Chatichai Choonhavan,org,-,PROPN,PROPN-PROPN,compound,compound-pobj,NNP,NNP-NNP,1,1
9617,8024.0,20,based,5,15,2,-13,14,17,-10,-3,BRAC,Dhaka,,org,PROPN,PROPN,conj,pobj,NNP,NNP,4,1
9618,8027.0,33,used,2,4,5,1,3,27,-2,3,cinematographer,Barry Sonnenfeld,,per-per,NOUN,PROPN-PROPN,compound,compound-dobj,NN,NNP-NNP,1,1
9619,8029.0,19,was,7,6,11,5,5,7,1,4,Yuki Kajiura,composer,per-per,,PROPN-PROPN,NOUN,compound-nsubj,attr,NNP-NNP,NN,5,1
9620,8030.0,24,entered,9,4,8,4,3,15,5,-1,Clorox,Oakland,org,,PROPN,PROPN,compound,compound,NNP,NNP,3,1
9621,8031.0,35,referred,26,13,3,-10,12,31,13,-23,institution,California State Normal School,,per-per-per-per,NOUN,PROPN-PROPN-PROPN-PROPN,nsubjpass,compound-compound-compound-pobj,NN,NNP-NNP-NNP-NNP,6,1
9622,8033.0,30,stopped,13,6,11,5,5,18,7,-2,Gazpromavia,Gazprom,,per,PROPN,PROPN,pobj,compound,NNP,NNP,4,1
9623,8035.0,16,operates,3,1,12,11,0,3,2,9,Ford Motor Company,Automotive Components Holdings,org-org-org,--,PROPN-PROPN-PROPN,PROPN-PROPN-PROPN,compound-compound-nsubj,compound-compound-compound,NNP-NNP-NNP,NNP-NNP-NNPS,6,1
9624,8036.0,23,broadcasts,2,1,16,15,0,6,1,14,C Television,Tobago,-,org,PROPN-PROPN,PROPN,compound-nsubj,conj,NNP-NNP,NNP,7,1
9625,8038.0,19,won,1,1,13,12,0,5,0,12,Verhofstadt,Belgium,,per,PROPN,PROPN,nsubj,poss,NNP,NNP,5,1
9626,8039.0,78,is,11,64,73,9,63,4,-53,62,Wales,Arriva North West and Wales,,per-per-per-per-per,PROPN,PROPN-PROPN-PROPN-CCONJ-PROPN,compound,compound-compound-pobj-cc-conj,NNP,NNP-NNP-NNP-CC-NNP,-1,1
9627,8040.0,26,is,3,16,19,3,15,6,-13,16,Crystal Dynamics,Europe,per-per,,PROPN-PROPN,PROPN,compound-pobj,pobj,NNP-NNPS,NNP,5,1
9628,8041.0,17,Under,0,12,16,4,11,0,-12,16,VASP,1990,per,,PROPN,NUM,nsubjpass,pobj,NNP,CD,3,1
9629,8042.0,33,get,13,5,31,26,4,1,8,18,Paul O'Neill,Treasury,-,org,PROPN-PROPN,PROPN,compound-appos,compound,NNP-NNP,NNP,8,1
9630,10336.0,32,said,20,4,30,26,3,1,16,10,Paul O'Neill,Treasury,per-per,,PROPN-PROPN,PROPN,compound-appos,compound,NNP-NNP,NNP,9,1
9631,12924.0,8,Bush's,2,1,5,4,0,2,1,3,Paul O'Neill,Treasury,per-per,,PROPN-PROPN,PROPN,compound-compound,compound,NNP-NNP,NNP,3,1
9632,8045.0,25,defeated,3,5,11,6,4,13,-2,8,Christopher Newport University,NCAA,--,per,PROPN-PROPN-PROPN,PROPN,compound-compound-dobj,compound,NNP-NNP-NNP,NNP,6,1
9633,8046.0,18,On,0,7,15,8,6,2,-7,15,his,Spinnin,per,,DET,PROPN,poss,poss,PRP$,NNP,7,1
9634,8047.0,20,sponsored,3,7,11,4,6,8,-4,8,Aviation Institute,University of Nebraska at Omaha,-,per-per-per-per-per,PROPN-PROPN,PROPN-ADP-PROPN-ADP-PROPN,compound-pobj,pobj-prep-pobj-prep-pobj,NNP-NNP,NNP-IN-NNP-IN-NNP,5,1
9635,8048.0,19,housed,7,15,18,3,14,0,-8,11,Union College,NY,org-org,,PROPN-PROPN,PROPN,pobj-compound,pobj,NNP-NNP,NNP,6,1
9636,8049.0,34,BKN-BILLUPS-ART,0,6,22,16,5,11,-6,22,Chauncey Billups,George Washington High School,org-org,---,PROPN-PROPN,PROPN-PROPN-PROPN-PROPN,compound-nsubj,compound-compound-compound-dobj,NNP-NNP,NNP-NNP-NNP-NNP,-1,1
9637,8050.0,28,includes,6,4,18,14,3,9,2,12,Dartmouth College,Ivy League,org-org,-,PROPN-PROPN,PROPN-PROPN,compound-compound,compound-compound,NNP-NNP,NNP-NNP,7,1
9638,8051.0,44,seemed,34,2,4,2,1,39,32,-30,Republican,Lisa Murkowski,,per-per,ADJ,PROPN-PROPN,amod,compound-nsubj,JJ,NNP-NNP,1,1
9639,8052.0,52,graduated,1,31,35,4,30,16,-30,34,Joliot-Curie,France,per,,PROPN,PROPN,pobj,pobj,NNP,NNP,9,1
9640,13850.0,55,petitioned,30,9,24,15,8,30,21,-6,Joliot-Curie,France,org,,PROPN,PROPN,pobj,compound,NNP,NNP,5,1
9641,8053.0,25,is,9,17,22,5,16,2,-8,13,Bell Helicopter,Texas,per-per,,PROPN-PROPN,PROPN,compound-pobj,pobj,NNP-NNP,NNP,3,1
9642,8055.0,28,died,1,13,26,13,12,1,-12,25,Ptolemy,Cleopatra VII,per,-,PROPN,PROPN-PROPN,compound,compound-conj,NNP,NNP-NNP,8,1
9643,8056.0,26,sworn,8,1,14,13,0,11,7,6,Valdis Zatlers,Latvia,per-per,,PROPN-PROPN,PROPN,compound-nsubjpass,poss,NNP-NNP,NNP,5,1
9644,8057.0,31,returned,8,11,11,0,10,19,-3,3,Norfolk State University,Norfolk,org-org-org,,PROPN-PROPN-PROPN,PROPN,compound-compound-pobj,pobj,NNP-NNP-NNP,NNP,0,1
9645,12582.0,30,is,8,20,20,0,19,9,-12,12,Norfolk State University,Norfolk,--,org,PROPN-PROPN-PROPN,PROPN,compound-compound-pobj,pobj,NNP-NNP-NNP,NNP,0,1
9646,8058.0,58,reported,38,18,20,2,17,37,20,-18,Prime Minister,Atef Sedki,org-org,-,PROPN-PROPN,PROPN-PROPN,compound-compound,compound-pobj,NNP-NNP,NNP-NNP,1,1
9647,8059.0,14,located,4,1,13,12,0,0,3,9,Hudson Middle School,Ohio,--,per,PROPN-PROPN-PROPN,PROPN,compound-compound-nsubjpass,pobj,NNP-NNP-NNP,NNP,3,1
9648,8061.0,29,feuded,3,21,21,0,20,7,-18,18,Juventud Guerrera,Juventud,org-org,,PROPN-PROPN,PROPN,compound-conj,poss,NNP-NNP,NNP,0,1
9649,8062.0,25,recorded,5,9,16,7,8,8,-4,11,Solomon Burke,Atlantic,-,per,PROPN-PROPN,PROPN,compound-pobj,compound,NNP-NNP,NNP,6,1
9650,8063.0,24,joined,1,14,20,6,13,3,-13,19,Andreas Papandreou,Greek,per-per,,PROPN-PROPN,ADJ,compound-pobj,amod,NNP-NNP,JJ,6,1
9651,8065.0,37,warned,10,7,9,2,6,27,3,-1,Kiribati,Anote Tong,per,-,PROPN,PROPN-PROPN,compound,compound-nsubj,NNP,NNP-NNP,1,1
9652,10433.0,46,added,21,5,7,2,4,38,16,-14,Kiribati,Anote Tong,org,-,PROPN,PROPN-PROPN,compound,compound-nsubj,NNP,NNP-NNP,2,1
9653,8066.0,47,comes,7,15,24,9,14,22,-8,17,Bolivia,Paz Estenssoro,per,-,PROPN,PROPN-PROPN,pobj,compound-pobj,NNP,NNP-NNP,5,1
9654,9531.0,32,regulated,5,4,27,23,3,4,1,22,Bolivia,Paz Estenssoro,per,-,PROPN,PROPN-PROPN,pobj,compound-pobj,NNP,NNP-NNP,8,1
9655,8069.0,20,became,1,1,9,8,0,10,0,8,He,New Jersey,,per-per,PRON,PROPN-PROPN,nsubj,compound-pobj,PRP,NNP-NNP,5,1
9656,8071.0,16,is,6,5,13,8,4,2,1,7,PCA,Lilburn,per,,PROPN,PROPN,appos,compound,NNP,NNP,7,1
9657,8072.0,16,born,2,6,10,4,5,5,-4,8,Michigan,Terry Crews,org,-,PROPN,PROPN-PROPN,pobj,compound-compound,NNP,NNP-NNP,4,1
9658,8073.0,41,said,2,8,10,2,7,30,-6,8,Sweden,Bergman,,per,PROPN,PROPN,nsubj,conj,NNP,NNP,3,1
9659,8074.0,13,included,5,1,4,3,0,8,4,-1,Lisa Kelly,Celtic Woman,per-per,-,PROPN-PROPN,PROPN-PROPN,compound-nsubj,compound-pobj,NNP-NNP,NNP-NNP,2,1
9660,8075.0,24,School,7,14,17,3,13,6,-7,10,University of Ibadan,Nigeria,--,per,PROPN-ADP-PROPN,PROPN,ROOT-prep-compound,pobj,NNP-IN-NNP,NNP,2,1
9661,8076.0,44,gained,18,13,33,20,12,10,5,15,Gibraltar,Robert Peliza,org,-,PROPN,PROPN-PROPN,pobj,compound-appos,NNP,NNP-NNP,9,1
9662,8077.0,19,is,2,2,7,5,1,11,0,5,party,Liberal International,per,-,NOUN,PROPN-PROPN,nsubj,compound-pobj,NN,NNP-NNP,3,1
9663,8081.0,21,warned,6,2,4,2,1,16,4,-2,Health,Liow Tiong Lai,,org-org-org,PROPN,PROPN-PROPN-PROPN,compound,compound-compound-nsubj,NNP,NNP-NNP-NNP,2,1
9664,8082.0,64,Committee,2,32,11,-21,31,52,-30,9,USA,University of Texas at Dallas,per,----,PROPN,PROPN-ADP-PROPN-ADP-PROPN,compound,ROOT-prep-pobj-prep-compound,NNP,NNP-IN-NNP-IN-NNP,-1,1
9665,8086.0,20,held,7,10,18,8,9,1,-3,11,Alfa Group,Mikhail Fridman,per-per,-,PROPN-PROPN,PROPN-PROPN,compound-pobj,compound-pobj,NNP-NNP,NNP-NNP,6,1
9666,11701.0,25,is,8,1,7,6,0,17,7,-1,Alfa Group,Mikhail Fridman,per-per,-,PROPN-PROPN,PROPN-PROPN,compound-nsubj,compound-pobj,NNP-NNP,NNP-NNP,3,1
9667,8087.0,22,acquired,11,1,8,7,0,13,10,-3,RBC Bank,Royal Bank of Canada,-,org-org-org-org,PROPN-PROPN,PROPN-PROPN-ADP-PROPN,compound-nsubj,compound-pobj-prep-pobj,NNP-NNP,NNP-NNP-IN-NNP,3,1
9668,8088.0,27,was,1,6,8,2,5,18,-5,7,Jo Grimond,Baron Grimond,org-org,-,PROPN-PROPN,PROPN-PROPN,compound-compound,compound-pobj,NNP-NNP,NNP-NNP,1,1
9669,8089.0,38,reaps,21,1,7,6,0,30,20,-14,Pacific Sunwear,Anaheim,org-org,,PROPN-PROPN,PROPN,compound-nsubj,compound,NNP-NNP,NNP,2,1
9670,8090.0,27,disappeared,7,3,20,17,2,6,4,13,his,Kenya,per,,DET,PROPN,poss,compound,PRP$,NNP,7,1
9671,8092.0,21,is,6,2,3,1,1,17,4,-3,Northern Illinois University,Illinois,--,per,PROPN-PROPN-PROPN,PROPN,nmod-compound-pobj,compound,NNP-NNP-NNP,NNP,1,1
9672,8093.0,27,focusing,6,9,19,10,8,7,-3,13,Shakira,Colombia,,org,PROPN,PROPN,compound,compound,NNP,NNP,6,1
9673,8094.0,42,came,29,10,28,18,9,13,19,-1,Paz Estenssoro,Bolivia,per-per,,PROPN-PROPN,PROPN,compound-poss,pobj,NNP-NNP,NNP,5,1
9674,8095.0,35,cited,3,14,18,4,13,16,-11,15,Xavier Niel,Free,-,org,PROPN-PROPN,PROPN,compound-compound,compound,NNP-NNP,NNP,3,1
9675,8096.0,15,released,1,1,13,12,0,1,0,12,Moore,Epic,org,,PROPN,PROPN,nsubj,compound,NNP,NNP,-1,1
9676,8097.0,51,worked,1,40,49,9,39,1,-39,48,Other Worlds,November 1949,-,org-org,ADJ-PROPN,PROPN-NUM,compound-conj,npadvmod-nummod,JJ-NNPS,NNP-CD,2,1
9677,8099.0,69,gained,16,7,47,40,6,21,9,31,actor,Mauritz Stiller,,per-per,NOUN,PROPN-PROPN,nsubj,compound-dobj,NN,NNP-NNP,7,1
9678,8102.0,36,said,5,1,2,1,0,33,4,-3,Delphi,chief executive,,per-per,ADJ,ADJ-NOUN,amod,amod-nsubj,JJ,JJ-NN,1,1
9679,8103.0,37,ranked,4,6,10,4,5,26,-2,6,PLC,Australia,,per,PROPN,PROPN,compound,poss,NNP,NNP,1,1
9680,8104.0,40,is,8,12,20,8,11,19,-4,12,African Methodist Episcopal Church,Richard Allen,per-per-per-per,-,PROPN-PROPN-PROPN-PROPN,PROPN-PROPN,compound-compound-compound-attr,compound-pobj,NNP-NNP-NNP-NNP,NNP-NNP,5,1
9681,8105.0,34,received,1,12,15,3,11,18,-11,14,University of Florence,Italy,org-org-org,,PROPN-ADP-PROPN,PROPN,pobj-prep-compound,pobj,NNP-IN-NNP,NNP,4,1
9682,8106.0,24,became,5,1,4,3,0,19,4,-1,Lassie Goodbread-Black,Lake City,-,per-per,PROPN-PROPN,PROPN-PROPN,compound-nsubj,compound-pobj,NNP-NNP,NNP-NNP,2,1
9683,8107.0,25,recognized,13,10,20,10,9,4,3,7,college,Montreal,org,,NOUN,PROPN,nsubjpass,poss,NN,NNP,7,1
9684,8108.0,15,is,3,1,14,13,0,0,2,11,Canton High School,Connecticut,--,per,PROPN-PROPN-PROPN,PROPN,compound-compound-nsubj,pobj,NNP-NNP-NNP,NNP,10,1
9685,8111.0,54,was,1,10,33,23,9,20,-9,32,Cambodia,Pol Pot,per,-,PROPN,PROPN-PROPN,pobj,compound-poss,NNP,NNP-NNP,7,1
9686,8813.0,26,recovering,2,1,12,11,0,13,1,10,Cambodia,Pol Pot,,per-per,PROPN,PROPN-PROPN,nsubj,compound-nsubj,NNP,NNP-NNP,5,1
9687,11056.0,40,argued,21,15,28,13,14,11,6,7,Cambodia,Pol Pot,,org-org,PROPN,PROPN-PROPN,poss,compound-nsubj,NNP,NNP-NNP,9,1
9688,13602.0,34,exposed,12,12,21,9,11,12,0,9,Cambodia,Pol Pot,org,-,PROPN,PROPN-PROPN,pobj,compound-pobj,NNP,NNP-NNP,6,1
9689,8112.0,20,has,2,15,18,3,14,1,-13,16,Go-Ahead group,Meteor Parking,-,per-per,PROPN-NOUN,PROPN-PROPN,compound-compound,compound-pobj,NNP-NN,NNP-NNP,2,1
9690,8113.0,25,returned,1,4,23,19,3,1,-3,22,Chile,Jorge Montt,,per-per,PROPN,PROPN-PROPN,pobj,compound-pobj,NNP,NNP-NNP,5,1
9691,13847.0,38,recruited,4,22,23,1,21,14,-18,19,Chile,Jorge Montt,org,-,PROPN,PROPN-PROPN,compound,compound-pobj,NNP,NNP-NNP,1,1
9692,8115.0,46,invited,1,25,30,5,24,15,-24,29,The Allman Brothers Band,Dickey Betts,org-org-org-org,-,DET-PROPN-PROPN-PROPN,PROPN-PROPN,det-compound-compound-pobj,compound-nsubjpass,DT-NNP-NNPS-NNP,NNP-NNP,6,1
9693,8116.0,42,commented,11,1,5,4,0,36,10,-6,Michael Simms,Linux Game Publishing,per-per,--,PROPN-PROPN,PROPN-PROPN-PROPN,compound-compound,compound-compound-pobj,NNP-NNP,NNP-NNP-NNP,4,1
9694,8117.0,43,Cerati,4,1,26,25,0,16,3,22,Gustavo Cerati,Argentina,per-per,,PROPN-PROPN,PROPN,compound-ROOT,pobj,NNP-NNP,NNP,-1,1
9695,8118.0,23,is,1,1,7,6,0,15,0,6,CCNM,Association of Accredited Naturopathic Medical Colleges,org,-----,PROPN,PROPN-ADP-PROPN-PROPN-PROPN-PROPN,nsubj,pobj-prep-compound-compound-compound-pobj,NNP,NNP-IN-NNP-NNP-NNP-NNPS,4,1
9696,8119.0,62,took,24,50,56,6,49,5,-26,32,Nova Scotia,Peter MacKay,org-org,-,PROPN-PROPN,PROPN-PROPN,compound-pobj,compound-poss,NNP-NNP,NNP-NNP,-1,1
9697,13154.0,57,announced,5,23,34,11,22,22,-18,29,Nova Scotia,Peter MacKay,per-per,-,PROPN-PROPN,PROPN-PROPN,compound-compound,compound-pobj,NNP-NNP,NNP-NNP,5,1
9698,8120.0,14,creates,6,5,13,8,4,0,1,7,de San,Peru,-,per,PROPN-PROPN,PROPN,compound-nsubj,pobj,NNP-NNP,NNP,2,1
9699,9428.0,12,joined,3,8,11,3,7,0,-5,8,de San,Peru,org-org,,X-PROPN,PROPN,compound-pobj,pobj,FW-NNP,NNP,4,1
9700,8122.0,44,signed,4,35,38,3,34,5,-31,34,Jeff Waters,Annihilator,per-per,,PROPN-PROPN,PROPN,compound-conj,appos,NNP-NNP,NNP,3,1
9701,8124.0,29,joined,1,4,10,6,3,18,-3,9,Indian Statistical Institute,Kolkata,--,per,PROPN-PROPN-PROPN,PROPN,compound-compound-dobj,ROOT,NNP-NNP-NNP,NNP,-1,1
9702,8125.0,16,attended,2,9,14,5,8,1,-7,12,New Trier High School,Winnetka,---,org,PROPN-PROPN-PROPN-PROPN,PROPN,compound-compound-compound-pobj,compound,NNP-NNP-NNP-NNP,NNP,3,1
9703,8126.0,40,FACT,0,21,26,5,20,13,-21,26,e VF Corp,f Greensbor,--,org-org,PROPN-PROPN-PROPN,X-PROPN,compound-compound-pobj,ROOT-nmod,NNP-NNP-NNP,XX-NNP,-1,1
9704,8127.0,46,registered,5,2,10,8,1,35,3,5,MoveOn.org,1998,per,,PROPN,NUM,compound,nummod,NNP,CD,3,1
9705,8128.0,23,replaces,19,1,16,15,0,6,18,-3,Kevin W. Cosby,Simmons College of Kentucky,--,per-per-per-per,PROPN-PROPN-PROPN,PROPN-PROPN-ADP-PROPN,nmod-nmod-nsubj,compound-pobj-prep-pobj,NNP-NNP-NNP,NNP-NNP-IN-NNP,7,1
9706,8130.0,34,built,6,17,20,3,16,13,-11,14,RUAG,Alpnach,,org,PROPN,PROPN,compound,compound,NNP,NNP,4,1
9707,8131.0,38,supported,5,3,20,17,2,17,2,15,Netherlands,Dries van Agt,,per-per-per,PROPN,PROPN-PROPN-PROPN,nsubjpass,compound-pobj-compound,NNP,NNP-NNP-NNP,2,1
9708,8132.0,27,received,1,1,23,22,0,3,0,22,Wickremanayake,Prime Minister,,per-per,PROPN,PROPN-PROPN,nsubj,compound-compound,NNP,NNP-NNP,4,1
9709,8133.0,93,served,2,36,41,5,35,51,-34,39,Kamp,Defense,,per,PROPN,PROPN,nsubj,pobj,NNP,NNP,1,1
9710,8135.0,20,were,3,9,15,6,8,4,-6,12,Papadopoulos,Greece,,org,PROPN,PROPN,poss,pobj,NNP,NNP,4,1
9711,8136.0,48,are,3,18,21,3,17,26,-15,18,Felipe Gozon,GMA Network,per-per,-,PROPN-PROPN,PROPN-PROPN,compound-appos,compound-appos,NNP-NNP,NNP-NNP,1,1
9712,8137.0,35,had,2,9,18,9,8,16,-7,16,Catholic People,Katholieke Volkspartij,org-org,-,PROPN-PROPN,PROPN-PROPN,compound-poss,compound-compound,NNP-NNPS,NNP-NNP,5,1
9713,8138.0,24,built,15,11,23,12,10,0,4,8,Ponte Vedra High School,2008,per-per-per-per,,PROPN-PROPN-PROPN-PROPN,NUM,compound-compound-compound-nsubjpass,pobj,NNP-NNP-NNP-NNP,CD,6,1
9714,8140.0,16,auditioned,9,3,9,6,2,6,6,0,Portugal,Luciana,org,,PROPN,PROPN,dobj,pobj,NNP,NNP,3,1
9715,8141.0,42,gave,6,3,39,36,2,2,3,33,1990,Bulgarian Socialist Party,per,--,NUM,PROPN-PROPN-PROPN,nummod,compound-compound-dobj,CD,NNP-NNP-NNP,6,1
9716,8142.0,32,is,9,23,29,6,22,2,-14,20,Universitaires Notre-Dame de la Paix,Namur,per-per-per-per-per,,PROPN-PROPN-PROPN-X-PROPN,PROPN,nmod-nmod-nmod-amod-pobj,compound,NNP-NNP-NNP-FW-NNP,NNP,2,1
9717,8143.0,20,disappeared,10,1,6,5,0,13,9,-4,His,Sinjai Plengpanich,,org-org,DET,PROPN-PROPN,poss,compound-appos,PRP$,NNP-NNP,1,1
9718,8144.0,17,Lonely,0,12,15,3,11,1,-12,15,Seven Places,BEC Recordings,per-per,-,NUM-PROPN,PROPN-PROPN,compound-pobj,compound-pobj,CD-NNPS,NNP-NNPS,2,1
9719,9348.0,16,Hear,0,11,14,3,10,1,-11,14,Seven Places,BEC Recordings,org-org,-,NUM-PROPN,PROPN-PROPN,compound-pobj,compound-pobj,CD-NNPS,NNP-NNPS,2,1
9720,8145.0,51,traced,6,4,13,9,3,37,2,7,ABC2,Australian Broadcasting,org,-,PROPN,PROPN-PROPN,pobj,compound-compound,NNP,NNP-NNP,4,1
9721,8146.0,13,is,5,3,11,8,2,1,2,6,Artemas Ward,Shrewsbury,per-per,,PROPN-PROPN,PROPN,compound-compound,compound,NNP-NNP,NNP,5,1
9722,8147.0,22,led,3,13,18,5,12,3,-10,15,Luxembourg,Arbed,,per,PROPN,PROPN,pobj,compound,NNP,NNP,4,1
9723,8148.0,27,constructed,12,2,6,4,1,20,10,-6,Johor,Universiti Teknologi,,org-org,PROPN,PROPN-PROPN,compound,compound-compound,NNP,NNP-NNP,4,1
9724,8149.0,30,According,0,23,26,3,22,3,-23,26,Tim Lambesis,As I Lay Dying,org-org,---,PROPN-PROPN,ADP-PRON-VERB-VERB,compound-pobj,pobj-pobj-compound-appos,NNP-NNP,IN-PRP-VBP-VBG,4,1
9725,8151.0,29,Led,0,8,10,2,7,18,-8,10,Ricky Bell,New Edition,org-org,-,PROPN-PROPN,PROPN-PROPN,compound-compound,compound-conj,NNP-NNP,NNP-NNP,1,1
9726,8153.0,22,housed,4,6,16,10,5,5,-2,12,Woolverstone Hall School,London County Council,org-org-org,--,PROPN-PROPN-PROPN,PROPN-PROPN-PROPN,compound-compound-dobj,compound-compound-pobj,NNP-NNP-NNP,NNP-NNP-NNP,7,1
9727,8154.0,18,formed,5,2,13,11,1,4,3,8,RND,Ahmed Ouyahia,per,-,PROPN,PROPN-PROPN,compound,compound-pobj,NNP,NNP-NNP,4,1
9728,8155.0,18,was,11,1,17,16,0,0,10,6,Thomas Holliday Hicks,Maryland,org-org-org,,PROPN-PROPN-PROPN,PROPN,compound-compound-nsubj,pobj,NNP-NNP-NNP,NNP,3,1
9729,8156.0,52,charged,20,6,19,13,5,32,14,-1,Sony Music,Howard Stringer,org-org,-,PROPN-PROPN,PROPN-PROPN,compound-pobj,compound-conj,NNP-NNP,NNP-NNP,7,1
9730,8157.0,23,was,1,1,6,5,0,16,0,5,Roblin,Winnipeg,,per,PROPN,PROPN,nsubj,compound,NNP,NNP,4,1
9731,8158.0,26,Houston,5,17,23,6,16,2,-12,18,University of Texas Medical Branch,Galveston,per-per-per-per-per,,PROPN-ADP-PROPN-PROPN-PROPN,PROPN,ROOT-prep-compound-compound-pobj,compound,NNP-IN-NNP-NNP-NNP,NNP,5,1
9732,8159.0,33,has,3,2,10,8,1,22,1,7,club,Group,,per,NOUN,PROPN,nsubj,compound,NN,NNP,4,1
9733,8160.0,28,is,1,12,21,9,11,6,-11,20,Finland,Emppu Vuorinen,org,-,PROPN,PROPN-PROPN,pobj,compound-pobj,NNP,NNP-NNP,8,1
9734,8162.0,19,implemented,8,8,13,5,7,5,0,5,Northumberland,school,org,,PROPN,NOUN,pobj,nsubj,NNP,NN,7,1
9735,8163.0,40,taught,2,8,16,8,7,23,-6,14,Fashion Institute of Technology,New York City,---,per-per-per,PROPN-PROPN-ADP-PROPN,PROPN-PROPN-PROPN,compound-conj-prep-pobj,compound-compound-compound,NNP-NNP-IN-NNP,NNP-NNP-NNP,7,1
9736,8164.0,30,included,1,6,13,7,5,16,-5,12,Sydney Sturgess,Barry Morse,-,org-org,PROPN-PROPN,PROPN-PROPN,compound-appos,compound-dobj,NNP-NNP,NNP-NNP,3,1
9737,8167.0,24,made,14,1,13,12,0,10,13,-1,Coakley,Massachusetts,,per,PROPN,PROPN,nsubj,pobj,NNP,NNP,4,1
9738,8168.0,46,said,12,3,10,7,2,35,9,-2,Roger A. Pielke,Colorado State University,per-per-per,--,PROPN-PROPN-PROPN,PROPN-PROPN-PROPN,compound-compound-compound,compound-compound-pobj,NNP-NNP-NNP,NNP-NNP-NNP,-1,1
9739,8169.0,50,played,3,7,26,19,6,23,-4,23,MuchMoreMusic,Canada,per,,PROPN,PROPN,pobj,nmod,NNP,NNP,-1,1
9740,8170.0,22,transferred,4,2,12,10,1,9,2,8,1931,Seven Kings High School,per,---,NUM,NUM-NOUN-PROPN-PROPN,pobj,compound-compound-compound-compound,CD,CD-NNS-NNP-NNP,6,1
9741,8174.0,95,included,11,20,41,21,19,53,-9,30,Blake Babies,Juliana Hatfield,org-org,-,PROPN-PROPN,PROPN-PROPN,compound-appos,compound-ROOT,NNP-NNPS,NNP-NNP,-1,1
9742,8176.0,29,Died,8,1,23,22,0,5,7,15,Ben Johnson,Carol Elaine Jones,-,org-org-org,PROPN-PROPN,PROPN-PROPN-PROPN,compound-nsubj,compound-compound-ROOT,NNP-NNP,NNP-NNP-NNP,-1,1
9743,8177.0,23,was,2,1,13,12,0,9,1,11,Henrietta Anne,France,-,per,PROPN-PROPN,PROPN,compound-nsubj,appos,NNP-NNP,NNP,4,1
9744,8178.0,28,moved,11,5,9,4,4,18,6,-2,1st Armored Division,commander,org-org-org,,NOUN-PROPN-PROPN,NOUN,compound-compound-poss,nsubj,NN-NNP-NNP,NN,4,1
9745,8179.0,15,closed,1,1,11,10,0,3,0,10,TSMC,Taiwan,,per,PROPN,PROPN,nsubj,compound,NNP,NNP,3,1
9746,8180.0,34,partnered,3,8,23,15,7,10,-5,20,Roots Music Group,Rick Guard,per-per-per,-,PROPN-PROPN-PROPN,PROPN-PROPN,compound-compound-nmod,compound-conj,NNP-NNP-NNP,NNP-NNP,6,1
9747,8181.0,36,met,6,1,4,3,0,31,5,-2,Indonesia,Susilo Bambang Yudhoyono,per,--,PROPN,PROPN-PROPN-PROPN,poss,compound-compound-nsubj,NNP,NNP-NNP-NNP,4,1
9748,10065.0,25,said,23,13,21,8,12,3,10,-2,Indonesia,Susilo Bambang Yudhoyono,,per-per-per,PROPN,PROPN-PROPN-PROPN,poss,compound-compound-pobj,NNP,NNP-NNP-NNP,4,1
9749,10469.0,38,said,8,1,4,3,0,33,7,-4,Indonesia,Susilo Bambang Yudhoyono,org,--,PROPN,PROPN-PROPN-PROPN,poss,compound-compound-nsubj,NNP,NNP-NNP-NNP,4,1
9750,10540.0,29,said,6,3,4,1,2,24,3,-2,Indonesia,Susilo Bambang Yudhoyono,per,--,PROPN,PROPN-PROPN-PROPN,pobj,compound-compound-appos,NNP,NNP-NNP-NNP,2,1
9751,12720.0,26,said,24,14,22,8,13,3,10,-2,Indonesia,Susilo Bambang Yudhoyono,,per-per-per,PROPN,PROPN-PROPN-PROPN,poss,compound-compound-pobj,NNP,NNP-NNP-NNP,4,1
9752,8182.0,28,are,10,2,24,22,1,3,8,14,Newtown Jets,Sydney,-,per,PROPN-NOUN,PROPN,compound-nsubj,poss,NNP-NNS,NNP,6,1
9753,8184.0,19,was,1,4,9,5,3,9,-3,8,Surfers,Touch,,org,PROPN,PROPN,poss,pobj,NNPS,NNP,3,1
9754,8185.0,36,got,2,4,7,3,3,28,-2,5,Rhode Island,Sheldon Whitehouse,org-org,-,PROPN-PROPN,PROPN-PROPN,compound-compound,compound-nsubj,NNP-NNP,NNP-NNP,2,1
9755,12462.0,42,had,7,34,40,6,33,1,-27,33,Rhode Island,Sheldon Whitehouse,org-org,-,PROPN-PROPN,PROPN-PROPN,compound-poss,compound-conj,NNP-NNP,NNP-NNP,1,1
9756,13366.0,52,issued,25,1,10,9,0,41,24,-15,Rhode Island,Sheldon Whitehouse,-,org-org,PROPN-PROPN,PROPN-PROPN,compound-poss,compound-conj,NNP-NNP,NNP-NNP,3,1
9757,8186.0,30,became,4,14,23,9,13,6,-10,19,SkyTeam,Delta Air Lines,org,--,PROPN,PROPN-PROPN-PROPN,nmod,compound-compound-conj,NNP,NNP-NNP-NNP,6,1
9758,8187.0,24,been,17,12,15,3,11,8,5,-2,Lou Anna Simon,MSU,--,per,PROPN-PROPN-PROPN,PROPN,compound-compound-compound,appos,NNP-NNP-NNP,NNP,3,1
9759,8188.0,17,served,3,8,15,7,7,1,-5,12,Oslo Commuter Rail,Norges Statsbaner,--,per-per,PROPN-PROPN-PROPN,PROPN-PROPN,compound-compound-compound,compound-pobj,NNP-NNP-NNP,NNPS-NNP,5,1
9760,8189.0,23,is,2,1,16,15,0,6,1,14,Kirklees College,Dewsbury,-,org,PROPN-PROPN,PROPN,compound-nsubj,pobj,NNP-NNP,NNP,9,1
9761,8190.0,19,released,10,2,17,15,1,1,8,7,band,Lion Music,org,-,NOUN,PROPN-PROPN,poss,compound-pobj,NN,NNP-NNP,5,1
9762,8191.0,22,graduated,1,1,5,4,0,16,0,4,He,University of Vienna,per,--,PRON,PROPN-ADP-PROPN,nsubj,pobj-prep-pobj,PRP,NNP-IN-NNP,3,1
9763,8192.0,20,was,4,2,13,11,1,6,2,9,759th Tank Battalion,Army,per-per-per,,ADJ-PROPN-PROPN,PROPN,compound-compound-nsubj,pobj,JJ-NNP-NNP,NNP,4,1
9764,8193.0,23,said,5,1,4,3,0,18,4,-1,MIC,Samy Vellu,org,-,PROPN,PROPN-PROPN,compound,compound-nsubj,NNP,NNP-NNP,1,1
9765,8194.0,19,played,4,8,1,-7,7,17,-4,-3,Chicago,The Ponys,org,-,PROPN,DET-PROPN,compound,det-appos,NNP,DT-NNP,5,1
9766,8195.0,22,is,12,12,16,4,11,5,0,4,O'Fredericks,Denmark,,org,PROPN,PROPN,nsubj,poss,NNP,NNP,5,1
9767,8197.0,48,said,1,36,44,8,35,3,-35,43,Saudi Aramco,Kingdom of Saudi Arabia,per-per,---,PROPN-PROPN,PROPN-ADP-PROPN-PROPN,compound-pobj,pobj-prep-compound-pobj,NNP-NNP,NNP-IN-NNP-NNP,8,1
9768,8199.0,36,included,2,26,35,9,25,0,-24,33,Antonio,Venezuela,per,,PROPN,PROPN,nsubj,pobj,NNP,NNP,1,1
9769,8200.0,46,received,2,38,43,5,37,2,-36,41,Ivy League,Dartmouth,-,per,PROPN-PROPN,PROPN,compound-nsubj,compound,NNP-NNP,NNP,3,1
9770,8201.0,40,were,3,25,28,3,24,11,-22,25,Radar,Elvis Costello,,org-org,PROPN,PROPN-PROPN,compound,compound-compound,NNP,NNP-NNP,2,1
9771,8202.0,31,is,3,1,10,9,0,20,2,7,ACL,Canada,,per,PROPN,PROPN,compound,pobj,NNP,NNP,5,1
9772,8203.0,66,selection,1,18,33,15,17,32,-17,32,Denmark,CBS,per,,PROPN,PROPN,nmod,pobj,NNP,NNP,4,1
9773,8204.0,27,competed,7,3,22,19,2,4,4,15,Ball State Cardinals,Division I,org-org-org,-,PROPN-PROPN-PROPN,PROPN-PRON,compound-compound-compound,compound-compound,NNP-NNP-NNPS,NNP-PRP,6,1
9774,8205.0,35,is,23,2,16,14,1,18,21,-7,University of Montenegro,),per-per-per,,PROPN-ADP-PROPN,PUNCT,nsubj-prep-compound,punct,NNP-IN-NNP,-RRB-,-1,1
9775,8206.0,35,incites,26,11,17,6,10,17,15,-9,Maxime Verhagen,Foreign Affairs,org-org,-,PROPN-PROPN,PROPN-PROPN,compound-npadvmod,compound-pobj,NNP-NNP,NNP-NNPS,4,1
9776,8208.0,20,is,3,13,18,5,12,1,-10,15,California,Aaron Turner,,per-per,PROPN,PROPN-PROPN,pobj,compound-pobj,NNP,NNP-NNP,2,1
9777,8209.0,13,is,3,1,11,10,0,1,2,8,Stephanie D. Neely,Chicago,--,per,PROPN-PROPN-ADV,PROPN,compound-compound-advmod,compound,NNP-NNP-RB,NNP,7,1
9778,8210.0,41,was,14,3,17,14,2,23,11,3,Olowofoyeku,Nigerian,,org,PROPN,ADJ,compound,amod,NNP,JJ,4,1
9779,8212.0,25,opened,6,2,9,7,1,15,4,3,University of Dallas,1956,per-per-per,,PROPN-ADP-PROPN,NUM,nsubj-prep-pobj,pobj,NNP-IN-NNP,CD,3,1
9780,8213.0,30,Institute,2,10,15,5,9,14,-8,13,University Grants Commission,university,per-per-per,,PROPN-PROPN-PROPN,NOUN,compound-compound-nsubj,dobj,NNP-NNPS-NNP,NN,3,1
9781,8214.0,30,attended,5,5,10,5,4,19,0,5,Thailand,Tanin Kraivixien,,per-per,PROPN,PROPN-PROPN,pobj,compound-compound,NNP,NNP-NNP,5,1
9782,9994.0,62,published,10,29,38,9,28,23,-19,28,Thailand,Tanin Kraivixien,org,-,PROPN,PROPN-PROPN,pobj,compound-nsubj,NNP,NNP-NNP,-1,1
9783,8216.0,21,is,11,11,20,9,10,0,0,9,STAR,Malaysia,per,,PROPN,PROPN,pobj,pobj,NNP,NNP,1,1
9784,8219.0,14,was,1,1,7,6,0,6,0,6,Butt,Greater Toronto Apartment Association,,per-per-per-per,PROPN,PROPN-PROPN-PROPN-PROPN,nsubj,compound-compound-compound-pobj,NNP,NNP-NNP-NNP-NNP,4,1
9785,8221.0,24,called,3,12,17,5,11,6,-9,14,Wu-Syndicate,Wu-Tang Records,per,-,VERB,PROPN-PROPN,conj,compound-pobj,VB,NNP-NNPS,5,1
9786,8222.0,17,formed,9,12,14,2,11,2,-3,5,Pig,London,,per,PROPN,PROPN,dobj,pobj,NNP,NNP,2,1
9787,8223.0,21,sworn,6,1,20,19,0,0,5,14,Tusk,Republic,,org,PROPN,PROPN,nsubjpass,pobj,NNP,NNP,3,1
9788,8225.0,31,co-produced,6,8,29,21,7,1,-2,23,Deniece Williams,Columbia Records,per-per,-,PROPN-PROPN,PROPN-PROPN,compound-dobj,compound-pobj,NNP-NNP,NNP-NNPS,6,1
9789,8227.0,39,said,10,6,24,18,5,14,4,14,Fatah,Yasser Arafat,org,-,PROPN,PROPN-PROPN,compound,compound-appos,NNP,NNP-NNP,8,1
9790,9058.0,30,promised,9,26,28,2,25,1,-17,19,Fatah,Yasser Arafat,per,-,PROPN,PROPN-PROPN,compound,compound-conj,NNP,NNP-NNP,1,1
9791,8228.0,24,was,3,10,14,4,9,9,-7,11,Royal Navy,Armstrong Whitworth,-,per-per,PROPN-PROPN,PROPN-PROPN,compound-pobj,compound-compound,NNP-NNP,NNP-NNP,3,1
9792,8232.0,52,served,2,16,24,8,15,27,-14,22,Scott-Heron,Poet,per,,PROPN,PROPN,poss,compound,NNP,NNP,11,1
9793,8233.0,17,provided,4,3,15,12,2,1,1,11,Israel,Hot,,per,PROPN,PROPN,pobj,conj,NNP,NNP,2,1
9794,8234.0,24,discovered,9,16,18,2,15,5,-7,9,Dubai,Aramex,org,,PROPN,PROPN,pobj,nsubj,NNP,NNP,1,1
9795,8237.0,37,sought,1,1,7,6,0,29,0,6,Baucus,Montana,org,,PROPN,PROPN,nsubj,pobj,NNP,NNP,1,1
9796,8243.0,33,completed,2,1,14,13,0,18,1,12,Baucus,Montana,per,,PROPN,PROPN,nsubj,compound,NNP,NNP,6,1
9797,8238.0,13,known,6,2,10,8,1,2,4,4,West Virginia,Jennings Randolph,per-per,-,PROPN-PROPN,PROPN-PROPN,compound-compound,compound-compound,NNP-NNP,NNP-NNP,6,1
9798,8241.0,33,awarded,3,2,12,10,1,20,1,9,college,NDF,org,,NOUN,PROPN,nsubjpass,compound,NN,NNP,4,1
9799,8242.0,13,is,3,1,12,11,0,0,2,9,Uplands Community College,England,--,per,PROPN-PROPN-PROPN,PROPN,compound-compound-nsubj,pobj,NNP-NNP-NNP,NNP,3,1
9800,8244.0,31,attended,7,4,4,0,3,26,3,-3,McAllen,McAllen High School,,per-per-per,PROPN,PROPN-PROPN-PROPN,compound,compound-compound-dobj,NNP,NNP-NNP-NNP,0,1
9801,8246.0,22,were,6,6,8,2,5,13,0,2,Association,United States,org,-,PROPN,PROPN-PROPN,pobj,compound-compound,NNP,NNP-NNP,5,1
9802,8250.0,49,whilst,2,8,9,1,7,39,-6,7,Magazine,McGeoch,org,,PROPN,PROPN,compound,pobj,NNP,NNP,3,1
9803,8251.0,37,was,3,11,19,8,10,17,-8,16,Robert Bourassa,Quebec,-,org,PROPN-PROPN,PROPN,compound-poss,pobj,NNP-NNP,NNP,4,1
9804,8252.0,26,group,11,16,24,8,15,1,-5,13,Communist Party,Jose Penelon,-,org-org,PROPN-PROPN,PROPN-PROPN,compound-pobj,compound-pobj,NNP-NNP,NNP-NNP,6,1
9805,8253.0,22,elected,3,18,20,2,17,1,-15,17,NDP,Jerry Pye,org,-,PROPN,PROPN-PROPN,compound,compound-dobj,NNP,NNP-NNP,1,1
9806,8254.0,81,won,14,31,49,18,30,31,-17,35,Forza Italia,Roberto Formigoni,per-per,-,PROPN-PROPN,PROPN-PROPN,conj-poss,compound-nsubj,NNP-NNP,NNP-NNP,-1,1
9807,8255.0,38,toured,6,6,23,17,5,14,0,17,Johnson,United States,,per-per,PROPN,PROPN-PROPN,nsubj,compound-pobj,NNP,NNP-NNP,6,1
9808,8256.0,14,is,1,3,13,10,2,0,-2,12,the Madras Regiment,Army,--,per,DET-PROPN-PROPN,PROPN,det-compound-pobj,pobj,DT-NNP-NNP,NNP,3,1
9809,8257.0,26,represented,10,4,4,0,3,21,6,-6,Mississippi,Mississippi Valley State University,per,---,PROPN,PROPN-PROPN-PROPN-PROPN,compound,compound-compound-compound-dobj,NNP,NNP-NNP-NNP-NNP,0,1
9810,8258.0,35,announced,7,3,34,31,2,0,4,27,Talvivaara Mining Company,Finland,per-per-per,,PROPN-PROPN-PROPN,PROPN,compound-compound-compound,pobj,NNP-NNP-NNP,NNP,8,1
9811,8259.0,22,is,1,11,14,3,10,7,-10,13,Desi Arnaz,Lucille Ball,-,per-per,PROPN-PROPN,PROPN-PROPN,compound-pobj,compound-conj,NNP-NNP,NNP-NNP,2,1
9812,8260.0,22,expected,2,6,11,5,5,10,-4,9,ACTS,Army Air Corps,org,--,NOUN,PROPN-PROPN-PROPN,nsubj,compound-compound-pobj,NNS,NNP-NNP-NNP,4,1
9813,8261.0,27,entered,2,15,20,5,14,6,-13,18,CHUM Radio,CTVglobemedia,org-org,,PROPN-PROPN,PROPN,compound-pobj,pobj,NNP-NNP,NNP,2,1
9814,8262.0,28,is,1,1,6,5,0,21,0,5,ISSU,Organising Bureau of European School Student Unions,,per-per-per-per-per-per-per,PROPN,PROPN-PROPN-ADP-PROPN-PROPN-PROPN-PROPN,nsubj,compound-pobj-prep-compound-compound-compound-pobj,NNP,NNP-NNP-IN-NNP-NNP-NNP-NNPS,3,1
9815,8263.0,31,recorded,27,21,23,2,20,7,6,-4,UK,Vodafone,org,,PROPN,PROPN,poss,pobj,NNP,NNP,1,1
9816,8264.0,20,is,2,12,15,3,11,4,-10,13,Japan,Ami Suzuki,org,-,PROPN,PROPN-PROPN,pobj,compound-pobj,NNP,NNP-NNP,1,1
9817,8265.0,37,chairman,3,26,31,5,25,5,-23,28,Stuart Gulliver,HSBC,-,per,PROPN-PROPN,PROPN,compound-nmod,compound,NNP-NNP,NNP,4,1
9818,8266.0,35,is,19,2,10,8,1,24,17,-9,Department of the Prime Minister and Cabinet,New Zealand,org-org-org-org-org-org-org,-,PROPN-ADP-DET-PROPN-PROPN-CCONJ-PROPN,PROPN-PROPN,nsubj-prep-det-compound-pobj-cc-conj,compound-pobj,NNP-IN-DT-NNP-NNP-CC-NNP,NNP-NNP,4,1
9819,11512.0,30,are,5,5,25,20,4,4,0,20,Department of the Prime Minister and Cabinet,New Zealand,per-per-per-per-per-per-per,-,PROPN-ADP-DET-PROPN-PROPN-CCONJ-PROPN,PROPN-PROPN,nsubj-prep-det-compound-pobj-cc-conj,compound-pobj,NNP-IN-DT-NNP-NNP-CC-NNP,NNP-NNP,6,1
9820,8268.0,31,manufactured,1,13,19,6,12,11,-12,18,Wheels,1980,,org,PROPN,NUM,pobj,pobj,NNP,CD,5,1
9821,8271.0,27,headquartered,7,1,15,14,0,11,6,8,Digital Equipment Corporation,Maynard,per-per-per,,PROPN-PROPN-PROPN,PROPN,compound-compound-nsubjpass,pobj,NNP-NNP-NNP,NNP,3,1
9822,8272.0,40,Ciampi,0,1,22,21,0,17,-1,22,Ciampi,Italy,per,,VERB,PROPN,ROOT,pobj,VB,NNP,4,1
9823,8273.0,25,traced,4,1,19,18,0,5,3,15,Podravka,Koprivnica,per,,PROPN,PROPN,poss,pobj,NNP,NNP,11,1
9824,8274.0,42,released,6,27,30,3,26,11,-21,24,India,Madhubala,,per,PROPN,PROPN,pobj,pobj,NNP,NNP,2,1
9825,8275.0,40,began,10,2,9,7,1,30,8,-1,Deng Xiaoping,Sichuan,-,per,PROPN-PROPN,PROPN,compound-nsubj,compound,NNP-NNP,NNP,4,1
9826,8276.0,32,was,3,17,30,13,16,1,-14,27,Shenzhen Airlines,Guangdong,-,per,PROPN-PROPN,PROPN,compound-compound,compound,NNP-NNPS,NNP,3,1
9827,8278.0,38,entered,3,3,9,6,2,28,0,6,Gretsch,Fender Musical Instruments Corporation,per,---,PROPN,PROPN-PROPN-PROPN-PROPN,nsubj,compound-compound-compound-pobj,NNP,NNP-NNP-NNPS-NNP,6,1
9828,8279.0,14,wanted,2,2,4,2,1,9,0,2,Federalists,Adams,per,,PROPN,PROPN,nsubj,dobj,NNPS,NNP,1,1
9829,8280.0,22,viewed,14,6,9,3,5,12,8,-5,Golkar,Suharto,per,,PROPN,PROPN,appos,poss,NNP,NNP,4,1
9830,8281.0,31,finished,8,2,27,25,1,3,6,19,University of Richmond,Division I,--,org-org,PROPN-ADP-PROPN,PROPN-PRON,poss-prep-pobj,conj-nsubj,NNP-IN-NNP,NNP-PRP,7,1
9831,8282.0,25,served,7,3,5,2,2,19,4,-2,Maryland,Curt Anderson,,org-org,PROPN,PROPN-PROPN,compound,compound-compound,NNP,NNP-NNP,1,1
9832,8283.0,51,is,4,32,39,7,31,11,-28,35,Bainimarama,Fiji,org,,PROPN,PROPN,appos,compound,NNP,NNP,6,1
9833,8285.0,36,announced,6,11,25,14,10,10,-5,19,Major League Baseball,network,per-per-per,,PROPN-PROPN-PROPN,NOUN,compound-compound-conj,poss,NNP-NNP-NNP,NN,9,1
9834,8287.0,8,Labels,0,5,7,2,4,0,-5,7,General Motors,Pontiac,per-per,,PROPN-PROPN,PROPN,compound-compound,appos,NNP-NNPS,NNP,3,1
9835,8288.0,16,offers,2,10,12,2,9,3,-8,10,China,Xing,,per,PROPN,PROPN,pobj,nsubj,NNP,NNP,4,1
9836,8289.0,11,named,2,1,8,7,0,2,1,6,He,Sweden,,org,PRON,PROPN,nsubjpass,pobj,PRP,NNP,3,1
9837,8290.0,23,gave,4,6,12,6,5,10,-2,8,FirstGroup,Greyhound Lines,org,-,PROPN,PROPN-PROPN,dative,compound-pobj,NNP,NNP-NNP,3,1
9838,8291.0,20,told,7,1,18,17,0,1,6,11,Japan,NHK,per,,PROPN,PROPN,poss,nsubj,NNP,NNP,8,1
9839,8292.0,23,wondered,7,2,6,4,1,16,5,-1,Nigeria,Yakubu Gowon,,org-org,PROPN,PROPN-PROPN,compound,compound-pobj,NNP,NNP-NNP,2,1
9840,8907.0,28,said,25,14,24,10,13,3,11,-1,Nigeria,Yakubu Gowon,,per-per,PROPN,PROPN-PROPN,nsubj,compound-dobj,NNP,NNP-NNP,3,1
9841,8295.0,33,went,12,12,21,9,11,11,0,9,Mikael,Sweden,org,,PROPN,PROPN,conj,pobj,NNP,NNP,6,1
9842,8296.0,23,was,1,1,8,7,0,14,0,7,Girlsareshort,Mississauga,,per,PROPN,PROPN,nsubj,compound,NNP,NNP,3,1
9843,8297.0,23,died,1,1,5,4,0,17,0,4,Williams,New York,,per-per,PROPN,PROPN-PROPN,nsubj,compound-compound,NNP,NNP-NNP,3,1
9844,8298.0,29,is,10,3,23,20,2,5,7,13,Cope,California,,per,PROPN,PROPN,compound,pobj,NNP,NNP,8,1
9845,8301.0,43,Queenzy,0,3,25,22,2,17,-3,25,Wei Wei,ld star i,-,per-per-per,PROPN-PROPN,ADP-NOUN-PRON,compound-conj,compound-ROOT-subtok,NNP-NNP,IN-NN-PRP,7,1
9846,8302.0,27,are,3,1,15,14,0,11,2,12,Way Out West,Bristol,--,per,PROPN-ADV-PROPN,PROPN,nmod-prep-nsubj,compound,NNP-RB-NNP,NNP,6,1
9847,8305.0,31,includes,2,25,28,3,24,2,-23,26,Dave Greenfield,The Stranglers,-,org-org,PROPN-PROPN,DET-PROPN,compound-conj,det-appos,NNP-NNP,DT-NNPS,1,1
9848,8306.0,18,Dept,3,9,17,8,8,0,-6,14,College of the Holy Cross,USA,org-org-org-org-org,,PROPN-ADP-DET-PROPN-PROPN,PROPN,appos-prep-det-compound-compound,npadvmod,NNP-IN-DT-NNP-NNP,NNP,4,1
9849,8307.0,23,view,2,15,16,1,14,6,-13,14,Canada,his,,per,PROPN,DET,pobj,nsubjpass,NNP,PRP$,2,1
9850,8308.0,15,made,3,2,10,8,1,4,1,7,CSTO,Kyrgyzstan,org,,PROPN,PROPN,nsubjpass,compound,NNP,NNP,4,1
9851,8309.0,34,submitted,2,15,31,16,14,2,-13,29,Meteor,Ireland,,org,PROPN,PROPN,compound,compound,NNP,NNP,12,1
9852,8311.0,20,returned,4,7,19,12,6,0,-3,15,Brussels,Magritte,,org,PROPN,PROPN,pobj,pobj,NNP,NNP,3,1
9853,8312.0,23,It's,0,13,20,7,12,2,-13,20,Akala,Illa State Records,,per-per-per,PROPN,PROPN-PROPN-PROPN,pobj,compound-compound-pobj,NNP,NNP-NNP-NNPS,4,1
9854,8314.0,24,had,5,18,22,4,17,1,-13,17,X-Raided,Sacramento,org,,PROPN,PROPN,pobj,compound,NNP,NNP,3,1
9855,8315.0,28,put,2,8,15,7,7,12,-6,13,Hubbard,Columbia,,per,PROPN,PROPN,nsubj,pobj,NNP,NNP,2,1
9856,8316.0,29,traveled,14,17,19,2,16,9,-3,5,London,Andrew Loog Oldham,org,--,PROPN,PROPN-VERB-PROPN,pobj,compound-compound-nsubj,NNP,NNP-VBZ-NNP,3,1
9857,8317.0,13,hired,4,3,12,9,2,0,1,8,she,Norway,,per,PRON,PROPN,nsubj,pobj,PRP,NNP,2,1
9858,8319.0,28,Wah,3,9,1,-8,8,26,-6,-2,Haiti,Edouard Wah,org,-,PROPN,PROPN-PROPN,appos,compound-pobj,NNP,NNP-NNP,4,1
9859,8320.0,32,defeated,9,9,15,6,8,16,0,6,DiNovo,Toronto,per,,PROPN,PROPN,nsubj,compound,NNP,NNP,4,1
9860,8322.0,41,is,2,18,15,-3,17,25,-16,13,Hardy Myers,Oregon,-,per,PROPN-PROPN,PROPN,compound-pobj,pobj,NNP-NNP,NNP,2,1
9861,8323.0,25,represents,3,11,24,13,10,0,-8,21,John P. Donoghue,Delegates,per-per-per,,PROPN-PROPN-PROPN,PROPN,compound-compound-nsubj,pobj,NNP-NNP-NNP,NNPS,4,1
9862,8325.0,19,is,6,1,16,15,0,2,5,10,Daniela Sea,juggler,org-org,,PROPN-PROPN,NOUN,compound-nsubj,attr,NNP-NNP,NN,4,1
9863,8326.0,34,In,0,9,12,3,8,21,-9,12,Los Angeles,Richard Riordan,-,org-org,PROPN-PROPN,PROPN-PROPN,compound-compound,compound-pobj,NNP-NNP,NNP-NNP,2,1
9864,9440.0,35,Simon's,2,20,23,3,19,11,-18,21,Los Angeles,Richard Riordan,-,per-per,PROPN-PROPN,PROPN-PROPN,compound-compound,compound-pobj,NNP-NNP,NNP-NNP,1,1
9865,10048.0,36,mounted,1,26,34,8,25,1,-25,33,Los Angeles,Richard Riordan,-,per-per,PROPN-PROPN,PROPN-PROPN,compound-pobj,compound-pobj,NNP-NNP,NNP-NNP,8,1
9866,12939.0,23,tried,13,2,8,6,1,14,11,-5,Los Angeles,Richard Riordan,-,per-per,PROPN-PROPN,PROPN-PROPN,compound-compound,compound-pobj,NNP-NNP,NNP-NNP,3,1
9867,8328.0,41,is,12,1,2,1,0,38,11,-10,Vinnie Vincent,Vincent John Cusano,-,per-per-per,PROPN-PROPN,PROPN-PROPN-PROPN,compound-nsubj,compound-compound-appos,NNP-NNP,NNP-NNP-NNP,2,1
9868,8329.0,42,gave,1,1,14,13,0,27,0,13,He,Minister,,org,PRON,PROPN,nsubj,pobj,PRP,NNP,5,1
9869,8330.0,32,won,5,4,29,25,3,2,1,24,FAU,Division I,,per-per,PROPN,PROPN-PRON,nsubj,pobj-nsubj,NNP,NNP-PRP,3,1
9870,8331.0,56,took,2,10,15,5,9,40,-8,13,Alameda-Contra Costa Transit District,AC Transit,per-per-per-per,-,PROPN-PROPN-PROPN-PROPN,PROPN-PROPN,amod-compound-compound-pobj,compound-appos,NNP-NNP-NNP-NNP,NNP-NNP,3,1
9871,8332.0,63,sold,4,14,43,29,13,19,-10,39,Digital Domain,Holdings,per-per,,PROPN-PROPN,PROPN,compound-compound,compound,NNP-NNP,NNP,7,1
9872,8333.0,19,used,1,11,13,2,10,5,-10,12,Germany,Erich Honecker,,org-org,PROPN,PROPN-PROPN,poss,compound-pobj,NNP,NNP-NNP,2,1
9873,8334.0,27,met,9,6,22,16,5,4,3,13,Japan,d Takeda Pharmaceutical Compan,,per-per-per-per,PROPN,ADJ-PROPN-PROPN-PROPN,pobj,nummod-compound-compound-compound,NNP,JJ-NNP-NNP-NNP,6,1
9874,8335.0,21,is,3,2,12,10,1,8,1,9,Oxford University Press,University of Oxford,org-org-org,--,PROPN-PROPN-PROPN,PROPN-ADP-PROPN,compound-compound-pobj,pobj-prep-pobj,NNP-NNP-NNP,NNP-IN-NNP,5,1
9875,11252.0,26,is,6,2,14,12,1,11,4,8,Oxford University Press,University of Oxford,per-per-per,--,PROPN-PROPN-PROPN,PROPN-ADP-PROPN,compound-compound-pobj,pobj-prep-pobj,NNP-NNP-NNP,NNP-IN-NNP,5,1
9876,8337.0,21,building,2,6,17,11,5,3,-4,15,2001,Hudson,per,,NUM,PROPN,nummod,poss,CD,NNP,10,1
9877,8338.0,25,is,9,6,9,3,5,15,3,0,Washington,1999,org,,PROPN,NUM,pobj,pobj,NNP,CD,2,1
9878,8339.0,34,said,28,15,21,6,14,12,13,-7,Sen. Martinez,Florida,-,org,PROPN-PROPN,PROPN,compound-nsubj,pobj,NNP-NNP,NNP,2,1
9879,8340.0,36,was,28,20,28,8,19,7,8,0,South Africa,regiment,-,per,PROPN-PROPN,NOUN,compound-nsubj,nsubj,NNP-NNP,NN,3,1
9880,8341.0,23,released,3,2,14,12,1,8,1,11,Kim C,Hot Potato,-,per-per,PROPN-PROPN,PROPN-PROPN,compound-nsubj,compound-pobj,NNP-NNP,NNP-NNP,6,1
9881,8342.0,34,In,0,27,23,-4,26,10,-27,23,Kyprianou,House,per,,PROPN,PROPN,conj,pobj,NNP,NNP,5,1
9882,8343.0,33,was,6,5,15,10,4,17,1,9,Navarro College,Texas,per-per,,PROPN-PROPN,PROPN,compound-pobj,pobj,NNP-NNP,NNP,6,1
9883,8344.0,27,represented,8,4,11,7,3,15,4,3,Pittsburgh,University of Pittsburgh,per,--,PROPN,PROPN-ADP-PROPN,compound,dobj-prep-pobj,NNP,NNP-IN-NNP,4,1
9884,8346.0,22,tapped,6,5,20,15,4,1,1,14,Junichiro Koizumi,Japan,per-per,,PROPN-PROPN,PROPN,compound-nsubj,compound,NNP-NNP,NNP,8,1
9885,8432.0,24,ruled,7,4,16,12,3,7,3,9,Junichiro Koizumi,Japan,-,org,PROPN-PROPN,PROPN,compound-nsubj,poss,NNP-NNP,NNP,5,1
9886,12652.0,36,was,13,15,33,18,14,2,-2,20,Junichiro Koizumi,Japan,-,per,PROPN-PROPN,PROPN,compound-attr,poss,NNP-NNP,NNP,6,1
9887,8347.0,34,is,7,5,16,11,4,17,2,9,St. Louis,Express Scripts,org-org,-,PROPN-PROPN,VERB-PROPN,compound-compound,compound-compound,NNP-NNP,VB-NNPS,8,1
9888,8350.0,23,bought,3,2,19,17,1,3,1,16,1928,Sentinel-Cammell,per,,NUM,PROPN,pobj,pobj,CD,NNP,5,1
9889,8352.0,30,announced,7,15,19,4,14,10,-8,12,Simone,Oliver Palotai,,org-org,PROPN,PROPN-PROPN,nsubj,compound-appos,NNP,NNP-NNP,2,1
9890,8353.0,39,was,2,31,35,4,30,3,-29,33,Italian Space Agency,Italy,per-per-per,,PROPN-PROPN-PROPN,PROPN,amod-compound-pobj,poss,NNP-NNP-NNP,NNP,3,1
9891,8355.0,33,attended,3,6,13,7,5,19,-3,10,Tuilaepa Aiono Sailele Malielegaoi,Samoa,---,per,PROPN-PROPN-PROPN-PROPN,PROPN,compound-compound-compound-compound,pobj,NNP-NNP-NNP-NNP,NNP,3,1
9892,11480.0,51,planned,22,29,41,12,28,9,-7,19,Tuilaepa Aiono Sailele Malielegaoi,Samoa,per-per-per-per,,PROPN-PROPN-PROPN-PROPN,PROPN,compound-compound-nsubj-ccomp,pobj,NNP-NNP-NNP-NNP,NNP,5,1
9893,8356.0,57,believed,3,6,17,11,5,39,-3,14,Paul Martin,Quebec,org-org,,PROPN-PROPN,PROPN,compound-poss,pobj,NNP-NNP,NNP,3,1
9894,8357.0,19,born,14,6,11,5,5,7,8,-3,Yoweri Museveni,Janet Museveni,org-org,-,PROPN-PROPN,PROPN-PROPN,compound-pobj,compound-appos,NNP-NNP,NNP-NNP,2,1
9895,8358.0,16,said,5,4,1,-3,3,14,1,-4,Walldorf,SAP,per,,PROPN,PROPN,compound,poss,NNP,NNP,2,1
9896,8359.0,17,signed,5,1,15,14,0,1,4,10,In Strict Confidence,WTII,--,per,ADP-PROPN-PROPN,PROPN,prep-compound-pobj,compound,IN-NNP-NNP,NNP,8,1
9897,8362.0,39,replaced,15,6,14,8,5,24,9,-1,Italian Intelligence Services,CESIS,per-per-per,,PROPN-PROPN-PROPN,PROPN,compound-compound-pobj,nsubjpass,NNP-NNP-NNPS,NNP,6,1
9898,8363.0,14,arrived,1,4,4,0,3,9,-3,3,Gonzaga University,Gonzaga Bulldogs,per-per,-,PROPN-PROPN,PROPN-PROPN,compound-pobj,compound-pobj,NNP-NNP,NNP-NNPS,0,1
9899,8364.0,20,joined,9,11,11,0,10,8,-2,2,Tottori University,Tottori,-,per,PROPN-PROPN,PROPN,compound-dobj,compound,NNP-NNP,NNP,0,1
9900,8365.0,39,say,2,22,35,13,21,3,-20,33,Mari Alkatiri,East Timor,per-per,-,PROPN-PROPN,PROPN-PROPN,compound-nsubj,compound-poss,NNP-NNP,NNP-NNP,7,1
9901,8367.0,27,blamed,6,2,4,2,1,22,4,-2,Prime Minister,Jorge del Castillo,-,per-per-per,PROPN-PROPN,PROPN-PROPN-PROPN,compound-compound,compound-compound-nsubj,NNP-NNP,NNP-NNP-NNP,2,1
9902,8368.0,27,been,12,7,25,18,6,1,5,13,Council of Economic Advisers,Martin Feldstein,per-per-per-per,-,PROPN-ADP-PROPN-PROPN,PROPN-PROPN,pobj-prep-compound-pobj,compound-conj,NNP-IN-NNP-NNPS,NNP-NNP,10,1
9903,8370.0,20,Shalala,0,1,6,5,0,13,-1,6,Shalala,University,per,,PROPN,PROPN,ROOT,pobj,NNP,NNP,4,1
9904,8372.0,16,founded,3,1,2,1,0,13,2,-1,Barrington,College,per,,PROPN,PROPN,compound,nsubjpass,NNP,NNP,2,1
9905,8375.0,33,was,2,26,31,5,25,1,-24,29,Boeing,chief executive,per,-,PROPN,ADJ-NOUN,compound,amod-conj,NNP,JJ-NN,3,1
9906,8377.0,96,scored,2,35,44,9,34,51,-33,42,Canada,Davey Boy Smith,per,--,PROPN,PROPN-PROPN-PROPN,pobj,compound-compound-compound,NNP,NNP-NNP-NNP,5,1
9907,8378.0,41,began,3,12,24,12,11,16,-9,21,Paris,her,,org,PROPN,PRON,pobj,poss,NNP,PRP,6,1
9908,8380.0,37,oversaw,9,7,8,1,6,28,2,-1,Treasurer,Paul Keating,org,-,PROPN,PROPN-PROPN,conj,compound-appos,NNP,NNP-NNP,1,1
9909,8381.0,38,went,21,26,29,3,25,8,-5,8,Daiei,Japan,,per,PROPN,PROPN,compound,pobj,NNP,NNP,3,1
9910,8382.0,24,Cock,1,12,22,10,11,1,-11,21,Merzbow,ZSF Produkt,,org-org,PROPN,PROPN-PROPN,poss,compound-pobj,NNP,NNP-NNP,5,1
9911,14071.0,14,recorded,4,2,7,5,1,6,2,3,Merzbow,ZSF Produkt,,org-org,PROPN,PROPN-PROPN,compound,compound-compound,NNP,NNP-NNP,6,1
9912,8383.0,11,started,4,2,8,6,1,2,2,4,Oslo Stock Exchange,Christiania,org-org-org,,PROPN-PROPN-PROPN,PROPN,compound-compound-nsubj,pobj,NNP-NNP-NNP,NNP,3,1
9913,8384.0,39,is,14,10,10,0,9,28,4,-4,Sierra Leone,Sierra Leone national football team,per-per,----,PROPN-PROPN,PROPN-PROPN-ADJ-NOUN-NOUN,compound-pobj,nmod-nmod-amod-compound-pobj,NNP-NNP,NNP-NNP-JJ-NN-NN,0,1
9914,8385.0,32,replaced,20,12,16,4,11,15,8,-4,American Public Television,Create,--,org,PROPN-PROPN-PROPN,PROPN,compound-compound-poss,pobj,NNP-NNP-NNP,NNP,7,1
9915,8386.0,48,called,3,1,16,15,0,31,2,13,Mucho Muchacho,Barcelona,org-org,,PROPN-PROPN,PROPN,compound-nsubj,pobj,NNP-NNP,NNP,4,1
9916,8388.0,27,recorded,2,1,11,10,0,15,1,9,Berkofsky,Koch,,org,PROPN,PROPN,nsubj,compound,NNP,NNP,7,1
9917,8389.0,12,born,7,1,6,5,0,5,6,-1,Chadli Bendjedid,Algeria,per-per,,PROPN-PROPN,PROPN,nsubj-dep,pobj,NNP-NNP,NNP,3,1
9918,8390.0,23,served,6,5,19,14,4,3,1,13,Windsor,Paul Martin,per,-,PROPN,PROPN-PROPN,compound,compound-compound,NNP,NNP-NNP,5,1
9919,8391.0,30,told,10,5,9,4,4,20,5,-1,Chamber,Irene Pivetti,org,-,PROPN,PROPN-PROPN,nmod,compound-nsubj,NNP,NNP-NNP,4,1
9920,8392.0,18,took,4,3,16,13,2,1,1,12,Emmanuel Olivier,MC2 France,-,org-org,PROPN-PROPN,PROPN-PROPN,compound-nsubj,compound-dobj,NNP-NNP,NNP-NNP,4,1
9921,8394.0,54,stated,4,1,3,2,0,50,3,-1,Prime Minister,Robert Borden,per-per,-,PROPN-PROPN,PROPN-PROPN,compound-compound,compound-nsubj,NNP-NNP,NNP-NNP,1,1
9922,8397.0,32,hurt,2,8,12,4,7,19,-6,10,Quebec,Gilles Duceppe,,org-org,PROPN,PROPN-PROPN,pobj,compound-nsubj,NNP,NNP-NNP,3,1
9923,13322.0,67,noted,20,50,52,2,49,14,-30,32,Quebec,Gilles Duceppe,per,-,PROPN,PROPN-PROPN,pobj,compound-pobj,NNP,NNP-NNP,1,1
9924,8398.0,52,said,31,45,51,6,44,0,-14,20,Capital University,Ohio,-,org,PROPN-PROPN,PROPN,compound-compound,pobj,NNP-NNP,NNP,7,1
9925,8399.0,17,is,7,7,10,3,6,6,0,3,Nepal,Ram Baran Yadav,per,--,PROPN,PROPN-PROPN-PROPN,pobj,compound-compound-attr,NNP,NNP-NNP-NNP,2,1
9926,8401.0,23,shortened,7,1,1,0,0,21,6,-6,Haileybury and Imperial Service College,Haileybury,org-org-org-org-org,,PROPN-CCONJ-PROPN-PROPN-PROPN,PROPN,nsubj-cc-compound-compound-conj,compound,NNP-CC-NNP-NNP-NNP,NNP,0,1
9927,8403.0,37,questioned,11,30,34,4,29,2,-19,23,IE Business School,Madrid,per-per-per,,PROPN-PROPN-PROPN,PROPN,compound-compound-pobj,pobj,NNP-NNP-NNP,NNP,3,1
9928,8405.0,37,was,1,18,27,9,17,9,-17,26,Arlene Dahl,Esther Williams,per-per,-,PROPN-PROPN,PROPN-PROPN,compound-ROOT,compound-ROOT,NNP-NNP,NNP-NNP,-1,1
9929,8406.0,34,produces,2,1,22,21,0,11,1,20,General Motors,Buick,-,org,PROPN-PROPN,PROPN,compound-nsubj,compound,NNP-NNPS,NNP,4,1
9930,8409.0,27,served,11,10,15,5,9,11,1,4,Vladimir Putin,President,per-per,,PROPN-PROPN,PROPN,compound-nsubj,pobj,NNP-NNP,NNP,4,1
9931,8410.0,44,believe,1,16,42,26,15,1,-15,41,Germany,Helmut Kohl,org,-,PROPN,PROPN-PROPN,pobj,compound-conj,NNP,NNP-NNP,-1,1
9932,8412.0,13,played,3,1,12,11,0,0,2,9,Doherty,England,org,,NOUN,PROPN,nsubj,pobj,NN,NNP,2,1
9933,8414.0,32,slashed,3,8,15,7,7,16,-5,12,LDK,Ibrahim Rugova,org,-,PROPN,PROPN-PROPN,pobj,compound-dobj,NNP,NNP-NNP,3,1
9934,8415.0,50,was,5,12,27,15,11,22,-7,22,AeroRepublica,Colombia,,per,PROPN,PROPN,pobj,pobj,NNP,NNP,10,1
9935,8416.0,24,nicknamed,5,2,8,6,1,15,3,3,Nigeria national football team,Super Eagles,---,per-per,PROPN-ADJ-NOUN-NOUN,PROPN-PROPN,nmod-amod-compound-nsubj,compound-nsubj,NNP-JJ-NN-NN,NNP-NNPS,3,1
9936,8417.0,32,is,5,15,31,16,14,0,-10,26,Johnny Borrell,London,per-per,,PROPN-PROPN,PROPN,compound-poss,pobj,NNP-NNP,NNP,3,1
9937,8418.0,17,is,3,8,15,7,7,1,-5,12,Avondale College,Cooranbong,per-per,,PROPN-PROPN,PROPN,compound-pobj,compound,NNP-NNP,NNP,6,1
9938,8419.0,32,contributed,18,5,21,16,4,10,13,3,Algeria,his,,per,PROPN,DET,pobj,poss,NNP,PRP$,5,1
9939,8421.0,31,said,28,1,5,4,0,25,27,-23,Malaysia,Maybank,,org,PROPN,PROPN,poss,nsubj,NNP,NNP,4,1
9940,8422.0,22,recorded,8,1,8,7,0,13,7,0,Electric Wizard,England,-,per,PROPN-PROPN,PROPN,compound-nsubj,pobj,NNP-NNP,NNP,1,1
9941,8424.0,10,born,3,1,7,6,0,2,2,4,Omar Deghayes,Libya,per-per,,PROPN-PROPN,PROPN,compound-nsubjpass,pobj,NNP-NNP,NNP,2,1
9942,8425.0,38,was,3,1,18,17,0,19,2,15,Emperors Club VIP,Mark Brener,--,per-per,NOUN-PROPN-PROPN,PROPN-PROPN,compound-compound-nsubj,compound-pobj,NNS-NNP-NNP,NNP-NNP,6,1
9943,8426.0,36,awarded,22,16,21,5,15,14,6,-1,Austria,choir,,per,PROPN,NOUN,pobj,nsubjpass,NNP,NN,8,1
9944,8427.0,38,is,1,19,24,5,18,13,-18,23,Rabbi David Ellenson,Hebrew Union College,--,per-per-per,PROPN-PROPN-PROPN,PROPN-PROPN-PROPN,compound-compound-dobj,compound-compound-pobj,NNP-NNP-NNP,NNP-NNP-NNP,5,1
9945,8428.0,23,met,10,14,15,1,13,7,-4,5,President,Castro,,per,PROPN,PROPN,compound,pobj,NNP,NNP,4,1
9946,8429.0,24,joined,1,1,13,12,0,10,0,12,Moreve,Steppenwolf,org,,PROPN,PROPN,nsubj,appos,NNP,NNP,5,1
9947,8430.0,25,arrived,1,19,24,5,18,0,-18,23,Adisadel College,Ghana,-,org,PROPN-PROPN,PROPN,compound-pobj,pobj,NNP-NNP,NNP,5,1
9948,8431.0,22,is,1,12,20,8,11,1,-11,19,Chuck Berry,Chess,org-org,,PROPN-PROPN,PROPN,compound-nsubj,compound,NNP-NNP,NNP,5,1
9949,8433.0,34,devoted,3,1,31,30,0,2,2,28,The Weather Channel,Blackstone Group,org-org-org,-,DET-PROPN-PROPN,PROPN-PROPN,det-compound-pobj,compound-conj,DT-NNP-NNP,NNP-NNP,7,1
9950,8436.0,46,was,8,16,23,7,15,22,-8,15,Army,Dixie Mission,per,-,PROPN,PROPN-PROPN,pobj,compound-pobj,NNP,NNP-NNP,7,1
9951,8437.0,19,was,3,1,11,10,0,7,2,8,Low Yield Atomics was,Sydney,per-per-per-per,,PROPN-PROPN-PROPN-VERB,PROPN,compound-compound-nsubj-ROOT,pobj,NNP-NNP-NNPS-VBD,NNP,4,1
9952,8438.0,20,was,7,2,2,0,1,17,5,-5,Samoa Broadcasting Corporation,Samoa,--,per,PROPN-PROPN-PROPN,PROPN,compound-compound-nsubj,pobj,NNP-NNP-NNP,NNP,0,1
9953,8439.0,20,serves,1,13,18,5,12,1,-12,17,Queens University of Charlotte,North Carolina,---,per-per,PROPN-PROPN-ADP-PROPN,PROPN-PROPN,compound-pobj-prep-pobj,compound-pobj,NNP-NNP-IN-NNP,NNP-NNP,2,1
9954,8440.0,33,compete,14,12,24,12,11,8,2,10,Georgia Bulldogs,Division I,-,org-org,PROPN-PROPN,PROPN-PROPN,compound-compound,compound-ROOT,NNP-NNPS,NNP-NNP,-1,1
9955,8441.0,11,Love,7,1,6,5,0,4,6,-1,Highcliffe School,Dorset,per-per,,PROPN-PROPN,PROPN,compound-compound,compound,NNP-NNP,NNP,3,1
9956,8443.0,21,rested,12,7,16,9,6,4,5,4,India,Jitender Kumar,,per-per,PROPN,PROPN-PROPN,poss,compound-appos,NNP,NNP-NNP,9,1
9957,8444.0,23,affiliated,3,1,7,6,0,15,2,4,CAMH,University of Toronto,per,--,PROPN,PROPN-ADP-PROPN,nsubjpass,pobj-prep-pobj,NNP,NNP-IN-NNP,4,1
9958,8563.0,29,affiliated,3,1,7,6,0,21,2,4,CAMH,University of Toronto,per,--,PROPN,PROPN-ADP-PROPN,nsubjpass,pobj-prep-pobj,NNP,NNP-IN-NNP,4,1
9959,8445.0,42,is,1,12,32,20,11,9,-11,31,New World Development,China,--,org,PROPN-PROPN-PROPN,PROPN,compound-compound-pobj,appos,NNP-NNP-NNP,NNP,9,1
9960,8446.0,15,ensured,2,9,14,5,8,0,-7,12,OPEC,Vienna,,per,PROPN,PROPN,dobj,pobj,NNP,NNP,5,1
9961,8447.0,34,won,1,12,13,1,11,20,-11,12,Treasury,Lyman J. Gage,org,--,PROPN,PROPN-PROPN-PROPN,compound,compound-compound-pobj,NNP,NNP-NNP-NNP,5,1
9962,8449.0,38,received,6,17,17,0,16,20,-11,11,Stony Brook University,Stony Brook,org-org-org,-,PROPN-PROPN-PROPN,PROPN-PROPN,compound-compound-nsubjpass,compound-compound,NNP-NNP-NNP,NNP-NNP,0,1
9963,8998.0,28,earned,1,15,15,0,14,12,-14,14,Stony Brook University,Stony Brook,--,per-per,PROPN-PROPN-PROPN,PROPN-PROPN,compound-compound-pobj,compound-pobj,NNP-NNP-NNP,NNP-NNP,0,1
9964,8450.0,20,began,1,1,15,14,0,4,0,14,She,Hamburg,org,,PRON,PROPN,nsubj,compound,PRP,NNP,4,1
9965,8451.0,19,wanted,1,3,9,6,2,9,-2,8,Hifikepunye Pohamba,Namibia,-,per,PROPN-PROPN,PROPN,compound-nsubj,pobj,NNP-NNP,NNP,2,1
9966,8452.0,18,born,2,13,16,3,12,1,-11,14,Sybil Thorndike,Lewis Casson,org-org,-,PROPN-PROPN,PROPN-PROPN,compound-appos,compound-conj,NNP-NNP,NNP-NNP,1,1
9967,8455.0,36,showed,6,4,5,1,3,30,2,-1,CEO,Paul Otellini,org,-,NOUN,PROPN-PROPN,pobj,compound-nsubj,NN,NNP-NNP,1,1
9968,8456.0,24,issued,6,5,5,0,4,18,1,-1,Saudi Arabian Oil Company,Saudi Aramco,per-per-per-per,-,ADJ-PROPN-PROPN-PROPN,PROPN-PROPN,amod-compound-compound-dobj,compound-pobj,JJ-NNP-NNP-NNP,NNP-NNP,0,1
9969,8457.0,37,After,0,19,24,5,18,12,-19,24,Florida Institute of Technology,NCAA Division II,---,per-per-per,PROPN-PROPN-ADP-PROPN,PROPN-PROPN-PROPN,compound-pobj-prep-pobj,compound-compound-compound,NNP-NNP-IN-NNP,NNP-NNP-NNP,3,1
9970,8460.0,20,referred,3,1,18,17,0,1,2,15,Hero,Quezon City,,per-per,NOUN,PROPN-PROPN,nsubj,compound-pobj,NN,NNP-NNP,7,1
9971,8461.0,21,filled,7,16,19,3,15,1,-9,12,Vital Remains,Dave Suzuki,per-per,-,PROPN-PROPN,PROPN-PROPN,compound-compound,compound-conj,NNP-NNP,NNP-NNP,5,1
9972,8462.0,25,formed,23,19,21,2,18,3,4,-2,ARL,News Limited,,per-per,PROPN,PROPN-PROPN,pobj,compound-conj,NNP,NNP-NNP,2,1
9973,8463.0,19,bought,3,3,8,5,2,10,0,5,Citigroup,Akbank,,per,PROPN,PROPN,nsubj,pobj,NNP,NNP,1,1
9974,8464.0,28,was,2,1,2,1,0,25,1,0,Doreen Bird,Bird College,org-org,-,PROPN-PROPN,PROPN-PROPN,compound-nsubj,compound-pobj,NNP-NNP,NNP-NNP,1,1
9975,8465.0,30,had,6,11,18,7,10,11,-5,12,Henry,her,org,,PROPN,PRON,conj,pobj,NNP,PRP,5,1
9976,8467.0,37,founded,2,1,5,4,0,31,1,3,BaseN,Pasi Hurri,org,-,PROPN,PROPN-PROPN,nsubjpass,compound-pobj,NNP,NNP-NNP,3,1
9977,8469.0,30,is,2,10,10,0,9,19,-8,8,Negros Oriental State University,Negros Oriental,---,per-per,PROPN-PROPN-PROPN-PROPN,PROPN-PROPN,compound-compound-compound-compound,compound-compound,NNP-NNP-NNP-NNP,NNP-NNP,0,1
9978,8470.0,28,tried,17,17,26,9,16,1,0,9,Iran,he,,org,PROPN,PRON,pobj,nsubj,NNP,PRP,8,1
9979,8471.0,13,is,2,1,8,7,0,4,1,6,Lawrence Arabia,New Zealand,per-per,-,PROPN-PROPN,PROPN-PROPN,compound-nsubj,compound-compound,NNP-NNP,NNP-NNP,6,1
9980,8472.0,31,said,8,20,23,3,19,7,-12,15,Register.com,New York,,per-per,PROPN,PROPN-PROPN,dobj,compound-compound,NNP,NNP-NNP,4,1
9981,8474.0,24,represented,9,3,19,16,2,4,6,10,Mississippi Valley State University,Division I,org-org-org-org,-,PROPN-PROPN-PROPN-PROPN,PROPN-PROPN,compound-compound-compound-dobj,compound-compound,NNP-NNP-NNP-NNP,NNP-NNP,7,1
9982,8475.0,36,agreed,31,8,29,21,7,6,23,-2,musician,Dave Matthews,,per-per,NOUN,PROPN-PROPN,appos,compound-compound,NN,NNP-NNP,8,1
9983,8476.0,39,brought,23,10,22,12,9,16,13,-1,Bill Laswell,Gigi,-,org,PROPN-PROPN,PROPN,compound-pobj,conj,NNP-NNP,NNP,7,1
9984,8477.0,38,dominated,10,4,4,0,3,33,6,-6,Edge and Christian,Edge,--,per,PROPN-CCONJ-PROPN,PROPN,pobj-cc-conj,nsubj,NNP-CC-NNP,NNP,0,1
9985,8481.0,24,scheduled,11,5,9,4,4,14,6,-2,Alitalia,Augusto Fantozzi,per,-,PROPN,PROPN-PROPN,poss,compound-appos,NNP,NNP-NNP,3,1
9986,8483.0,61,escaped,15,38,48,10,37,12,-23,33,Pol Pot,Communist Party,per-per,-,PROPN-PROPN,PROPN-PROPN,compound-compound,compound-compound,NNP-NNP,NNP-NNP,-1,1
9987,8484.0,24,is,9,1,20,19,0,3,8,11,Sari Nusseibeh,Al-Quds University,per-per,-,PROPN-PROPN,PROPN-PROPN,compound-nsubj,compound-pobj,NNP-NNP,NNP-NNP,7,1
9988,8485.0,37,is,7,15,1,-14,14,35,-8,-6,Metropolitan Transportation Authority,MTA,org-org-org,,PROPN-PROPN-PROPN,PROPN,compound-compound-pobj,pobj,NNP-NNP-NNP,NNP,6,1
9989,8486.0,32,LeBow's,0,2,17,15,1,14,-2,17,Vector Group,Douglas Elliman Realty,per-per,--,PROPN-PROPN,PROPN-PROPN-PROPN,compound-nsubj,compound-compound-compound,NNP-NNP,NNP-NNP-NNP,9,1
9990,8487.0,48,given,2,33,44,11,32,3,-31,42,Nashville,Hospital Corporation of America,org,---,PROPN,PROPN-PROPN-ADP-PROPN,compound,compound-oprd-prep-pobj,NNP,NNP-NNP-IN-NNP,6,1
9991,8488.0,33,renamed,10,13,24,11,12,8,-3,14,Helen Hayes,Nyack,org-org,,PROPN-PROPN,PROPN,compound-compound,pobj,NNP-NNP,NNP,6,1
9992,8489.0,19,became,1,14,16,2,13,2,-13,15,1851,Patek Philippe Co.,,org-org-org,NUM,PROPN-PROPN-PROPN,pobj,compound-compound-attr,CD,NNP-NNP-NNP,4,1
9993,8492.0,38,http://www.cddft.nhs.uk/Contact+Us/Hospital+Sites/BishopAucklandGeneralHospital.htm,0,15,33,18,14,4,-15,33,University Hospital of North Durham,County Durham,----,per-per,PROPN-PROPN-ADP-PROPN-PROPN,PROPN-PROPN,conj-pobj-prep-compound-pobj,nmod-nmod,NNP-NNP-IN-NNP-NNP,NNP-NNP,8,1
9994,8493.0,20,saw,1,4,13,9,3,6,-3,12,Theodor,Austria,,org,PROPN,PROPN,compound,compound,NNP,NNP,4,1
9995,8494.0,28,became,4,9,9,0,8,18,-5,5,BYU,BYU Jerusalem Center,org,--,PROPN,PROPN-PROPN-PROPN,pobj,compound-compound-pobj,NNP,NNP-NNP-NNP,0,1
9996,8495.0,30,be,2,12,25,13,11,4,-10,23,Andrew Johnson,American,org-org,,PROPN-PROPN,ADJ,compound-conj,amod,NNP-NNP,JJ,5,1
9997,8496.0,13,appointed,2,10,11,1,9,1,-8,9,Governor,Lewis Cass,,per-per,PROPN,PROPN-PROPN,compound,compound-pobj,NNP,NNP-NNP,1,1
9998,8498.0,24,released,8,6,7,1,5,16,2,-1,Albania,Nano,org,,PROPN,PROPN,compound,pobj,NNP,NNP,5,1
9999,8499.0,20,represented,7,3,3,0,2,16,4,-4,Duke Blue Devils,Duke University,per-per-per,-,PROPN-PROPN-PROPN,PROPN-PROPN,compound-compound-compound,compound-dobj,NNP-NNP-NNP,NNP-NNP,0,1
10000,8501.0,35,suspended,17,9,33,24,8,1,8,16,Britney Spears,Kevin Federline,per-per,-,PROPN-PROPN,PROPN-PROPN,compound-poss,compound-appos,NNP-NNPS,NNP-NNP,10,1
10001,8502.0,38,born,2,6,11,5,5,26,-4,9,Nova Scotia,Charles Tupper,-,per-per,PROPN-PROPN,PROPN-PROPN,compound-pobj,compound-pobj,NNP-NNP,NNP-NNP,3,1
10002,8503.0,24,are,17,2,8,6,1,15,15,-9,Russia,Eurasian Economic Community,,per-per-per,PROPN,PROPN-PROPN-PROPN,pobj,compound-compound-pobj,NNP,NNP-NNP-NNP,4,1
10003,8667.0,57,provide,7,19,23,4,18,33,-12,16,Russia,Eurasian Economic Community,,org-org-org,PROPN,PROPN-PROPN-PROPN,pobj,compound-compound-nmod,NNP,NNP-NNP-NNP,4,1
10004,8504.0,12,include,6,3,8,5,2,3,3,2,GM Europe,Saab,-,per,PROPN-PROPN,PROPN,compound-poss,compound,NNP-NNP,NNP,3,1
10005,8506.0,32,named,2,5,8,3,4,23,-3,6,Harold Brown,physicist,-,org,PROPN-PROPN,NOUN,compound-pobj,appos,NNP-NNP,NN,5,1
10006,8508.0,25,appeared,7,10,18,8,9,6,-3,11,Chrispa,Athens,org,,PROPN,PROPN,nmod,pobj,NNP,NNP,4,1
10007,8509.0,24,established,3,2,12,10,1,11,1,9,NUT,London,org,,PROPN,PROPN,nsubj,compound,NNP,NNP,3,1
10008,8510.0,18,covers,7,6,16,10,5,1,1,9,Huddersfield,Kirklees,,per,PROPN,PROPN,nsubj,compound,NNP,NNP,5,1
10009,8512.0,22,announced,5,12,17,5,11,4,-7,12,Lil Scrappy,G ' $ Up,org-org,---,PROPN-PROPN,NOUN-PUNCT-SYM-PROPN,compound-poss,appos-punct-nmod-compound,NNP-NNP,NN-''-$-NNP,5,1
10010,8514.0,47,is,20,1,19,18,0,27,19,-1,Ninet Tayeb,Israel,-,per,PROPN-PROPN,PROPN,compound-nsubj,pobj,NNP-NNP,NNP,2,1
10011,8515.0,37,is,3,8,17,9,7,19,-5,14,South Africa,DStv,-,org,PROPN-PROPN,NOUN,compound-pobj,pobj,NNP-NNP,NNS,5,1
10012,8517.0,36,is,9,1,13,12,0,22,8,4,Augustus,producer,,per,PROPN,NOUN,compound,attr,NNP,NN,5,1
10013,8518.0,35,was,12,3,18,15,2,16,9,6,England,Ethelred the Unready,org,--,PROPN,PROPN-DET-PROPN,pobj,pobj-det-dobj,NNP,NNP-DT-NNP,9,1
10014,8519.0,47,was,3,11,9,-2,10,37,-8,6,Missouri,University of Missouri System,,per-per-per-per,PROPN,PROPN-ADP-PROPN-PROPN,compound,nmod-prep-pobj-pobj,NNP,NNP-IN-NNP-NNP,1,1
10015,8520.0,36,expanded,12,9,11,2,8,24,3,-1,Illinois,league,per,,PROPN,NOUN,conj,nsubj,NNP,NN,3,1
10016,8521.0,48,Barni,2,16,24,8,15,23,-14,22,Princess,Ramphaiphanni,org,,PROPN,PROPN,compound,compound,NNP,NNP,4,1
10017,8522.0,31,born,2,6,15,9,5,15,-4,13,Ontario,Centennial Secondary School,,per-per-per,PROPN,PROPN-PROPN-PROPN,pobj,compound-compound-dobj,NNP,NNP-NNP-NNP,4,1
10018,8524.0,24,ran,5,11,22,11,10,1,-6,17,British Columbia,Russ Hiebert,-,per-per,PROPN-PROPN,PROPN-PROPN,compound-pobj,compound-pobj,NNP-NNP,NNP-NNP,9,1
10019,8525.0,31,escaped,1,1,14,13,0,16,0,13,He,Romania,,per,PRON,PROPN,nsubj,pobj,PRP,NNP,4,1
10020,8527.0,13,recognized,4,2,8,6,1,4,2,4,school,Michigan,,per,NOUN,PROPN,nsubjpass,compound,NN,NNP,4,1
10021,8530.0,34,ordered,11,5,6,1,4,27,6,-5,Navy,James C. Dobbin,org,--,PROPN,PROPN-PROPN-PROPN,pobj,compound-compound-nsubj,NNP,NNP-NNP-NNP,2,1
10022,9792.0,25,met,7,19,20,1,18,4,-12,13,Navy,James C. Dobbin,per,--,PROPN,PROPN-PROPN-PROPN,pobj,compound-compound-conj,NNP,NNP-NNP-NNP,2,1
10023,8531.0,14,named,3,6,11,5,5,2,-3,8,Leon Levine,Family Dollar,per-per,-,PROPN-PROPN,PROPN-PROPN,compound-pobj,compound-compound,NNP-NNP,NNP-NNP,4,1
10024,8532.0,37,cited,7,1,6,5,0,30,6,-1,David Kirk,Fairfax Media,per-per,-,PROPN-PROPN,PROPN-PROPN,compound-nmod,compound-pobj,NNP-NNP,NNP-NNP,3,1
10025,8533.0,59,met,12,48,53,5,47,5,-36,41,Movement for Democratic Change,Morgan Tsvangirai,---,org-org,PROPN-ADP-PROPN-PROPN,PROPN-PROPN,pobj-prep-compound-pobj,compound-pobj,NNP-IN-NNP-NNP,NNP-NNP,4,1
10026,8534.0,17,is,7,1,10,9,0,6,6,3,Daniel Desnoyers,Canadian,-,org,PROPN-PROPN,ADJ,compound-nsubj,amod,NNP-NNPS,JJ,3,1
10027,8535.0,48,is,1,1,9,8,0,38,0,8,Columbus,Red Barber,org,-,PROPN,PROPN-PROPN,nsubj,compound-pobj,NNP,NNP-NNP,3,1
10028,8537.0,31,started,4,11,17,6,10,13,-7,13,f he,n Belgrad,per-per,-,X-PRON,CCONJ-PROPN,intj-nmod,ROOT-compound,XX-PRP,CC-NNP,-1,1
10029,8538.0,20,is,1,8,15,7,7,4,-7,14,Zero 7,Sia Furler,-,org-org,PROPN-NUM,PROPN-PROPN,appos-nummod,compound-pobj,NNP-CD,NNP-NNP,10,1
10030,8540.0,43,joined,1,29,34,5,28,8,-28,33,European Central Bank,Germany,--,per,PROPN-PROPN-PROPN,PROPN,compound-compound-pobj,pobj,NNP-NNP-NNP,NNP,4,1
10031,8541.0,38,are,30,16,29,13,15,8,14,-1,President,Mikhail Gorbachev,org,-,PROPN,PROPN-PROPN,compound,compound-pobj,NNP,NNP-NNP,6,1
10032,8542.0,32,remain,2,23,31,8,22,0,-21,29,University of Central Florida,Orlando,per-per-per-per,,PROPN-ADP-PROPN-PROPN,PROPN,nmod-prep-compound-compound,pobj,NNP-IN-NNP-NNP,NNP,6,1
10033,8545.0,40,born,2,14,20,6,13,19,-12,18,Theodore Roosevelt,Alice Hathaway Lee,-,per-per-per,PROPN-PROPN,PROPN-PROPN-PROPN,compound-poss,compound-compound-compound,NNP-NNP,NNP-NNP-NNP,-1,1
10034,8546.0,27,worked,6,6,14,8,5,12,0,8,he,Institute of Field Archaeologists,,org-org-org-org,PRON,PROPN-ADP-PROPN-PROPN,nsubj,conj-prep-pobj-dobj,PRP,NNP-IN-NNP-NNPS,5,1
10035,8547.0,29,disclosed,8,5,7,2,4,21,3,-1,Tucows,Elliot Noss,,per-per,PROPN,PROPN-PROPN,compound,compound-nsubj,NNP,NNP-NNP,1,1
10036,8548.0,11,is,2,1,9,8,0,1,1,7,Cassandra Vasik,Blenheim,-,org,PROPN-PROPN,PROPN,compound-nsubj,compound,NNP-NNP,NNP,3,1
10037,8549.0,33,are,3,6,17,11,5,15,-3,14,Admiral Makarov National University of Shipbuilding,Ukraine,org-org-org-org-org-org,,PROPN-PROPN-PROPN-PROPN-ADP-PROPN,PROPN,compound-compound-compound-attr-prep-pobj,pobj,NNP-NNP-NNP-NNP-IN-NNP,NNP,2,1
10038,8550.0,47,is,13,23,27,4,22,19,-10,14,his,Carlton,,per,DET,PROPN,poss,compound,PRP$,NNP,3,1
10039,8551.0,19,left,1,1,15,14,0,3,0,14,He,Black Flag,,per-per,PRON,PROPN-PROPN,nsubj,compound-poss,PRP,NNP-NNP,4,1
10040,8552.0,29,is,1,12,22,10,11,6,-11,21,Broadcasting,Doordarshan,org,,PROPN,PROPN,nmod,compound,NNP,NNP,5,1
10041,8553.0,34,released,5,4,19,15,3,14,1,14,Ruby Blue,Red Flame Records,org-org,--,PROPN-PROPN,PROPN-PROPN-PROPN,compound-nsubj,compound-compound-pobj,NNP-NNP,NNP-NNP-NNPS,8,1
10042,8555.0,18,designated,7,3,15,12,2,2,4,8,lieutenant,Transit Police Department,per,--,NOUN,PROPN-PROPN-PROPN,nsubjpass,compound-compound-pobj,NN,NNP-NNP-NNP,6,1
10043,8556.0,17,was,4,8,15,7,7,1,-4,11,Grateful Dead,Rhino,-,per,PROPN-PROPN,PROPN,compound-compound,compound,NNP-NNP,NNP,6,1
10044,8557.0,21,said,7,1,5,4,0,15,6,-2,Barrick,Peter Munk,per,-,PROPN,PROPN-PROPN,compound,compound-conj,NNP,NNP-NNP,1,1
10045,8559.0,21,opened,11,9,11,2,8,9,2,0,Chubut Province,Aluar,org-org,,PROPN-PROPN,PROPN,compound-compound,pobj,NNP-NNP,NNP,2,1
10046,8560.0,45,began,3,9,31,22,8,13,-6,28,2003,Nicktoons,per,,NUM,PROPN,nummod,compound,CD,NNPS,7,1
10047,8562.0,19,appointed,6,11,17,6,10,1,-5,11,Senegal,Macky Sall,,per-per,PROPN,PROPN-PROPN,pobj,compound-pobj,NNP,NNP-NNP,1,1
10048,8564.0,18,attended,1,3,6,3,2,11,-2,5,Baldwin-Wallace College,Berea,-,org,PROPN-PROPN,PROPN,amod-dobj,compound,NNP-NNP,NNP,4,1
10049,8565.0,35,is,9,2,8,6,1,26,7,-1,2nd Marine Aircraft Wing,MAW,---,per,ADJ-PROPN-PROPN-PROPN,PROPN,amod-compound-compound-nsubj,appos,JJ-NNP-NNP-NNP,NNP,3,1
10050,8566.0,28,is,1,10,14,4,9,13,-9,13,Shakespears Sister,London,per-per,,PROPN-PROPN,PROPN,compound-pobj,compound,NNP-NNP,NNP,3,1
10051,13121.0,64,appeared,4,46,62,16,45,1,-42,58,Shakespears Sister,London,org-org,,PROPN-PROPN,PROPN,compound-conj,pobj,NNPS-NNP,NNP,4,1
10052,13701.0,26,intended,3,17,24,7,16,1,-14,21,Shakespears Sister,London,org-org,,PROPN-PROPN,PROPN,compound-nsubjpass,compound,NNPS-NNP,NNP,4,1
10053,8568.0,28,sold,3,2,9,7,1,18,1,6,2000,MG Rover Group,org,--,NUM,PROPN-PROPN-PROPN,pobj,compound-compound-dobj,CD,NNP-NNP-NNP,4,1
10054,8569.0,24,represented,7,3,10,7,2,13,4,3,New Mexico,University of New Mexico,-,per-per-per-per,PROPN-PROPN,PROPN-ADP-PROPN-PROPN,compound-compound,dobj-prep-compound-pobj,NNP-NNP,NNP-IN-NNP-NNP,5,1
10055,8570.0,15,graduated,1,5,7,2,4,7,-4,6,University of New Hampshire,New Hampshire,---,per-per,PROPN-ADP-PROPN-PROPN,PROPN-PROPN,pobj-prep-compound-pobj,compound-pobj,NNP-IN-NNP-NNP,NNP-NNP,1,1
10056,8571.0,24,had,1,15,19,4,14,4,-14,18,Woking F.C.,Football League Trophy,-,org-org-org,PROPN-PROPN,PROPN-PROPN-PROPN,compound-pobj,compound-compound-compound,NNP-NNP,NNP-NNP-NNP,7,1
10057,8572.0,27,court,2,8,19,11,7,7,-6,17,IDF,Israel,,per,PROPN,PROPN,compound,poss,NNP,NNP,9,1
10058,8573.0,33,incorporated,10,28,30,2,27,2,-18,20,GAIL,India,,per,PROPN,PROPN,nmod,nmod,NNP,NNP,3,1
10059,8574.0,10,established,4,1,9,8,0,0,3,5,IISCO,1918,per,,PROPN,NUM,compound,pobj,NNP,CD,3,1
10060,8575.0,20,started,1,14,19,5,13,0,-13,18,Willem de Kooning,Rotterdam,org-org-org,,PROPN-ADP-PROPN,PROPN,nmod-compound-compound,pobj,NNP-IN-NNP,NNP,5,1
10061,8576.0,36,succeeded,4,24,30,6,23,5,-20,26,New York City,Harold Prince,org-org-org,-,PROPN-PROPN-PROPN,PROPN-PROPN,compound-compound-appos,compound-pobj,NNP-NNP-NNP,NNP-NNP,6,1
10062,8577.0,28,graduated,3,6,11,5,5,16,-3,8,Caesar Rodney High School,Camden,---,org,PROPN-PROPN-PROPN-PROPN,PROPN,compound-compound-compound-pobj,compound,NNP-NNP-NNP-NNP,NNP,5,1
10063,8578.0,17,hailed,4,13,15,2,12,1,-9,11,Treasury,Alexander Hamilton,per,-,PROPN,PROPN-PROPN,pobj,compound-pobj,NNP,NNP-NNP,1,1
10064,8581.0,36,convinced,4,24,14,-10,23,21,-20,10,Norris McWhirter,the Freedom Association,-,org-org-org,PROPN-PROPN,DET-PROPN-PROPN,compound-conj,det-compound-dobj,NNP-NNP,DT-NNP-NNP,10,1
10065,8582.0,13,continues,2,5,11,6,4,1,-3,9,POWER,Jacqui Simmons,org,-,PROPN,PROPN-PROPN,pobj,compound-pobj,NNP,NNP-NNP,3,1
10066,8583.0,24,started,12,3,21,18,2,2,9,9,Anne Carroll,Seton High School,per-per,--,PROPN-PROPN,PROPN-PROPN-PROPN,compound-nsubj,compound-compound-oprd,NNP-NNP,NNP-NNP-NNP,5,1
10067,8585.0,39,recognized,3,1,14,13,0,24,2,11,SOF,New York City,,org-org-org,PROPN,PROPN-PROPN-PROPN,nsubjpass,compound-compound-pobj,NNP,NNP-NNP-NNP,6,1
10068,8586.0,25,Corporation,1,6,16,10,5,8,-5,15,Brady Corporation,Wisconsin,-,org,PROPN-PROPN,PROPN,conj-appos,compound,NNP-NNP,NNP,3,1
10069,8588.0,38,achieved,10,3,9,6,2,28,7,-1,Big Black,Steve Albini,-,per-per,PROPN-PROPN,PROPN-PROPN,compound-poss,compound-nsubj,NNP-NNP,NNP-NNP,2,1
10070,8590.0,31,is,17,15,29,14,14,1,2,12,United Kingdom,Five,org-org,,PROPN-PROPN,PROPN,compound-pobj,compound,NNP-NNP,NNP,9,1
10071,8591.0,24,is,3,1,16,15,0,7,2,13,Chester High School,United States,--,per-per,PROPN-PROPN-PROPN,PROPN-PROPN,compound-compound-nsubj,compound-pobj,NNP-NNP-NNP,NNP-NNP,6,1
10072,8592.0,11,obtained,3,8,10,2,7,0,-5,7,Jahangirnagar University,Savar,org-org,,PROPN-PROPN,PROPN,compound-compound,pobj,NNP-NNP,NNP,4,1
10073,8594.0,27,demonstrated,4,9,22,13,8,4,-5,18,Japan,Mitsumasa Yonai,per,-,PROPN,PROPN-PROPN,nsubj,compound-nsubj,NNP,NNP-NNP,3,1
10074,13300.0,17,was,4,14,15,1,13,1,-10,11,Japan,Mitsumasa Yonai,per,-,PROPN,PROPN-PROPN,compound,compound-pobj,NNP,NNP-NNP,1,1
10075,8595.0,45,commented,5,4,12,8,3,32,1,7,Oregon,Merkley,per,,PROPN,PROPN,compound,pobj,NNP,NNP,3,1
10076,8596.0,25,is,5,1,14,13,0,10,4,9,Saffron Walden County High School,Technology College,per-per-per-per-per,-,PROPN-PROPN-PROPN-PROPN-PROPN,PROPN-PROPN,compound-compound-compound-compound-nsubj,compound-conj,NNP-NNP-NNP-NNP-NNP,NNP-NNP,6,1
10077,8597.0,22,led,1,4,1,-3,3,20,-3,0,Workers ' Party,Kim Jong-Il,org-org-org,-,PROPN-PART-PROPN,PROPN-PROPN,poss-case-nmod,compound-pobj,NNPS-POS-NNP,NNP-NNP,4,1
10078,8598.0,43,is,1,27,39,12,26,3,-26,38,Kuroda Seiki,Japan,per-per,,PROPN-PROPN,PROPN,nmod-nmod,compound,NNP-NNP,NNP,5,1
10079,8600.0,40,is,3,10,26,16,9,13,-7,23,Kent,Wildernesse School,per,-,PROPN,PROPN-PROPN,compound,compound-pobj,NNP,NNP-NNP,9,1
10080,8601.0,41,warned,6,23,32,9,22,8,-17,26,Pakistan,Abdullah Mehsud,per,-,PROPN,PROPN-VERB,pobj,compound-appos,NNP,NNP-VBZ,4,1
10081,8602.0,30,stopped,9,3,7,4,2,22,6,-2,Avianca,Star Alliance,,org-org,PROPN,PROPN-PROPN,poss,compound-pobj,NNP,NNP-NNP,4,1
10082,13966.0,36,maintains,2,1,34,33,0,1,1,32,Avianca,Star Alliance,org,-,NOUN,PROPN-PROPN,nsubj,compound-pobj,NNS,NNP-NNP,-1,1
10083,8603.0,17,appeared,5,2,9,7,1,7,3,4,Canada,BBC Canada,per,-,PROPN,PROPN-PROPN,pobj,compound-pobj,NNP,NNP-NNP,4,1
10084,8604.0,17,is,7,2,4,2,1,12,5,-3,University of Fribourg,Fribourg,per-per-per,,PROPN-ADP-PROPN,PROPN,nsubj-prep-pobj,compound,NNP-IN-NNP,NNP,2,1
10085,8605.0,17,is,1,9,15,6,8,1,-8,14,Jim Lovell,American,-,org,PROPN-PROPN,ADJ,compound-nsubj,amod,NNP-NNP,JJ,2,1
10086,8606.0,26,left,6,14,20,6,13,5,-8,14,Hinsdale Central High School,Illinois,per-per-per-per,,PROPN-PROPN-PROPN-PROPN,PROPN,compound-compound-compound-pobj,pobj,NNP-NNP-NNP-NNP,NNP,4,1
10087,8607.0,20,released,1,1,18,17,0,1,0,17,He,Earl Johnson,org,-,PRON,PROPN-PROPN,nsubj,compound-pobj,PRP,NNP-NNP,-1,1
10088,8609.0,39,immigrate,12,16,31,15,15,7,-4,19,United States,Ultimate Fighting Championship,-,org-org-org,PROPN-PROPN,PROPN-PROPN-PROPN,compound-pobj,compound-compound-dobj,NNP-NNP,NNP-NNP-NNP,7,1
10089,8611.0,29,Feel,4,1,17,16,0,11,3,13,Darude,Finland,org,,PROPN,PROPN,poss,pobj,NNP,NNP,5,1
10090,13685.0,26,is,15,15,25,10,14,0,0,10,Darude,Finland,,org,PROPN,PROPN,nsubj,pobj,NNP,NNP,1,1
10091,8612.0,30,run,5,2,10,8,1,19,3,5,Shad Valley,International,-,per,PROPN-PROPN,PROPN,compound-compound,pobj,NNP-NNP,NNP,5,1
10092,8614.0,30,held,7,2,4,2,1,25,5,-3,Prime Minister,Abdelaziz Belkhadem,org-org,-,PROPN-PROPN,PROPN-PROPN,compound-compound,compound-nsubj,NNP-NNP,NNP-NNP,1,1
10093,8616.0,28,convened,17,9,14,5,8,13,8,-3,Tommy G. Thompson,Health and Human Services,per-per-per,---,PROPN-PROPN-PROPN,PROPN-CCONJ-PROPN-PROPN,compound-compound-compound,pobj-cc-compound-conj,NNP-NNP-NNP,NNP-CC-NNP-NNPS,5,1
10094,8617.0,44,incorporated,2,12,22,10,11,21,-10,20,John Gokongwei,Robinsons,org-org,,PROPN-PROPN,PROPN,compound-compound,nmod,NNP-NNP,NNPS,7,1
10095,8619.0,20,started,11,2,16,14,1,3,9,5,The Walt Disney Company,ESPN,---,org,DET-PROPN-PROPN-PROPN,PROPN,det-compound-compound-nsubj,dobj,DT-NNP-NNP-NNP,NNP,4,1
10096,8620.0,18,released,6,1,9,8,0,8,5,3,Michael,Epic,org,,PROPN,PROPN,poss,compound,NNP,NNP,5,1
10097,8621.0,15,said,12,5,14,9,4,0,7,2,United States,Miller,-,org,PROPN-PROPN,PROPN,compound-nsubj,nsubj,NNP-NNP,NNP,4,1
10098,8623.0,30,is,4,2,14,12,1,15,2,10,University of Seville,Spain,org-org-org,,PROPN-ADP-PROPN,PROPN,nsubj-prep-pobj,pobj,NNP-IN-NNP,NNP,6,1
10099,8624.0,12,USA,10,2,11,9,1,0,8,1,Ann Arbor News,USA,org-org-org,,PROPN-PROPN-PROPN,PROPN,compound-compound-nmod,ROOT,NNP-NNP-NNP,NNP,3,1
10100,8625.0,57,attended,3,36,40,4,35,16,-33,37,Albania,d Bamir Top,org,--,PROPN,ADJ-PROPN-PROPN,compound,pobj-compound-ROOT,NNP,JJ-NNP-NNP,3,1
10101,8627.0,16,called,2,12,14,2,11,1,-10,12,Mississippi,Lance Bass,org,-,PROPN,PROPN-PROPN,pobj,compound-oprd,NNP,NNP-NNP,2,1
10102,8629.0,43,is,2,17,24,7,16,18,-15,22,Eminem,Michigan,per,,PROPN,PROPN,ROOT,nsubj,NNP,NNP,6,1
10103,8630.0,22,offered,7,17,19,2,16,2,-10,12,Perth,The Sleepy Jackson,,per-per-per,PROPN,DET-PROPN-PROPN,compound,det-compound-dobj,NNP,DT-NNP-NNP,3,1
10104,8632.0,31,given,2,1,6,5,0,24,1,4,Israel,Natalie Portman,org,-,PROPN,PROPN-PROPN,nsubj,compound-appos,NNP,NNP-NNP,3,1
10105,8633.0,30,graduated,7,2,5,3,1,24,5,-2,its,1938,,org,DET,NUM,poss,pobj,PRP$,CD,4,1
10106,8634.0,25,is,4,18,21,3,17,3,-14,17,SM Prime Holdings,Henry Sy Sr .,per-per-per,---,PROPN-PROPN-PROPN,PROPN-PROPN-PROPN-PUNCT,compound-compound-compound,compound-compound-subtok-pobj,NNP-NNP-NNPS,NNP-NNP-NNP-.,3,1
10107,8635.0,34,mobilized,19,7,16,9,6,17,12,-3,184th Infantry Regiment,California,org-org-org,,PROPN-PROPN-PROPN,PROPN,amod-compound-pobj,compound,NNP-NNP-NNP,NNP,9,1
10108,8636.0,55,presented,5,3,21,18,2,33,2,16,Danny Mixon,Harlem,-,org,PROPN-PROPN,PROPN,compound-nsubjpass,pobj,NNP-NNP,NNP,7,1
10109,8638.0,17,separated,4,3,16,13,2,0,1,12,Pamida,Nebraska,,per,PROPN,PROPN,nsubjpass,pobj,NNP,NNP,2,1
10110,8641.0,22,carried,10,8,19,11,7,2,2,9,SEUA,Armenia,org,,PROPN,PROPN,compound,pobj,NNP,NNP,10,1
10111,8642.0,23,played,14,11,12,1,10,10,3,-2,guitarist,John Reis,org,-,NOUN,PROPN-PROPN,compound,compound-nsubj,NN,NNP-NNP,1,1
10112,8643.0,8,replaced,2,4,6,2,3,1,-2,4,Thors,Prime Minister,per,-,PROPN,PROPN-PROPN,dobj,compound-pobj,NNPS,NNP-NNP,1,1
10113,8644.0,29,have,2,1,8,7,0,20,1,6,Adams,England,,per,PROPN,PROPN,nsubj,pobj,NNP,NNP,3,1
10114,8645.0,25,born,2,8,11,3,7,13,-6,9,Rex Harrison,Lilli Palmer,-,per-per,PROPN-PROPN,PROPN-PROPN,compound-appos,compound-conj,NNP-NNP,NNP-NNP,1,1
10115,8646.0,24,there's,1,17,23,6,16,0,-16,22,Rob Portman,Director,-,org,PROPN-PROPN,PROPN,compound-dobj,pobj,NNP-NNP,NNP,3,1
10116,8647.0,10,daughter,3,3,7,4,2,2,0,4,Fujimori,Peru,,per,PROPN,PROPN,compound,nmod,NNP,NNP,4,1
10117,8648.0,24,grew,7,12,13,1,11,10,-5,6,1964,Yle TV2,per,-,NUM,PROPN-PROPN,pobj,compound-pobj,CD,NNP-NNP,1,1
10118,8649.0,41,operate,20,18,33,15,17,7,2,13,Qantas,Oneworld,,org,PROPN,PROPN,nsubj,compound,NNP,NNP,6,1
10119,8651.0,31,is,2,16,18,2,15,12,-14,16,United States,National Security Agency,-,per-per-per,PROPN-PROPN,PROPN-PROPN-PROPN,compound-compound,compound-compound-pobj,NNP-NNP,NNP-NNP-NNP,3,1
10120,9778.0,123,is,7,13,31,18,12,91,-6,24,United States,National Security Agency,per-per,--,PROPN-PROPN,PROPN-PROPN-PROPN,compound-compound,compound-compound-pobj,NNP-NNP,NNP-NNP-NNP,9,1
10121,8652.0,22,is,1,8,20,12,7,1,-7,19,East Tennessee State University,United States,---,org-org,PROPN-PROPN-PROPN-PROPN,PROPN-PROPN,compound-compound-compound-pobj,compound-conj,NNP-NNP-NNP-NNP,NNP-NNP,10,1
10122,8653.0,42,commissioned,2,14,27,13,13,14,-12,25,Green Howards,Army,-,org,PROPN-PROPN,PROPN,compound-pobj,compound,NNP-NNPS,NNP,8,1
10123,8654.0,25,born,4,1,16,15,0,8,3,12,Dennis Lee Hopper,his,org-org-org,,PROPN-PROPN-PROPN,DET,compound-compound-nsubjpass,poss,NNP-NNP-NNP,PRP$,6,1
10124,8655.0,15,is,7,1,5,4,0,9,6,-2,Ashley Bickerton,Barbados,per-per,,PROPN-PROPN,PROPN,compound-nsubj,dobj,NNP-NNP,NNP,3,1
10125,8657.0,21,spun,2,1,16,15,0,4,1,14,Western Wireless,Deutsche Telekom,per-per,-,PROPN-PROPN,PROPN-PROPN,compound-nsubj,compound-compound,NNP-NNP,NNP-NNP,6,1
10126,8659.0,35,began,1,1,8,7,0,26,0,7,Armstrong,Glasgow,,org,PROPN,PROPN,nsubj,compound,NNP,NNP,5,1
10127,8660.0,15,captured,8,1,2,1,0,12,7,-6,President,Nicolas Sarkozy,org,-,PROPN,PROPN-PROPN,compound,compound-poss,NNP,NNP-NNP,1,1
10128,13919.0,36,said,31,2,3,1,1,32,29,-28,President,Nicolas Sarkozy,,org-org,PROPN,PROPN-PROPN,compound,compound-nsubj,NNP,NNP-NNP,1,1
10129,13991.0,14,included,2,5,6,1,4,7,-3,4,President,Nicolas Sarkozy,org,-,PROPN,PROPN-PROPN,compound,compound-dobj,NNP,NNP-NNP,1,1
10130,8661.0,30,founded,14,11,13,2,10,16,3,-1,his,Venezuela,per,,DET,PROPN,poss,compound,PRP$,NNP,1,1
10131,8662.0,13,is,1,1,12,11,0,0,0,11,He,Israel,org,,PRON,PROPN,nsubj,pobj,PRP,NNP,1,1
10132,8664.0,13,graduated,1,6,10,4,5,2,-5,9,Garfield High School,East Los Angeles,--,per-per-per,PROPN-PROPN-PROPN,PROPN-PROPN-PROPN,compound-compound-pobj,compound-compound-pobj,NNP-NNP-NNP,NNP-NNP-NNP,4,1
10133,8665.0,38,said,17,31,35,4,30,2,-14,18,MediaNews Group,The Denver Post,-,per-per-per,PROPN-PROPN,DET-PROPN-PROPN,compound-compound,det-compound-pobj,NNP-NNP,DT-NNP-NNP,4,1
10134,11447.0,41,said,11,19,33,14,18,7,-8,22,MediaNews Group,The Denver Post,per-per,--,PROPN-PROPN,DET-PROPN-PROPN,compound-compound,det-compound-pobj,NNP-NNP,DT-NNP-NNP,9,1
10135,8666.0,37,was,1,12,15,3,11,21,-11,14,EMI,their,per,,PROPN,DET,compound,poss,NNP,PRP$,4,1
10136,8668.0,40,welcomed,5,36,38,2,35,1,-31,33,Vice President,Hu Jintao,per-per,-,PROPN-PROPN,PROPN-PROPN,compound-compound,compound-ROOT,NNP-NNP,NNP-NNP,1,1
10137,8670.0,31,nominated,6,10,17,7,9,13,-4,11,James Buchanan,United States,per-per,-,PROPN-PROPN,PROPN-PROPN,compound-pobj,compound-compound,NNP-NNP,NNP-NNP,7,1
10138,12311.0,23,appointed,6,10,16,6,9,6,-4,10,James Buchanan,United States,-,per-per,PROPN-PROPN,PROPN-PROPN,compound-pobj,compound-compound,NNP-NNP,NNP-NNP,5,1
10139,8671.0,44,is,18,7,14,7,6,29,11,-4,Perak,Federated Malay States,,per-per-per,PROPN,PROPN-PROPN-PROPN,pobj,compound-compound-compound,NNP,NNP-NNP-NNP,6,1
10140,8672.0,30,developed,9,8,25,17,7,4,1,16,Jerry Shirley,Humble Pie,-,per-per,PROPN-PROPN,PROPN-PROPN,compound-pobj,compound-compound,NNP-NNP,NNP-NNP,5,1
10141,8673.0,30,formed,9,8,15,7,7,14,1,6,Lisa Clark,Pett Productions,org-org,-,PROPN-PROPN,PROPN-PROPN,compound-conj,compound-appos,NNP-NNP,NNP-NNPS,4,1
10142,8674.0,42,Note,0,10,10,0,9,31,-10,10,Norwegian Maritime Directorate,Norwegian Ministry of Trade and Industry,org-org-org,-----,ADJ-PROPN-PROPN,PROPN-PROPN-ADP-PROPN-CCONJ-PROPN,amod-compound-appos,amod-pobj-prep-pobj-cc-conj,JJ-NNP-NNP,NNP-NNP-IN-NNP-CC-NNP,0,1
10143,8675.0,37,evoked,5,33,1,-32,32,35,-28,-4,Perth,The Triffids,,per-per,PROPN,DET-PROPN,compound,det-appos,NNP,DT-NNPS,-1,1
10144,8678.0,28,is,5,1,17,16,0,10,4,12,Stivers School for the Arts,Ohio,org-org-org-org-org,,PROPN-PROPN-ADP-DET-PROPN,PROPN,compound-nsubj-prep-det-pobj,compound,NNPS-NNP-IN-DT-NNPS,NNP,3,1
10145,8679.0,19,co-hosted,3,8,10,2,7,8,-5,7,Vice President,Xi Jinping,org-org,-,PROPN-PROPN,PROPN-PROPN,compound-compound,compound-dobj,NNP-NNP,NNP-NNP,1,1
10146,8680.0,110,opened,23,33,109,76,32,0,-10,86,Andrews University,Michigan,-,per,PROPN-PROPN,PROPN,compound-compound,pobj,NNP-NNP,NNP,-1,1
10147,11974.0,23,is,6,1,22,21,0,0,5,16,Andrews University,Michigan,-,org,PROPN-PROPN,PROPN,compound-compound,pobj,NNP-NNP,NNP,3,1
10148,8681.0,25,finished,4,4,18,14,3,6,0,14,he,Southern Rhodesia,,org-org,PRON,PROPN-PROPN,nsubj,compound-pobj,PRP,NNP-NNP,3,1
10149,8683.0,28,grew,11,6,15,9,5,12,5,4,foundation,Seattle,org,,NOUN,PROPN,dobj,pobj,NN,NNP,5,1
10150,8685.0,11,H,1,5,10,5,4,0,-4,9,Guru Gobind Singh Indraprastha University,Delhi,----,org,PROPN-PROPN-PROPN-PROPN-PROPN,PROPN,compound-compound-compound-compound-compound,pobj,NNP-NNP-NNP-NNP-NNP,NNP,5,1
10151,13217.0,25,located,20,1,18,17,0,6,19,-2,Guru Gobind Singh Indraprastha University,Delhi,----,per,PROPN-PROPN-PROPN-PROPN-PROPN,PROPN,compound-compound-compound-compound-nsubjpass,pobj,NNP-NNP-NNP-NNP-NNP,NNP,3,1
10152,8688.0,20,is,14,16,19,3,15,0,-2,5,David Vitter,Louisiana,org-org,,PROPN-PROPN,PROPN,compound-attr,pobj,NNP-NNP,NNP,3,1
10153,12111.0,46,made,6,3,6,3,2,39,3,0,David Vitter,Louisiana,-,org,PROPN-PROPN,PROPN,compound-nsubj,pobj,NNP-NNP,NNP,1,1
10154,8689.0,51,started,4,34,37,3,33,13,-30,33,Lehman Brothers,Henry Lehman,-,per-per,PROPN-PROPN,PROPN-PROPN,compound-ROOT,compound-appos,NNP-NNPS,NNP-NNP,1,1
10155,8691.0,26,is,2,1,20,19,0,5,1,18,Astra International,Tjia Kian Tie,org-org,--,PROPN-PROPN,PROPN-ADJ-PROPN,compound-nsubj,compound-compound-pobj,NNP-NNP,NNP-JJ-NNP,10,1
10156,8693.0,25,signed,3,9,13,4,8,11,-6,10,Gary Numan,Numa,per-per,,PROPN-PROPN,PROPN,compound-poss,compound,NNP-NNP,NNP,2,1
10157,8694.0,44,sought,4,22,31,9,21,12,-18,27,Opel,Germany,per,,PROPN,PROPN,compound,pobj,NNP,NNP,4,1
10158,9797.0,22,spent,1,11,14,3,10,7,-10,13,Opel,Germany,org,,PROPN,PROPN,compound,pobj,NNP,NNP,3,1
10159,8695.0,27,visited,6,5,19,14,4,7,1,13,Mozambique,MOZAL,,per,PROPN,PROPN,compound,compound,NNP,NNP,8,1
10160,8696.0,10,served,2,1,8,7,0,1,1,6,Smith,New Brunswick,per,-,PROPN,PROPN-PROPN,nsubj,compound-pobj,NNP,NNP-NNP,5,1
10161,8698.0,54,is,13,5,31,26,4,22,8,18,Office of Science and Technology Policy,May 11 1976,-----,org-org-org,PROPN-ADP-PROPN-CCONJ-PROPN-PROPN,PROPN-NUM-NUM,pobj-prep-pobj-cc-conj-conj,pobj-nummod-nummod,NNP-IN-NNP-CC-NNP-NNP,NNP-CD-CD,9,1
10162,8699.0,24,worked,4,8,23,15,7,0,-4,19,his,Berkeley,,org,DET,PROPN,poss,pobj,PRP$,NNP,3,1
10163,8701.0,20,graduated,1,10,15,5,9,4,-9,14,Arizona,Yavapai College,,org-org,PROPN,PROPN-PROPN,pobj,compound-dobj,NNP,NNP-NNP,4,1
10164,8703.0,22,worked,7,17,21,4,16,0,-10,14,The Detroit News,1873,--,org,DET-PROPN-PROPN,NUM,det-compound-dobj,pobj,DT-NNP-NNP,CD,3,1
10165,8706.0,17,faced,1,3,8,5,2,8,-2,7,Arkansas,David Pryor,,org-org,PROPN,PROPN-PROPN,compound,compound-poss,NNP,NNP-NNP,3,1
10166,8707.0,18,unveils,7,3,17,14,2,0,4,10,Patrick Hillery,Dublin,-,org,PROPN-PROPN,PROPN,compound-compound,pobj,NNP-NNP,NNP,5,1
10167,13057.0,11,Hillery,2,2,10,8,1,0,0,8,Patrick Hillery,Dublin,org-org,,PROPN-PROPN,PROPN,compound-ROOT,pobj,NNP-NNP,NNP,1,1
10168,8708.0,56,celebrated,3,29,36,7,28,19,-26,33,Tokyo,Empress Michiko,per,-,PROPN,PROPN-PROPN,pobj,compound-pobj,NNP,NNP-NNP,5,1
10169,8709.0,13,continued,2,1,9,8,0,3,1,7,He,Kentucky,per,,PRON,PROPN,nsubj,compound,PRP,NNP,5,1
10170,8710.0,20,was,3,5,15,10,4,4,-2,12,Robert Beaven,British Columbia,-,per-per,PROPN-PROPN,PROPN-PROPN,compound-attr,compound-pobj,NNP-NNP,NNP-NNP,8,1
10171,8713.0,24,closed,6,1,3,2,0,20,5,-3,Argentina,Buenos Aires stock exchange,org,---,PROPN,PROPN-PROPN-NOUN-NOUN,poss,compound-compound-compound-nsubj,NNP,NNP-NNP-NN-NN,3,1
10172,8714.0,42,scored,1,5,15,10,4,26,-4,14,Bundesliga,Bayer 04 Leverkusen,org,--,PROPN,PROPN-NUM-PROPN,compound,pobj-nummod-nsubj,NNP,NNP-CD-NNP,6,1
10173,8715.0,57,went,5,21,29,8,20,27,-16,24,Ukraine,Viktor Pinchuk,org,-,PROPN,PROPN-PROPN,pobj,compound-pobj,NNP,NNP-NNP,-1,1
10174,13773.0,73,conducted,4,33,59,26,32,13,-29,55,Ukraine,Viktor Pinchuk,per,-,PROPN,PROPN-PROPN,compound,compound-pobj,NNP,NNP-NNP,11,1
10175,8716.0,30,announced,5,18,28,10,17,1,-13,23,Hong Kong,Ma Lik,-,per-per,PROPN-PROPN,PROPN-PROPN,compound-compound,compound-pobj,NNP-NNP,NNP-NNP,5,1
10176,8717.0,23,incorporated,3,10,13,3,9,9,-7,10,Salmon P. Chase,United States,--,org-org,PROPN-PROPN-PROPN,PROPN-PROPN,compound-compound-compound,compound-compound,NNP-NNP-NNP,NNP-NNP,3,1
10177,8718.0,15,was,2,10,13,3,9,1,-8,11,Bang Olufsen,Peter Bang,-,per-per,PROPN-PROPN,PROPN-PROPN,compound-dobj,compound-pobj,NNP-NNP,NNP-NNP,2,1
10178,8719.0,57,toured,4,4,6,2,3,50,0,2,Ellis,Jamaica,,per,PROPN,PROPN,nsubj,dobj,NNP,NNP,1,1
10179,8720.0,30,Dragoons,4,4,19,15,3,10,0,15,Light Dragoons,Pennsylvania,per-per,,PROPN-PROPN,PROPN,compound-ROOT,pobj,NNP-NNPS,NNP,3,1
10180,8721.0,20,moved,11,10,14,4,9,5,1,3,Luke Doucet,Vancouver,-,org,PROPN-PROPN,PROPN,compound-nsubj,pobj,NNP-NNP,NNP,2,1
10181,8722.0,14,sold,4,1,10,9,0,3,3,6,The World,WRC Media,per-per,-,DET-PROPN,PROPN-PROPN,det-compound,compound-pobj,DT-NNP,NNP-NNP,4,1
10182,8723.0,39,airs,2,19,5,-14,18,33,-17,3,Division I,Stony Brook Seawolves,-,org-org-org,PROPN-PRON,PROPN-PROPN-PROPN,pobj-nsubj,compound-compound-dobj,NNP-PRP,NNP-NNP-NNPS,7,1
10183,8724.0,47,exchanged,8,1,7,6,0,39,7,-1,Uncle Tupelo,Jeff Tweedy,-,org-org,PROPN-PROPN,PROPN-PROPN,compound-compound,compound-conj,NNP-NNP,NNP-NNP,3,1
10184,8725.0,17,owns,1,1,6,5,0,10,0,5,Textron,Cessna,,per,PROPN,PROPN,nsubj,conj,NNP,NNP,1,1
10185,8726.0,50,revealed,17,1,6,5,0,43,16,-11,Studio Ghibli,Isao Takahata,-,org-org,PROPN-ADJ,PROPN-PROPN,compound-compound,compound-conj,NNP-JJ,NNP-NNP,3,1
10186,8727.0,36,was,20,17,33,16,16,2,3,13,National Defence Commission,Kim Jong-il,per-per-per,-,PROPN-PROPN-PROPN,PROPN-PROPN,compound-compound-pobj,compound-pobj,NNP-NNP-NNP,NNP-NNP,13,1
10187,8728.0,16,represent,3,2,12,10,1,3,1,9,UMBC,NCAA,org,,PROPN,PROPN,compound,compound,NNP,NNP,4,1
10188,8729.0,21,held,1,1,11,10,0,9,0,10,Allianz,Germany,,per,PROPN,PROPN,nsubj,pobj,NNP,NNP,1,1
10189,10461.0,32,return,22,4,19,15,3,12,18,-3,Allianz,Germany,per,,PROPN,PROPN,pobj,pobj,NNP,NNP,5,1
10190,8730.0,15,visited,12,4,8,4,3,6,8,-4,Japan,Ysuke Matsuok,org,-,PROPN,PROPN-PROPN,poss,compound-pobj,NNP,NNP-NNP,3,1
10191,12732.0,83,is,25,37,42,5,36,40,-12,17,Japan,Ysuke Matsuok,,per-per,PROPN,PROPN-PROPN,pobj,compound-appos,NNP,NNP-NNP,2,1
10192,8731.0,21,formed,3,10,20,10,9,0,-7,17,DEUXO,Schpilkas,per,,ADV,PROPN,oprd,pobj,RB,NNP,3,1
10193,8732.0,19,makes,5,5,18,13,4,0,0,13,Dudamel,Venezuela,,per,PROPN,PROPN,nsubj,pobj,NNP,NNP,1,1
10194,8733.0,28,formed,6,9,26,17,8,1,-3,20,Ehud Barak,Prime Minister,org-org,-,PROPN-PROPN,PROPN-PROPN,compound-pobj,compound-pobj,NNP-NNP,NNP-NNP,6,1
10195,8734.0,23,continued,2,13,21,8,12,1,-11,19,Japan,Baba,per,,PROPN,PROPN,nsubj,conj,NNP,NNP,7,1
10196,8735.0,37,charged,16,13,28,15,12,8,3,12,Germany,Werner,org,,PROPN,PROPN,pobj,pobj,NNP,NNP,7,1
10197,8738.0,16,http://www.nytimes.com/2007/10/25/sports/baseball/25yankees.html,0,7,13,6,6,2,-7,13,Bet Shemesh Blue Sox,Israel Baseball League,per-per-per-per,--,PROPN-PROPN-PROPN-PROPN,PROPN-PROPN-PROPN,compound-compound-compound-pobj,compound-compound-pobj,NNP-NNP-NNP-NNPS,NNP-NNP-NNP,4,1
10198,8739.0,27,made,20,7,16,9,6,10,13,-4,he,Chancellor,org,,PRON,PROPN,nsubj,nmod,PRP,NNP,5,1
10199,8740.0,34,revealed,3,21,30,9,20,3,-18,27,d Borisav Jovi,FR Yugoslav,per-per-per,-,ADJ-NOUN-NOUN,PROPN-NOUN,nummod-compound-npadvmod,compound-pobj,JJ-NN-NNS,NNP-NN,-1,1
10200,8741.0,39,artists,2,4,7,3,3,31,-2,5,Zain Bhikha,South Africa,org-org,-,PROPN-PROPN,PROPN-PROPN,compound-appos,compound-appos,NNP-NNP,NNP-NNP,2,1
10201,10302.0,51,track,19,9,12,3,8,38,10,-7,Zain Bhikha,South Africa,org-org,-,PROPN-PROPN,PROPN-PROPN,compound-appos,compound-pobj,NNP-NNP,NNP-NNP,2,1
10202,8743.0,23,moved,5,4,22,18,3,0,1,17,him he,Switzerland,per-per,,PRON-PRON,PROPN,dobj-nsubj,pobj,PRP-PRP,NNP,2,1
10203,8744.0,120,released,109,91,39,-52,90,80,18,-70,Seoul National University Hospital,South Korea,org-org-org-org,-,PROPN-PROPN-PROPN-PROPN,PROPN-PROPN,compound-compound-compound-pobj,compound-pobj,NNP-NNP-NNP-NNP,NNP-NNP,8,1
10204,8745.0,9,Equality,4,1,7,6,0,1,3,3,Bruce Springsteen,New Jersey,-,org-org,PROPN-PROPN,PROPN-PROPN,compound-compound,compound-pobj,NNP-NNP,NNP-NNP,4,1
10205,8747.0,28,represented,7,5,11,6,4,16,2,4,Alpha Alpha,Illinois College,-,org-org,PROPN-PROPN,PROPN-PROPN,compound-compound,compound-pobj,NNP-NNP,NNP-NNP,4,1
10206,8748.0,42,met,6,1,24,23,0,17,5,18,Amy Ray,Georgia,-,org,PROPN-PROPN,PROPN,compound-nsubj,pobj,NNP-NNP,NNP,7,1
10207,8749.0,20,born,2,11,11,0,10,8,-9,9,Dover,Dover High School,org,--,PROPN,PROPN-PROPN-PROPN,compound,compound-compound-pobj,NNP,NNP-NNP-NNP,0,1
10208,8750.0,10,channel,1,5,7,2,4,2,-4,6,Virgin1,1 October 2007,per,--,PROPN,NUM-PROPN-NUM,pobj,nummod-pobj-nummod,NNP,CD-NNP-CD,1,1
10209,8752.0,35,received,3,31,34,3,30,0,-28,31,Novartis,Basel,,org,PROPN,PROPN,appos,pobj,NNP,NNP,6,1
10210,8753.0,31,is,8,2,11,9,1,19,6,3,Sheriff,1979,per,,PROPN,NUM,nsubj,nummod,NNP,CD,5,1
10211,8754.0,21,was,1,1,17,16,0,3,0,16,He,KMFDM,org,,PRON,PROPN,nsubj,compound,PRP,NNP,2,1
10212,8755.0,15,took,4,4,14,10,3,0,0,10,he,Norway,org,,PRON,PROPN,nsubj,pobj,PRP,NNP,1,1
10213,8757.0,43,SABAH,0,15,36,21,14,6,-15,36,Bashar al-Assad,Syria,-,per,PROPN-PROPN,PROPN,compound-pobj,compound,NNP-NNP,NNP,12,1
10214,8760.0,46,announced,5,11,15,4,10,30,-6,10,Sony,Ken Kutaragi,per,-,PROPN,PROPN-PROPN,compound,compound-nsubj,NNP,NNP-NNP,1,1
10215,8763.0,60,issued,3,24,35,11,23,24,-21,32,Shore Line Railway,1852,--,org,PROPN-PROPN-PROPN,NUM,compound-compound-pobj,pobj,NNP-NNP-NNP,CD,3,1
10216,8764.0,11,is,0,3,6,3,2,4,-3,6,Japanese,Akira Toriyama,,org-org,ADJ,PROPN-PROPN,amod,compound-pobj,JJ,NNP-NNP,2,1
10217,8765.0,26,performed,12,2,21,19,1,4,10,9,Mali,Toumani,org,,PROPN,PROPN,compound,pobj,NNP,NNP,5,1
10218,8766.0,17,is,1,1,7,6,0,9,0,6,He,Scantraxx,,per,PRON,PROPN,nsubj,compound,PRP,NNP,3,1
10219,8768.0,30,is,5,13,25,12,12,4,-8,20,Jimmy Smith,Blue Note,per-per,-,PROPN-PROPN,PROPN-PROPN,compound-pobj,compound-compound,NNP-NNP,NNP-NNP,9,1
10220,8771.0,25,elected,17,8,15,7,7,9,9,-2,Fredrik Reinfeldt,Moderate Party,org-org,-,PROPN-PROPN,PROPN-PROPN,compound-nsubjpass,compound-pobj,NNP-NNP,NNP-NNP,3,1
10221,8772.0,30,studied,1,1,10,9,0,19,0,9,She,California,per,,PRON,PROPN,nsubj,pobj,PRP,NNP,1,1
10222,8773.0,14,is,3,1,9,8,0,4,2,6,Marc Handley Andrus,California,--,org,PROPN-PROPN-PROPN,PROPN,compound-compound-nsubj,pobj,NNP-NNP-NNP,NNP,4,1
10223,8777.0,61,served,2,24,17,-7,23,43,-22,15,Point Park University,Pittsburgh,org-org-org,,PROPN-PROPN-PROPN,PROPN,compound-compound-pobj,compound,NNP-NNP-NNP,NNP,6,1
10224,8778.0,43,told,11,8,25,17,7,17,3,14,Democritus University of Thrace,Greece,---,per,PROPN-PROPN-ADP-PROPN,PROPN,compound-pobj-prep-pobj,nsubj,NNP-NNP-IN-NNP,NNP,5,1
10225,8781.0,25,evolved,13,11,21,10,10,3,2,8,Jack Hardy,Fast Folk,-,per-per,PROPN-PROPN,PROPN-PROPN,compound-pobj,compound-compound,NNP-NNP,NNP-NNP,13,1
10226,8782.0,44,is,10,1,4,3,0,39,9,-6,Mary Alice,Herbert,-,per,PROPN-PROPN,PROPN,compound-compound,nsubj,NNP-NNP,NNP,4,1
10227,8783.0,27,is,2,2,18,16,1,8,0,16,ADFIS,Australian Army,per,-,PROPN,PROPN-PROPN,nsubj,compound-pobj,NNP,NNP-NNP,8,1
10228,8784.0,50,had,21,17,18,1,16,31,4,-3,Quebecor,Osprey Media,per,-,PROPN,PROPN-PROPN,compound,compound-poss,NNP,NNP-NNP,2,1
10229,8787.0,25,is,1,7,12,5,6,12,-6,11,Denmark,Svendborg Gymnasium,,per-per,PROPN,PROPN-PROPN,pobj,compound-pobj,NNP,NNP-NNP,5,1
10230,8788.0,47,rejects,11,2,10,8,1,36,9,-1,Southern African Clothing,SACTWU,org-org-org,,ADJ-PROPN-PROPN,PROPN,amod-compound-compound,appos,JJ-NNP-NNP,NNP,4,1
10231,8789.0,26,served,7,7,15,8,6,10,0,8,he,Huntington Beach,,org-org,PRON,PROPN-PROPN,nsubj,compound-pobj,PRP,NNP-NNP,4,1
10232,8790.0,25,entrusted,8,8,11,3,7,13,0,3,Bolivia,Guido Vildoso,per,-,PROPN,PROPN-PROPN,pobj,compound-dobj,NNP,NNP-NNP,1,1
10233,8791.0,41,was,9,38,39,1,37,1,-29,30,Heritage,James Moore,per,-,PROPN,PROPN-PROPN,compound,compound-pobj,NNP,NNP-NNP,1,1
10234,8792.0,23,was,7,2,16,14,1,6,5,9,1st Iowa Independent Battery Light Artillery,Union,per-per-per-per-per-per,,ADJ-PROPN-PROPN-PROPN-PROPN-PROPN,PROPN,amod-compound-compound-compound-compound-nsubj,compound,JJ-NNP-NNP-NNP-NNP-NNP,NNP,7,1
10235,8793.0,33,served,2,6,9,3,5,23,-4,7,Chilean Navy,Armada de Chile,per-per,--,PROPN-PROPN,PROPN-PROPN-PROPN,compound-pobj,compound-compound-appos,NNP-NNP,NNP-NNP-NNP,2,1
10236,8794.0,35,was,12,18,33,15,17,1,-6,21,James II of England,Anne Hyde,per-per-per-per,-,PROPN-PROPN-ADP-PROPN,PROPN-PROPN,compound-appos-prep-pobj,compound-appos,NNP-NNP-IN-NNP,NNP-NNP,5,1
10237,8795.0,29,include,2,25,28,3,24,0,-23,26,Mark Pryor,Arkansas,org-org,,PROPN-PROPN,PROPN,compound-conj,pobj,NNP-NNP,NNP,8,1
10238,8797.0,42,reported,2,8,24,16,7,17,-6,22,Sprint,Forsee,per,,PROPN,PROPN,poss,dobj,NNP,NNP,8,1
10239,8798.0,42,said,18,11,34,23,10,7,7,16,Premier Liu,National Taiwan University,-,org-org-org,PROPN-PROPN,PROPN-PROPN-PROPN,compound-poss,compound-compound-pobj,NNP-NNP,NNP-NNP-NNP,15,1
10240,8799.0,21,renamed,5,7,10,3,6,10,-2,5,California State University,Humboldt State University,per-per-per,--,PROPN-PROPN-PROPN,PROPN-PROPN-PROPN,compound-compound-compound,compound-compound-oprd,NNP-NNP-NNP,NNP-NNP-NNP,4,1
10241,8800.0,46,is,11,1,21,20,0,24,10,10,Aaron Bertram,Suburban Legends,-,org-org,PROPN-PROPN,PROPN-PROPN,compound-nsubj,compound-pobj,NNP-NNP,NNP-NNP,2,1
10242,8801.0,29,became,10,9,19,10,8,9,1,9,1997,Melbourne Storm,org,-,NUM,PROPN-PROPN,pobj,compound-pobj,CD,NNP-NNP,12,1
10243,8802.0,14,known,1,8,11,3,7,2,-7,10,Emperor Taish?,f Japa,per-per,-,PROPN-NOUN,PROPN-PROPN,compound-pobj,det-subtok,NNP-NN,NNP-NNP,-1,1
10244,8804.0,28,named,5,10,20,10,9,7,-5,15,Aris T. Allen,Maryland,org-org-org,,PROPN-PROPN-PROPN,PROPN,compound-compound-pobj,compound,NNP-NNP-NNP,NNP,6,1
10245,8805.0,40,On,0,23,23,0,22,16,-23,23,Bukidnon State College,Bukidnon State University,per-per-per,--,PROPN-PROPN-PROPN,PROPN-PROPN-PROPN,compound-compound-dobj,compound-compound-pobj,NNP-NNP-NNP,NNP-NNP-NNP,0,1
10246,8806.0,55,been,7,30,53,23,29,1,-23,46,Austria,Franz Vranitzky,per,-,PROPN,PROPN-PROPN,compound,compound-pobj,NNP,NNP-NNP,4,1
10247,8807.0,25,were,3,12,20,8,11,4,-9,17,Vancouver,Neko Case,per,-,PROPN,PROPN-PROPN,pobj,compound-pobj,NNP,NNP-NNP,4,1
10248,8808.0,15,attended,1,3,11,8,2,3,-2,10,Callaway High School,All-Conference,per-per-per,,PROPN-PROPN-PROPN,PROPN,compound-compound-dobj,compound,NNP-NNP-NNP,NNP,6,1
10249,8809.0,23,died,16,6,12,6,5,10,10,-4,Texas,Rangers Division,,per-per,PROPN,PROPN-PROPN,compound,compound-pobj,NNP,NNP-NNP,6,1
10250,8810.0,57,was,30,4,4,0,3,52,26,-26,MediaCorp TV TVMobile,MediaCorp,--,per,PROPN-PROPN-PROPN,PROPN,compound-pobj-compound,compound,NNP-NNP-NNP,NNP,0,1
10251,8811.0,33,agreed,8,3,7,4,2,25,5,-1,Alberta,Ralph Klein,org,-,PROPN,PROPN-PROPN,compound,compound-nsubj,NNP,NNP-NNP,2,1
10252,8812.0,25,was,0,13,20,7,12,4,-13,20,1976,Democratic Party,,per-per,NUM,PROPN-PROPN,nummod,compound-pobj,CD,NNP-NNP,3,1
10253,8814.0,10,saw,1,4,9,5,3,0,-3,8,Junaid,Karachi,org,,PROPN,PROPN,nsubj,pobj,NNP,NNP,3,1
10254,13069.0,33,saw,3,8,11,3,7,21,-5,8,Junaid,Karachi,,per,PROPN,PROPN,conj,pobj,NNP,NNP,4,1
10255,8815.0,38,is,10,7,13,6,6,24,3,3,England,Birmingham Mail,,per-per,PROPN,PROPN-PROPN,poss,compound-attr,NNP,NNP-NNP,7,1
10256,8816.0,25,bought,12,10,24,14,9,0,2,12,Moscow,Yukos,,per,PROPN,PROPN,compound,pobj,NNP,NNP,6,1
10257,8817.0,54,is,14,13,28,15,12,25,1,14,California,Quicksilver,per,,PROPN,PROPN,appos,compound,NNP,NNP,7,1
10258,8818.0,17,stepped,4,2,11,9,1,5,2,7,Nankai University,China,org-org,,PROPN-PROPN,PROPN,compound-nsubj,poss,NNP-NNP,NNP,5,1
10259,8820.0,30,entered,13,2,2,0,1,27,11,-11,Hawaii,Hawaii Army National Guard,per,---,PROPN,PROPN-PROPN-PROPN-PROPN,nsubjpass,compound-compound-compound-pobj,NNP,NNP-NNP-NNP-NNP,0,1
10260,8821.0,37,is,9,1,17,16,0,19,8,8,Peninsula College of Medicine and Dentistry,England,-----,per,PROPN-PROPN-ADP-PROPN-CCONJ-PROPN,PROPN,compound-nsubj-prep-pobj-cc-conj,pobj,NNP-NNP-IN-NNP-CC-NNP,NNP,3,1
10261,8822.0,30,recorded,12,7,10,3,6,19,5,-2,Chapter of Acts,Matthew Ward,per-per-per,-,NOUN-ADP-PROPN,PROPN-PROPN,pobj-prep-compound,compound-pobj,NN-IN-NNP,NNP-NNP,1,1
10262,8823.0,63,NeOn,4,11,16,5,10,46,-7,12,Megabus,United Kingdom,per,-,PROPN,PROPN-PROPN,compound,compound-pobj,NNP,NNP-NNP,3,1
10263,8825.0,29,completed,8,20,23,3,19,5,-12,15,Lady Bird Johnson,Hall,--,per,PROPN-PROPN-PROPN,PROPN,compound-compound-compound,pobj,NNP-NNP-NNP,NNP,2,1
10264,8827.0,30,attended,4,3,7,4,2,22,1,3,Artur Barrio,Escola Nacional de Belas Artes,per-per,----,PROPN-PROPN,PROPN-PROPN-PROPN-PROPN-PROPN,compound-nsubj,compound-compound-compound-compound-dobj,NNP-NNP,NNP-NNP-NNP-NNP-NNPS,4,1
10265,8828.0,24,situated,20,11,18,7,10,5,9,-2,Ingesund College of Music,Karlstad University,org-org-org-org,-,PROPN-PROPN-ADP-PROPN,PROPN-PROPN,compound-pobj-prep-pobj,compound-pobj,NNP-NNP-IN-NNP,NNP-NNP,7,1
10266,8830.0,26,elected,14,1,9,8,0,16,13,-5,R. Venkataraman,India,-,per,PROPN-PROPN,PROPN,compound-nsubjpass,pobj,NNP-NNP,NNP,2,1
10267,8832.0,21,Sr.,2,1,17,16,0,3,1,15,Thomas Gangemi,Jersey City,-,org-org,PROPN-PROPN,PROPN-PROPN,compound-compound,compound-compound,NNP-NNP,NNP-NNP,-1,1
10268,8834.0,37,known,3,19,24,5,18,12,-16,21,Patrick Collins,Elegant Angel,-,org-org,PROPN-PROPN,ADJ-PROPN,compound-pobj,compound-compound,NNP-NNP,JJ-NNP,3,1
10269,12408.0,18,founded,6,3,9,6,2,8,3,3,Patrick Collins,Elegant Angel,org-org,-,PROPN-PROPN,PROPN-PROPN,compound-nsubj,compound-compound,NNP-NNP,NNP-NNP,3,1
10270,8835.0,13,was,1,1,10,9,0,2,0,9,He,University of Aberdeen,org,--,PRON,PROPN-ADP-PROPN,nsubj,pobj-prep-pobj,PRP,NNP-IN-NNP,4,1
10271,8836.0,31,is,1,23,27,4,22,3,-22,26,Universiti Teknologi MARA,Shah Alam,per-per-per,-,PROPN-PROPN-PROPN,PROPN-PROPN,compound-compound-pobj,compound-compound,NNP-NNP-NNP,NNP-NNP,4,1
10272,8838.0,28,promoted,17,3,6,3,2,21,14,-11,President,W?adys?aw Raczkiewi,,org-org,PROPN,VERB-PROPN,nsubj,compound-pobj,NNP,VBP-NNP,5,1
10273,8839.0,20,has,8,2,4,2,1,15,6,-4,University of Brighton,Brighton Polytechnic,--,org-org,PROPN-ADP-PROPN,PROPN-PROPN,nsubj-prep-pobj,compound-nsubj,NNP-IN-NNP,NNP-NNP,3,1
10274,8840.0,33,suggested,10,7,8,1,6,24,3,-2,State,Frederick W. Seward,per,--,PROPN,PROPN-PROPN-PROPN,pobj,compound-compound-appos,NNP,NNP-NNP-NNP,2,1
10275,8843.0,29,Following,0,4,23,19,3,5,-4,23,Romanian,Gloria,,org,ADJ,PROPN,amod,appos,JJ,NNP,6,1
10276,8844.0,36,actors,6,8,13,5,7,22,-2,7,Antonio Banderas,Melanie Griffith,org-org,-,PROPN-PROPN,PROPN-PROPN,compound-appos,compound-compound,NNP-NNPS,NNP-NNP,2,1
10277,8845.0,12,defeated,2,7,11,4,6,0,-5,9,Amir Khadir,solidaire,per-per,,PROPN-PROPN,NOUN,compound-compound,pobj,NNP-NNP,NN,4,1
10278,8846.0,27,is,5,4,13,9,3,13,1,8,Kerry Kelly,New York City Fire Department,per-per,----,PROPN-PROPN,PROPN-PROPN-PROPN-PROPN-PROPN,compound-appos,compound-compound-compound-compound-pobj,NNP-NNP,NNP-NNP-NNP-NNP-NNP,9,1
10279,8847.0,37,led,2,5,6,1,4,30,-3,4,KMT,36th Division,per,-,PROPN,NOUN-PROPN,compound,compound-dobj,NNP,NN-NNP,1,1
10280,8848.0,46,was,19,19,29,10,18,16,0,10,E-Sir,Ogopa DJs,org,-,PROPN,PROPN-VERB,appos,compound-amod,NNP,NNP-VBZ,8,1
10281,8849.0,20,producer,2,5,17,12,4,2,-3,15,Wynonna Judd,Judds,per-per,,PROPN-PROPN,PROPN,compound-pobj,poss,NNP-NNP,NNP,9,1
10282,8851.0,34,|,1,6,9,3,5,24,-5,8,Caspar Weinberger,United States,per-per,-,PROPN-PROPN,PROPN-PROPN,compound-compound,compound-nmod,NNP-NNP,NNP-NNP,4,1
10283,8852.0,10,Chronicle,1,1,4,3,0,5,0,3,Houston Chronicle,Hearst Corporation,-,org-org,PROPN-PROPN,PROPN-PROPN,compound-ROOT,compound-appos,NNP-NNP,NNP-NNP,1,1
10284,8853.0,10,names,5,2,7,5,1,2,3,2,Japan,Fukuda,per,,PROPN,PROPN,poss,appos,NNP,NNP,4,1
10285,10729.0,28,said,20,15,27,12,14,0,5,7,Japan,Fukuda,,org,PROPN,PROPN,compound,pobj,NNP,NNP,4,1
10286,8854.0,34,gives,3,5,13,8,4,20,-2,10,UST,Glassell School,per,-,PROPN,PROPN-PROPN,compound,compound-pobj,NNP,NNP-NNP,5,1
10287,8855.0,27,booked,2,22,25,3,21,1,-20,23,poet,Reinaldo Arenas,per,-,NOUN,PROPN-PROPN,pobj,compound-conj,NNS,NNP-NNP,2,1
10288,8856.0,16,was,1,1,6,5,0,9,0,5,Christie,Canada,,org,PROPN,PROPN,nsubj,pobj,NNP,NNP,3,1
10289,8857.0,24,before,1,17,22,5,16,1,-16,21,Sonic Youth,Thurston Moore,-,per-per,PROPN-PROPN,PROPN-PROPN,compound-compound,compound-conj,NNP-NNP,NNP-NNP,3,1
10290,8858.0,32,recalled,3,20,20,0,19,11,-17,17,Nagasaki,Nagasaki University,,per-per,PROPN,PROPN-PROPN,compound,compound-compound,NNP,NNP-NNP,0,1
10291,8860.0,21,developed,3,9,18,9,8,2,-6,15,UK,Imperial College London,,org-org-org,PROPN,PROPN-PROPN-PROPN,compound,compound-compound-conj,NNP,NNP-NNP-NNP,5,1
10292,8861.0,35,Born,0,25,28,3,24,6,-25,28,Army,Maratha Light Infantry,,org-org-org,PROPN,PROPN-PROPN-PROPN,pobj,compound-compound-pobj,NNP,NNP-NNP-NNP,2,1
10293,8864.0,25,represented,10,4,20,16,3,4,6,10,Wake Forest University,Division I,--,per-per,PROPN-PROPN-PROPN,PROPN-PRON,compound-compound-dobj,pobj-nsubj,NNP-NNP-NNP,NNP-PRP,5,1
10294,9636.0,23,represented,9,3,18,15,2,4,6,9,Wake Forest University,Division I,--,per-per,PROPN-PROPN-PROPN,PROPN-PRON,compound-compound-dobj,pobj-nsubj,NNP-NNP-NNP,NNP-PRP,5,1
10295,8865.0,20,failed,5,2,10,8,1,9,3,5,Randell,Australia,per,,PROPN,PROPN,poss,pobj,NNP,NNP,5,1
10296,8867.0,39,Switzerland,4,5,18,13,4,20,-1,14,Switzerland,Longines,,org,PROPN,PROPN,ROOT,compound,NNP,NNP,6,1
10297,8868.0,51,coordinating,2,12,19,7,11,31,-10,17,Ahmed Nazif,Egypt,-,org,PROPN-PROPN,PROPN,compound-pobj,pobj,NNP-NNP,NNP,4,1
10298,8869.0,52,On,0,17,24,7,16,27,-17,24,Black Watch,Army,org-org,,PROPN-PROPN,PROPN,compound-pobj,ROOT,NNP-NNP,NNP,-1,1
10299,8870.0,22,was,1,11,14,3,10,7,-10,13,its,Germany,,per,DET,PROPN,poss,pobj,PRP$,NNP,5,1
10300,8874.0,17,returned,1,1,4,3,0,12,0,3,Palmer,Germany,org,,PROPN,PROPN,nsubj,pobj,NNP,NNP,1,1
10301,8875.0,16,born,3,1,11,10,0,4,2,8,James Callaghan,England,-,per,PROPN-PROPN,PROPN,compound-nsubjpass,pobj,NNP-NNP,NNP,2,1
10302,8876.0,17,is,10,1,9,8,0,7,9,-1,Wendy Guerra,Cuba,-,per,PROPN-PROPN,PROPN,compound-nsubj,pobj,NNP-NNP,NNP,1,1
10303,8878.0,29,was,11,10,18,8,9,10,1,7,George Rallis,Greece,per-per,,PROPN-PROPN,PROPN,compound-pobj,pobj,NNP-NNP,NNP,5,1
10304,8879.0,26,history,1,11,19,8,10,6,-10,18,Greifswald,University of Greifswald,,org-org-org,PROPN,PROPN-ADP-PROPN,compound,pobj-prep-pobj,NNP,NNP-IN-NNP,8,1
10305,8880.0,17,Minister,1,4,9,5,3,7,-3,8,Mark Rutte,Party,per-per,,PROPN-PROPN,PROPN,compound-appos,appos,NNP-NNP,NNP,1,1
10306,8881.0,19,born,2,7,13,6,6,5,-5,11,California,Lynwood High School,per,--,PROPN,PROPN-PROPN-PROPN,pobj,compound-compound-pobj,NNP,NNP-NNP-NNP,5,1
10307,8882.0,13,arrest,2,1,11,10,0,1,1,9,Bangladesh,Khaleda Zia,per,-,PROPN,PROPN-PROPN,compound,compound-pobj,NNP,NNP-NNP,4,1
10308,8883.0,37,became,23,23,30,7,22,6,0,7,Owls,NCAA,per,,PROPN,PROPN,nsubj,compound,NNP,NNP,5,1
10309,10462.0,13,competed,2,2,6,4,1,6,0,4,Owls,NCAA,,org,PROPN,PROPN,nsubj,poss,NNP,NNP,4,1
10310,8884.0,39,is,8,21,27,6,20,11,-13,19,Division I,Cornell Big Red,per-per,--,PROPN-NUM,PROPN-PROPN-PROPN,compound-compound,compound-compound-compound,NNP-CD,NNP-NNP-NNP,5,1
10311,8886.0,21,placed,18,1,10,9,0,10,17,-8,Ricki-Lee Coulter,New Zealand,-,per-per,PROPN-PROPN,PROPN-PROPN,compound-nsubjpass,compound-pobj,NNP-NNP,NNP-NNP,5,1
10312,8887.0,56,born,4,40,40,0,39,15,-36,36,Sara Sothern,Sara Viola Warmbrodt,per-per,--,PROPN-PROPN,PROPN-PROPN-PROPN,compound-conj,compound-compound-appos,NNP-NNP,NNP-NNP-NNP,0,1
10313,8888.0,26,formed,5,4,23,19,3,2,1,18,Sprint Nextel,Common Cents Mobile,org-org,--,PROPN-PROPN,PROPN-PROPN-PROPN,compound-nsubj,compound-compound-conj,NNP-NNP,NNP-NNPS-NNP,8,1
10314,8889.0,15,accredited,3,1,7,6,0,7,2,4,Emerson College,New England Association of Schools and Colleges,per-per,------,PROPN-PROPN,PROPN-PROPN-PROPN-ADP-PROPN-CCONJ-PROPN,compound-nsubjpass,compound-compound-pobj-prep-pobj-cc-compound,NNP-NNP,NNP-NNP-NNP-IN-NNPS-CC-NNP,4,1
10315,8890.0,29,provides,7,6,15,9,5,13,1,8,United Kingdom,British Armed Forces,-,per-per-per,PROPN-PROPN,ADJ-PROPN-PROPN,compound-pobj,amod-compound-compound,NNP-NNP,JJ-NNP-NNPS,10,1
10316,8891.0,24,waived,5,5,13,8,4,10,0,8,she,California,org,,PRON,PROPN,nsubj,pobj,PRP,NNP,3,1
10317,8892.0,50,taught,1,32,38,6,31,11,-31,37,Everett Shinn,Ashcan School,-,per-per,PROPN-PROPN,PROPN-PROPN,compound-conj,compound-pobj,NNP-NNP,NNP-NNP,7,1
10318,8893.0,11,Album,1,7,9,2,6,1,-6,8,Don Henley,Warner Bros,per-per,-,PROPN-PROPN,PROPN-PROPN,compound-compound,compound-ROOT,NNP-NNP,NNP-NNP,1,1
10319,8894.0,24,elected,2,9,21,12,8,2,-7,19,Penang,Koh Tsu Koon,org,--,PROPN,PROPN-PROPN-PROPN,compound,compound-compound-dobj,NNP,NNP-NNP-NNP,9,1
10320,8895.0,71,said,32,1,13,12,0,57,31,-19,Ahmad Shah Ahmadzai,Afghanistan,org-org-org,,PROPN-PROPN-PROPN,PROPN,compound-compound-nsubj,pobj,NNP-NNP-NNP,NNP,8,1
10321,8897.0,27,named,3,6,11,5,5,15,-3,8,Herbert Greenfield,Alberta,-,org,PROPN-PROPN,PROPN,compound-pobj,pobj,NNP-NNP,NNP,3,1
10322,8900.0,26,was,18,1,13,12,0,12,17,-5,David Stout Manners,Jersey City,per-per-per,-,PROPN-PROPN-PROPN,PROPN-PROPN,compound-compound-nsubj,compound-pobj,NNP-NNP-NNPS,NNP-NNP,5,1
10323,8902.0,23,suggested,6,1,3,2,0,19,5,-3,Victoria Police,Chief Commissioner,-,org-org,PROPN-PROPN,PROPN-PROPN,compound-compound,compound-compound,NNP-NNP,NNP-NNP,1,1
10324,11579.0,20,said,6,1,3,2,0,16,5,-3,Victoria Police,Chief Commissioner,-,per-per,PROPN-PROPN,PROPN-PROPN,compound-compound,compound-compound,NNP-NNP,NNP-NNP,2,1
10325,8904.0,49,found,3,31,38,7,30,10,-28,35,Third Eye Blind,Elektra,--,org,PROPN-PROPN-PROPN,PROPN,compound-compound-pobj,compound,NNP-NNP-NNP,NNP,5,1
10326,8905.0,36,rescinded,25,19,22,3,18,13,6,-3,American Express,Kenneth Chenault,-,per-per,PROPN-PROPN,PROPN-PROPN,compound-compound,compound-compound,NNP-NNP,NNP-NNP,3,1
10327,8906.0,29,left,3,9,24,15,8,4,-6,21,England,Miranda Richardson,,org-org,PROPN,PROPN-PROPN,pobj,compound-pobj,NNP,NNP-NNP,7,1
10328,8908.0,22,give,6,5,9,4,4,12,1,3,Ryan Hall,US,per-per,,PROPN-PROPN,PROPN,compound-conj,dative,NNP-NNP,NNP,4,1
10329,8909.0,23,n,1,1,17,16,0,5,0,16,Ro?ma,4; Austr,,per-per,NOUN,PROPN-PROPN,subtok,compound-nsubj,NN,NNP-NNP,4,1
10330,8910.0,22,headquartered,2,1,19,18,0,2,1,17,It,Texas,,org,PRON,PROPN,nsubjpass,compound,PRP,NNP,8,1
10331,8912.0,17,served,1,1,8,7,0,8,0,7,He,Netherlands,,org,PRON,PROPN,nsubj,pobj,PRP,NNP,1,1
10332,11228.0,17,served,1,1,8,7,0,8,0,7,He,Netherlands,,org,PRON,PROPN,nsubj,pobj,PRP,NNP,1,1
10333,8913.0,36,Flynn,1,1,24,23,0,11,0,23,Pat Flynn,guitarist,org-org,,PROPN-PROPN,NOUN,compound-ROOT,pobj,NNP-NNP,NN,-1,1
10334,8914.0,24,became,2,1,6,5,0,17,1,4,Richard Garriott,American,-,per,PROPN-PROPN,ADJ,compound-nsubj,attr,NNP-NNP,JJ,4,1
10335,8915.0,27,was,1,18,23,5,17,3,-17,22,Enver Hoxha,Albania,-,per,PROPN-PROPN,PROPN,compound-pobj,poss,NNP-NNP,NNP,9,1
10336,8916.0,28,seen,16,5,13,8,4,14,11,-3,Ethiopian Airlines,Addis Ababa,-,org-org,PROPN-PROPN,PROPN-PROPN,compound-compound,compound-pobj,NNP-NNPS,NNP-NNP,4,1
10337,8917.0,34,was,3,13,32,19,12,1,-10,29,Albania,Enver Hoxha,per,-,PROPN,PROPN-PROPN,pobj,compound-pobj,NNP,NNP-NNP,7,1
10338,8919.0,23,left,2,2,19,17,1,3,0,17,he,Liberia,,org,PRON,PROPN,nsubj,pobj,PRP,NNP,8,1
10339,8920.0,45,entered,3,14,15,1,13,29,-11,12,Rod Jones,Jones,per-per,,PROPN-PROPN,PROPN,compound-nsubj,nsubj,NNP-NNP,NNP,2,1
10340,8921.0,44,Proclamation,1,10,20,10,9,23,-9,19,Vietnam,written by H? Ch,,org-org-org-org,PROPN,VERB-ADP-NOUN-PROPN,pobj,ROOT-agent-compound-compound,NNP,VBN-IN-NN-NNP,-1,1
10341,8923.0,18,was,1,1,16,15,0,1,0,15,Anderson,Baltimore,,per,PROPN,PROPN,nsubj,compound,NNP,NNP,7,1
10342,9166.0,10,attended,1,1,6,5,0,3,0,5,Anderson,Baltimore,org,,PROPN,PROPN,nsubj,pobj,NNP,NNP,4,1
10343,8924.0,27,founded,6,16,18,2,15,8,-10,12,United States,Eve,-,per,PROPN-PROPN,PROPN,compound-compound,poss,NNP-NNP,NNP,2,1
10344,8925.0,15,took,1,1,5,4,0,9,0,4,Amtrak,Crescent,,per,PROPN,PROPN,nsubj,dobj,NNP,NNP,2,1
10345,8926.0,29,approved,3,2,27,25,1,1,1,24,judge,New York,per,-,NOUN,PROPN-PROPN,nsubj,compound-pobj,NN,NNP-NNP,8,1
10346,8927.0,33,launched,25,8,11,3,7,21,17,-14,Yukos,Mikhail Khodorkovsky,per,-,PROPN,PROPN-PROPN,compound,compound-nsubjpass,NNP,NNP-NNP,2,1
10347,13483.0,33,became,6,6,29,23,5,3,0,23,Yukos,Mikhail Khodorkovsky,org,-,PROPN,PROPN-PROPN,nsubj,compound-appos,NNP,NNP-NNP,8,1
10348,8928.0,62,After,0,7,17,10,6,44,-7,17,44; ?ivk,er of S,per-per,--,PUNCT-PUNCT,INTJ-ADP-PROPN,ROOT-ROOT,intj-prep-compound,LS-.,UH-IN-NNP,6,1
10349,8929.0,22,was,6,1,21,20,0,0,5,15,Straight University,Louisiana,-,org,PROPN-PROPN,PROPN,compound-nsubj,pobj,NNP-NNP,NNP,2,1
10350,8930.0,20,includes,1,3,19,16,2,0,-2,18,Dana Hills High School,1972,per-per-per-per,,PROPN-PROPN-PROPN-PROPN,NUM,compound-compound-compound-dobj,pobj,NNP-NNP-NNP-NNP,CD,3,1
10351,8931.0,23,is,2,1,21,20,0,1,1,19,Air Canada,Star Alliance,-,org-org,PROPN-PROPN,PROPN-PROPN,compound-nsubj,compound-pobj,NNP-NNP,NNP-NNP,6,1
10352,8933.0,70,stated,42,33,35,2,32,34,9,-7,CESIS,Executive Committee for Intelligence,,org-org-org-org,PROPN,PROPN-PROPN-ADP-PROPN,pobj,compound-appos-prep-nmod,NNP,NNP-NNP-IN-NNP,3,1
10353,8934.0,38,formed,4,1,1,0,0,36,3,-3,Hawker Siddeley,Hawker Aircraft,-,per-per,PROPN-PROPN,PROPN-PROPN,compound-compound,compound-pobj,NNP-NNP,NNP-NNP,0,1
10354,8935.0,74,formed,8,6,23,17,5,50,2,15,Morihiro Hosokawa,Japan,-,org,PROPN-PROPN,PROPN,compound-pobj,compound,NNP-NNP,NNP,10,1
10355,8936.0,29,issued,9,6,13,7,5,15,3,4,New Zealand,Reserve Bank of New Zealand,org-org,----,PROPN-PROPN,PROPN-PROPN-ADP-PROPN-PROPN,compound-compound,compound-pobj-prep-compound-pobj,NNP-NNP,NNP-NNP-IN-NNP-NNP,7,1
10356,8937.0,33,advocated,11,6,10,4,5,22,5,-1,Saint Lucia,Stephenson King,per-per,-,PROPN-PROPN,PROPN-PROPN,compound-compound,compound-conj,NNP-NNP,NNP-NNP,2,1
10357,8938.0,20,monitors,7,7,12,5,6,7,0,5,Lebanon,forces,per,,PROPN,NOUN,pobj,pobj,NNP,NNS,1,1
10358,8939.0,20,is,1,10,16,6,9,3,-9,15,Paul Potts,Britain,per-per,,PROPN-PROPN,PROPN,compound-appos,poss,NNP-NNP,NNP,9,1
10359,8940.0,20,born,2,7,14,7,6,5,-5,12,England,Anthony Minghella,org,-,PROPN,PROPN-PROPN,pobj,compound-pobj,NNP,NNP-NNP,3,1
10360,8942.0,19,released,4,2,13,11,1,5,2,9,his,Norway,,org,DET,PROPN,poss,pobj,PRP$,NNP,3,1
10361,8943.0,32,said,18,25,31,6,24,0,-7,13,American Electric Power,Ohio,per-per-per,,PROPN-PROPN-PROPN,PROPN,compound-compound-pobj,pobj,NNP-NNP-NNP,NNP,6,1
10362,8944.0,30,was,11,2,14,12,1,15,9,3,William McCune,American,per-per,,PROPN-PROPN,ADJ,compound-nsubj,amod,NNP-NNP,JJ,4,1
10363,8945.0,34,are,12,18,23,5,17,10,-6,11,Solidarity,Tommy Sheridan,per,-,PROPN,PROPN-PROPN,compound,compound-pobj,NNP,NNP-NNP,6,1
10364,8946.0,62,Hume,0,1,12,11,0,49,-1,12,Hume Cronyn,Canada,-,per,PROPN-PROPN,PROPN,ROOT-dative,pobj,NNP-NNP,NNP,6,1
10365,8948.0,22,is,12,1,15,14,0,6,11,3,Broderick Smith,Australian,per-per,,PROPN-PROPN,ADJ,compound-nsubj,amod,NNP-NNP,JJ,4,1
10366,8951.0,26,returned,1,5,12,7,4,13,-4,11,Philippines,Cheska Garcia,,per-per,PROPN,PROPN-PROPN,pobj,compound-appos,NNPS,NNP-NNP,4,1
10367,8952.0,23,lived,6,1,15,14,0,7,5,9,He,Guyana,per,,PRON,PROPN,nsubjpass,pobj,PRP,NNP,3,1
10368,8953.0,32,On,0,18,21,3,17,10,-18,21,Pascal Couchepin,Switzerland,per-per,,PROPN-PROPN,PROPN,compound-pobj,pobj,NNP-NNP,NNP,3,1
10369,8954.0,27,recognised,4,8,6,-2,7,20,-4,2,King,James III,org,-,PROPN,PROPN-PROPN,pobj,compound-pobj,NNP,NNP-NNP,2,1
10370,8955.0,18,declared,11,5,10,5,4,7,6,-1,Lithuania,Vytautas Landsbergis,per,-,PROPN,PROPN-PROPN,nsubj,compound-pobj,NNP,NNP-NNP,2,1
10371,13806.0,27,founded,2,16,19,3,15,7,-14,17,Lithuania,Vytautas Landsbergis,per,-,PROPN,PROPN-PROPN,pobj,compound-pobj,NNP,NNP-NNP,2,1
10372,8956.0,27,sent,1,1,4,3,0,22,0,3,Italy,Canadair,per,,PROPN,PROPN,nsubj,compound,NNP,NNP,2,1
10373,8957.0,25,is,3,2,19,17,1,5,1,16,Botswana,Seretse Khama,org,-,PROPN,PROPN-PROPN,compound,compound-compound,NNP,NNP-NNP,9,1
10374,8958.0,46,opened,19,5,18,13,4,27,14,-1,Japan,Takao Doi,,per-per,PROPN,PROPN-PROPN,nmod,compound-conj,NNP,NNP-NNP,6,1
10375,8959.0,59,held,3,28,33,5,27,25,-25,30,Satoshi Kojima,Japan,-,per,PROPN-PROPN,PROPN,compound-conj,attr,NNP-NNP,NNP,5,1
10376,8960.0,34,rose,7,1,17,16,0,16,6,10,China,Huadian Power International,per,--,PROPN,PROPN-PROPN-PROPN,nsubj,compound-compound-compound,NNP,NNP-NNP-NNP,4,1
10377,8962.0,27,waved,6,2,6,4,1,20,4,0,John Barrasso,Wyoming,per-per,,PROPN-PROPN,PROPN,compound-compound,pobj,NNP-NNP,NNP,2,1
10378,13119.0,48,directed,4,20,30,10,19,17,-16,26,John Barrasso,Wyoming,-,per,PROPN-PROPN,PROPN,compound-compound,compound,NNP-NNP,NNP,11,1
10379,8963.0,39,unnerved,8,20,20,0,19,18,-12,12,Colorado State University,Colorado,per-per-per,,PROPN-PROPN-PROPN,PROPN,compound-compound-pobj,pobj,NNP-NNP-NNP,NNP,0,1
10380,8964.0,16,is,10,1,9,8,0,6,9,-1,Christophe,Vaucluse,per,,PROPN,PROPN,nsubj,pobj,NNP,NNP,3,1
10381,8965.0,29,are,9,1,19,18,0,9,8,10,The Oaks,Florida,per-per,,DET-PROPN,PROPN,det-nsubj,pobj,DT-NNPS,NNP,7,1
10382,8967.0,27,scrapped,5,17,8,-9,16,18,-12,3,Mesa Airlines,America West Express,per-per,--,PROPN-PROPN,PROPN-PROPN-PROPN,compound-pobj,compound-compound-pobj,NNP-NNP,NNP-NNP-NNP,4,1
10383,8968.0,34,is,10,1,19,18,0,14,9,9,Tallinn University,2005,org-org,,PROPN-PROPN,NUM,compound-compound,pobj,NNP-NNP,CD,6,1
10384,8969.0,46,were,38,6,24,18,5,21,32,-14,Sri Lanka,Ranil Wickremasinghe,per-per,-,PROPN-PROPN,PROPN-PROPN,compound-compound,compound-conj,NNP-NNP,NNP-NNP,3,1
10385,8971.0,40,said,38,1,3,2,0,36,37,-35,Than Shwe,Chairman,-,per,ADP-PROPN,PROPN,compound-compound,nsubj,IN-NNP,NNP,2,1
10386,8973.0,30,sold,5,13,24,11,12,5,-8,19,Wella,Procter Gamble,per,-,PROPN,PROPN-PROPN,compound,compound-pobj,NNP,NNP-NNP,4,1
10387,8974.0,7,makes,1,3,5,2,2,1,-2,4,John,Abigail,,per,PROPN,PROPN,nsubj,conj,NNP,NNP,2,1
10388,8975.0,22,is,1,14,18,4,13,3,-13,17,Ukraine,Malyshev Factory,,per-per,PROPN,PROPN-PROPN,pobj,compound-pobj,NNP,NNP-NNP,5,1
10389,8976.0,20,replaced,2,8,11,3,7,8,-6,9,MTV,Viacom,per,,PROPN,PROPN,compound,nsubj,NNP,NNP,4,1
10390,8977.0,10,is,3,1,9,8,0,0,2,6,China Petrochemical Corporation,Sinopec,--,org,PROPN-PROPN-PROPN,PROPN,compound-compound-nsubj,pobj,NNP-NNP-NNP,NNP,3,1
10391,12142.0,46,said,1,34,45,11,33,0,-33,44,China Petrochemical Corporation,Sinopec,org-org-org,,PROPN-PROPN-PROPN,PROPN,compound-compound-appos,pobj,NNP-NNP-NNP,NNP,4,1
10392,8978.0,14,born,2,1,5,4,0,8,1,3,Camacho,Puerto Rico,org,-,PROPN,PROPN-PROPN,nsubjpass,compound-pobj,NNP,NNP-NNP,3,1
10393,13374.0,35,killed,30,5,22,17,4,12,25,-8,Camacho,Puerto Rico,,org-org,PROPN,PROPN-PROPN,nsubjpass,compound-pobj,NNP,NNP-NNP,7,1
10394,8979.0,11,was,1,1,6,5,0,4,0,5,Doxaras,painter,per,,PROPN,NOUN,nsubj,attr,NNP,NN,3,1
10395,8980.0,22,is,7,11,21,10,10,0,-4,14,Mass Rapid Transit,Singapore,org-org-org,,PROPN-PROPN-PROPN,PROPN,compound-compound-compound,pobj,NNP-NNP-NNP,NNP,4,1
10396,8981.0,28,1946,0,4,16,12,3,11,-4,16,Evangelical,United Brethren Church,per,--,PROPN,PROPN-PROPN-PROPN,amod,compound-compound-dobj,NNP,NNP-NNP-NNP,4,1
10397,8982.0,13,spent,1,6,11,5,5,1,-5,10,North Central Texas College,Gainesville,org-org-org-org,,PROPN-PROPN-PROPN-PROPN,PROPN,compound-compound-compound-pobj,compound,NNP-NNP-NNP-NNP,NNP,4,1
10398,8983.0,45,assembled,3,9,19,10,8,25,-6,16,Whitesnake,Adrian Vandenberg,org,-,PROPN,PROPN-PROPN,pobj,compound-pobj,NNP,NNP-NNP,7,1
10399,8984.0,21,been,7,5,18,13,4,2,2,11,Renu Khator,University of Houston,-,org-org-org,PROPN-PROPN,PROPN-ADP-PROPN,compound-nsubj,pobj-prep-pobj,NNP-NNP,NNP-IN-NNP,6,1
10400,8985.0,24,is,8,2,15,13,1,8,6,7,Hamilton Street Railway,City of Hamilton,--,per-per-per,PROPN-PROPN-PROPN,PROPN-ADP-PROPN,compound-compound-compound,nmod-prep-pobj,NNP-NNP-NNP,NNP-IN-NNP,6,1
10401,8987.0,44,said,39,35,39,4,34,4,4,0,Piper Jaffray,Minneapolis,-,org,PROPN-PROPN,PROPN,compound-compound,pobj,NNP-NNP,NNP,-1,1
10402,8988.0,42,is,3,2,35,33,1,6,1,32,Gallegos,Venezuela,per,,PROPN,PROPN,compound,pobj,NNP,NNP,4,1
10403,8989.0,40,put,3,12,23,11,11,16,-9,20,Paro,airline,,org,PROPN,NOUN,compound,conj,NNP,NN,5,1
10404,8991.0,40,have,23,2,5,3,1,34,21,-18,Dillon Freasier,Fort Davis,-,org-org,PROPN-PROPN,PROPN-PROPN,compound-dep,compound-compound,NNP-NNP,NNP-NNP,4,1
10405,8992.0,29,grew,2,1,15,14,0,13,1,13,Calvin Coolidge,Northampton,per-per,,PROPN-PROPN,PROPN,compound-nsubj,compound,NNP-NNP,NNP,5,1
10406,8994.0,56,is,12,1,1,0,0,54,11,-11,Vodafone Omnitel NV,Vodafone Italia,per-per-per,-,PROPN-PROPN-PROPN,PROPN-PROPN,compound-compound-nsubj,compound-dobj,NNP-NNP-NNP,NNP-NNP,0,1
10407,8995.0,18,do,13,2,15,13,1,2,11,2,he,Rio de Janeiro,per,--,PRON,PROPN-PROPN-PROPN,nsubj,compound-compound-dobj,PRP,NNP-NNP-NNP,3,1
10408,8996.0,18,Seger,1,1,3,2,0,14,0,2,Bob Seger,The Silver Bullet Band,org-org,---,PROPN-PROPN,DET-PROPN-PROPN-PROPN,compound-ROOT,det-compound-compound-nsubj,NNP-NNP,DT-NNP-NNP-NNP,3,1
10409,8997.0,23,allowed,9,7,14,7,6,8,2,5,Mabini,Philippines,per,,PROPN,PROPN,conj,pobj,NNP,NNPS,2,1
10410,10263.0,31,pressured,7,6,27,21,5,3,1,20,Mabini,Philippines,,per,PROPN,PROPN,nsubjpass,pobj,NNP,NNP,9,1
10411,8999.0,22,developed,2,14,21,7,13,0,-12,19,Maruti Suzuki,India,per-per,,PROPN-PROPN,PROPN,compound-poss,pobj,NNP-NNP,NNP,5,1
10412,9000.0,26,represented,14,3,17,14,2,8,11,3,Tennessee,University of Tennessee,,per-per-per,PROPN,PROPN-ADP-PROPN,compound,dobj-prep-pobj,NNP,NNP-IN-NNP,4,1
10413,9001.0,30,consists,12,11,24,13,10,5,1,12,NHL,United States,per,-,PROPN,PROPN-PROPN,nsubj,compound-pobj,NNP,NNP-NNP,4,1
10414,9002.0,23,represented,9,4,12,8,3,10,5,3,San Francisco,University of San Francisco,-,per-per-per-per,PROPN-PROPN,PROPN-ADP-PROPN-PROPN,compound-compound,dobj-prep-compound-pobj,NNP-NNP,NNP-IN-NNP-NNP,5,1
10415,9006.0,21,was,3,15,20,5,14,0,-12,17,Jean-Luc Ponty,violinist,per-per,,PROPN-PROPN,NOUN,compound-pobj,appos,NNP-NNP,NN,8,1
10416,9007.0,28,was,10,1,22,21,0,5,9,12,Girija Prasad Koirala,Nepali Congress,per-per-per,-,PROPN-PROPN-PROPN,PROPN-PROPN,compound-compound-nsubj,compound-pobj,NNP-NNP-NNP,NNP-NNP,6,1
10417,9008.0,28,viewed,12,6,22,16,5,5,6,10,United States,Piet Mondrian,-,per-per,PROPN-PROPN,PROPN-PROPN,compound-pobj,compound-pobj,NNP-NNP,NNP-NNP,6,1
10418,9009.0,23,decided,6,5,11,6,4,11,1,5,TUT,Tallinn,,per,PROPN,PROPN,compound,compound,NNP,NNP,5,1
10419,9010.0,22,nominated,13,8,10,2,7,11,5,-3,United States,George H. W. Bush,-,org-org-org-org,PROPN-PROPN,PROPN-PROPN-PROPN-PROPN,compound-pobj,compound-compound-compound-nsubj,NNP-NNP,NNP-NNP-NNP-NNP,2,1
10420,9011.0,32,showed,3,11,17,6,10,14,-8,14,Juan Antonio,Chile,-,org,PROPN-PROPN,PROPN,compound-dobj,pobj,NNP-NNP,NNP,2,1
10421,9012.0,33,was,1,25,31,6,24,1,-24,30,Pakistani,Saeed Anwar,,per-per,PROPN,PROPN-PROPN,attr,compound-pobj,NNP,NNP-NNP,3,1
10422,9013.0,35,moved,6,9,23,14,8,11,-3,17,Quito,Central University of Ecuador,per,---,PROPN,PROPN-PROPN-ADP-PROPN,pobj,compound-conj-prep-pobj,NNP,NNP-NNP-IN-NNP,3,1
10423,9014.0,34,1.5-billion-pound,1,16,25,9,15,8,-15,24,DP World,Dubai World,-,per-per,PROPN-PROPN,PROPN-PROPN,compound-nmod,compound-pobj,NNP-NNP,NNP-NNP,-1,1
10424,9015.0,60,.,0,17,26,9,16,33,-17,26,Alyson Hannigan,Alexis Denisof,-,org-org,PROPN-PROPN,PROPN-PROPN,compound-ROOT,compound-appos,NNP-NNP,NNP-NNP,-1,1
10425,9017.0,105,is,3,2,31,29,1,73,1,28,Memphis,First Assembly Christian School,per,---,PROPN,PROPN-PROPN-PROPN-PROPN,compound,compound-compound-compound-ROOT,NNP,NNP-NNP-NNP-NNP,-1,1
10426,9018.0,12,came,1,1,4,3,0,7,0,3,Russell,Montana,org,,PROPN,PROPN,nsubj,pobj,NNP,NNP,1,1
10427,9019.0,17,was,10,1,15,14,0,1,9,5,Alfred Speakman,Alberta,per-per,,PROPN-PROPN,PROPN,compound-nsubj,compound,NNP-NNP,NNP,4,1
10428,9020.0,26,operates,3,1,3,2,0,22,2,0,National Express Coventry,Coventry,per-per-per,,PROPN-PROPN-PROPN,PROPN,compound-compound-nsubj,pobj,NNP-NNP-NNP,NNP,2,1
10429,9021.0,28,said,11,1,11,10,0,16,10,0,Joe Comuzzi,Ontario,-,org,PROPN-PROPN,PROPN,compound-nsubj,pobj,NNP-NNP,NNP,1,1
10430,9022.0,23,Eisenhower,9,14,22,8,13,0,-5,13,Charles Erwin Wilson,Defense,--,org,PROPN-PROPN-PROPN,PROPN,compound-compound-oprd,pobj,NNP-NNP-NNP,NNP,5,1
10431,12803.0,37,authorized,6,19,27,8,18,9,-13,21,Charles Erwin Wilson,Defense,--,per,PROPN-PROPN-PROPN,PROPN,compound-compound-compound,compound,NNP-NNP-NNP,NNP,3,1
10432,13315.0,46,thumb,0,6,27,21,5,18,-6,27,Charles Erwin Wilson,Defense,--,per,PROPN-PROPN-PROPN,PROPN,compound-compound-pobj,pobj,NNP-NNP-NNP,NNP,9,1
10433,9023.0,48,members,1,8,23,15,7,24,-7,22,Bee Gees,Andy Gibb,org-org,-,PROPN-PROPN,PROPN-PROPN,compound-appos,compound-conj,NNP-NNPS,NNP-NNP,7,1
10434,9024.0,24,has,1,14,19,5,13,4,-13,18,Federal Aviation Administration,United States Department of Transportation,--,per-per-per-per-per,PROPN-PROPN-PROPN,PROPN-PROPN-PROPN-ADP-PROPN,compound-compound-pobj,compound-compound-pobj-prep-pobj,NNP-NNP-NNP,NNP-NNP-NNP-IN-NNP,4,1
10435,9025.0,24,moved,5,9,20,11,8,3,-4,15,USA,The Cars,,per-per,PROPN,DET-PROPN,compound,det-pobj,NNP,DT-NNPS,7,1
10436,9026.0,24,was,19,1,10,9,0,13,18,-9,Victor Wong,California,per-per,,PROPN-PROPN,PROPN,compound-nsubj,compound,NNP-NNP,NNP,3,1
10437,9027.0,20,joined,1,8,16,8,7,3,-7,15,e University of Vienn,r Ludwig Boltzman,per-per-per-per,--,PROPN-PROPN-ADP-PROPN,PROPN-PROPN-PROPN,compound-dobj-prep-pobj,npadvmod-compound-oprd,NNP-NNP-IN-NNP,NNP-NNP-NNP,7,1
10438,9028.0,23,is,4,1,18,17,0,4,3,14,Adam and Company,Royal Bank of Scotland Group,--,org-org-org-org-org,PROPN-CCONJ-PROPN,PROPN-PROPN-ADP-PROPN-PROPN,nsubj-cc-compound,compound-pobj-prep-compound-pobj,NNP-CC-NNP,NNP-NNP-IN-NNP-NNP,9,1
10439,9029.0,51,site,2,19,37,18,18,13,-17,35,Hokusai,Japanese,per,,PROPN,ADJ,poss,amod,NNP,JJ,-1,1
10440,9031.0,49,kept,3,34,48,14,33,0,-31,45,Tenix,1997,,org,PROPN,NUM,compound,nummod,NNP,CD,2,1
10441,9032.0,24,scouted,3,6,15,9,5,8,-3,12,Park Jin-young,JYP Entertainment,org-org,-,PROPN-PROPN,PROPN-PROPN,compound-pobj,compound-pobj,NNP-NNP,NNP-NNP,4,1
10442,9033.0,50,are,4,16,16,0,15,33,-12,12,Johnson County Transit,Johnson County,per-per-per,-,PROPN-PROPN-PROPN,PROPN-PROPN,compound-compound-pobj,compound-pobj,NNP-NNP-NNP,NNP-NNP,0,1
10443,9034.0,17,acquired,4,4,4,0,3,12,0,0,Ubisoft,Ubisoft Montreal,per,-,PROPN,PROPN-PROPN,nsubj,compound-pobj,NNP,NNP-NNP,0,1
10444,9035.0,89,formed,12,16,78,62,15,10,-4,66,Reservists,Royal Victoria Regiment,org,--,PROPN,PROPN-PROPN-PROPN,pobj,compound-compound-pobj,NNPS,NNP-NNP-NNP,-1,1
10445,9036.0,23,enlisted,1,1,22,21,0,0,0,21,Beauregarde,Portland,,org,NOUN,PROPN,nsubj,pobj,NNS,NNP,9,1
10446,9037.0,31,elected,10,8,5,-3,7,25,2,-5,Key Club,Pennsylvania,org-org,,PROPN-PROPN,PROPN,compound-compound,compound,NNP-NNP,NNP,3,1
10447,9038.0,32,booked,12,7,22,15,6,9,5,10,United Arab Emirates,FIFA U-17 World Cup,--,per-per-per-per,PROPN-PROPN-PROPN,PROPN-PROPN-PROPN-PROPN,compound-compound-conj,nmod-compound-compound-nmod,NNP-NNP-NNPS,NNP-NNP-NNP-NNP,7,1
10448,9040.0,35,reported,33,14,31,17,13,3,19,-2,Marcia Valentine,Jesse James,org-org,-,PROPN-PROPN,PROPN-PROPN,compound-nsubjpass,compound-compound,NNP-NNP,NNP-NNP,8,1
10449,9041.0,28,featured,3,7,26,19,6,1,-4,23,Revelation Records,Gorilla Biscuits,per-per,-,PROPN-PROPN,PROPN-PROPN,compound-compound,compound-pobj,NNP-NNPS,NNP-NNP,9,1
10450,9043.0,38,stepped,4,3,26,23,2,11,1,22,Chancellor,his,per,,PROPN,DET,compound,poss,NNP,PRP$,6,1
10451,9044.0,38,accredited,2,1,11,10,0,26,1,9,PUPR,Puerto Rico,,org-org,PROPN,PROPN-PROPN,nsubjpass,compound-compound,NNP,NNP-NNP,7,1
10452,9046.0,18,seen,2,8,11,3,7,6,-6,9,Jethro Tull,Martin Barre,per-per,-,PROPN-PROPN,PROPN-PROPN,compound-compound,compound-dobj,NNP-NNP,NNP-NNP,3,1
10453,9047.0,33,said,21,18,20,2,17,12,3,-1,Prime Minister,Han Myeong-Sook,per-per,-,PROPN-PROPN,PROPN-PROPN,compound-compound,compound-pobj,NNP-NNP,NNP-NNP,2,1
10454,9048.0,31,is,1,18,22,4,17,8,-17,21,Mubadala Development Company,Abu Dhabi,per-per-per,-,PROPN-PROPN-PROPN,PROPN-PROPN,compound-compound-pobj,compound-pobj,NNP-NNP-NNP,NNP-NNP,3,1
10455,9049.0,14,studied,1,9,11,2,8,2,-8,10,Interdisciplinary Center,Herzliya,org-org,,PROPN-PROPN,PROPN,compound-compound,pobj,NNP-NNP,NNP,2,1
10456,9050.0,26,is,18,17,21,4,16,4,1,3,Black Francis,American,per-per,,PROPN-PROPN,ADJ,compound-nsubj,amod,NNP-NNP,JJ,7,1
10457,9051.0,41,grumbling,3,23,26,3,22,14,-20,23,Thad Cochran,Mississippi,per-per,,PROPN-PROPN,PROPN,compound-pobj,pobj,NNP-NNP,NNP,5,1
10458,9052.0,30,died,3,2,15,13,1,14,1,12,Lal,India,per,,PROPN,PROPN,nsubj,pobj,NNP,NNP,8,1
10459,9054.0,46,founded,14,24,41,17,23,4,-10,27,North-East Project,Mariangelo Foggiato,org-org,-,PROPN-PROPN,PROPN-PROPN,compound-oprd,compound-pobj,NNP-NNP,NNP-NNP,3,1
10460,9055.0,47,rocketed,8,1,2,1,0,44,7,-6,PCCW,Hong Kong,,org-org,PROPN,PROPN-PROPN,compound,compound-poss,NNP,NNP-NNP,1,1
10461,9056.0,35,acquired,3,26,28,2,25,6,-23,25,Mumbai,National Stock Exchange of India,org,----,PROPN,PROPN-PROPN-PROPN-ADP-PROPN,pobj,compound-compound-conj-prep-compound,NNP,NNP-NNP-NNP-IN-NNP,3,1
10462,9057.0,7,finished,4,1,4,3,0,2,3,0,France,Fontaine,,org,PROPN,PROPN,poss,nsubj,NNP,NNP,3,1
10463,9060.0,26,has,5,10,23,13,9,2,-5,18,Singapore,Chartered Semiconductor Manufacturing,org,--,PROPN,PROPN-PROPN-PROPN,pobj,compound-compound-conj,NNP,NNP-NNP-NNP,5,1
10464,9061.0,46,goes,10,5,10,5,4,35,5,0,Tammy Grimes,Plummer,per-per,,PROPN-PROPN,PROPN,compound-appos,pobj,NNP-NNP,NNP,3,1
10465,9063.0,19,challenged,4,3,17,14,2,1,1,13,Redford,Calgary,,per,PROPN,PROPN,nsubj,compound,NNP,NNP,5,1
10466,9064.0,41,rose,6,16,29,13,15,11,-10,23,President,John Sculley,org,-,PROPN,PROPN-PROPN,pobj,compound-nsubjpass,NNP,NNP-NNP,9,1
10467,9065.0,20,is,6,1,18,17,0,1,5,12,Parkside High School,United States,--,per-per,PROPN-PROPN-PROPN,PROPN-PROPN,compound-compound-nsubj,compound-pobj,NNP-NNP-NNP,NNP-NNP,6,1
10468,9067.0,48,expressed,7,18,25,7,17,22,-11,18,International Atomic Energy Agency,Hans Blix,---,per-per,PROPN-PROPN-PROPN-PROPN,PROPN-PROPN,compound-compound-compound-pobj,compound-ROOT,NNP-NNP-NNP-NNP,NNP-NNP,-1,1
10469,10513.0,42,said,37,7,15,8,6,26,30,-22,International Atomic Energy Agency,Hans Blix,per-per-per-per,-,PROPN-PROPN-PROPN-PROPN,PROPN-PROPN,compound-compound-compound-pobj,compound-conj,NNP-NNP-NNP-NNP,NNP-NNP,3,1
10470,9068.0,26,graduated,1,4,4,0,3,21,-3,3,Annandale High School,Annandale,--,org,PROPN-PROPN-PROPN,PROPN,compound-compound-pobj,compound,NNP-NNP-NNP,NNP,0,1
10471,9069.0,31,retired,2,25,29,4,24,1,-23,27,Hamburg Sea Devils,NFL Europa,--,org-org,PROPN-PROPN-PROPN,PROPN-PROPN,compound-compound-pobj,compound-pobj,NNP-NNP-NNP,NNP-NNP,3,1
10472,9070.0,16,won,5,2,4,2,1,11,3,-1,Republican,Roger Wicker,per,-,ADJ,PROPN-PROPN,compound,compound-nsubj,JJ,NNP-NNP,2,1
10473,9071.0,35,elected,3,1,10,9,0,24,2,7,Francesco Cossiga,Italian Republic,per-per,-,PROPN-PROPN,PROPN-PROPN,compound-nsubjpass,compound-pobj,NNP-NNP,NNP-NNP,6,1
10474,13707.0,44,was,1,6,15,9,5,28,-5,14,Francesco Cossiga,Italian Republic,per-per,-,PROPN-PROPN,PROPN-PROPN,compound-pobj,compound-pobj,NNP-NNP,NNP-NNP,7,1
10475,9072.0,22,became,3,11,14,3,10,7,-8,11,Osaka University,Japan,-,org,PROPN-PROPN,PROPN,compound-pobj,pobj,NNP-NNP,NNP,5,1
10476,9073.0,24,was,2,1,9,8,0,14,1,7,Fillmore,Buffalo,per,,PROPN,PROPN,nsubj,compound,NNP,NNP,6,1
10477,9075.0,24,is,1,7,12,5,6,11,-6,11,International Criminal Police Organization,INTERPOL,org-org-org-org,,PROPN-PROPN-PROPN-PROPN,PROPN,compound-compound-compound-pobj,appos,NNP-NNP-NNP-NNP,NNP,5,1
10478,9076.0,28,was,10,1,13,12,0,14,9,3,Al Boasberg,American,per-per,,PROPN-PROPN,ADJ,compound-nsubj,amod,NNP-NNP,JJ,3,1
10479,9077.0,20,implemented,8,13,13,0,12,6,-5,5,Pune Institute of Computer Technology,Pune,per-per-per-per-per,,PROPN-PROPN-ADP-PROPN-PROPN,PROPN,compound-pobj-prep-compound-compound,compound,NNP-NNP-IN-NNP-NNP,NNP,0,1
10480,9078.0,54,said,2,20,46,26,19,7,-18,44,Glock,Gaston,,per,PROPN,PROPN,poss,compound,NNP,NNP,9,1
10481,9079.0,10,lives,1,1,4,3,0,5,0,3,Shields,Seattle,,org,PROPN,PROPN,nsubj,pobj,NNP,NNP,1,1
10482,9080.0,29,confirmed,6,21,26,5,20,2,-15,20,James Van Allen,University of Iowa,--,per-per-per,PROPN-PROPN-PROPN,PROPN-ADP-PROPN,compound-compound-pobj,pobj-prep-pobj,NNP-NNP-NNP,NNP-IN-NNP,6,1
10483,9081.0,22,given,3,9,17,8,8,4,-6,14,News International,James Murdoch,per-per,-,PROPN-PROPN,PROPN-PROPN,compound-compound,compound-pobj,NNP-NNP,NNP-NNP,7,1
10484,9083.0,20,served,5,15,18,3,14,1,-10,13,Republic,George Vasiliou,,org-org,PROPN,PROPN-PROPN,nmod,compound-pobj,NNP,NNP-NNP,1,1
10485,9084.0,20,recorded,9,7,18,11,6,1,2,9,Buddy Clark,Columbia,per-per,,PROPN-PROPN,PROPN,compound-conj,compound,NNP-NNP,NNP,7,1
10486,9085.0,34,urged,10,3,7,4,2,26,7,-3,Fatah,West Bank,,per-per,PROPN,PROPN-PROPN,compound,compound-pobj,NNP,NNP-NNP,2,1
10487,9086.0,57,led,10,30,32,2,29,24,-20,22,AFL-CIO,1955,org,,NOUN,NUM,pobj,pobj,NN,CD,2,1
10488,9088.0,27,rushed,14,7,26,19,6,0,7,12,Nikola Gruevski,Skopje,org-org,,PROPN-PROPN,PROPN,compound-nsubjpass,pobj,NNP-NNP,NNP,2,1
10489,9089.0,15,Born,2,1,1,0,0,13,1,-1,Michael Ealy,Michael Brown,org-org,-,PROPN-PROPN,PROPN-PROPN,compound-nsubj,compound-ROOT,NNP-NNP,NNP-NNP,0,1
10490,9090.0,32,reported,5,11,30,19,10,1,-6,25,Somare,Prime Minister,,org-org,PROPN,PROPN-PROPN,nsubj,compound-ccomp,NNP,NNP-NNP,4,1
10491,9091.0,11,canceled,2,1,7,6,0,3,1,5,Air Florida,Miami,per-per,,PROPN-PROPN,PROPN,compound-nsubj,pobj,NNP-NNP,NNP,2,1
10492,9092.0,26,is,8,1,17,16,0,8,7,9,Bharrat Jagdeo,Guyana,org-org,,PROPN-PROPN,PROPN,compound-nsubj,pobj,NNP-NNP,NNP,4,1
10493,9806.0,31,served,2,24,30,6,23,0,-22,28,Bharrat Jagdeo,Guyana,-,per,PROPN-PROPN,PROPN,compound-pobj,pobj,NNP-NNP,NNP,6,1
10494,10109.0,27,is,2,22,26,4,21,0,-20,24,Bharrat Jagdeo,Guyana,-,org,PROPN-PROPN,PROPN,compound-conj,pobj,NNP-NNP,NNP,9,1
10495,11202.0,22,revealed,3,9,12,3,8,9,-6,9,Bharrat Jagdeo,Guyana,org-org,,PROPN-PROPN,PROPN,compound-nsubj,pobj,NNP-NNP,NNP,1,1
10496,9093.0,35,was,9,5,8,3,4,26,4,-1,St Kilda,Luke Ball,-,org-org,PROPN-PROPN,PROPN-PROPN,compound-compound,compound-pobj,NNP-NNP,NNP-NNP,2,1
10497,9094.0,13,born,2,1,12,11,0,0,1,10,Hesse,Germany,,org,PROPN,PROPN,nsubjpass,pobj,NNP,NNP,2,1
10498,9096.0,27,do,2,15,17,2,14,9,-13,15,Defence,Peter MacKay,org,-,PROPN,PROPN-PROPN,compound,compound-pobj,NNP,NNP-NNP,1,1
10499,9097.0,28,northeast,1,11,15,4,10,12,-10,14,Port Authority Trans-Hudson,PATH,per-per-per,,PROPN-PROPN-PROPN,PROPN,compound-compound-pobj,nmod,NNP-NNP-NNP,NNP,3,1
10500,9098.0,20,actress,1,2,3,1,1,16,-1,2,actress,Sally Field,,per-per,NOUN,PROPN-PROPN,ROOT,compound-appos,NN,NNP-NNP,1,1
10501,9099.0,26,teamed,3,7,11,4,6,14,-4,8,Atlantic,Don Covay,,org-org,PROPN,PROPN-PROPN,amod,compound-compound,NNP,NNP-NNP,4,1
10502,9100.0,58,was,5,20,38,18,19,19,-15,33,Maroon 5,Adam Levine,per-per,-,PROPN-NUM,PROPN-PROPN,pobj-nummod,compound-appos,NNP-CD,NNP-NNP,4,1
10503,9101.0,46,went,2,9,29,20,8,16,-7,27,School,St. Thomas,,per-per,PROPN,PROPN-PROPN,dobj,compound-compound,NNP,NNP-NNP,7,1
10504,9102.0,26,produces,13,3,25,22,2,0,10,12,Bank of Ireland,Dublin,--,per,PROPN-ADP-PROPN,PROPN,nsubj-prep-pobj,pobj,NNP-IN-NNP,NNP,3,1
10505,9103.0,15,1914,0,3,6,3,2,8,-3,6,Jonas Salk,American,org-org,,PROPN-PROPN,ADJ,nsubj-ROOT,amod,NNP-NNP,JJ,1,1
10506,9104.0,61,became,6,25,27,2,24,33,-19,21,Cuban-born,Desi Arnaz,org,-,ADJ,PROPN-PROPN,amod,compound-appos,JJ,NNP-NNP,2,1
10507,9106.0,20,developed,3,15,15,0,14,4,-12,12,Chiba University,Chiba,per-per,,PROPN-PROPN,PROPN,compound-pobj,compound,NNP-NNP,NNP,0,1
10508,9107.0,11,opened,7,5,10,5,4,0,2,3,Highline High School,1924,per-per-per,,PROPN-PROPN-PROPN,NUM,compound-compound-nsubj,pobj,NNP-NNP-NNP,CD,5,1
10509,9108.0,24,sailed,11,3,8,5,2,15,8,-3,William,Navy,per,,PROPN,PROPN,appos,pobj,NNP,NNP,3,1
10510,9110.0,13,named,9,8,12,4,7,0,1,3,Illinois,him,org,,PROPN,PRON,pobj,pobj,NNP,PRP,5,1
10511,9111.0,37,is,5,13,17,4,12,19,-8,12,Gazprom,Russia,,org,PROPN,PROPN,compound,pobj,NNP,NNP,5,1
10512,9112.0,29,nominated,12,22,24,2,21,4,-10,12,Massachusetts,Calvin Coolidge,,per-per,PROPN,PROPN-PROPN,compound,compound-conj,NNP,NNP-NNP,1,1
10513,9113.0,20,returned,5,5,8,3,4,11,0,3,Sukarno,Jakarta,,per,PROPN,PROPN,conj,pobj,NNP,NNP,4,1
10514,9114.0,32,launched,2,1,1,0,0,30,1,-1,BBC Worldwide,BBC Knowledge,per-per,-,PROPN-PROPN,PROPN-PROPN,compound-nsubj,compound-appos,NNP-NNP,NNP-NNP,0,1
10515,9115.0,24,received,1,11,8,-3,10,15,-10,7,Italy,University of Trieste,,org-org-org,PROPN,PROPN-ADP-PROPN,pobj,nmod-prep-compound,NNP,NNP-IN-NNP,4,1
10516,9116.0,40,evolved,31,13,9,-4,12,30,18,-22,Discovery Health,Canada,-,per,PROPN-PROPN,PROPN,compound-compound,nsubj,NNP-NNP,NNP,5,1
10517,9117.0,22,is,8,1,21,20,0,0,7,13,UTM,Johor,per,,PROPN,PROPN,nsubj,pobj,NNP,NNP,1,1
10518,9118.0,15,launched,7,3,14,11,2,0,4,7,SFR,France,per,,PROPN,PROPN,conj,pobj,NNP,NNP,4,1
10519,9119.0,20,met,3,1,19,18,0,0,2,16,Lane,London,,per,PROPN,PROPN,nsubj,pobj,NNP,NNP,3,1
10520,9120.0,34,named,4,10,10,0,9,23,-6,6,Robert Wood Johnson Foundation,Robert Wood Johnson,org-org-org-org,--,PROPN-PROPN-PROPN-PROPN,PROPN-PROPN-PROPN,compound-compound-compound-pobj,compound-compound-compound,NNP-NNP-NNP-NNP,NNP-NNP-NNP,0,1
10521,9121.0,27,served,1,1,10,9,0,16,0,9,Cyrus,Kentucky,per,,PROPN,PROPN,nsubj,compound,NNP,NNP,5,1
10522,9122.0,80,held,15,35,31,-4,34,48,-20,16,Michael Ming-Chiao Lai,NCKU Hospital,--,per-per,PROPN-PROPN-PROPN,PROPN-PROPN,pobj-pobj-compound,compound-pobj,NNP-NNP-NNP,NNP-NNP,13,1
10523,9123.0,43,said,17,13,16,3,12,26,4,-1,Dutch,minister Kamp,org,-,ADJ,NOUN-PROPN,amod,pobj-nsubj,JJ,NN-NNP,2,1
10524,9124.0,13,attended,1,1,9,8,0,3,0,8,Vernon,Wisconsin,,org,PROPN,PROPN,nsubj,pobj,NNP,NNP,1,1
10525,9125.0,56,is,1,1,21,20,0,34,0,20,Nevada,UNLV Rebels,,per-per,PROPN,PROPN-PROPN,nsubj,compound-dobj,NNP,NNP-NNPS,2,1
10526,9128.0,22,founded,5,2,3,1,1,18,3,-2,2005,Magna Powertrain,per,-,NUM,PROPN-PROPN,pobj,compound-nsubjpass,CD,NNP-NNP,1,1
10527,9129.0,124,include,2,61,61,0,60,62,-59,59,Indiana University of Pennsylvania,Indiana,---,per,PROPN-PROPN-ADP-PROPN,PROPN,compound-pobj-prep-pobj,compound,NNP-NNP-IN-NNP,NNP,0,1
10528,12895.0,36,Title,0,14,14,0,13,21,-14,14,Indiana University of Pennsylvania,Indiana,per-per-per-per,,PROPN-PROPN-ADP-PROPN,PROPN,compound-appos-prep-compound,compound,NNP-NNP-IN-NNP,NNP,0,1
10529,9132.0,33,was,1,11,18,7,10,14,-10,17,Cuba,Mario Menocal,org,-,PROPN,PROPN-PROPN,pobj,compound-pobj,NNP,NNP-NNP,3,1
10530,9135.0,26,introduced,18,9,21,12,8,4,9,3,United Kingdom,Megabus,per-per,,PROPN-PROPN,PROPN,compound-pobj,compound,NNP-NNP,NNP,8,1
10531,9136.0,26,played,4,8,17,9,7,8,-4,13,St. Louis Maroons,Union Association,org-org-org,-,PROPN-PROPN-PROPN,PROPN-PROPN,compound-compound-pobj,compound-pobj,NNP-NNP-NNPS,NNP-NNP,7,1
10532,9137.0,27,tells,24,1,4,3,0,22,23,-20,Jake,Reese,org,,PROPN,PROPN,nsubj,conj,NNP,NNP,3,1
10533,9141.0,30,educated,2,7,9,2,6,20,-5,7,Collegio Borromeo,Pavia,org-org,,PROPN-PROPN,PROPN,compound-compound,pobj,NNP-NNP,NNP,4,1
10534,9142.0,24,hired,3,15,20,5,14,3,-12,17,Nashville,Great American Country,org,--,PROPN,PROPN-PROPN-PROPN,npadvmod,compound-compound-appos,NNP,NNP-NNP-NNP,3,1
10535,9143.0,24,is,8,1,11,10,0,12,7,3,Francesca Gagnon,Canadian,per-per,,PROPN-PROPN,ADJ,compound-nsubj,amod,NNP-NNP,JJ,3,1
10536,9144.0,27,was,12,1,6,5,0,20,11,-6,John Curtin,Australia,per-per,,PROPN-PROPN,PROPN,compound-compound,pobj,NNP-NNP,NNP,2,1
10537,9145.0,39,remained,1,1,9,8,0,29,0,8,He,Khmer Rouge,per,-,PRON,PROPN-PROPN,nsubj,compound-compound,PRP,NNP-NNP,5,1
10538,9146.0,30,is,1,9,26,17,8,3,-8,25,Alex Lifeson,Anthem,org-org,,PROPN-PROPN,PROPN,compound-pobj,compound,NNP-NNP,NNP,9,1
10539,9147.0,45,involved,12,18,28,10,17,16,-6,16,El Moudjahid,Algeria,per-per,,PROPN-PROPN,PROPN,compound-pobj,poss,NNP-NNP,NNP,6,1
10540,9149.0,28,summoned,14,7,27,20,6,0,7,13,Portuguese Armed Forces,Portugal,per-per-per,,PROPN-PROPN-PROPN,PROPN,amod-compound-pobj,dobj,NNP-NNP-NNPS,NNP,7,1
10541,9150.0,22,is,2,1,20,19,0,1,1,18,Badminton School,Bristol,per-per,,PROPN-PROPN,PROPN,compound-nsubj,compound,NNP-NNP,NNP,8,1
10542,9152.0,19,is,2,7,13,6,6,5,-5,11,Peter Hammill,Naive,org-org,,PROPN-PROPN,PROPN,compound-pobj,compound,NNP-NNP,NNP,6,1
10543,9153.0,28,began,1,12,26,14,11,1,-11,25,Paul Meany,New Orleans,-,per-per,PROPN-PROPN,PROPN-PROPN,compound-conj,compound-pobj,NNP-NNP,NNP-NNP,10,1
10544,9154.0,23,June,5,2,5,3,1,17,3,0,Lena Mary Calhoun Horne,Horne,---,per,PROPN-PROPN-PROPN-PROPN,PROPN,compound-compound-compound-compound,poss,NNP-NNP-NNP-NNP,NNP,2,1
10545,9155.0,42,ran,19,7,16,9,6,25,12,-3,North Carolina,Richard Burr,-,per-per,PROPN-PROPN,PROPN-PROPN,compound-poss,compound-compound,NNP-NNP,NNP-NNP,5,1
10546,9156.0,99,prevents,2,36,45,9,35,53,-34,43,; University of Murci,1 Murci,---,org-org,PUNCT-PROPN-ADP-PROPN,NUM-PROPN,punct-nmod-prep-pobj,nummod-nmod,:-NNP-IN-NNP,CD-NNP,6,1
10547,9157.0,30,is,8,18,14,-4,17,15,-10,6,158th Fighter Wing,Vermont,org-org-org,,NOUN-PROPN-PROPN,PROPN,compound-compound-pobj,pobj,NN-NNP-NNP,NNP,4,1
10548,9158.0,23,was,7,15,15,0,14,7,-8,8,Florida Army National Guard,Florida,per-per-per-per,,PROPN-PROPN-PROPN-PROPN,PROPN,compound-compound-compound-compound,pobj,NNP-NNP-NNP-NNP,NNP,0,1
10549,10576.0,38,is,1,7,7,0,6,30,-6,6,Florida Army National Guard,Florida,---,per,PROPN-PROPN-PROPN-PROPN,PROPN,compound-compound-compound-pobj,compound,NNP-NNP-NNP-NNP,NNP,0,1
10550,9159.0,31,is,11,21,27,6,20,3,-10,16,Hong Kong First Division,TSW Pegasus,---,per-per,PROPN-PROPN-PROPN-PROPN,PROPN-PROPN,compound-compound-compound-compound,compound-pobj,NNP-NNP-NNP-NNP,NNP-NNP,3,1
10551,9161.0,15,is,2,1,14,13,0,0,1,12,Hinchingbrooke School,Cambridgeshire,org-org,,PROPN-PROPN,PROPN,compound-nsubj,pobj,NNP-NNP,NNP,2,1
10552,9162.0,22,was,5,3,14,11,2,7,2,9,DFB-Pokal,Germany,org,,PROPN,PROPN,punct,poss,NNP,NNP,5,1
10553,9164.0,39,had,6,4,30,26,3,8,2,24,United States,Health,per-per,,PROPN-PROPN,PROPN,compound-conj,pobj,NNP-NNP,NNP,12,1
10554,9165.0,42,followed,5,11,21,10,10,20,-6,16,Pakistan,Chaudhry Muhammad Ali,,per-per-per,PROPN,NOUN-PROPN-PROPN,pobj,compound-appos-compound,NNP,NN-NNP-NNP,7,1
10555,9168.0,24,known,3,1,12,11,0,11,2,9,He,St. Louis,per,-,PRON,PROPN-PROPN,nsubjpass,compound-compound,PRP,NNP-NNP,5,1
10556,9169.0,33,injected,4,2,18,16,1,14,2,14,Bank of Japan,Tokyo,org-org-org,,PROPN-ADP-PROPN,PROPN,nsubj-prep-pobj,compound,NNP-IN-NNP,NNP,5,1
10557,9170.0,27,employed,6,6,23,17,5,3,0,17,TTC,Toronto,,org,PROPN,PROPN,nsubj,compound,NNP,NNP,7,1
10558,9172.0,22,was,10,3,3,0,2,18,7,-7,New Zealand,New Zealand national rugby league team,org-org,-----,PROPN-PROPN,PROPN-PROPN-ADJ-NOUN-NOUN-NOUN,compound-compound,nmod-nmod-amod-compound-compound-pobj,NNP-NNP,NNP-NNP-JJ-NN-NN-NN,0,1
10559,9174.0,14,said,7,3,9,6,2,4,4,2,Bill Bryson,its,per-per,,PROPN-PROPN,DET,compound-nsubj,poss,NNP-NNP,PRP$,4,1
10560,9176.0,24,was,7,5,6,1,4,17,2,-1,Australia,Billy Hughes,per,-,PROPN,PROPN-PROPN,pobj,compound-nsubj,NNP,NNP-NNP,1,1
10561,9181.0,21,is,5,10,19,9,9,1,-5,14,Willie Nelson,Columbia,per-per,,PROPN-PROPN,PROPN,compound-pobj,compound,NNP-NNP,NNP,5,1
10562,9182.0,22,promotes,11,5,10,5,4,11,6,-1,Stacy Codikow,POWER UP,per-per,-,PROPN-PROPN,PROPN-PROPN,compound-pobj,compound-conj,NNP-NNP,NNP-NNP,1,1
10563,9183.0,18,was,5,4,12,8,3,5,1,7,Duquesne,Division I,,org-org,PROPN,PROPN-PRON,compound,pobj-nmod,NNP,NNP-PRP,6,1
10564,9184.0,26,bought,4,9,11,2,8,14,-5,7,India,Tata Group,org,-,PROPN,PROPN-PROPN,poss,compound-compound,NNP,NNP-NNP,3,1
10565,9185.0,35,served,16,1,21,20,0,13,15,5,Francis Cornwall Sherman,Chicago,--,per,PROPN-PROPN-PROPN,PROPN,compound-compound-nsubj,compound,NNP-NNP-NNP,NNP,4,1
10566,9187.0,76,run,3,8,33,25,7,42,-5,30,Jersey City,Bret Schundler,-,per-per,PROPN-PROPN,PROPN-PROPN,compound-compound,compound-pobj,NNP-NNP,NNP-NNP,9,1
10567,13824.0,17,sought,13,8,11,3,7,5,5,-2,Jersey City,Bret Schundler,per-per,-,PROPN-PROPN,PROPN-PROPN,compound-compound,compound-conj,NNP-NNP,NNP-NNP,2,1
10568,9190.0,30,entered,3,3,28,25,2,1,0,25,he,New Hampshire,,org-org,PRON,PROPN-PROPN,nsubj,compound-pobj,PRP,NNP-NNP,5,1
10569,9191.0,31,leave,9,5,28,23,4,2,4,19,Yen Chia-kan,Republic,-,org,PROPN-PROPN,PROPN,compound-nsubj,pobj,NNP-NNP,NNP,8,1
10570,9193.0,22,is,2,1,14,13,0,7,1,12,Maurice Tougas,Edmonton,-,per,PROPN-PROPN,PROPN,compound-nsubj,compound,NNP-NNP,NNP,6,1
10571,9194.0,18,released,1,1,14,13,0,3,0,13,Rhodes,Infinite Bloom,,per-per,NOUN,PROPN-PROPN,nsubj,compound-appos,NNS,NNP-NNP,2,1
10572,9195.0,43,established,7,3,17,14,2,25,4,10,University of Missouri,Columbia,--,per,PROPN-ADP-PROPN,PROPN,nsubjpass-prep-compound,pobj,NNP-IN-NNP,NNP,5,1
10573,9520.0,43,tend,5,27,31,4,26,11,-22,26,University of Missouri,Columbia,org-org-org,,PROPN-ADP-PROPN,PROPN,pobj-prep-pobj,pobj,NNP-IN-NNP,NNP,9,1
10574,13012.0,42,said,24,10,14,4,9,27,14,-10,University of Missouri,Columbia,--,per,PROPN-ADP-PROPN,PROPN,pobj-prep-pobj,compound,NNP-IN-NNP,NNP,3,1
10575,9197.0,40,leading,8,22,29,7,21,10,-14,21,Bill Moggridge,IDEO,-,org,PROPN-PROPN,PROPN,compound-pobj,pobj,NNP-NNP,NNP,3,1
10576,9198.0,33,divorced,25,11,12,1,10,20,14,-13,actress,Virginia Cherrill,per,-,NOUN,PROPN-PROPN,compound,compound-dobj,NN,NNP-NNP,1,1
10577,9199.0,48,Remember,0,26,45,19,25,2,-26,45,Pittsburgh,Scaife,per,,PROPN,PROPN,pobj,poss,NNP,NNP,7,1
10578,9200.0,20,Named,0,9,18,9,8,1,-9,18,John Curtin,Western Australia,per-per,-,PROPN-PROPN,PROPN-PROPN,compound-appos,compound-pobj,NNP-NNP,NNP-NNP,7,1
10579,9201.0,58,composed,3,11,17,6,10,40,-8,14,1st Marine Aircraft Wing,MAW,per-per-per-per,,ADJ-PROPN-PROPN-PROPN,PROPN,amod-compound-compound-dobj,appos,JJ-NNP-NNP-NNP,NNP,3,1
10580,9202.0,22,operates,1,15,18,3,14,3,-14,17,New Zealand,the New Zealand Herald,org-org,---,PROPN-PROPN,DET-PROPN-PROPN-PROPN,compound-conj,det-compound-compound-pobj,NNP-NNP,DT-NNP-NNP-NNP,5,1
10581,9203.0,28,joined,1,3,17,14,2,10,-2,16,Abdullah Mehsud,Taliban,per-per,,PROPN-PROPN,PROPN,compound-dobj,pobj,NNP-NNP,NNP,4,1
10582,10380.0,22,described,17,1,4,3,0,17,16,-13,Abdullah Mehsud,Taliban,org-org,,PROPN-PROPN,PROPN,compound-nsubjpass,compound,NNP-NNP,NNP,1,1
10583,9205.0,15,Instinct,1,2,10,8,1,4,-1,9,Instinct,1997,org,,PROPN,NUM,ROOT,nummod,NNP,CD,3,1
10584,9206.0,16,was,6,5,6,1,4,9,1,0,ABC,News,,per,PROPN,PROPN,compound,pobj,NNP,NNP,3,1
10585,9207.0,29,was,1,10,27,17,9,1,-9,26,House,Spyros Kyprianou,per,-,PROPN,PROPN-PROPN,pobj,compound-conj,NNP,NNP-NNP,11,1
10586,9208.0,33,graduated,2,26,8,-18,25,24,-24,6,Albert Ritchie,Maryland,per-per,,PROPN-PROPN,PROPN,compound-compound,pobj,NNP-NNP,NNP,8,1
10587,9209.0,41,formed,18,17,34,17,16,6,1,16,United States,Jefferson,-,per,PROPN-PROPN,PROPN,compound-nsubj,nsubjpass,NNP-NNP,NNP,5,1
10588,9210.0,56,after,1,4,10,6,3,45,-3,9,ArmaLite,United States,,per-per,PROPN,PROPN-PROPN,compound,compound-poss,NNP,NNP-NNP,5,1
10589,9213.0,51,Berlin-based,0,5,11,6,4,39,-5,11,Basic Channel,Rhythm Sound,-,org-org,PROPN-PROPN,PROPN-PROPN,compound-nsubj,compound-oprd,NNP-NNP,NNP-NNP,4,1
10590,9214.0,18,studied,1,10,10,0,9,7,-9,9,San Marcos Baptist Academy,San Marcos,org-org-org-org,-,PROPN-PROPN-PROPN-PROPN,PROPN-PROPN,compound-compound-compound-conj,compound-compound,NNP-NNP-NNP-NNP,NNP-NNP,0,1
10591,9215.0,38,is,4,9,34,25,8,3,-5,30,The Triffids,Perth,org-org,,DET-PROPN,PROPN,det-poss,compound,DT-NNP,NNP,9,1
10592,9216.0,24,decided,13,5,6,1,4,17,8,-7,Staff,Mack McLarty,,per-per,PROPN,PROPN-PROPN,pobj,compound-nsubj,NNP,NNP-NNP,1,1
10593,9217.0,41,created,4,13,28,15,12,12,-9,24,Police Combat Diving Unit,Malacca,org-org-org-org,,PROPN-PROPN-PROPN-PROPN,PROPN,compound-compound-compound-pobj,compound,NNP-NNP-NNP-NNP,NNP,11,1
10594,9221.0,29,is,8,1,17,16,0,11,7,9,Beata Moon,Indiana,per-per,,PROPN-PROPN,PROPN,compound-nsubj,pobj,NNP-NNP,NNP,3,1
10595,9223.0,34,came,4,2,2,0,1,31,2,-2,Colorado Midland Railway,Colorado,per-per-per,,PROPN-PROPN-PROPN,PROPN,compound-compound-nsubj,compound,NNP-NNP-NNP,NNP,0,1
10596,9226.0,34,WITH,0,6,12,6,5,21,-6,12,John Adams,Abigail Adams,org-org,-,PROPN-PROPN,PROPN-PROPN,compound-appos,compound-appos,NNP-NNP,NNP-NNP,3,1
10597,9228.0,21,attended,1,3,7,4,2,13,-2,6,Le Moyne College,Syracuse,--,per,PROPN-PROPN-PROPN,PROPN,compound-compound-dobj,compound,NNP-NNP-NNP,NNP,5,1
10598,9229.0,36,is,9,1,17,16,0,18,8,8,Gordon Michael Woolvett,Canada,--,org,PROPN-PROPN-PROPN,PROPN,compound-compound-nsubj,pobj,NNP-NNP-NNP,NNP,5,1
10599,9231.0,16,opened,6,1,8,7,0,7,5,2,The Hongkong and Shanghai Banking Corporation,its,-----,org,DET-PROPN-CCONJ-PROPN-PROPN-PROPN,DET,det-nmod-cc-conj-compound-nsubj,poss,DT-NNP-CC-NNP-NNP-NNP,PRP$,3,1
10600,9233.0,38,is,1,6,24,18,5,13,-5,23,Leeds Teaching Hospitals NHS Trust,Chapel Allerton Hospital,----,per-per-per,PROPN-PROPN-PROPN-PROPN-PROPN,PROPN-PROPN-PROPN,compound-compound-compound-compound-pobj,compound-compound-ROOT,NNP-NNP-NNPS-NNP-NNP,NNP-NNP-NNP,-1,1
10601,9237.0,29,left,2,11,17,6,10,11,-9,15,Jacques Parizeau,Parti,per-per,,PROPN-PROPN,PROPN,compound-pobj,pobj,NNP-NNP,NNP,7,1
10602,9239.0,57,records,4,34,41,7,33,15,-30,37,Charterhouse school,Thomas Sutton,per-per,-,PROPN-NOUN,PROPN-PROPN,compound-appos,compound-pobj,NNP-NN,NNP-NNP,1,1
10603,9240.0,31,cop,15,4,21,17,3,9,11,6,Ward,BBI,,org,PROPN,PROPN,poss,npadvmod,NNP,NNP,6,1
10604,9243.0,42,known,3,10,19,9,9,22,-7,16,Eminem,Shady,per,,PROPN,PROPN,compound,compound,NNP,NNP,4,1
10605,10188.0,103,opened,5,89,101,12,88,1,-84,96,Eminem,Shady,,per,PROPN,PROPN,pobj,compound,NNP,NNP,9,1
10606,9244.0,30,quit,16,15,16,1,14,13,1,0,Mississippi,Burnside,,per,PROPN,PROPN,compound,pobj,NNP,NNP,1,1
10607,9245.0,32,is,19,10,30,20,9,1,9,11,Universidad Popular de la Chontalpa,Tabasco,----,per,PROPN-PROPN-PROPN-PROPN-PROPN,PROPN,compound-compound-compound-compound-appos,compound,NNP-NNP-NNP-NNP-NNP,NNP,9,1
10608,9246.0,19,worked,4,3,9,6,2,9,1,5,I-GO,Chicago,org,,PROPN,PROPN,nsubj,compound,NNP,NNP,5,1
10609,9247.0,27,announced,5,5,22,17,4,4,0,17,Anarbor,Hopeless Records,org,-,PROPN,PROPN-PROPN,nsubj,compound-pobj,NNP,NNP-NNPS,4,1
10610,9248.0,27,became,3,11,22,11,10,4,-8,19,1868,Benjamin Disraeli,per,-,NUM,PROPN-PROPN,pobj,compound-poss,CD,NNP-NNP,7,1
10611,9249.0,26,returned,3,1,13,12,0,12,2,10,Anote Tong,Kiribati,per-per,,PROPN-PROPN,PROPN,compound-nsubjpass,pobj,NNP-NNP,NNP,2,1
10612,9250.0,30,announced,17,1,7,6,0,22,16,-10,Szeto Wah,Hong Kong,per-per,-,PROPN-PROPN,PROPN-PROPN,compound-nsubj,compound-compound,NNP-NNP,NNP-NNP,4,1
10613,9251.0,27,move,8,5,17,12,4,9,3,9,Monica,Georgia,per,,PROPN,PROPN,nsubj,pobj,NNP,NNP,3,1
10614,10506.0,20,filmed,12,15,19,4,14,0,-3,7,Monica,Georgia,org,,PROPN,PROPN,poss,appos,NNP,NNP,5,1
10615,9252.0,31,began,4,4,25,21,3,5,0,21,CSUN,California State University,per,--,PROPN,PROPN-PROPN-PROPN,pobj,compound-compound-compound,NNP,NNP-NNP-NNP,7,1
10616,9253.0,31,became,6,3,23,20,2,7,3,17,Italy,Elsa Merlini,org,-,PROPN,PROPN-PROPN,pobj,compound-compound,NNP,NNP-NNP,6,1
10617,9254.0,33,acquired,11,16,23,7,15,9,-5,12,FAO Schwarz,New York,per-per,-,PROPN-PROPN,PROPN-PROPN,compound-appos,compound-pobj,NNP-NNP,NNP-NNP,7,1
10618,9255.0,32,says,30,1,3,2,0,28,29,-27,Gabon,Omar Bongo,,org-org,PROPN,PROPN-PROPN,compound,compound-compound,NNP,NNP-NNP,1,1
10619,10802.0,35,looking,2,10,13,3,9,21,-8,11,Gabon,Omar Bongo,org,-,PROPN,PROPN-PROPN,poss,compound-pobj,NNP,NNP-NNP,4,1
10620,11143.0,37,said,13,1,4,3,0,32,12,-9,Gabon,Omar Bongo,per,-,PROPN,PROPN-PROPN,poss,compound-compound,NNP,NNP-NNP,4,1
10621,12783.0,29,repeated,8,1,17,16,0,11,7,9,Gabon,Omar Bongo,,org-org,PROPN,PROPN-PROPN,poss,compound-compound,NNP,NNP-NNP,10,1
10622,12988.0,44,said,12,34,41,7,33,2,-22,29,Gabon,Omar Bongo,per,-,PROPN,PROPN-PROPN,pobj,compound-compound,NNP,NNP-NNP,4,1
10623,9256.0,41,warned,9,1,9,8,0,31,8,0,James Baker,State,-,per,PROPN-PROPN,PROPN,compound-nsubj,pobj,NNP-NNP,NNP,1,1
10624,9257.0,35,engineer,6,2,20,18,1,14,4,14,Tatsuo Okamoto,Winbond,-,per,PROPN-PROPN,PROPN,pobj-nsubj,compound,NNP-NNP,NNP,6,1
10625,9259.0,21,kidnap,1,3,9,6,2,11,-2,8,Aldo Moro,Italy,org-org,,PROPN-ADJ,PROPN,compound-dobj,pobj,NNP-JJ,NNP,2,1
10626,9261.0,24,fell,4,1,15,14,0,8,3,11,Tong Sang,French Polynesia,per-per,-,PROPN-PROPN,PROPN-PROPN,compound-poss,compound-poss,NNP-NNP,NNP-NNP,6,1
10627,9264.0,42,Hancock,6,22,38,16,21,3,-16,32,Rhodesian Front,Ian Smith,-,org-org,ADJ-ADJ,PROPN-PROPN,compound-compound,compound-pobj,JJ-JJ,NNP-NNP,9,1
10628,9266.0,31,struck,1,5,17,12,4,13,-4,16,MediaCorp,Aaron Kwok,per,-,PROPN,PROPN-PROPN,compound,compound-pobj,NNP,NNP-NNP,5,1
10629,9269.0,22,formed,4,17,21,4,16,0,-13,17,Tommy Thayer,Oregon,per-per,,PROPN-PROPN,PROPN,compound-conj,pobj,NNP-NNP,NNP,4,1
10630,9270.0,20,is,2,10,19,9,9,0,-8,17,Detroit,Buick,,per,PROPN,PROPN,compound,pobj,NNP,NNP,5,1
10631,9271.0,14,is,3,1,1,0,0,12,2,-2,Beresford High School,Beresford School District,org-org-org,--,PROPN-PROPN-PROPN,PROPN-PROPN-PROPN,compound-compound-nsubj,compound-compound-pobj,NNP-NNP-NNP,NNP-NNP-NNP,0,1
10632,9273.0,30,was,1,1,5,4,0,24,0,4,He,Education,per,,PRON,PROPN,nsubj,pobj,PRP,NNP,2,1
10633,9274.0,16,was,6,2,4,2,1,11,4,-2,1909,Maltese Premier League,,per-per-per,NUM,PROPN-PROPN-PROPN,nummod,compound-compound-nsubj,CD,NNP-NNP-NNP,2,1
10634,9275.0,25,spent,3,1,3,2,0,21,2,0,England,Steadman,org,,PROPN,PROPN,poss,nsubj,NNP,NNP,3,1
10635,9276.0,29,put,5,7,18,11,6,10,-2,13,U Nu,Union,-,per,PROPN-PROPN,PROPN,compound-dobj,compound,NNP-NNP,NNP,5,1
10636,9277.0,23,moved,6,9,17,8,8,5,-3,11,New York City,Lee Strasberg,org-org-org,-,PROPN-PROPN-PROPN,PROPN-PROPN,compound-compound-pobj,compound-compound,NNP-NNP-NNP,NNP-NNP,8,1
10637,9278.0,53,are,8,36,38,2,35,14,-28,30,Philippines,Land Bank of the Philippines,,per-per-per-per-per,PROPN,PROPN-PROPN-ADP-DET-PROPN,pobj,compound-conj-prep-det-pobj,NNP,NNP-NNP-IN-DT-NNPS,4,1
10638,9279.0,37,came,7,27,30,3,26,6,-20,23,New York,Columbia University,per-per,-,PROPN-PROPN,PROPN-PROPN,compound-poss,compound-pobj,NNP-NNP,NNP-NNP,3,1
10639,9280.0,14,graduated,1,4,4,0,3,9,-3,3,St. Cloud State University,St. Cloud,per-per-per-per,-,PROPN-PROPN-PROPN-PROPN,PROPN-PROPN,compound-compound-compound-pobj,compound-compound,NNP-NNP-NNP-NNP,NNP-NNP,0,1
10640,9282.0,38,ISBN,2,19,24,5,18,13,-17,22,Mental Health,CAMH,-,per,PROPN-PROPN,PROPN,compound-compound,pobj,NNP-NNP,NNP,7,1
10641,9283.0,13,is,2,1,9,8,0,3,1,7,GREN Automotive,Qingdao GREN Machinery Company,-,per-per-per-per,PROPN-PROPN,PROPN-PROPN-PROPN-PROPN,compound-nsubj,compound-compound-compound-pobj,NNP-NNP,NNP-NNP-NNP-NNP,5,1
10642,9285.0,26,were,4,11,23,12,10,2,-7,19,Peter Lang,Takoma Records,per-per,-,PROPN-PROPN,PROPN-PROPN,compound-conj,compound-compound,NNP-NNP,NNP-NNPS,6,1
10643,9286.0,25,agreed,11,2,5,3,1,19,9,-6,MSM,Anerood Jugnauth,org,-,PROPN,PROPN-PROPN,nsubj,compound-pobj,NNP,NNP-NNP,2,1
10644,9288.0,36,forwarded,5,5,12,7,4,23,0,7,EMI,she,per,,PROPN,PRON,dobj,nsubj,NNP,PRP,2,1
10645,9289.0,20,Touted,0,3,14,11,2,5,-3,14,Thailand,Kukrit Pramoj,,org-org,PROPN,PROPN-PROPN,poss,compound-pobj,NNP,NNP-NNP,9,1
10646,9290.0,36,said,1,9,19,10,8,16,-8,18,Big East,USF,-,org,PROPN-PROPN,PROPN,compound-compound,nsubj,NNP-NNP,NNP,7,1
10647,9291.0,43,seized,4,12,19,7,11,23,-8,15,Zambia,University of Zambia,org,--,PROPN,PROPN-ADP-PROPN,pobj,pobj-prep-pobj,NNP,NNP-IN-NNP,6,1
10648,9293.0,33,controls,19,9,16,7,8,16,10,-3,Southern Cross Broadcasting,Macquarie Media Group,org-org-org,--,PROPN-PROPN-PROPN,PROPN-PROPN-PROPN,nmod-nmod-nmod,compound-compound-dobj,NNP-NNP-NNP,NNP-NNP-NNP,3,1
10649,9297.0,49,is,2,24,30,6,23,18,-22,28,Television Networks,The Biography Channel,org-org,--,PROPN-PROPN,DET-PROPN-PROPN,compound-pobj,det-compound-compound,NNP-NNPS,DT-NNP-NNP,3,1
10650,9299.0,23,was,8,1,14,13,0,8,7,6,Otmar Hasler,Liechtenstein,-,per,PROPN-PROPN,PROPN,compound-nsubj,pobj,NNP-NNP,NNP,3,1
10651,9301.0,12,are,1,1,10,9,0,1,0,9,Polytechnic,Manchester,org,,PROPN,PROPN,nsubj,compound,NNP,NNP,6,1
10652,9302.0,39,had,2,21,2,-19,20,36,-19,0,York Centurions,Hawks their,-,per-per,PROPN-PROPN,PROPN-DET,compound-appos,dative-poss,NNP-NNPS,NNPS-PRP$,5,1
10653,9303.0,46,constructing,6,3,5,2,2,40,3,-1,University of Windsor,Windsor,org-org-org,,PROPN-ADP-PROPN,PROPN,nsubj-prep-pobj,compound,NNP-IN-NNP,NNP,3,1
10654,9304.0,18,is,8,2,17,15,1,0,6,9,National Union of Workers,1989,org-org-org-org,,PROPN-PROPN-ADP-PROPN,NUM,compound-nsubj-prep-pobj,pobj,NNP-NNP-IN-NNP,CD,2,1
10655,9306.0,31,is,11,22,22,0,21,8,-11,11,Malaysia,Malaysia national football team,,per-per-per-per,PROPN,PROPN-ADJ-NOUN-NOUN,compound,nmod-amod-compound-conj,NNP,NNP-JJ-NN-NN,0,1
10656,9307.0,31,is,8,3,18,15,2,12,5,10,Fighter Squadron,115th Fighter Wing,per-per,--,PROPN-PROPN,ADJ-PROPN-PROPN,compound-nsubj,compound-compound-pobj,NNP-NNP,JJ-NNP-NNP,5,1
10657,9308.0,31,planning,18,2,7,5,1,23,16,-11,Village People,Victor Willis,per-per,-,PROPN-NOUN,PROPN-PROPN,compound-compound,compound-conj,NNP-NNS,NNP-NNP,2,1
10658,9309.0,48,established,32,1,35,34,0,12,31,3,Gannon University,1925,per-per,,PROPN-PROPN,NUM,compound-nsubjpass,pobj,NNP-NNP,CD,-1,1
10659,9310.0,41,is,3,17,19,2,16,21,-14,16,Estonia,Toomas Hendrik Ilves,org,--,PROPN,PROPN-PROPN-PROPN,appos,nmod-nmod-npadvmod,NNP,NNP-NNP-NNPS,7,1
10660,9312.0,35,named,3,6,15,9,5,19,-3,12,Michael Anthony Bilandic,Chicago,org-org-org,,PROPN-PROPN-PROPN,PROPN,compound-compound-pobj,pobj,NNP-NNP-NNP,NNP,5,1
10661,12068.0,33,was,11,1,22,21,0,10,10,11,Michael Anthony Bilandic,Chicago,per-per-per,,PROPN-PROPN-PROPN,PROPN,compound-compound-nsubj,compound,NNP-NNP-NNP,NNP,8,1
10662,9313.0,24,headquartered,4,1,12,11,0,11,3,8,CIBC World Markets,Canada,--,per,PROPN-PROPN-PROPN,PROPN,compound-compound-nsubjpass,pobj,NNP-NNP-NNPS,NNP,5,1
10663,9314.0,37,think,1,30,32,2,29,4,-29,31,Pakistani,Danish Kaneria,per,-,ADJ,PROPN-PROPN,amod,compound-ccomp,JJ,NNP-NNP,1,1
10664,9315.0,32,are,2,7,15,8,6,16,-5,13,London,Yvonne Mitchell,,org-org,PROPN,PROPN-PROPN,compound,compound-appos,NNP,NNP-NNP,3,1
10665,9317.0,34,was,3,1,5,4,0,28,2,2,Its,Sky Bank,per,-,DET,PROPN-PROPN,poss,compound-attr,PRP$,NNP-NNP,3,1
10666,9318.0,26,chosen,3,1,16,15,0,9,2,13,Bagapsh,United Abkhazia,per,-,PROPN,PROPN-PROPN,nsubjpass,compound-compound,NNP,NNP-NNP,6,1
10667,9319.0,38,built,7,3,15,12,2,22,4,8,Steve Fawkner,Infinite Interactive,per-per,-,PROPN-PROPN,PROPN-PROPN,compound-pobj,compound-pobj,NNP-NNP,NNP-NNP,5,1
10668,9320.0,25,said,5,13,17,4,12,7,-8,12,Liechtenstein,Otmar Hasler,per,-,PROPN,PROPN-PROPN,poss,compound-appos,NNP,NNP-NNP,3,1
10669,9321.0,23,supported,1,1,21,20,0,1,0,20,He,Flushing,per,,PRON,VERB,nsubj,compound,PRP,VBG,7,1
10670,9323.0,13,attended,1,7,11,4,6,1,-6,10,Nova High School,Davie,--,per,PROPN-PROPN-PROPN,PROPN,compound-compound-conj,compound,NNP-NNP-NNP,NNP,3,1
10671,9325.0,9,was,1,1,7,6,0,1,0,6,Stroger,Democratic,,per,PROPN,PROPN,nsubj,compound,NNP,NNP,3,1
10672,9326.0,44,became,24,4,4,0,3,39,20,-20,California Institute of Integral Studies,California Institute of Asian Studies,per-per-per-per-per,----,PROPN-PROPN-ADP-PROPN-PROPN,PROPN-PROPN-ADP-PROPN-PROPN,compound-dobj-prep-compound-pobj,compound-appos-prep-compound-pobj,NNP-NNP-IN-NNP-NNPS,NNP-NNP-IN-NNP-NNPS,0,1
10673,9327.0,23,triggered,3,1,10,9,0,12,2,7,Holt,Liberal,per,,PROPN,PROPN,poss,compound,NNP,NNP,6,1
10674,9749.0,37,embarrassed,23,3,35,32,2,1,20,12,Holt,Liberal,per,,PROPN,PROPN,poss,compound,NNP,NNP,6,1
10675,9328.0,22,rated,16,9,11,2,8,10,7,-5,Camber,Huntsville,,per,PROPN,PROPN,poss,compound,NNP,NNP,3,1
10676,9329.0,45,was,11,31,7,-24,30,37,-20,-4,Cougars,Conference USA,,org-org,PROPN,PROPN-PROPN,nsubj,compound-pobj,NNPS,NNP-NNP,7,1
10677,9330.0,30,was,20,1,27,26,0,2,19,7,His,Toronto,,org,DET,PROPN,poss,pobj,PRP$,NNP,8,1
10678,9331.0,66,renamed,6,4,20,16,3,45,2,14,the Tribune,Arizona,per-per,,DET-PROPN,PROPN,det-nsubjpass,compound,DT-NNP,NNP,4,1
10679,9332.0,26,held,17,3,10,7,2,15,14,-7,Singapore,StarHub,,org,PROPN,PROPN,compound,compound,NNP,NNP,5,1
10680,9333.0,28,was,8,1,18,17,0,9,7,10,Tevis Clyde Smith,publisher,--,per,PROPN-PROPN-PROPN,NOUN,compound-compound-compound,conj,NNP-NNP-NNP,NN,5,1
10681,9335.0,32,make,5,1,12,11,0,19,4,7,ALITALIA,Italy,,org,PROPN,PROPN,poss,poss,NNP,NNP,5,1
10682,9337.0,17,is,1,1,13,12,0,3,0,12,SVT1,Sveriges Television,,org-org,PROPN,PROPN-PROPN,nsubj,compound-appos,NNP,NNP-NNP,3,1
10683,9340.0,20,bought,3,11,17,6,10,2,-8,14,Ottaway Community Newspapers,Dow Jones,--,org-org,PROPN-PROPN-PROPN,PROPN-PROPN,compound-compound-pobj,compound-compound,NNP-NNP-NNPS,NNP-NNP,3,1
10684,9341.0,13,was,1,1,12,11,0,0,0,11,Harmonium,Montreal,,org,PROPN,PROPN,nsubj,pobj,NNP,NNP,1,1
10685,9342.0,17,is,2,10,14,4,9,2,-8,12,Wake Forest University,Winston-Salem,per-per-per,,PROPN-PROPN-PROPN,PROPN,compound-compound-pobj,compound,NNP-NNP-NNP,NNP,5,1
10686,9343.0,12,is,1,6,10,4,5,1,-5,9,Harvard University,Eric Mazur,per-per,-,PROPN-PROPN,PROPN-PROPN,compound-compound,compound-pobj,NNP-NNP,NNP-NNP,2,1
10687,9344.0,20,replaced,10,4,8,4,3,11,6,-2,Jacques De Jongh,Hush,--,per,PROPN-PROPN-PROPN,PROPN,compound-compound-nsubj,appos,NNP-NNP-NNP,NNP,3,1
10688,9345.0,28,moved,6,5,4,-1,4,23,1,-2,ProCurve,HP,org,,PROPN,PROPN,nsubjpass,poss,NNP,NNP,2,1
10689,9347.0,9,is,2,1,8,7,0,0,1,6,Rembrandt,Netherlands,,per,PROPN,PROPN,compound,pobj,NNP,NNP,2,1
10690,11855.0,20,born,5,1,19,18,0,0,4,14,Rembrandt,Netherlands,,per,PROPN,PROPN,compound,pobj,NNP,NNP,3,1
10691,9349.0,18,is,1,15,17,2,14,0,-14,16,University of,Finland,-,org,PROPN-ADP,PROPN,pobj-prep,pobj,NNP-IN,NNP,7,1
10692,9351.0,26,is,4,11,13,2,10,12,-7,9,University of North Dakota,North Dakota,---,org-org,PROPN-ADP-PROPN-PROPN,PROPN-PROPN,pobj-prep-compound-pobj,compound-pobj,NNP-IN-NNP-NNP,NNP-NNP,1,1
10693,12299.0,26,is,7,2,4,2,1,21,5,-3,University of North Dakota,North Dakota,---,org-org,PROPN-ADP-PROPN-PROPN,PROPN-PROPN,nmod-prep-compound-pobj,compound-pobj,NNP-IN-NNP-NNP,NNP-NNP,1,1
10694,9353.0,36,refused,7,16,23,7,15,12,-9,16,Studio Ghibli,he,per-per,,PROPN-PROPN,PRON,compound-pobj,nsubj,NNP-NNP,PRP,6,1
10695,9355.0,21,founded,2,1,11,10,0,9,1,9,Alias,Brett Burner,org,-,PROPN,PROPN-PROPN,nsubjpass,compound-conj,NNP,NNP-NNP,4,1
10696,9356.0,28,raided,14,9,13,4,8,14,5,-1,Federal Investigations Agency,AFI,per-per-per,,PROPN-PROPN-PROPN,PROPN,compound-compound-pobj,appos,NNP-NNPS-NNP,NNP,2,1
10697,9357.0,30,was,12,1,23,22,0,6,11,11,Tzannis Tzannetakis,Greece,per-per,,PROPN-PROPN,PROPN,compound-nsubj,pobj,NNP-NNP,NNP,4,1
10698,9358.0,15,involved,4,13,14,1,12,0,-9,10,provider,Mobiltel,,per,NOUN,PROPN,compound,pobj,NN,NNP,1,1
10699,9359.0,42,present,4,34,38,4,33,3,-30,34,Western Washington University,Bellingham,per-per-per,,PROPN-PROPN-PROPN,PROPN,compound-compound-pobj,pobj,NNP-NNP-NNP,NNP,6,1
10700,9362.0,64,Isotta,1,5,17,12,4,46,-4,16,Italy,Corriere della Sera,org,--,PROPN,PROPN-PROPN-PROPN,poss,compound-compound-appos,NNP,NNP-NNP-NNP,10,1
10701,9364.0,47,joined,12,14,19,5,13,27,-2,7,AFP,Alexander B. Yano,,org-org-org,PROPN,PROPN-PROPN-PROPN,compound,compound-compound-nsubj,NNP,NNP-NNP-NNP,4,1
10702,9365.0,25,launched,18,6,6,0,5,18,12,-12,Astro,Astro TVIQ,,org-org,PROPN,PROPN-PROPN,compound,compound-conj,NNP,NNP-NNP,0,1
10703,9367.0,25,announced,5,8,19,11,7,5,-3,14,Ueto,Pony Canyon,org,-,PROPN,PROPN-PROPN,nsubj,compound-compound,NNP,NNP-NNP,8,1
10704,9368.0,11,Motor,2,1,6,5,0,4,1,4,Great Wall Motor,Baoding,--,per,PROPN-PROPN-PROPN,PROPN,compound-compound-ROOT,pobj,NNP-NNP-NNP,NNP,5,1
10705,9369.0,61,admitted,29,9,20,11,8,40,20,-9,Las Vegas Metropolitan Police Department,Ray Flynn,per-per-per-per-per,-,PROPN-PROPN-PROPN-PROPN-PROPN,PROPN-PROPN,compound-compound-compound-compound-pobj,compound-pobj,NNP-NNP-NNP-NNP-NNP,NNP-NNP,9,1
10706,9370.0,26,recruited,2,2,6,4,1,19,0,4,company,Thomas Lowry,per,-,NOUN,PROPN-PROPN,nsubj,compound-dobj,NN,NNP-NNP,2,1
10707,9371.0,32,attended,1,3,25,22,2,6,-2,24,Fairfield University,NCAA,org-org,,PROPN-PROPN,PROPN,compound-dobj,compound,NNP-NNP,NNP,8,1
10708,9373.0,18,is,4,2,7,5,1,10,2,3,6th Armoured Division,Pakistan Army,--,per-per,ADJ-PROPN-PROPN,PROPN-PROPN,amod-compound-nsubj,nmod-nmod,JJ-NNP-NNP,NNP-NNP,4,1
10709,9374.0,16,contains,2,6,12,6,5,3,-4,10,Peter Schickele,P. D. Q. Bach,-,per-per-per-per,PROPN-PROPN,PROPN-PROPN-PROPN-PROPN,compound-pobj,compound-compound-compound-pobj,NNP-NNP,NNP-NNP-NNP-NNP,5,1
10710,9375.0,29,suggested,10,3,8,5,2,20,7,-2,Joaquim Chissano,Mozambique,-,per,PROPN-PROPN,PROPN,compound-nsubj,pobj,NNP-NNP,NNP,4,1
10711,11726.0,34,awarded,11,6,9,3,5,24,5,-2,Joaquim Chissano,Mozambique,-,org,PROPN-PROPN,PROPN,compound-pobj,pobj,NNP-NNP,NNP,3,1
10712,9376.0,47,offers,1,1,38,37,0,8,0,37,MDIS,Singapore,org,,PROPN,PROPN,nsubj,pobj,NNP,NNP,2,1
10713,9377.0,26,released,2,1,7,6,0,18,1,5,The Joykiller,Epitaph,per-per,,DET-PROPN,PROPN,det-nsubj,compound,DT-NNP,NNP,4,1
10714,9378.0,28,enlisted,11,10,23,13,9,4,1,12,actor,James Caan,,org-org,NOUN,PROPN-PROPN,nsubj,compound-pobj,NN,NNP-NNP,9,1
10715,9382.0,24,merged,3,2,7,5,1,16,1,4,1850,Glasgow and South Western Railway,org,----,NUM,PROPN-CCONJ-PROPN-PROPN-PROPN,pobj,attr-cc-compound-compound-conj,CD,NNP-CC-NNP-NNP-NNP,3,1
10716,9383.0,33,is,9,14,29,15,13,3,-5,20,National Security Agency,United States,--,per-per,PROPN-PROPN-PROPN,PROPN-PROPN,compound-compound-attr,compound-compound,NNP-NNP-NNP,NNP-NNP,-1,1
10717,9384.0,28,joined,1,11,23,12,10,4,-10,22,Israel,Givati Brigade,per,-,PROPN,PROPN-PROPN,nsubj,compound-pobj,NNP,NNP-NNP,5,1
10718,9386.0,23,recruited,2,1,11,10,0,11,1,9,Shankar,Nepal,per,,PROPN,PROPN,nsubjpass,pobj,NNP,NNP,6,1
10719,9389.0,26,is,1,8,16,8,7,9,-7,15,Trondheim,University College,per,-,PROPN,PROPN-PROPN,compound,compound-pobj,NNP,NNP-NNP,3,1
10720,9390.0,45,remained,2,23,11,-12,22,33,-21,9,Vardhaman Mahaveer Open University,Kota,org-org-org-org,,PROPN-PROPN-PROPN-PROPN,PROPN,compound-compound-compound-compound,pobj,NNP-NNP-NNP-NNP,NNP,8,1
10721,10747.0,27,is,5,1,11,10,0,15,4,6,Vardhaman Mahaveer Open University,Kota,per-per-per-per,,PROPN-PROPN-PROPN-PROPN,PROPN,compound-compound-compound-nsubj,compound,NNP-NNP-NNP-NNP,NNP,6,1
10722,9391.0,23,express,1,8,11,3,7,11,-7,10,Versace,Giancarlo Di Risio,,org-org-org,PROPN,PROPN-PROPN-PROPN,appos,compound-compound-nsubj,NNP,NNP-NNP-NNP,4,1
10723,9392.0,67,released,4,3,11,8,2,55,1,7,Verve,Lester Young,per,-,PROPN,PROPN-PROPN,compound,compound-compound,NNP,NNP-NNP,5,1
10724,9393.0,36,acquired,29,23,26,3,22,9,6,-3,Limited,Japan,per,,PROPN,PROPN,appos,pobj,NNP,NNP,3,1
10725,9394.0,21,maintained,6,12,16,4,11,4,-6,10,Horn of Africa,CJTF-HOA,org-org-org,,PROPN-ADP-PROPN,PROPN,nsubj-prep-pobj,subtok,NNP-IN-NNP,NNP,3,1
10726,9395.0,36,replaced,8,21,26,5,20,9,-13,18,Forza Italia,Giancarlo Galan,-,per-per,PROPN-PROPN,PROPN-PROPN,ROOT-ROOT,compound-appos,NNP-NNP,NNP-NNP,4,1
10727,9396.0,20,helped,1,9,11,2,8,8,-8,10,Massachusetts,Meditech,,org,PROPN,PROPN,pobj,dobj,NNP,NNP,2,1
10728,9397.0,15,founded,1,1,3,2,0,11,0,2,Jackson,Zebra,,org,PROPN,PROPN,nsubj,dobj,NNP,NNP,1,1
10729,9398.0,33,started,3,18,26,8,17,6,-15,23,RCTI,Feni Rose,org,-,PROPN,PROPN-PROPN,pobj,compound-compound,NNP,NNP-NNP,7,1
10730,9402.0,43,encompassed,6,4,14,10,3,28,2,8,Bergman,Sweden,,per,PROPN,PROPN,poss,pobj,NNP,NNP,5,1
10731,12282.0,15,waged,2,1,10,9,0,4,1,8,Bergman,Sweden,org,,PROPN,PROPN,nsubj,poss,NNP,NNP,2,1
10732,9404.0,27,was,15,1,26,25,0,0,14,11,Emilio,Mexico,,org,PROPN,PROPN,compound,pobj,NNP,NNP,3,1
10733,9406.0,28,left,5,20,21,1,19,6,-15,16,Chancellor,Gordon Brown,per,-,PROPN,PROPN-PROPN,compound,compound-pobj,NNP,NNP-NNP,2,1
10734,9720.0,21,Prior,0,14,18,4,13,2,-14,18,Chancellor,Gordon Brown,per,-,PROPN,PROPN-PROPN,nmod,compound-compound,NNP,NNP-NNP,3,1
10735,9407.0,25,remain,21,2,10,8,1,14,19,-11,John Ensign,Republican,-,org,PROPN-PROPN,PROPN,compound-nsubj,compound,NNP-NNP,NNP,3,1
10736,9408.0,41,Active,0,14,29,15,13,11,-14,29,Fuckin Wild,Artvoice,org-org,,PROPN-PROPN,PROPN,compound-nsubj,compound,NNP-NNP,NNP,5,1
10737,9412.0,46,was,1,1,16,15,0,29,0,15,Donlevy,actress,org,,PROPN,VERB,nsubj,advcl,NNP,VB,4,1
10738,9413.0,56,became,1,28,42,14,27,13,-27,41,Mustafa Pasha Fahmi,Egypt,--,per,PROPN-PROPN-PROPN,PROPN,compound-compound-appos,pobj,NNP-NNP-NNP,NNP,10,1
10739,9414.0,19,Patra,0,1,10,9,0,8,-1,10,Patra,Jamaica,org,,PROPN,PROPN,ROOT,appos,NNP,NNP,3,1
10740,9415.0,36,is,18,10,21,11,9,14,8,3,Denmark,Danish Superliga,org,-,PROPN,PROPN-PROPN,pobj,compound-pobj,NNP,NNP-NNP,4,1
10741,9416.0,20,is,3,1,10,9,0,9,2,7,Melbourn Village College,Cambridgeshire,per-per-per,,PROPN-PROPN-PROPN,PROPN,compound-compound-nsubj,compound,NNP-NNP-NNP,NNP,6,1
10742,13499.0,14,is,1,9,13,4,8,0,-8,12,Melbourn Village College,Cambridgeshire,--,org,PROPN-PROPN-PROPN,PROPN,compound-compound-pobj,pobj,NNP-NNP-NNP,NNP,2,1
10743,9418.0,58,said,25,21,24,3,20,33,4,-1,Nauru,Ludwig Scotty,org,-,PROPN,PROPN-PROPN,poss,compound-appos,NNP,NNP-NNP,3,1
10744,9419.0,22,is,3,3,10,7,2,11,0,7,School,Coquitlam,org,,PROPN,PROPN,nsubj,compound,NNP,NNP,5,1
10745,9421.0,24,included,1,13,19,6,12,4,-12,18,Mildred Harris,Charlie Chaplin,-,org-org,PROPN-PROPN,PROPN-PROPN,compound-pobj,compound-poss,NNP-NNP,NNP-NNP,6,1
10746,9422.0,33,took,4,9,12,3,8,20,-5,8,Vermont,New England Culinary Institute,,org-org-org-org,PROPN,PROPN-PROPN-PROPN-PROPN,pobj,compound-compound-compound-nsubj,NNP,NNP-NNP-NNP-NNP,3,1
10747,9423.0,20,commenced,7,11,16,5,10,3,-4,9,Yarra Trams,Melbourne,org-org,,PROPN-PROPN,PROPN,compound-compound,poss,NNP-NNPS,NNP,5,1
10748,9424.0,12,played,1,7,6,-1,6,5,-6,5,Scots,Alma,,org,PROPN,PROPN,pobj,compound,NNPS,NNP,1,1
10749,9425.0,30,sketched,4,10,13,3,9,16,-6,9,songwriter,Jason Kay,org,-,NOUN,PROPN-PROPN,pobj,compound-appos,NN,NNP-NNP,3,1
10750,9426.0,36,is,1,6,7,1,5,28,-5,6,actress,Marilyn Monroe,per,-,NOUN,PROPN-PROPN,relcl,compound-dobj,NN,NNP-NNP,1,1
10751,9429.0,15,co-founded,2,5,8,3,4,6,-3,6,Victor Muller,Spyker Cars,org-org,-,PROPN-PROPN,PROPN-PROPN,compound-compound,compound-pobj,NNP-NNP,NNP-NNPS,2,1
10752,9430.0,46,is,2,9,18,9,8,27,-7,16,Euroleague,FIBA Europe,,org-org,PROPN,PROPN-PROPN,compound,compound-pobj,NNP,NNP-NNP,9,1
10753,9431.0,17,born,2,1,16,15,0,0,1,14,Ambrose,England,org,,PROPN,PROPN,nsubjpass,pobj,NNP,NNP,2,1
10754,9433.0,20,is,10,3,9,6,2,10,7,-1,1976,Kakatiya University,,per-per,NUM,PROPN-PROPN,pobj,compound-pobj,CD,NNP-NNP,2,1
10755,9434.0,30,toured,2,1,4,3,0,25,1,2,Rutledge,Canada,per,,PROPN,PROPN,nsubj,dobj,NNP,NNP,4,1
10756,13617.0,21,receiving,3,17,20,3,16,0,-14,17,Rutledge,Canada,per,,PROPN,PROPN,poss,pobj,NNP,NNP,7,1
10757,9435.0,34,attracted,2,1,14,13,0,19,1,12,Verve,Richie Havens,org,-,PROPN,PROPN-PROPN,compound,compound-pobj,NNP,NNP-NNP,4,1
10758,9436.0,25,hosted,4,21,16,-5,20,8,-17,12,Persistent Systems,Pune,-,org,PROPN-PROPN,PROPN,compound-compound,appos,NNP-NNPS,NNP,8,1
10759,9439.0,17,born,3,1,16,15,0,0,2,13,Anthony David,Atlanta,org-org,,PROPN-PROPN,PROPN,compound-nsubjpass,pobj,NNP-NNP,NNP,2,1
10760,9443.0,69,argues,3,28,47,19,27,21,-25,44,in Roman,th Gheorghe Gheorghiu-D,-,org-org-org,ADP-PROPN,DET-VERB-VERB,prep-pobj,prep-pobj-ROOT,IN-NNP,DT-VBN-VBP,6,1
10761,9444.0,30,selected,24,5,9,4,4,20,19,-15,Bob Menendez,New Jersey,-,per-per,PROPN-PROPN,PROPN-PROPN,compound-pobj,compound-compound,NNP-NNP,NNP-NNP,3,1
10762,9445.0,40,said,29,1,15,14,0,24,28,-14,Rothschild,France,per,,NOUN,PROPN,nsubj,pobj,NN,NNP,6,1
10763,9446.0,36,served,1,26,12,-14,25,23,-25,11,Maurice Rose,3rd Armored Division,per-per,--,PROPN-PROPN,ADJ-PROPN-PROPN,compound-nsubjpass,compound-compound-dobj,NNP-NNP,JJ-NNP-NNP,10,1
10764,9448.0,23,served,13,8,12,4,7,10,5,-1,London,Alexander,,org,PROPN,PROPN,pobj,compound,NNP,NNP,3,1
10765,9449.0,11,Cricket,0,5,7,2,4,3,-5,7,India,Johnson,org,,PROPN,PROPN,dobj,nsubj,NNP,NNP,1,1
10766,9450.0,24,consists,2,15,1,-14,14,22,-13,-1,Dave DeSantis,The Secret Syde,per-per,--,PROPN-PROPN,DET-PROPN-PROPN,compound-conj,det-compound-pobj,NNP-NNP,DT-NNP-NNP,4,1
10767,9451.0,27,operates,5,3,5,2,2,21,2,0,1963,railway,,per,NUM,NOUN,pobj,nsubj,CD,NN,2,1
10768,9452.0,25,died,2,10,17,7,9,7,-8,15,Hoyte,Guyana,org,,PROPN,PROPN,nsubj,nsubj,NNP,NNP,4,1
10769,9453.0,40,printed,2,26,36,10,25,3,-24,34,Adam Hirshan,The Conway Daily Sun,-,org-org-org-org,PROPN-PROPN,DET-PROPN-PROPN-PROPN,compound-conj,det-compound-compound-pobj,NNP-NNP,DT-NNP-NNP-NNP,8,1
10770,9456.0,22,be,4,10,17,7,9,4,-6,13,EMI,her,per,,PROPN,DET,pobj,poss,NNP,PRP$,8,1
10771,9457.0,26,is,7,15,20,5,14,5,-8,13,Georgia Southern University,Statesboro,--,per,PROPN-PROPN-PROPN,PROPN,compound-compound-pobj,compound,NNP-NNP-NNP,NNP,3,1
10772,9458.0,27,told,10,1,6,5,0,20,9,-4,Ella,Malaysia,,per,PROPN,PROPN,nsubj,poss,NNP,NNP,5,1
10773,9460.0,21,owned,2,5,19,14,4,1,-3,17,the Independent,South Africa,-,per-per,DET-PROPN,PROPN-PROPN,det-compound,compound-pobj,DT-NNP,NNP-NNP,8,1
10774,9461.0,22,called,5,8,19,11,7,2,-3,14,Fischer,Austria,,per,PROPN,PROPN,pobj,poss,NNP,NNP,7,1
10775,12542.0,25,re-elected,5,4,10,6,3,14,1,5,Fischer,Austria,per,,PROPN,PROPN,nsubjpass,pobj,NNP,NNP,4,1
10776,9463.0,22,immigrated,9,16,21,5,15,0,-7,12,CRK,ID,org,,NOUN,PROPN,conj,pobj,NNS,NNP,7,1
10777,9464.0,54,is,1,20,30,10,19,23,-19,29,Governor General,Canadian Forces,per-per,-,PROPN-PROPN,PROPN-PROPN,compound-compound,compound-compound,NNP-NNP,NNP-NNPS,5,1
10778,9465.0,25,scored,3,12,17,5,11,7,-9,14,Free State Cheetahs,Currie Cup,org-org-org,-,PROPN-PROPN-PROPN,PROPN-PROPN,compound-compound-pobj,compound-compound,NNP-NNP-NNP,NNP-NNP,4,1
10779,9466.0,37,consists,6,10,13,3,9,23,-4,7,Mitchy Slick,San Diego,-,per-per,PROPN-PROPN,PROPN-PROPN,compound-appos,compound-compound,NNP-NNP,NNP-NNP,3,1
10780,9467.0,15,Founded,0,3,4,1,2,10,-3,4,1976,Boston,per,,NUM,PROPN,nummod,pobj,CD,NNP,2,1
10781,9468.0,31,with,1,17,22,5,16,8,-16,21,Disney,Pixar,per,,PROPN,PROPN,compound,pobj,NNP,NNP,2,1
10782,9469.0,46,laid,2,11,14,3,10,31,-9,12,Pennsylvania,American Bridge Company,org,--,PROPN,PROPN-PROPN-PROPN,pobj,compound-compound-pobj,NNP,NNP-NNP-NNP,2,1
10783,9472.0,20,sold,3,3,10,7,2,9,0,7,he,Windham Hill,per,-,PRON,PROPN-PROPN,nsubj,compound-compound,PRP,NNP-NNP,6,1
10784,9473.0,37,introduced,3,7,14,7,6,22,-4,11,Arizona,Dean Martin,per,-,PROPN,PROPN-PROPN,compound,compound-pobj,NNP,NNP-NNP,5,1
10785,9474.0,22,is,6,3,6,3,2,15,3,0,Barbados,Bickerton,per,,PROPN,PROPN,pobj,nsubj,NNP,NNP,2,1
10786,9475.0,32,said,3,2,3,1,1,28,1,0,MAN Ferrostaal,AG,-,org,PROPN-PROPN,PROPN,compound-compound,appos,NNP-NNP,NNP,1,1
10787,10255.0,19,acquired,2,13,15,2,12,3,-11,13,MAN Ferrostaal,AG,per-per,,PROPN-PROPN,PROPN,compound-compound,pobj,NNP-NNP,NNP,4,1
10788,9476.0,22,attended,1,4,4,0,3,17,-3,3,Georgia Institute of Technology,Georgia,org-org-org-org,,PROPN-PROPN-ADP-PROPN,PROPN,compound-dobj-prep-pobj,compound,NNP-NNP-IN-NNP,NNP,0,1
10789,9478.0,24,began,5,2,23,21,1,0,3,18,University of the East,1946,---,per,PROPN-ADP-DET-PROPN,NUM,nsubj-prep-det-pobj,pobj,NNP-IN-DT-NNP,CD,3,1
10790,9479.0,17,started,5,3,7,4,2,9,2,2,Jerome T. Youngman,Mutant Press,org-org-org,-,PROPN-PROPN-PROPN,PROPN-PROPN,compound-compound-nsubj,compound-dative,NNP-NNP-NNP,NNP-NNP,3,1
10791,9480.0,37,stretched,4,25,32,7,24,4,-21,28,Dale Evans,Apple Valley,-,per-per,PROPN-PROPN,PROPN-PROPN,compound-compound,compound-compound,NNP-NNP,NNP-NNP,9,1
10792,9481.0,15,is,6,5,1,-4,4,13,1,-5,WHS,Whittier,per,,PROPN,PROPN,appos,compound,NNP,NNP,3,1
10793,9482.0,49,published,5,24,27,3,23,21,-19,22,Musa Aman,Sabah,-,org,PROPN-PROPN,PROPN,compound-pobj,compound,NNP-NNP,NNP,3,1
10794,9483.0,23,had,1,1,14,13,0,8,0,13,Smith,Blue Note,org,-,PROPN,PROPN-PROPN,nsubj,compound-pobj,NNP,NNP-NNP,4,1
10795,9484.0,43,Group,2,5,23,18,4,19,-3,21,Australia,Donut King,,org-org,PROPN,PROPN-PROPN,appos,compound-nmod,NNP,NNP-NNP,-1,1
10796,9485.0,45,Laboratory,4,4,14,10,3,30,0,10,Wright Laboratory,Air Force,-,per-per,PROPN-PROPN,PROPN-PROPN,compound-ROOT,compound-compound,NNP-NNP,NNP-NNP,5,1
10797,9486.0,34,appointed,6,3,8,5,2,25,3,2,Louisiana,Dr. Mackie,,per-per,PROPN,PROPN-PROPN,compound,compound-dobj,NNP,NNP-NNP,3,1
10798,9489.0,31,rebuilt,24,8,13,5,7,17,16,-11,University of Puerto Rico at Ponce,Ponce,-----,org,PROPN-ADP-PROPN-PROPN-ADP-PROPN,PROPN,pobj-prep-compound-pobj-prep-pobj,compound,NNP-IN-NNP-NNP-IN-NNP,NNP,3,1
10799,9490.0,54,occurred,15,19,49,30,18,4,-4,34,Syria,Hashim al-Atassi,,org-org,PROPN,PROPN-CCONJ,pobj,compound-pobj,NNP,NNP-CC,7,1
10800,9931.0,21,considered,3,13,19,6,12,1,-10,16,Syria,Hashim al-Atassi,per,-,PROPN,PROPN-PROPN,pobj,compound-pobj,NNP,NNP-NNP,5,1
10801,10912.0,25,went,16,14,15,1,13,9,2,-1,Syria,Hashim al-Atassi,org,-,PROPN,PROPN-CCONJ,compound,compound-pobj,NNP,NNP-CC,2,1
10802,9493.0,51,song,3,2,23,21,1,27,1,20,Academy Award-winning,Maureen McGovern,-,org-org,PROPN-NOUN,PROPN-PROPN,compound-compound,compound-pobj,NNP-NN,NNP-NNP,5,1
10803,9494.0,35,are,3,17,17,0,16,17,-14,14,International Federation of Journalists,International,per-per-per-per,,PROPN-PROPN-ADP-PROPN,PROPN,compound-nsubj-prep-pobj,compound,NNP-NNP-IN-NNPS,NNP,0,1
10804,9496.0,27,changed,2,1,15,14,0,11,1,13,Hua,Communist Party,org,-,PROPN,PROPN-PROPN,nsubj,compound-conj,NNP,NNP-NNP,4,1
10805,9498.0,26,was,9,1,16,15,0,9,8,7,Attack Squadron 46,United States Navy,per-per-per,--,PROPN-PROPN-NUM,PROPN-PROPN-PROPN,compound-nsubj-nummod,compound-compound-pobj,NNP-NNP-CD,NNP-NNP-NNP,5,1
10806,9500.0,20,was,10,1,15,14,0,4,9,5,Juan Carlos Wasmosy,Paraguay,--,per,PROPN-PROPN-PROPN,PROPN,compound-compound-compound,pobj,NNP-NNP-NNP,NNP,4,1
10807,9503.0,20,married,5,7,5,-2,6,14,-2,0,Teresa Felicia,he,-,per,PROPN-PROPN,PRON,compound-dobj,nsubj,NNP-NNP,PRP,1,1
10808,9504.0,23,France,1,2,21,19,1,1,-1,20,France,Claude Monet,per,-,PROPN,PROPN-PROPN,ROOT,compound-pobj,NNP,NNP-NNP,7,1
10809,9506.0,29,said,5,2,19,17,1,9,3,14,Saab,Sweden,,org,PROPN,PROPN,compound,pobj,NNP,NNP,6,1
10810,10425.0,37,built,5,5,20,15,4,16,0,15,Saab,Sweden,per,,PROPN,PROPN,nsubj,pobj,NNP,NNP,3,1
10811,13726.0,26,built,3,6,9,3,5,16,-3,6,Saab,Sweden,org,,PROPN,PROPN,compound,pobj,NNP,NNP,1,1
10812,9507.0,52,include,7,7,10,3,6,41,0,3,Japan,The Stalin,per,-,PROPN,DET-PROPN,pobj,det-compound,NNP,DT-NNP,2,1
10813,9508.0,71,continue,51,17,23,6,16,47,34,-28,United States,Coast Guard,-,per-per,PROPN-PROPN,PROPN-PROPN,compound-compound,compound-conj,NNP-NNP,NNP-NNP,2,1
10814,9509.0,12,He's,0,9,10,1,8,1,-9,10,producer,Jerry Bruckheimer,,per-per,NOUN,PROPN-PROPN,pobj,compound-appos,NN,NNP-NNP,2,1
10815,9510.0,11,is,2,7,9,2,6,1,-5,7,Canadian,Paul Quarrington,,org-org,ADJ,PROPN-PROPN,amod,compound-pobj,JJ,NNP-NNP,1,1
10816,9511.0,20,remained,7,1,10,9,0,9,6,3,Simmons,Israel,,org,NOUN,PROPN,poss,pobj,NNS,NNP,4,1
10817,13466.0,12,is,8,1,8,7,0,3,7,0,Simmons,Israel,,per,NOUN,PROPN,poss,pobj,NNS,NNP,3,1
10818,9512.0,71,claim,3,7,59,52,6,11,-4,56,Bill Haley,Decca,per-per,,PROPN-PROPN,PROPN,compound-poss,pobj,NNP-NNP,NNP,-1,1
10819,12698.0,40,set,25,10,16,6,9,23,15,-9,Bill Haley,Decca,-,per,PROPN-PROPN,PROPN,compound-pobj,compound,NNP-NNP,NNP,4,1
10820,9513.0,42,doubled,3,21,33,12,20,8,-18,30,Los Angeles Times,Tribune Company,--,org-org,PROPN-PROPN-PROPN,PROPN-PROPN,compound-nmod-compound,compound-pobj,NNP-NNP-NNP,NNP-NNP,6,1
10821,9514.0,17,is,1,11,15,4,10,1,-10,14,Kean University,New Jersey,per-per,-,PROPN-PROPN,PROPN-PROPN,compound-pobj,compound-pobj,NNP-NNP,NNP-NNP,2,1
10822,9515.0,9,strive,3,2,8,6,1,0,1,5,me,Quebec,per,,PRON,PROPN,pobj,pobj,PRP,NNP,2,1
10823,9517.0,10,closed,1,1,7,6,0,2,0,6,Altadis,Madrid,org,,NOUN,PROPN,nsubj,pobj,NNS,NNP,1,1
10824,9518.0,32,was,2,2,12,10,1,19,0,10,WADF,United States,per,-,PROPN,PROPN-PROPN,nsubj,compound-pobj,NNP,NNP-NNP,5,1
10825,9519.0,52,was,1,17,21,4,16,30,-16,20,Amintore Fanfani.Cavazza,Italy,per-per,,PROPN-PROPN,PROPN,compound-ROOT,ROOT,NNP-NNP,NNP,-1,1
10826,9521.0,28,was,5,11,20,9,10,7,-6,15,Iraq,People,per,,PROPN,PROPN,poss,poss,NNP,NNPS,6,1
10827,9522.0,24,was,3,12,21,9,11,2,-9,18,Trinidad and Tobago,TT Pro League,--,per-per-per,PROPN-CCONJ-PROPN,PROPN-PROPN-PROPN,pobj-cc-conj,compound-compound-pobj,NNP-CC-NNP,NNP-NNP-NNP,8,1
10828,9523.0,41,defeated,19,6,27,21,5,13,13,8,Australia,Ben Chifley,org,-,PROPN,PROPN-PROPN,pobj,compound-pobj,NNP,NNP-NNP,4,1
10829,14193.0,26,endorsed,3,8,19,11,7,6,-5,16,Australia,Ben Chifley,,org-org,PROPN,PROPN-PROPN,compound,compound-pobj,NNP,NNP-NNP,9,1
10830,9524.0,23,Other,0,3,15,12,2,7,-3,15,Pantheon-Assas University,France,-,org,PROPN-PROPN,PROPN,compound-pobj,pobj,NNP-NNP,NNP,7,1
10831,9525.0,18,released,8,1,12,11,0,5,7,4,His,Nettwerk Records,,org-org,DET,PROPN-PROPN,poss,compound-pobj,PRP$,NNP-NNPS,5,1
10832,9528.0,36,known,4,2,15,13,1,20,2,11,he,Dream Theater,org,-,PRON,PROPN-PROPN,nsubjpass,compound-nsubj,PRP,NNP-NNP,5,1
10833,9529.0,31,became,9,18,18,0,17,12,-9,9,Texas Southern University,Texas State University for Negroes,--,org-org-org-org-org,PROPN-PROPN-PROPN,PROPN-PROPN-PROPN-ADP-PROPN,compound-compound-pobj,compound-compound-pobj-prep-pobj,NNP-NNP-NNP,NNP-NNP-NNP-IN-NNPS,0,1
10834,9530.0,53,organized,37,10,29,19,9,23,27,-8,Islamic Affairs and Kuwait Institute for Scientific Research,Cooperation Council for the Arab States of the Gulf,-------,per-per-per-per-per-per-per-per-per,PROPN-PROPN-CCONJ-PROPN-PROPN-ADP-PROPN-PROPN,PROPN-PROPN-ADP-DET-PROPN-PROPN-ADP-DET-PROPN,compound-conj-cc-compound-appos-prep-compound-pobj,compound-pobj-prep-det-compound-pobj-prep-det-pobj,NNP-NNPS-CC-NNP-NNP-IN-NNP-NNP,NNP-NNP-IN-DT-NNP-NNPS-IN-DT-NNP,6,1
10835,9532.0,27,protected,5,18,10,-8,17,16,-13,5,No. 12 Group RAF,RAF Watnall,per-per-per-per,-,NOUN-NUM-PROPN-PROPN,PROPN-PROPN,nmod-nummod-compound-pobj,compound-pobj,NN-CD-NNP-NNP,NNP-NNP,8,1
10836,9533.0,25,represents,8,11,22,11,10,2,-3,14,University of North Carolina at Chapel Hill,NCAA,------,per,PROPN-ADP-PROPN-PROPN-ADP-PROPN-PROPN,PROPN,dobj-prep-compound-pobj-prep-compound-pobj,compound,NNP-IN-NNP-NNP-IN-NNP-NNP,NNP,4,1
10837,9534.0,54,elected,13,22,40,18,21,13,-9,27,Mexico,Porfirio,,per,PROPN,PROPN,pobj,pobj,NNP,NNP,4,1
10838,9537.0,21,was,8,3,7,4,2,13,5,-1,Fontanne,Genesee Depot,,per-per,PROPN,PROPN-PROPN,poss,compound-pobj,NNP,NNP-NNP,4,1
10839,9538.0,29,was,3,3,11,8,2,17,0,8,Nixon,House Un-American Activities Committee,org,---,PROPN,PROPN-PROPN-PROPN-PROPN,nsubj,compound-compound-compound-pobj,NNP,NNP-NNP-NNPS-NNP,4,1
10840,9539.0,27,Publications,5,8,20,12,7,6,-3,15,The Rolling Stones,Bill Wyman,per-per-per,-,DET-PROPN-PROPN,PROPN-PROPN,det-compound-compound,compound-compound,DT-NNP-NNPS,NNP-NNP,4,1
10841,9662.0,37,remembers,10,5,21,16,4,15,5,11,The Rolling Stones,Bill Wyman,--,per-per,DET-PROPN-PROPN,PROPN-PROPN,det-compound-compound,compound-compound,DT-NNP-NNPS,NNP-NNP,11,1
10842,9540.0,25,left,6,6,8,2,5,16,0,2,Scorpions,RCA,org,,PROPN,PROPN,pobj,dobj,NNPS,NNP,1,1
10843,9541.0,21,is,8,1,18,17,0,2,7,10,John Mooney,New Orleans,org-org,-,PROPN-PROPN,PROPN-PROPN,compound-nsubj,compound-compound,NNP-NNP,NNP-NNP,6,1
10844,9542.0,7,was,2,1,6,5,0,0,1,4,Wera Engels,actress,per-per,,PROPN-PROPN,NOUN,compound-nsubj,attr,NNP-NNP,NN,2,1
10845,9544.0,34,re-released,3,10,21,11,9,12,-7,18,Rouvas,Greece,,org,PROPN,PROPN,nsubj,poss,NNP,NNP,4,1
10846,9545.0,16,join,7,9,14,5,8,1,-2,7,Rupert Stadler,Audi,org-org,,PROPN-PROPN,PROPN,compound-compound,compound,NNP-NNP,NNP,4,1
10847,9546.0,44,testified,12,19,29,10,18,14,-7,17,John V. Kenny,Jersey City,--,per-per,PROPN-PROPN-PROPN,PROPN-PROPN,compound-compound-dobj,compound-pobj,NNP-NNP-NNP,NNP-NNP,8,1
10848,9547.0,35,was,1,15,18,3,14,16,-14,17,The Offspring,Dexter Holland,per-per,-,DET-PROPN,PROPN-PROPN,det-poss,compound-pobj,DT-NNP,NNP-NNP,3,1
10849,9548.0,21,Retrieved,0,8,10,2,7,10,-8,10,University,Manitoba,,per,PROPN,PROPN,nsubj,pobj,NNP,NNP,2,1
10850,13381.0,39,born,13,10,12,2,9,26,3,-1,University,Manitoba,per,,PROPN,PROPN,pobj,pobj,NNP,NNP,2,1
10851,9549.0,18,worked,5,12,15,3,11,2,-7,10,Angel Ramos,El Mundo,org-org,-,PROPN-PROPN,PROPN-PROPN,compound-poss,compound-compound,NNP-NNP,NNP-NNP,2,1
10852,9550.0,31,said,29,2,5,3,1,25,27,-24,director,Mario Monicelli,,per-per,NOUN,PROPN-PROPN,nsubj,compound-conj,NN,NNP-NNP,3,1
10853,9551.0,40,became,9,18,37,19,17,2,-9,28,Venezuela,Gallegos,,per,PROPN,PROPN,pobj,poss,NNP,NNP,10,1
10854,9553.0,28,co-founded,3,3,6,3,2,21,0,3,he,Singapore,,per,PRON,PROPN,nsubj,compound,PRP,NNP,3,1
10855,9554.0,43,said,28,25,39,14,24,3,3,11,ABC,the Walt Disney Company,org,---,PROPN,DET-PROPN-PROPN-PROPN,compound,det-compound-compound-pobj,NNP,DT-NNP-NNP-NNP,11,1
10856,9555.0,34,was,13,3,18,15,2,15,10,5,George Miller,physician,-,per,PROPN-PROPN,NOUN,compound-compound,attr,NNP-NNP,NN,5,1
10857,9556.0,26,formed,3,2,17,15,1,8,1,14,band,Rachel Hall,per,-,NOUN,PROPN-PROPN,nsubjpass,compound-conj,NN,NNP-NNP,-1,1
10858,9557.0,42,confirmed,1,28,30,2,27,11,-27,29,Garbage,Butch Vig,per,-,PROPN,PROPN-PROPN,compound,compound-conj,NNP,NNP-NNP,1,1
10859,9558.0,42,settled,10,13,38,25,12,3,-3,28,Pinto,Chile,,org,PROPN,PROPN,nsubj,pobj,NNP,NNP,7,1
10860,9559.0,25,went,1,4,22,18,3,2,-3,21,St. Raphael Academy,Pawtucket,--,per,PROPN-PROPN-PROPN,PROPN,compound-compound-dative,compound,NNP-NNP-NNP,NNP,8,1
10861,9560.0,42,Front,2,5,10,5,4,31,-3,8,Afghanistan,Ahmad Zia Massoud,per,--,PROPN,PROPN-PROPN-PROPN,pobj,compound-compound-compound,NNP,NNP-NNP-NNP,4,1
10862,9561.0,38,are,10,2,13,11,1,24,8,3,Singapore,Management Development Institute of Singapore,,per-per-per-per-per,PROPN,PROPN-PROPN-PROPN-ADP-PROPN,compound,compound-compound-attr-prep-compound,NNP,NNP-NNP-NNP-IN-NNP,4,1
10863,9562.0,26,toured,2,6,12,6,5,13,-4,10,United States,Cornerstone,-,per,PROPN-PROPN,PROPN,compound-pobj,compound,NNP-NNP,NNP,6,1
10864,9563.0,14,distributes,1,10,12,2,9,1,-9,11,Viacom,National Amusements,,per-per,PROPN,PROPN-PROPN,compound,compound-pobj,NNP,NNP-NNPS,1,1
10865,9565.0,31,came,6,9,23,14,8,7,-3,17,Essendon,David Hille,org,-,PROPN,PROPN-PROPN,pobj,compound-appos,NNP,NNP-NNP,8,1
10866,9566.0,16,founded,2,1,14,13,0,1,1,12,Petplan,Natasha Ashton,org,-,PROPN,PROPN-PROPN,nsubjpass,compound-conj,NNP,NNP-NNP,5,1
10867,9568.0,12,is,1,6,10,4,5,1,-5,9,American,Tori Amos,,org-org,ADJ,PROPN-PROPN,amod,compound-pobj,JJ,NNP-NNP,3,1
10868,9569.0,25,relationship,2,14,15,1,13,9,-12,13,President,Isaias Afewerki,,per-per,PROPN,PROPN-PROPN,compound,compound-nsubj,NNP,NNP-NNP,2,1
10869,9570.0,18,is,1,1,10,9,0,7,0,9,GLAA,1971,,per,PROPN,NUM,nsubj,nummod,NNP,CD,5,1
10870,9571.0,150,is,1,10,19,9,9,130,-9,18,Green Party of England and Wales,Caroline Lucas,per-per-per-per-per-per,-,PROPN-PROPN-ADP-PROPN-CCONJ-PROPN,PROPN-PROPN,compound-pobj-prep-pobj-cc-conj,compound-compound,NNP-NNP-IN-NNP-CC-NNP,NNP-NNP,9,1
10871,9573.0,19,is,1,6,6,0,5,12,-5,5,South Carolina Army National Guard,South Carolina,----,org-org,PROPN-PROPN-PROPN-PROPN-PROPN,PROPN-PROPN,compound-compound-compound-compound-pobj,compound-compound,NNP-NNP-NNP-NNP-NNP,NNP-NNP,0,1
10872,9575.0,14,founded,4,9,13,4,8,0,-5,9,ASD,Afrob,per,,NOUN,PROPN,appos,appos,NN,NNP,2,1
10873,9576.0,29,Chancellor,2,5,21,16,4,7,-3,19,Lithuania,W?adys?aw IV Va,per,--,PROPN,VERB-PROPN-PROPN,pobj,compound-compound-compound,NNP,VBP-NNP-NNP,6,1
10874,9577.0,41,said,37,3,5,2,2,35,34,-32,French,Edgar Degas,org,-,ADJ,PROPN-PROPN,amod,compound-poss,JJ,NNP-NNP,1,1
10875,9578.0,25,renamed,3,1,22,21,0,2,2,19,The Bon,Federated Department Stores,org-org,--,DET-PROPN,PROPN-PROPN-PROPN,det-nsubjpass,compound-compound-appos,DT-NNP,NNP-NNP-NNPS,6,1
10876,9582.0,19,graduated,1,14,18,4,13,0,-13,17,Boston University,MA,-,org,PROPN-PROPN,NOUN,compound-pobj,pobj,NNP-NNP,NN,6,1
10877,9584.0,37,known,9,3,3,0,2,33,6,-6,New York Life Insurance Company,New York,org-org-org-org-org,-,PROPN-PROPN-PROPN-PROPN-PROPN,PROPN-PROPN,compound-compound-compound-compound-compound,compound-compound,NNP-NNP-NNP-NNP-NNP,NNP-NNP,0,1
10878,9585.0,40,included,3,20,31,11,19,8,-17,28,Julian Cope,The Teardrop Explodes,per-per,--,PROPN-PROPN,DET-PROPN-PROPN,compound-pobj,det-compound-pobj,NNP-NNP,DT-NNP-NNP,12,1
10879,9586.0,14,painted,3,8,13,5,7,0,-5,10,Monet,France,,per,PROPN,PROPN,poss,pobj,NNP,NNP,7,1
10880,9587.0,42,favoured,3,1,9,8,0,32,2,6,England,Harold Harefoot,,per-per,PROPN,PROPN-PROPN,poss,compound-dobj,NNP,NNP-NNP,7,1
10881,10905.0,57,succeeded,3,28,44,16,27,12,-25,41,England,Harold Harefoot,per,-,PROPN,PROPN-PROPN,pobj,compound-appos,NNP,NNP-NNP,8,1
10882,9588.0,26,undertook,7,7,21,14,6,4,0,14,Bauhaus,Love and Rockets,per,--,PROPN,PROPN-CCONJ-PROPN,pobj,pobj-cc-conj,NNP,NNP-CC-NNPS,4,1
10883,9589.0,50,born,9,1,13,12,0,36,8,4,Natasha Alexandra Rastapkavicius Arrondo,1975 ) pr,org-org-org-org,--,PROPN-PROPN-PROPN-PROPN,NUM-PUNCT-X,compound-compound-compound-nsubj,nummod-punct-punct,NNP-NNP-NNP-NNP,CD--RRB--XX,3,1
10884,9590.0,25,Other,0,20,21,1,19,3,-20,21,guitarist,Ron Asheton,,org-org,NOUN,PROPN-PROPN,compound,compound-appos,NN,NNP-NNP,1,1
10885,9591.0,35,band,3,22,32,10,21,2,-19,29,Cornell,New York City,,per-per-per,PROPN,PROPN-PROPN-PROPN,poss,compound-compound-pobj,NNP,NNP-NNP-NNP,10,1
10886,9593.0,29,said,9,3,8,5,2,20,6,-1,Doug Scott,Illinois,-,org,PROPN-PROPN,PROPN,compound-compound,compound,NNP-NNP,NNP,3,1
10887,9594.0,22,left,1,1,3,2,0,18,0,2,Darin,Decca,,per,PROPN,PROPN,nsubj,dobj,NNP,NNP,2,1
10888,9595.0,35,College,2,13,33,20,12,1,-11,31,Osmania University,Andhra Pradesh,per-per,-,PROPN-PROPN,PROPN-PROPN,compound-pobj,compound-pobj,NNP-NNP,NNP-NNP,9,1
10889,9598.0,32,sponsors,4,2,12,10,1,19,2,8,University of Pittsburgh,Division I,per-per-per,-,PROPN-ADP-PROPN,PROPN-PROPN,nsubj-prep-pobj,pobj-nsubj,NNP-IN-NNP,NNP-NNP,6,1
10890,9599.0,19,step,3,8,10,2,7,8,-5,7,Transport,Ong Tee Keat,,per-per-per,PROPN,PROPN-PROPN-PROPN,compound,compound-compound-nsubj,NNP,NNP-NNP-NNP,2,1
10891,9601.0,22,is,10,12,18,6,11,3,-2,8,Mother Angelica,Eternal Word Television Network,per-per,---,PROPN-PROPN,PROPN-PROPN-PROPN-PROPN,compound-attr,compound-compound-compound-pobj,NNP-NNP,NNP-NNP-NNP-NNP,6,1
10892,9602.0,40,said,10,27,31,4,26,8,-17,21,Italy,Giulio Tremonti,per,-,PROPN,PROPN-PROPN,poss,compound-conj,NNP,NNP-NNP,3,1
10893,9603.0,22,opened,3,1,9,8,0,12,2,6,Bartlett High School,1997,org-org-org,,PROPN-PROPN-PROPN,NUM,compound-compound-nsubj,nummod,NNP-NNP-NNP,CD,3,1
10894,9604.0,12,born,2,1,6,5,0,5,1,4,Jacob,Hauts-de-Seine,per,,PROPN,PROPN,nsubjpass,pobj,NNP,NNP,4,1
10895,9605.0,17,1981,0,11,15,4,10,1,-11,15,Chinese,Hua Guofeng,,org-org,PROPN,PROPN-PROPN,compound,compound-dobj,NNP,NNP-NNP,7,1
10896,9607.0,38,mandated,5,32,35,3,31,2,-27,30,Infantry,25th Infantry Regiment,,per-per-per,PROPN,PROPN-PROPN-PROPN,compound,compound-compound-conj,NNP,NNP-NNP-NNP,2,1
10897,9608.0,39,signed,2,17,22,5,16,16,-15,20,College of the Sequoias,Visalia,org-org-org-org,,PROPN-ADP-DET-PROPN,PROPN,pobj-prep-det-pobj,compound,NNP-IN-DT-NNP,NNP,3,1
10898,9609.0,19,hit,1,8,12,4,7,6,-7,11,airline,Frankfurt,,org,NOUN,PROPN,poss,pobj,NN,NNP,5,1
10899,9610.0,35,came,3,14,12,-2,13,22,-11,9,North America,Church of God,-,per-per-per,PROPN-PROPN,PROPN-ADP-PROPN,compound-pobj,conj-prep-pobj,NNP-NNP,NNP-IN-NNP,2,1
10900,9611.0,31,recorded,6,20,22,2,19,8,-14,16,Jaidev,Bombay,,per,PROPN,PROPN,pobj,pobj,NNP,NNP,4,1
10901,9612.0,21,was,1,11,18,7,10,2,-10,17,Zuffa LLC,Ultimate Fighting Championship,-,per-per-per,PROPN-PROPN,PROPN-PROPN-PROPN,compound-pobj,compound-compound-pobj,NNP-NNP,NNP-NNP-NNP,5,1
10902,10413.0,20,purchased,2,5,12,7,4,7,-3,10,Zuffa LLC,Ultimate Fighting Championship,org-org,--,PROPN-PROPN,PROPN-PROPN-PROPN,compound-pobj,compound-compound-pobj,NNP-NNP,NNP-NNP-NNP,4,1
10903,9614.0,20,is,11,2,6,4,1,13,9,-5,State Engineering University of Armenia,Armenia,----,org,PROPN-PROPN-PROPN-ADP-PROPN,PROPN,compound-compound-nsubj-prep-pobj,pobj,NNP-NNP-NNP-IN-NNP,NNP,3,1
10904,9615.0,18,denied,8,1,5,4,0,12,7,-3,Gabon,Jean Eyeghe Ndong,per,--,PROPN,PROPN-PROPN-PROPN,poss,compound-compound-nsubj,NNP,NNP-NNP-NNP,3,1
10905,9616.0,19,Lawson,1,1,10,9,0,8,0,9,Ben Lawson,Australia,org-org,,PROPN-PROPN,PROPN,compound-ROOT,pobj,NNP-NNP,NNP,2,1
10906,9618.0,16,is,8,1,15,14,0,0,7,7,Henry Silva,actor,per-per,,PROPN-PROPN,NOUN,compound-nsubj,attr,NNP-NNP,NN,2,1
10907,9619.0,17,is,7,1,3,2,0,13,6,-4,Bank of Ningbo,Ningbo,org-org-org,,PROPN-ADP-PROPN,PROPN,nmod-prep-pobj,compound,NNP-IN-NNP,NNP,3,1
10908,9621.0,27,graduated,1,7,15,8,6,11,-6,14,Hunan Normal University,China,--,org,PROPN-PROPN-PROPN,PROPN,compound-compound-pobj,compound,NNP-NNP-NNP,NNP,11,1
10909,9623.0,20,acted,3,16,18,2,15,1,-13,15,Newfoundland,Richard Squires,,org-org,PROPN,PROPN-PROPN,compound,compound-pobj,NNP,NNP-NNP,1,1
10910,9768.0,33,asked,4,14,16,2,13,16,-10,12,Newfoundland,Richard Squires,org,-,PROPN,PROPN-PROPN,compound,compound-pobj,NNP,NNP-NNP,1,1
10911,9624.0,21,is,2,2,12,10,1,8,0,10,IMx,Immature,per,,NOUN,PROPN,nsubj,pobj,NNS,NNP,7,1
10912,9625.0,21,won,5,2,13,11,1,7,3,8,People,Sangay Ngedup,,per-per,PROPN,PROPN-PROPN,poss,compound-appos,NNPS,NNP-NNP,6,1
10913,9626.0,29,congratulated,3,5,10,5,4,18,-2,7,Japan,Yasuo Fukuda,org,-,PROPN,PROPN-PROPN,poss,compound-dobj,NNP,NNP-NNP,2,1
10914,9627.0,35,stricken,4,1,9,8,0,25,3,5,Sharon,Israel,org,,PROPN,PROPN,nsubjpass,poss,NNP,NNP,8,1
10915,9629.0,11,created,3,1,6,5,0,4,2,3,Rap Snacks,James,-,per,PROPN-PROPN,PROPN,compound-nsubjpass,compound,NNP-NNP,NNP,4,1
10916,9630.0,31,In,0,22,28,6,21,2,-22,28,Walder,Nomad Soul Records,org,--,PROPN,PROPN-PROPN-PROPN,nsubj,compound-compound-appos,NNP,NNP-NNP-NNPS,2,1
10917,9632.0,20,participated,1,1,8,7,0,11,0,7,GFTU,International Federation,per,-,PROPN,PROPN-PROPN,nsubj,compound-pobj,NNP,NNP-NNP,4,1
10918,9633.0,18,headed,3,6,12,6,5,5,-3,9,Claude Blanchet,Pauline Marois,-,org-org,PROPN-PROPN,PROPN-PROPN,compound-pobj,compound-compound,NNP-NNP,NNP-NNP,5,1
10919,9634.0,33,was,7,1,15,14,0,17,6,8,Charles Milford Bergstresser,Dow Jones Company,--,per-per-per,PROPN-PROPN-PROPN,PROPN-PROPN-PROPN,compound-compound-nsubj,compound-compound-pobj,NNP-NNP-NNP,NNP-NNP-NNP,5,1
10920,9637.0,27,served,2,1,6,5,0,20,1,4,He,Ohio,,per,PRON,PROPN,nsubj,nmod,PRP,NNP,3,1
10921,9638.0,54,is,10,2,5,3,1,48,8,-5,Kore University of Enna,Enna,per-per-per-per,,PROPN-PROPN-ADP-PROPN,PROPN,compound-nsubj-prep-pobj,pobj,NNP-NNP-IN-NNP,NNP,1,1
10922,9639.0,37,head,21,10,19,9,9,17,11,-2,Donna Shalala,President,-,per,PROPN-PROPN,PROPN,conj-appos,compound,NNP-NNP,NNP,5,1
10923,9640.0,54,lived,18,12,15,3,11,38,6,-3,Bethel College,North Newton,-,per-per,PROPN-PROPN,PROPN-PROPN,compound-pobj,compound-compound,NNP-NNP,NNP-NNP,5,1
10924,9641.0,16,talks,10,7,9,2,6,6,3,-1,Texas,Lyle Lovett,,per-per,PROPN,PROPN-PROPN,compound,compound-appos,NNP,NNP-NNP,4,1
10925,9642.0,14,File,0,3,3,0,2,10,-3,3,Kolkata,Kolkata Metro,org,-,PROPN,PROPN-PROPN,compound,compound-compound,NNP,NNP-NNP,0,1
10926,9643.0,21,is,3,3,17,14,2,3,0,14,England,Stanley Kubrick,,per-per,PROPN,PROPN-PROPN,nsubj,compound-attr,NNP,NNP-NNP,3,1
10927,9644.0,27,said,14,9,14,5,8,12,5,0,Comcast,1963,org,,PROPN,NUM,dobj,pobj,NNP,CD,-1,1
10928,9646.0,17,is,3,1,1,0,0,15,2,-2,Indiana Northeastern Railroad,Indiana,per-per-per,,PROPN-PROPN-PROPN,PROPN,compound-compound-nsubj,nmod,NNP-NNP-NNP,NNP,0,1
10929,9647.0,30,is,21,1,20,19,0,9,20,-1,Hazel Pascual Reyes,Ara Mina,--,per-per,PROPN-PROPN-PROPN,PROPN-PROPN,compound-compound-nsubj,compound-nsubj,NNP-NNP-NNP,NNP-NNP,3,1
10930,9648.0,16,is,3,1,15,14,0,0,2,12,John Charles Keegan,Arizona,per-per-per,,PROPN-PROPN-PROPN,PROPN,compound-compound-nsubj,pobj,NNP-NNP-NNP,NNP,3,1
10931,9649.0,44,signed,12,8,22,14,7,21,4,10,Lancashire,Mike Watkinson,,per-per,PROPN,PROPN-PROPN,pobj,compound-pobj,NNP,NNP-NNP,10,1
10932,9650.0,23,co-wrote,3,3,19,16,2,3,0,16,Woods,Some Bizzare,,per-per,PROPN,DET-PROPN,pobj,compound-compound,NNP,DT-NNP,5,1
10933,9652.0,31,says,4,3,9,6,2,21,1,5,Nouri al-Maliki,Iraq,org-org,,PROPN-PROPN,PROPN,compound-nsubj,poss,NNP-NNP,NNP,4,1
10934,9653.0,14,provided,9,2,9,7,1,4,7,0,Rick Froberg,artist,per-per,,PROPN-PROPN,NOUN,compound-nsubj,attr,NNP-NNP,NN,4,1
10935,9654.0,31,involves,2,7,23,16,6,7,-5,21,United States,Pontiac,per-per,,PROPN-PROPN,PROPN,compound-pobj,compound,NNP-NNP,NNP,5,1
10936,9664.0,25,said,23,6,10,4,5,14,17,-13,United States,Pontiac,per-per,,PROPN-PROPN,PROPN,compound-pobj,compound,NNP-NNP,NNP,5,1
10937,9655.0,23,found,2,15,22,7,14,0,-13,20,Richard Mellon Scaife,Pittsburgh,org-org-org,,PROPN-PROPN-PROPN,PROPN,compound-compound-pobj,pobj,NNP-NNP-NNP,NNP,8,1
10938,9656.0,34,was,14,11,19,8,10,14,3,5,Boomerang,TBS,per,,PROPN,PROPN,poss,poss,NNP,NNP,14,1
10939,9657.0,28,renamed,1,3,10,7,2,17,-2,9,the Vanguard group,Lesbian Center,org-org-org,-,DET-PROPN-NOUN,PROPN-PROPN,det-compound-dobj,conj-nsubj,DT-NNP-NN,NNP-NNP,4,1
10940,9658.0,87,ruled,56,24,31,7,23,55,32,-25,Pridi Phanomyong,Thai,-,org,PROPN-PROPN,PROPN,compound-nsubj,compound,NNP-NNP,NNP,3,1
10941,9659.0,40,contributes,2,27,31,4,26,8,-25,29,professor,McGill University,,per-per,NOUN,PROPN-PROPN,appos,compound-pobj,NN,NNP-NNP,3,1
10942,9661.0,107,spent,2,46,67,21,45,39,-44,65,France,Jean-Louis Barrault,,org-org,PROPN,PROPN-PROPN,pobj,compound-appos,NNP,NNP-NNP,9,1
10943,9665.0,10,became,4,2,9,7,1,0,2,5,Robert Schneider,guitarist,-,per,PROPN-PROPN,NOUN,compound-nsubj,attr,NNP-NNP,NN,2,1
10944,9666.0,18,is,2,7,8,1,6,9,-5,6,de Sherbrooke,Sherbrooke,per-per,,X-PROPN,PROPN,nmod-pobj,compound,FW-NNP,NNP,4,1
10945,9667.0,50,announced,21,21,26,5,20,23,0,5,HSBC,Stuart Gulliver,per,-,PROPN,PROPN-PROPN,pobj,compound-conj,NNP,NNP-NNP,14,1
10946,13241.0,36,said,9,7,8,1,6,27,2,-1,HSBC,Stuart Gulliver,,per-per,PROPN,PROPN-PROPN,compound,compound-pobj,NNP,NNP-NNP,2,1
10947,9668.0,34,noted,3,11,27,16,10,6,-8,24,his,Grizzly Bear,org,-,DET,PROPN-PROPN,poss,compound-pobj,PRP$,NNP-NNP,5,1
10948,9669.0,18,announced,7,5,16,11,4,1,2,9,Take-Two Interactive,2K Marin,org-org,-,PROPN-PROPN,PROPN-PROPN,compound-nsubj,compound-pobj,NNP-NNP,NNP-NNP,4,1
10949,9670.0,16,created,5,3,12,9,2,3,2,7,Fiasco,Atlantic,org,,PROPN,PROPN,poss,compound,NNP,NNP,7,1
10950,11436.0,24,disbanded,2,9,22,13,8,1,-7,20,Fiasco,Atlantic,org,,PROPN,PROPN,conj,compound,NNP,NNP,6,1
10951,9671.0,26,been,6,1,19,18,0,6,5,13,Guizot,France,org,,PROPN,PROPN,nsubj,poss,NNP,NNP,8,1
10952,14013.0,27,sent,4,9,22,13,8,4,-5,18,Guizot,France,,per,PROPN,PROPN,pobj,pobj,NNP,NNP,5,1
10953,9672.0,20,held,4,8,15,7,7,4,-4,11,University of the South Pacific,Suva,per-per-per-per-per,,PROPN-ADP-DET-PROPN-PROPN,PROPN,pobj-prep-det-compound-compound,pobj,NNP-IN-DT-NNP-NNP,NNP,4,1
10954,9673.0,45,won,13,30,33,3,29,11,-17,20,AirAsia X,Malaysia,org-org,,PROPN-PROPN,PROPN,compound-conj,pobj,NNP-NNP,NNP,3,1
10955,9674.0,17,obtained,1,6,14,8,5,2,-5,13,Princeton University,Albert W. Tucker,per-per,--,PROPN-PROPN,PROPN-PROPN-PROPN,compound-pobj,compound-compound-pobj,NNP-NNP,NNP-NNP-NNP,7,1
10956,9679.0,27,named,2,19,24,5,18,2,-17,22,John Franklin,Lady Jane Franklin,per-per,--,PROPN-PROPN,PROPN-PROPN-PROPN,compound-appos,compound-compound-appos,NNP-NNP,NNP-NNP-NNP,4,1
10957,9680.0,54,argues,31,5,43,38,4,10,26,12,Chicago,University of Chicago,org,--,PROPN,PROPN-ADP-PROPN,compound,nsubj-prep-pobj,NNP,NNP-IN-NNP,6,1
10958,9681.0,26,co-chaired,5,18,23,5,17,2,-13,18,Trinidad State Junior College,Ruth Ann Woods,per-per-per-per,--,PROPN-PROPN-PROPN-PROPN,PROPN-PROPN-PROPN,compound-compound-compound-compound,compound-compound-conj,NNP-NNP-NNP-NNP,NNP-NNP-NNP,3,1
10959,9682.0,15,moved,3,3,7,4,2,7,0,4,Elissa,Canada,org,,PROPN,PROPN,nsubj,pobj,NNP,NNP,2,1
10960,9685.0,49,were,10,17,23,6,16,25,-7,13,Dawn Black,New Westminster,per-per,-,PROPN-PROPN,PROPN-PROPN,compound-nsubj,compound-compound,NNP-NNP,NNP-NNP,5,1
10961,9688.0,38,controls,7,1,23,22,0,14,6,16,Swire Group,Cathay Pacific,per-per,-,PROPN-PROPN,PROPN-PROPN,compound-nsubj,compound-appos,NNP-NNP,NNP-NNP,7,1
10962,9690.0,41,had,37,3,31,28,2,9,34,-6,Bank of Montreal,Harris Bank,org-org-org,-,PROPN-ADP-PROPN,PROPN-PROPN,poss-prep-pobj,compound-conj,NNP-IN-NNP,NNP-NNP,10,1
10963,9691.0,22,is,8,1,7,6,0,14,7,-1,Ralph Allen School,Bath,per-per-per,,PROPN-PROPN-PROPN,PROPN,compound-compound-nsubj,compound,NNP-NNP-NNP,NNP,2,1
10964,9692.0,13,recruited,5,8,12,4,7,0,-3,7,Brett Reed,Rancid,per-per,,PROPN-PROPN,PROPN,compound-dobj,dobj,NNP-NNP,NNP,2,1
10965,9693.0,37,appointed,13,8,9,1,7,27,5,-4,Treasury,Salmon P. Chase,per,--,PROPN,PROPN-PROPN-PROPN,pobj,compound-compound-pobj,NNP,NNP-NNP-NNP,5,1
10966,12214.0,33,discharged,3,19,30,11,18,2,-16,27,Treasury,Salmon P. Chase,,per-per-per,PROPN,PROPN-PROPN-PROPN,compound,compound-compound-pobj,NNP,NNP-NNP-NNP,6,1
10967,12529.0,34,confided,9,29,31,2,28,2,-20,22,Treasury,Salmon P. Chase,org,--,PROPN,PROPN-PROPN-PROPN,conj,compound-compound-pobj,NNP,NNP-NNP-NNP,4,1
10968,9694.0,17,Baby,0,8,15,7,7,1,-8,15,Reprise,Sonny Cher,,org-org,PROPN,PROPN-PROPN,pobj,compound-pobj,NNP,NNP-NNP,5,1
10969,9695.0,66,left,33,41,43,2,40,22,-8,10,University of Adelaide,Adelaide,--,per,PROPN-ADP-PROPN,PROPN,appos-prep-pobj,pobj,NNP-IN-NNP,NNP,2,1
10970,9699.0,14,is,3,1,11,10,0,2,2,8,PAREF Westbridge School,Iloilo City,per-per-per,-,PROPN-PROPN-PROPN,PROPN-PROPN,compound-compound-nsubj,compound-compound,NNP-NNP-NNP,NNP-NNP,8,1
10971,9700.0,20,is,7,1,1,0,0,18,6,-6,Plainview-Old Bethpage,Plainview-Old Bethpage Central School District,org-org,----,PUNCT-PROPN,NOUN-PROPN-PROPN-PROPN-PROPN,compound-compound,compound-compound-compound-compound-pobj,NFP-NNP,NN-NNP-NNP-NNP-NNP,0,1
10972,9701.0,40,erected,7,10,32,22,9,7,-3,25,Germany,Wilhelm Frick,per,-,PROPN,PROPN-PROPN,pobj,compound-pobj,NNP,NNP-NNP,4,1
10973,9702.0,21,represented,6,3,9,6,2,11,3,3,Nebraska Cornhuskers,University of Nebraska Lincoln,org-org,---,PROPN-PROPN,PROPN-ADP-PROPN-PROPN,compound-compound,nmod-prep-pobj-dobj,NNP-NNP,NNP-IN-NNP-NNP,4,1
10974,9703.0,14,speak,9,1,13,12,0,0,8,4,Ben,Berlin,,per,PROPN,PROPN,compound,pobj,NNP,NNP,3,1
10975,9704.0,27,decided,10,10,26,16,9,0,0,16,Cook,Australia,,org,PROPN,PROPN,pobj,pobj,NNP,NNP,1,1
10976,9705.0,52,is,1,1,10,9,0,41,0,9,Fife,University of St Andrews,,per-per-per-per,NOUN,PROPN-ADP-PROPN-PROPN,nsubj,appos-prep-pobj-pobj,NN,NNP-IN-NNP-NNP,6,1
10977,9706.0,22,joins,8,2,7,5,1,14,6,-1,National Union of Mineworkers,NUM,org-org-org-org,,PROPN-PROPN-ADP-PROPN,PROPN,compound-nsubj-prep-pobj,appos,NNP-NNP-IN-NNP,NNP,2,1
10978,11536.0,24,served,1,17,22,5,16,1,-16,21,National Union of Mineworkers,NUM,org-org-org-org,,PROPN-PROPN-ADP-PROPN,PROPN,compound-pobj-prep-pobj,appos,NNP-NNP-IN-NNP,NNP,4,1
10979,9707.0,30,had,25,17,19,2,16,10,8,-6,Arizona,Meat Puppets,,per-per,PROPN,PROPN-PROPN,poss,compound-conj,NNP,NNP-NNPS,2,1
10980,9708.0,29,Bank,2,10,27,17,9,1,-8,25,Counties Bank,United Kingdom,org-org,-,PROPN-PROPN,PROPN-PROPN,conj-conj,compound-pobj,NNPS-NNP,NNP-NNP,8,1
10981,9709.0,33,returned,1,1,20,19,0,12,0,19,He,Dial,,per,PRON,PROPN,nsubj,conj,PRP,NNP,6,1
10982,9710.0,8,owned,3,1,6,5,0,1,2,3,Foxtel,News Corporation,per,-,PROPN,PROPN-PROPN,nsubjpass,compound-pobj,NNP,NNP-NNP,3,1
10983,9711.0,24,is,16,2,23,21,1,0,14,7,University of Cienfuegos,Cuba,org-org-org,,PROPN-ADP-PROPN,PROPN,nmod-prep-pobj,pobj,NNP-IN-NNP,NNP,4,1
10984,9712.0,20,was,6,2,14,12,1,5,4,8,Kriegsmarine,Nazi Germany,per,-,PROPN,PROPN-PROPN,nsubj,compound-pobj,NNP,NNP-NNP,7,1
10985,9714.0,42,said,30,19,24,5,18,17,11,-6,PNC Financial Services,Pittsburgh,per-per-per,,PROPN-PROPN-PROPN,PROPN,compound-compound-compound,pobj,NNP-NNP-NNPS,NNP,5,1
10986,9716.0,39,is,8,1,24,23,0,14,7,16,Oliver Tobias,Switzerland,-,org,PROPN-PROPN,PROPN,compound-nsubj,pobj,NNP-NNP,NNP,3,1
10987,9717.0,27,is,2,9,13,4,8,13,-7,11,Sam Roberts,Canada,per-per,,PROPN-PROPN,PROPN,compound-pobj,pobj,NNP-NNP,NNP,2,1
10988,9718.0,63,said,27,23,27,4,22,35,4,0,Yigal Carmon,Memri,-,org,PROPN-PROPN,PROPN,compound-nsubj,dobj,NNP-NNP,NNP,4,1
10989,9719.0,24,is,4,16,18,2,15,5,-12,14,Havana,La Habana,org,-,PROPN,PROPN-PROPN,pobj,compound-nmod,NNP,NNP-NNP,5,1
10990,9721.0,34,served,5,24,26,2,23,7,-19,21,University of North Carolina at Pembroke,North Carolina,-----,org-org,PROPN-ADP-PROPN-PROPN-ADP-PROPN,PROPN-PROPN,pobj-prep-compound-pobj-prep-pobj,compound-pobj,NNP-IN-NNP-NNP-IN-NNP,NNP-NNP,3,1
10991,9722.0,34,said,29,2,23,21,1,10,27,-6,Icelandic Financial Supervisory Authority,Iceland,---,org,PROPN-PROPN-PROPN-PROPN,PROPN,compound-compound-compound-nsubj,poss,NNP-NNP-NNP-NNP,NNP,7,1
10992,11831.0,39,said,28,6,26,20,5,12,22,-2,Icelandic Financial Supervisory Authority,Iceland,per-per-per-per,,PROPN-PROPN-PROPN-PROPN,PROPN,nmod-compound-compound-nmod,pobj,NNP-NNP-NNP-NNP,NNP,5,1
10993,9723.0,53,said,30,9,29,20,8,23,21,-1,MTR,Hong Kong,,per-per,PROPN,PROPN-PROPN,appos,compound-pobj,NNP,NNP-NNP,9,1
10994,9725.0,40,decided,2,34,39,5,33,0,-32,37,him,England,per,,PRON,PROPN,dobj,pobj,PRP,NNP,9,1
10995,9726.0,15,is,4,2,12,10,1,2,2,8,Community High School,Illinois,--,org,PROPN-PROPN-PROPN,PROPN,compound-compound-nsubj,compound,NNP-NNP-NNP,NNP,7,1
10996,11308.0,37,known,4,1,26,25,0,10,3,22,Community High School,Illinois,org-org-org,,PROPN-PROPN-PROPN,PROPN,compound-compound-nsubj,pobj,NNP-NNP-NNP,NNP,6,1
10997,9727.0,7,England,5,1,4,3,0,2,4,-1,Royal Masonic School,Rickmansworth,per-per-per,,PROPN-PROPN-PROPN,PROPN,compound-compound-compound,compound,NNP-NNP-NNP,NNP,4,1
10998,9728.0,25,hold,1,19,23,4,18,1,-18,22,Olivet Nazarene University,Bourbonnais,org-org-org,,PROPN-PROPN-PROPN,PROPN,compound-compound-pobj,compound,NNP-NNP-NNP,NNP,2,1
10999,9729.0,36,created,6,9,1,-8,8,34,-3,-5,1974,British Overseas Airways Corporation,org,---,NUM,PROPN-PROPN-PROPN-PROPN,pobj,amod-compound-compound-nsubjpass,CD,NNP-NNP-NNPS-NNP,5,1
11000,9731.0,25,is,7,1,22,21,0,2,6,15,Virtusa,Westborough,org,,PROPN,PROPN,compound,compound,NNP,NNP,7,1
11001,9733.0,44,is,1,15,26,11,14,17,-14,25,of Dr Yeoh Ghi,ent of Sin,per-per-per-per,--,ADP-PROPN-PROPN-PROPN,NOUN-ADP-NOUN,prep-compound-pobj-compound,appos-prep-pobj,IN-NNP-NNP-NNP,NN-IN-NN,10,1
11002,9735.0,26,launched,12,16,25,9,15,0,-4,13,Hyundai Heavy Industries,Ulsan,org-org-org,,PROPN-PROPN-PROPN,PROPN,compound-compound-compound,pobj,NNP-NNP-NNPS,NNP,4,1
11003,9736.0,30,meet,3,1,16,15,0,13,2,13,Ajax,Australia,,per,PROPN,PROPN,nsubj,pobj,NNP,NNP,2,1
11004,9737.0,29,reside,4,9,25,16,8,3,-5,21,he,Alabama,,per,PRON,PROPN,nsubj,compound,PRP,NNP,5,1
11005,10328.0,25,inducted,4,3,18,15,2,6,1,14,he,Alabama,per,,PRON,PROPN,nsubjpass,compound,PRP,NNP,5,1
11006,9738.0,22,joined,4,1,15,14,0,6,3,11,England,Premier League,per,-,PROPN,PROPN-PROPN,compound,compound-compound,NNP,NNP-NNP,6,1
11007,9740.0,14,served,6,3,13,10,2,0,3,7,Nathan A. Farwell,Maine,--,per,PROPN-PROPN-PROPN,PROPN,compound-compound-appos,pobj,NNP-NNP-NNP,NNP,3,1
11008,9741.0,24,returned,14,14,17,3,13,6,0,3,Anwar,Pakistan,per,,PROPN,PROPN,pobj,pobj,NNP,NNP,1,1
11009,9742.0,50,thought,2,11,13,2,10,36,-9,11,MCA,Tan Siew Sin,,org-org-org,PROPN,PROPN-PROPN-PROPN,compound,compound-compound-poss,NNP,NNP-NNP-NNP,2,1
11010,9745.0,33,funded,13,18,18,0,17,14,-5,5,Columbia,Columbia International University,per,--,PROPN,PROPN-PROPN-PROPN,compound,compound-compound-oprd,NNP,NNP-NNP-NNP,0,1
11011,9746.0,20,broadcasting,1,14,19,5,13,0,-13,18,Progressive Broadcasting Corporation,Philippines,per-per-per,,PROPN-PROPN-PROPN,PROPN,compound-compound-pobj,pobj,NNP-NNP-NNP,NNP,5,1
11012,9747.0,23,met,1,3,22,19,2,0,-2,21,Yoko Ono,Tokyo,per-per,,PROPN-PROPN,PROPN,compound-dobj,pobj,NNP-NNP,NNP,2,1
11013,9748.0,48,announced,19,13,19,6,12,28,6,0,Wales,University,,per,PROPN,PROPN,pobj,nsubj,NNP,NNP,6,1
11014,9752.0,53,is,16,2,16,14,1,36,14,0,Ocean Park Conservation Foundation,OPCFHK,org-org-org-org,,PROPN-PROPN-PROPN-PROPN,PROPN,compound-compound-compound-compound,appos,NNP-NNP-NNP-NNP,NNP,3,1
11015,9753.0,35,elected,16,13,29,16,12,5,3,13,Claiborne Pell,Rhode Island,org-org,-,PROPN-PROPN,PROPN-PROPN,compound-compound,compound-compound,NNP-NNP,NNP-NNP,10,1
11016,9756.0,22,created,11,5,21,16,4,0,6,10,Narayan Gopal,Nepal,-,org,PROPN-PROPN,PROPN,compound-dobj,pobj,NNP-NNP,NNP,4,1
11017,9759.0,22,is,8,1,18,17,0,3,7,10,Macky Sall,Senegal,org-org,,PROPN-PROPN,PROPN,compound-nsubj,pobj,NNP-NNP,NNP,4,1
11018,9760.0,25,was,6,5,17,12,4,7,1,11,Continental Army,his,org-org,,PROPN-PROPN,DET,compound-pobj,poss,NNP-NNP,PRP$,5,1
11019,13149.0,42,saying,1,27,7,-20,26,34,-26,6,Continental Army,his,org-org,,PROPN-PROPN,DET,compound-pobj,poss,NNP-NNP,PRP$,8,1
11020,9761.0,38,used,3,31,34,3,30,3,-28,31,Telstra,BigPond,org,,PROPN,PROPN,pobj,compound,NNP,NNP,2,1
11021,9762.0,21,said,19,1,14,13,0,6,18,-5,Tellme,Microsoft,,org,PROPN,PROPN,nsubj,poss,NNP,NNP,7,1
11022,9763.0,34,saw,4,13,31,18,12,2,-9,27,1981,IRNA,,per,NUM,PROPN,pobj,appos,CD,NNP,7,1
11023,9766.0,30,renamed,6,6,11,5,5,18,0,5,Seattle,Safeco,per,,PROPN,PROPN,pobj,compound,NNP,NNP,4,1
11024,9767.0,39,urged,1,1,14,13,0,24,0,13,She,Ecuador,,org,PRON,PROPN,nsubj,poss,PRP,NNP,8,1
11025,9770.0,52,maintained,3,22,35,13,21,16,-19,32,University College London,Francis Crick,org-org-org,-,PROPN-PROPN-PROPN,PROPN-PROPN,compound-compound-appos,compound-compound,NNP-NNP-NNP,NNP-NNP,9,1
11026,9771.0,25,is,2,10,20,10,9,4,-8,18,Maria,Universal Music Norway,per,--,PROPN,PROPN-PROPN-PROPN,compound,compound-compound-pobj,NNP,NNP-NNP-NNP,5,1
11027,9772.0,19,partnered,1,8,13,5,7,5,-7,12,Lee Shau Kee,Sun Hung Kai Properties,--,org-org-org-org,PROPN-PROPN-PROPN,PROPN-PROPN-PROPN-PROPN,compound-compound-conj,compound-compound-compound-dobj,NNP-NNP-NNP,NNP-NNP-NNP-NNP,7,1
11028,9773.0,18,attended,1,3,5,2,2,12,-2,4,Saddleback College,Mission Viejo,org-org,-,PROPN-PROPN,PROPN-PROPN,compound-compound,compound-compound,NNP-NNP,NNP-NNP,3,1
11029,9774.0,74,Taking,0,57,60,3,56,13,-57,60,Clere School,Hampshire,-,org,PROPN-PROPN,PROPN,compound-pobj,pobj,NNP-NNP,NNP,3,1
11030,9775.0,87,is,1,42,62,20,41,24,-41,61,Iran,Hooshang Kamkar,,per-per,PROPN,PROPN-PROPN,compound,compound-pobj,NNP,NNP-NNP,-1,1
11031,9776.0,34,is,3,14,20,6,13,13,-11,17,Air Vanuatu,1981,org-org,,PROPN-PROPN,NUM,compound-nsubjpass,pobj,NNP-NNP,CD,5,1
11032,9780.0,17,released,3,1,16,15,0,0,2,13,The Mess Hall,Australia,--,org,DET-PROPN-PROPN,PROPN,det-compound-nsubj,pobj,DT-NNP-NNP,NNP,3,1
11033,9782.0,35,grew,1,1,14,13,0,20,0,13,Mercury,Salvador,,per,NOUN,PROPN,nsubj,pobj,NN,NNP,1,1
11034,9783.0,57,became,2,6,14,8,5,42,-4,12,The South End,Wayne State University,org-org-org,--,DET-PROPN-PROPN,PROPN-PROPN-PROPN,det-compound-pobj,compound-compound-pobj,DT-NNP-NNP,NNP-NNP-NNP,5,1
11035,9784.0,18,love,2,8,11,3,7,6,-6,9,Pink Floyd,Syd Barrett,org-org,-,PROPN-PROPN,PROPN-PROPN,compound-pobj,compound-conj,NNP-NNP,NNP-NNP,1,1
11036,9785.0,16,was,5,1,13,12,0,2,4,8,His,Columbia,org,,DET,PROPN,poss,compound,PRP$,NNP,7,1
11037,9786.0,37,came,2,14,9,-5,13,27,-12,7,Andrei Gromyko,Soviet Union,org-org,-,PROPN-PROPN,PROPN-PROPN,compound-appos,compound-pobj,NNP-NNP,NNP-NNP,2,1
11038,10736.0,35,visited,10,5,9,4,4,25,5,-1,Andrei Gromyko,Soviet Union,per-per,-,PROPN-PROPN,PROPN-PROPN,compound-nsubj,compound-pobj,NNP-NNP,NNP-NNP,2,1
11039,9787.0,24,is,2,14,19,5,13,4,-12,17,Harvey,Thornton Township High School,per,---,PROPN,PROPN-PROPN-PROPN-PROPN,compound,compound-compound-compound-compound,NNP,NNP-NNP-NNP-NNP,7,1
11040,9788.0,33,hiked,3,8,13,5,7,19,-5,10,Portugal Telecom,Vivo,org-org,,PROPN-PROPN,PROPN,compound-poss,pobj,NNP-NNP,NNP,5,1
11041,9789.0,34,scheduled,6,25,28,3,24,5,-19,22,Colgate University,Hamilton,org-org,,PROPN-PROPN,PROPN,compound-pobj,compound,NNP-NNP,NNP,3,1
11042,9793.0,12,Rorsch,1,1,8,7,0,3,0,7,Arthur Rorsch,Leiden University,org-org,-,PROPN-PROPN,PROPN-PROPN,compound-ROOT,compound-compound,NNP-NNP,NNP-NNP,2,1
11043,9795.0,28,is,8,2,20,18,1,7,6,12,179th Airlift Wing,Mansfield,per-per-per,,ADJ-PROPN-PROPN,PROPN,amod-compound-nsubj,compound,JJ-NNP-NNP,NNP,10,1
11044,9796.0,26,edited,3,7,10,3,6,15,-4,7,Edge,Tony Mott,,org-org,PROPN,PROPN-PROPN,compound,compound-pobj,NNP,NNP-NNP,2,1
11045,9798.0,36,said,5,2,4,2,1,31,3,-1,Bank of Greece,Greece,org-org-org,,PROPN-ADP-PROPN,PROPN,nmod-prep-pobj,poss,NNP-IN-NNP,NNP,2,1
11046,9799.0,33,'s,1,1,16,15,0,16,0,15,Gessle,Roxette,per,,PROPN,PROPN,nsubj,dobj,NNP,NNP,-1,1
11047,9800.0,16,attend,14,2,4,2,1,11,12,-10,Prime Minister,Yves Leterme,-,org-org,PROPN-PROPN,PROPN-PROPN,compound-compound,compound-nsubj,NNP-NNP,NNP-NNP,1,1
11048,10339.0,25,offered,10,1,3,2,0,21,9,-7,Prime Minister,Yves Leterme,-,org-org,PROPN-PROPN,PROPN-PROPN,compound-compound,compound-nsubj,NNP-NNP,NNP-NNP,1,1
11049,11110.0,49,attend,3,38,40,2,37,8,-35,37,Prime Minister,Yves Leterme,per-per,-,PROPN-PROPN,PROPN-PROPN,compound-appos,compound-appos,NNP-NNP,NNP-NNP,1,1
11050,9801.0,24,In,0,19,22,3,18,1,-19,22,Trent University,Peterborough,org-org,,PROPN-PROPN,PROPN,compound-pobj,compound,NNP-NNP,NNP,3,1
11051,9804.0,64,SA,5,11,24,13,10,39,-6,19,Kevin J. Todeschi,Atlantic University,--,per-per,PROPN-PROPN-PROPN,PROPN-PROPN,compound-compound-nsubj,compound-conj,NNP-NNP-NNP,NNP-NNP,9,1
11052,9805.0,55,located,21,15,42,27,14,12,6,21,Brewers Fayre,Whitbread,-,per,PROPN-PROPN,PROPN,compound-pobj,nsubj,NNPS-NNP,NNP,7,1
11053,9807.0,56,are,8,8,26,18,7,29,0,18,Montevideo,ANTEL,,org,PROPN,PROPN,pobj,compound,NNP,NNP,6,1
11054,9808.0,24,represented,7,3,20,17,2,3,4,13,Virginia Tech Hokies,Division I-A,org-org-org,-,PROPN-PROPN-PROPN,PROPN-PROPN,compound-compound-compound,compound-compound,NNP-NNP-NNP,NNP-NNP,7,1
11055,9811.0,50,Founded,0,10,11,1,9,38,-10,11,guitarist,Mom?ilo Bajagi,per,-,NOUN,PROPN-PROPN,conj,compound-pobj,NN,NNP-NNP,2,1
11056,9814.0,37,fell,2,2,26,24,1,10,0,24,Zhivkov,Bulgaria,,per,PROPN,PROPN,nsubj,poss,NNP,NNP,8,1
11057,9816.0,30,is,8,2,3,1,1,26,6,-5,North Halifax Grammar School,Halifax,per-per-per-per,,PROPN-PROPN-PROPN-PROPN,PROPN,compound-compound-compound-nsubj,compound,NNP-NNP-NNP-NNP,NNP,2,1
11058,9817.0,14,Returning,0,4,12,8,3,1,-4,12,Turkey,Universit,per,,PROPN,PROPN,pobj,compound,NNP,NNP,3,1
11059,9818.0,23,released,1,1,10,9,0,12,0,9,He,MFS,per,,PRON,PROPN,nsubj,pobj,PRP,NNP,2,1
11060,9820.0,55,holotype,1,43,44,1,42,10,-42,43,Universitas Andalas,Andalas University,-,per-per,PROPN-PROPN,PROPN-PROPN,compound-pobj,compound-pobj,NNP-NNP,NNP-NNP,1,1
11061,9822.0,36,announced,4,29,34,5,28,1,-25,30,London General,Go-Ahead Group,per-per,-,PROPN-PROPN,PROPN-PROPN,compound-pobj,compound-pobj,NNP-NNP,NNP-NNP,4,1
11062,9823.0,15,is,2,2,11,9,1,3,0,9,MSM,Jugnauth,,per,PROPN,PROPN,nsubj,compound,NNP,NNP,4,1
11063,9825.0,37,joined,11,14,26,12,13,10,-3,15,Paul Gilbert,Mr. Big,-,org-org,PROPN-PROPN,PROPN-PROPN,compound-pobj,compound-dobj,NNP-NNP,NNP-NNP,-1,1
11064,9826.0,37,said,35,5,28,23,4,8,30,-7,Koenigsegg,Saab Automobile AB,,org-org-org,PROPN,PROPN-PROPN-PROPN,compound,compound-compound-pobj,NNP,NNP-NNP-NNP,13,1
11065,9827.0,25,taught,4,12,15,3,11,9,-8,11,Carrie Brownstein,Sleater-Kinney,per-per,,PROPN-PROPN,ADJ,compound-pobj,amod,NNP-NNP,JJ,3,1
11066,9828.0,16,built,4,1,8,7,0,7,3,4,Florida International University,1965,--,per,PROPN-PROPN-PROPN,NUM,compound-compound-nsubjpass,pobj,NNP-NNP-NNP,CD,3,1
11067,9829.0,21,ended,11,3,5,2,2,15,8,-6,Galp Energia,Portugal,-,org,PROPN-PROPN,PROPN,compound-compound,poss,NNP-NNP,NNP,2,1
11068,9830.0,30,continued,4,4,21,17,3,8,0,17,Grappelli,France,per,,PROPN,PROPN,conj,pobj,NNP,NNP,5,1
11069,9831.0,17,established,8,5,16,11,4,0,3,8,CHUM Radio,Canada,-,per,PROPN-PROPN,PROPN,compound-compound,pobj,NNP-NNP,NNP,3,1
11070,9832.0,41,failed,6,26,30,4,25,10,-20,24,Malaysian Indian Congress,Samy Vellu,--,per-per,ADJ-ADJ-PROPN,PROPN-PROPN,amod-amod-compound,compound-pobj,JJ-JJ-NNP,NNP-NNP,4,1
11071,9836.0,43,consists,27,5,26,21,4,16,22,-1,Turkish Airlines,AnadoluJet,org-org,,PROPN-PROPN,PROPN,compound-nsubj,pobj,NNP-NNPS,NNP,4,1
11072,9837.0,20,represented,7,3,3,0,2,16,4,-4,Cornell Big Red,Cornell University,org-org-org,-,PROPN-PROPN-PROPN,PROPN-PROPN,compound-compound-compound,compound-dobj,NNP-NNP-NNP,NNP-NNP,0,1
11073,11200.0,26,represent,11,4,4,0,3,21,7,-7,Cornell Big Red,Cornell University,--,org-org,PROPN-PROPN-PROPN,PROPN-PROPN,nmod-nmod-nmod,compound-dobj,NNP-NNP-NNP,NNP-NNP,0,1
11074,9838.0,39,refers,16,9,16,7,8,22,7,0,Tuomas Holopainen,Nightwish,-,per,PROPN-PROPN,PROPN,compound-nsubj,pobj,NNP-NNP,NNP,2,1
11075,9839.0,24,spread,11,1,22,21,0,1,10,11,Guru Ghasidas University,Bilaspur,org-org-org,,PROPN-PROPN-PROPN,PROPN,compound-compound-nsubj,amod,NNP-NNP-NNP,NNP,7,1
11076,9840.0,21,attended,5,7,12,5,6,8,-2,7,Eckerd College,Florida,-,per,PROPN-PROPN,PROPN,compound-dobj,pobj,NNP-NNP,NNP,6,1
11077,9841.0,17,is,3,5,14,9,4,2,-2,11,Dave Quest,Strathcona,-,per,PROPN-PROPN,PROPN,compound-attr,pobj,NNP-NNP,NNP,2,1
11078,9842.0,13,arrived,11,8,9,1,7,3,3,-2,Vietnam,Nguy?n T?n,org,-,PROPN,PROPN-PROPN,pobj,compound-compound,NNP,NNP-NNP,2,1
11079,10899.0,34,been,2,8,19,11,7,14,-6,17,Vietnam,Nguy?n T?n,,per-per,PROPN,PROPN-PROPN,pobj,compound-compound,NNP,NNP-NNP,9,1
11080,9843.0,15,elected,3,1,8,7,0,6,2,5,Premier Dexter,Nova Scotia New Democratic Party,per-per,----,PROPN-PROPN,PROPN-PROPN-PROPN-PROPN-PROPN,compound-nsubjpass,compound-compound-compound-compound-pobj,NNP-NNP,NNP-NNP-NNP-NNP-NNP,5,1
11081,9844.0,12,are,2,1,10,9,0,1,1,8,The Adicts,Suffolk,per-per,,DET-PROPN,PROPN,det-nsubj,compound,DT-NNPS,NNP,4,1
11082,9845.0,31,diagnosed,11,24,6,-18,23,24,-13,-5,Iona College,New Rochelle,per-per,-,PROPN-PROPN,PROPN-PROPN,compound-pobj,compound-compound,NNP-NNP,NNP-NNP,11,1
11083,9848.0,35,resigned,3,3,26,23,2,8,0,23,she,The Poozies,,per-per,PRON,DET-PROPN,nsubj,det-pobj,PRP,DT-NNPS,5,1
11084,9849.0,23,said,14,1,13,12,0,9,13,-1,Riordan,Los Angeles,per,-,NOUN,PROPN-PROPN,nsubj,compound-pobj,NN,NNP-NNP,5,1
11085,9853.0,26,separated,5,19,24,5,18,1,-14,19,United States,circus,org-org,,PROPN-PROPN,NOUN,compound-pobj,compound,NNP-NNP,NN,4,1
11086,9854.0,21,is,2,6,14,8,5,6,-4,12,Bethel College,United States,-,per-per,PROPN-PROPN,PROPN-PROPN,compound-pobj,compound-pobj,NNP-NNP,NNP-NNP,6,1
11087,10670.0,13,is,2,1,11,10,0,1,1,9,Bethel College,United States,org-org,-,PROPN-PROPN,PROPN-PROPN,compound-nsubj,compound-pobj,NNP-NNP,NNP-NNP,5,1
11088,9855.0,8,lost,2,1,7,6,0,0,1,5,HeidelbergCement,Germany,org,,PROPN,PROPN,compound,pobj,NNP,NNP,2,1
11089,9857.0,26,represents,8,4,11,7,3,14,4,3,UAB Blazers,University of Alabama at Birmingham,-,org-org-org-org-org,NOUN-PROPN,PROPN-ADP-PROPN-ADP-PROPN,compound-compound,dobj-prep-pobj-prep-pobj,NNS-NNPS,NNP-IN-NNP-IN-NNP,4,1
11090,12150.0,33,represented,6,3,9,6,2,23,3,3,UAB Blazers,University of Alabama at Birmingham,per-per,----,PROPN-PROPN,PROPN-ADP-PROPN-ADP-PROPN,compound-compound,dobj-prep-pobj-prep-pobj,NNP-NNPS,NNP-IN-NNP-IN-NNP,4,1
11091,9858.0,22,attempted,8,2,7,5,1,14,6,-1,Andrew Cunningham,Mediterranean Fleet,-,per-per,PROPN-PROPN,PROPN-PROPN,compound-compound,compound-pobj,NNP-NNP,NNP-NNP,3,1
11092,9860.0,33,returned,6,2,24,22,1,8,4,18,1865,The Hongkong and Shanghai Banking Corporation,org,-----,NUM,DET-PROPN-CCONJ-PROPN-PROPN-PROPN,pobj,det-nmod-cc-conj-compound-pobj,CD,DT-NNP-CC-NNP-NNP-NNP,7,1
11093,9861.0,24,is,2,2,8,6,1,15,0,6,University,Atlantic 10 Conference,org,--,PROPN,PROPN-NUM-PROPN,nsubj,nmod-nummod-pobj,NNP,NNP-CD-NNP,5,1
11094,9862.0,36,determined,10,2,13,11,1,22,8,3,Schleicher,Germany,org,,PROPN,PROPN,nsubjpass,nsubj,NNP,NNP,4,1
11095,9863.0,29,replaced,4,13,19,6,12,9,-9,15,The Zombies,Argent,per-per,,DET-PROPN,PROPN,det-nsubj,dobj,DT-NNPS,NNP,1,1
11096,9864.0,46,said,14,16,19,3,15,26,-2,5,Connecticut,Denise L. Nappier,,per-per-per,PROPN,PROPN-PROPN-PROPN,compound,compound-compound-ccomp,NNP,NNP-NNP-NNP,3,1
11097,12890.0,52,said,14,16,19,3,15,32,-2,5,Connecticut,Denise L. Nappier,org,--,PROPN,PROPN-PROPN-PROPN,compound,compound-compound-dobj,NNP,NNP-NNP-NNP,3,1
11098,9866.0,24,is,2,1,15,14,0,8,1,13,Ragged Flag,The Prodigy,-,per-per,PROPN-PROPN,DET-PROPN,compound-nsubj,det-appos,NNP-NNP,DT-NNP,6,1
11099,9867.0,10,strengthened,3,5,9,4,4,0,-2,6,De Gasperi,Italy,-,per,PROPN-PROPN,PROPN,compound-compound,pobj,NNP-NNP,NNP,3,1
11100,9868.0,58,prove,51,21,32,11,20,25,30,-19,Jazz Messengers,Cedar Walton,-,org-org,NOUN-PROPN,PROPN-PROPN,compound-conj,compound-pobj,NN-NNPS,NNP-NNP,7,1
11101,9869.0,31,is,8,2,2,0,1,28,6,-6,New Brunswick Community College,New Brunswick,org-org-org-org,-,PROPN-PROPN-PROPN-PROPN,PROPN-PROPN,compound-compound-compound-nsubj,compound-compound,NNP-NNP-NNP-NNP,NNP-NNP,0,1
11102,9870.0,16,started,7,7,15,8,6,0,0,8,Kowalski,Massachusetts,per,,PROPN,PROPN,pobj,pobj,NNP,NNP,1,1
11103,9872.0,29,Eda-Ines,0,1,17,16,0,11,-1,17,Eda-Ines Etti,Estonia,-,org,PROPN-PROPN,PROPN,ROOT-nsubj,pobj,NNPS-NNP,NNP,4,1
11104,9873.0,38,says,36,6,29,23,5,8,30,-7,IKB Deutsche Industriebank,Lone Star Funds,per-per-per,--,PROPN-PROPN-PROPN,PROPN-PROPN-VERB,compound-compound-compound,compound-compound-pobj,NNP-NNP-NNP,NNP-NNP-VBZ,7,1
11105,9874.0,64,designed,43,38,58,20,37,5,5,15,Marion Koogler McNay,San Antonio,--,org-org,PROPN-PROPN-PROPN,PROPN-PROPN,compound-compound-compound,compound-pobj,NNP-NNP-NNP,NNP-NNP,7,1
11106,9875.0,22,announced,13,6,21,15,5,0,7,8,British Airways,Oneworld,-,per,PROPN-PROPN,PROPN,compound-compound,appos,NNP-NNP,NNP,4,1
11107,9876.0,62,picketed,11,31,4,-27,30,57,-20,-7,UK,Starbucks Workers Union,,org-org-org,PROPN,PROPN-PROPN-PROPN,conj,compound-compound-compound,NNP,NNP-NNPS-NNP,9,1
11108,9877.0,21,is,3,2,3,1,1,17,1,0,France,Berrchem,per,,PROPN,PROPN,compound,pobj,NNP,NNP,2,1
11109,9878.0,25,established,7,2,13,11,1,11,5,6,Australian Academy of the Humanities,1969,per-per-per-per-per,,PROPN-PROPN-ADP-DET-PROPN,NUM,compound-nsubjpass-prep-det-pobj,pobj,NNP-NNP-IN-DT-NNPS,CD,3,1
11110,9879.0,27,born,3,8,25,17,7,1,-5,22,California Institute of the Arts,Valencia,----,per,PROPN-PROPN-ADP-DET-PROPN,PROPN,compound-pobj-prep-det-compound,compound,NNP-NNP-IN-DT-NNP,NNP,5,1
11111,9880.0,55,attempted,6,10,48,38,9,6,-4,42,Mitchell,Billy Mitchell,org,-,PROPN,PROPN-PROPN,nsubj,compound-dobj,NNP,NNP-NNP,4,1
11112,9881.0,17,is,1,6,13,7,5,3,-5,12,CONMEBOL,Colombia national football team,,org-org-org-org,PROPN,PROPN-ADJ-NOUN-NOUN,pobj,nmod-amod-compound-pobj,NNP,NNP-JJ-NN-NN,8,1
11113,9882.0,26,und,1,12,16,4,11,9,-11,15,Joseph Goebbels,Germany,per-per,,PROPN-PROPN,PROPN,compound-pobj,conj,NNP-NNP,NNP,3,1
11114,9883.0,17,published,3,3,15,12,2,1,0,12,Fogerty,Warner Bros,,org-org,PROPN,PROPN-PROPN,nsubj,compound-pobj,NNP,NNP-NNP,5,1
11115,9885.0,36,Best,1,4,27,23,3,8,-3,26,Belgium,Guy Verhofstadt,,per-per,PROPN,PROPN-PROPN,pobj,compound-pobj,NNP,NNP-NNP,10,1
11116,12402.0,25,along,1,18,23,5,17,1,-17,22,Belgium,Guy Verhofstadt,per,-,PROPN,PROPN-PROPN,pobj,compound-conj,NNP,NNP-NNP,2,1
11117,9886.0,21,is,6,2,20,18,1,0,4,14,Ball State Cardinals,USA,--,org,PROPN-PROPN-PROPN,PROPN,compound-compound-compound,pobj,NNP-NNP-NNPS,NNP,4,1
11118,9887.0,17,News,1,6,8,2,5,8,-5,7,USA,Trial,,per,PROPN,PROPN,nmod,nsubj,NNP,NNP,3,1
11119,9889.0,37,orchestrated,3,11,12,1,10,24,-8,9,State,Robert B. Zoellick,,org-org-org,PROPN,PROPN-PROPN-PROPN,pobj,compound-compound-compound,NNP,NNP-NNP-NNP,2,1
11120,9890.0,25,is,8,1,17,16,0,7,7,9,Michael Smith,Tampa Bay Buccaneers,org-org,--,PROPN-PROPN,PROPN-PROPN-NOUN,compound-nsubj,compound-compound-pobj,NNP-NNP,NNP-NNP-NNS,6,1
11121,9891.0,15,charted,5,1,4,3,0,10,4,-1,Gretchen Wilson,Pocahontas,per-per,,PROPN-PROPN,PROPN,compound-nsubj,compound,NNP-NNP,NNP,1,1
11122,9892.0,15,is,2,1,14,13,0,0,1,12,Carina Round,England,org-org,,PROPN-PROPN,PROPN,compound-nsubj,pobj,NNP-NNP,NNP,5,1
11123,9894.0,29,novelizations,2,24,27,3,23,1,-22,25,George Lucas,Lucasfilm,per-per,,PROPN-PROPN,PROPN,compound-pobj,compound,NNP-NNP,NNP,2,1
11124,9895.0,27,delegation,2,22,25,3,21,1,-20,23,House,Marios Garoyian,org,-,PROPN,PROPN-PROPN,pobj,compound-pobj,NNP,NNP-NNP,5,1
11125,9896.0,34,is,10,4,6,2,3,27,6,-4,Gas Natural,Spain,-,per,PROPN-PROPN,PROPN,compound-compound,poss,NNP-NNP,NNP,1,1
11126,9897.0,29,signed,6,2,14,12,1,14,4,8,East African Community,Tanzania,per-per-per,,PROPN-PROPN-PROPN,PROPN,compound-compound-compound,pobj,NNP-NNP-NNP,NNP,4,1
11127,12610.0,45,made,1,20,28,8,19,16,-19,27,East African Community,Tanzania,--,per,PROPN-PROPN-PROPN,PROPN,compound-compound-pobj,pobj,NNP-NNP-NNP,NNP,5,1
11128,9898.0,20,collaborated,2,5,9,4,4,10,-3,7,Asian Man Records,Mike Park,--,per-per,PROPN-PROPN-PROPN,PROPN-PROPN,compound-compound-compound,compound-pobj,NNP-NNP-NNPS,NNP-NNP,3,1
11129,9899.0,26,came,2,8,25,17,7,0,-6,23,Dollar Tree,NASDAQ,-,per,PROPN-PROPN,PROPN,compound-compound,pobj,NNP-NNP,NNP,5,1
11130,9900.0,20,recruited,8,12,18,6,11,1,-4,10,Special Forces,Green Berets,org-org,-,PROPN-PROPN,PROPN-PROPN,compound-pobj,compound-pobj,NNP-NNPS,NNP-NNPS,3,1
11131,9901.0,21,met,6,10,13,3,9,7,-4,7,Nazim al-Kudsi,Syria,-,org,PROPN-NOUN,PROPN,compound-pobj,pobj,NNP-NN,NNP,2,1
11132,9902.0,26,removed,7,5,23,18,4,2,2,16,President,Pascoal Ranieri Mazzilli,per,--,PROPN,PROPN-PROPN-PROPN,compound,compound-compound-pobj,NNP,NNP-NNP-NNP,9,1
11133,9904.0,32,contacted,1,4,15,11,3,16,-3,14,National Oceanic and Atmospheric Administration,Department of Commerce,org-org-org-org-org,--,PROPN-PROPN-CCONJ-PROPN-PROPN,PROPN-ADP-PROPN,compound-dobj-cc-compound-conj,pobj-prep-pobj,NNP-NNP-CC-NNP-NNP,NNP-IN-NNP,5,1
11134,9906.0,25,is,10,19,24,5,18,0,-9,14,UW-Eau,WI,,per,PROPN,PROPN,compound,pobj,NNP,NNP,6,1
11135,9909.0,30,told,7,6,25,19,5,4,1,18,Natalie Maines,United States,org-org,-,PROPN-PROPN,PROPN-PROPN,compound-nsubj,compound-pobj,NNP-NNPS,NNP-NNP,7,1
11136,9910.0,60,been,2,33,57,24,32,2,-31,55,Labor,Rudd,per,,PROPN,PROPN,nsubj,pobj,NNP,NNP,-1,1
11137,9911.0,43,was,6,33,36,3,32,6,-27,30,AFL,Daniel Cross,,per-per,PROPN,PROPN-PROPN,compound,compound-pobj,NNP,NNP-NNP,2,1
11138,9912.0,32,include,4,12,14,2,11,17,-8,10,CNPC,Hong Kong,per,-,PROPN,PROPN-PROPN,conj,compound-npadvmod,NNP,NNP-NNP,3,1
11139,9913.0,40,incorporated,6,2,37,35,1,2,4,31,Federal Reserve System,United States,per-per-per,-,PROPN-PROPN-PROPN,PROPN-PROPN,compound-compound-nsubjpass,compound-compound,NNP-NNP-NNP,NNP-NNP,8,1
11140,9914.0,22,Limited,3,1,17,16,0,4,2,14,Hainan Airlines,Haikou,per-per,,PROPN-PROPN,PROPN,compound-compound,compound,NNP-NNPS,NNP,7,1
11141,9915.0,23,represented,1,1,3,2,0,19,0,2,Mikl,Austria,,per,PROPN,PROPN,nsubj,dobj,NNP,NNP,1,1
11142,9916.0,25,stated,2,12,18,6,11,6,-10,16,Public Service Alliance of Canada,PSAC,per-per-per-per-per,,PROPN-PROPN-PROPN-ADP-PROPN,PROPN,compound-compound-pobj-prep-pobj,appos,NNP-NNP-NNP-IN-NNP,NNP,3,1
11143,9919.0,39,Furnish,10,23,31,8,22,7,-13,21,Gately,he,org,,PROPN,PRON,poss,nsubj,NNP,PRP,3,1
11144,9920.0,21,were,2,6,17,11,5,3,-4,15,Abigail Adams,Massachusetts,per-per,,PROPN-PROPN,PROPN,compound-dobj,compound,NNP-NNP,NNP,7,1
11145,9921.0,32,said,17,1,19,18,0,12,16,2,Bear Stearns,James Cayne,-,org-org,PROPN-PROPN,PROPN-PROPN,compound-poss,compound-nsubj,NNP-NNP,NNP-NNP,4,1
11146,9923.0,31,said,12,5,8,3,4,22,7,-4,Chuck Grassley,Iowa,-,org,PROPN-PROPN,PROPN,compound-nsubj,pobj,NNP-NNP,NNP,3,1
11147,11582.0,41,teamed,8,2,6,4,1,34,6,-2,Chuck Grassley,Iowa,-,per,PROPN-PROPN,PROPN,compound-nsubj,compound,NNP-NNP,NNP,2,1
11148,9924.0,28,acting,4,1,3,2,0,24,3,-1,Treasury,Hugh McCulloch,,org-org,PROPN,PROPN-PROPN,compound,compound-nsubj,NNP,NNP-NNP,1,1
11149,9925.0,30,have,11,1,1,0,0,28,10,-10,Dubai World,Dubai,-,org,PROPN-PROPN,PROPN,compound-compound,compound,NNP-NNP,NNP,0,1
11150,9926.0,19,founded,4,1,12,11,0,6,3,8,Poisoned Pen Press,Robert Rosenwald,per-per-per,-,PROPN-PROPN-PROPN,PROPN-PROPN,compound-compound-nsubjpass,compound-pobj,NNP-NNP-NNP,NNP-NNP,4,1
11151,9927.0,35,attended,3,29,33,4,28,1,-26,30,Belize,Said Musa,per,-,PROPN,VERB-PROPN,poss,compound-appos,NNP,VBD-NNP,4,1
11152,9929.0,35,attended,13,4,4,0,3,30,9,-9,Rockford,Rockford College,,per-per,PROPN,PROPN-PROPN,compound,compound-dobj,NNP,NNP-NNP,0,1
11153,9930.0,20,became,3,10,18,8,9,1,-7,15,John F. Kennedy High School,Sacramento California,----,org-org,PROPN-PROPN-PROPN-PROPN-PROPN,PROPN-PROPN,compound-compound-compound-compound-compound,compound-pobj,NNP-NNP-NNP-NNP-NNP,NNP-NNP,6,1
11154,9934.0,23,played,4,11,16,5,10,6,-7,12,London,Charlie Watts,per,-,PROPN,PROPN-PROPN,pobj,compound-pobj,NNP,NNP-NNP,3,1
11155,9935.0,31,includes,6,24,29,5,23,1,-18,23,Inspectah Deck,Wu-Tang Clan,-,per-per,PROPN-PROPN,PROPN-PROPN,compound-appos,compound-pobj,NNP-NNP,NNP-NNP,6,1
11156,9936.0,24,reported,4,13,22,9,12,1,-9,18,him,United States,per,-,PRON,PROPN-PROPN,compound,compound-pobj,PRP,NNP-NNP,3,1
11157,9938.0,24,is,6,2,2,0,1,21,4,-4,University of Tennessee,University of Tennessee System,per-per-per,---,PROPN-ADP-PROPN,PROPN-ADP-PROPN-PROPN,nsubj-prep-pobj,nmod-prep-pobj-pobj,NNP-IN-NNP,NNP-IN-NNP-NNP,0,1
11158,9939.0,13,acted,2,8,11,3,7,1,-6,9,Sarah Bernhardt,Paris,-,org,PROPN-PROPN,PROPN,compound-pobj,compound,NNP-NNPS,NNP,2,1
11159,9940.0,24,is,4,3,13,10,2,10,1,9,Curt Anderson,Maryland,-,org,PROPN-PROPN,PROPN,compound-appos,compound,NNP-NNP,NNP,6,1
11160,9941.0,33,appointed,20,15,18,3,14,14,5,-2,SBS,Australia,,per,PROPN,PROPN,compound,compound,NNP,NNP,2,1
11161,9942.0,93,are,2,5,30,25,4,62,-3,28,Parton,actress,org,,PROPN,NOUN,nmod,compound,NNP,NN,-1,1
11162,9943.0,11,is,2,1,10,9,0,0,1,8,Central College,Texas,org-org,,PROPN-PROPN,PROPN,compound-nsubj,pobj,NNP-NNP,NNP,2,1
11163,9944.0,15,moved,3,6,3,-3,5,11,-3,0,New York,he,per-per,,PROPN-PROPN,PRON,compound-compound,nsubj,NNP-NNP,PRP,3,1
11164,9946.0,56,was,2,4,14,10,3,41,-2,12,Greece,Christos Dantis,per,-,PROPN,PROPN-PROPN,poss,compound-appos,NNP,NNP-NNP,6,1
11165,9947.0,29,ran,0,24,27,3,23,1,-24,27,Liberal,Jean Lapierre,per,-,ADJ,PROPN-PROPN,amod,compound-pobj,JJ,NNP-NNP,2,1
11166,9950.0,23,defeated,7,4,9,5,3,13,3,2,Hiram Fong,Hawaii,org-org,,PROPN-PROPN,PROPN,compound-pobj,poss,NNP-NNP,NNP,7,1
11167,9951.0,40,reported,4,18,39,21,17,0,-14,35,Vicente Rangel,Venezuela,-,per,PROPN-PROPN,PROPN,compound-nsubj,pobj,NNP-NNP,NNP,8,1
11168,9952.0,18,legend,14,8,16,8,7,1,6,2,Betty Davis,Miles Davis,per-per,-,PROPN-PROPN,PROPN-PROPN,compound-pobj,compound-dobj,NNP-NNP,NNP-NNP,4,1
11169,9953.0,20,takes,6,5,5,0,4,14,1,-1,Lisahally F.C.,Lisahally,-,per,PROPN-PROPN,PROPN,compound-nsubj,compound,NNP-NNP,NNP,0,1
11170,12526.0,18,founded,11,1,1,0,0,16,10,-10,Lisahally F.C.,Lisahally,-,org,PROPN-PROPN,PROPN,compound-nsubjpass,pobj,NNP-NNP,NNP,0,1
11171,9954.0,45,married,10,8,13,5,7,31,2,3,Mary of Teck,George,per-per-per,,PROPN-ADP-PROPN,PROPN,appos-prep-pobj,compound,NNP-IN-NNP,NNP,4,1
11172,9955.0,14,is,3,1,12,11,0,1,2,9,St Laurence School,Wiltshire,per-per-per,,PROPN-PROPN-PROPN,PROPN,compound-compound-nsubj,compound,NNP-NNP-NNP,NNP,5,1
11173,9956.0,12,elected,4,3,11,8,2,0,1,7,Montt,Chile,per,,PROPN,PROPN,nsubjpass,pobj,NNP,NNP,2,1
11174,9957.0,65,be,6,31,40,9,30,24,-25,34,Vermont,Patrick Leahy,,per-per,PROPN,PROPN-PROPN,compound,compound-compound,NNP,NNP-NNP,4,1
11175,9958.0,88,completed,1,60,74,14,59,13,-59,73,Ramkhamhaeng University,Thailand,-,org,PROPN-PROPN,PROPN,compound-pobj,poss,NNP-NNP,NNP,7,1
11176,9959.0,27,published,3,3,11,8,2,15,0,8,Benitez,Puerto Rico,,per-per,PROPN,PROPN-PROPN,nsubj,compound-appos,NNP,NNP-NNP,2,1
11177,9960.0,43,comes,2,24,31,7,23,11,-22,29,Anne,Henry,org,,PROPN,PROPN,dobj,compound,NNP,NNP,4,1
11178,9964.0,24,is,4,20,22,2,19,1,-16,18,Vanderbilt University,Nashville,org-org,,PROPN-PROPN,PROPN,compound-compound,compound,NNP-NNP,NNP,1,1
11179,13155.0,30,became,13,10,13,3,9,16,3,0,Vanderbilt University,Nashville,per-per,,PROPN-PROPN,PROPN,compound-pobj,pobj,NNP-NNP,NNP,4,1
11180,9966.0,19,said,12,14,16,2,13,2,-2,4,Yellowknife,Gordon Van Tighem,,per-per-per,PROPN,PROPN-PROPN-PROPN,compound,compound-compound-nsubj,NNP,NNP-NNP-NNP,2,1
11181,9967.0,12,States,3,1,3,2,0,8,2,0,David Martin,United States,per-per,-,PROPN-PROPN,PROPN-PROPN,compound-compound,compound-ROOT,NNP-NNP,NNP-NNP,1,1
11182,9968.0,30,was,5,2,2,0,1,27,3,-3,Cyprus College,Cyprus,-,org,PROPN-PROPN,PROPN,compound-nsubj,pobj,NNP-NNP,NNP,0,1
11183,9969.0,32,performance,2,6,15,9,5,16,-4,13,New York City,Elia Kazan,--,org-org,PROPN-PROPN-PROPN,PROPN-PROPN,compound-compound-pobj,compound-pobj,NNP-NNP-NNP,NNP-NNP,6,1
11184,9971.0,26,ordered,11,7,8,1,6,17,4,-3,Abkhazia,Sergei Bagapsh,,per-per,PROPN,PROPN-PROPN,compound,compound-pobj,NNP,NNP-NNP,2,1
11185,9972.0,23,released,2,1,15,14,0,7,1,13,John,Ant-Zen,,per,PROPN,PROPN,nsubj,compound,NNP,NNP,10,1
11186,9973.0,32,moved,1,1,5,4,0,26,0,4,He,Utah,per,,PRON,PROPN,nsubj,pobj,PRP,NNP,1,1
11187,9974.0,30,declared,19,16,26,10,15,3,3,7,ident Ho Chi,ic of Vi,--,per-per-per,NOUN-PROPN-PROPN,ADP-ADP-PROPN,csubj-compound-compound,npadvmod-prep-compound,NN-NNP-NNP,IN-IN-NNP,6,1
11188,9975.0,32,objected,6,1,10,9,0,21,5,4,Delaware,Nemours,,per,PROPN,PROPN,compound,compound,NNP,NNP,5,1
11189,9976.0,27,www.sc.edu/uscpress,24,11,19,8,10,7,13,-5,University of South Carolina,Columbia,org-org-org-org,,PROPN-ADP-PROPN-PROPN,PROPN,pobj-prep-compound-pobj,compound,NNP-IN-NNP-NNP,NNP,3,1
11190,11007.0,17,University,9,10,14,4,9,2,-1,5,University of South Carolina,Columbia,---,per,PROPN-ADP-PROPN-PROPN,PROPN,ROOT-prep-compound-compound,compound,NNP-IN-NNP-NNP,NNP,3,1
11191,9981.0,28,built,4,17,26,9,16,1,-13,22,Franklin D. Roosevelt,Hyde Park,--,per-per,PROPN-PROPN-PROPN,PROPN-PROPN,compound-compound-compound,compound-pobj,NNP-NNP-NNP,NNP-NNP,8,1
11192,9982.0,16,is,6,5,5,0,4,10,1,-1,Indiana,Indiana National Guard,,per-per-per,PROPN,PROPN-PROPN-PROPN,compound,compound-compound-pobj,NNP,NNP-NNP-NNP,0,1
11193,9983.0,20,following,1,14,19,5,13,0,-13,18,Westminster High School,California,per-per-per,,PROPN-PROPN-PROPN,PROPN,compound-compound-pobj,pobj,NNP-NNP-NNP,NNP,5,1
11194,9984.0,22,taught,7,5,7,2,4,14,2,0,Caracas,Gego,per,,PROPN,PROPN,compound,nsubj,NNP,NNP,5,1
11195,9985.0,32,was,2,1,25,24,0,6,1,23,Don Roach,West Adelaide,per-per,-,PROPN-PROPN,PROPN-PROPN,compound-nsubj,compound-compound,NNP-NNP,NNP-NNP,7,1
11196,9986.0,29,integrated,5,9,23,14,8,5,-4,18,AFL,AFL-CIO,,per,PROPN,NOUN,pobj,appos,NNP,NN,4,1
11197,12702.0,25,rejoined,4,7,23,16,6,1,-3,19,AFL,AFL-CIO,org,,PROPN,ADV,nsubj,appos,NNP,RB,4,1
11198,9987.0,16,play,2,2,6,4,1,9,0,4,Blues,Ontario,per,,PROPN,PROPN,nsubj,compound,NNPS,NNP,4,1
11199,9988.0,20,was,1,7,11,4,6,8,-6,10,Newcastle Knights,1988,-,per,PROPN-PROPN,NUM,compound-compound,pobj,NNP-NNPS,CD,3,1
11200,9989.0,34,is,11,1,25,24,0,8,10,14,Almaden,California,org,,PROPN,PROPN,oprd,compound,NNP,NNP,5,1
11201,9990.0,15,signed,2,1,8,7,0,6,1,6,He,Atlantic,org,,PRON,PROPN,nsubjpass,compound,PRP,NNP,6,1
11202,9991.0,17,is,3,1,15,14,0,1,2,12,Aquinas High School,Augusta,--,per,PROPN-PROPN-PROPN,PROPN,compound-compound-nsubj,compound,NNP-NNP-NNP,NNP,6,1
11203,9992.0,43,registered,8,2,2,0,1,40,6,-6,California Southern University,California,--,per,PROPN-PROPN-PROPN,PROPN,compound-compound-compound,pobj,NNP-NNP-NNP,NNP,0,1
11204,9993.0,16,http://www.tarletonsports.com/roster.aspx?rp_id=5028,0,7,7,0,6,8,-7,7,Ranger College,Ranger,-,org,PROPN-PROPN,PROPN,compound-pobj,compound,NNP-NNP,NNP,0,1
11205,9995.0,42,passed,23,12,22,10,11,19,11,-1,National Association of Teachers in Further and Higher Education,NATFHE,--------,per,PROPN-PROPN-ADP-PROPN-ADP-PROPN-CCONJ-PROPN-PROPN,PROPN,compound-appos-prep-pobj-prep-amod-cc-conj-pobj,appos,NNP-NNP-IN-NNPS-IN-NNP-CC-NNP-NNP,NNP,4,1
11206,9997.0,57,include,2,5,9,4,4,47,-3,7,Sally Ride,American,-,per,PROPN-PROPN,ADJ,compound-dobj,amod,NNP-NNP,JJ,2,1
11207,9998.0,26,began,6,1,23,22,0,2,5,17,France,Jean-Marie Le Pen,,per-per-per,PROPN,PROPN-PROPN-PROPN,poss,compound-compound-pobj,NNP,NNP-NNP-NNP,10,1
11208,9999.0,25,centralised,5,1,21,20,0,3,4,16,Egypt,Anwar Sadat,per,-,PROPN,PROPN-PROPN,poss,compound-pobj,NNP,NNP-NNP,7,1
11209,10002.0,25,released,2,1,19,18,0,5,1,17,Garnet Crow,Japan,-,org,PROPN-PROPN,PROPN,compound-nsubj,pobj,NNP-NNP,NNP,-1,1
11210,10004.0,24,is,5,2,5,3,1,18,3,0,American University of Kuwait,Kuwait,per-per-per-per,,PROPN-PROPN-ADP-PROPN,PROPN,compound-nsubj-prep-pobj,pobj,NNP-NNP-IN-NNP,NNP,1,1
11211,10005.0,35,scheduled,3,21,26,5,20,8,-18,23,Missy Elliott,artist,org-org,,PROPN-PROPN,NOUN,compound-pobj,nmod,NNP-NNP,NN,12,1
11212,10006.0,21,Look,0,10,11,1,9,9,-10,11,guitarist,Buckethead,per,,ADJ,PROPN,compound,pobj,JJ,NNP,2,1
11213,10009.0,54,known,4,30,53,23,29,0,-26,49,University of St. La Salle,Philippines,----,per,PROPN-ADP-PROPN-PROPN-PROPN,PROPN,nmod-prep-compound-pobj-pobj,pobj,NNP-IN-NNP-NNP-NNP,NNP,5,1
11214,10010.0,20,was,2,1,5,4,0,14,1,3,Rex,United States,,per-per,PROPN,PROPN-PROPN,compound,compound-attr,NNP,NNP-NNP,4,1
11215,10013.0,28,left,2,5,14,9,4,13,-3,12,L.L.Bean,1912,per,,PROPN,NUM,oprd,pobj,NNP,CD,3,1
11216,10014.0,12,is,1,1,10,9,0,1,0,9,Jones,Foreigner,per,,PROPN,PROPN,nsubj,compound,NNP,NNP,4,1
11217,10015.0,35,is,7,14,17,3,13,17,-7,10,Justicialist Party,Peronism,per-per,,PROPN-PROPN,PROPN,compound-pobj,appos,NNP-NNP,NNP,4,1
11218,10016.0,39,played,1,1,6,5,0,32,0,5,He,villain,per,,PRON,NOUN,nsubj,compound,PRP,NN,3,1
11219,10019.0,33,Tour,4,1,16,15,0,16,3,12,Namie Amuro,singer,org-org,,PROPN-PROPN,NOUN,compound-compound,pobj,NNP-NNP,NN,7,1
11220,10020.0,21,serves,3,1,1,0,0,19,2,-2,Hackensack High School,Hackensack,per-per-per,,PROPN-PROPN-PROPN,PROPN,compound-compound-nsubj,compound,NNP-NNP-NNP,NNP,0,1
11221,10021.0,14,is,5,4,8,4,3,5,1,3,MIRV,Iran,,per,PROPN,PROPN,appos,poss,NNP,NNP,5,1
11222,10022.0,47,released,9,15,30,15,14,16,-6,21,Interscope,Karen O,org,-,PROPN,PROPN-PROPN,pobj,compound-compound,NNP,NNP-NNP,10,1
11223,10024.0,72,Association,2,9,1,-8,8,70,-7,-1,United States,National Guard,per-per,-,PROPN-PROPN,PROPN-PROPN,compound-compound,compound-pobj,NNP-NNP,NNP-NNP,6,1
11224,10025.0,42,said,6,3,1,-2,2,40,3,-5,Benigno S. Aquino III,Philippine Airlines,org-org-org-org,-,PROPN-PROPN-PROPN-PROPN,PROPN-PROPN,compound-compound-compound-nsubj,compound-pobj,NNP-NNP-NNP-NNP,NNP-NNP,2,1
11225,10027.0,36,is,2,1,24,23,0,11,1,22,The Rocco Forte Collection,Sir Rocco Forte,---,per-per-per,DET-PROPN-PROPN-PROPN,PROPN-PROPN-PROPN,det-compound-compound-pobj,compound-compound-pobj,DT-NNP-NNP-NNP,NNP-NNP-NNP,8,1
11226,10028.0,15,admitted,2,6,9,3,5,5,-4,7,Maudsley Hospital,South London,org-org,-,PROPN-PROPN,PROPN-PROPN,compound-pobj,compound-pobj,NNP-NNP,NNP-NNP,2,1
11227,10029.0,43,written,2,16,26,10,15,16,-14,24,London,Cliff Richard,per,-,PROPN,PROPN-PROPN,compound,compound-conj,NNP,NNP-NNP,8,1
11228,10030.0,18,is,2,10,10,0,9,7,-8,8,Marvel UK,Marvel Comics,-,per-per,PROPN-PROPN,PROPN-PROPN,compound-compound,compound-pobj,NNP-NNP,NNP-NNP,0,1
11229,10031.0,39,had,15,26,33,7,25,5,-11,18,PIAA,LCHS,per,,PROPN,PROPN,compound,poss,NNP,NNP,8,1
11230,10032.0,25,decreed,8,6,21,15,5,3,2,13,Nicolae Ceau?esc,g Romani,org-org,-,PROPN-PROPN,PUNCT-PROPN,compound-pobj,det-nmod,NNP-NNP,",-NNP",-1,1
11231,10033.0,42,won,3,34,40,6,33,1,-31,37,Joyce Murray,Vancouver,-,per,PROPN-PROPN,PROPN,compound-conj,compound,NNP-NNP,NNP,6,1
11232,10034.0,29,is,3,18,24,6,17,4,-15,21,Houston,Rice University,org,-,PROPN,PROPN-PROPN,pobj,compound-compound,NNP,NNP-NNP,5,1
11233,10035.0,26,is,5,13,25,12,12,0,-8,20,Eva,Argentina,,per,PROPN,PROPN,pobj,pobj,NNP,NNP,3,1
11234,10037.0,22,were,4,9,13,4,8,8,-5,9,Cactus Air Force,Henderson Field,per-per-per,-,PROPN-PROPN-PROPN,PROPN-PROPN,compound-compound-pobj,compound-pobj,NNP-NNP-NNP,NNP-NNP,3,1
11235,10039.0,19,was,3,3,18,15,2,0,0,15,Park,Illinois,,per,PROPN,PROPN,nsubj,pobj,NNP,NNP,1,1
11236,10041.0,31,reelected,5,5,11,6,4,19,0,6,Maryland,Ritchie,,per,PROPN,PROPN,pobj,nsubj,NNP,NNP,1,1
11237,10042.0,14,considers,4,12,13,1,11,0,-8,9,Sukhoi,Su-34,per,,PROPN,PROPN,compound,subtok,NNP,NNP,4,1
11238,10043.0,39,is,5,24,36,12,23,2,-19,31,Spence School,New York City,per-per,--,PROPN-PROPN,PROPN-PROPN-PROPN,compound-appos,compound-compound-pobj,NNP-NNP,NNP-NNP-NNP,-1,1
11239,10044.0,20,Perhaps,0,6,9,3,5,10,-6,9,Minneapolis,Prince,,per,PROPN,PROPN,compound,compound,NNP,NNP,4,1
11240,10045.0,19,purchased,5,3,9,6,2,9,2,4,Corus Group,Tata Steel,org-org,-,PROPN-PROPN,PROPN-PROPN,compound-nsubjpass,compound-pobj,NNP-NNP,NNP-NNP,4,1
11241,10046.0,17,born,2,9,13,4,8,3,-7,11,Arizona,Red Mountain High School,,org-org-org-org,PROPN,PROPN-PROPN-PROPN-PROPN,pobj,compound-compound-compound-dobj,NNP,NNP-NNP-NNP-NNP,3,1
11242,10047.0,31,remained,7,6,21,15,5,9,1,14,Canada,Bank of Canada,org,--,PROPN,PROPN-ADP-PROPN,pobj,nsubj-prep-poss,NNP,NNP-IN-NNP,6,1
11243,11425.0,25,located,11,7,19,12,6,5,4,8,Canada,Bank of Canada,,per-per-per,PROPN,PROPN-ADP-PROPN,poss,pobj-prep-pobj,NNP,NNP-IN-NNP,8,1
11244,10050.0,39,attended,2,7,10,3,6,28,-5,8,Michael Somare,Papua New Guinea,-,org-org-org,PROPN-PROPN,PROPN-PROPN-PROPN,compound-pobj,compound-compound-compound,NNP-NNP,NNP-NNP-NNP,4,1
11245,10051.0,23,Sees,2,11,21,10,10,1,-9,19,Butthole Surfers,Go,-,org,PROPN-PROPN,VERB,compound-pobj,conj,NNP-NNPS,VB,3,1
11246,10052.0,15,founded,7,3,13,10,2,1,4,6,The Walt Disney Company,Roy Disney,org-org-org-org,-,DET-PROPN-PROPN-PROPN,PROPN-PROPN,det-compound-compound-nsubjpass,compound-conj,DT-NNP-NNP-NNP,NNP-NNP,5,1
11247,10053.0,28,At,0,21,27,6,20,0,-21,27,Bill Nighy,Actor,per-per,,PROPN-PROPN,PROPN,compound-nsubjpass,pobj,NNP-NNP,NNP,4,1
11248,10056.0,18,protested,8,7,14,7,6,3,1,6,Ottawa,Dalton McGuinty,org,-,PROPN,PROPN-PROPN,compound,compound-poss,NNP,NNP-NNP,7,1
11249,10057.0,32,stretches,6,5,18,13,4,13,1,12,Portland Timbers,North American Soccer League,org-org,---,PROPN-PROPN,PROPN-PROPN-PROPN-PROPN,compound-pobj,compound-compound-compound-dobj,NNP-NNPS,NNP-NNP-NNP-NNP,6,1
11250,10059.0,13,lost,11,1,6,5,0,6,10,-5,Mike DeWine,Ohio,org-org,,PROPN-PROPN,PROPN,compound-nsubj,pobj,NNP-NNP,NNP,4,1
11251,10060.0,34,called,10,6,8,2,5,25,4,-2,Prime Minister,Girija Prasad Koirala,-,per-per-per,PROPN-PROPN,PROPN-PROPN-PROPN,compound-compound,compound-compound-nsubj,NNP-NNP,NNP-NNP-NNP,2,1
11252,10061.0,23,was,11,1,14,13,0,8,10,3,Ion Valentin Anestin,Romanian,per-per-per,,PROPN-PROPN-PROPN,ADJ,compound-compound-nsubj,amod,NNP-NNP-NNP,JJ,6,1
11253,10062.0,24,learn,2,14,17,3,13,6,-12,15,Neil Peart,Rush,-,per,PROPN-PROPN,PROPN,compound-dep,pobj,NNP-NNP,NNP,2,1
11254,10063.0,37,is,13,1,23,22,0,13,12,10,Antonio Fazio,Banca d'Italia,-,per-per,PROPN-PROPN,PROPN-PROPN,compound-nsubj,pobj-appos,NNP-NNP,NNP-NNP,6,1
11255,10064.0,28,caught,6,17,21,4,16,6,-11,15,his,Klein,,per,DET,PROPN,poss,compound,PRP$,NNP,3,1
11256,10066.0,35,But,0,5,15,10,4,19,-5,15,Junaid Jamshed,Vital Signs,per-per,-,PROPN-PROPN,PROPN-PROPN,compound-pobj,compound-pobj,NNP-NNP,NNP-NNPS,6,1
11257,10067.0,34,Formigoni,0,1,8,7,0,25,-1,8,Formigoni,Lombardy,per,,PROPN,PROPN,ROOT,pobj,NNP,NNP,2,1
11258,10068.0,31,Co,1,12,14,2,11,16,-11,13,Panasonic,Matsushita Electric Industrial Co.,org,---,PROPN,PROPN-PROPN-PROPN-PROPN,amod,compound-compound-compound-pobj,NNP,NNP-NNP-NNP-NNP,2,1
11259,10070.0,18,is,5,2,17,15,1,0,3,12,Middlesex Senior Charity Cup,1901,---,per,PROPN-PROPN-PROPN-PROPN,NUM,compound-compound-compound-nsubj,pobj,NNP-NNP-NNP-NNP,CD,5,1
11260,10071.0,14,released,3,3,10,7,2,3,0,7,she,Winnipeg,org,,PRON,ADJ,nsubj,compound,PRP,JJ,2,1
11261,10072.0,46,came,3,9,14,5,8,31,-6,11,Lady Jane Franklin,John Franklin,--,per-per,PROPN-PROPN-PROPN,PROPN-PROPN,compound-compound-compound,compound-compound,NNP-NNP-NNP,NNP-NNP,5,1
11262,10073.0,26,received,1,8,17,9,7,8,-7,16,California State University,Long Beach,org-org-org,-,PROPN-PROPN-PROPN,PROPN-PROPN,compound-compound-compound,compound-pobj,NNP-NNP-NNP,NNP-NNP,4,1
11263,10074.0,29,merged,23,2,8,6,1,20,21,-15,2006,Torrent Power,per,-,NUM,PROPN-PROPN,pobj,compound-compound,CD,NNP-NNP,2,1
11264,10075.0,34,say,1,8,30,22,7,3,-7,29,his,International Atomic Energy Agency,,per-per-per-per,DET,PROPN-PROPN-PROPN-PROPN,poss,compound-compound-compound-pobj,PRP$,NNP-NNP-NNP-NNP,11,1
11265,10076.0,20,was,1,1,12,11,0,7,0,11,He,Denver,org,,PRON,PROPN,nsubj,compound,PRP,NNP,7,1
11266,10078.0,26,established,2,7,25,18,6,0,-5,23,Macdonald College,Montreal,per-per,,PROPN-PROPN,PROPN,compound-pobj,pobj,NNP-NNP,NNP,7,1
11267,10079.0,31,established,21,8,21,13,7,9,13,0,Niagara,College,org,,PROPN,PROPN,compound,nsubj,NNP,NNP,7,1
11268,10080.0,31,founded,3,2,6,4,1,24,1,3,university,Newberg Oregon,per,-,NOUN,PROPN-PROPN,nsubjpass,compound-pobj,NN,NNP-NNP,3,1
11269,10081.0,62,educated,2,14,49,35,13,12,-12,47,Colorado State Normal School,University of Northern Colorado,org-org-org-org,---,PROPN-PROPN-PROPN-PROPN,PROPN-ADP-PROPN-PROPN,compound-compound-compound-pobj,det-prep-compound-pobj,NNP-NNP-NNP-NNP,NNP-IN-NNP-NNP,5,1
11270,10082.0,44,acquired,3,6,17,11,5,26,-3,14,Vivendi,Sierra Entertainment,per,-,PROPN,PROPN-PROPN,compound,compound-pobj,NNP,NNP-NNP,6,1
11271,10083.0,26,elected,5,2,21,19,1,4,3,16,Saskatchewan,Brad Wall,per,-,PROPN,PROPN-PROPN,compound,compound-conj,NNP,NNP-NNP,2,1
11272,10084.0,51,served,1,25,35,10,24,15,-24,34,New York City,Rusty Magee,org-org-org,-,PROPN-PROPN-PROPN,PROPN-PROPN,compound-compound-pobj,compound-pobj,NNP-NNP-NNP,NNP-NNP,12,1
11273,10085.0,21,recorded,7,4,19,15,3,1,3,12,Phil,Philles Records,org,-,PROPN,PROPN-PROPN,compound,compound-pobj,NNP,NNP-NNPS,10,1
11274,10088.0,18,championed,1,10,17,7,9,0,-9,16,Archie Shepp,Impulse,org-org,,PROPN-PROPN,PROPN,compound-appos,appos,NNP-NNP,NNP,3,1
11275,10089.0,34,announce,11,4,19,15,3,14,7,8,Time Warner,TBS,-,org,PROPN-PROPN,PROPN,compound-compound,dobj,NNP-NNP,NNP,6,1
11276,10090.0,41,filed,4,4,9,5,3,31,0,5,XanGo,Bryan Davis,per,-,PROPN,PROPN-PROPN,nsubj,compound-pobj,NNP,NNP-NNP,3,1
11277,10091.0,20,is,6,1,5,4,0,14,5,-1,Patrick Henry College,Purcellville,--,org,PROPN-PROPN-PROPN,PROPN,compound-compound-nsubj,pobj,NNP-NNP-NNP,NNP,2,1
11278,10092.0,65,founded,5,4,25,21,3,39,1,20,Wales,Aberystwyth University,org,-,PROPN,PROPN-PROPN,pobj,compound-appos,NNP,NNP-NNP,4,1
11279,10093.0,22,is,0,10,18,8,9,3,-10,18,Apocalypse,Rock Symphony,,per-per,PROPN,PROPN-PROPN,pobj,compound-compound,NNP,NNP-NNP,4,1
11280,10094.0,17,produced,3,2,16,14,1,0,1,13,Equinox,Canada,,org,PROPN,PROPN,nsubjpass,pobj,NNP,NNP,5,1
11281,10095.0,17,Universiti,0,1,3,2,0,13,-1,3,Universiti Malaysia Kelantan,Kelantan,org-org-org,,PROPN-PROPN-PROPN,PROPN,ROOT-compound-dobj,pobj,NNP-NNP-NNP,NNP,3,1
11282,10096.0,21,Established,0,4,8,4,3,12,-4,8,Mohindra College,Patiala,per-per,,PROPN-PROPN,PROPN,compound-pobj,compound,NNP-NNP,NNP,3,1
11283,10099.0,52,was,18,14,16,2,13,35,4,-2,CDA,Jan Peter Balkenende,per,--,PROPN,PROPN-PROPN-PROPN,compound,compound-compound-pobj,NNP,NNP-NNP-NNP,1,1
11284,10101.0,19,One,0,8,16,8,7,2,-8,16,Reynolds,Ireland,org,,PROPN,PROPN,poss,compound,NNP,NNP,9,1
11285,10102.0,19,said,17,5,6,1,4,12,12,-11,President,Vladimir Voronin,org,-,PROPN,PROPN-PROPN,compound,compound-dobj,NNP,NNP-NNP,1,1
11286,10104.0,22,was,2,1,11,10,0,10,1,9,Your Computer,1981,-,per,DET-PROPN,NUM,poss-nsubj,pobj,PRP$-NNP,CD,4,1
11287,10106.0,26,announced,4,7,14,7,6,11,-3,10,he,Great Russia,org,-,PRON,PROPN-PROPN,nsubj,compound-compound,PRP,NNP-NNP,4,1
11288,10107.0,14,is,3,1,11,10,0,2,2,8,Glenforest Secondary School,Mississauga,org-org-org,,PROPN-PROPN-PROPN,PROPN,compound-compound-nsubj,compound,NNP-NNP-NNP,NNP,6,1
11289,10108.0,18,established,6,2,9,7,1,8,4,3,Robins School,1949,-,per,PROPN-PROPN,NUM,compound-nsubjpass,pobj,NNP-NNP,CD,2,1
11290,10111.0,37,removed,4,25,36,11,24,0,-21,32,Belgium,NBB,,org,PROPN,PROPN,pobj,pobj,NNP,NNP,5,1
11291,10279.0,16,On,0,5,15,10,4,0,-5,15,Belgium,NBB,,per,PROPN,PROPN,pobj,pobj,NNP,NNP,3,1
11292,10116.0,38,discovered,5,21,23,2,20,14,-16,18,Hindenburg,Neudeck,org,,PROPN,PROPN,poss,compound,NNP,NNP,2,1
11293,10117.0,10,sold,2,1,6,5,0,3,1,4,OBC,Go-Ahead Group,per,-,PROPN,PROPN-PROPN,nsubjpass,compound-pobj,NNP,NNP-NNP,4,1
11294,10118.0,33,offered,2,8,12,4,7,20,-6,10,Exchequer,Canning,,per,PROPN,PROPN,pobj,poss,NNP,NNP,6,1
11295,10119.0,105,is,11,37,61,24,36,43,-26,50,Kasparov,ratic P,per,-,PROPN,ADJ-NOUN,compound,amod-compound,NNP,JJ-NN,11,1
11296,10120.0,23,bought,2,1,7,6,0,15,1,5,China Mobile,Millicom,-,per,PROPN-PROPN,PROPN,compound-nsubj,pobj,NNP-NNP,NNP,2,1
11297,10121.0,10,competed,1,1,5,4,0,4,0,4,He,University of Alberta,,org-org-org,PRON,PROPN-ADP-PROPN,nsubj,nmod-prep-pobj,PRP,NNP-IN-NNP,3,1
11298,10122.0,24,is,2,1,10,9,0,13,1,8,Pasi Hurri,BaseN,-,per,PROPN-PROPN,PROPN,compound-nsubj,pobj,NNP-NNP,NNP,3,1
11299,10123.0,15,denounced,4,4,6,2,3,8,0,2,France,Guizot,per,,PROPN,PROPN,pobj,poss,NNP,NNP,3,1
11300,10124.0,23,Nakayama,1,1,19,18,0,3,0,18,Tosiwo Nakayama,Federated States,-,per-per,PROPN-PROPN,PROPN-PROPN,compound-ROOT,compound-pobj,NNP-NNP,NNP-NNPS,4,1
11301,11501.0,16,Nakayama,2,2,8,6,1,7,0,6,Tosiwo Nakayama,Federated States,-,org-org,PROPN-PROPN,PROPN-PROPN,compound-ROOT,compound-pobj,NNP-NNP,NNP-NNP,3,1
11302,10125.0,28,was,14,22,25,3,21,2,-8,11,his,The Missing Link,per,--,DET,DET-PROPN-PROPN,poss,det-compound-appos,PRP$,DT-NNP-NNP,3,1
11303,10126.0,28,marveled,7,3,6,3,2,21,4,-1,National Review,Rich Lowry,per-per,-,PROPN-PROPN,PROPN-PROPN,compound-compound,compound-appos,NNP-NNP,NNP-NNP,2,1
11304,10127.0,21,songs,1,5,15,10,4,5,-4,14,Ian Hunter,UK,per-per,,PROPN-PROPN,PROPN,compound-pobj,compound,NNP-NNP,NNP,6,1
11305,10128.0,21,teamed,2,1,7,6,0,13,1,5,He,Joanne Woodward,per,-,PRON,PROPN-PROPN,nsubj,compound-appos,PRP,NNP-NNP,4,1
11306,10129.0,29,was,11,1,24,23,0,4,10,13,James J. Couzens,Detroit,--,per,PROPN-PROPN-PROPN,PROPN,compound-compound-nsubj,pobj,NNP-NNP-NNP,NNP,4,1
11307,10130.0,39,decided,22,13,21,8,12,17,9,-1,Soledad Orozco,Manuel Camacho,per-per,-,PROPN-PROPN,PROPN-PROPN,compound-compound,compound-pobj,NNP-NNP,NNP-NNP,3,1
11308,10131.0,43,Basketball,2,27,28,1,26,14,-25,26,Mishawaka,High School,per,-,PROPN,PROPN-PROPN,compound,compound-compound,NNP,NNP-NNP,2,1
11309,10134.0,13,is,2,1,9,8,0,3,1,7,SuperValu,Eden Prairie,org,-,PROPN,PROPN-PROPN,compound,compound-pobj,NNP,NNP-NNP,5,1
11310,10136.0,16,took,6,5,15,10,4,0,1,9,Badfinger,Jackson,,per,PROPN,PROPN,compound,pobj,NNP,NNP,2,1
11311,10139.0,29,is,3,21,24,3,20,4,-18,21,Australia,Ralph,per,,PROPN,PROPN,pobj,compound,NNP,NNP,5,1
11312,10141.0,55,appointed,4,13,15,2,12,39,-9,11,University of Hull,Hull,--,per,PROPN-ADP-PROPN,PROPN,pobj-prep-pobj,compound,NNP-IN-NNP,NNP,2,1
11313,11194.0,29,visited,5,8,10,2,7,18,-3,5,University of Hull,Hull,per-per-per,,PROPN-ADP-PROPN,PROPN,dobj-prep-pobj,compound,NNP-IN-NNP,NNP,4,1
11314,10142.0,27,was,1,16,26,10,15,0,-15,25,her,Pakistan,org,,DET,PROPN,poss,pobj,PRP$,NNP,6,1
11315,10143.0,29,represented,10,4,23,19,3,5,6,13,Texas Tech Red Raiders,NCAA University Division,---,org-org-org,PROPN-PROPN-PROPN-PROPN,PROPN-PROPN-PROPN,compound-compound-compound-compound,compound-compound-compound,NNP-NNP-NNP-NNPS,NNP-NNP-NNP,9,1
11316,10144.0,52,is,10,19,19,0,18,32,-9,9,Canton High School,Canton,org-org-org,,PROPN-PROPN-PROPN,PROPN,compound-compound-pobj,compound,NNP-NNP-NNP,NNP,0,1
11317,10145.0,14,is,1,1,6,5,0,7,0,5,Fudan,Universitas,,org,PROPN,PROPN,nsubj,pobj,NNP,NNP,4,1
11318,10146.0,36,includes,9,4,4,0,3,31,5,-5,Anderson University,Anderson Bible Training School,per-per,---,PROPN-PROPN,PROPN-PROPN-PROPN-PROPN,compound-nmod,compound-compound-compound-compound,NNP-NNP,NNP-NNP-NNP-NNP,0,1
11319,10147.0,14,worked,2,8,12,4,7,1,-6,10,singer,Moon Mullican,,per-per,NOUN,PROPN-PROPN,nmod,compound-conj,NN,NNP-NNP,3,1
11320,10148.0,49,commenced,2,29,38,9,28,10,-27,36,United States,National Educational Television,-,per-per-per,PROPN-PROPN,PROPN-PROPN-PROPN,compound-pobj,compound-compound-pobj,NNP-NNP,NNP-NNP-NNP,8,1
11321,10149.0,22,Live,0,15,19,4,14,2,-15,19,Bruce Springsteen,E Street Band,per-per,--,PROPN-PROPN,PROPN-PROPN-PROPN,compound-pobj,compound-compound-conj,NNP-NNP,NNP-NNP-NNP,4,1
11322,13728.0,64,By,0,26,30,4,25,33,-26,30,Bruce Springsteen,E Street Band,org-org,--,PROPN-PROPN,PROPN-PROPN-PROPN,compound-pobj,compound-compound-poss,NNP-NNP,NNP-NNP-NNP,6,1
11323,10150.0,14,Pack,2,2,6,4,1,7,0,4,India,Reliance Industries,,per-per,PROPN,PROPN-PROPN,compound,compound-compound,NNP,NNP-NNPS,2,1
11324,10151.0,18,provided,9,8,8,0,7,9,1,-1,Cyprus,Cyprus Airways,,per-per,PROPN,PROPN-PROPN,pobj,compound-compound,NNP,NNP-NNP,0,1
11325,10152.0,26,released,11,10,23,13,9,2,1,12,John Reis,Swami Records,per-per,-,PROPN-PROPN,PROPN-PROPN,compound-pobj,compound-compound,NNP-NNP,NNP-NNPS,9,1
11326,10154.0,25,picture,3,9,20,11,8,4,-6,17,Jeff Bridges,actor,org-org,,PROPN-PROPN,NOUN,compound-appos,compound,NNP-NNP,NN,7,1
11327,10156.0,11,awarded,3,9,10,1,8,0,-6,7,USC,Columbia,,org,PROPN,PROPN,compound,pobj,NNP,NNP,5,1
11328,10157.0,28,fled,3,8,27,19,7,0,-5,24,Mardam Bey,Syria,-,org,PROPN-PROPN,PROPN,compound-nsubj,pobj,NNP-NNP,NNP,4,1
11329,10158.0,18,released,3,3,16,13,2,1,0,13,she,Island,org,,PRON,PROPN,nsubj,compound,PRP,NNP,3,1
11330,10159.0,26,Reynolds,5,5,25,20,4,0,0,20,Albert Reynolds,Ireland,org-org,,PROPN-PROPN,PROPN,compound-ROOT,pobj,NNP-NNP,NNP,6,1
11331,10161.0,11,is,2,1,7,6,0,3,1,5,2K Sports,Take-Two Interactive,-,per-per,PROPN-PROPN,PROPN-PROPN,compound-nsubj,compound-compound,NNP-NNPS,NNP-NNP,6,1
11332,10162.0,53,is,2,32,41,9,31,11,-30,39,Imogen Heap,Frou Frou,org-org,-,PROPN-PROPN,PROPN-PROPN,compound-conj,compound-pobj,NNP-NNP,NNP-NNP,3,1
11333,10163.0,25,released,3,1,12,11,0,12,2,9,Cabaret Voltaire,Rough Trade,-,per-per,PROPN-PROPN,PROPN-PROPN,compound-nsubj,compound-conj,NNP-NNP,NNP-NNP,4,1
11334,10164.0,35,are,14,11,18,7,10,16,3,4,Steel Pole Bath Tub,Bozeman,---,org,PROPN-PROPN-PROPN-PROPN,PROPN,compound-compound-compound-appos,pobj,NNP-NNP-NNP-NNP,NNP,5,1
11335,10166.0,35,shot,12,10,22,12,9,12,2,10,Italy,Mario Bava,,per-per,PROPN,PROPN-PROPN,pobj,compound-appos,NNP,NNP-NNP,5,1
11336,10169.0,31,formed,16,2,8,6,1,22,14,-8,Philipp Scheidemann,Chancellor,per-per,,PROPN-PROPN,PROPN,compound-pobj,nsubj,NNP-NNP,NNP,4,1
11337,10170.0,47,condemned,5,26,41,15,25,5,-21,36,Bonham,United Kingdom,,org-org,PROPN,PROPN-PROPN,nsubjpass,compound-pobj,NNP,NNP-NNP,5,1
11338,10171.0,30,recorded,6,3,18,15,2,11,3,12,Financial Mirror,Cyprus,-,per,PROPN-PROPN,PROPN,compound-compound,pobj,NNP-NNP,NNP,4,1
11339,10174.0,25,serves,2,15,11,-4,14,13,-13,9,Wrightstown,New Hanover Township School,per,---,PROPN,PROPN-PROPN-PROPN-PROPN,conj,compound-compound-compound-compound,NNP,NNP-NNP-NNP-NNP,2,1
11340,10175.0,54,asked,37,21,5,-16,20,48,16,-32,Whitesnake,Coverdale,,per,PROPN,PROPN,nsubj,dobj,NNP,NNP,5,1
11341,10177.0,11,attended,1,3,9,6,2,1,-2,8,Seton Hall University,New Jersey,per-per-per,-,PROPN-PROPN-PROPN,PROPN-PROPN,compound-compound-dobj,compound-pobj,NNP-NNP-NNP,NNP-NNP,3,1
11342,10178.0,27,led,2,21,24,3,20,2,-19,22,Centerpartiet,Centre Party,per,-,PROPN,PROPN-PROPN,pobj,compound-appos,NNP,NNP-NNP,1,1
11343,10179.0,24,Confederation,4,2,9,7,1,14,2,5,Democratic Trade Union Confederation of Romania,Confedera?ia Sindicatelor Democratic,-----,per-per-per,PROPN-PROPN-PROPN-PROPN-ADP-PROPN,PROPN-PROPN-ADJ,compound-compound-compound-ROOT-prep-pobj,appos-compound-amod,NNP-NNP-NNP-NNP-IN-NNP,NNP-NNP-JJ,3,1
11344,10180.0,15,transported,3,9,13,4,8,1,-6,10,USA,Bob Berg,,per-per,PROPN,PROPN-PROPN,pobj,compound-pobj,NNP,NNP-NNP,3,1
11345,10182.0,24,worked,1,1,15,14,0,8,0,14,He,Alabama,,org,PRON,PROPN,nsubj,pobj,PRP,NNP,2,1
11346,10183.0,24,At,0,15,23,8,14,0,-15,23,Arthur D. Levinson,Genentech,--,per,PROPN-PROPN-PROPN,PROPN,compound-compound-conj,pobj,NNP-NNP-NNP,NNP,4,1
11347,10185.0,28,is,6,1,1,0,0,26,5,-5,Elmwood Park High School,Elmwood Park,org-org-org-org,-,PROPN-PROPN-PROPN-PROPN,PROPN-PROPN,compound-compound-compound-nsubj,compound-compound,NNP-NNP-NNP-NNP,NNP-NNP,0,1
11348,10187.0,31,known,5,2,23,21,1,7,3,18,Clinton,Ashford University,,org-org,PROPN,PROPN-PROPN,compound,compound-compound,NNP,NNP-NNP,9,1
11349,10189.0,43,reigned,11,3,10,7,2,32,8,-1,Mayo College,Berkshire,per-per,,PROPN-PROPN,PROPN,compound-compound,pobj,NNP-NNP,NNP,5,1
11350,10192.0,19,appointed,2,9,10,1,8,8,-7,8,Interior,James Rudolph Garfield,per,--,PROPN,PROPN-PROPN-PROPN,pobj,compound-compound-dobj,NNP,NNP-NNP-NNP,2,1
11351,10193.0,49,announced,6,9,21,12,8,27,-3,15,Chris Catalyst,Eureka Machines,per-per,-,PROPN-PROPN,PROPN-PROPN,compound-nsubj,compound-pobj,NNP-NNP,NNP-NNPS,4,1
11352,10194.0,36,developing,11,1,21,20,0,14,10,10,United bank,Karachi,per-per,,PROPN-NOUN,PROPN,compound-compound,pobj,NNP-NN,NNP,3,1
11353,10195.0,28,letters,2,12,16,4,11,11,-10,14,Onondaga Community College,Syracuse,--,per,PROPN-PROPN-PROPN,PROPN,compound-compound-pobj,compound,NNP-NNP-NNP,NNP,6,1
11354,10196.0,24,went,3,3,18,15,2,5,0,15,Freud,Mushroom Records,,org-org,PROPN,PROPN-PROPN,nsubj,compound-pobj,NNP,NNP-NNPS,5,1
11355,10197.0,51,Hanlon,2,12,33,21,11,17,-10,31,Irish,Gerry Adams.Sinn O'Hanlon,,per-per-per,PROPN,PROPN-PROPN-PROPN,compound,compound-compound-conj,NNP,NNP-NNP-NNP,6,1
11356,10199.0,53,was,3,1,18,17,0,34,2,15,William Hale Thompson,Illinois,--,org,PROPN-PROPN-PROPN,PROPN,compound-compound-nsubj,compound,NNP-NNP-NNP,NNP,8,1
11357,10201.0,34,relocated,3,6,19,13,5,14,-3,16,Poland,Ludwik Solski Academy for the Dramatic Arts,,per-per-per-per-per-per-per,PROPN,PROPN-PROPN-PROPN-ADP-DET-PROPN-PROPN,pobj,compound-compound-pobj-prep-det-compound-pobj,NNP,NNP-NNP-NNP-IN-DT-NNP-NNPS,8,1
11358,10202.0,49,?alf,0,1,15,14,0,33,-1,15,?alf,f Czechoslovaki,,per-per,DET,X-PROPN,ROOT,det-ROOT,PDT,XX-NNP,4,1
11359,10204.0,29,moved,3,7,24,17,6,4,-4,21,Austria,Theodor,,per,PROPN,PROPN,pobj,pobj,NNP,NNP,9,1
11360,10205.0,31,was,1,9,18,9,8,12,-8,17,his,Mexico,org,,DET,PROPN,poss,pobj,PRP$,NNP,5,1
11361,10208.0,22,died,1,1,20,19,0,1,0,19,Calder,New York,org,-,NOUN,PROPN-PROPN,nsubj,compound-pobj,NN,NNP-NNP,7,1
11362,10209.0,27,built,3,16,24,8,15,2,-13,21,Harvard University,Theodore William Richards,org-org,--,PROPN-PROPN,PROPN-PROPN-PROPN,compound-compound,compound-compound-conj,NNP-NNP,NNP-NNP-NNP,3,1
11363,10211.0,21,was,3,2,17,15,1,3,1,14,Buick,Michigan,org,,PROPN,PROPN,compound,pobj,NNP,NNP,4,1
11364,10212.0,62,visited,3,36,40,4,35,21,-33,37,2001,Indian School of Business,,per-per-per-per,NUM,PROPN-PROPN-ADP-PROPN,appos,compound-ROOT-prep-pobj,CD,NNP-NNP-IN-NNP,-1,1
11365,10213.0,28,attended,7,23,27,4,22,0,-16,20,ASIO,Canberra,,org,PROPN,PROPN,nmod,pobj,NNP,NNP,3,1
11366,10214.0,24,are,18,5,16,11,4,7,13,-2,Sierra Leone,Ernest Bai Koroma,per-per,--,PROPN-PROPN,PROPN-PROPN-PROPN,compound-compound,compound-compound-conj,NNP-NNP,NNP-NNP-NNP,6,1
11367,13854.0,27,attended,6,9,13,4,8,13,-3,7,Sierra Leone,Ernest Bai Koroma,per-per,--,PROPN-PROPN,PROPN-PROPN-PROPN,compound-poss,compound-compound-pobj,NNP-NNP,NNP-NNP-NNP,2,1
11368,10216.0,37,returned,12,21,28,7,20,8,-9,16,Stratford,Richard Manuel,,org-org,PROPN,PROPN-PROPN,compound,compound-compound,NNP,NNP-NNP,3,1
11369,10217.0,26,is,4,2,25,23,1,0,2,21,Washington High School,USA,per-per-per,,PROPN-PROPN-PROPN,PROPN,compound-compound-nsubj,pobj,NNP-NNP-NNP,NNP,9,1
11370,10221.0,33,reported,31,9,14,5,8,18,22,-17,Indian Space Research Organisation,ISRO,org-org-org-org,,PROPN-PROPN-PROPN-PROPN,PROPN,compound-compound-compound-appos,appos,NNP-NNP-NNP-NNP,NNP,2,1
11371,10222.0,14,decided,5,5,13,8,4,0,0,8,Voormann,London,per,,PROPN,PROPN,nsubj,pobj,NNP,NNP,1,1
11372,10223.0,25,sworn,2,1,20,19,0,4,1,18,He,Kuomintang,per,,PRON,PROPN,nsubjpass,pobj,PRP,NNP,5,1
11373,10225.0,43,attained,3,16,35,19,15,7,-13,32,II Army Corps,Hellenic Army,per-per-per,-,PROPN-PROPN-PROPN,PROPN-PROPN,compound-compound-pobj,compound-pobj,NNP-NNP-NNP,NNP-NNP,9,1
11374,10226.0,31,lead,19,16,22,6,15,8,3,3,Fugazi,Ian MacKaye,,org-org,PROPN,PROPN-PROPN,nmod,compound-dobj,NNP,NNP-NNP,10,1
11375,10227.0,38,settled,7,2,10,8,1,27,5,3,his,Edinburgh,,org,DET,PROPN,poss,nsubj,PRP$,NNP,3,1
11376,10228.0,16,made,4,10,13,3,9,2,-6,9,G-Unit,Young Hot Rod,per,--,PROPN,PROPN-PROPN-NOUN,punct,compound-compound-ROOT,NNP,NNP-NNP-NN,1,1
11377,10229.0,22,represented,6,3,17,14,2,4,3,11,UCF Knights,Division I,org-org,-,PROPN-PROPN,PROPN-PRON,compound-compound,compound-compound,NNP-NNPS,NNP-PRP,5,1
11378,10968.0,21,represented,6,3,17,14,2,3,3,11,UCF Knights,Division I,-,per-per,PROPN-PROPN,PROPN-NUM,compound-compound,pobj-appos,NNP-NNPS,NNP-CD,6,1
11379,11533.0,27,is,1,9,11,2,8,15,-8,10,UCF Knights,Division I,-,per-per,PROPN-PROPN,PROPN-PRON,compound-compound,pobj-compound,NNP-NNPS,NNP-PRP,6,1
11380,10230.0,12,born,2,4,6,2,3,5,-2,4,Jessie Ralph,Chambers,per-per,,PROPN-PROPN,PROPN,compound-compound,oprd,NNP-NNP,NNP,2,1
11381,10231.0,24,is,1,9,13,4,8,10,-8,12,University of Hertfordshire,Hatfield,--,per,PROPN-ADP-PROPN,PROPN,pobj-prep-pobj,compound,NNP-IN-NNP,NNP,4,1
11382,10233.0,26,given,8,1,3,2,0,22,7,-5,Arsenal,Belgium,per,,PROPN,PROPN,poss,compound,NNP,NNP,2,1
11383,10234.0,13,is,3,1,1,0,0,11,2,-2,Paulo Futebol Clube,Paulo,per-per-per,,PROPN-PROPN-PROPN,PROPN,compound-compound-nsubj,compound,NNP-NNP-NNP,NNP,0,1
11384,10235.0,76,was,2,17,26,9,16,49,-15,24,Manchester Regiment,Army,per-per,,PROPN-PROPN,PROPN,compound-nsubjpass,pobj,NNP-NNP,NNP,-1,1
11385,10237.0,32,traces,1,1,30,29,0,1,0,29,SAIC,Shanghai,per,,PROPN,PROPN,nsubj,compound,NNP,NNP,7,1
11386,10239.0,48,were,12,2,20,18,1,27,10,8,Intrepid,Dodge,,org,PROPN,PROPN,compound,poss,NNP,NNP,6,1
11387,10240.0,30,entered,5,8,13,5,7,16,-3,8,Discovery Communications,Silver Spring,-,per-per,PROPN-PROPN,PROPN-PROPN,compound-compound,compound-compound,NNP-NNPS,NNP-NNP,5,1
11388,10241.0,13,opened,7,1,10,9,0,2,6,3,Finland,Tapiola,,per,PROPN,PROPN,poss,pobj,NNP,NNP,5,1
11389,10243.0,62,recognized,5,25,30,5,24,31,-20,25,Chile,Violeta Parra,,org-org,PROPN,PROPN-PROPN,poss,compound-conj,NNP,NNP-NNP,5,1
11390,10244.0,11,earned,1,6,9,3,5,1,-5,8,Cornell University,Hans Bethe,org-org,-,PROPN-PROPN,PROPN-PROPN,compound-pobj,compound-pobj,NNP-NNP,NNP-NNP,4,1
11391,10245.0,49,was,2,27,37,10,26,11,-25,35,Tiger Lily,John Foxx,-,per-per,PROPN-PROPN,PROPN-PROPN,compound-oprd,compound-pobj,NNP-NNP,NNP-NNP,7,1
11392,10246.0,55,had,4,15,1,-14,14,53,-11,-3,Cokie Roberts,Hale Boggs,-,org-org,PROPN-PROPN,PROPN-PROPN,compound-conj,compound-compound,NNP-NNP,NNP-NNP,5,1
11393,10247.0,22,was,2,2,20,18,1,1,0,18,College,Marcellin Champagnat,per,-,PROPN,PROPN-PROPN,nsubj,compound-appos,NNP,NNP-NNP,9,1
11394,10248.0,60,attended,1,10,29,19,9,30,-9,28,Fresno State Bulldogs,WAC,--,org,PROPN-PROPN-PROPN,PROPN,compound-compound-compound,appos,NNP-NNP-NNPS,NNP,11,1
11395,10250.0,27,known,3,1,20,19,0,6,2,17,Greg Cartwright,singer,org-org,,PROPN-PROPN,NOUN,compound-nsubj,compound,NNP-NNP,NN,3,1
11396,10252.0,25,moved,2,6,20,14,5,4,-4,18,South Korea,Hankuk University of Foreign Studies,-,org-org-org-org-org,PROPN-PROPN,PROPN-PROPN-ADP-PROPN-PROPN,compound-pobj,compound-pobj-prep-compound-pobj,NNP-NNP,NNP-NNP-IN-NNP-NNPS,8,1
11397,10253.0,25,For,0,13,17,4,12,7,-13,17,Ingmar Bergman,Sweden,per-per,,PROPN-PROPN,PROPN,compound-compound,pobj,NNP-NNP,NNP,5,1
11398,10254.0,33,was,2,1,22,21,0,10,1,20,Wilfrid Blunt,England,org-org,,PROPN-PROPN,PROPN,compound-nsubj,nsubj,NNP-NNP,NNP,3,1
11399,10257.0,43,born,2,1,6,5,0,36,1,4,Ellul,France,,per,PROPN,PROPN,nsubjpass,pobj,NNP,NNP,2,1
11400,10258.0,22,Falco,2,12,17,5,11,4,-10,15,NBC,AOL,per,,PROPN,PROPN,nsubj,pobj,NNP,NNP,7,1
11401,10259.0,46,demonstrated,25,3,14,11,2,31,22,-11,European Society of Cardiology,Philips,org-org-org-org,,PROPN-PROPN-ADP-PROPN,PROPN,compound-pobj-prep-pobj,compound,NNP-NNP-IN-NNP,NNP,3,1
11402,10261.0,19,jumped,7,7,15,8,6,3,0,8,FAU,NCAA,per,,PROPN,PROPN,pobj,compound,NNP,NNP,4,1
11403,13579.0,29,jumped,9,7,14,7,6,14,2,5,FAU,NCAA,org,,PROPN,PROPN,compound,compound,NNP,NNP,7,1
11404,10262.0,36,said,24,9,26,17,8,9,15,2,Spyker Cars,Victor Muller,-,per-per,PROPN-PROPN,PROPN-PROPN,compound-compound,compound-compound,NNP-NNP,NNP-NNP,8,1
11405,10264.0,16,left,7,1,4,3,0,11,6,-3,Cheap Trick,Tom Petersson,per-per,-,ADJ-PROPN,PROPN-PROPN,amod-compound,compound-nsubj,JJ-NNP,NNP-NNP,2,1
11406,10265.0,44,Running,3,9,29,20,8,14,-6,26,Towson,NCAA,,org,PROPN,PROPN,pobj,compound,NNP,NNP,-1,1
11407,10266.0,25,used,3,14,12,-2,13,12,-11,9,Qantas,Australia,,org,PROPN,PROPN,nsubj,conj,NNP,NNP,1,1
11408,10267.0,39,--,0,34,21,-13,33,17,-34,21,Davy Jones,the Monkees,per-per,-,PROPN-PROPN,DET-PROPN,compound-conj,det-pobj,NNP-NNP,DT-NNPS,4,1
11409,10268.0,16,is,2,1,15,14,0,0,1,13,Michael Ignatieff,politician,-,per,PROPN-PROPN,NOUN,compound-nsubj,conj,NNP-NNP,NN,6,1
11410,10269.0,9,left,2,1,7,6,0,1,1,5,He,Rosemarie Ford,,per-per,PRON,PROPN-PROPN,nsubj,compound-pobj,PRP,NNP-NNP,4,1
11411,10271.0,16,accepted,1,1,8,7,0,7,0,7,DeWine,Cedarville,org,,NOUN,PROPN,nsubj,compound,NN,NNP,5,1
11412,10272.0,33,SEATTLE,0,8,11,3,7,21,-8,11,Howard Schultz,Starbucks,per-per,,PROPN-PROPN,PROPN,compound-nsubj,compound,NNP-NNP,NNP,2,1
11413,10273.0,15,played,6,2,14,12,1,0,4,8,Boilermakers,Indiana,per,,PROPN,PROPN,poss,pobj,NNPS,NNP,8,1
11414,10274.0,20,represented,7,3,15,12,2,4,4,8,Dartmouth Big Green,Division I,--,per-per,PROPN-ADJ-PROPN,PROPN-PROPN,compound-compound-compound,pobj-compound,NNP-JJ-NNP,NNP-NNP,7,1
11415,10275.0,27,+,0,2,14,12,1,12,-2,14,1991,Doom,,per,NUM,PROPN,nummod,pobj,CD,NNP,4,1
11416,10276.0,20,are,5,12,17,5,11,2,-7,12,Ministry of Education,MOE,org-org-org,,PROPN-ADP-PROPN,PROPN,poss-prep-pobj,nmod,NNP-IN-NNP,NNP,4,1
11417,10277.0,22,partnered,8,11,20,9,10,1,-3,12,Thomas B. Catron,Republican,--,org,PROPN-PROPN-PROPN,PROPN,compound-compound-pobj,compound,NNP-NNP-NNP,NNP,5,1
11418,10278.0,42,estimated,15,9,14,5,8,27,6,-1,University of the Ryukyus,Okinawa,org-org-org-org,,PROPN-ADP-DET-PROPN,PROPN,pobj-prep-det-pobj,pobj,NNP-IN-DT-NNP,NNP,6,1
11419,10281.0,29,reelected,7,5,13,8,4,15,2,6,Benjamin Netanyahu,Likud,-,per,PROPN-PROPN,PROPN,compound-appos,pobj,NNP-NNP,NNP,7,1
11420,10282.0,50,Leave,0,47,48,1,46,1,-47,48,Iran,Farah Pahlavi,org,-,PROPN,PROPN-PROPN,compound,compound-pobj,NNP,NNP-NNP,1,1
11421,10283.0,12,founded,4,1,11,10,0,0,3,7,Fairmount Heavy Transport,Rotterdam,org-org-org,,PROPN-PROPN-PROPN,PROPN,compound-compound-nsubjpass,pobj,NNP-NNP-NNP,NNP,3,1
11422,10284.0,43,is,1,23,32,9,22,10,-22,31,Alliance of Canadian Cinema,ACTRA,---,per,PROPN-ADP-PROPN-PROPN,PROPN,conj-prep-amod-nmod,appos,NNP-IN-NNP-NNP,NNP,3,1
11423,10285.0,25,was,1,1,20,19,0,4,0,19,She,Los Angeles,per,-,PRON,PROPN-PROPN,nsubj,compound-compound,PRP,NNP-NNP,3,1
11424,10287.0,19,seem,4,1,18,17,0,0,3,14,Brian France,NASCAR,per-per,,PROPN-PROPN,PROPN,compound-nsubj,pobj,NNP-NNP,NNP,2,1
11425,10288.0,15,competes,1,1,12,11,0,2,0,11,Yorkville,High School Association,per,--,PROPN,PROPN-PROPN-PROPN,nsubj,compound-compound-conj,NNP,NNP-NNP-NNP,3,1
11426,10289.0,26,known,9,1,20,19,0,5,8,11,K. K. Downing,Yew Tree,org-org-org,-,PROPN-PROPN-PROPN,PROPN-PROPN,compound-compound-compound,compound-compound,NNP-NNP-NNP,NNP-NNP,9,1
11427,10290.0,23,moved,5,15,20,5,14,2,-10,15,Kent,Tonbridge Grammar School,,org-org-org,PROPN,PROPN-PROPN-PROPN,pobj,compound-compound-dobj,NNP,NNP-NNP-NNP,3,1
11428,10291.0,31,honored,14,1,1,0,0,29,13,-13,Harrison High School,Harrison,--,per,PROPN-PROPN-PROPN,PROPN,compound-compound-compound,compound,NNP-NNP-NNP,NNP,0,1
11429,10618.0,24,is,3,1,1,0,0,22,2,-2,Harrison High School,Harrison,--,per,PROPN-PROPN-PROPN,PROPN,compound-compound-nsubj,compound,NNP-NNP-NNP,NNP,0,1
11430,10293.0,30,has,2,6,20,14,5,9,-4,18,Sonia Gandhi,Rajiv Gandhi,-,per-per,PROPN-PROPN,PROPN-PROPN,compound-poss,compound-poss,NNP-NNP,NNP-NNP,9,1
11431,10294.0,42,nominated,12,1,11,10,0,30,11,-1,Zoellick,State,,org,VERB,PROPN,nsubjpass,pobj,VB,NNP,4,1
11432,10295.0,17,is,2,11,15,4,10,1,-9,13,Nicholls State University,Thibodaux,per-per-per,,PROPN-PROPN-PROPN,PROPN,compound-compound-pobj,compound,NNP-NNP-NNP,NNP,3,1
11433,10296.0,50,said,20,13,17,4,12,32,7,-3,Charles Lewis,Center for Public Integrity,org-org,---,PROPN-PROPN,PROPN-ADP-PROPN-PROPN,compound-appos,pobj-prep-compound-pobj,NNP-NNP,NNP-IN-NNP-NNP,3,1
11434,10297.0,64,spent,7,22,28,6,21,35,-15,21,Roddy Woomble,Idlewild,org-org,,PROPN-PROPN,PROPN,nsubj-ROOT,pobj,NNP-NNP,NNP,1,1
11435,10299.0,22,started,2,5,13,8,4,8,-3,11,1973,Villa Park High School,org,---,NUM,PROPN-PROPN-PROPN-PROPN,pobj,compound-compound-compound-pobj,CD,NNP-NNP-NNP-NNP,4,1
11436,10300.0,32,formed,7,5,18,13,4,13,2,11,Cultural Trust,SVCET,-,org,PROPN-PROPN,PROPN,conj-nsubjpass,pobj,NNP-NNP,NNP,3,1
11437,10301.0,37,was,6,12,18,6,11,18,-6,12,Hilary R. W. Johnson,True Whig,---,org-org,PROPN-PROPN-PROPN-PROPN,PROPN-PROPN,compound-compound-compound-pobj,compound-compound,NNP-NNP-NNP-NNP,NNP-NNP,4,1
11438,10303.0,51,Located,0,7,10,3,6,40,-7,10,University of London,Heythrop College,per-per-per,-,PROPN-ADP-PROPN,PROPN-PROPN,nmod-prep-pobj,compound-attr,NNP-IN-NNP,NNP-NNP,2,1
11439,10304.0,36,mentored,3,32,34,2,31,1,-29,31,him,DEB,org,,PRON,PROPN,pobj,compound,PRP,NNP,1,1
11440,10306.0,20,became,3,1,18,17,0,1,2,15,Joe Strummer,London,-,org,PROPN-PROPN,PROPN,compound-nsubj,compound,NNP-NNP,NNP,6,1
11441,10307.0,42,resigned,12,4,8,4,3,33,8,-4,Malaysia,Wan Azizah Wan Ismail,,org-org-org-org,PROPN,PROPN-PROPN-PROPN-PROPN,poss,compound-compound-compound-appos,NNP,NNP-NNP-NNP-NNP,4,1
11442,10308.0,24,told,2,6,19,13,5,4,-4,17,GE,NBC Universal,,per-per,PROPN,PROPN-PROPN,nmod,compound-compound,NNP,NNP-NNP,4,1
11443,10309.0,20,decided,3,3,12,9,2,7,0,9,Stewart,Atlantic,,per,PROPN,PROPN,nsubj,compound,NNP,NNP,3,1
11444,10310.0,28,surfaced,1,7,14,7,6,13,-6,13,Bainbridge Colby,State,-,per,PROPN-PROPN,PROPN,compound-pobj,pobj,NNP-NNP,NNP,6,1
11445,10311.0,30,is,1,12,12,0,11,17,-11,11,Southfield Public Schools,Southfield High School,per-per-per,--,PROPN-PROPN-PROPN,PROPN-PROPN-PROPN,compound-compound-compound,compound-compound-attr,NNP-NNP-NNPS,NNP-NNP-NNP,0,1
11446,10312.0,25,referred,5,1,22,21,0,2,4,17,The National,January 31 1990,org-org,--,DET-PROPN,PROPN-NUM-NUM,det-compound,pobj-nummod-nummod,DT-NNP,NNP-CD-CD,6,1
11447,10313.0,31,is,1,25,30,5,24,0,-24,29,Lebanon Valley College,Pennsylvania,--,org,PROPN-PROPN-PROPN,PROPN,compound-compound-conj,pobj,NNP-NNP-NNP,NNP,11,1
11448,10314.0,23,included,3,13,16,3,12,6,-10,13,Yayi Boni,Benin,org-org,,PROPN-PROPN,PROPN,compound-ROOT,pobj,NNP-NNP,NNP,3,1
11449,10315.0,36,focus,7,16,23,7,15,12,-9,16,Metrovacesa,Spain,per,,PROPN,PROPN,nsubj,pobj,NNP,NNP,4,1
11450,10316.0,50,said,7,1,3,2,0,46,6,-4,Bank of Tanzania,Tanzania,--,per,PROPN-ADP-PROPN,PROPN,nsubj-prep-pobj,nsubjpass,NNP-IN-NNP,NNP,3,1
11451,10320.0,20,was,2,1,8,7,0,11,1,6,Paul Wall,Swishahouse,org-org,,PROPN-PROPN,PROPN,compound-nsubj,compound,NNP-NNP,NNP,4,1
11452,10321.0,29,follows,1,1,14,13,0,14,0,13,Frida,Mexico,per,,PROPN,PROPN,nsubj,compound,NNP,NNP,4,1
11453,10323.0,25,sent,8,1,6,5,0,18,7,-2,Billy Hayes,Communication Workers Union,org-org,--,PROPN-PROPN,PROPN-PROPN-PROPN,compound-nsubj,compound-compound-dobj,NNP-NNP,NNP-NNPS-NNP,3,1
11454,10324.0,29,stuck,7,22,28,6,21,0,-15,21,Metal Church,producer,org-org,,PROPN-PROPN,NOUN,compound-compound,pobj,NNP-NNP,NN,4,1
11455,10326.0,28,formed,3,18,21,3,17,6,-15,18,Humble Pie,Clem Clempson,-,org-org,PROPN-PROPN,PROPN-PROPN,compound-compound,compound-pobj,NNP-NNP,NNP-NNP,2,1
11456,10329.0,20,were,2,1,10,9,0,9,1,8,Gravy Train,England,-,per,PROPN-PROPN,PROPN,compound-nsubj,pobj,NNP-NNP,NNP,3,1
11457,10330.0,30,was,6,9,26,17,8,3,-3,20,barrister,Elizabeth I of England,,org-org-org-org,NOUN,PROPN-PROPN-ADP-PROPN,attr,pobj-appos-prep-pobj,NN,NNP-NNP-IN-NNP,4,1
11458,10331.0,35,built,12,7,17,10,6,17,5,5,Navy,Bremer Vulkan,org,-,PROPN,PROPN-PROPN,compound,compound-pobj,NNP,NNP-NNP,3,1
11459,10332.0,40,announced,1,1,39,38,0,0,0,38,Meighen,Canada,,org,PROPN,PROPN,nsubj,pobj,NNP,NNP,1,1
11460,10333.0,28,announced,10,13,25,12,12,2,-3,15,Hennig,Florida,per,,PROPN,PROPN,nsubj,compound,NNP,NNP,4,1
11461,10335.0,32,participated,15,14,29,15,13,2,1,14,Mikhail Fradkov,Russia,-,per,PROPN-PROPN,PROPN,compound-nsubj,pobj,NNP-NNP,NNP,5,1
11462,10341.0,18,continued,5,1,3,2,0,14,4,-2,Afghanistan,Tolo TV,org,-,PROPN,PROPN-NOUN,poss,compound-nsubj,NNP,NNP-NN,2,1
11463,10342.0,26,says,4,1,7,6,0,18,3,3,Japan,Honda,per,,PROPN,PROPN,nsubj,nsubj,NNP,NNP,3,1
11464,10343.0,28,published,3,1,9,8,0,18,2,6,Front,1998,org,,PROPN,NUM,nsubjpass,pobj,NNP,CD,3,1
11465,10344.0,24,was,10,1,17,16,0,6,9,7,Andrew Johnson,United States,-,org-org,PROPN-PROPN,PROPN-PROPN,compound-nsubj,compound-pobj,NNP-NNP,NNP-NNP,4,1
11466,10345.0,28,became,11,4,16,12,3,11,7,5,Piero,Italy,org,,PROPN,PROPN,pobj,pobj,NNP,NNP,4,1
11467,10347.0,9,died,5,1,4,3,0,4,4,-1,Suharto,Siti Hartinah,,per-per,PROPN,PROPN-PROPN,poss,compound-appos,NNP,NNP-NNP,3,1
11468,10348.0,33,forming,6,24,32,8,23,0,-18,26,agency,Netherlands,org,,NOUN,PROPN,poss,pobj,NN,NNP,5,1
11469,10349.0,26,said,1,1,12,11,0,13,0,11,He,Pakistan,,org,PRON,PROPN,nsubj,pobj,PRP,NNP,3,1
11470,10352.0,18,started,4,1,11,10,0,6,3,7,Special Ops Paintball,Jared Orvis,--,org-org,PROPN-PROPN-PROPN,PROPN-PROPN,compound-compound-nsubjpass,compound-appos,NNP-NNP-NNP,NNP-NNP,4,1
11471,10354.0,29,be,3,16,19,3,15,9,-13,16,Saudi Arabia,King Abdullah University of Science and Technology,per-per,------,PROPN-PROPN,PROPN-PROPN-PROPN-ADP-PROPN-CCONJ-PROPN,compound-poss,compound-compound-pobj-prep-pobj-cc-conj,NNP-NNP,NNP-NNP-NNP-IN-NNP-CC-NNP,2,1
11472,10355.0,26,encountered,3,3,21,18,2,4,0,18,he,Chinese,,org,PRON,PROPN,nsubj,compound,PRP,NNP,3,1
11473,10356.0,38,drawn,8,24,25,1,23,12,-16,17,Italy,Antonio Fazio,org,-,PROPN,PROPN-PROPN,pobj,compound-pobj,NNP,NNP-NNP,1,1
11474,10357.0,22,reacquired,2,2,7,5,1,14,0,5,Galaxy,Major League Soccer,,org-org-org,PROPN,PROPN-PROPN-PROPN,nsubj,compound-compound-compound,NNP,NNP-NNP-NNP,4,1
11475,10358.0,42,arrived,6,9,15,6,8,26,-3,9,Stockholm,OMX,,per,PROPN,PROPN,pobj,pobj,NNP,NNP,5,1
11476,10359.0,56,formed,3,36,40,4,35,15,-33,37,Tom Cato Visnes,King Ov Hell,per-per-per,--,PROPN-PROPN-PROPN,PROPN-PROPN-PROPN,compound-compound-ROOT,compound-compound-dobj,NNP-NNP-NNPS,NNP-NNP-NNP,4,1
11477,10360.0,27,was,12,1,19,18,0,7,11,7,Shelly,chairman,org,,PROPN,NOUN,nsubj,appos,NNP,NN,6,1
11478,10362.0,31,sold,2,14,24,10,13,6,-12,22,Columbia,him,per,,PROPN,PRON,compound,dative,NNP,PRP,7,1
11479,10363.0,30,taken,13,9,28,19,8,1,4,15,Yitzhak Ben-Zvi,Israel,org-org,,PROPN-PROPN,PROPN,compound-pobj,compound,NNP-NNP,NNP,13,1
11480,10364.0,22,Master,2,18,20,2,17,1,-16,18,VTU,Karnataka,,org,PROPN,PROPN,appos,compound,NNP,NNP,2,1
11481,10365.0,25,is,14,2,7,5,1,17,12,-7,United States Air Force,4th Space Launch Squadron,---,org-org-org-org,PROPN-PROPN-PROPN-PROPN,PROPN-PROPN-PROPN-PROPN,compound-compound-compound-poss,amod-compound-compound-nsubj,NNP-NNP-NNP-NNP,NNP-NNP-NNP-NNP,4,1
11482,10366.0,24,said,17,17,22,5,16,1,0,5,RATP,Paris,per,,PROPN,PROPN,dobj,compound,NNP,NNP,3,1
11483,10367.0,17,earned,1,7,15,8,6,1,-6,14,University of Cambridge,Alan Baker,per-per-per,-,PROPN-ADP-PROPN,PROPN-PROPN,pobj-prep-pobj,compound-pobj,NNP-IN-NNP,NNP-NNP,7,1
11484,10368.0,18,Limited,4,1,15,14,0,2,3,11,BWIA West Indies Airways,Trinidad and Tobago,org-org-org-org,--,PROPN-PROPN-PROPN-PROPN,PROPN-CCONJ-PROPN,compound-compound-compound-compound,pobj-cc-conj,NNP-NNP-NNP-NNP,NNP-CC-NNP,4,1
11485,10369.0,23,shows,3,1,1,0,0,21,2,-2,ESPN Classic,ESPN,per-per,,PROPN-PROPN,PROPN,compound-nsubj,nsubj,NNP-NNP,NNP,0,1
11486,10371.0,35,took,20,14,18,4,13,16,6,-2,National Defence Academy,Indian Military,per-per-per,-,PROPN-PROPN-PROPN,PROPN-PROPN,compound-compound-appos,compound-compound,NNP-NNP-NNP,NNP-NNP,3,1
11487,10372.0,36,receive,29,13,26,13,12,9,16,-3,Japan,Kyoto University,,per-per,PROPN,PROPN-PROPN,pobj,compound-pobj,NNP,NNP-NNP,5,1
11488,10374.0,38,went,1,18,37,19,17,0,-17,36,Steve Hackett,England,per-per,,PROPN-PROPN,PROPN,compound-conj,pobj,NNP-NNP,NNP,7,1
11489,10375.0,31,According,0,5,12,7,4,18,-5,12,Director,Ajegroup,per,,PROPN,PROPN,pobj,nsubj,NNP,NNP,-1,1
11490,10376.0,32,was,11,22,22,0,21,9,-11,11,Florida State University,Florida,org-org-org,,PROPN-PROPN-PROPN,PROPN,compound-compound-pobj,appos,NNP-NNP-NNP,NNP,0,1
11491,10377.0,35,latched,10,5,9,4,4,25,5,-1,Nationalist,Stanley Bruce,org,-,PROPN,PROPN-PROPN,compound,compound-pobj,NNP,NNP-NNP,3,1
11492,10378.0,13,remain,3,8,11,3,7,1,-5,8,Epic Games,Mike Capps,org-org,-,PROPN-PROPN,PROPN-PROPN,compound-compound,compound-pobj,NNP-NNPS,NNP-NNP,2,1
11493,10379.0,31,asked,14,8,21,13,7,9,6,7,Netherlands,Johan Rudolf Thorbecke,per,--,PROPN,PROPN-PROPN-PROPN,compound,compound-compound-appos,NNP,NNP-NNP-NNP,10,1
11494,10381.0,25,is,9,1,23,22,0,1,8,14,Tim Levinson,Sydney,org-org,,PROPN-PROPN,PROPN,compound-nsubj,compound,NNP-NNP,NNP,4,1
11495,10383.0,21,published,4,14,19,5,13,1,-10,15,University of Western Brittany,Brest,---,per,PROPN-ADP-PROPN-PROPN,PROPN,pobj-prep-compound-pobj,compound,NNP-IN-NNP-NNP,NNP,3,1
11496,10384.0,19,were,2,13,17,4,12,1,-11,15,Texas,Continental Airlines,org,-,PROPN,PROPN-PROPN,nmod,compound-pobj,NNP,NNP-NNPS,2,1
11497,10385.0,35,opened,10,17,21,4,16,13,-7,11,Miomir,Podgorica,per,,PROPN,PROPN,pobj,pobj,NNP,NNP,2,1
11498,10386.0,25,related,2,1,12,11,0,12,1,10,Yanni,Greece,per,,NOUN,PROPN,nsubj,pobj,NN,NNP,5,1
11499,10387.0,41,features,2,14,22,8,13,18,-12,20,Rawkus,Mr. J. Medeiros,per,--,PROPN,PROPN-PROPN-PROPN,compound,compound-compound-compound,NNP,NNP-NNP-NNP,4,1
11500,10388.0,27,is,3,1,17,16,0,9,2,14,Calgary,Diane Ablonczy,,org-org,PROPN,PROPN-PROPN,compound,compound-pobj,NNP,NNP-NNP,6,1
11501,10389.0,29,include,4,6,8,2,5,20,-2,4,Prime Minister,Winston Churchill,org-org,-,PROPN-PROPN,PROPN-PROPN,compound-compound,compound-compound,NNP-NNP,NNP-NNP,1,1
11502,10390.0,17,declared,10,5,8,3,4,8,5,-2,Lucio,President,,per,PROPN,PROPN,nmod,compound,NNP,NNP,3,1
11503,10392.0,22,donated,5,16,21,5,15,0,-11,16,Jamia Hamdard,Delhi,org-org,,PROPN-PROPN,PROPN,compound-compound,pobj,NNP-NNP,NNP,5,1
11504,10393.0,28,named,3,15,22,7,14,5,-12,19,Claude A. Swanson,Navy,per-per-per,,PROPN-NOUN-PROPN,PROPN,compound-compound-nsubj,pobj,NNP-NN-NNP,NNP,8,1
11505,10394.0,44,named,9,29,32,3,28,11,-20,23,North Dakota,Ed Schafer,per-per,-,PROPN-PROPN,PROPN-PROPN,compound-compound,compound-nsubjpass,NNP-NNP,NNP-NNP,4,1
11506,10395.0,42,set,7,12,17,5,11,24,-5,10,Chiang Kai-shek,Soong May-ling,-,per-per,PROPN-PROPN,PROPN-PROPN,compound-pobj,compound-appos,NNP-NNP,NNP-NNP,2,1
11507,10396.0,53,was,1,17,25,8,16,27,-16,24,Cameronians,Army,,per,PROPN,PROPN,compound,pobj,NNPS,NNP,3,1
11508,10397.0,42,',0,8,24,16,7,17,-8,24,Adelaide,Peter Dawson,per,-,PROPN,PROPN-PROPN,compound,compound-pobj,NNP,NNP-NNP,6,1
11509,10398.0,21,played,10,6,8,2,5,12,4,-2,NFL,Crimson Giants,per,-,PROPN,PROPN-PROPN,poss,compound-compound,NNP,NNP-NNPS,2,1
11510,10401.0,30,came,7,6,24,18,5,5,1,17,Comte,Paris,per,,PROPN,PROPN,pobj,nsubj,NNP,NNP,4,1
11511,10402.0,20,said,2,8,16,8,7,3,-6,14,Mozambique,his,,per,PROPN,DET,pobj,poss,NNP,PRP$,5,1
11512,10403.0,21,registered,9,2,19,17,1,1,7,10,BIZVI,Virgin Islands,,per-per,PROPN,PROPN-PROPN,compound,compound-pobj,NNP,NNP-NNP,6,1
11513,10405.0,16,invited,8,8,10,2,7,5,0,2,Canada,Duncan,,per,PROPN,PROPN,pobj,dobj,NNP,NNP,2,1
11514,10407.0,53,accompanied,4,18,32,14,17,20,-14,28,Mark Funkhouser,Kansas City,-,org-org,PROPN-PROPN,PROPN-PROPN,compound-pobj,compound-poss,NNP-NNP,NNP-NNP,9,1
11515,10410.0,20,arrived,10,14,16,2,13,3,-4,6,French,Claudie,per,,ADJ,PROPN,amod,nsubj,JJ,NNP,2,1
11516,10414.0,22,represented,2,1,5,4,0,16,1,3,France,Jonatan Cerrada,per,-,PROPN,PROPN-PROPN,nsubjpass,compound-pobj,NNP,NNP-NNP,3,1
11517,10415.0,39,decided,22,11,21,10,10,17,11,-1,Ottawa,Pearson,,org,PROPN,PROPN,pobj,pobj,NNP,NNP,10,1
11518,10416.0,17,entered,5,4,7,3,3,9,1,2,Queensland,Brisbane Grammar School,,per-per-per,PROPN,PROPN-PROPN-PROPN,pobj,compound-compound-dobj,NNP,NNP-NNP-NNP,3,1
11519,10417.0,30,Signing,0,15,17,2,14,12,-15,17,NEC,Kaoru Yano,org,-,PROPN,PROPN-PROPN,compound,compound-ROOT,NNP,NNP-NNP,1,1
11520,10418.0,20,founded,3,2,17,15,1,2,1,14,Thomas-Institut,University of Cologne,,per-per-per,PROPN,PROPN-ADP-PROPN,nsubjpass,pobj-prep-pobj,NNP,NNP-IN-NNP,8,1
11521,10424.0,38,Being,0,11,22,11,10,15,-11,22,her,University of Karachi,,per-per-per,DET,PROPN-ADP-PROPN,poss,pobj-prep-pobj,PRP$,NNP-IN-NNP,8,1
11522,10426.0,22,located,6,2,21,19,1,0,4,15,University of Dayton,Ohio,org-org-org,,PROPN-ADP-PROPN,PROPN,nmod-prep-pobj,pobj,NNP-IN-NNP,NNP,4,1
11523,10427.0,21,refers,14,7,20,13,6,0,7,6,university,Trier,,per,NOUN,PROPN,pobj,pobj,NN,NNP,4,1
11524,10428.0,18,is,2,10,17,7,9,0,-8,15,Chicago,Owen,per,,PROPN,PROPN,compound,appos,NNP,NNP,3,1
11525,10429.0,11,founded,2,1,5,4,0,5,1,3,Tracor,1955,org,,PROPN,NUM,nsubjpass,pobj,NNP,CD,2,1
11526,10432.0,12,was,6,5,11,6,4,0,1,5,Sisavang Vong,Laos,-,per,PROPN-PROPN,PROPN,compound-nsubj,pobj,NNP-NNP,NNP,2,1
11527,10434.0,40,Athabaskan,2,7,22,15,6,17,-5,20,Alaska,Mt. Edgecumbe High School,,org-org-org-org,PROPN,PROPN-PROPN-PROPN-PROPN,compound,compound-compound-compound-pobj,NNP,NNP-NNP-NNP-NNP,8,1
11528,10435.0,24,stands,12,8,10,2,7,13,4,-2,Colombian,Fernando Botero,,per-per,ADJ,PROPN-PROPN,amod,compound-compound,JJ,NNP-NNP,3,1
11529,10437.0,11,graduated,1,4,7,3,3,3,-3,6,Spelman College,Atlanta,-,org,PROPN-PROPN,PROPN,compound-pobj,compound,NNP-NNP,NNP,2,1
11530,13636.0,22,understand,1,18,21,3,17,0,-17,20,Spelman College,Atlanta,per-per,,PROPN-PROPN,PROPN,compound-pobj,pobj,NNP-NNP,NNP,5,1
11531,10438.0,10,represent,4,1,6,5,0,3,3,2,Lee Kuan Yew,Singapore,--,per,PROPN-PROPN-PROPN,PROPN,compound-compound-nsubj,dobj,NNP-NNP-NNP,NNP,3,1
11532,10439.0,21,opened,7,7,19,12,6,1,0,12,Animate,Tokyo,per,,PROPN,PROPN,pobj,compound,NNP,NNP,4,1
11533,10440.0,31,Founded,0,4,13,9,3,17,-4,13,Banco de,Colombia,-,org,PROPN-PROPN,PROPN,compound-nsubj,pobj,NNP-NNP,NNP,2,1
11534,10441.0,35,botanico,2,5,23,18,4,11,-3,21,Pisa,University of Pisa,org,--,PROPN,PROPN-ADP-PROPN,nsubj,pobj-prep-pobj,NNP,NNP-IN-NNP,9,1
11535,10443.0,22,changed,15,15,7,-8,14,14,0,-8,he,Tulsa Tribune,org,-,PRON,PROPN-PROPN,nsubj,compound-pobj,PRP,NNP-NNP,7,1
11536,10444.0,17,declared,3,5,13,8,4,3,-2,10,Hank Thompson,Waco,-,per,PROPN-PROPN,PROPN,compound-compound,compound,NNP-NNP,NNP,6,1
11537,10445.0,12,replaced,4,6,11,5,5,0,-2,7,Vinicio Cerezo,Guatemala,per-per,,PROPN-PROPN,PROPN,compound-dobj,pobj,NNP-NNP,NNP,2,1
11538,10446.0,30,separated,6,3,12,9,2,17,3,6,Gerrard,Australia,per,,PROPN,PROPN,nsubj,pobj,NNP,NNP,7,1
11539,10447.0,33,were,12,11,16,5,10,16,1,4,Elizabeth Montgomery,USA,per-per,,PROPN-PROPN,PROPN,compound-conj,pobj,NNP-NNP,NNP,6,1
11540,10448.0,27,represents,9,2,21,19,1,5,7,12,Wilfrid Laurier University,Waterloo,org-org-org,,PROPN-PROPN-PROPN,PROPN,compound-compound-compound,compound,NNP-NNP-NNP,NNP,10,1
11541,10449.0,15,gave,1,1,11,10,0,3,0,10,Rogers,New York,,org-org,NOUN,PROPN-PROPN,nsubj,compound-compound,NNS,NNP-NNP,6,1
11542,10450.0,26,Title,0,11,18,7,10,7,-11,18,University of Wisconsin-Parkside,Kenosha,per-per-per,,PROPN-ADP-ADJ,PROPN,nsubj-prep-amod,compound,NNP-IN-JJ,NNP,4,1
11543,10451.0,39,worked,2,30,31,1,29,7,-28,29,UNHCR,Kenya,per,,PROPN,PROPN,compound,compound,NNP,NNP,2,1
11544,10455.0,57,said,7,19,29,10,18,27,-12,22,VantagePoint Venture Partners,San Bruno,--,per-per,PROPN-PROPN-VERB,PROPN-PROPN,compound-compound-pobj,compound-compound,NNP-NNP-VBZ,NNP-NNP,8,1
11545,10456.0,33,organised,3,3,16,13,2,16,0,13,Venizelos,Greece,per,,PROPN,PROPN,nsubj,pobj,NNP,NNP,4,1
11546,10458.0,16,was,4,6,15,9,5,0,-2,11,Midge Ure,Slik,org-org,,PROPN-PROPN,PROPN,compound-attr,appos,NNP-NNP,NNP,2,1
11547,10459.0,17,wear,6,2,5,3,1,11,4,-1,Paracommando Brigade,Belgium,per-per,,PROPN-PROPN,PROPN,compound-nsubj,appos,NNP-NNP,NNP,2,1
11548,10460.0,28,acquired,6,21,23,2,20,4,-15,17,its,1845,,per,DET,NUM,poss,nummod,PRP$,CD,2,1
11549,10467.0,9,born,4,1,8,7,0,0,3,4,Kathrin Romary Beckinsale,England,per-per-per,,PROPN-PROPN-PROPN,PROPN,compound-compound-nsubjpass,pobj,NNP-NNP-NNP,NNP,3,1
11550,10470.0,23,cut,5,4,18,14,3,4,1,13,Airbus,Fabrice Bregier,,per-per,PROPN,PROPN-PROPN,appos,compound-appos,NNP,NNP-NNP,3,1
11551,10471.0,16,covered,4,7,12,5,6,3,-3,8,Howard Jones,Elektra,-,per,PROPN-PROPN,PROPN,compound-pobj,compound,NNP-NNP,NNP,5,1
11552,10473.0,39,asked,6,20,38,18,19,0,-14,32,Intwine,Netherlands,per,,PROPN,PROPN,poss,pobj,NNP,NNP,8,1
11553,10475.0,18,returned,10,9,13,4,8,4,1,3,her,England,,org,DET,PROPN,poss,pobj,PRP$,NNP,8,1
11554,10476.0,35,became,18,28,34,6,27,0,-10,16,Scottish Equitable,Edinburgh,-,per,PROPN-PROPN,PROPN,compound-compound,pobj,NNP-NNP,NNP,5,1
11555,10477.0,14,began,9,7,9,2,6,4,2,0,Columbia,Godflesh,per,,PROPN,PROPN,appos,pobj,NNP,NNP,-1,1
11556,10479.0,64,was,1,31,44,13,30,19,-30,43,Birmingham School of Art,Joseph Southall,org-org-org-org,-,PROPN-PROPN-ADP-PROPN,PROPN-PROPN,compound-pobj-prep-pobj,compound-compound,NNP-NNP-IN-NNP,NNP-NNP,4,1
11557,10481.0,29,continued,3,20,24,4,19,4,-17,21,Grassley,Iowa,,per,PROPN,PROPN,nsubj,poss,NNP,NNP,5,1
11558,10482.0,37,renamed,11,6,14,8,5,22,5,3,Drexel University,Earle Mack School of Law,-,org-org-org-org-org,PROPN-PROPN,PROPN-PROPN-PROPN-ADP-PROPN,compound-compound,compound-compound-oprd-prep-pobj,NNP-NNP,NNP-NNP-NNP-IN-NNP,4,1
11559,10483.0,36,was,17,16,27,11,15,8,1,10,Canada,John A. Macdonald,org,--,PROPN,PROPN-PROPN-PROPN,pobj,compound-compound-pobj,NNP,NNP-NNP-NNP,-1,1
11560,12885.0,27,called,2,8,24,16,7,2,-6,22,Canada,John A. Macdonald,,per-per-per,PROPN,PROPN-PROPN-PROPN,pobj,compound-compound-pobj,NNP,NNP-NNP-NNP,8,1
11561,10484.0,34,jpg,0,11,26,15,10,7,-11,26,Lamberto Dini,Italy,per-per,,PROPN-PROPN,PROPN,compound-ROOT,poss,NNP-NNP,NNP,-1,1
11562,12840.0,13,1995,0,3,9,6,2,3,-3,9,Lamberto Dini,Italy,-,per,PROPN-PROPN,PROPN,compound-nsubj,pobj,NNP-NNP,NNP,3,1
11563,10485.0,45,has,2,13,25,12,12,19,-11,23,Edmund A. Walsh School of Foreign Service,D.C,per-per-per-per-per-per-per,,PROPN-NOUN-PROPN-PROPN-ADP-PROPN-PROPN,PROPN,compound-compound-compound-pobj-prep-compound-pobj,appos,NNP-NN-NNP-NNP-IN-NNP-NNP,NNP,-1,1
11564,10487.0,20,said,11,6,13,7,5,6,5,2,HSBC,Zheng Haiquan,org,-,PROPN,PROPN-PROPN,poss,compound-compound,NNP,NNP-NNP,8,1
11565,10488.0,54,merged,4,38,53,15,37,0,-34,49,Dutch East India Company,Amsterdam,per-per-per-per,,PROPN-PROPN-PROPN-PROPN,PROPN,compound-compound-compound-pobj,pobj,NNP-NNP-NNP-NNP,NNP,13,1
11566,10489.0,31,elected,5,2,7,5,1,23,3,2,Mississippi,Blanche Bruce,per,-,PROPN,PROPN-PROPN,compound,compound-dobj,NNP,NNP-NNP,3,1
11567,10490.0,16,sponsored,2,1,7,6,0,8,1,5,He,Colorado,per,,PRON,PROPN,nsubj,poss,PRP,NNP,6,1
11568,10491.0,41,are,1,32,36,4,31,4,-31,35,University of Porto,Portugal,org-org-org,,PROPN-ADP-PROPN,PROPN,pobj-prep-pobj,pobj,NNP-IN-NNP,NNP,7,1
11569,10492.0,27,had,6,3,15,12,2,11,3,9,Austria,Waldheim,org,,PROPN,PROPN,poss,compound,NNP,NNP,8,1
11570,10493.0,42,records,7,15,35,20,14,6,-8,28,Martha Stelling,Sleeper,org-org,,PROPN-PROPN,PROPN,compound-pobj,nsubj,NNP-NNP,NNP,4,1
11571,10494.0,23,By,0,8,10,2,7,12,-8,10,Prime Minister,Shaukat Aziz,-,per-per,PROPN-PROPN,PROPN-PROPN,compound-compound,compound-compound,NNP-NNP,NNP-NNP,1,1
11572,10495.0,26,With,0,12,13,1,11,12,-12,13,President,Chen Shui-bian,org,-,PROPN,PROPN-PROPN,compound,compound-nsubj,NNP,NNP-NNP,1,1
11573,11396.0,14,says,2,7,8,1,6,5,-5,6,President,Chen Shui-bian,per,-,PROPN,PROPN-NOUN,compound,compound-nsubj,NNP,NNP-NN,2,1
11574,13716.0,24,2001,0,17,18,1,16,5,-17,18,President,Chen Shui-bian,per,-,PROPN,PROPN-PROPN,compound,compound-pobj,NNP,NNP-NNP,2,1
11575,10496.0,22,acquired,6,10,20,10,9,1,-4,14,International Leisure Group,Air Europe,per-per-per,-,PROPN-PROPN-PROPN,PROPN-PROPN,compound-compound-pobj,compound-pobj,NNP-NNP-NNP,NNP-NNP,4,1
11576,10497.0,115,Slated,10,72,78,6,71,36,-62,68,Energy Recovery Inc.,California,--,per,PROPN-PROPN-PROPN,PROPN,compound-compound-pobj,pobj,NNP-NNP-NNP,NNP,4,1
11577,10498.0,36,met,9,7,8,1,6,27,2,-1,Malta,George Abela,per,-,PROPN,PROPN-PROPN,compound,compound-pobj,NNP,NNP-NNP,1,1
11578,10499.0,23,is,4,1,21,20,0,1,3,17,MacAndrews Forbes Holdings,Ronald Perelman,--,per-per,PROPN-PROPN-PROPN,PROPN-PROPN,compound-compound-compound,compound-conj,NNP-NNP-NNPS,NNP-NNP,8,1
11579,10500.0,14,ran,2,1,9,8,0,4,1,7,Bruton,Ireland,,org,PROPN,PROPN,nsubj,pobj,NNP,NNP,3,1
11580,10501.0,25,was,7,1,6,5,0,18,6,-1,Sweden,Carl Bildt,,per-per,PROPN,PROPN-PROPN,poss,compound-nsubj,NNP,NNP-NNP,3,1
11581,10503.0,30,is,14,1,13,12,0,16,13,-1,Kee Marcello,Sweden,org-org,,PROPN-PROPN,PROPN,compound-nsubj,pobj,NNP-NNP,NNP,1,1
11582,10504.0,28,returned,3,9,12,3,8,15,-6,9,London,Jack Buchanan,per,-,PROPN,PROPN-PROPN,pobj,compound-pobj,NNP,NNP-NNP,2,1
11583,10505.0,24,sung,2,8,22,14,7,1,-6,20,Letta Mbulu,Africa,org-org,,PROPN-PROPN,PROPN,compound-pobj,pobj,NNP-NNP,NNP,4,1
11584,10508.0,26,sold,18,1,21,20,0,4,17,3,The New Zealand Herald,APN News Media,---,per-per-per,DET-PROPN-PROPN-PROPN,PROPN-PROPN-PROPN,det-compound-compound-nsubjpass,compound-compound-pobj,DT-NNP-NNP-NNP,NNP-NNP-NNP,6,1
11585,10510.0,69,released,21,42,59,17,41,9,-21,38,UK,Graham Gouldman,per,-,PROPN,PROPN-PROPN,pobj,compound-compound,NNP,NNP-NNP,5,1
11586,10511.0,37,announced,6,5,9,4,4,27,1,3,Virgin Blue,V Australia,per-per,-,PROPN-PROPN,PROPN-PROPN,compound-nsubj,compound-nsubj,NNP-NNP,NNP-NNP,3,1
11587,10512.0,12,Released,0,2,7,5,1,4,-2,7,his,J Records,per,-,DET,PROPN-PROPN,poss,compound-pobj,PRP$,NNP-NNPS,4,1
11588,10515.0,23,spearheaded,2,16,21,5,15,1,-14,19,Translational Genomics Research Institute,TGen,per-per-per-per,,PROPN-PROPN-PROPN-PROPN,PROPN,compound-compound-compound-conj,appos,NNP-NNP-NNP-NNP,NNP,2,1
11589,10516.0,51,is,1,24,27,3,23,23,-23,26,Technical University of Madrid,Madrid,org-org-org-org,,PROPN-PROPN-ADP-PROPN,PROPN,compound-pobj-prep-pobj,conj,NNP-NNP-IN-NNP,NNP,6,1
11590,10517.0,73,well-aligned,9,5,38,33,4,34,4,29,Paris Foreign Missions Society,Alexandre de Rhodes,org-org-org-org,--,PROPN-PROPN-PROPN-PROPN,PROPN-X-PROPN,compound-compound-compound-pobj,compound-compound-pobj,NNP-NNP-NNPS-NNP,NNP-FW-NNP,-1,1
11591,10518.0,17,donated,2,12,15,3,11,1,-10,13,Louisiana,David Vitter,,org-org,PROPN,PROPN-PROPN,compound,compound-pobj,NNP,NNP-NNP,2,1
11592,11854.0,30,said,5,1,4,3,0,25,4,-1,Louisiana,David Vitter,org,-,PROPN,PROPN-PROPN,compound,compound-nsubj,NNP,NNP-NNP,2,1
11593,13060.0,50,have,4,22,25,3,21,24,-18,21,Louisiana,David Vitter,org,-,PROPN,PROPN-PROPN,compound,compound-nsubj,NNP,NNP-NNP,9,1
11594,10519.0,33,elected,16,15,11,-4,14,21,1,-5,DiNapoli,New York,org,-,PROPN,PROPN-PROPN,pobj,compound-compound,NNP,NNP-NNP,9,1
11595,10520.0,34,assembled,8,11,30,19,10,3,-3,22,Leinster House,Jack Lynch,per-per,-,PROPN-PROPN,PROPN-PROPN,compound-pobj,compound-nsubj,NNP-NNP,NNP-NNP,6,1
11596,10521.0,92,contained,2,24,29,5,23,62,-22,27,Harry Hopkins,Commerce,org-org,,PROPN-PROPN,PROPN,compound-nmod,pobj,NNP-NNP,NNP,2,1
11597,11516.0,24,was,12,7,12,5,6,11,5,0,Harry Hopkins,Commerce,per-per,,PROPN-PROPN,PROPN,compound-dobj,pobj,NNP-NNP,NNP,3,1
11598,10523.0,30,decided,8,1,5,4,0,24,7,-3,Shelley,Buzzcocks,per,,PROPN,PROPN,nsubj,poss,NNP,NNPS,4,1
11599,10524.0,41,display,12,6,22,16,5,18,6,10,Mexico,Kahlo,,per,PROPN,PROPN,compound,pobj,NNP,NNP,8,1
11600,10525.0,21,is,4,1,4,3,0,16,3,0,Loreto Mandeville Hall,Toorak,org-org-org,,PROPN-PROPN-PROPN,PROPN,compound-compound-compound,pobj,NNP-NNP-NNP,NNP,2,1
11601,10526.0,13,licensed,5,8,12,4,7,0,-3,7,Curtiss-Wright,US,org,,PROPN,PROPN,pobj,pobj,NNP,NNP,4,1
11602,10527.0,33,PRC,9,18,24,6,17,8,-9,15,Viet Minh,Vietnam,org-org,,PROPN-PROPN,PROPN,compound-poss,pobj,NNP-NNP,NNP,4,1
11603,10533.0,25,graduated,3,13,16,3,12,8,-10,13,Trinity Laban,London,per-per,,PROPN-PROPN,PROPN,compound-appos,pobj,NNP-NNP,NNP,2,1
11604,10534.0,39,said,3,23,26,3,22,12,-20,23,Richard Branson,Virgin Group,per-per,-,PROPN-PROPN,PROPN-PROPN,compound-poss,compound-pobj,NNP-NNP,NNP-NNP,1,1
11605,11141.0,35,named,7,14,17,3,13,17,-7,10,Richard Branson,Virgin Group,org-org,-,PROPN-PROPN,PROPN-PROPN,compound-poss,compound-pobj,NNP-NNP,NNP-NNP,1,1
11606,10536.0,15,headquartered,2,1,10,9,0,4,1,8,TCM,Georgia,org,,NOUN,PROPN,nsubjpass,poss,NN,NNP,7,1
11607,10537.0,17,went,2,5,7,2,4,9,-3,5,Nanne,Sweden,per,,PROPN,PROPN,pobj,pobj,NNP,NNP,5,1
11608,10538.0,27,is,3,1,10,9,0,16,2,7,Wood Green School,Oxfordshire,--,per,PROPN-PROPN-PROPN,PROPN,compound-compound-nsubj,compound,NNP-NNP-NNP,NNP,6,1
11609,10539.0,36,is,5,2,2,0,1,33,3,-3,Kansas City Terminal Railway,Kansas,per-per-per-per,,PROPN-PROPN-PROPN-PROPN,PROPN,compound-compound-compound-nsubj,nmod,NNP-NNP-NNP-NNP,NNP,0,1
11610,10541.0,29,Is,2,9,24,15,8,4,-7,22,Filipino,Manny Pacquiao,per,-,ADJ,PROPN-PROPN,compound,compound-pobj,JJ,NNP-NNP,5,1
11611,10542.0,64,are,1,10,13,3,9,50,-9,12,Georgia,J-Bo,org,,PROPN,PROPN,pobj,appos,NNP,NNP,2,1
11612,10544.0,53,broken,16,12,36,24,11,16,4,20,Serbia,by Boris Ta,per,--,PROPN,ADP-PROPN-PROPN,pobj,agent-compound-compound,NNP,IN-NNP-NNP,-1,1
11613,10545.0,22,formed,1,13,20,7,12,1,-12,19,Elizabeth Bowes-Lyon,Queen,-,per,PROPN-PROPN,PROPN,attr-cc,compound,NNP-NNP,NNP,4,1
11614,10546.0,14,includes,4,11,12,1,10,1,-7,8,composer,Ken Thorne,org,-,NOUN,PROPN-PROPN,compound,compound-pobj,NN,NNP-NNP,2,1
11615,10547.0,22,is,2,1,19,18,0,2,1,17,By Nature,New Hampshire,per-per,-,ADP-PROPN,PROPN-PROPN,prep-pobj,compound-compound,IN-NNP,NNP-NNP,10,1
11616,10548.0,13,England,1,2,5,3,1,7,-1,4,England,Pete Doherty,org,-,PROPN,PROPN-PROPN,ROOT,compound-ROOT,NNP,NNP-NNP,-1,1
11617,10549.0,22,Vancouver,0,18,20,2,17,1,-18,20,Libby Davies,NDP,-,per,PROPN-VERB,PROPN,compound-dobj,compound,NNP-VBZ,NNP,1,1
11618,10550.0,15,taught,2,10,14,4,9,0,-8,12,St Pius X College,Chatswood,per-per-per-per,,PROPN-PROPN-PROPN-PROPN,PROPN,compound-compound-compound-compound,pobj,NNP-NNP-NNP-NNP,NNP,5,1
11619,10552.0,22,known,2,1,12,11,0,9,1,10,He,Dark Tranquillity,,org-org,PRON,PROPN-PROPN,nsubjpass,compound-poss,PRP,NNP-NNP,4,1
11620,10553.0,47,went,1,13,15,2,12,31,-12,14,Arizona,Phelps Dodge,org,-,PROPN,PROPN-PROPN,pobj,compound-pobj,NNP,NNP-NNP,1,1
11621,10554.0,14,said,3,1,2,1,0,11,2,-1,Clarinetist,Buddy DeFranco,org,-,PROPN,PROPN-PROPN,compound,compound-nsubj,NNP,NNP-NNP,1,1
11622,10555.0,59,is,2,10,17,7,9,41,-8,15,Chris Smither,United Artists Records,-,per-per-per,PROPN-PROPN,PROPN-PROPN-PROPN,compound-pobj,compound-compound-pobj,NNP-NNP,NNP-NNP-NNPS,6,1
11623,10556.0,16,scored,11,10,15,5,9,0,1,4,Brad,Seattle,per,,PROPN,PROPN,compound,pobj,NNP,NNP,6,1
11624,11145.0,39,plan,1,31,35,4,30,3,-30,34,Brad,Seattle,org,,PROPN,PROPN,poss,poss,NNP,NNP,2,1
11625,10559.0,19,is,7,2,18,16,1,0,5,11,Universidad de Sucre,Colombia,--,per,PROPN-ADP-PROPN,PROPN,nmod-nmod-nmod,pobj,NNP-IN-NNP,NNP,4,1
11626,10560.0,30,Following,0,11,28,17,10,1,-11,28,John Adams,Quincy,-,per,PROPN-PROPN,PROPN,compound-nsubj,compound,NNP-NNP,NNP,7,1
11627,10561.0,31,is,2,10,14,4,9,16,-8,12,Pacific Lutheran University,Tacoma,--,per,PROPN-PROPN-PROPN,PROPN,compound-compound-pobj,compound,NNP-NNP-NNP,NNP,2,1
11628,10563.0,24,renamed,3,5,5,0,4,18,-2,2,Tranz Rail,Tranz Metro,org-org,-,PROPN-PROPN,PROPN-PROPN,compound-oprd,compound-nsubj,NNP-NNP,NNP-NNP,0,1
11629,10565.0,19,announced,3,1,10,9,0,8,2,7,His,Austrian,org,,DET,ADJ,poss,amod,PRP$,JJ,5,1
11630,10566.0,29,opened,9,5,20,15,4,8,4,11,Fairfield Ludlowe High School,2003,per-per-per-per,,PROPN-PROPN-PROPN-PROPN,NUM,compound-compound-compound-dobj,pobj,NNP-NNP-NNP-NNP,CD,5,1
11631,10567.0,33,revealed,17,1,4,3,0,28,16,-13,Longmont,DigitalGlobe,,per,PROPN,PROPN,compound,compound,NNP,NNP,-1,1
11632,10570.0,19,represented,7,3,14,11,2,4,4,7,Tulane University,NCAA,-,per,PROPN-PROPN,PROPN,compound-dobj,compound,NNP-NNP,NNP,7,1
11633,10574.0,15,provided,5,1,4,3,0,10,4,-1,Mikael Stanne,Dark Tranquillity,-,org-org,PROPN-PROPN,PROPN-PROPN,compound-nsubj,compound-pobj,NNP-NNP,NNP-NNP,2,1
11634,10575.0,20,inaugurated,12,8,9,1,7,10,4,-3,Brazil,Afonso Augusto Moreira Pena,org,---,PROPN,PROPN-PROPN-PROPN-PROPN,pobj,compound-compound-compound-nsubj,NNP,NNP-NNP-NNP-NNP,1,1
11635,10577.0,20,joined,9,4,12,8,3,7,5,3,Israel,IDF,org,,PROPN,PROPN,poss,compound,NNP,NNP,6,1
11636,10578.0,57,had,3,31,33,2,30,23,-28,30,Louisville,Central High School,,org-org-org,PROPN,PROPN-PROPN-PROPN,poss,compound-compound-pobj,NNP,NNP-NNP-NNP,3,1
11637,10579.0,36,was,3,8,22,14,7,13,-5,19,Australia,6th Division,,per-per,PROPN,ADJ-PROPN,pobj,compound-dobj,NNP,JJ-NNP,5,1
11638,10580.0,19,decided,3,1,12,11,0,6,2,9,Clayton County,C-Tran,org-org,,PROPN-PROPN,PUNCT,compound-nsubj,punct,NNP-NNP,.,6,1
11639,10582.0,43,has,29,7,22,15,6,20,22,-7,Australia,Anthony LaPaglia,org,-,PROPN,PROPN-PROPN,pobj,compound-conj,NNP,NNP-NNP,10,1
11640,10583.0,17,Round,0,8,11,3,7,5,-8,11,Arabs,USA,org,,PROPN,PROPN,conj,pobj,NNPS,NNP,4,1
11641,10584.0,20,was,2,4,14,10,3,5,-2,12,Spencer Perceval,United Kingdom,-,per-per,PROPN-PROPN,PROPN-PROPN,compound-attr,compound-pobj,NNP-NNP,NNP-NNP,6,1
11642,10585.0,10,opened,3,3,9,6,2,0,0,6,UPMC,Italy,per,,PROPN,PROPN,nsubj,pobj,NNP,NNP,1,1
11643,10586.0,37,said,35,12,33,21,11,3,23,-2,Shiseido,Tokyo,,per,PROPN,PROPN,pobj,compound,NNP,NNP,8,1
11644,10587.0,30,is,15,1,2,1,0,27,14,-13,Basket Zaragoza 2002,Zaragoza,per-per-per,,PROPN-PROPN-NUM,PROPN,compound-nsubj-nummod,pobj,NNP-NNP-CD,NNP,1,1
11645,10589.0,15,aired,2,11,13,2,10,1,-9,11,Finland,YLE TV2,per,-,PROPN,PROPN-PROPN,pobj,compound-pobj,NNP,NNP-NNP,1,1
11646,10590.0,23,is,12,12,12,0,11,10,0,0,Georgia,Georgia Army National Guard,,per-per-per-per,PROPN,PROPN-PROPN-PROPN-PROPN,appos,compound-compound-compound-pobj,NNP,NNP-NNP-NNP-NNP,0,1
11647,10591.0,17,is,8,2,16,14,1,0,6,8,Royal Children,Australia,org-org,,PROPN-PROPN,PROPN,compound-poss,pobj,NNP-NNPS,NNP,5,1
11648,10592.0,42,known,4,30,33,3,29,8,-26,29,Alan,Ruaidhri,org,,PROPN,PROPN,appos,compound,NNP,NNP,1,1
11649,10594.0,15,plays,2,1,2,1,0,12,1,0,CS,Mioveni,per,,PROPN,PROPN,compound,pobj,NNP,NNP,1,1
11650,10595.0,24,Located,0,19,23,4,18,0,-19,23,Jawaharlal Nehru Technological University,Hyderabad,per-per-per-per,,PROPN-PROPN-PROPN-PROPN,PROPN,compound-compound-compound-compound,pobj,NNP-NNP-NNP-NNP,NNP,2,1
11651,10596.0,36,contracted,22,7,9,2,6,26,15,-13,Yes,Bill Bruford,per,-,INTJ,PROPN-PROPN,compound,compound-dobj,UH,NNP-NNP,1,1
11652,10597.0,37,developed,4,7,9,2,6,27,-3,5,Germany,Opel,,per,PROPN,PROPN,pobj,compound,NNP,NNP,1,1
11653,10598.0,24,composed,3,20,22,2,19,1,-17,19,Arista,Barry Manilow,,per-per,PROPN,PROPN-PROPN,compound,compound-pobj,NNP,NNP-NNP,1,1
11654,10599.0,63,offers,7,44,53,9,43,9,-37,46,collaboration with The International Centre f,ysics,org-org-org-org-org-org,,NOUN-ADP-DET-PROPN-PROPN-PROPN,NOUN,dobj-prep-det-compound-compound-pobj,ROOT,NN-IN-DT-NNP-NNP-NNP,NNS,2,1
11655,10600.0,15,established,3,2,6,4,1,8,1,3,university,Fayetteville,,org,NOUN,PROPN,nsubjpass,pobj,NN,NNP,2,1
11656,10601.0,21,is,3,1,6,5,0,14,2,3,Enterprise Inns,UK,-,per,NOUN-PROPN,PROPN,compound-compound,nsubj,NN-NNP,NNP,3,1
11657,10603.0,26,admitted,16,2,15,13,1,10,14,-1,the Libertines,1997,per-per,,DET-PROPN,NUM,det-dobj,pobj,DT-NNPS,CD,3,1
11658,10604.0,17,entered,4,1,10,9,0,6,3,6,Runga,Christchurch,org,,PROPN,PROPN,nsubj,pobj,NNP,NNP,3,1
11659,10605.0,22,thought,9,1,7,6,0,14,8,-2,Apple Daily,Next Media,org-org,-,PROPN-PROPN,PROPN-PROPN,compound-nsubjpass,compound-appos,NNP-NNP,NNP-NNP,2,1
11660,10606.0,40,told,7,18,28,10,17,11,-11,21,Organization of the Petroleum Exporting Countries,its,-----,per,PROPN-ADP-DET-PROPN-PROPN-PROPN,DET,nsubj-prep-det-compound-compound-pobj,poss,NNP-IN-DT-NNP-NNP-NNPS,PRP$,7,1
11661,10608.0,23,travels,2,2,22,20,1,0,0,20,he,Florida,,per,PRON,PROPN,nsubj,conj,PRP,NNP,1,1
11662,10609.0,82,developed,7,36,54,18,35,27,-29,47,Pixies,Kim Deal,,per-per,VERB,PROPN-PROPN,conj,compound-oprd,VBZ,NNP-NNP,8,1
11663,10612.0,15,won,5,9,10,1,8,4,-4,5,congressman,Mike Crapo,,per-per,NOUN,PROPN-PROPN,compound,compound-pobj,NN,NNP-NNP,2,1
11664,10613.0,19,supported,6,8,10,2,7,8,-2,4,solidaire,Amir Khadir,org,-,NOUN,PROPN-PROPN,compound,compound-dobj,NN,NNP-NNP,1,1
11665,10614.0,23,was,2,1,19,18,0,3,1,17,Kiyohara Tamayo,4; Tok,-,per-per,PROPN-PROPN,NUM-PROPN,compound-nsubj,pobj-compound,NNP-NNP,CD-NNP,10,1
11666,10615.0,34,series,2,20,24,4,19,9,-18,22,KBO,SK Wyverns,per,-,PROPN,PROPN-PROPN,nmod,compound-nsubjpass,NNP,NNP-NNP,3,1
11667,10616.0,20,decided,10,10,14,4,9,5,0,4,Viacom,their,,per,PROPN,DET,nsubj,poss,NNP,PRP$,9,1
11668,10617.0,25,purchased,9,5,11,6,4,13,4,2,McGraw-Hill,Micropal,org,,NOUN,PROPN,compound,dobj,NN,NNP,3,1
11669,10620.0,22,is,8,1,18,17,0,3,7,10,Jonathan Glickman,Metro-Goldwyn-Mayer,-,org,PROPN-PROPN,PROPN,compound-nsubj,compound,NNP-NNP,NNP,7,1
11670,10621.0,17,is,8,1,16,15,0,0,7,8,Martin Kristjansen,Denmark,-,per,PROPN-PROPN,PROPN,compound-nsubj,pobj,NNP-NNP,NNP,2,1
11671,10622.0,21,formed,1,7,13,6,6,7,-6,12,Parlet,Mallia Franklin,per,-,PROPN,PROPN-PROPN,dobj,compound-conj,NNP,NNP-NNP,5,1
11672,10624.0,22,is,2,11,18,7,10,3,-9,16,MC Ren,Compton,-,per,PROPN-PROPN,PROPN,compound-pobj,compound,NNP-NNP,NNP,5,1
11673,10625.0,36,appointed,26,2,4,2,1,31,24,-22,Prime Minister,Seyni Oumarou,-,per-per,PROPN-PROPN,PROPN-PROPN,compound-compound,compound-nsubj,NNP-NNP,NNP-NNP,1,1
11674,10627.0,45,Rica,5,8,27,19,7,17,-3,22,UWCCR,San,per,,PROPN,PROPN,appos,pobj,NNP,NNP,3,1
11675,10628.0,42,was,9,32,36,4,31,5,-23,27,United Kingdom,Edward VII of the United Kingdom,org-org,-----,PROPN-PROPN,PROPN-PROPN-ADP-DET-PROPN-PROPN,compound-compound,compound-pobj-prep-det-compound-pobj,NNP-NNP,NNP-NNP-IN-DT-NNP-NNP,3,1
11676,10630.0,18,was,1,3,16,13,2,1,-2,15,Montgomery,Verve,org,,PROPN,PROPN,poss,compound,NNP,NNP,6,1
11677,10631.0,13,is,2,1,10,9,0,2,1,8,Kakatiya University,Andhra Pradesh,per-per,-,PROPN-PROPN,PROPN-PROPN,compound-nsubj,compound-compound,NNP-NNP,NNP-NNP,6,1
11678,10632.0,26,said,1,15,18,3,14,7,-14,17,Space Administration,NASA,per-per,,PROPN-PROPN,PROPN,conj-pobj,appos,NNP-NNP,NNP,1,1
11679,10633.0,8,is,5,2,5,3,1,2,3,0,Chris Squire,Yes,org-org,,PROPN-PROPN,PROPN,compound-nsubj,pobj,NNP-NNP,NNP,1,1
11680,10634.0,27,became,4,13,26,13,12,0,-9,22,Augusto Pinochet,Chile,-,org,PROPN-PROPN,PROPN,compound-pobj,pobj,NNP-NNP,NNP,7,1
11681,10635.0,24,carried,3,15,16,1,14,7,-12,13,President,Ranasinghe Premadasa,,per-per,PROPN,PROPN-PROPN,nsubj,compound-appos,NNP,NNP-NNP,1,1
11682,10636.0,32,helped,1,8,11,3,7,20,-7,10,Quebec,Lucien Bouchard,,per-per,PROPN,PROPN-PROPN,compound,compound-pobj,NNP,NNP-NNP,2,1
11683,10638.0,31,played,2,27,30,3,26,0,-25,28,Winnipeg Fury,1993,per-per,,PROPN-PROPN,NUM,compound-pobj,pobj,NNP-NNP,CD,6,1
11684,10640.0,33,nicknamed,5,4,25,21,3,7,1,20,Brian Epstein,Liverpool,per-per,,PROPN-PROPN,PROPN,compound-nsubj,compound,NNP-NNP,NNP,-1,1
11685,10643.0,16,has,2,1,10,9,0,5,1,8,Pierce Brosnan,her,-,org,PROPN-PROPN,DET,compound-nsubj,poss,NNP-NNP,PRP$,4,1
11686,10645.0,57,Serve,6,15,1,-14,14,55,-9,-5,John Cornyn,Senate Judiciary Committee,-,org-org-org,PROPN-PROPN,PROPN-PROPN-PROPN,compound-nsubj,compound-compound-pobj,NNP-NNP,NNP-NNP-NNP,-1,1
11687,13263.0,72,Let,7,20,26,6,19,45,-13,19,John Cornyn,Senate Judiciary Committee,per-per,--,PROPN-PROPN,PROPN-PROPN-PROPN,compound-nsubj,compound-compound-compound,NNP-NNP,NNP-NNP-NNP,4,1
11688,10647.0,14,included,5,11,12,1,10,1,-6,7,guitarist,Igor Grigoriev,,org-org,NOUN,PROPN-PROPN,compound,compound-conj,NN,NNP-NNP,1,1
11689,10648.0,54,started,2,22,29,7,21,24,-20,27,Armada,California,per,,PROPN,PROPN,pobj,pobj,NNP,NNP,4,1
11690,10649.0,21,contributed,2,1,16,15,0,4,1,14,Katharine Hepburn,Connecticut,-,per,PROPN-PROPN,PROPN,compound-nsubj,pobj,NNP-NNP,NNP,3,1
11691,10650.0,21,developed,8,5,6,1,4,14,3,-2,Mumbai,Air India,per,-,PROPN,PROPN-PROPN,compound,compound-pobj,NNP,NNP-NNP,1,1
11692,10652.0,34,is,1,1,18,17,0,15,0,17,Immortal,Abbath Doom Occulta,org,--,PROPN,PROPN-PROPN-PROPN,nsubj,compound-compound-conj,NNP,NNP-NNP-NNP,5,1
11693,10654.0,21,voted,2,10,13,3,9,7,-8,11,United States,Benjamin Harrison,org-org,-,PROPN-PROPN,PROPN-PROPN,compound-compound,compound-appos,NNP-NNP,NNP-NNP,2,1
11694,10657.0,41,was,21,5,23,18,4,17,16,2,Charles,Margaret of York,,org-org-org,PROPN,PROPN-ADP-PROPN,appos,attr-prep-pobj,NNP,NNP-IN-NNP,3,1
11695,10660.0,46,worked,1,41,44,3,40,1,-40,43,Miscellaneous Union,LHMU,-,per,PROPN-PROPN,PROPN,compound-conj,appos,NNP-NNP,NNP,8,1
11696,10663.0,19,is,3,1,7,6,0,11,2,4,NEMO Equipment,NH,-,per,PROPN-PROPN,PROPN,compound-compound,npadvmod,NNP-NNP,NNP,4,1
11697,10665.0,34,1961-1965,32,8,14,6,7,19,24,-18,Blair Moody,Michigan,-,per,PROPN-PROPN,PROPN,compound-pobj,nmod,NNP-NNP,NNP,4,1
11698,10666.0,15,At,0,7,14,7,6,0,-7,14,he,Austria,org,,PRON,PROPN,nsubj,pobj,PRP,NNP,5,1
11699,10667.0,54,scandal,5,25,28,3,24,25,-20,23,France,Georges Clemenceau,org,-,PROPN,PROPN-PROPN,compound,compound-conj,NNP,NNP-NNP,1,1
11700,10669.0,35,elected,19,7,22,15,6,12,12,3,Bo,Georgia,per,,PROPN,PROPN,compound,pobj,NNP,NNP,3,1
11701,10671.0,18,associated,3,6,11,5,5,6,-3,8,Serjical Strike,Serj Tankian,per-per,-,PROPN-PROPN,PROPN-PROPN,compound-compound,compound-pobj,NNP-NNP,NNP-NNP,4,1
11702,10672.0,17,signed,8,7,11,4,6,5,1,3,Walker,Polygram,,org,PROPN,PROPN,pobj,pobj,NNP,NNP,2,1
11703,10673.0,45,issued,31,20,28,8,19,16,11,-3,David McComb,Melbourne,-,org,PROPN-PROPN,PROPN,compound-pobj,npadvmod,NNP-NNP,NNP,8,1
11704,10674.0,26,listed,16,7,24,17,6,1,9,8,New Zealand,Waikato Hospital,-,per-per,PROPN-PROPN,PROPN-PROPN,compound-pobj,compound-pobj,NNP-NNP,NNP-NNP,9,1
11705,10675.0,29,',0,17,19,2,16,9,-17,19,Missouri,Kit Bond,per,-,PROPN,PROPN-PROPN,compound,compound-oprd,NNP,NNP-NNP,3,1
11706,10676.0,23,School,9,6,8,2,5,14,3,-1,University of Pittsburgh,Pittsburgh,--,per,PROPN-ADP-PROPN,PROPN,nmod-prep-pobj,compound,NNP-IN-NNP,NNP,3,1
11707,10678.0,12,lives,1,1,5,4,0,6,0,4,She,Massachusetts,,per,PRON,PROPN,nsubj,pobj,PRP,NNP,1,1
11708,10679.0,24,were,3,12,15,3,11,8,-9,12,United Kingdom,MI5,-,per,PROPN-PROPN,PROPN,compound-pobj,conj,NNP-NNP,NNP,3,1
11709,10681.0,18,trained,2,9,16,7,8,1,-7,14,Ontario,Shane Sewell,per,-,PROPN,PROPN-PROPN,pobj,compound-conj,NNP,NNP-NNP,2,1
11710,10682.0,5,resides,1,1,4,3,0,0,0,3,Mel,Orlando,org,,PROPN,PROPN,nsubj,pobj,NNP,NNP,1,1
11711,10683.0,21,is,12,1,17,16,0,3,11,5,Boisfeuillet,the Washington Post,,org-org-org,PROPN,DET-PROPN-PROPN,nsubj,det-compound-compound,NNP,DT-NNP-NNP,9,1
11712,10684.0,32,made,1,20,21,1,19,10,-19,20,actor,John Barrymore,org,-,NOUN,PROPN-PROPN,compound,compound-pobj,NN,NNP-NNP,1,1
11713,10685.0,24,located,5,1,3,2,0,20,4,-2,Lennart Meri,Tallinn,-,org,PROPN-PROPN,PROPN,compound-compound,compound,NNP-NNP,NNP,1,1
11714,10686.0,32,in,0,8,11,3,7,20,-8,11,Northeastern University,Boston,-,org,PROPN-PROPN,PROPN,compound-pobj,compound,NNP-NNP,NNP,1,1
11715,10687.0,23,wrestled,4,15,17,2,14,5,-11,13,Massachusetts,Killer Kowalski,per,-,PROPN,PROPN-PROPN,pobj,compound-poss,NNP,NNP-NNP,2,1
11716,10689.0,34,come,2,19,24,5,18,9,-17,22,Redman,Def Jam,org,-,PROPN,PROPN-PROPN,pobj,compound-appos,NNP,NNP-NNP,3,1
11717,13800.0,35,was,23,10,7,-3,9,27,13,-16,Redman,Def Jam,org,-,PROPN,PROPN-PROPN,conj,compound-compound,NNP,NNP-NNP,3,1
11718,10690.0,20,felt,2,11,19,8,10,0,-9,17,Alexandria,him,per,,PROPN,PRON,pobj,dobj,NNP,PRP,4,1
11719,10691.0,68,was,2,56,67,11,55,0,-54,65,Pol Pot,Cambodia,per-per,,PROPN-PROPN,PROPN,compound-pobj,pobj,NNP-NNP,NNP,9,1
11720,10826.0,41,electing,10,18,38,20,17,2,-8,28,Pol Pot,Cambodia,org-org,,PROPN-PROPN,PROPN,compound-pobj,compound,NNP-NNP,NNP,9,1
11721,10693.0,17,is,2,9,15,6,8,1,-7,13,Parts Labor,Jagjaguwar Records,per-per,-,PROPN-PROPN,PROPN-PROPN,compound-pobj,compound-pobj,NNP-NNP,NNP-NNPS,3,1
11722,12899.0,17,is,2,9,15,6,8,1,-7,13,Parts Labor,Jagjaguwar Records,-,per-per,PROPN-PROPN,PROPN-PROPN,compound-pobj,compound-pobj,NNP-NNP,NNP-NNPS,3,1
11723,10695.0,28,finished,1,6,11,5,5,16,-5,10,Big Ten,Northwestern Wildcats,-,per-per,PROPN-PROPN,PROPN-PROPN,compound-compound,compound-pobj,NNP-NNP,NNP-NNPS,6,1
11724,10696.0,22,had,5,17,20,3,16,1,-12,15,Philadelphia,John Neagle,per,-,PROPN,PROPN-PROPN,compound,compound-pobj,NNP,NNP-NNP,2,1
11725,10697.0,21,Exhibition,4,1,19,18,0,1,3,15,Childe Hassam,New York,per-per,-,PROPN-PROPN,PROPN-PROPN,compound-compound,compound-pobj,NNP-NNP,NNP-NNP,5,1
11726,10698.0,22,bought,4,12,19,7,11,2,-8,15,Paris,his,org,,PROPN,DET,pobj,poss,NNP,PRP$,4,1
11727,10700.0,19,are,3,2,18,16,1,0,1,15,Bethune-Cookman Wildcats,Florida,per-per,,PROPN-PROPN,PROPN,amod-nsubj,pobj,NNP-NNPS,NNP,7,1
11728,10701.0,26,stayed,2,2,16,14,1,9,0,14,Ramphaiphanni,Thailand,per,,PROPN,PROPN,nsubj,pobj,NNP,NNP,2,1
11729,10702.0,24,produced,3,11,1,-10,10,22,-8,-2,ABC Studios,The Walt Disney Company,-,per-per-per-per,PROPN-NOUN,DET-PROPN-PROPN-PROPN,compound-pobj,det-compound-compound-compound,NNP-NNS,DT-NNP-NNP-NNP,5,1
11730,10705.0,26,was,10,1,17,16,0,8,9,7,Benjamin Harrison,United States,org-org,-,PROPN-PROPN,PROPN-PROPN,compound-nsubj,compound-pobj,NNP-NNP,NNP-NNP,4,1
11731,10707.0,29,traces,3,1,15,14,0,13,2,12,Face to Face,Matt Riddle,per-per-per,-,NOUN-ADP-PROPN,PROPN-PROPN,nsubj-prep-pobj,compound-nsubj,NN-IN-NNP,NNP-NNP,5,1
11732,10709.0,24,carried,7,4,6,2,3,17,3,-1,Prime Minister,Mohamed Ghannouchi,per-per,-,PROPN-PROPN,PROPN-PROPN,compound-compound,compound-nsubj,NNP-NNP,NNP-NNP,1,1
11733,10710.0,20,is,1,9,18,9,8,1,-8,17,Regina Belle,Pendulum Records,-,per-per,PROPN-PROPN,PROPN-PROPN,compound-pobj,compound-pobj,NNP-NNP,NNP-NNPS,6,1
11734,10711.0,44,launched,3,1,8,7,0,35,2,5,Malibu Comics,Dave Olbrich,per-per,-,PROPN-PROPN,PROPN-PROPN,compound-nsubjpass,compound-pobj,NNP-NNPS,NNP-NNP,3,1
11735,10713.0,38,argued,21,4,19,15,3,18,17,-2,Parliament,Bung Mokhtar Radin,per,--,PROPN,PROPN-PROPN-PROPN,pobj,compound-compound-pobj,NNP,NNP-NNP-NNP,4,1
11736,10714.0,19,merged,6,3,9,6,2,9,3,3,Shanghai,SJTU,,per,PROPN,PROPN,compound,pobj,NNP,NNP,3,1
11737,10715.0,35,went,3,7,7,0,6,27,-4,4,National Institutes of Health,National Institute of Mental Health,org-org-org-org,----,PROPN-PROPN-ADP-PROPN,PROPN-PROPN-ADP-PROPN-PROPN,compound-pobj-prep-pobj,compound-pobj-prep-compound-pobj,NNP-NNPS-IN-NNP,NNP-NNP-IN-NNP-NNP,0,1
11738,10716.0,18,awarded,3,5,17,12,4,0,-2,14,Bharat Bhushan,India,per-per,,PROPN-PROPN,PROPN,compound-compound,appos,NNP-NNP,NNP,3,1
11739,11498.0,25,awarded,2,5,15,10,4,9,-3,13,Bharat Bhushan,India,-,per,PROPN-PROPN,PROPN,compound-compound,nsubj,NNP-NNP,NNP,3,1
11740,10717.0,37,ran,7,4,28,24,3,8,3,21,Ontario,Bob Delaney,,org-org,PROPN,PROPN-PROPN,compound,compound-pobj,NNP,NNP-NNP,6,1
11741,10718.0,31,witnessed,12,8,11,3,7,19,4,-1,Lesotho,Pakalitha Mosisili,,org-org,PROPN,PROPN-PROPN,compound,compound-conj,NNP,NNP-NNP,2,1
11742,10719.0,28,became,21,9,10,1,8,17,12,-11,Army Air Corps,Air Corps Tactical School,--,per-per-per-per,PROPN-PROPN-PROPN,PROPN-PROPN-PROPN-PROPN,compound-compound-pobj,compound-compound-compound-attr,NNP-NNP-NNP,NNP-NNP-NNP-NNP,1,1
11743,10721.0,31,elected,2,1,14,13,0,16,1,12,Wilmot,Pennsylvania,,per,PROPN,PROPN,nsubjpass,pobj,NNP,NNP,2,1
11744,10722.0,32,went,4,7,27,20,6,4,-3,23,England,Henry Irving,,org-org,PROPN,PROPN-PROPN,pobj,compound-poss,NNP,NNP-NNP,6,1
11745,10724.0,24,is,6,5,21,16,4,2,1,15,London Buses,Transport for London,per-per,--,PROPN-PROPN,PROPN-ADP-PROPN,compound-pobj,pobj-prep-pobj,NNP-NNPS,NNP-IN-NNP,7,1
11746,10725.0,41,re-branded,16,14,2,-12,13,38,2,-14,Disney-ABC Television Group,Disney,--,org,PROPN-PROPN-PROPN,PROPN,compound-compound-nsubj,compound,NNP-NNP-NNP,NNP,4,1
11747,10726.0,41,December,8,1,7,6,0,33,7,-1,European Aeronautic Defence,EADS,--,per,PROPN-PROPN-PROPN,PROPN,amod-nmod-nmod,compound,NNP-NNP-NNP,NNP,3,1
11748,10727.0,47,included,24,39,44,5,38,2,-15,20,Tim Schafer,Double Fine Productions,-,org-org-org,PROPN-PROPN,ADJ-PROPN-PROPN,compound-pobj,compound-compound-pobj,NNP-NNP,JJ-NNP-NNPS,4,1
11749,11862.0,38,leave,13,2,25,23,1,12,11,12,Tim Schafer,Double Fine Productions,-,per-per-per,PROPN-PROPN,ADJ-PROPN-PROPN,compound-nsubj,compound-compound-appos,NNP-NNP,JJ-NNP-NNPS,5,1
11750,10728.0,20,moved,6,4,15,11,3,4,2,9,South Vietnam,he,-,org,PROPN-PROPN,PRON,compound-compound,nsubj,NNP-NNP,PRP,4,1
11751,10731.0,27,worked,16,1,9,8,0,17,15,-7,Hill,Australia,org,,PROPN,PROPN,nsubjpass,pobj,NNP,NNP,2,1
11752,10732.0,33,re-signed,6,5,9,4,4,23,1,3,George Michael,Sony,per-per,,PROPN-PROPN,PROPN,compound-nsubj,compound,NNP-NNP,NNP,3,1
11753,10734.0,29,founded,4,2,7,5,1,21,2,3,Cooper Union,1859,-,per,PROPN-PROPN,NUM,compound-nsubjpass,pobj,NNP-NNP,CD,2,1
11754,10735.0,27,is,1,7,10,3,6,16,-6,9,Greek,Constantine Mitsotakis,org,-,ADJ,PROPN-PROPN,amod,compound-pobj,JJ,NNP-NNP,2,1
11755,10738.0,18,is,1,5,13,8,4,4,-4,12,Anthrax,Joey Belladonna,,per-per,PROPN,PROPN-PROPN,compound,compound-pobj,NNP,NNP-NNP,6,1
11756,10740.0,38,saw,2,14,18,4,13,19,-12,16,Baptist Bible College,Missouri,per-per-per,,PROPN-PROPN-PROPN,PROPN,compound-compound-compound,pobj,NNP-NNP-NNP,NNP,2,1
11757,10741.0,17,held,6,10,13,3,9,3,-4,7,Hunter College,New York,-,org-org,PROPN-PROPN,PROPN-PROPN,compound-pobj,compound-compound,NNP-NNP,NNP-NNP,3,1
11758,13222.0,51,given,2,22,31,9,21,19,-20,29,Hunter College,New York,per-per,-,PROPN-PROPN,PROPN-PROPN,compound-compound,compound-compound,NNP-NNP,NNP-NNP,6,1
11759,10742.0,28,Following,0,2,17,15,1,10,-2,17,FRETILIN,Alkatiri,,per,PROPN,PROPN,poss,nsubjpass,NNP,NNP,5,1
11760,10744.0,75,filed,53,34,43,9,33,31,19,-10,San Francisco Public Utilities Commission,SFPUC,----,per,PROPN-PROPN-PROPN-PROPN-PROPN,PROPN,compound-compound-compound-compound-pobj,poss,NNP-NNP-NNP-NNPS-NNP,NNP,2,1
11761,10745.0,27,tells,2,16,23,7,15,3,-14,21,Queen,Elizabeth I of England,per,---,PROPN,PROPN-PROPN-ADP-PROPN,appos,appos-appos-prep-pobj,NNP,NNP-NNP-IN-NNP,3,1
11762,10751.0,10,is,1,1,9,8,0,0,0,8,Kiuas,Finland,,per,PROPN,PROPN,nsubj,pobj,NNP,NNP,1,1
11763,10752.0,18,chosen,3,1,11,10,0,6,2,8,His,Singapore,per,,DET,PROPN,poss,pobj,PRP$,NNP,5,1
11764,10753.0,29,became,1,10,25,15,9,3,-9,24,The Angels,Caprice,org-org,,DET-PROPN,PROPN,det-appos,compound,DT-NNPS,NNP,4,1
11765,10754.0,10,born,2,1,9,8,0,0,1,7,Carter,Canada,,per,PROPN,PROPN,nsubjpass,pobj,NNP,NNP,2,1
11766,10756.0,34,include,2,25,27,2,24,6,-23,25,Heinrich,Germany,per,,PROPN,PROPN,pobj,pobj,NNP,NNP,2,1
11767,10758.0,34,said,28,18,32,14,17,1,10,4,Japan,Yukihiro,per,,PROPN,PROPN,nmod,compound,NNP,NNP,9,1
11768,10760.0,26,got,17,16,24,8,15,1,1,7,Him Kerosene,Telegram,-,org,PROPN-PROPN,PROPN,compound-nsubj,compound,NNP-NNP,NNP,4,1
11769,10761.0,40,proposed,13,5,16,11,4,23,8,3,Cesare Previti,Minister,per-per,,PROPN-PROPN,PROPN,compound-nsubj,compound,NNP-NNP,NNP,4,1
11770,10762.0,30,closed,21,12,18,6,11,11,9,-3,New York City,Morris High School,org-org-org,--,PROPN-PROPN-PROPN,PROPN-PROPN-PROPN,compound-compound-poss,compound-compound-appos,NNP-NNP-NNP,NNP-NNP-NNP,11,1
11771,10763.0,30,Home,0,9,14,5,8,15,-9,14,University of Bologna,1088,--,per,PROPN-ADP-PROPN,NUM,pobj-prep-pobj,pobj,NNP-IN-NNP,CD,7,1
11772,10765.0,18,is,9,1,14,13,0,3,8,5,Usher,songwriter,,per,PROPN,NOUN,compound,compound,NNP,NN,3,1
11773,10766.0,19,established,7,1,5,4,0,13,6,-2,Foxcroft Academy,Dover-Foxcroft,-,per,PROPN-PROPN,PROPN,compound-nsubjpass,amod,NNP-NNP,NNP,4,1
11774,10768.0,17,has,2,7,12,5,6,4,-5,10,singer,A. R. Rahman,per,--,NOUN,NOUN-PROPN-PROPN,compound,compound-compound-pobj,NN,NN-NNP-NNP,7,1
11775,10770.0,37,returned,8,4,11,7,3,25,4,3,Thaksin,Thailand,org,,PROPN,PROPN,appos,pobj,NNP,NNP,5,1
11776,10771.0,41,said,10,13,20,7,12,20,-3,10,Owen,Chicago,per,,PROPN,PROPN,nsubj,pobj,NNP,NNP,4,1
11777,10773.0,31,was,1,12,13,1,11,17,-11,12,1st Rhode Island Regiment,Rhode Island,per-per-per-per,-,ADJ-PROPN-PROPN-PROPN,PROPN-PROPN,amod-compound-compound-appos,compound-pobj,JJ-NNP-NNP-NNP,NNP-NNP,2,1
11778,10774.0,18,started,5,15,16,1,14,1,-10,11,Archbishop,Juan Sinforiano,,per-per,PROPN,PROPN-PROPN,compound,compound-pobj,NNP,NNP-NNP,1,1
11779,10775.0,40,described,24,4,21,17,3,18,20,-3,Department,New Zealand,org,-,PROPN,PROPN-PROPN,nsubj,compound-compound,NNP,NNP-NNP,3,1
11780,10777.0,24,assigned,2,16,19,3,15,4,-14,17,Infantry,Fort Benning,,per-per,PROPN,PROPN-PROPN,compound,compound-pobj,NNP,NNP-NNP,2,1
11781,10778.0,19,is,8,1,11,10,0,7,7,3,Loni Ackerman,American,per-per,,PROPN-PROPN,PROPN,compound-nsubj,nmod,NNP-NNP,NNP,3,1
11782,10780.0,32,sailed,26,9,10,1,8,21,17,-16,Queen,Cleopatra VII,per,-,PROPN,PROPN-PROPN,compound,compound-nsubjpass,NNP,NNP-NNP,1,1
11783,10781.0,19,Things,0,6,16,10,5,2,-6,16,Ellsworth Kelly,American,-,per,PROPN-PROPN,PROPN,compound-compound,compound,NNP-NNP,NNP,5,1
11784,10782.0,28,carried,4,6,24,18,5,3,-2,20,Joseph Howe,Halifax,-,org,PROPN-PROPN,PROPN,compound-dobj,compound,NNP-NNP,NNP,8,1
11785,10783.0,35,became,7,7,19,12,6,15,0,12,Vee-Jay,John Lee Hooker,org,--,PROPN,PROPN-PROPN-PROPN,nsubj,compound-compound-compound,NNP,NNP-NNP-NNP,8,1
11786,10784.0,24,is,17,15,21,6,14,2,2,4,Toquinho,singer,per,,PROPN,NOUN,pobj,attr,NNP,NN,3,1
11787,10785.0,49,include,3,8,16,8,7,32,-5,13,Group of Eight,University of Adelaide,--,per-per-per,PROPN-ADP-NUM,PROPN-ADP-PROPN,nmod-prep-pobj,pobj-prep-pobj,NNP-IN-CD,NNP-IN-NNP,6,1
11788,10786.0,24,launched,7,1,4,3,0,19,6,-3,Motorola,NYSE,,per,PROPN,PROPN,compound,appos,NNP,NNP,2,1
11789,10788.0,60,announced,9,8,7,-1,7,52,1,-2,Rod Paige,Education,per-per,,PROPN-PROPN,PROPN,compound-nsubj,pobj,NNP-NNP,NNP,1,1
11790,10789.0,10,established,4,3,4,1,2,5,1,0,Louise Hay,Hay House,per-per,-,PROPN-PROPN,PROPN-PROPN,compound-nsubj,compound-compound,NNP-NNP,NNP-NNP,1,1
11791,10791.0,36,sold,2,24,26,2,23,9,-22,24,Italy,Pininfarina,per,,PROPN,PROPN,poss,pobj,NNP,NNP,5,1
11792,10793.0,32,won,2,1,4,3,0,27,1,2,Lee Myung-bak,South Korea,-,org-org,PROPN-PROPN,PROPN-PROPN,nsubj-punct,compound-poss,NNP-NNP,NNP-NNP,2,1
11793,10794.0,22,agreed,1,9,12,3,8,9,-8,11,Indonesia,Bumi Resources,,org-org,PROPN,PROPN-PROPN,poss,compound-pobj,NNP,NNP-NNP,4,1
11794,10797.0,71,was,34,6,24,18,5,46,28,-10,McEwen,Australia,,per,PROPN,PROPN,poss,pobj,NNP,NNP,-1,1
11795,10798.0,20,Oregon,0,1,3,2,0,16,-1,3,Oregon,Hardy Myers,per,-,NOUN,ADJ-NOUN,ROOT,compound-appos,NN,JJ-NNS,2,1
11796,10799.0,25,started,1,1,3,2,0,21,0,2,Baker,FlightAware,per,,PROPN,PROPN,nsubj,dobj,NNP,NNP,1,1
11797,10803.0,18,dissolved,3,6,13,7,5,4,-3,10,Guido Vildoso,Bolivia,-,per,PROPN-PROPN,PROPN,compound-nsubj,pobj,NNP-NNP,NNP,2,1
11798,10804.0,16,advocated,8,3,7,4,2,8,5,-1,Donald Regan,Treasury,per-per,,PROPN-PROPN,PROPN,compound-compound,compound,NNP-NNP,NNP,3,1
11799,10805.0,43,am,1,29,32,3,28,10,-28,31,Ed Derwinski,Illinois,per-per,,PROPN-PROPN,PROPN,compound-nsubj,pobj,NNP-NNP,NNP,1,1
11800,10806.0,7,is,4,1,2,1,0,4,3,-2,Actress,Gena Lee Nolin,,per-per-per,PROPN,PROPN-PROPN-PROPN,compound,compound-compound-nsubj,NNP,NNP-NNP-NNP,1,1
11801,10807.0,18,served,1,1,8,7,0,9,0,7,He,Democratic Party,,per-per,PRON,PROPN-PROPN,nsubj,compound-pobj,PRP,NNP-NNP,4,1
11802,10808.0,41,was,1,25,35,10,24,5,-24,34,Pink Floyd,Nick Mason,org-org,-,PROPN-PROPN,PROPN-PROPN,compound-pobj,compound-conj,NNP-NNP,NNP-NNP,8,1
11803,10809.0,17,born,2,5,11,6,4,5,-3,9,Chatham,Lemuel John Tweedie,org,--,PROPN,PROPN-PROPN-PROPN,compound,compound-compound-pobj,NNP,NNP-NNP-NNP,4,1
11804,10810.0,21,is,1,11,19,8,10,1,-10,18,Brian Larsen,Protocol Records,-,per-per,PROPN-PROPN,PROPN-PROPN,compound-pobj,compound-pobj,NNP-NNP,NNP-NNPS,5,1
11805,10811.0,14,fell,10,1,8,7,0,5,9,-2,Huang Guangyu,GOME Electrical Appliances,-,per-per-per,PROPN-PROPN,PROPN-PROPN-PROPN,compound-nsubj,compound-compound-pobj,NNP-NNP,NNP-NNP-NNPS,3,1
11806,10812.0,47,is,5,20,20,0,19,26,-15,15,Albemarle High School,Albemarle County,org-org-org,-,PROPN-PROPN-PROPN,PROPN-PROPN,compound-compound-conj,compound-compound,NNP-NNP-NNP,NNP-NNP,0,1
11807,10815.0,30,named,10,4,8,4,3,21,6,-2,Villanova Preparatory School,Ojai,org-org-org,,PROPN-PROPN-PROPN,PROPN,compound-compound-pobj,compound,NNP-NNP-NNP,NNP,3,1
11808,10816.0,28,is,11,1,10,9,0,17,10,-1,Lani Misalucha,Philippines,org-org,,PROPN-PROPN,PROPN,compound-nsubj,pobj,NNP-NNP,NNP,1,1
11809,10818.0,19,was,5,4,17,13,3,1,1,12,Sabinal,his,org,,PROPN,DET,compound,poss,NNP,PRP$,7,1
11810,10819.0,23,be,2,12,15,3,11,7,-10,13,SingTel,Optus,per,,PROPN,PROPN,conj,dobj,NNP,NNP,6,1
11811,10820.0,33,Sankara,1,1,25,24,0,7,0,24,Thomas Sankara,Burkina Faso,per-per,-,PROPN-PROPN,PROPN-PROPN,compound-ROOT,compound-oprd,NNP-NNP,NNP-NNP,3,1
11812,10822.0,40,is,8,2,23,21,1,16,6,15,Stony Brook University,State University of New York at,per-per-per,-----,PROPN-PROPN-PROPN,PROPN-PROPN-ADP-PROPN-PROPN-ADP,compound-nmod-nmod,compound-pobj-prep-compound-pobj-prep,NNP-NNP-NNP,NNP-NNP-IN-NNP-NNP-IN,10,1
11813,10823.0,23,worked,6,13,18,5,12,4,-7,12,Google,Larry Page,per,-,PROPN,PROPN-PROPN,poss,compound-pobj,NNP,NNP-NNP,4,1
11814,12889.0,63,grew,34,5,45,40,4,17,29,11,Google,Larry Page,,org-org,PROPN,PROPN-PROPN,poss,compound-pobj,NNP,NNP-NNP,9,1
11815,12961.0,27,dreamed,8,1,3,2,0,23,7,-5,Google,Larry Page,org,-,PROPN,PROPN-PROPN,compound,compound-nsubj,NNP,NNP-NNP,2,1
11816,12975.0,27,plan,7,1,3,2,0,23,6,-4,Google,Larry Page,per,-,PROPN,PROPN-PROPN,compound,compound-appos,NNP,NNP-NNP,2,1
11817,13131.0,41,promised,12,2,8,6,1,32,10,-4,Google,Larry Page,per,-,PROPN,PROPN-PROPN,nsubj,compound-nsubj,NNP,NNP-NNP,1,1
11818,10824.0,30,was,1,13,18,5,12,11,-12,17,Manuel Belgrano,Argentina,per-per,,PROPN-PROPN,PROPN,compound-pobj,pobj,NNP-NNP,NNP,4,1
11819,10825.0,22,is,7,2,21,19,1,0,5,14,Bowling Green Falcons,Ohio,per-per-per,,PROPN-PROPN-PROPN,PROPN,compound-compound-compound,pobj,NNP-NNP-NNPS,NNP,8,1
11820,10827.0,35,provided,16,11,26,15,10,8,5,10,8th Fighter Wing,Korea,--,per,ADJ-PROPN-PROPN,PROPN,amod-compound-appos,pobj,JJ-NNP-NNP,NNP,6,1
11821,10828.0,17,is,10,2,9,7,1,7,8,-1,Puch,Graz,,per,PROPN,PROPN,nsubj,pobj,NNP,NNP,3,1
11822,10831.0,21,was,5,1,5,4,0,15,4,0,Arriva North West and Wales,Wales,----,org,PROPN-PROPN-PROPN-CCONJ-PROPN,PROPN,compound-compound-nsubj-cc-conj,conj,NNP-NNP-NNP-CC-NNP,NNP,2,1
11823,10832.0,29,Groundstory,12,23,28,5,22,0,-11,16,Agnes Scott College,Georgia,org-org-org,,PROPN-PROPN-PROPN,PROPN,compound-compound-pobj,pobj,NNP-NNP-NNP,NNP,9,1
11824,10833.0,19,was,8,1,14,13,0,4,7,6,Vivendi Games,Sierra Entertainment,-,per-per,PROPN-PROPN,PROPN-PROPN,compound-nsubj,compound-pobj,NNP-NNPS,NNP-NNP,4,1
11825,10834.0,22,voted,3,2,8,6,1,13,1,5,he,NCAA,per,,PRON,PROPN,nsubjpass,compound,PRP,NNP,4,1
11826,10835.0,16,married,3,5,15,10,4,0,-2,12,Audrey,DC,org,,PROPN,PROPN,compound,pobj,NNP,NNP,2,1
11827,10837.0,29,reached,4,12,25,13,11,3,-8,21,NCAA,WVU,,per,PROPN,PROPN,compound,compound,NNP,NNP,10,1
11828,10838.0,18,describes,4,2,3,1,1,14,2,-1,Grace,Presbyterian Church,,per-per,PROPN,PROPN-PROPN,compound,compound-nsubj,NNP,NNP-NNP,1,1
11829,10839.0,61,were,2,1,13,12,0,47,1,11,Pale Saints,Ian Masters,per-per,-,PROPN-PROPN,PROPN-PROPN,compound-nsubj,compound-pobj,NNP-NNPS,NNP-NNP,5,1
11830,10840.0,19,is,2,1,9,8,0,9,1,7,Woodbridge School,Suffolk,per-per,,PROPN-PROPN,PROPN,compound-nsubj,compound,NNP-NNP,NNP,4,1
11831,10842.0,40,born,7,33,39,6,32,0,-26,32,Shawlands Academy,Glasgow,org-org,,PROPN-PROPN,PROPN,compound-pobj,pobj,NNP-NNP,NNP,4,1
11832,10843.0,37,marked,3,9,11,2,8,25,-6,8,Sweden,Carola,,per,PROPN,PROPN,poss,pobj,NNP,NNP,6,1
11833,10844.0,34,led,1,12,26,14,11,7,-11,25,SIS,United Kingdom,org,-,PROPN,PROPN-PROPN,pobj,compound-dobj,NNP,NNP-NNP,9,1
11834,10845.0,29,is,2,7,8,1,6,20,-5,6,Alliance Boots,Boots,-,per,PROPN-PROPN,PROPN,compound-pobj,compound,NNP-NNPS,NNPS,2,1
11835,11043.0,22,formed,3,1,2,1,0,19,2,-1,Alliance Boots,Boots,-,per,PROPN-PROPN,PROPN,compound-nsubjpass,compound,NNP-NNPS,NNPS,2,1
11836,13964.0,34,formed,3,1,2,1,0,31,2,-1,Alliance Boots,Boots,per-per,,PROPN-PROPN,PROPN,compound-nsubjpass,compound,NNP-NNPS,NNPS,2,1
11837,10846.0,19,ruled,5,8,15,7,7,3,-3,10,Mary I of England,Philip II of Spain,org-org-org-org,---,PROPN-PROPN-ADP-PROPN,PROPN-PROPN-ADP-PROPN,compound-pobj-prep-pobj,compound-appos-prep-pobj,NNP-NNP-IN-NNP,NNP-NNP-IN-NNP,2,1
11838,10847.0,87,With,0,15,23,8,14,63,-15,23,Chinsali,Kenneth Kaunda,per,-,PROPN,PROPN-PROPN,pobj,compound-pobj,NNP,NNP-NNP,7,1
11839,10848.0,49,hosted,4,7,10,3,6,38,-3,6,three,Shinji Orito,per,-,NUM,PROPN-PROPN,nummod,compound-ROOT,CD,NNP-NNP,1,1
11840,10850.0,30,Jr.,2,1,16,15,0,13,1,14,Derek Johnson,Pro,per-per,,PROPN-PROPN,PROPN,compound-compound,nsubj,NNP-NNP,NNP,3,1
11841,10851.0,25,released,7,1,11,10,0,13,6,4,Jackson,United States,per,-,PROPN,PROPN-PROPN,poss,compound-pobj,NNP,NNP-NNP,5,1
11842,10852.0,82,recorded,3,22,28,6,21,53,-19,25,Ella Fitzgerald,Verve,-,per,PROPN-PROPN,PROPN,compound-pobj,compound,NNP-NNP,NNP,4,1
11843,10962.0,22,included,2,1,8,7,0,13,1,6,Ella Fitzgerald,Verve,org-org,,PROPN-PROPN,PROPN,compound-nsubj,compound,NNP-NNP,NNP,5,1
11844,10853.0,19,were,1,14,17,3,13,1,-13,16,Rolling Stones,Bill Wyman,per-per,-,PROPN-PROPN,PROPN-PROPN,compound-compound,compound-pobj,NNP-NNPS,NNP-NNP,2,1
11845,10854.0,25,born,5,20,23,3,19,1,-15,18,Chulalongkorn,Saovabha,org,,PROPN,PROPN,pobj,compound,NNP,NNP,2,1
11846,10855.0,36,appeared,22,7,8,1,6,27,15,-14,Ted Turner,Turner Broadcasting System,-,org-org-org,PROPN-PROPN,PROPN-PROPN-PROPN,compound-nsubj,compound-compound-compound,NNP-NNP,NNP-NNP-NNP,2,1
11847,10856.0,29,In,0,5,28,23,4,0,-5,28,Yae,Japan,org,,PROPN,PROPN,nsubj,pobj,NNP,NNP,1,1
11848,10857.0,24,elected,4,3,15,12,2,8,1,11,Videla,Chile,,per,PROPN,PROPN,nsubjpass,dobj,NNP,NNP,3,1
11849,10858.0,37,released,3,8,29,21,7,7,-5,26,Ruthless,Eazy-E,per,,PROPN,PROPN,compound,pobj,NNP,NNP,9,1
11850,10859.0,24,ran,3,6,9,3,5,14,-3,6,Xetra,Deutsche,,org,PROPN,PROPN,compound,compound,NNP,NNP,2,1
11851,10861.0,36,leased,6,11,22,11,10,13,-5,16,its,Dallas,,org,DET,PROPN,poss,compound,PRP$,NNP,9,1
11852,10862.0,31,plan,1,1,13,12,0,17,0,12,Her,San Diego,per,-,DET,PROPN-PROPN,poss,compound-pobj,PRP$,NNP-NNP,5,1
11853,10863.0,31,attended,3,12,14,2,11,16,-9,11,Prime Minister,Feleti Sevele,per-per,-,PROPN-PROPN,PROPN-PROPN,compound-compound,compound-conj,NNP-NNP,NNP-NNP,3,1
11854,10866.0,31,attacked,5,14,24,10,13,6,-9,19,Dmitry Sanakoyev,Provisional Administrative Entity,-,per-per-per,PROPN-PROPN,PROPN-PROPN-PROPN,compound-compound,compound-compound-appos,NNP-NNP,NNP-NNP-NNP,4,1
11855,10867.0,17,inaugurated,2,9,14,5,8,2,-7,12,Rede 21,Grupo Bandeirantes de,per-per,--,PROPN-NUM,PROPN-PROPN-PROPN,dobj-nummod,compound-compound-pobj,NNP-CD,NNP-NNP-NNP,6,1
11856,10868.0,22,is,2,1,1,0,0,20,1,-1,Bradfield College,Bradfield,-,per,PROPN-PROPN,PROPN,compound-nsubj,pobj,NNP-NNP,NNP,0,1
11857,10869.0,31,is,3,18,27,9,17,3,-15,24,Tuck School of Business,New Hampshire,---,org-org,PROPN-PROPN-ADP-PROPN,PROPN-PROPN,compound-pobj-prep-pobj,compound-compound,NNP-NNP-IN-NNP,NNP-NNP,5,1
11858,10872.0,20,is,1,1,9,8,0,10,0,8,BankDirect,ASB,,per,PROPN,PROPN,nsubj,compound,NNP,NNP,5,1
11859,10873.0,19,is,7,1,18,17,0,0,6,11,Wang Lei,China,per-per,,PROPN-PROPN,PROPN,compound-nsubj,pobj,NNP-NNP,NNP,6,1
11860,10874.0,23,invented,2,1,9,8,0,13,1,7,Meccano,Frank Hornby,per,-,NOUN,PROPN-PROPN,nsubjpass,compound-pobj,NN,NNP-NNP,3,1
11861,10875.0,24,Sheriff,1,1,22,21,0,1,0,21,Lawrence Sheriff,Rugby School,per-per,-,PROPN-PROPN,PROPN-PROPN,compound-ROOT,compound-dobj,NNP-NNP,NNP-NNP,4,1
11862,10876.0,26,opened,6,8,14,6,7,11,-2,8,F-Beat,Elvis Costello,,per-per,PROPN,PROPN-PROPN,compound,compound-dobj,NNP,NNP-NNP,6,1
11863,10877.0,38,was,11,1,1,0,0,36,10,-10,Sega Racing Studio,Sega,per-per-per,,PROPN-PROPN-PROPN,PROPN,compound-compound-nsubj,compound,NNP-NNP-NNP,NNP,0,1
11864,10878.0,42,moved,5,8,9,1,7,32,-3,4,VTC,Vietnam Television,,per-per,PROPN,PROPN-PROPN,compound,compound-pobj,NNP,NNP-NNP,1,1
11865,10879.0,46,is,8,1,13,12,0,32,7,5,Patrea Smallacombe,writer,-,per,PROPN-PROPN,NOUN,compound-nsubj,nmod,NNP-NNP,NN,3,1
11866,10880.0,14,Tomohito,3,2,4,2,1,9,1,1,Prince Mikasa,Tomohito,per-per,,PROPN-PROPN,PROPN,compound-compound,ROOT,NNP-NNP,NNP,2,1
11867,10883.0,37,said,9,4,17,13,3,19,5,8,Colorado,University of Northern Colorado,,per-per-per-per,PROPN,PROPN-ADP-PROPN-PROPN,compound,pobj-prep-compound-pobj,NNP,NNP-IN-NNP-NNP,9,1
11868,10884.0,31,left,8,1,29,28,0,1,7,21,Sandhu,Kamal,per,,NOUN,PROPN,nsubj,compound,NNS,NNP,7,1
11869,10885.0,32,team,4,2,17,15,1,14,2,13,1988,Mr. Big,org,-,NUM,PROPN-PROPN,pobj,compound-dobj,CD,NNP-NNP,3,1
11870,10886.0,22,consists,6,1,11,10,0,10,5,5,Six Apart,Mena Trott,per-per,-,NUM-PROPN,PROPN-PROPN,nummod-poss,pobj-compound,CD-NNP,NNP-NNP,7,1
11871,10889.0,28,played,1,11,16,5,10,11,-10,15,Cincinnati Red Stockings,American Association,org-org-org,-,PROPN-PROPN-PROPN,PROPN-PROPN,compound-compound-pobj,compound-pobj,NNP-NNP-NNPS,NNP-NNP,3,1
11872,10890.0,41,led,8,2,16,14,1,24,6,8,Mississippi,Henry S. Foote,per,--,PROPN,PROPN-PROPN-PROPN,compound,compound-compound-nsubj,NNP,NNP-NNP-NNP,5,1
11873,10891.0,10,is,1,1,3,2,0,6,0,2,TV3,de Catalunya,org,-,PROPN,PROPN-PROPN,nsubj,compound-poss,NNP,NNP-NNP,2,1
11874,10892.0,17,is,3,1,13,12,0,3,2,10,Steven Alfred Hill,author,--,org,PROPN-PROPN-PROPN,NOUN,compound-compound-nsubj,attr,NNP-NNP-NNP,NN,4,1
11875,10893.0,38,spent,4,9,25,16,8,12,-5,21,Australia,City Tattersalls Club,org,--,PROPN,PROPN-PROPN-PROPN,dobj,compound-compound-pobj,NNP,NNP-NNP-NNP,9,1
11876,10894.0,30,ordered,14,8,28,20,7,1,6,14,Los Angeles County,Michael Wilson,per-per-per,-,PROPN-PROPN-PROPN,PROPN-PROPN,compound-compound-poss,compound-pobj,NNP-NNP-NNP,NNP-NNP,7,1
11877,10895.0,30,is,19,1,17,16,0,12,18,-2,Darko Dimitrov,Macedonia,org-org,,PROPN-PROPN,PROPN,compound-nsubj,pobj,NNP-NNP,NNP,5,1
11878,10897.0,13,introduced,5,2,8,6,1,4,3,3,Detroit,Tamia,org,,PROPN,PROPN,pobj,pobj,NNP,NNP,3,1
11879,10900.0,39,captured,7,17,11,-6,16,27,-10,4,Bret Schundler,Jersey City,per-per,-,PROPN-PROPN,PROPN-PROPN,compound-conj,compound-compound,NNP-NNP,NNP-NNP,4,1
11880,12000.0,19,is,5,3,11,8,2,7,2,6,Bret Schundler,Jersey City,-,per-per,PROPN-PROPN,PROPN-PROPN,compound-nsubj,compound-pobj,NNP-NNP,NNP-NNP,5,1
11881,10901.0,11,born,2,1,10,9,0,0,1,8,Ivana,Bulgaria,org,,PROPN,PROPN,nsubjpass,pobj,NNP,NNP,2,1
11882,10902.0,19,is,6,1,6,5,0,12,5,0,Lowell,LHS,org,,PROPN,PROPN,compound,conj,NNP,NNP,2,1
11883,10906.0,15,are,1,11,13,2,10,1,-10,12,Omaha,Edward Ruscha,per,-,PROPN,PROPN-PROPN,pobj,compound-pobj,NNP,NNP-NNP,1,1
11884,10907.0,16,moved,3,7,11,4,6,4,-4,8,France,Ariane Mnouchkine,org,-,PROPN,PROPN-PROPN,pobj,compound-poss,NNP,NNP-NNP,4,1
11885,10908.0,21,performed,2,1,13,12,0,7,1,11,He,Actor,,org,PRON,PROPN,nsubj,compound,PRP,NNP,3,1
11886,10909.0,42,considered,14,7,24,17,6,17,7,10,Kings XI Punjab,Yuvraj Singh,org-org-org,-,PROPN-PROPN-PROPN,PROPN-PROPN,compound-compound-conj,compound-nmod,NNPS-NNP-NNP,NNP-NNP,11,1
11887,10910.0,57,writes,25,9,22,13,8,34,16,-3,Maria Angela Cerruto,University of Verona,org-org-org,--,PROPN-PROPN-PROPN,PROPN-ADP-PROPN,compound-compound-appos,pobj-prep-compound,NNP-NNP-NNP,NNP-IN-NNP,6,1
11888,10911.0,39,explained,18,31,38,7,30,0,-13,20,Norwegian University of Science and Technology,Trondheim,per-per-per-per-per-per,,PROPN-PROPN-ADP-PROPN-CCONJ-PROPN,PROPN,compound-pobj-prep-pobj-cc-conj,pobj,NNP-NNP-IN-NNP-CC-NNP,NNP,6,1
11889,10913.0,24,said,16,1,14,13,0,9,15,-2,Mexico,Bank of Mexico,,per-per-per,PROPN,PROPN-ADP-PROPN,poss,nsubj-prep-pobj,NNP,NNP-IN-NNP,5,1
11890,10915.0,35,discovers,2,21,29,8,20,5,-19,27,702,Motown,org,,NUM,PROPN,conj,nmod,CD,NNP,4,1
11891,10916.0,29,moved,4,2,3,1,1,25,2,-1,Wisconsin,Henry Hansen,per,-,PROPN,PROPN-PROPN,pobj,compound-nsubj,NNP,NNP-NNP,1,1
11892,10917.0,39,said,11,1,6,5,0,32,10,-5,Jorge del Castillo,Peru,--,per,PROPN-DET-PROPN,PROPN,compound-compound-compound,poss,NNP-DT-NNP,NNP,5,1
11893,12874.0,39,surfaced,2,20,38,18,19,0,-18,36,Jorge del Castillo,Peru,--,per,PROPN-PROPN-PROPN,PROPN,compound-compound-compound,pobj,NNP-NNP-NNP,NNP,10,1
11894,10918.0,29,need,5,14,15,1,13,13,-9,10,Minister,Arturo Parisi,,per-per,PROPN,PROPN-PROPN,compound,compound-nsubj,NNP,NNP-NNP,1,1
11895,10919.0,33,Featuring,0,6,22,16,5,10,-6,22,Albert King,Stax,per-per,,PROPN-PROPN,PROPN,compound-pobj,compound,NNP-NNP,NNP,10,1
11896,11159.0,21,was,5,11,14,3,10,6,-6,9,Albert King,Stax,org-org,,PROPN-PROPN,PROPN,compound-pobj,compound,NNP-NNP,NNP,2,1
11897,10921.0,36,founded,18,10,32,22,9,3,8,14,Guelph Collegiate,Ontario,per-per,,PROPN-PROPN,PROPN,nmod-nmod,pobj,NNP-NNP,NNP,7,1
11898,10922.0,16,situated,2,1,7,6,0,8,1,5,It,England,,per,PRON,PROPN,nsubjpass,pobj,PRP,NNP,2,1
11899,10925.0,13,is,7,1,6,5,0,6,6,-1,Promotora de Informaciones,PRISA,per-per-per,,PROPN-ADP-PROPN,PROPN,compound-compound-compound,appos,NNP-IN-NNP,NNP,3,1
11900,10926.0,30,is,11,4,21,17,3,8,7,10,Peter Phillips,Anne Princess Royal,-,org-org-org,PROPN-PROPN,PROPN-PROPN-PROPN,compound-nsubj,compound-compound-pobj,NNP-NNP,NNP-NNP-NNP,-1,1
11901,10929.0,31,is,10,1,21,20,0,9,9,11,Viktor Vasyliovych Petrenko,Soviet Union,--,per-per,PROPN-PROPN-PROPN,PROPN-PROPN,compound-compound-nsubj,compound-dobj,NNP-NNP-NNP,NNP-NNP,5,1
11902,10931.0,30,continued,7,14,24,10,13,5,-7,17,Kunstakademie,Joseph Beuys,,org-org,PROPN,PROPN-PROPN,pobj,compound-pobj,NNP,NNP-NNP,8,1
11903,10932.0,25,is,2,1,14,13,0,10,1,12,Chris Davis,Spotlight Kid,org-org,-,PROPN-PROPN,PROPN-PROPN,compound-nsubj,compound-pobj,NNP-NNP,NNP-NNP,5,1
11904,10934.0,30,elected,4,1,11,10,0,18,3,7,Chaudhry Shujaat Hussain,Pakistan,--,per,PROPN-PROPN-PROPN,PROPN,compound-compound-nsubjpass,pobj,NNP-NNP-NNP,NNP,3,1
11905,10936.0,26,remarked,13,9,13,4,8,12,4,0,NewsNight,Klein,per,,PROPN,PROPN,pobj,nsubj,NNP,NNP,1,1
11906,10939.0,51,is,8,15,31,16,14,19,-7,23,nal Assembly of R,th of Presid,org-org-org-org,--,PROPN-PROPN-ADP-PROPN,X-ADP-PROPN,amod-pobj-prep-compound,appos-prep-pobj,NNP-NNP-IN-NNP,XX-IN-NNP,7,1
11907,10940.0,44,built,2,36,41,5,35,2,-34,39,HSV,Holden,org,,PROPN,PROPN,poss,compound,NNP,NNP,4,1
11908,10942.0,31,was,4,4,25,21,3,5,0,21,he,Quebec,org,,PRON,PROPN,nsubjpass,pobj,PRP,NNP,2,1
11909,10943.0,27,joined,2,20,22,2,19,4,-18,20,Labor,John Curtin,,org-org,PROPN,PROPN-PROPN,compound,compound-dobj,NNP,NNP-NNP,1,1
11910,10945.0,12,followed,3,6,10,4,5,1,-3,7,China Southern Airlines,Xiamen Airlines,org-org-org,-,PROPN-PROPN-PROPN,PROPN-PROPN,compound-compound-pobj,compound-conj,NNP-NNP-NNPS,NNP-NNPS,2,1
11911,10947.0,21,is,5,13,17,4,12,3,-8,12,Singapore,MediaCorp TV Channel 8,,per-per-per-per,PROPN,PROPN-PROPN-PROPN-NUM,poss,compound-compound-pobj-nummod,NNP,NNP-NNP-NNP-CD,5,1
11912,10948.0,50,performed,3,8,11,3,7,38,-5,8,Oscar Peterson,Concordia University,-,org-org,PROPN-PROPN,PROPN-PROPN,compound-compound,compound-appos,NNP-NNP,NNP-NNP,1,1
11913,10950.0,30,grew,1,5,8,3,4,21,-4,7,Evansville,Reitz Memorial High School,per,---,PROPN,PROPN-PROPN-PROPN-PROPN,compound,compound-compound-compound-dobj,NNP,NNP-NNP-NNP-NNP,6,1
11914,10951.0,46,is,4,20,26,6,19,19,-16,22,Ohio,Mike DeWine,per,-,PROPN,PROPN-PROPN,pobj,compound-conj,NNP,NNP-NNP,7,1
11915,10952.0,34,said,12,1,10,9,0,23,11,-2,Iliad,Free,per,,VERB,PROPN,nsubj,pobj,VB,NNP,3,1
11916,10953.0,69,said,56,50,55,5,49,13,6,-1,Presidency,?eljko,per,,PROPN,NOUN,pobj,punct,NNP,NN,4,1
11917,12514.0,15,is,6,6,8,2,5,6,0,2,Presidency,?eljko,,per,PROPN,PUNCT,pobj,punct,NNP,.,1,1
11918,10954.0,38,established,3,2,5,3,1,32,1,2,Richard Tompkins,Green Shield Stamps,-,org-org-org,PROPN-PROPN,PROPN-PROPN-PROPN,compound-nsubj,compound-compound-dobj,NNP-NNP,NNP-NNP-NNPS,3,1
11919,10956.0,51,is,39,2,17,15,1,33,37,-22,Ali Khamenei,Mashhad,-,org,PROPN-PROPN,PROPN,compound-nsubj,compound,NNP-NNP,NNP,7,1
11920,10960.0,25,studied,5,8,12,4,7,12,-3,7,Arnold Sommerfeld,University of Munich,-,org-org-org,PROPN-PROPN,PROPN-ADP-PROPN,compound-pobj,pobj-prep-pobj,NNP-NNP,NNP-IN-NNP,5,1
11921,10961.0,32,identified,7,19,25,6,18,6,-12,18,Windsor,Roseland Public school,,per-per-per,PROPN,PROPN-PROPN-NOUN,pobj,compound-compound-pobj,NNP,NNP-NNP-NN,5,1
11922,10963.0,85,File,0,69,78,9,68,6,-69,78,Virginia,John Marshall,per,-,PROPN,PROPN-PROPN,compound,compound-compound,NNP,NNP-NNP,4,1
11923,10964.0,44,operates,9,4,7,3,3,36,5,-2,Kum Go,Krause Gentle Corporation,-,org-org-org,PROPN-VERB,PROPN-PROPN-PROPN,nsubj-pcomp,compound-compound-nsubj,NNP-VB,NNP-NNP-NNP,3,1
11924,10966.0,39,are,5,11,16,5,10,22,-6,11,Rossmore Community College,Poole,per-per-per,,PROPN-PROPN-PROPN,PROPN,compound-compound-conj,nmod,NNP-NNP-NNP,NNP,3,1
11925,10967.0,22,go,13,4,7,3,3,14,9,-6,Siti Nurhaliza,Malaysia,-,per,PROPN-PROPN,PROPN,compound-pobj,pobj,NNP-NNP,NNP,3,1
11926,10969.0,33,became,6,12,12,0,11,20,-6,6,Oberlin College,Oberlin Ohio,org-org,-,PROPN-PROPN,PROPN-PROPN,compound-pobj,compound-pobj,NNP-NNP,NNP-NNP,0,1
11927,10970.0,27,was,4,1,9,8,0,17,3,5,Oxenberg,Robert Evans,,per-per,PROPN,PROPN-PROPN,poss,compound-appos,NNP,NNP-NNP,6,1
11928,10972.0,26,increased,3,10,23,13,9,2,-7,20,McCain,Arizona,per,,PROPN,PROPN,nsubj,compound,NNP,NNP,8,1
11929,10973.0,29,created,3,3,8,5,2,20,0,5,Plaskett,Thrush Hermit,,org-org,PROPN,PROPN-PROPN,nsubj,compound-dobj,NNP,NNP-NNP,2,1
11930,10974.0,32,formed,6,4,28,24,3,3,2,22,Ukraine,Viktor Yushchenko,per,-,PROPN,PROPN-PROPN,compound,compound-pobj,NNP,NNP-NNP,9,1
11931,10976.0,25,held,9,12,16,4,11,8,-3,7,Petco,California,per,,PROPN,PROPN,compound,compound,NNP,NNP,3,1
11932,10977.0,30,Jugendorchester,2,1,22,21,0,7,1,20,Gustav Mahler Youth Orchestra,Austria,---,per,PROPN-PROPN-PROPN-PROPN,PROPN,compound-compound-compound-pobj,pobj,NNP-NNP-NNP-NNP,NNP,4,1
11933,10979.0,55,is,8,1,13,12,0,41,7,5,Hunter Allan,actor,-,per,PROPN-PROPN,NOUN,compound-nsubj,attr,NNP-NNP,NN,4,1
11934,10980.0,27,met,4,2,12,10,1,14,2,8,President,Valdis Zatlers,per,-,PROPN,PROPN-PROPN,compound,compound-pobj,NNP,NNP-NNP,6,1
11935,10981.0,26,thrived,2,1,19,18,0,6,1,17,Connecticut,General Electric,org,-,NOUN,PROPN-PROPN,compound,compound-compound,NN,NNP-NNP,9,1
11936,10983.0,35,earned,1,10,15,5,9,19,-9,14,Southern Baptist Theological Seminary,Louisville,org-org-org-org,,PROPN-PROPN-PROPN-PROPN,PROPN,compound-compound-compound-pobj,compound,NNP-NNP-NNP-NNP,NNP,3,1
11937,10984.0,25,is,1,9,18,9,8,6,-8,17,England,Imperial Tobacco,,per-per,PROPN,PROPN-PROPN,pobj,compound-appos,NNP,NNP-NNP,2,1
11938,13449.0,18,is,2,10,12,2,9,5,-8,10,England,Imperial Tobacco,per,-,PROPN,PROPN-PROPN,pobj,compound-pobj,NNP,NNP-NNP,1,1
11939,10986.0,63,seek,11,3,9,6,2,53,8,-2,Fernando Henrique Cardoso,PSDB,org-org-org,,PROPN-PROPN-PROPN,PROPN,compound-compound-nsubj,pobj,NNP-NNP-NNP,NNP,3,1
11940,10987.0,34,Tiomkin,1,1,12,11,0,21,0,11,Dimitri Tiomkin,s Dmitri Tiomki,per-per,--,PROPN-PROPN,NOUN-PROPN-PROPN,compound-ROOT,dobj-compound-compound,NNP-NNP,NN-NNP-NNP,-1,1
11941,10988.0,72,include,2,50,66,16,49,5,-48,64,Marsha Mason,United States,-,per-per,PROPN-PROPN,PROPN-PROPN,compound-dobj,compound-pobj,NNP-NNP,NNP-NNP,8,1
11942,10989.0,28,plays,8,1,16,15,0,11,7,8,Dave Knudson,Minus the Bear,per-per,--,PROPN-PROPN,PROPN-DET-PROPN,compound-nsubj,dobj-det-appos,NNP-NNP,NNP-DT-NNP,6,1
11943,10990.0,55,included,3,49,53,4,48,1,-46,50,Citgo,Houston,,per,PROPN,PROPN,compound,compound,NNP,NNP,2,1
11944,10991.0,38,moved,7,11,29,18,10,8,-4,22,Florida State University,Scott Stapp,per-per-per,-,PROPN-PROPN-PROPN,PROPN-PROPN,compound-compound-pobj,compound-appos,NNP-NNP-NNP,NNP-NNP,7,1
11945,10992.0,34,display,2,17,32,15,16,1,-15,30,Mehmet Ali Talat,Northern Cyprus,--,per-per,PROPN-PROPN-PROPN,PROPN-PROPN,compound-compound-pobj,compound-pobj,NNP-NNP-NNP,NNP-NNP,8,1
11946,10995.0,19,Department,0,7,18,11,6,0,-7,18,Leiden University,Netherlands,per-per,,PROPN-PROPN,PROPN,compound-compound,appos,NNP-NNP,NNP,-1,1
11947,10996.0,29,yielded,1,1,23,22,0,5,0,22,He,Republic,,per,PRON,PROPN,nsubj,pobj,PRP,NNP,4,1
11948,10997.0,38,dance,12,11,25,14,10,12,1,13,United States,Jackson,-,org,PROPN-PROPN,PROPN,compound-pobj,poss,NNP-NNP,NNP,9,1
11949,10998.0,44,was,14,32,36,4,31,7,-18,22,Antiochus IV Epiphanes,Laodice,per-per-per,,PROPN-PROPN-PROPN,PROPN,compound-nmod-pobj,compound,NNP-NNP-NNPS,NNP,2,1
11950,10999.0,19,met,4,13,17,4,12,1,-9,13,Hamas,Khaled Mashaal,,org-org,PROPN,PROPN-PROPN,poss,compound-appos,NNP,NNP-NNP,2,1
11951,11000.0,35,are,3,10,33,23,9,1,-7,30,Southern Methodist University,NCAA,--,per,PROPN-PROPN-PROPN,PROPN,compound-compound-dobj,appos,NNP-NNP-NNP,NNP,7,1
11952,11001.0,33,made,17,9,14,5,8,18,8,-3,British Telecommunications plc,BT Group,per-per-per,-,PROPN-PROPN-NOUN,PROPN-PROPN,amod-compound-appos,compound-compound,NNP-NNPS-NN,NNP-NNP,3,1
11953,11002.0,25,was,1,18,24,6,17,0,-17,23,Communist Party of Great Britain,1920,per-per-per-per-per,,PROPN-PROPN-ADP-PROPN-PROPN,NUM,compound-pobj-prep-compound-pobj,pobj,NNP-NNP-IN-NNP-NNP,CD,6,1
11954,11003.0,36,told,1,12,12,0,11,23,-11,11,( Sali Berish,( Albani,--,per-per,PUNCT-PROPN-PROPN,PUNCT-PROPN,punct-compound-appos,punct-appos,-LRB--NNP-NNP,-LRB--NNP,0,1
11955,11004.0,21,steal,2,15,20,5,14,0,-13,18,Daniel arap Moi,Kenya,per-per-per,,PROPN-NOUN-PROPN,PROPN,compound-compound-nsubj,pobj,NNP-NN-NNP,NNP,9,1
11956,11005.0,26,was,1,1,7,6,0,18,0,6,He,Mississippi,,per,PRON,PROPN,nsubj,compound,PRP,NNP,4,1
11957,11006.0,60,involved,28,1,34,33,0,25,27,6,The Supremes,Motown,per-per,,DET-PROPN,PROPN,det-pobj,pobj,DT-NNP,NNP,3,1
11958,11009.0,88,fixture,1,34,36,2,33,51,-33,35,Texas,Jandek,,per,PROPN,PROPN,compound,compound,NNP,NNP,2,1
11959,11010.0,15,managed,3,2,9,7,1,5,1,6,college,Congregation of Holy Cross,,per-per-per-per,NOUN,PROPN-ADP-PROPN-PROPN,nsubjpass,pobj-prep-compound-pobj,NN,NNP-IN-NNP-NNP,6,1
11960,11011.0,46,said,44,38,42,4,37,3,6,-2,University of Michigan,Mary Sue Coleman,--,per-per-per,PROPN-ADP-PROPN,PROPN-PROPN-PROPN,nmod-prep-pobj,compound-compound-nsubj,NNP-IN-NNP,NNP-NNP-NNP,3,1
11961,11012.0,43,featured,23,16,18,2,15,24,7,-5,Singapore,Ministry of Defence,org,--,PROPN,PROPN-ADP-PROPN,poss,pobj-prep-pobj,NNP,NNP-IN-NNP,3,1
11962,11013.0,13,re-elected,6,1,2,1,0,10,5,-4,President,Teodoro Obiang Nguema Mbasogo,,per-per-per-per,PROPN,PROPN-PROPN-PROPN-PROPN,compound,compound-compound-compound-nsubjpass,NNP,NNP-NNP-NNP-NNP,2,1
11963,11014.0,26,analyzed,14,10,14,4,9,11,4,0,Carnegie Mellon University,Pittsburgh,per-per-per,,PROPN-PROPN-PROPN,PROPN,compound-compound-conj,pobj,NNP-NNP-NNP,NNP,4,1
11964,11015.0,26,choose,8,6,13,7,5,12,2,5,Finland,his,,per,PROPN,DET,nsubj,poss,NNP,PRP$,4,1
11965,11017.0,18,acquired,1,1,8,7,0,9,0,7,Interoute,KPNQwest NV,org,-,PROPN,PROPN-PROPN,nsubj,compound-compound,NNP,NNP-NNP,4,1
11966,11019.0,29,joined,10,13,26,13,12,2,-3,16,British South Africa Police,23 April 1939,---,org-org-org,PROPN-PROPN-PROPN-PROPN,NUM-PROPN-NUM,compound-compound-compound-dobj,nummod-pobj-nummod,NNP-NNP-NNP-NNP,CD-NNP-CD,5,1
11967,11020.0,17,is,2,6,6,0,5,10,-4,4,Virginia Army National Guard,Virginia,---,org,PROPN-PROPN-PROPN-PROPN,PROPN,compound-compound-compound-compound,compound,NNP-NNP-NNP-NNP,NNP,0,1
11968,11410.0,31,commissioned,4,8,8,0,7,22,-4,4,Virginia Army National Guard,Virginia,per-per-per-per,,PROPN-PROPN-PROPN-PROPN,PROPN,compound-compound-compound-pobj,pobj,NNP-NNP-NNP-NNP,NNP,0,1
11969,11021.0,23,was,3,3,12,9,2,10,0,9,UH,Texas,per,,PROPN,PROPN,nsubj,pobj,NNP,NNP,4,1
11970,11022.0,30,samples,1,17,22,5,16,7,-16,21,Big Audio Dynamite,Mick Jones,--,org-org,PROPN-PROPN-PROPN,PROPN-PROPN,compound-compound-compound,compound-pobj,NNP-NNP-NNP,NNP-NNP,3,1
11971,11023.0,61,ask,57,8,11,3,7,49,49,-46,teacher,McAuliffe,,per,NOUN,PROPN,attr,pobj,NN,NNP,2,1
11972,11024.0,48,created,2,9,9,0,8,38,-7,7,Federal Ministry of Economics and Technology,Federal Ministry for Health,org-org-org-org-org-org,---,PROPN-PROPN-ADP-PROPN-CCONJ-PROPN,PROPN-PROPN-ADP-PROPN,compound-pobj-prep-pobj-cc-conj,compound-pobj-prep-pobj,NNP-NNP-IN-NNP-CC-NNP,NNP-NNP-IN-NNP,0,1
11973,11025.0,24,attended,7,5,9,4,4,14,2,2,San Diego,Torrey Pines High School,-,per-per-per-per,PROPN-PROPN,PROPN-PROPN-PROPN-PROPN,compound-compound,compound-compound-compound-dobj,NNP-NNP,NNP-NNP-NNP-NNP,6,1
11974,11026.0,14,included,6,6,12,6,5,1,0,6,Army,Rifle Corps,,org-org,PROPN,PROPN-PROPN,pobj,compound-dobj,NNP,NNP-NNP,2,1
11975,11027.0,33,was,7,1,15,14,0,17,6,8,Sheila Copps,Ontario,per-per,,PROPN-PROPN,PROPN,compound-nsubj,compound,NNP-NNP,NNP,4,1
11976,11028.0,33,rejected,8,2,4,2,1,28,6,-4,Prime Minister,Abubakar Tafawa Balewa,per-per,--,PROPN-PROPN,PROPN-PROPN-PROPN,compound-compound,compound-compound-nsubj,NNP-NNP,NNP-NNP-NNP,2,1
11977,11030.0,26,claimed,1,10,19,9,9,6,-9,18,him,Kenya,org,,PRON,PROPN,dative,poss,PRP,NNP,7,1
11978,11031.0,118,NSERC,46,104,109,5,103,8,-58,63,European Space Agency,Italy,--,per,PROPN-PROPN-PROPN,PROPN,compound-compound-ROOT,appos,NNP-NNP-NNP,NNP,-1,1
11979,11033.0,19,located,3,11,14,3,10,4,-8,11,AC Transit,Alameda-Contra Costa Transit District,-,org-org-org-org,PROPN-PROPN,PROPN-PROPN-PROPN-PROPN,compound-dobj,compound-compound-compound-appos,NNP-NNP,NNP-NNP-NNP-NNP,3,1
11980,11034.0,15,named,11,6,9,3,5,5,5,-2,Scripps College,Claremont,per-per,,PROPN-PROPN,PROPN,compound-pobj,compound,NNP-NNP,NNP,2,1
11981,11035.0,32,is,6,13,16,3,12,15,-7,10,composer,Anthony Braxton,,per-per,NOUN,PROPN-PROPN,pobj,compound-conj,NN,NNP-NNP,3,1
11982,11036.0,13,is,1,3,11,8,2,1,-2,10,his,ATO,,org,DET,PROPN,poss,compound,PRP$,NNP,6,1
11983,11038.0,21,moved,4,15,20,5,14,0,-11,16,Baylor College of Medicine,Houston,org-org-org-org,,PROPN-PROPN-ADP-PROPN,PROPN,compound-pobj-prep-pobj,pobj,NNP-NNP-IN-NNP,NNP,4,1
11984,11039.0,24,owned,1,13,20,7,12,3,-12,19,Philip II of Spain,Mary I of England,per-per-per-per,---,PROPN-PROPN-ADP-PROPN,PROPN-PROPN-ADP-PROPN,compound-pobj-prep-pobj,compound-appos-prep-pobj,NNP-NNP-IN-NNP,NNP-NNP-IN-NNP,5,1
11985,11040.0,26,affiliated,15,8,21,13,7,4,7,6,India,Serampore College,,org-org,PROPN,PROPN-PROPN,pobj,compound-pobj,NNP,NNP-NNP,9,1
11986,11042.0,23,drums,2,14,21,7,13,1,-12,19,Gim me Gimmes,Joey Cape,per-per-per,-,PROPN-PRON-PROPN,PROPN-PROPN,conj-compound-ROOT,compound-pobj,NNP-PRP-NNPS,NNP-NNP,4,1
11987,11044.0,42,recruited,23,25,40,15,24,1,-2,17,Brian,New Hampshire,per,-,PROPN,PROPN-PROPN,dobj,compound-pobj,NNP,NNP-NNP,3,1
11988,11046.0,28,were,4,2,19,17,1,8,2,15,Tomko,Angle Alliance,,per-per,PROPN,PROPN-PROPN,nsubj,compound-dobj,NNPS,NNP-NNP,6,1
11989,11047.0,48,is,16,26,31,5,25,16,-10,15,University of Alberta,Canada,--,org,PROPN-ADP-PROPN,PROPN,pobj-prep-pobj,pobj,NNP-IN-NNP,NNP,5,1
11990,11049.0,38,saw,12,1,8,7,0,29,11,-4,Porto,Pinto da Costa,org,--,PROPN,PROPN-X-PROPN,poss,compound-compound-pobj,NNP,NNP-FW-NNP,6,1
11991,11050.0,31,played,1,6,12,6,5,18,-5,11,Arkansas,University of Arkansas at Pine Bluff,per,-----,PROPN,PROPN-ADP-PROPN-ADP-PROPN-PROPN,pobj,pobj-prep-pobj-prep-compound-pobj,NNP,NNP-IN-NNP-IN-NNP-NNP,4,1
11992,11052.0,27,began,16,1,9,8,0,17,15,-7,Georgia Southern University,Mechanical School,--,per-per,PROPN-PROPN-PROPN,PROPN-PROPN,compound-compound-nsubj,compound-pobj,NNP-NNP-NNP,NNP-NNP,4,1
11993,11053.0,45,appointed,11,7,27,20,6,17,4,16,Samuel L. Southard,New Jersey,--,org-org,PROPN-PROPN-PROPN,PROPN-PROPN,compound-compound-pobj,compound-compound,NNP-NNP-NNP,NNP-NNP,6,1
11994,11054.0,21,born,6,12,15,3,11,5,-6,9,New York,Sheldon M. Levine,per-per,--,PROPN-PROPN,PROPN-PROPN-PROPN,compound-pobj,compound-compound-pobj,NNP-NNP,NNP-NNP-NNP,6,1
11995,11055.0,50,are,1,28,40,12,27,9,-27,39,Piaggio,Italy,org,,PROPN,PROPN,conj,pobj,NNP,NNP,3,1
11996,11057.0,71,produces,19,1,10,9,0,60,18,-9,Frito-Lay,1961,,per,PROPN,NUM,compound,pobj,NNP,CD,6,1
11997,11058.0,10,sold,1,5,5,0,4,4,-4,4,Club Med,Club,per-per,,PROPN-PROPN,PROPN,compound-appos,pobj,NNP-NNP,NNP,0,1
11998,11060.0,17,is,7,1,10,9,0,6,6,3,Gulf of Finland Naval Command,Finnish Navy,per-per-per-per-per,-,PROPN-ADP-PROPN-PROPN-PROPN,ADJ-PROPN,nsubj-prep-compound-compound-pobj,amod-compound,NNP-IN-NNP-NNP-NNP,JJ-NNP,4,1
11999,11061.0,14,chose,2,4,10,6,3,3,-2,8,Brian Masse,Windsor,per-per,,PROPN-PROPN,PROPN,compound-dative,poss,NNP-NNP,NNP,6,1
12000,14232.0,21,grew,16,2,11,9,1,9,14,-5,Brian Masse,Windsor,org-org,,PROPN-PROPN,PROPN,compound-poss,compound,NNP-NNP,NNP,6,1
12001,11062.0,38,required,36,8,19,11,7,18,28,-17,Auguste Comte,Paris,org-org,,PROPN-PROPN,PROPN,compound-pobj,compound,NNP-NNP,NNP,5,1
12002,11064.0,26,is,13,1,12,11,0,13,12,-1,International University of Business Agriculture and Technology,IUBAT,per-per-per-per-per-per-per,,PROPN-PROPN-ADP-PROPN-PROPN-CCONJ-PROPN,NOUN,nmod-nmod-prep-pobj-nsubj-cc-conj,conj,NNP-NNP-IN-NNP-NNP-CC-NNP,NN,2,1
12003,11066.0,28,moved,2,12,15,3,11,12,-10,13,Blue Rodeo,Greg Keelor,-,org-org,PROPN-PROPN,PROPN-PROPN,compound-poss,compound-pobj,NNP-NNP,NNP-NNP,1,1
12004,11067.0,28,chosen,10,4,9,5,3,18,6,-1,Stanwell School,Wales,org-org,,PROPN-PROPN,PROPN,compound-nsubjpass,pobj,NNP-NNP,NNP,2,1
12005,11068.0,31,fled,2,1,13,12,0,17,1,11,Chiang Kai-shek,Taipei,per-per,,PROPN-PROPN,PROPN,compound-nsubj,pobj,NNP-NNP,NNP,4,1
12006,11070.0,26,was,8,8,20,12,7,5,0,12,England,Edward the Confessor,per,--,PROPN,PROPN-DET-PROPN,pobj,pobj-det-appos,NNP,NNP-DT-NNP,9,1
12007,11071.0,48,registered,20,24,47,23,23,0,-4,27,Australian Securities and Investments Commission,Australia,org-org-org-org-org,,PROPN-PROPN-CCONJ-PROPN-PROPN,PROPN,nmod-nmod-cc-conj-pobj,pobj,NNP-NNPS-CC-NNPS-NNP,NNP,4,1
12008,11072.0,27,born,7,4,21,17,3,5,3,14,the Mountain Goats,Rachel Ware,--,org-org,DET-PROPN-PROPN,PROPN-PROPN,det-compound-nsubjpass,compound-dobj,DT-NNP-NNPS,NNP-NNP,7,1
12009,11073.0,29,spent,6,5,24,19,4,4,1,18,Bergman,Stockholm,,org,PROPN,PROPN,nsubj,pobj,NNP,NNP,6,1
12010,11074.0,20,born,2,1,7,6,0,12,1,5,Eddington,England,org,,PROPN,PROPN,nsubjpass,pobj,NNP,NNP,5,1
12011,11075.0,29,said,17,6,26,20,5,2,11,9,Spain,Esade,per,,PROPN,PROPN,nsubj,compound,NNP,NNP,8,1
12012,11076.0,27,established,12,6,10,4,5,16,6,-2,Special Assault Team,SAT,per-per-per,,PROPN-PROPN-PROPN,PROPN,compound-compound-nsubjpass,appos,NNP-NNP-NNP,NNP,3,1
12013,11078.0,10,was,4,4,9,5,3,0,0,5,Isabella,England,,org,PROPN,PROPN,nsubj,pobj,NNP,NNP,1,1
12014,11081.0,29,became,5,4,22,18,3,6,1,17,Devon,Stagecoach in Devon,,org-org-org,PROPN,PROPN-ADP-PROPN,compound,pobj-prep-pobj,NNP,NNP-IN-NNP,9,1
12015,11082.0,26,leaned,5,1,5,4,0,20,4,0,Norton,California,,per,PROPN,PROPN,nsubj,pobj,NNP,NNP,3,1
12016,11083.0,24,determine,4,9,13,4,8,10,-5,9,Michael Somare,National Alliance,org-org,-,PROPN-PROPN,PROPN-PROPN,compound-nsubj,compound-compound,NNP-NNP,NNP-NNP,3,1
12017,11084.0,19,won,3,8,13,5,7,5,-5,10,NCAA,them,org,,PROPN,PRON,compound,dobj,NNP,PRP,4,1
12018,11085.0,43,is,37,5,9,4,4,33,32,-28,Osram,1906,org,,PROPN,NUM,nsubj,pobj,NNP,CD,3,1
12019,11087.0,14,is,1,3,12,9,2,1,-2,11,Carroll,Arista Nashville,org,-,PROPN,PROPN-PROPN,poss,compound-pobj,NNP,NNP-NNP,6,1
12020,11089.0,20,signed,1,1,11,10,0,8,0,10,Norman,ABC Records,,per-per,PROPN,PROPN-PROPN,nsubj,compound-appos,NNP,NNP-NNPS,3,1
12021,11091.0,42,is,5,30,37,7,29,4,-25,32,University,James J.,org,-,PROPN,PROPN-PROPN,compound,compound-compound,NNP,NNP-NNP,3,1
12022,11092.0,36,was,1,16,34,18,15,1,-15,33,Bloomberg L.P.,Michael Bloomberg,-,per-per,PROPN-PROPN,PROPN-PROPN,compound-compound,compound-dobj,NNP-NNP,NNP-NNP,6,1
12023,11093.0,24,drafted,1,15,23,8,14,0,-14,22,he,Tennessee,org,,PRON,PROPN,nsubj,pobj,PRP,NNP,8,1
12024,11094.0,22,named,3,11,15,4,10,6,-8,12,Ohio University,Roderick J. McDavis,org-org,--,PROPN-PROPN,PROPN-PROPN-PROPN,compound-pobj,compound-compound-pobj,NNP-NNP,NNP-NNP-NNP,5,1
12025,11096.0,18,was,1,13,17,4,12,0,-12,16,Tokyo Gakugei University,Japan,org-org-org,,PROPN-PROPN-PROPN,PROPN,compound-compound-pobj,pobj,NNP-NNP-NNP,NNP,7,1
12026,11097.0,37,Joseph,0,1,21,20,0,15,-1,21,Joseph,National Union of Mineworkers,,per-per-per-per,PROPN,PROPN-PROPN-ADP-PROPN,ROOT,compound-pobj-prep-pobj,NNP,NNP-NNP-IN-NNP,6,1
12027,11098.0,8,reelected,2,1,5,4,0,2,1,3,John Monks,ETUC,-,org,PROPN-PROPN,PROPN,compound-nsubj,compound,NNP-NNP,NNP,4,1
12028,11100.0,37,preparing,8,6,25,19,5,11,2,17,New Hampshire College,Manchester,org-org-org,,PROPN-PROPN-PROPN,PROPN,compound-compound-nsubj,pobj,NNP-NNP-NNP,NNP,8,1
12029,11101.0,20,born,2,1,6,5,0,13,1,4,Mendelsohn,Australia,per,,PROPN,PROPN,nsubjpass,pobj,NNP,NNP,5,1
12030,11102.0,30,Nasir,1,1,6,5,0,23,0,5,Ibrahim Nasir,Maldives,-,per,PROPN-PROPN,PROPN,compound-ROOT,poss,NNP-NNP,NNPS,4,1
12031,11103.0,59,Exchanges,0,20,29,9,19,29,-20,29,Eastern Mennonite University,VA,--,per,PROPN-PROPN-PROPN,PROPN,compound-compound-poss,appos,NNP-NNP-NNP,NNP,4,1
12032,11104.0,44,been,2,38,41,3,37,2,-36,39,Mac Dre,Thizz Entertainment,per-per,-,PROPN-PROPN,PROPN-PROPN,compound-poss,compound-compound,NNP-NNP,NNP-NNP,2,1
12033,11105.0,16,are,4,1,15,14,0,0,3,11,Southern University,Jaguars,org-org,,PROPN-PROPN,PROPN,compound-poss,attr,NNP-NNP,NNPS,4,1
12034,11106.0,30,committed,23,12,15,3,11,14,11,-8,Vall,Military Council for Justice and Democracy,,org-org-org-org-org-org,PROPN,PROPN-PROPN-ADP-PROPN-CCONJ-PROPN,poss,compound-nsubj-prep-pobj-cc-conj,NNP,NNP-NNP-IN-NNP-CC-NNP,3,1
12035,11108.0,17,located,6,1,14,13,0,2,5,8,Its,Tennessee,org,,DET,PROPN,poss,compound,PRP$,NNP,4,1
12036,11109.0,51,was,4,44,45,1,43,5,-40,41,Peruvian,Santos Chocano,,per-per,PROPN,PROPN-PROPN,compound,compound-conj,NNP,NNP-NNP,2,1
12037,11111.0,38,are,8,14,27,13,13,10,-6,19,Anchorage,University of Alaska Anchorage,,per-per-per-per,PROPN,PROPN-ADP-PROPN-PROPN,pobj,nmod-prep-pobj-compound,NNP,NNP-IN-NNP-NNP,6,1
12038,11112.0,14,became,5,4,10,6,3,3,1,5,Alitalia,SkyTeam,org,,PROPN,PROPN,compound,compound,NNP,NNP,4,1
12039,11113.0,20,is,4,2,19,17,1,0,2,15,Kaithapram,Kerala,,per,PROPN,PROPN,nsubj,pobj,NNP,NNP,2,1
12040,11114.0,32,is,4,1,12,11,0,19,3,8,King Henry VIII School,Coventry,---,org,PROPN-PROPN-PROPN-PROPN,PROPN,compound-compound-compound-nsubj,compound,NNP-NNP-NNP-NNP,NNP,6,1
12041,11115.0,15,opened,3,9,10,1,8,4,-6,7,Sanford,Central High School,,per-per-per,PROPN,PROPN-PROPN-PROPN,compound,compound-compound-pobj,NNP,NNP-NNP-NNP,2,1
12042,11116.0,20,anncounced,3,15,18,3,14,1,-12,15,Oklahoma,Scott Meacham,,per-per,PROPN,PROPN-PROPN,compound,compound-dobj,NNP,NNP-NNP,2,1
12043,11117.0,44,was,4,19,39,20,18,4,-15,35,Rex Whistler,Anglo-American,org-org,,PROPN-PROPN,ADJ,compound-pobj,amod,NNP-NNP,JJ,11,1
12044,11118.0,27,said,16,5,15,10,4,11,11,-1,Brin,Google,per,,PROPN,PROPN,dobj,compound,NNP,NNP,2,1
12045,11120.0,24,began,5,3,17,14,2,6,2,12,Frederick Trump,British Columbia,-,org-org,PROPN-PROPN,PROPN-PROPN,compound-compound,compound-pobj,NNP-NNP,NNP-NNP,6,1
12046,11121.0,40,is,11,3,7,4,2,32,8,-4,Baltic,AirBaltic,org,,PROPN,PROPN,compound,pobj,NNP,NNP,3,1
12047,11123.0,6,Italy,2,1,3,2,0,2,1,1,Carolina Kostner,Italy,org-org,,PROPN-PROPN,PROPN,compound-compound,ROOT,NNP-NNP,NNP,2,1
12048,11126.0,30,compete,2,2,5,3,1,24,0,3,Lancers,Ontario University Athletics,org,--,PROPN,PROPN-PROPN-PROPN,nsubj,compound-compound-pobj,NNPS,NNP-NNP-NNP,3,1
12049,11127.0,35,pushed,1,30,32,2,29,2,-29,31,Defense,Kurt von Schleicher,per,--,PROPN,PROPN-PROPN-PROPN,compound,compound-compound-conj,NNP,NNP-NNP-NNP,3,1
12050,11128.0,21,are,5,1,8,7,0,12,4,3,Leyland Trucks,Central Lancashire,-,per-per,PROPN-PROPN,PROPN-PROPN,compound-nsubj,compound-attr,NNP-NNPS,NNP-NNP,4,1
12051,11129.0,33,Marinella,0,1,22,21,0,10,-1,22,Marinella,he PolyGram Recor,org,--,PROPN,PRON-PROPN-PROPN,ROOT,pobj-nmod-nmod,NNP,PRP-NNP-NNP,7,1
12052,11130.0,43,received,2,24,19,-5,23,23,-22,17,Central Saint Martins College of Art and Design,University of the Arts London,-------,per-per-per-per-per,PROPN-PROPN-PROPN-PROPN-ADP-PROPN-CCONJ-PROPN,PROPN-ADP-DET-PROPN-PROPN,compound-compound-compound-pobj-prep-nmod-cc-conj,pobj-prep-det-compound-pobj,NNP-NNP-NNPS-NNP-IN-NNP-CC-NNP,NNP-IN-DT-NNPS-NNP,6,1
12053,11132.0,59,By,0,16,29,13,15,29,-16,29,London,Strummer,org,,PROPN,PROPN,compound,poss,NNP,NNP,-1,1
12054,11133.0,49,records,9,23,24,1,22,24,-14,15,UK,John Digweed,,per-per,PROPN,PROPN-PROPN,compound,compound-compound,NNP,NNP-NNP,2,1
12055,11134.0,38,was,5,30,23,-7,29,14,-25,18,Giovanni Giolitti,Italy,-,org,PROPN-PROPN,PROPN,compound-conj,pobj,NNP-NNP,NNP,4,1
12056,11135.0,54,Bragg,1,8,32,24,7,21,-7,31,Richard Burton,Elizabeth Taylor,per-per,-,PROPN-PROPN,PROPN-PROPN,compound-pobj,compound-pobj,NNP-NNP,NNP-NNP,14,1
12057,11137.0,22,afford,1,14,17,3,13,4,-13,16,model,Mugdha Godse,org,-,NOUN,PROPN-PROPN,nsubj,compound-appos,NN,NNP-NNP,3,1
12058,11139.0,22,film,5,14,20,6,13,1,-9,15,Tsui Hark,Film Workshop,-,org-org,PROPN-PROPN,PROPN-PROPN,compound-pobj,compound-appos,NNP-NNP,NNP-NNP,2,1
12059,11142.0,34,said,16,13,32,19,12,1,3,16,Botswana,Festus Mogae,per,-,PROPN,PROPN-PROPN,compound,compound-pobj,NNP,NNP-NNP,12,1
12060,11144.0,33,is,3,1,17,16,0,15,2,14,Lockerby Composite School,Canada,--,per,PROPN-PROPN-PROPN,PROPN,compound-compound-nsubj,pobj,NNP-NNP-NNP,NNP,6,1
12061,11147.0,23,said,21,9,11,2,8,11,12,-10,Sharif,Egypt,per,,PROPN,PROPN,dobj,pobj,NNP,NNP,3,1
12062,11149.0,19,is,3,1,17,16,0,1,2,14,Channel 7 Television,Grimsby Institute,--,org-org,PROPN-NUM-PROPN,PROPN-PROPN,nmod-nummod-nsubj,compound-conj,NNP-CD-NNP,NNP-NNP,10,1
12063,11150.0,22,made,1,4,20,16,3,1,-3,19,London,Alastair Sim,org,-,PROPN,PROPN-PROPN,compound,compound-pobj,NNP,NNP-NNP,6,1
12064,11152.0,31,said,11,6,13,7,5,17,5,2,Baltimore,Delegate Rawlings,per,-,PROPN,PROPN-PROPN,compound,compound-nsubj,NNP,NNP-NNP,8,1
12065,11154.0,27,College,1,1,21,20,0,5,0,20,Vidyasagar College,University of Calcutta,per-per,--,PROPN-PROPN,PROPN-ADP-PROPN,compound-ROOT,pobj-prep-pobj,NNP-NNP,NNP-IN-NNP,7,1
12066,11155.0,20,signed,2,6,10,4,5,9,-4,8,Botany Swarm,New Zealand Ice Hockey League,-,org-org-org-org-org,PROPN-PROPN,PROPN-PROPN-PROPN-PROPN-PROPN,compound-pobj,compound-compound-compound-compound-pobj,NNP-NNP,NNP-NNP-NNP-NNP-NNP,3,1
12067,11160.0,34,declined,8,15,26,11,14,7,-7,18,EDF Energy,France,org-org,,PROPN-PROPN,PROPN,compound-nsubjpass,appos,NNP-NNP,NNP,4,1
12068,11162.0,29,after,1,7,18,11,6,10,-6,17,Prime Minister,Viktor Yushchenko,org-org,-,PROPN-PROPN,PROPN-PROPN,compound-pobj,compound-pobj,NNP-NNP,NNP-NNP,6,1
12069,11163.0,38,divided,5,2,18,16,1,19,3,13,his,California,per,,DET,PROPN,poss,compound,PRP$,NNP,8,1
12070,11164.0,23,began,1,5,5,0,4,17,-4,4,Oxford University,Oxford University Cricket Club,per-per,---,PROPN-PROPN,PROPN-PROPN-PROPN-PROPN,compound-pobj,compound-compound-compound-pobj,NNP-NNP,NNP-NNP-NNP-NNP,0,1
12071,11165.0,36,renamed,10,12,20,8,11,15,-2,10,Burkina Faso,Thomas Sankara,org-org,-,PROPN-PROPN,PROPN-PROPN,compound-oprd,compound-pobj,NNP-NNP,NNP-NNP,4,1
12072,11166.0,21,is,15,1,14,13,0,6,14,-1,Billy J. Kramer,England,org-org-org,,PROPN-PROPN-PROPN,PROPN,compound-compound-nsubj,appos,NNP-NNP-NNP,NNP,2,1
12073,11167.0,28,issued,8,6,25,19,5,2,2,17,45th Space Wing,Air Force,per-per-per,-,PROPN-PROPN-PROPN,PROPN-PROPN,amod-compound-nsubj,compound-compound,NNP-NNP-NNP,NNP-NNP,5,1
12074,11172.0,14,degree,0,6,9,3,5,4,-6,9,Punjab Agricultural University,Ludhiana,--,org,PROPN-PROPN-PROPN,PROPN,compound-compound-compound,compound,NNP-NNP-NNP,NNP,3,1
12075,11173.0,37,announced,26,3,7,4,2,29,23,-19,Tusk,PO,,per,PROPN,PROPN,poss,poss,NNP,NNP,5,1
12076,11175.0,41,developed,18,2,10,8,1,30,16,-8,musician,Phil Lesh,per,-,NOUN,PROPN-PROPN,nsubj,compound-pobj,NN,NNP-NNP,4,1
12077,11176.0,24,o,0,8,12,4,7,11,-8,12,National Science Foundation,NSF,per-per-per,,PROPN-PROPN-PROPN,PROPN,compound-compound-nmod,nmod,NNP-NNP-NNP,NNP,3,1
12078,11177.0,31,withdrew,25,9,18,9,8,12,16,-7,Sadiq al-Mahdi,Sudan,org-org,,PROPN-PROPN,PROPN,compound-appos,compound,NNP-NNP,NNP,5,1
12079,11178.0,18,born,2,1,13,12,0,4,1,11,Parra,Chile,per,,NOUN,PROPN,nsubjpass,pobj,NN,NNP,3,1
12080,11179.0,21,based,2,6,16,10,5,4,-4,14,University of New South Wales,Kensington,----,org,PROPN-ADP-PROPN-PROPN-PROPN,PROPN,nmod-prep-compound-compound-pobj,pobj,NNP-IN-NNP-NNP-NNP,NNP,5,1
12081,11180.0,16,serviced,7,4,10,6,3,5,3,3,Seoul,Asiana Airlines,per,-,PROPN,PROPN-PROPN,compound,compound-pobj,NNP,NNP-NNP,6,1
12082,11181.0,29,married,25,11,23,12,10,5,14,-2,Max Roach,myself,-,per,PROPN-PROPN,PRON,compound-dobj,dobj,NNP-NNP,PRP,4,1
12083,11185.0,27,won,4,21,23,2,20,3,-17,19,Japan,Tomoyoshi Koyama,,org-org,PROPN,PROPN-PROPN,poss,compound-pobj,NNP,NNP-NNP,2,1
12084,11187.0,19,won,1,1,6,5,0,12,0,5,Akaka,Hawaii,per,,PROPN,PROPN,nsubj,compound,NNP,NNP,1,1
12085,11188.0,103,is,1,59,81,22,58,21,-58,80,Kilburn,Ian Dury,org,-,PROPN,PROPN-PROPN,pobj,compound-pobj,NNP,NNP-NNP,7,1
12086,11189.0,20,criticized,4,1,4,3,0,15,3,0,The ACORN,Ottawa,-,org,DET-PROPN,PROPN,det-nsubj,pobj,DT-NNP,NNP,1,1
12087,11191.0,22,was,9,1,13,12,0,8,8,4,Rodrigo Borja Cevallos,Ecuador,per-per-per,,PROPN-PROPN-PROPN,PROPN,compound-compound-nsubj,pobj,NNP-NNP-NNP,NNP,3,1
12088,11195.0,31,is,12,26,30,4,25,0,-14,18,Vrije Universiteit Brussel,Brussels,--,org,PROPN-PROPN-PROPN,PROPN,compound-compound-pobj,pobj,NNP-NNP-NNP,NNP,8,1
12089,11196.0,53,awarded,2,38,43,5,37,9,-36,41,Dublin City University,Ollscoil Chathair Bhaile Cliath,--,org-org-org-org,PROPN-PROPN-PROPN,PROPN-PROPN-PROPN-PROPN,compound-compound-compound,compound-compound-compound-appos,NNP-NNP-NNP,NNP-NNP-NNP-NNP,7,1
12090,11197.0,63,noted,10,4,9,5,3,53,6,-1,John Negroponte,National Intelligence,per-per,-,PROPN-PROPN,PROPN-PROPN,compound-pobj,compound-pobj,NNP-NNP,NNP-NNP,3,1
12091,11437.0,23,is,1,6,21,15,5,1,-5,20,John Negroponte,National Intelligence,per-per,-,PROPN-PROPN,PROPN-PROPN,compound-pobj,compound-pobj,NNP-NNP,NNP-NNP,4,1
12092,13576.0,29,said,22,7,13,6,6,15,15,-9,John Negroponte,National Intelligence,org-org,-,PROPN-PROPN,PROPN-PROPN,compound-pobj,compound-pobj,NNP-NNP,NNP-NNP,3,1
12093,11198.0,76,made,7,62,63,1,61,12,-55,56,Treasury,Lloyd Bentsen,per,-,PROPN,PROPN-PROPN,pobj,compound-pobj,NNP,NNP-NNP,1,1
12094,11199.0,31,split,4,10,16,6,9,14,-6,12,The Broadway,Los Angeles,per-per,-,DET-PROPN,PROPN-PROPN,det-compound,compound-pobj,DT-NNP,NNP-NNP,4,1
12095,11201.0,36,ordered,5,18,33,15,17,2,-13,28,US Army,Virginia Military Institute,-,per-per-per,PROPN-PROPN,PROPN-PROPN-PROPN,compound-compound,compound-compound-pobj,NNP-NNP,NNP-NNP-NNP,16,1
12096,11203.0,19,transferred,3,6,9,3,5,9,-3,6,NCAA Division II,Wingate University,per-per-per,-,PROPN-PROPN-PROPN,PROPN-PROPN,compound-compound-compound,compound-pobj,NNP-NNP-NNP,NNP-NNP,2,1
12097,11204.0,41,manufactured,9,26,28,2,25,12,-17,19,1988,Geo,,org,NUM,PROPN,appos,compound,CD,NNP,-1,1
12098,11205.0,22,consists,5,2,2,0,1,19,3,-3,South Carolina,South Carolina Army National Guard,per-per,----,PROPN-PROPN,PROPN-PROPN-PROPN-PROPN-PROPN,compound-compound,compound-compound-compound-compound-pobj,NNP-NNP,NNP-NNP-NNP-NNP-NNP,0,1
12099,11206.0,70,brought,3,10,16,6,9,53,-7,13,Peterborough,Trent University,,per-per,PROPN,PROPN-PROPN,compound,compound-ROOT,NNP,NNP-NNP,4,1
12100,11209.0,26,appointed,5,8,12,4,7,13,-3,7,Donna Shalala,Health and Human Services,-,per-per-per-per,PROPN-PROPN,PROPN-CCONJ-PROPN-PROPN,compound-compound,pobj-cc-compound-conj,NNP-NNP,NNP-CC-NNP-NNPS,4,1
12101,11210.0,32,founded,3,5,30,25,4,1,-2,27,Enterprise Inns,United Kingdom,per-per,-,NOUN-NOUN,PROPN-PROPN,compound-dobj,compound-pobj,NN-NNS,NNP-NNP,8,1
12102,11211.0,14,are,3,2,12,10,1,1,1,9,Milwaukee Panthers,Wisconsin,-,per,PROPN-PROPN,PROPN,compound-nsubj,pobj,NNP-NNPS,NNP,4,1
12103,11212.0,25,encouraged,2,12,23,11,11,1,-10,21,Klaus Schulze,Sky Records,-,per-per,PROPN-PROPN,PROPN-PROPN,compound-conj,compound-pobj,NNP-NNP,NNP-NNPS,7,1
12104,11213.0,19,located,4,1,16,15,0,2,3,12,Hofstra University,Hempstead,-,org,PROPN-PROPN,PROPN,compound-compound,compound,NNP-NNP,NNP,8,1
12105,11214.0,17,is,2,9,13,4,8,3,-7,11,Wright State University,Dayton,--,per,PROPN-PROPN-PROPN,PROPN,compound-compound-pobj,compound,NNP-NNP-NNP,NNP,2,1
12106,11215.0,36,said,10,4,9,5,3,26,6,-1,American Federation of Teachers,Randi Weingarten,---,org-org,PROPN-PROPN-ADP-PROPN,PROPN-PROPN,compound-nsubj-prep-compound,compound-pobj,NNP-NNP-IN-NNPS,NNP-NNP,2,1
12107,11565.0,40,Federation,1,1,9,8,0,30,0,8,American Federation of Teachers,Randi Weingarten,---,org-org,PROPN-PROPN-ADP-PROPN,PROPN-PROPN,compound-ROOT-prep-pobj,compound-nsubj,NNP-NNP-IN-NNPS,NNP-NNP,-1,1
12108,11216.0,27,supplies,4,1,4,3,0,22,3,0,Icheon,Hynix,,per,PROPN,PROPN,compound,nsubj,NNP,NNP,1,1
12109,11217.0,33,Machado,1,1,19,18,0,13,0,18,Gerardo Machado,Cuba,-,per,PROPN-PROPN,PROPN,compound-ROOT,pobj,NNP-NNP,NNP,5,1
12110,11220.0,47,had,3,37,45,8,36,1,-34,42,Federal,James Brown,per,-,PROPN,PROPN-PROPN,compound,compound-pobj,NNP,NNP-NNP,4,1
12111,11222.0,19,was,1,11,12,1,10,6,-10,11,King,William II of England,,per-per-per-per,PROPN,PROPN-PROPN-ADP-PROPN,compound,compound-pobj-prep-pobj,NNP,NNP-NNP-IN-NNP,1,1
12112,11224.0,25,made,1,20,22,2,19,2,-19,21,Prime Minister,Andrew Bonar Law,-,per-per-per,PROPN-PROPN,PROPN-PROPN-PROPN,compound-compound,compound-compound-attr,NNP-NNP,NNP-NNP-NNP,2,1
12113,11227.0,17,comes,10,8,10,2,7,6,2,0,Aishwarya Rai,Bachchan,-,per,PROPN-PROPN,PROPN,compound-compound,conj,NNP-NNP,NNP,4,1
12114,11229.0,24,going,3,17,21,4,16,2,-14,18,Minneapolis,University of Minnesota,,org-org-org,PROPN,PROPN-ADP-PROPN,compound,pobj-prep-pobj,NNP,NNP-IN-NNP,3,1
12115,11230.0,8,born,2,1,5,4,0,2,1,3,Webbie,Baton Rouge,org,-,NOUN,PROPN-PROPN,nsubjpass,compound-compound,NN,NNP-NNP,4,1
12116,11231.0,29,send,2,20,24,4,19,4,-18,22,Aston University,Birmingham,-,per,PROPN-PROPN,PROPN,compound-compound,compound,NNP-NNP,NNP,1,1
12117,11232.0,29,nicknamed,7,2,7,5,1,21,5,0,7th Independent Battery Wisconsin Light Artillery,Artillery,-----,per,ADJ-PROPN-PROPN-PROPN-PROPN-PROPN,PROPN,amod-compound-compound-compound-compound-nsubj,nsubj,JJ-NNP-NNP-NNP-NNP-NNP,NNP,3,1
12118,11234.0,40,betrayed,17,2,22,20,1,17,15,5,Peruvians,Moreno,org,,PROPN,PROPN,nsubj,pobj,NNPS,NNP,3,1
12119,11235.0,19,was,3,1,13,12,0,5,2,10,Newman,Bayonne,,org,NOUN,PROPN,nsubj,nmod,NN,NNP,8,1
12120,11236.0,33,was,11,25,31,6,24,1,-14,20,Jamaica,Alexander Bustamante,org,-,PROPN,PROPN-PROPN,poss,compound-pobj,NNP,NNP-NNP,3,1
12121,11237.0,34,raised,11,11,18,7,10,15,0,7,California,GreenNote,,per,PROPN,PROPN,pobj,pobj,NNP,NNP,2,1
12122,11238.0,19,founded,2,1,12,11,0,6,1,10,Plan,John Langdon-Davies,per,-,PROPN,PROPN-PROPN,nsubjpass,compound-pobj,NNP,NNP-NNP,4,1
12123,11239.0,52,created,32,21,31,10,20,20,11,-1,Sam the Record Man,Canada,org-org-org-org,,PROPN-DET-PROPN-PROPN,PROPN,appos-det-compound-nmod,poss,NNP-DT-NNP-NNP,NNP,6,1
12124,11240.0,33,orchestra,1,8,21,13,7,11,-7,20,Taipei,Ma Ying-jeou,,per-per,PROPN,PROPN-PROPN,pobj,compound-pobj,NNP,NNP-NNP,8,1
12125,11242.0,38,downloaded,10,4,7,3,3,30,6,-3,ARRIS,chief executive,org,-,PROPN,ADJ-NOUN,nmod,amod-compound,NNP,JJ-NN,2,1
12126,11243.0,24,ended,1,1,15,14,0,8,0,14,Lowe,USA,,per,PROPN,PROPN,nsubj,compound,NNP,NNP,4,1
12127,11244.0,23,said,11,19,21,2,18,1,-8,10,Israel,Bar-Ilan University,,per-per,PROPN,PROPN-PROPN,poss,punct-pobj,NNP,NNP-NNP,4,1
12128,11245.0,39,said,8,7,11,4,6,27,1,3,Maxime Verhagen,Netherlands,-,per,PROPN-PROPN,PROPN,compound-nsubj,nsubj,NNP-NNP,NNP,4,1
12129,12685.0,31,said,29,4,11,7,3,19,25,-18,Maxime Verhagen,Netherlands,-,per,PROPN-PROPN,PROPN,compound-nsubj,pobj,NNP-NNP,NNP,3,1
12130,11246.0,26,declined,1,9,15,6,8,10,-8,14,Lon Nol,Khmer Republic,-,per-per,PROPN-PROPN,PROPN-PROPN,compound-pobj,compound-pobj,NNP-NNP,NNP-NNP,4,1
12131,11248.0,9,Takes,1,1,6,5,0,2,0,5,California,Hospital,per,,PROPN,PROPN,nsubj,poss,NNP,NNP,4,1
12132,11249.0,30,claims,5,24,27,3,23,2,-19,22,Van Nuys,MGA Entertainment,-,org-org,PROPN-PROPN,PROPN-PROPN,compound-compound,compound-compound,NNP-NNP,NNP-NNP,4,1
12133,11250.0,42,thinks,5,38,41,3,37,0,-33,36,Netscape,1994,,per,PROPN,NUM,compound,pobj,NNP,CD,4,1
12134,11254.0,30,ate,22,15,19,4,14,10,7,-3,New Zealand,Helen Clark,org-org,-,PROPN-PROPN,PROPN-PROPN,compound-compound,compound-pobj,NNP-NNP,NNP-NNP,2,1
12135,11255.0,31,includes,2,14,15,1,13,15,-12,13,actress,Salma Hayek,,org-org,NOUN,PROPN-PROPN,compound,compound-pobj,NN,NNP-NNP,1,1
12136,11256.0,39,operates,4,9,14,5,8,24,-5,10,Mt. Edgecumbe High School,Sitka,---,per,PROPN-PROPN-PROPN-PROPN,PROPN,compound-compound-compound-appos,pobj,NNP-NNP-NNP-NNP,NNP,3,1
12137,11257.0,24,owned,5,10,19,9,9,4,-5,14,Zijin Mining,China,per-per,,PROPN-PROPN,PROPN,compound-compound,poss,NNP-NNP,NNP,4,1
12138,11258.0,47,is,24,13,24,11,12,22,11,0,VNPT,MobiFone,per,,PROPN,PROPN,appos,oprd,NNP,NNP,8,1
12139,11259.0,29,was,8,5,13,8,4,15,3,5,Atlanta,the Weather Channel,,per-per-per,PROPN,DET-PROPN-PROPN,pobj,det-compound-conj,NNP,DT-NNP-NNP,7,1
12140,11260.0,45,are,5,28,44,16,27,0,-23,39,Jeanne III of Navarre,France,---,per,PROPN-PROPN-ADP-PROPN,PROPN,compound-pobj-prep-compound,pobj,NNP-NNP-IN-NNP,NNP,11,1
12141,13475.0,49,painted,15,34,48,14,33,0,-19,33,Jeanne III of Navarre,France,---,org,PROPN-PROPN-ADP-PROPN,PROPN,compound-appos-prep-pobj,pobj,NNP-NNP-IN-NNP,NNP,5,1
12142,11261.0,24,is,12,1,22,21,0,1,11,10,Drum Workshop,Oxnard,-,per,PROPN-PROPN,PROPN,compound-nsubj,compound,NNP-NNP,NNP,5,1
12143,11263.0,15,was,4,3,12,9,2,2,1,8,Gustav Heinemann,Germany,-,per,PROPN-PROPN,PROPN,compound-appos,pobj,NNP-NNP,NNP,8,1
12144,11264.0,27,stunned,5,9,25,16,8,1,-4,20,Indonesia,Megawati,org,,PROPN,PROPN,pobj,compound,NNP,NNP,2,1
12145,13444.0,20,saw,8,1,10,9,0,9,7,2,Indonesia,Megawati,per,,PROPN,PROPN,poss,nsubj,NNP,NNP,4,1
12146,11265.0,16,appointed,14,3,8,5,2,7,11,-6,NEGS,Anglican,,org,PROPN,ADJ,nsubjpass,amod,NNP,JJ,3,1
12147,11266.0,48,was,4,29,40,11,28,7,-25,36,New York City,Andy Warhol,per-per-per,-,PROPN-PROPN-PROPN,PROPN-PROPN,compound-compound-pobj,compound-compound,NNP-NNP-NNP,NNP-NNP,11,1
12148,11269.0,34,grew,17,6,28,22,5,5,11,11,John L. Mitchell,Milwaukee,per-per-per,,PROPN-PROPN-PROPN,PROPN,compound-compound-pobj,compound,NNP-NNP-NNP,NNP,9,1
12149,11270.0,45,Act,1,24,15,-9,23,29,-23,14,England,the police,org,-,PROPN,DET-NOUN,pobj,det-pobj,NNP,DT-NN,5,1
12150,11271.0,24,is,12,7,18,11,6,5,5,6,college,California,org,,NOUN,PROPN,nsubj,compound,NN,NNP,6,1
12151,11272.0,22,composed,3,9,19,10,8,2,-6,16,Vodafone AirTouch,4,org-org,,PROPN-PROPN,NUM,compound-poss,nummod,NNP-NNP,CD,9,1
12152,11274.0,24,sanctioned,3,2,22,20,1,1,1,19,league,USSF,,per,NOUN,PROPN,nsubjpass,appos,NN,NNP,7,1
12153,11275.0,25,born,2,5,15,10,4,9,-3,13,Guatemala,Vinicio Cerezo,org,-,PROPN,PROPN-PROPN,compound,compound-compound,NNP,NNP-NNP,4,1
12154,11276.0,28,Rzeznik,3,18,23,5,17,4,-15,20,Johnny Rzeznik,guitarist,-,org,PROPN-PROPN,NOUN,compound-pobj,nmod,NNP-NNP,NN,6,1
12155,11277.0,44,dissolved,2,11,26,15,10,17,-9,24,Lee High School,Clinch Mountain District,org-org-org,--,PROPN-PROPN-PROPN,PROPN-PROPN-PROPN,compound-compound-appos,compound-compound-pobj,NNP-NNP-NNP,NNP-NNP-NNP,12,1
12156,11278.0,25,is,12,1,5,4,0,19,11,-7,Meryl Streep,Mary Louise Streep,per-per,--,PROPN-PROPN,PROPN-PROPN-PROPN,compound-nsubj,compound-compound-dobj,NNP-NNP,NNP-NNP-NNP,3,1
12157,11279.0,20,appointed,1,5,13,8,4,6,-4,12,Wellington Webb,Denver,org-org,,PROPN-PROPN,PROPN,compound-pobj,compound,NNP-NNP,NNP,8,1
12158,13423.0,17,include,2,7,14,7,6,2,-5,12,Wellington Webb,Denver,-,org,PROPN-PROPN,PROPN,compound-nsubj,poss,NNP-NNP,NNP,5,1
12159,11280.0,30,is,1,1,20,19,0,9,0,19,Bezeq,Yes,,org,PROPN,INTJ,nsubj,intj,NNP,UH,-1,1
12160,11281.0,23,is,7,1,10,9,0,12,6,3,Joan,Dominican,org,,PROPN,ADJ,nsubj,amod,NNP,JJ,4,1
12161,11282.0,25,worked,2,5,22,17,4,2,-3,20,Plze?,f Work,,org-org,NOUN,X-PROPN,pobj,det-compound,NN,XX-NNP,-1,1
12162,11283.0,21,belongs,3,6,9,3,5,11,-3,6,Amy Adams,actress,per-per,,PROPN-PROPN,NOUN,compound-pobj,appos,NNP-NNP,NN,3,1
12163,11284.0,17,is,3,1,15,14,0,1,2,12,Loughborough High School,Leicestershire,--,per,PROPN-PROPN-PROPN,PROPN,compound-compound-nsubj,compound,NNP-NNP-NNP,NNP,8,1
12164,11286.0,23,consolidated,5,1,8,7,0,14,4,3,Hartford City,Blackford High School,org-org,--,PROPN-PROPN,PROPN-PROPN-PROPN,compound-compound,compound-compound-pobj,NNP-NNP,NNP-NNP-NNP,5,1
12165,11288.0,29,got,2,1,22,21,0,6,1,20,David Civera,Spain,per-per,,PROPN-PROPN,PROPN,compound-nsubj,pobj,NNP-NNP,NNP,3,1
12166,11289.0,33,performing,4,2,7,5,1,25,2,3,band,Australia,org,,NOUN,PROPN,nsubj,compound,NN,NNP,3,1
12167,11290.0,19,represents,4,2,10,8,1,8,2,6,WCBE,Columbus City Schools,org,--,PROPN,PROPN-PROPN-PROPN,nsubj,compound-compound-ROOT,NNP,NNP-NNP-NNP,5,1
12168,11291.0,21,was,4,12,15,3,11,5,-8,11,Motown,Brenda Holloway,org,-,PROPN,PROPN-PROPN,compound,compound-pobj,NNP,NNP-NNP,2,1
12169,11295.0,49,December2008,0,8,28,20,7,20,-8,28,MegaFon,Moscow,org,,PROPN,PROPN,pobj,appos,NNP,NNP,12,1
12170,11297.0,15,attended,4,6,14,8,5,0,-2,10,Worksop College,Nottinghamshire,per-per,,PROPN-PROPN,PROPN,compound-dative,pobj,NNP-NNP,NNP,2,1
12171,11298.0,17,is,1,11,15,4,10,1,-10,14,her,Verve,,per,DET,PROPN,poss,compound,PRP$,NNP,4,1
12172,11299.0,10,is,2,1,9,8,0,0,1,7,Higuchi,Congress,,per,PROPN,PROPN,nsubj,pobj,NNP,NNP,5,1
12173,11301.0,39,began,1,35,38,3,34,0,-34,37,Art Hodes,Chicago,-,per,PROPN-PROPN,PROPN,compound-pobj,pobj,NNP-NNPS,NNP,4,1
12174,11302.0,116,reshuffled,103,2,10,8,1,105,101,-93,al-Bashir,Sudan,per,,PROPN,PROPN,poss,poss,NNP,NNP,6,1
12175,11303.0,35,said,3,1,11,10,0,23,2,8,General Motors,Vauxhall,-,per,PROPN-PROPN,PROPN,compound-compound,conj,NNP-NNPS,NNP,6,1
12176,11304.0,22,formed,3,8,20,12,7,1,-5,17,Sparrow Records,Margaret Becker,per-per,-,PROPN-PROPN,PROPN-PROPN,compound-appos,compound-conj,NNP-NNPS,NNP-NNP,3,1
12177,11305.0,23,comes,2,18,22,4,17,0,-16,20,South San Francisco,Genentech,--,org,PROPN-PROPN-PROPN,PROPN,compound-compound-pobj,dobj,NNP-NNP-NNP,NNP,3,1
12178,11311.0,51,Payne,4,18,26,8,17,24,-14,22,English,Ian Dury,per,-,ADJ,PROPN-PROPN,amod,compound-poss,JJ,NNP-NNP,6,1
12179,11312.0,38,Birthdays,2,5,23,18,4,14,-3,21,Christa McAuliffe,New Hampshire,-,per-per,PROPN-PROPN,PROPN-PROPN,compound-appos,compound-pobj,NNP-NNP,NNP-NNP,-1,1
12180,11313.0,42,ran,11,9,16,7,8,25,2,5,Louisville,McConnell,,org,PROPN,PROPN,poss,poss,NNP,NNP,5,1
12181,11314.0,20,discography,1,4,19,15,3,0,-3,18,Versailles,Hizaki,org,,PROPN,PROPN,pobj,conj,NNP,NNP,3,1
12182,11315.0,22,renamed,4,4,17,13,3,4,0,13,school,St. Paul School,per,--,NOUN,PROPN-PROPN-PROPN,nsubj,compound-compound-pobj,NN,NNP-NNP-NNP,4,1
12183,11316.0,16,are,4,2,7,5,1,8,2,3,Minnesota Golden Gophers,Division I,--,per-per,PROPN-PROPN-PROPN,PROPN-NUM,compound-compound-nsubj,nmod-nmod,NNP-NNP-NNPS,NNP-CD,4,1
12184,11317.0,39,video,2,24,26,2,23,12,-22,24,Girlicious,Natalie Mejia,per,-,PROPN,PROPN-PROPN,compound,compound-compound,NNP,NNP-NNP,2,1
12185,11320.0,31,was,1,1,6,5,0,24,0,5,He,Tasmania,,org,PRON,PROPN,nsubj,pobj,PRP,NNP,1,1
12186,11321.0,52,grew,10,28,44,16,27,7,-18,34,Touch,Butthole Surfers,per,-,PROPN,PROPN-PROPN,compound,compound-compound,NNP,NNP-NNPS,10,1
12187,11323.0,23,is,11,11,21,10,10,1,0,10,Blockhead,New York,,per-per,PROPN,PROPN-PROPN,appos,compound-pobj,NNP,NNP-NNP,4,1
12188,11325.0,26,achieved,5,3,11,8,2,14,2,6,FK Rg,n Virslig,-,org-org,PROPN-PROPN,CCONJ-PROPN,compound-nsubj,ROOT-ROOT,NNP-NNP,CC-NNP,4,1
12189,11326.0,16,derived,3,3,15,12,2,0,0,12,PGE,Oregon,org,,PROPN,PROPN,nsubj,pobj,NNP,NNP,1,1
12190,11328.0,45,worked,1,41,42,1,40,2,-40,41,his,Treasury,,org,DET,PROPN,poss,compound,PRP$,NNP,2,1
12191,11329.0,11,served,1,1,8,7,0,2,0,7,He,Denmark,per,,PRON,PROPN,nsubj,pobj,PRP,NNP,1,1
12192,11330.0,65,agreed,11,15,53,38,14,11,-4,42,Lauper,New York,,per-per,PROPN,PROPN-PROPN,dative,compound-compound,NNP,NNP-NNP,7,1
12193,11331.0,32,established,3,17,17,0,16,14,-14,14,Louisiana College,Louisiana,-,per,PROPN-PROPN,PROPN,compound-compound,pobj,NNP-NNP,NNP,0,1
12194,11332.0,41,featured,15,17,23,6,16,17,-2,8,Kevin Drew,Broken Social Scene,org-org,--,PROPN-PROPN,PROPN-PROPN-PROPN,compound-dobj,compound-compound-compound,NNP-NNP,NNP-NNP-NNP,2,1
12195,11333.0,35,goes,4,16,16,0,15,18,-12,12,Amsterdam,Amsterdam,org,,PROPN,PROPN,pobj,conj,NNP,NNP,0,1
12196,11334.0,49,comes,1,21,24,3,20,24,-20,23,Gena Rowlands,actress,org-org,,PROPN-VERB,NOUN,compound-appos,appos,NNP-VBZ,NN,2,1
12197,11335.0,37,constituted,10,3,2,-1,2,34,7,-8,Infantry Division,104th Division,-,org-org,PROPN-PROPN,PROPN-PROPN,compound-poss,amod-pobj,NNP-NNP,NNP-NNP,1,1
12198,11336.0,22,became,3,3,20,17,2,1,0,17,he,Royal Society,per,-,PRON,PROPN-PROPN,nsubj,compound-pobj,PRP,NNP-NNP,3,1
12199,11337.0,18,left,3,1,5,4,0,12,2,2,Richard Thompson,Fairport Convention,org-org,-,PROPN-PROPN,PROPN-PROPN,compound-nsubj,compound-dobj,NNP-NNP,NNP-NNP,2,1
12200,11339.0,30,announced,6,5,11,6,4,18,1,5,FTD,Interflora,per,,PROPN,PROPN,compound,compound,NNP,NNP,4,1
12201,11340.0,36,believe,2,23,25,2,22,10,-21,23,Shapour Bakhtiar,Iran,-,per,PROPN-PROPN,PROPN,compound-compound,poss,NNP-NNP,NNP,4,1
12202,11341.0,9,names,1,1,3,2,0,5,0,2,Motorola,Sanjay Jha,,org-org,PROPN,PROPN-PROPN,compound,compound-compound,NNP,NNP-NNP,1,1
12203,11343.0,33,enrolled,11,14,19,5,13,13,-3,8,Webster University,Missouri,per-per,,PROPN-PROPN,PROPN,compound-pobj,pobj,NNP-NNP,NNP,3,1
12204,11344.0,78,are,6,8,22,14,7,55,-2,16,Het Nieuwsblad,Corelio,per-per,,PROPN-PROPN,PROPN,compound-ROOT,appos,NNP-NNP,NNP,-1,1
12205,11345.0,53,attributed,42,13,16,3,12,36,29,-26,KMT,Ma Ying-jeou,per,-,PROPN,PROPN-PROPN,compound,compound-nsubjpass,NNP,NNP-NNP,3,1
12206,11346.0,33,Bennington,1,1,23,22,0,9,0,22,Chester Bennington,Arizona,-,org,PROPN-PROPN,PROPN,compound-ROOT,pobj,NNP-NNP,NNP,10,1
12207,11347.0,29,married,5,1,5,4,0,23,4,0,Sophie Harris,England,org-org,,PROPN-PROPN,PROPN,compound-nsubj,pobj,NNP-NNP,NNP,1,1
12208,11348.0,13,formed,2,1,7,6,0,5,1,5,Papercranes,Gainesville,org,,NOUN,PROPN,nsubjpass,pobj,NNS,NNP,3,1
12209,11349.0,11,Bolivia,0,1,4,3,0,6,-1,4,Bolivia,Morales,per,,PROPN,PROPN,ROOT,nsubj,NNP,NNPS,3,1
12210,11350.0,28,is,8,1,24,23,0,3,7,16,Washington State University,1890,--,org,PROPN-PROPN-PROPN,NUM,compound-compound-compound,pobj,NNP-NNP-NNP,CD,7,1
12211,11351.0,20,renamed,7,2,10,8,1,9,5,3,1982,Austin Rover Group,,per-per-per,NUM,PROPN-PROPN-PROPN,pobj,compound-compound-oprd,CD,NNP-NNP-NNP,4,1
12212,11352.0,29,allowed,1,10,25,15,9,3,-9,24,Byron Stingily,singer,per-per,,PROPN-PROPN,NOUN,compound-conj,compound,NNP-NNP,NN,4,1
12213,11353.0,14,located,4,1,7,6,0,6,3,3,John Cabot University,Rome,--,org,PROPN-PROPN-PROPN,PROPN,compound-compound-nsubjpass,compound,NNP-NNP-NNP,NNP,4,1
12214,11356.0,18,is,1,1,15,14,0,2,0,14,ShortList,20 September 2007,,org-org-org,PROPN,NUM-PROPN-NUM,nsubj,nummod-pobj-nummod,NNP,CD-NNP-CD,4,1
12215,11357.0,34,was,1,1,8,7,0,25,0,7,She,Canadian,per,,PRON,PROPN,nsubj,amod,PRP,NNP,3,1
12216,11359.0,26,was,10,15,25,10,14,0,-5,15,EOKA,Cyprus,per,,PROPN,PROPN,pobj,pobj,NNP,NNP,2,1
12217,11360.0,23,bought,4,1,21,20,0,1,3,17,Bob Jones University,Greenville,org-org-org,,PROPN-PROPN-PROPN,PROPN,compound-compound-nsubj,compound,NNP-NNP-NNP,NNP,9,1
12218,11362.0,67,Let,0,1,21,20,0,45,-1,21,Let Loose,London,-,org,VERB-PROPN,PROPN,ROOT-nsubj,pobj,VB-NNP,NNP,8,1
12219,11363.0,29,said,16,14,14,0,13,14,2,-2,Colorado,Colorado State University,org,--,PROPN,PROPN-PROPN-PROPN,compound,compound-compound-pobj,NNP,NNP-NNP-NNP,0,1
12220,11364.0,35,said,15,26,32,6,25,2,-11,17,Robert Wood Johnson Medical School,New Brunswick,per-per-per-per-per,-,PROPN-PROPN-PROPN-PROPN-PROPN,PROPN-PROPN,compound-compound-compound-compound-pobj,compound-compound,NNP-NNP-NNP-NNP-NNP,NNP-NNP,6,1
12221,11365.0,29,educated,2,13,18,5,12,10,-11,16,Aiken Preparatory School,South Carolina,per-per-per,-,PROPN-PROPN-PROPN,PROPN-PROPN,compound-compound-conj,compound-compound,NNP-NNP-NNP,NNP-NNP,5,1
12222,11366.0,17,contributes,9,1,3,2,0,13,8,-6,Petronas,Malaysia,,org,PROPN,PROPN,nsubj,poss,NNP,NNP,4,1
12223,11367.0,26,is,5,2,14,12,1,11,3,9,Democratic Rally,Cyprus,-,per,ADJ-PROPN,PROPN,compound-nsubj,pobj,JJ-NNP,NNP,3,1
12224,11369.0,35,owned,4,7,25,18,6,9,-3,21,Somers,Alan Hamel,org,-,PROPN,PROPN-PROPN,pobj,compound-pobj,NNP,NNP-NNP,5,1
12225,11370.0,23,launched,13,18,20,2,17,2,-5,7,MyNetworkTV,September 5 2006,,per-per-per,PROPN,PROPN-NUM-NUM,oprd,pobj-nummod-nummod,NNP,NNP-CD-CD,2,1
12226,11736.0,33,announced,7,25,30,5,24,2,-18,23,MyNetworkTV,September 5 2006,per,--,NOUN,PROPN-NUM-NUM,pobj,pobj-nummod-nummod,NN,NNP-CD-CD,4,1
12227,13935.0,27,continued,11,2,8,6,1,18,9,-3,MyNetworkTV,September 5 2006,org,--,PROPN,PROPN-NUM-NUM,poss,pobj-nummod-nummod,NNP,NNP-CD-CD,6,1
12228,11371.0,26,Making,0,11,24,13,10,1,-11,24,Dire Straits,Warner Bros,org-org,-,PROPN-PROPN,PROPN-PROPN,compound-pobj,compound-pobj,NNP-NNPS,NNP-NNP,5,1
12229,11373.0,28,captured,6,1,22,21,0,5,5,16,Pakistan,Geo TV,org,-,PROPN,PROPN-NOUN,poss,compound-compound,NNP,NNP-NN,10,1
12230,11375.0,44,is,21,2,29,27,1,14,19,8,Kowloon Motor Bus,Hong Kong,per-per-per,-,PROPN-PROPN-PROPN,PROPN-PROPN,compound-compound-compound,compound-pobj,NNP-NNP-NNP,NNP-NNP,6,1
12231,12972.0,19,is,3,10,17,7,9,1,-7,14,Kowloon Motor Bus,Hong Kong,--,per-per,PROPN-PROPN-PROPN,PROPN-PROPN,compound-compound-pobj,compound-pobj,NNP-NNP-NNP,NNP-NNP,5,1
12232,11376.0,28,is,3,13,21,8,12,6,-10,18,Dire Straits,Vertigo,-,per,PROPN-PROPN,PROPN,compound-pobj,compound,NNP-NNPS,NNP,5,1
12233,11378.0,35,held,5,8,25,17,7,9,-3,20,the Stampeders,Canada,per-per,,DET-PROPN,PROPN,det-nsubj,compound,DT-NNP,NNP,7,1
12234,11380.0,27,went,3,1,21,20,0,5,2,18,The Libertines,London,-,per,DET-PROPN,PROPN,det-nsubj,pobj,DT-NNPS,NNP,5,1
12235,11381.0,42,confirmed,2,17,6,-11,16,35,-15,4,98th Guards Airborne Division,Russian Airborne Troops,---,org-org-org,NOUN-PROPN-PROPN-PROPN,ADJ-PROPN-PROPN,compound-compound-compound-pobj,compound-compound-pobj,NN-NNP-NNP-NNP,JJ-NNP-NNPS,8,1
12236,11382.0,33,known,3,17,27,10,16,5,-14,24,Empire of Japan,Imperial Japanese Army,per-per-per,--,PROPN-ADP-PROPN,PROPN-ADJ-PROPN,pobj-prep-pobj,compound-amod-pobj,NNP-IN-NNP,NNP-JJ-NNP,9,1
12237,11383.0,27,worked,1,7,12,5,6,14,-6,11,ITN,ITV News Channel,per,--,PROPN,PROPN-PROPN-PROPN,pobj,compound-compound-dobj,NNP,NNP-NNP-NNP,2,1
12238,11385.0,16,is,8,1,7,6,0,8,7,-1,American Champion,Rochester,-,per,PROPN-PROPN,PROPN,compound-compound,compound,NNP-NNP,NNP,4,1
12239,11386.0,26,earned,1,14,16,2,13,9,-13,15,USC,Steven B. Sample,per,--,PROPN,PROPN-PROPN-PROPN,compound,compound-compound-pobj,NNP,NNP-NNP-NNP,2,1
12240,11387.0,32,stepped,5,4,12,8,3,19,1,7,Jean Charest,Progressive Conservatives,-,per-per,PROPN-PROPN,PROPN-PROPN,compound-nsubj,compound-pobj,NNP-NNP,NNP-NNPS,5,1
12241,11388.0,29,judge,3,20,17,-3,19,11,-17,14,Communication Workers Union,South Africa,per-per-per,-,PROPN-PROPN-PROPN,PROPN-PROPN,compound-compound-pobj,compound-pobj,NNP-NNPS-NNP,NNP-NNP,3,1
12242,11389.0,31,serves,1,7,16,9,6,14,-6,15,Barack Obama,Michelle Obama,-,per-per,PROPN-PROPN,PROPN-PROPN,compound-pobj,compound-pobj,NNP-NNP,NNP-NNP,5,1
12243,11390.0,27,founded,2,1,18,17,0,8,1,16,Vitasoy,Hong Kong,,per-per,PROPN,PROPN-PROPN,nsubjpass,compound-pobj,NNP,NNP-NNP,5,1
12244,11391.0,16,renamed,5,3,7,4,2,8,2,2,Ashmun Institute,Lincoln University,org-org,-,PROPN-PROPN,PROPN-PROPN,compound-nsubjpass,compound-oprd,NNP-NNP,NNP-NNP,2,1
12245,11393.0,30,paints,8,11,13,2,10,16,-3,5,Prime Minister,Gordon Brown,-,per-per,PROPN-PROPN,PROPN-PROPN,compound-compound,compound-dobj,NNP-NNP,NNP-NNP,1,1
12246,11394.0,23,is,14,9,13,4,8,9,5,-1,Universitas Islam Indonesia,UII,--,per,PROPN-PROPN-PROPN,PROPN,compound-compound-appos,conj,NNP-NNP-NNP,NNP,3,1
12247,11395.0,28,went,10,6,24,18,5,3,4,14,Prime Minister,Nepal,per-per,,PROPN-PROPN,PROPN,compound-compound,pobj,NNP-NNP,NNP,9,1
12248,11397.0,28,was,7,15,27,12,14,0,-8,20,Paramount Airways,India,-,per,PROPN-PROPN,PROPN,compound-pobj,pobj,NNP-NNP,NNP,8,1
12249,11398.0,23,was,6,1,13,12,0,9,5,7,Jesse Brown,Veterans Affairs,org-org,-,PROPN-PROPN,PROPN-PROPN,compound-nsubj,pobj-attr,NNP-NNP,NNP-NNPS,2,1
12250,11399.0,13,serves,3,1,12,11,0,0,2,9,Huddersfield,England,per,,PROPN,PROPN,compound,pobj,NNP,NNP,3,1
12251,11400.0,20,attended,2,4,12,8,3,7,-2,10,Cathedral High School,Indianapolis,per-per-per,,PROPN-PROPN-PROPN,PROPN,compound-compound-dobj,compound,NNP-NNP-NNP,NNP,4,1
12252,11403.0,63,is,4,7,30,23,6,32,-3,26,Anderson Community School Corporation,Highland High School,---,per-per-per,PROPN-PROPN-PROPN-PROPN,PROPN-PROPN-PROPN,compound-compound-compound-attr,compound-compound-appos,NNP-NNP-NNP-NNP,NNP-NNP-NNP,7,1
12253,11404.0,42,was,5,14,31,17,13,10,-9,26,Slobodan,l Croatia,per,-,PROPN,PROPN-PROPN,pobj,nmod-compound,NNP,NNP-NNP,-1,1
12254,11405.0,26,is,4,12,23,11,11,2,-8,19,of Ho Chi Mi,in Vietn,per-per-per-per,-,ADP-PROPN-PROPN-PROPN,ADP-PROPN,prep-compound-compound-pobj,prep-pobj,IN-NNP-NNP-NNP,IN-NNP,6,1
12255,11407.0,17,write-off,6,1,5,4,0,11,5,-1,Cessna,Textron,org,,PROPN,PROPN,poss,appos,NNP,NNP,4,1
12256,11409.0,19,composed,5,2,2,0,1,16,3,-3,Pennsylvania,Pennsylvania Army National Guard,org,---,PROPN,PROPN-PROPN-PROPN-PROPN,compound,compound-compound-compound-pobj,NNP,NNP-NNP-NNP-NNP,0,1
12257,11411.0,21,married,5,4,7,3,3,13,1,2,Andrew Cuomo,Kerry Kennedy,-,org-org,PROPN-PROPN,PROPN-PROPN,compound-appos,compound-dobj,NNP-NNP,NNP-NNP,3,1
12258,11412.0,44,issued,14,1,3,2,0,40,13,-11,Jackson,Chicago,per,,PROPN,PROPN,nmod,compound,NNP,NNP,1,1
12259,11413.0,21,have,1,9,11,2,8,9,-8,10,University of Kassel,Kassel,per-per-per,,PROPN-ADP-PROPN,PROPN,nmod-prep-pobj,compound,NNP-IN-NNP,NNP,4,1
12260,11414.0,30,helped,4,7,7,0,6,22,-3,3,Discovery Communications,Discovery Channel,org-org,-,PROPN-PROPN,PROPN-PROPN,compound-dobj,compound-compound,NNP-NNPS,NNP-NNP,0,1
12261,11415.0,35,was,10,14,18,4,13,16,-4,8,SS-Obergruppenfuhrer,Waffen-SS,,org,PROPN,NUM,compound,attr,NNP,CD,4,1
12262,11416.0,23,said,4,11,20,9,10,2,-7,16,PDVSA,Citgo,per,,PROPN,PROPN,conj,compound,NNP,NNP,5,1
12263,11417.0,16,include,3,2,10,8,1,5,1,7,Scantraxx,The Prophet,org,-,PROPN,DET-PROPN,compound,det-compound,NNP,DT-NNP,6,1
12264,11418.0,60,Employers,1,31,42,11,30,17,-30,41,USA,Kraft Foods,per,-,PROPN,PROPN-PROPN,nmod,compound-appos,NNP,NNP-NNPS,5,1
12265,11419.0,31,said,29,25,27,2,24,3,4,-2,Indonesian,Susilo Bambang Yudhoyono,org,--,ADJ,PROPN-PROPN-PROPN,amod,compound-compound-nsubj,JJ,NNP-NNP-NNP,2,1
12266,11421.0,47,appointed,15,9,31,22,8,15,6,16,University of Aalborg,Australian National University,--,per-per-per,PROPN-ADP-PROPN,PROPN-PROPN-PROPN,pobj-prep-pobj,compound-compound-compound,NNP-IN-NNP,NNP-NNP-NNP,12,1
12267,11422.0,43,signed,10,4,5,1,3,37,6,-5,President,Gnassingbe,per,,PROPN,PROPN,compound,nsubj,NNP,NNP,1,1
12268,11424.0,12,located,7,1,1,0,0,10,6,-6,Oklahoma School for the Deaf,Oklahoma,per-per-per-per-per,,PROPN-PROPN-ADP-DET-PROPN,PROPN,compound-nsubjpass-prep-det-pobj,pobj,NNP-NNP-IN-DT-NNP,NNP,0,1
12269,11426.0,43,experimenting,14,2,9,7,1,33,12,-5,Rover Company,Land Rover,org-org,-,PROPN-PROPN,PROPN-PROPN,compound-nsubj,compound-compound,NNP-NNP,NNP-NNP,4,1
12270,11427.0,45,make,6,3,29,26,2,15,3,23,Martin Barre,Jethro Tull,-,org-org,PROPN-PROPN,PROPN-PROPN,compound-nsubj,compound-pobj,NNP-NNP,NNP-NNP,9,1
12271,11428.0,38,recalling,2,14,26,12,13,11,-12,24,United States,Jeep,per-per,,PROPN-PROPN,PROPN,compound-pobj,compound,NNP-NNP,NNP,9,1
12272,11429.0,35,settled,2,8,12,4,7,22,-6,10,Galesburg,Knox College,org,-,PROPN,PROPN-PROPN,compound,compound-dobj,NNP,NNP-NNP,3,1
12273,11430.0,32,graduated,3,6,26,20,5,5,-3,23,Seoul,Hanyang University,,per-per,PROPN,PROPN-PROPN,compound,compound-pobj,NNP,NNP-NNP,9,1
12274,11431.0,33,called,14,13,11,-2,12,21,1,-3,Xanana,East Timor,,per-per,PROPN,PROPN-PROPN,pobj,compound-dobj,NNP,NNP-NNP,9,1
12275,11432.0,13,is,3,1,12,11,0,0,2,9,Angkor Airways,Cambodia,org-org,,PROPN-PROPN,PROPN,compound-compound,pobj,NNP-NNP,NNP,3,1
12276,11433.0,18,been,3,1,17,16,0,0,2,14,Austrian Airlines,Vienna,per-per,,PROPN-PROPN,PROPN,amod-nsubj,pobj,NNP-NNPS,NNP,2,1
12277,11435.0,20,is,6,1,13,12,0,6,5,7,Police Negotiation Team,New Zealand Police,org-org-org,--,PROPN-PROPN-PROPN,PROPN-PROPN-PROPN,compound-compound-nsubj,compound-compound-pobj,NNP-NNP-NNP,NNP-NNP-NNPS,6,1
12278,11439.0,22,begins,2,13,20,7,12,1,-11,18,Konstantin Chernenko,Communist Party,-,org-org,PROPN-PROPN,PROPN-PROPN,compound-dobj,compound-pobj,NNP-NNP,NNP-NNP,4,1
12279,11441.0,17,established,3,2,10,8,1,6,1,7,university,Rajkot,org,,NOUN,PROPN,nsubjpass,compound,NN,NNP,3,1
12280,11443.0,11,went,6,1,10,9,0,0,5,4,Heath,London,org,,PROPN,PROPN,nsubj,pobj,NNP,NNP,4,1
12281,11445.0,33,performed,3,2,32,30,1,0,1,29,Toronto,Quartette,per,,PROPN,PROPN,compound,pobj,NNP,NNP,2,1
12282,11446.0,21,founded,3,10,18,8,9,2,-7,15,James Otis,New York City,org-org,--,PROPN-PROPN,PROPN-PROPN-PROPN,compound-compound,compound-compound-pobj,NNP-NNP,NNP-NNP-NNP,5,1
12283,11448.0,30,Saio,2,7,20,13,6,9,-5,18,Nairobi Hospital,Kenya,per-per,,PROPN-PROPN,PROPN,compound-pobj,pobj,NNP-NNP,NNP,8,1
12284,11449.0,30,For,0,8,15,7,7,14,-8,15,The Runaways,Joan Jett,-,org-org,DET-PROPN,PROPN-PROPN,det-nmod,compound-nsubj,DT-NNP,NNP-NNP,6,1
12285,11450.0,33,flew,7,4,24,20,3,8,3,17,his,Sweden,,per,DET,PROPN,poss,poss,PRP$,NNP,12,1
12286,11451.0,56,said,5,18,41,23,17,14,-13,36,BHP,Don Argus,org,-,PROPN,PROPN-PROPN,compound,compound-pobj,NNP,NNP-NNP,5,1
12287,11452.0,20,is,7,1,18,17,0,1,6,11,Carlos Alvarez,Miami-Dade County,per-per,-,PROPN-PROPN,PROPN-PROPN,compound-nsubj,compound-pobj,NNP-NNP,NNP-NNP,7,1
12288,12200.0,24,described,6,2,5,3,1,18,4,-1,Carlos Alvarez,Miami-Dade County,per-per,-,PROPN-PROPN,PROPN-PROPN,compound-nsubj,compound-pobj,NNP-NNP,NNP-NNP,4,1
12289,11453.0,38,established,1,5,11,6,4,26,-4,10,School of Economics,SESS,per-per-per,,PROPN-ADP-PROPN,PROPN,pobj-prep-compound,nsubj,NNP-IN-NNP,NNP,4,1
12290,11455.0,25,born,3,1,17,16,0,7,2,14,Christos Stefanopoulos,politician,-,per,PROPN-PROPN,NOUN,compound-nsubjpass,appos,NNP-NNP,NN,5,1
12291,11457.0,15,composed,2,11,13,2,10,1,-9,11,Brunei,his,,org,PROPN,DET,pobj,poss,NNP,PRP$,2,1
12292,11458.0,31,founded,2,1,15,14,0,15,1,13,ICAHD,Jeff Halper,org,-,PROPN,PROPN-PROPN,nsubjpass,compound-nsubj,NNP,NNP-NNP,5,1
12293,11459.0,13,resides,4,4,12,8,3,0,0,8,Sursara,Australia,org,,PROPN,PROPN,nsubj,pobj,NNP,NNP,1,1
12294,11460.0,26,is,4,2,23,21,1,2,2,19,Islamic Azad University,Iran,--,per,PROPN-PROPN-PROPN,PROPN,compound-compound-nsubj,poss,NNP-NNP-NNP,NNP,9,1
12295,11461.0,21,represented,7,3,15,12,2,5,4,8,Norfolk State University,NCAA,org-org-org,,PROPN-PROPN-PROPN,PROPN,compound-compound-dobj,compound,NNP-NNP-NNP,NNP,5,1
12296,11462.0,113,Marriages,3,82,85,3,81,27,-79,82,Robert Evans,Catherine Oxenberg,org-org,-,PROPN-PROPN,PROPN-PROPN,nmod-compound,compound-ROOT,NNP-NNP,NNP-NNP,3,1
12297,11465.0,32,Airline,4,4,4,0,3,27,0,0,Emirates Airline,Emirates,per-per,,PROPN-PROPN,PROPN,compound-ROOT,dobj,NNP-NNP,NNPS,0,1
12298,11467.0,28,elected,12,14,27,13,13,0,-2,15,San Yu,Burma,-,org,PROPN-PROPN,PROPN,compound-dobj,pobj,NNP-NNP,NNP,2,1
12299,11469.0,47,said,42,2,26,24,1,20,40,-16,United States,National League,-,per-per,PROPN-PROPN,PROPN-PROPN,compound-nsubj,compound-appos,NNP-NNP,NNP-NNP,7,1
12300,11470.0,19,occupied,3,7,13,6,6,5,-4,10,Mouchel,West Byfleet,,org-org,PROPN,PROPN-PROPN,compound,compound-pobj,NNP,NNP-NNP,4,1
12301,11473.0,28,is,7,2,6,4,1,21,5,-1,Armed Offenders Squad,AOS,org-org-org,,PROPN-PROPN-PROPN,PROPN,compound-compound-nsubj,appos,NNP-NNPS-NNP,NNP,3,1
12302,11474.0,37,ended,5,15,26,11,14,10,-10,21,Helmet,Chris Traynor,per,-,PROPN,PROPN-PROPN,dobj,compound-conj,NNP,NNP-NNP,4,1
12303,11475.0,29,located,20,10,12,2,9,16,10,-8,University of Tennessee at Martin,Tennessee,org-org-org-org-org,,PROPN-ADP-PROPN-ADP-PROPN,PROPN,pobj-prep-pobj-prep-pobj,pobj,NNP-IN-NNP-IN-NNP,NNP,4,1
12304,11476.0,28,succeeded,1,3,12,9,2,15,-2,11,Margaret Thatcher,Finchley,org-org,,PROPN-PROPN,PROPN,compound-dobj,pobj,NNP-NNP,NNP,4,1
12305,11477.0,19,Doherty,2,2,18,16,1,0,0,16,Denny Doherty,Canada,-,org,PROPN-PROPN,PROPN,compound-ROOT,pobj,NNP-NNP,NNP,5,1
12306,11478.0,16,grew,1,9,14,5,8,1,-8,13,St. Viator High School,Arlington Heights,---,org-org,PROPN-PROPN-PROPN-PROPN,PROPN-PROPN,compound-compound-compound-dobj,compound-pobj,NNP-NNP-NNP-NNP,NNP-NNP,3,1
12307,11482.0,29,University,1,4,26,22,3,2,-3,25,Ho Chi Minh,ity,per-per-per,,PROPN-PROPN-PROPN,NOUN,compound-compound-compound,pobj,NNP-NNP-NNP,NN,-1,1
12308,11483.0,41,2010,3,23,25,2,22,15,-20,22,Republican,Mitch McConnell,,org-org,PROPN,PROPN-PROPN,amod,compound-compound,NNP,NNP-NNP,2,1
12309,11484.0,20,is,2,11,12,1,10,7,-9,10,actor,Johnny Depp,org,-,NOUN,PROPN-PROPN,compound,compound-nsubj,NN,NNP-NNP,1,1
12310,11485.0,35,ordered,3,7,7,0,6,27,-4,4,British Transport Commission,British Rail,--,org-org,PROPN-PROPN-PROPN,PROPN-PROPN,compound-compound-pobj,compound-compound,NNP-NNP-NNP,NNP-NNP,0,1
12311,11488.0,13,goes,1,1,10,9,0,2,0,9,Disney,California,per,,PROPN,PROPN,nsubj,compound,NNP,NNP,2,1
12312,12647.0,19,financed,7,7,18,11,6,0,0,11,Disney,California,,org,PROPN,PROPN,pobj,pobj,NNP,NNP,1,1
12313,11489.0,13,grew,1,5,9,4,4,3,-4,8,San Jose,Yerba Buena High School,org-org,---,PROPN-PROPN,PROPN-PROPN-PROPN-PROPN,compound-compound,compound-compound-compound-dobj,NNP-NNP,NNP-NNP-NNP-NNP,6,1
12314,11491.0,57,involved,41,24,38,14,23,18,17,-3,Massachusetts,B.U.,,org,PROPN,PROPN,compound,compound,NNP,NNP,16,1
12315,11492.0,24,won,4,3,6,3,2,17,1,2,LCHS,PIAA,org,,NOUN,PROPN,compound,compound,NN,NNP,4,1
12316,11493.0,19,Included,0,4,17,13,3,1,-4,17,GT Interactive,Reflections Interactive,-,per-per,PROPN-ADJ,PROPN-PROPN,compound-amod,compound-conj,NNP-JJ,NNPS-NNP,7,1
12317,11495.0,19,was,8,1,14,13,0,4,7,6,Philip Schuyler,New York,-,per-per,PROPN-PROPN,PROPN-PROPN,compound-compound,compound-pobj,NNP-NNP,NNP-NNP,5,1
12318,11496.0,44,remained,13,3,36,33,2,7,10,23,he,Billie Burke,per,-,PRON,PROPN-PROPN,nsubj,compound-appos,PRP,NNP-NNP,5,1
12319,11497.0,122,poured,3,8,12,4,7,109,-5,9,Andreas Papandreou,Greece,org-org,,PROPN-PROPN,PROPN,compound-compound,compound,NNP-NNP,NNP,4,1
12320,11500.0,26,founded,4,1,9,8,0,16,3,5,Whitney High School,1976,org-org-org,,PROPN-PROPN-PROPN,NUM,compound-compound-nsubjpass,nummod,NNP-NNP-NNP,CD,3,1
12321,11502.0,53,resigned,1,39,42,3,38,10,-38,41,40th Wisconsin Volunteer Infantry Regiment,Infantry,----,org,ADJ-PROPN-PROPN-PROPN-PROPN,PROPN,compound-compound-compound-compound-pobj,compound,JJ-NNP-NNP-NNP-NNP,NNP,3,1
12322,11504.0,9,Japan,2,1,3,2,0,5,1,1,Shinya,Japan,,org,PROPN,PROPN,compound,ROOT,NNP,NNP,4,1
12323,11505.0,17,is,3,1,14,13,0,2,2,11,Gilles Bisson,Timmins,-,org,PROPN-PROPN,PROPN,compound-nsubj,compound,NNP-NNP,NNP,4,1
12324,11507.0,26,was,7,13,13,0,12,12,-6,6,Virginia Commonwealth University,Virginia,per-per-per,,PROPN-PROPN-PROPN,PROPN,compound-compound-nsubj,pobj,NNP-NNP-NNP,NNP,0,1
12325,11509.0,26,said,3,2,23,21,1,2,1,20,company,Netherlands,org,,NOUN,PROPN,nsubjpass,appos,NN,NNP,5,1
12326,11510.0,18,created,3,2,12,10,1,5,1,9,program,USA,,per,NOUN,PROPN,nsubjpass,compound,NN,NNP,6,1
12327,11511.0,34,accused,9,7,28,21,6,5,2,19,Gilles Duceppe,Montreal,-,org,PROPN-PROPN,PROPN,compound-nsubjpass,pobj,NNP-NNP,NNP,8,1
12328,11513.0,23,is,4,2,16,14,1,6,2,12,Gibraltar Police,Royal Gibraltar Police,per-per,--,PROPN-PROPN,PROPN-PROPN-PROPN,compound-compound,compound-compound-nsubj,NNP-NNP,NNP-NNP-NNP,10,1
12329,11514.0,28,Grefsen,0,11,21,10,10,6,-11,21,Aker,Oslo,per,,PROPN,PROPN,pobj,pobj,NNP,NNP,3,1
12330,11515.0,24,presented,5,1,3,2,0,20,4,-2,California,William M. Gwin,per,--,PROPN,PROPN-PROPN-PROPN,compound,compound-compound-nsubj,NNP,NNP-NNP-NNP,2,1
12331,11518.0,18,educated,2,6,11,5,5,6,-4,9,Diocesan College,South Africa,per-per,-,PROPN-PROPN,PROPN-PROPN,compound-compound,compound-pobj,NNP-NNP,NNP-NNP,3,1
12332,11520.0,43,confronting,8,4,6,2,3,36,4,-2,Wisconsin,Russ Feingold,,per-per,PROPN,PROPN-PROPN,pobj,compound-nsubj,NNP,NNP-NNP,1,1
12333,11521.0,46,flourishing,13,9,20,11,8,25,4,7,Greece,Konstantinos Tsatsos,,per-per,PROPN,PROPN-PROPN,pobj,compound-nsubj,NNP,NNP-NNP,6,1
12334,11522.0,18,is,6,2,4,2,1,13,4,-2,University of Pennsylvania,Pennsylvania,per-per-per,,PROPN-ADP-PROPN,PROPN,nsubj-prep-compound,pobj,NNP-IN-NNP,NNP,3,1
12335,13264.0,17,List,0,10,12,2,9,4,-10,12,University of Pennsylvania,Pennsylvania,--,per,PROPN-ADP-PROPN,PROPN,pobj-prep-pobj,compound,NNP-IN-NNP,NNP,2,1
12336,11523.0,24,was,5,19,22,3,18,1,-14,17,Bulgaria Air,FB,org-org,,PROPN-PROPN,PROPN,compound-dobj,appos,NNP-NNP,NNP,1,1
12337,11525.0,40,distributes,2,1,1,0,0,38,1,-1,Cisco Press,Cisco Systems,-,per-per,PROPN-PROPN,PROPN-PROPN,compound-nsubj,compound-nsubj,NNP-NNP,NNP-NNP,0,1
12338,11526.0,13,became,6,4,6,2,3,6,2,0,Adam,Singer,per,,PROPN,PROPN,compound,appos,NNP,NNP,1,1
12339,11527.0,22,arrested,3,6,17,11,5,4,-3,14,Paul Wall,Texas,org-org,,PROPN-PROPN,PROPN,compound-pobj,pobj,NNP-NNP,NNP,3,1
12340,11529.0,20,reside,7,5,11,6,4,8,2,4,University,Waterloo,,org,PROPN,PROPN,poss,compound,NNP,NNP,7,1
12341,11530.0,31,contested,3,6,11,5,5,19,-3,8,Indian,Indira Gandhi,org,-,ADJ,PROPN-PROPN,amod,compound-pobj,JJ,NNP-NNP,3,1
12342,11531.0,33,subordinated,19,23,32,9,22,0,-4,13,1st Infantry Division,Bucharest,per-per-per,,PROPN-PROPN-PROPN,PROPN,compound-compound-pobj,pobj,NNP-NNP-NNP,NNP,4,1
12343,11532.0,30,captured,5,10,17,7,9,12,-5,12,Yurii Khmelnytsky,Ukraine,per-per,,PROPN-PROPN,PROPN,compound-dobj,pobj,NNP-NNP,NNP,3,1
12344,11534.0,41,assigns,6,29,40,11,28,0,-23,34,Benito Mussolini,Italy,org-org,,PROPN-PROPN,PROPN,compound-pobj,pobj,NNP-NNP,NNP,8,1
12345,11535.0,41,continued,8,28,32,4,27,8,-20,24,Shin Jung Hwan,Country Kko Kko,per-per-per,--,PROPN-PROPN-PROPN,PROPN-PROPN-PROPN,compound-compound-pobj,pobj-compound-ROOT,NNP-NNP-NNP,NNP-NNP-NNP,6,1
12346,11537.0,32,began,4,10,29,19,9,2,-6,25,Detroit,Natas,,org,PROPN,PROPN,compound,pobj,NNP,NNP,11,1
12347,11538.0,21,said,5,1,4,3,0,16,4,-1,Beckman,Scott Garrett,,per-per,PROPN,PROPN-PROPN,compound,compound-nsubj,NNP,NNP-NNP,2,1
12348,11539.0,42,said,19,13,19,6,12,22,6,0,State University of New York,Albany,----,org,PROPN-PROPN-ADP-PROPN-PROPN,PROPN,compound-pobj-prep-compound-pobj,pobj,NNP-NNP-IN-NNP-NNP,NNP,2,1
12349,11540.0,17,is,3,1,16,15,0,0,2,13,Skyline High School,USA,per-per-per,,PROPN-PROPN-PROPN,PROPN,compound-compound-nsubj,pobj,NNP-NNP-NNP,NNP,3,1
12350,11541.0,14,represented,6,2,9,7,1,4,4,3,Fine,California,org,,PROPN,PROPN,nmod,compound,NNP,NNP,6,1
12351,11542.0,37,owns,15,10,26,16,9,10,5,11,JCE Movies Limited,Willie Chan,--,per-per,PROPN-PROPN-PROPN,PROPN-PROPN,compound-compound-compound,compound-pobj,NNP-NNPS-NNP,NNP-NNP,-1,1
12352,11543.0,45,served,5,13,14,1,12,30,-8,9,COSI Columbus,Columbus,per-per,,PROPN-PROPN,PROPN,pobj-dative,compound,NNP-NNP,NNP,6,1
12353,11544.0,36,is,13,11,13,2,10,22,2,0,University of Glasgow,Glasgow School of Art,--,per-per-per-per,PROPN-ADP-PROPN,PROPN-PROPN-ADP-PROPN,pobj-prep-pobj,compound-dobj-prep-pobj,NNP-IN-NNP,NNP-NNP-IN-NNP,4,1
12354,11545.0,64,prolific,26,31,34,3,30,29,-5,8,Panola College,Carthage,-,org,PROPN-PROPN,PROPN,compound-pobj,compound,NNP-NNP,NNP,2,1
12355,11546.0,29,was,6,3,25,22,2,3,3,19,James C. Dobbin,Navy,org-org-org,,PROPN-PROPN-PROPN,PROPN,compound-compound-nsubj,compound,NNP-NNP-NNP,NNP,10,1
12356,11547.0,24,signed,4,7,20,13,6,3,-3,16,Fat Possum,Andrew Bird,per-per,-,PROPN-PROPN,PROPN-PROPN,compound-compound,compound-appos,NNP-NNP,NNP-NNP,4,1
12357,11548.0,35,called,10,10,29,19,9,5,0,19,Seaga,PNP,,per,PROPN,PROPN,nsubj,pobj,NNP,NNP,4,1
12358,11549.0,24,was,9,1,12,11,0,11,8,3,Jamil Mardam Bey,Syrian,org-org-org,,PROPN-PROPN-PROPN,ADJ,compound-compound-nsubj,amod,NNP-NNP-NNP,JJ,3,1
12359,11552.0,37,said,5,1,4,3,0,32,4,-1,Enbridge,Calgary,per,,PROPN,PROPN,nsubj,compound,NNP,NNP,2,1
12360,11555.0,35,sell,2,21,23,2,20,11,-19,21,Optus,Australia,,org,PROPN,PROPN,conj,pobj,NNP,NNP,6,1
12361,11558.0,18,is,8,1,16,15,0,1,7,8,Eric Mazur,Harvard University,org-org,-,PROPN-PROPN,PROPN-PROPN,compound-nsubj,compound-pobj,NNP-NNP,NNP-NNP,4,1
12362,13760.0,32,developed,15,7,14,7,6,17,8,-1,Eric Mazur,Harvard University,per-per,-,PROPN-PROPN,PROPN-PROPN,compound-pobj,compound-pobj,NNP-NNP,NNP-NNP,4,1
12363,11559.0,132,buried,4,102,104,2,101,27,-98,100,Prime Minister,Menachem Begin,-,per-per,PROPN-PROPN,PROPN-VERB,compound-compound,nsubj-ROOT,NNP-NNP,NNP-VB,8,1
12364,11560.0,48,split,18,16,22,6,15,25,2,4,Paz Estenssoro,MNR,-,per,PROPN-PROPN,PROPN,compound-compound,pobj,NNP-NNP,NNP,7,1
12365,11561.0,20,played,2,9,12,3,8,7,-7,10,Guus Hiddink,Russia national football team,org-org,---,PROPN-PROPN,PROPN-ADJ-NOUN-NOUN,compound-dobj,nmod-amod-compound-dobj,NNP-NNP,NNP-JJ-NN-NN,3,1
12366,11562.0,68,picked,12,40,57,17,39,10,-28,45,?T2,he Czech Republ,per,--,ADV,PRON-PROPN-PROPN,punct,compound-compound-ROOT,RB,PRP-NNP-NNP,-1,1
12367,11563.0,40,saw,3,11,20,9,10,19,-8,17,Germany,Willy Fritsch,per,-,PROPN,PROPN-PROPN,poss,compound-pobj,NNP,NNP-NNP,6,1
12368,11564.0,25,is,6,1,21,20,0,3,5,15,Foreign Language Academy,Kansas City,per-per-per,-,PROPN-PROPN-PROPN,PROPN-PROPN,compound-compound-nsubj,compound-compound,NNP-NNP-NNP,NNP-NNP,7,1
12369,11566.0,21,born,2,16,19,3,15,1,-14,17,Bradfield College,Berkshire,-,org,PROPN-PROPN,PROPN,compound-pobj,compound,NNP-NNP,NNP,2,1
12370,11568.0,23,stopped,12,4,9,5,3,13,8,-3,Pietro Ingrao,Italian,-,org,PROPN-PROPN,ADJ,compound-compound,amod,NNP-NNP,JJ,3,1
12371,11569.0,28,consists,16,4,4,0,3,23,12,-12,Billie Piper,Billie,org-org,,PROPN-PROPN,PROPN,compound-pobj,pobj,NNP-NNP,NNP,0,1
12372,11570.0,42,.,0,12,19,7,11,22,-12,19,he,New York City,per,--,PRON,PROPN-PROPN-PROPN,nsubj,compound-compound-pobj,PRP,NNP-NNP-NNP,5,1
12373,11571.0,24,endorsed,3,17,20,3,16,3,-14,17,Thailand,Chuan Leekpai,per,-,PROPN,PROPN-PROPN,compound,compound-conj,NNP,NNP-NNP,2,1
12374,11573.0,77,is,1,7,21,14,6,55,-6,20,Ozu,Tokyo,per,,PROPN,PROPN,amod,compound,NNP,NNP,6,1
12375,11574.0,25,linked,3,16,22,6,15,2,-13,19,Lake Erie and Western Railroad,1879,per-per-per-per-per,,PROPN-PROPN-CCONJ-PROPN-PROPN,NUM,compound-dobj-cc-compound-conj,pobj,NNP-NNP-CC-NNP-NNP,CD,5,1
12376,11576.0,31,said,10,8,12,4,7,18,2,2,Botswana,Mogae,org,,PROPN,PROPN,compound,nsubj,NNP,NNP,6,1
12377,11577.0,24,founded,3,8,18,10,7,5,-5,15,California,Interwoven,per,,PROPN,PROPN,pobj,poss,NNP,NNP,5,1
12378,11578.0,19,raised,2,10,14,4,9,4,-8,12,Texas,McAllen High School,,org-org-org,PROPN,PROPN-PROPN-PROPN,pobj,compound-compound-pobj,NNP,NNP-NNP-NNP,5,1
12379,11580.0,32,is,16,3,3,0,2,28,13,-13,Saudi Aramco,Saudi Arabian Oil Company,per-per,---,ADJ-PROPN,ADJ-PROPN-PROPN-PROPN,compound-compound,amod-compound-compound-nsubj,JJ-NNP,JJ-NNP-NNP-NNP,0,1
12380,11581.0,25,born,2,1,15,14,0,9,1,13,Manners,New Jersey,per,-,NOUN,PROPN-PROPN,nsubjpass,compound-pobj,NNS,NNP-NNP,6,1
12381,11583.0,30,established,4,1,7,6,0,22,3,3,Houlihan Smith Company,1996,org-org-org,,PROPN-PROPN-PROPN,NUM,compound-compound-nsubjpass,pobj,NNP-NNP-NNP,CD,3,1
12382,11584.0,25,joined,1,1,7,6,0,17,0,6,Peters,Transportation,per,,NOUN,PROPN,nsubj,pobj,NNS,NNP,1,1
12383,11585.0,30,served,3,20,21,1,19,8,-17,18,Commerce,Herbert Hoover,org,-,PROPN,PROPN-PROPN,pobj,compound-conj,NNP,NNP-NNP,1,1
12384,11588.0,13,is,1,1,6,5,0,6,0,5,It,Baltimore County Public Schools,org,---,PRON,PROPN-PROPN-PROPN-PROPN,nsubj,compound-compound-compound-nmod,PRP,NNP-NNP-NNP-NNPS,5,1
12385,11589.0,39,has,28,16,25,9,15,13,12,-3,Nintendo,Game Boy,org,-,PROPN,PROPN-PROPN,compound,compound-compound,NNP,NNP-NNP,7,1
12386,11590.0,28,loaned,8,11,15,4,10,12,-3,7,U.S. Lecce,Serie A,org-org,-,PROPN-PROPN,PROPN-PROPN,compound-pobj,compound-compound,NNP-NNP,NNP-NNP,4,1
12387,11592.0,31,recorded,7,5,16,11,4,14,2,9,2004,Tempo,per,,NUM,PROPN,appos,compound,CD,NNP,5,1
12388,11593.0,33,is,3,10,14,4,9,18,-7,11,National Guard of the United States,United States Army,per-per-per-per-per-per,--,PROPN-PROPN-ADP-DET-PROPN-PROPN,PROPN-PROPN-PROPN,compound-pobj-prep-det-compound-pobj,compound-compound-compound,NNP-NNP-IN-DT-NNP-NNP,NNP-NNP-NNP,2,1
12389,11594.0,42,Accessed,0,4,13,9,3,28,-4,13,2008,Virgin Comics,org,-,NUM,PROPN-PROPN,nummod,compound-attr,CD,NNP-NNP,3,1
12390,11596.0,34,In,0,10,20,10,9,13,-10,20,United States,Phoenix,-,per,PROPN-PROPN,PROPN,compound-pobj,compound,NNP-NNP,NNP,7,1
12391,11597.0,37,composition,2,13,9,-4,12,27,-11,7,London,Trinity College London,,per-per-per,PROPN,PROPN-PROPN-PROPN,pobj,compound-compound-pobj,NNP,NNP-NNP-NNP,3,1
12392,11598.0,29,expected,6,3,3,0,2,25,3,-3,Taiwan Cooperative Bank,Taiwan,org-org-org,,PROPN-PROPN-PROPN,PROPN,compound-compound-nsubjpass,pobj,NNP-NNP-NNP,NNP,0,1
12393,13457.0,19,joined,5,7,7,0,6,11,-2,2,Taiwan Cooperative Bank,Taiwan,--,per,PROPN-PROPN-PROPN,PROPN,compound-compound-compound,poss,NNP-NNP-NNP,NNP,0,1
12394,11599.0,44,is,7,13,17,4,12,26,-6,10,Public Health Agency of Canada,Canada,org-org-org-org-org,,PROPN-PROPN-PROPN-ADP-PROPN,PROPN,compound-compound-pobj-prep-pobj,pobj,NNP-NNP-NNP-IN-NNP,NNP,5,1
12395,11601.0,46,descended,7,6,12,6,5,33,1,5,Thailand,Mahidol Adulyadej,,org-org,PROPN,PROPN-PROPN,pobj,compound-pobj,NNP,NNP-NNP,3,1
12396,11602.0,15,is,5,1,1,0,0,13,4,-4,Eastern Michigan Eagles,Eastern Michigan University,per-per-per,--,PROPN-PROPN-PROPN,PROPN-PROPN-PROPN,compound-compound-compound,compound-compound-pobj,NNP-NNP-NNP,NNP-NNP-NNP,0,1
12397,11603.0,18,represented,7,3,3,0,2,14,4,-4,West Virginia Mountaineers,West Virginia University,per-per-per,--,PROPN-PROPN-PROPN,PROPN-PROPN-PROPN,compound-compound-compound,compound-compound-dobj,NNP-NNP-NNP,NNP-NNP-NNP,0,1
12398,11604.0,40,In,0,9,12,3,8,27,-9,12,Mercedes-Benz,Daimler-Benz,,per,PROPN,PROPN,ROOT,compound,NNP,NNP,2,1
12399,11605.0,22,is,2,2,16,14,1,5,0,14,Don Caballero,Touch,org-org,,PROPN-PROPN,PROPN,compound-pobj,pobj,NNP-NNP,NNP,6,1
12400,11608.0,44,gens,2,7,4,-3,6,39,-5,2,France,de Balzac,per,-,PROPN,ADP-PROPN,pobj,compound-compound,NNP,IN-NNP,4,1
12401,11609.0,42,declared,7,6,12,6,5,29,1,5,Mao Zedong,People's Republic,-,org-org,PROPN-PROPN,PROPN-PROPN,compound-nsubj,compound-pobj,NNP-NNP,NNP-NNP,6,1
12402,11610.0,31,sent,18,2,7,5,1,23,16,-11,England,neck,per,,PROPN,PROPN,compound,appos,NNP,NNP,3,1
12403,11612.0,19,met,8,11,13,2,10,5,-3,5,Prime Minister,Marouf al-Bakhit,org-org,-,PROPN-PROPN,PROPN-PROPN,compound-compound,compound-pobj,NNP-NNP,NNP-NNP,2,1
12404,11614.0,16,became,4,4,10,6,3,5,0,6,he,American,per,,PRON,ADJ,nsubj,amod,PRP,JJ,3,1
12405,11615.0,23,play,15,4,7,3,3,15,11,-8,William Holda,Kilgore College,org-org,-,PROPN-PROPN,PROPN-PROPN,compound-compound,compound-nsubj,NNP-NNP,NNP-NNP,2,1
12406,11617.0,21,dubbed,17,3,8,5,2,12,14,-9,Canada,Prise 2,per,-,PROPN,PROPN-NUM,pobj,pobj-nummod,NNP,NNP-CD,2,1
12407,11618.0,55,is,11,11,31,20,10,23,0,20,DHL,Bonn,org,,PROPN,PROPN,nsubj,pobj,NNP,NNP,-1,1
12408,11619.0,41,McSpadden,4,1,38,37,0,2,3,34,Markus Schulz,Coldharbour Recordings,org-org,-,PROPN-PROPN,PROPN-PROPN,compound-compound,compound-compound,NNP-NNP,NNP-NNPS,6,1
12409,11621.0,31,decided,8,17,21,4,16,9,-9,13,Sydney,Chifley University,org,-,PROPN,PROPN-PROPN,poss,compound-appos,NNP,NNP-NNP,3,1
12410,11622.0,17,OH,1,1,13,12,0,3,0,12,Cleveland,Case Western Reserve University,per,---,PROPN,PROPN-PROPN-PROPN-PROPN,compound,compound-compound-compound-ROOT,NNP,NNP-NNP-NNP-NNP,3,1
12411,11623.0,51,places,8,32,35,3,31,15,-24,27,Herod Antipas,Herodias,-,per,PROPN-PROPN,PROPN,compound-pobj,conj,NNP-NNP,NNP,2,1
12412,11624.0,82,was,12,4,16,12,3,65,8,4,Lane,musician,per,,PROPN,ADJ,nsubj,amod,NNP,JJ,3,1
12413,11626.0,38,Barcelona,0,7,16,9,6,21,-7,16,Juan Antonio Samaranch,Spain,--,per,PROPN-PROPN-PROPN,PROPN,compound-compound-nsubjpass,pobj,NNP-NNP-NNP,NNP,3,1
12414,11627.0,21,sold,2,11,19,8,10,1,-9,17,VSEL,Cammell Laird,per,-,PROPN,PROPN-PROPN,compound,compound-appos,NNP,NNP-NNP,5,1
12415,11629.0,12,became,4,3,7,4,2,4,1,3,Mike Lee,United States,per-per,-,PROPN-PROPN,PROPN-PROPN,compound-nsubj,compound-compound,NNP-NNP,NNP-NNP,3,1
12416,11630.0,15,pitted,2,7,10,3,6,4,-5,8,Rod Grams,Minnesota,org-org,,PROPN-PROPN,PROPN,compound-dobj,compound,NNP-NNP,NNP,3,1
12417,11631.0,18,died,6,5,14,9,4,3,1,8,Richard Halliday,Mary Martin,org-org,-,PROPN-PROPN,PROPN-PROPN,compound-appos,compound-appos,NNP-NNP,NNP-NNP,5,1
12418,11632.0,27,was,5,14,19,5,13,7,-9,14,Cuba,Alicia Alonso,per,-,PROPN,PROPN-PROPN,pobj,compound-nsubj,NNP,NNP-NNP,3,1
12419,11633.0,35,focused,1,23,25,2,22,9,-22,24,Political-Military Affairs,Mark Kimmitt,-,per-per,PROPN-PROPN,PROPN-PROPN,amod-pobj,compound-nsubj,NNP-NNPS,NNP-NNP,1,1
12420,11634.0,15,is,5,1,12,11,0,2,4,7,Lavasa,built,per,,PROPN,VERB,nsubj,ccomp,NNP,VBN,6,1
12421,11635.0,47,continued,7,24,26,2,23,20,-17,19,Electric Factory,Philadelphia,-,per,PROPN-PROPN,PROPN,compound-compound,pobj,NNP-NNP,NNP,4,1
12422,11636.0,35,said,27,9,27,18,8,7,18,0,me,Florida,per,,PRON,PROPN,nsubj,pobj,PRP,NNP,8,1
12423,11637.0,40,is,5,14,22,8,13,17,-9,17,Erik Santos,Star Records,-,org-org,PROPN-PROPN,PROPN-PROPN,compound-pobj,compound-pobj,NNP-NNP,NNP-NNPS,5,1
12424,11638.0,20,made,3,11,17,6,10,2,-8,14,Australia,University of Adelaide,org,--,PROPN,PROPN-ADP-PROPN,pobj,conj-prep-pobj,NNP,NNP-IN-NNP,3,1
12425,11639.0,15,attended,1,3,10,7,2,4,-2,9,Miami Carol City High School,Florida,----,per,PROPN-PROPN-PROPN-PROPN-PROPN,PROPN,compound-compound-compound-compound-dobj,pobj,NNP-NNP-NNP-NNP-NNP,NNP,4,1
12426,11640.0,23,started,18,8,17,9,7,5,10,-1,Kowloon-Canton Railway,MTR,org-org,,PROPN-PROPN,PROPN,compound-pobj,pobj,NNP-NNP,NNP,6,1
12427,11641.0,36,renamed,29,31,35,4,30,0,-2,6,Brown University,1764,org-org,,PROPN-PROPN,NUM,compound-oprd,pobj,NNP-NNP,CD,3,1
12428,11642.0,37,said,35,17,26,9,16,10,18,-9,Pakistan,Asif Ali Zardari,org,--,PROPN,PROPN-PROPN-PROPN,compound,compound-compound-nsubjpass,NNP,NNP-NNP-NNP,10,1
12429,11644.0,13,merged,4,7,11,4,6,1,-3,7,UFC,Zuffa LLC,per,-,PROPN,PROPN-PROPN,pobj,compound-pobj,NNP,NNP-NNP,1,1
12430,12884.0,22,serves,2,9,20,11,8,1,-7,18,UFC,Zuffa LLC,,org-org,PROPN,PROPN-PROPN,pobj,compound-dobj,NNP,NNP-NNP,4,1
12431,11646.0,21,assembling,4,10,14,4,9,6,-6,10,NetJets,Berkshire Hathaway,per,-,PROPN,PROPN-PROPN,pobj,compound-pobj,NNP,NNP-NNP,3,1
12432,11647.0,25,is,3,1,18,17,0,6,2,15,Guadeloupe,Saint-John Perse,,per-per,PROPN,PROPN-PROPN,poss,pobj-ROOT,NNP,NNP-NNP,10,1
12433,11648.0,12,founded,5,4,7,3,3,4,1,2,Adam Moore,Springbox,-,per,PROPN-PROPN,PROPN,compound-conj,dobj,NNP-NNP,NNP,3,1
12434,11649.0,21,is,2,1,13,12,0,7,1,11,Karl Blau,Washington,per-per,,PROPN-PROPN,PROPN,compound-nsubj,pobj,NNP-NNP,NNP,6,1
12435,11650.0,36,helped,2,22,25,3,21,10,-20,23,Warren Buffett,Berkshire Hathaway,org-org,-,PROPN-PROPN,PROPN-PROPN,compound-poss,compound-nsubj,NNP-NNP,NNP-NNP,1,1
12436,13882.0,25,receive,6,1,4,3,0,20,5,-2,Warren Buffett,Berkshire Hathaway,-,per-per,PROPN-PROPN,PROPN-PROPN,compound-poss,compound-nsubj,NNP-NNP,NNP-NNP,1,1
12437,11651.0,39,III,3,3,13,10,2,25,0,10,George III of the United Kingdom,William,per-per-per-per-per-per,,PROPN-PROPN-ADP-DET-PROPN-PROPN,PROPN,compound-ROOT-prep-det-compound-compound,compound,NNP-NNP-IN-DT-NNP-NNP,NNP,2,1
12438,11653.0,19,picked,2,10,13,3,9,5,-8,11,Gary Hart,Colorado,-,org,PROPN-PROPN,PROPN,compound-pobj,compound,NNP-NNP,NNP,3,1
12439,11654.0,38,co-wrote,1,13,37,24,12,0,-12,36,Soil,Texas,,org,PROPN,PROPN,compound,pobj,NNP,NNP,9,1
12440,11656.0,20,replaced,8,3,3,0,2,16,5,-5,New Zealand,New Zealand Transport Agency,org-org,---,PROPN-PROPN,PROPN-PROPN-PROPN-PROPN,compound-nsubjpass,compound-compound-compound-pobj,NNP-NNP,NNP-NNP-NNP-NNP,0,1
12441,11657.0,18,won,2,7,12,5,6,5,-5,10,Mastella,Justice,per,,PROPN,PROPN,nsubjpass,pobj,NNP,NNP,3,1
12442,11658.0,35,founded,2,12,21,9,11,13,-10,19,Dallin,Bristol,per,,PROPN,PROPN,conj,pobj,NNP,NNP,3,1
12443,11659.0,55,scrolled,4,48,51,3,47,3,-44,47,Lucille Ball,Desi Arnaz,org-org,-,PROPN-PROPN,PROPN-PROPN,compound-conj,compound-conj,NNP-NNP,NNP-NNP,1,1
12444,11660.0,27,included,5,4,20,16,3,6,1,15,Atlantic,Lupe Fiasco,per,-,PROPN,PROPN-PROPN,pobj,compound-compound,NNP,NNP-NNP,5,1
12445,11663.0,45,is,13,10,12,2,9,32,3,-1,Policy,CEPMLP,,per,PROPN,PROPN,conj,appos,NNP,NNP,2,1
12446,11665.0,40,were,17,30,39,9,29,0,-13,22,Wilfred,England,org,,PROPN,PROPN,pobj,pobj,NNP,NNP,4,1
12447,11666.0,12,are,4,1,7,6,0,4,3,3,Kansas,Pat Roberts,,org-org,PROPN,PROPN-PROPN,poss,compound-attr,NNP,NNP-NNP,4,1
12448,12855.0,40,sensitive,8,30,36,6,29,3,-22,28,Kansas,Pat Roberts,,org-org,PROPN,PROPN-PROPN,poss,compound-conj,NNP,NNP-NNP,4,1
12449,13402.0,43,said,8,5,7,2,4,35,3,-1,Kansas,Pat Roberts,per,-,PROPN,PROPN-PROPN,compound,compound-nsubj,NNP,NNP-NNP,1,1
12450,11667.0,50,usurped,40,11,14,3,10,35,29,-26,Arthur Mutambara,MDC,-,per,PROPN-PROPN,PROPN,compound-pobj,nsubj,NNP-NNP,NNP,3,1
12451,11668.0,33,be,15,7,12,5,6,20,8,-3,Beijing,Bank of China,,per-per-per,PROPN,PROPN-ADP-PROPN,nmod,pobj-prep-pobj,NNP,NNP-IN-NNP,4,1
12452,11672.0,40,was,11,1,27,26,0,12,10,16,Ted de Corsia,gangster,per-per-per,,PROPN-PROPN-PROPN,NOUN,compound-nmod-nsubj,nsubj,NNP-NNP-NNP,NN,4,1
12453,11673.0,15,was,3,3,12,9,2,2,0,9,he,President,,org,PRON,PROPN,nsubj,conj,PRP,NNP,4,1
12454,11675.0,61,proposed,4,1,9,8,0,51,3,5,Boston University Academy,1993,org-org-org,,PROPN-PROPN-PROPN,NUM,compound-compound-nsubjpass,pobj,NNP-NNP-NNP,CD,4,1
12455,11677.0,13,Knights,2,1,3,2,0,9,1,1,Holy Cross,Knights,per-per,,PROPN-PROPN,PROPN,compound-compound,ROOT,NNP-NNP,NNPS,2,1
12456,11678.0,40,decided,3,7,22,15,6,17,-4,19,Thailand,Kukrit,,per,PROPN,PROPN,dobj,nsubjpass,NNP,NNP,4,1
12457,11679.0,17,biopic,1,8,11,3,7,5,-7,10,Joy Division,Ian Curtis,org-org,-,PROPN-PROPN,PROPN-PROPN,compound-compound,compound-pobj,NNP-NNP,NNP-NNP,2,1
12458,11680.0,46,dropped,5,2,29,27,1,16,3,24,Mizo National Front,1961,--,org,PROPN-PROPN-PROPN,NUM,compound-compound-pobj,nummod,NNP-NNP-NNP,CD,4,1
12459,11681.0,21,made,1,1,18,17,0,2,0,17,He,Australia,,org,PRON,PROPN,nsubj,pobj,PRP,NNP,2,1
12460,11682.0,35,transferred,3,8,13,5,7,21,-5,10,Winston Churchill,British,per-per,,PROPN-PROPN,PROPN,compound-pobj,compound,NNP-NNP,NNP,6,1
12461,11683.0,31,holds,1,1,21,20,0,9,0,20,Tapout,Grand Terrace,per,-,PROPN,PROPN-PROPN,nsubj,compound-pobj,NNP,NNP-NNP,8,1
12462,11684.0,16,is,2,1,5,4,0,10,1,3,Perceval Press,Viggo Mortensen,-,per-per,PROPN-PROPN,PROPN-PROPN,compound-nsubj,compound-poss,NNP-NNP,NNP-NNP,5,1
12463,11685.0,30,began,3,1,6,5,0,23,2,3,Schroders,1804,,per,NOUN,NUM,poss,pobj,NNS,CD,5,1
12464,11686.0,16,Light,3,6,13,7,5,2,-3,10,Martin Scorsese,United States,per-per,-,PROPN-PROPN,PROPN-PROPN,compound-pobj,compound-appos,NNP-NNP,NNP-NNP,5,1
12465,11688.0,15,became,2,1,6,5,0,8,1,4,Hastings Banda,MCP,per-per,,PROPN-PROPN,PROPN,compound-nsubj,compound,NNP-NNP,NNP,2,1
12466,11690.0,31,is,9,1,17,16,0,13,8,8,St. Thomas Aquinas Catholic Secondary School,Ontario,-----,per,PROPN-PROPN-PROPN-PROPN-PROPN-PROPN,PROPN,compound-compound-compound-compound-compound-nsubj,pobj,NNP-NNP-NNP-NNP-NNP-NNP,NNP,4,1
12467,11691.0,13,graduated,2,5,10,5,4,2,-3,8,Crane School of Music,Potsdam,per-per-per-per,,PROPN-PROPN-ADP-PROPN,PROPN,compound-pobj-prep-pobj,compound,NNP-NNP-IN-NNP,NNP,5,1
12468,11692.0,24,were,17,1,6,5,0,17,16,-11,Chen Yuan,CDB,-,org,PROPN-PROPN,PROPN,compound-compound,compound,NNP-NNP,NNP,5,1
12469,11693.0,13,released,8,2,8,6,1,4,6,0,Europe,Tempest,,org,PROPN,PROPN,nsubj,pobj,NNP,NNP,1,1
12470,11694.0,19,signed,5,2,8,6,1,10,3,3,The Cortinas,Step Forward,-,org-org,DET-PROPN,PROPN-PROPN,det-nsubj,compound-compound,DT-NNP,NNP-NNP,5,1
12471,11696.0,23,is,9,2,2,0,1,20,7,-7,Norfolk and Norwich University Hospitals,Norfolk,per-per-per-per-per,,PROPN-CCONJ-PROPN-PROPN-PROPN,PROPN,nmod-cc-compound-conj-compound,compound,NNP-CC-NNP-NNP-NNPS,NNP,0,1
12472,11698.0,25,appears,1,6,23,17,5,1,-5,22,VMware,Mendel Rosenblum,per,-,PROPN,PROPN-PROPN,pobj,compound-conj,NNP,NNP-NNP,5,1
12473,11699.0,38,At,0,18,25,7,17,12,-18,25,Morales,Bolivia,,org,PROPN,PROPN,nsubj,nsubj,NNPS,NNP,5,1
12474,13407.0,25,born,2,1,17,16,0,7,1,15,Morales,Bolivia,per,,NOUN,PROPN,nsubjpass,poss,NNS,NNP,6,1
12475,11700.0,22,is,6,2,2,0,1,19,4,-4,Bahrain,Bahrain national football team,,org-org-org-org,PROPN,PROPN-ADJ-NOUN-NOUN,pobj,nmod-amod-compound-dobj,NNP,NNP-JJ-NN-NN,0,1
12476,11704.0,17,told,5,11,15,4,10,1,-6,10,Bushido,Aggro Berlin,per,-,PROPN,PROPN-PROPN,nsubj,compound-dobj,NNP,NNP-NNP,2,1
12477,11706.0,32,was,3,13,1,-12,12,30,-10,-2,Keith Moon,The Who,org-org,-,PROPN-PROPN,DET-PRON,compound-nsubj,det-nsubj,NNP-NNP,DT-WP,4,1
12478,11707.0,39,inactivated,20,9,30,21,8,8,11,10,United States,58th Special Operations Wing,per-per,---,PROPN-PROPN,ADJ-PROPN-PROPN-PROPN,compound-compound,amod-compound-compound-nsubj,NNP-NNP,JJ-NNP-NNPS-NNP,10,1
12479,11708.0,25,is,9,2,14,12,1,10,7,5,Saint Petersburg State University of Engineering and Economics,Russia,per-per-per-per-per-per-per-per,,PROPN-PROPN-PROPN-PROPN-ADP-PROPN-CCONJ-PROPN,PROPN,nmod-compound-compound-nsubj-prep-pobj-cc-conj,pobj,NNP-NNP-NNP-NNP-IN-NNP-CC-NNP,NNP,4,1
12480,11709.0,14,born,3,1,7,6,0,6,2,4,Marc Antoine,France,-,per,PROPN-PROPN,PROPN,compound-nsubjpass,pobj,NNP-NNP,NNP,2,1
12481,11710.0,65,Khan,4,3,29,26,2,35,1,25,Liaquat Ali Khan,woman fig,--,per-per,PROPN-PROPN-PROPN,NOUN-NOUN,compound-compound-ROOT,compound-compound,NNP-NNP-NNP,NN-NN,-1,1
12482,11711.0,25,scheduled,4,13,14,1,12,10,-9,10,Russian,Yuri Malenchenko,,per-per,PROPN,PROPN-PROPN,compound,compound-dobj,NNP,NNP-NNP,1,1
12483,11712.0,37,3,0,3,6,3,2,30,-3,6,Daniel Arap Moi,Kenya,org-org-org,,PROPN-PROPN-PROPN,PROPN,compound-compound-compound,poss,NNP-NNP-NNP,NNP,2,1
12484,11713.0,49,broadcast,3,31,39,8,30,9,-28,36,Rhodesia,Ian Smith,org,-,PROPN,PROPN-PROPN,conj,compound-poss,NNP,NNP-NNP,5,1
12485,14211.0,43,Hancock,6,20,39,19,19,3,-14,33,Rhodesia,Ian Smith,,org-org,PROPN,PROPN-PROPN,poss,compound-pobj,NNP,NNP-NNP,8,1
12486,11714.0,35,lectures,1,1,5,4,0,29,0,4,He,Berlin,per,,PRON,PROPN,nsubj,compound,PRP,NNP,2,1
12487,11715.0,23,transferred,9,7,12,5,6,10,2,3,Cruxshadows,Dancing Ferret Discs,per,--,PROPN,PROPN-PROPN-PROPN,compound,compound-compound-pobj,NNPS,NNP-NNP-NNPS,4,1
12488,11717.0,28,chosen,18,10,17,7,9,10,8,-1,Archbishop Edmund Grindal,school,org-org-org,,PROPN-PROPN-PROPN,NOUN,compound-compound-appos,pobj,NNP-NNP-NNP,NN,11,1
12489,11720.0,95,File,0,49,52,3,48,42,-49,52,Gustave Courbet,Artist,-,per,PROPN-PROPN,PROPN,compound-acl,poss,NNP-NNP,NNP,3,1
12490,11723.0,25,is,8,7,1,-6,6,23,1,-7,ICSM,Imperial College London,,per-per-per,PROPN,PROPN-PROPN-PROPN,appos,compound-compound-pobj,NNP,NNP-NNP-NNP,2,1
12491,11725.0,31,is,14,22,26,4,21,4,-8,12,her,Canadian,,per,DET,ADJ,poss,amod,PRP$,JJ,4,1
12492,11727.0,12,is,1,7,11,4,6,0,-6,10,Northern Film School,Leeds,per-per-per,,PROPN-PROPN-PROPN,PROPN,compound-compound-pobj,pobj,NNP-NNP-NNP,NNP,5,1
12493,11728.0,24,is,10,6,23,17,5,0,4,13,DLSU-D,Cavite,,org,PROPN,PROPN,amod,pobj,NNP,NNP,8,1
12494,11729.0,44,filed,9,5,9,4,4,34,4,0,Sandoz,Novartis,per,,PROPN,PROPN,compound,pobj,NNP,NNP,2,1
12495,11730.0,26,is,3,1,14,13,0,11,2,11,Calvin Coolidge,Massachusetts,per-per,,PROPN-PROPN,PROPN,compound-compound,pobj,NNP-NNP,NNP,8,1
12496,11731.0,24,worked,1,4,11,7,3,12,-3,10,Mexico,Emilio,per,,PROPN,PROPN,pobj,appos,NNP,NNP,5,1
12497,11733.0,37,studied,1,1,28,27,0,8,0,27,He,Royal Navy,,org-org,PRON,PROPN-PROPN,nsubj,compound-pobj,PRP,NNP-NNP,5,1
12498,11735.0,44,U.S.,2,1,11,10,0,32,1,9,DHL,Germany,per,,PROPN,PROPN,compound,poss,NNP,NNP,6,1
12499,11737.0,25,appointed,11,10,19,9,9,5,1,8,Kohlrausch,University of,per,-,PROPN,PROPN-ADP,pobj,pobj-prep,NNP,NNP-IN,11,1
12500,11738.0,13,operating,2,1,11,10,0,1,1,9,Flydubai,Dubai,,per,NOUN,PROPN,nsubj,compound,NN,NNP,5,1
12501,11739.0,13,merged,6,5,5,0,4,7,1,-1,Continental Airlines,Continental Micronesia,per-per,-,PROPN-PROPN,PROPN-PROPN,compound-nsubj,compound-pobj,NNP-NNPS,NNP-NNP,0,1
12502,11741.0,17,born,2,1,15,14,0,1,1,13,He,Venezuela,,org,PRON,PROPN,nsubjpass,pobj,PRP,NNP,2,1
12503,11743.0,32,built,3,8,11,3,7,20,-5,8,Focke-Wulf,Germany,per,,PROPN,PROPN,pobj,pobj,NNP,NNP,4,1
12504,11744.0,40,comprise,32,11,15,4,10,24,21,-17,Coach,Jonathan Coachman,,per-per,PROPN,PROPN-PROPN,compound,compound-pobj,NNP,NNP-NNP,3,1
12505,11745.0,12,owned,2,6,6,0,5,5,-4,4,Illinois Railway Museum,Illinois,--,org,PROPN-PROPN-PROPN,PROPN,compound-compound-pobj,pobj,NNP-NNP-NNP,NNP,0,1
12506,11746.0,23,Linenthal,3,8,14,6,7,8,-5,11,Arcadia Publishing,Mount Pleasant,-,org-org,PROPN-PROPN,PROPN-PROPN,compound-ROOT,compound-compound,NNP-NNP,NNP-NNP,3,1
12507,11747.0,10,are,3,8,9,1,7,0,-5,6,Sibelco,Belgium,per,,PROPN,PROPN,compound,pobj,NNP,NNP,4,1
12508,11748.0,35,said,10,12,16,4,11,18,-2,6,Bruce Rockowitz,Li Fung,org-org,-,PROPN-PROPN,PROPN-PROPN,compound-compound,compound-pobj,NNP-NNP,NNP-NNP,3,1
12509,11749.0,29,attended,7,4,9,5,3,19,3,2,Charlotte,Mallard Creek High School,,per-per-per-per,PROPN,PROPN-PROPN-PROPN-PROPN,compound,compound-compound-compound-dobj,NNP,NNP-NNP-NNP-NNP,6,1
12510,11750.0,27,born,2,11,16,5,10,10,-9,14,Birmingham,his,per,,PROPN,DET,compound,poss,NNP,PRP$,7,1
12511,11751.0,17,is,1,9,13,4,8,3,-8,12,Sweden,Kikki Danielsson,per,-,PROPN,PROPN-PROPN,pobj,compound-pobj,NNP,NNP-NNP,3,1
12512,11752.0,14,displayed,1,1,10,9,0,3,0,9,Waterhouse,Royal Academy,per,-,NOUN,PROPN-PROPN,nsubj,compound-pobj,NN,NNP-NNP,4,1
12513,11753.0,21,regarded,4,16,19,3,15,1,-12,15,Parliament,Zurab Zhvania,org,-,PROPN,PROPN-PROPN,pobj,compound-pobj,NNP,NNP-NNP,1,1
12514,11756.0,13,is,4,2,11,9,1,1,2,7,Scottish Building Society,Edinburgh,--,per,PROPN-PROPN-PROPN,PROPN,compound-compound-nsubj,compound,NNP-NNP-NNP,NNP,6,1
12515,11757.0,32,Takaful,2,5,20,15,4,11,-3,18,Malaysia,Bank Negara Malaysia,,per-per-per,PROPN,PROPN-PROPN-PROPN,appos,compound-compound-pobj,NNP,NNP-NNP-NNP,-1,1
12516,11758.0,29,named,10,5,8,3,4,20,5,-2,Wesleyan University,1831,org-org,,PROPN-PROPN,NUM,compound-pobj,pobj,NNP-NNP,CD,5,1
12517,11760.0,18,founded,3,6,17,11,5,0,-3,14,1897,University,per,,NUM,PROPN,pobj,pobj,CD,NNP,2,1
12518,11762.0,59,said,21,20,49,29,19,9,1,28,Ban Ki-moon,United Nations,org-org,-,PROPN-PROPN,PROPN-PROPN,compound-pobj,compound-pobj,NNP-NNP,NNP-NNP,-1,1
12519,11764.0,21,born,3,1,15,14,0,5,2,12,Humayun Ahmed,Bangladesh,per-per,,PROPN-PROPN,PROPN,compound-nsubjpass,attr,NNP-NNP,NNP,4,1
12520,11766.0,34,is,23,2,29,27,1,4,21,6,University of Science and Technology Beijing,niversit,per-per-per-per-per-per,,PROPN-ADP-PROPN-CCONJ-PROPN-PROPN,NOUN,nmod-prep-pobj-cc-conj-nsubj,compound,NNP-IN-NNP-CC-NNP-NNP,NN,5,1
12521,11767.0,19,declared,13,7,12,5,6,6,6,-1,Mozambique,Samora Machel,per,-,PROPN,PROPN-PROPN,pobj,compound-pobj,NNP,NNP-NNP,7,1
12522,11768.0,17,brought,1,1,16,15,0,0,0,15,He,Texas,org,,PRON,PROPN,nsubj,pobj,PRP,NNP,3,1
12523,11769.0,24,tied,3,6,8,2,5,15,-3,5,Cedar Rapids,Washington High School,org-org,--,PROPN-PROPN,PROPN-PROPN-PROPN,compound-compound,compound-compound-pobj,NNP-NNP,NNP-NNP-NNP,2,1
12524,11770.0,33,-,3,1,6,5,0,26,2,3,Shanda,China,,org,PROPN,PROPN,compound,ROOT,NNP,NNP,5,1
12525,11772.0,22,were,2,11,20,9,10,1,-9,18,Bing Crosby,Dixie Lee,per-per,-,PROPN-PROPN,PROPN-PROPN,compound-appos,compound-appos,NNP-NNP,NNP-NNP,8,1
12526,11774.0,38,seems,1,16,25,9,15,12,-15,24,E Street Band,Clemons,org-org-org,,PROPN-PROPN-PROPN,PROPN,compound-compound-pobj,poss,NNP-NNP-NNP,NNPS,12,1
12527,11775.0,30,said,7,1,4,3,0,25,6,-3,General Motors,GM Daewoo,-,org-org,PROPN-PROPN,PROPN-PROPN,compound-compound,compound-compound,NNP-NNPS,NNP-NNP,3,1
12528,11777.0,43,continued,1,12,41,29,11,1,-11,40,Marilyn Manson,Nothing Records,per-per,-,PROPN-PROPN,PROPN-PROPN,compound-pobj,compound-appos,NNP-NNP,NNP-NNPS,11,1
12529,11780.0,42,Carman,3,21,26,5,20,15,-18,23,Santa Ana High School,California,per-per-per-per,,PROPN-PROPN-PROPN-PROPN,PROPN,compound-compound-compound-pobj,pobj,NNP-NNP-NNP-NNP,NNP,2,1
12530,11781.0,22,is,7,7,21,14,6,0,0,14,BCGS,India,per,,PROPN,PROPN,nsubj,pobj,NNP,NNP,7,1
12531,11782.0,21,is,3,1,1,0,0,19,2,-2,Toowoomba Preparatory School,Toowoomba,per-per-per,,PROPN-PROPN-PROPN,PROPN,compound-compound-nsubj,compound,NNP-NNP-NNP,NNP,0,1
12532,11784.0,33,said,31,4,19,15,3,13,27,-12,India,Aishwarya Rai,per,-,PROPN,PROPN-PROPN,pobj,compound-poss,NNP,NNP-NNP,6,1
12533,11785.0,41,was,1,32,34,2,31,6,-31,33,Northern Ireland,Terence O'Neill,org-org,-,PROPN-PROPN,PROPN-NOUN,compound-pobj,compound-appos,NNP-NNP,NNP-NN,5,1
12534,11786.0,41,dropped,12,6,12,6,5,28,6,0,Chavez,Venezuela,org,,PROPN,PROPN,pobj,pobj,NNP,NNP,2,1
12535,13640.0,42,think,3,21,28,7,20,13,-18,25,Chavez,Venezuela,org,,PROPN,PROPN,nsubj,poss,NNP,NNP,3,1
12536,11788.0,22,serving,12,4,4,0,3,17,8,-8,Hong Kong Baptist Hospital,Hong Kong,per-per-per-per,-,PROPN-PROPN-PROPN-PROPN,PROPN-PROPN,compound-compound-compound-pobj,compound-compound,NNP-NNP-NNP-NNP,NNP-NNP,0,1
12537,11789.0,31,came,8,1,8,7,0,22,7,0,His,Germany,,per,DET,PROPN,poss,pobj,PRP$,NNP,1,1
12538,11791.0,18,worked,11,6,8,2,5,9,5,-3,Ohio,Kent State University,,per-per-per,PROPN,PROPN-PROPN-PROPN,poss,compound-compound-compound,NNP,NNP-NNP-NNP,3,1
12539,11793.0,37,is,3,29,6,-23,28,30,-26,3,SWPP,British Professional Photographic Associates,,per-per-per-per,PROPN,PROPN-PROPN-PROPN-PROPN,appos,compound-compound-compound-conj,NNP,NNP-NNP-NNP-NNPS,11,1
12540,11794.0,24,formed,7,2,9,7,1,14,5,2,1995,Fremont-Elizabeth City High School,,org-org-org-org,NUM,PROPN-PROPN-PROPN-PROPN,nummod,amod-compound-compound-dobj,CD,NNP-NNP-NNP-NNP,5,1
12541,11795.0,22,comes,10,10,18,8,9,3,0,8,Anchorage,Murkowski,,per,PROPN,PROPN,pobj,pobj,NNP,NNP,7,1
12542,11796.0,28,is,3,10,16,6,9,11,-7,13,Delaware,University of Delaware,,org-org-org,PROPN,PROPN-ADP-PROPN,pobj,poss-prep-pobj,NNP,NNP-IN-NNP,5,1
12543,11797.0,49,was,1,10,29,19,9,19,-9,28,Def Jam,Scarface,per-per,,PROPN-PROPN,PROPN,compound-dobj,pobj,NNP-NNP,NNP,6,1
12544,11798.0,17,graduated,1,4,16,12,3,0,-3,15,Terrebonne High School,Louisiana,--,per,PROPN-PROPN-PROPN,PROPN,compound-compound-pobj,pobj,NNP-NNP-NNP,NNP,4,1
12545,11799.0,46,have,1,26,34,8,25,11,-25,33,Florida,Reno,per,,PROPN,PROPN,compound,pobj,NNP,NNP,4,1
12546,11800.0,41,ketika,1,4,11,7,3,29,-3,10,Indonesia,dan teguh,org,-,PROPN,VERB-ADJ,compound,compound-dobj,NNP,VBD-JJ,4,1
12547,11802.0,10,baptised,2,1,9,8,0,0,1,7,He,Reading,,org,PRON,PROPN,nsubjpass,pobj,PRP,NNP,5,1
12548,11804.0,41,is,9,35,38,3,34,2,-26,29,Joseph Fourier,France,per-per,,PROPN-PROPN,PROPN,compound-compound,compound,NNP-NNP,NNP,3,1
12549,11805.0,31,changed,3,8,12,4,7,18,-5,9,Benelli,Pesaro,per,,PROPN,PROPN,compound,pobj,NNP,NNP,3,1
12550,11806.0,17,is,1,12,15,3,11,1,-11,14,Nightmare Records,Lance King,org-org,-,PROPN-PROPN,PROPN-PROPN,compound-compound,compound-pobj,NNP-NNPS,NNP-NNP,4,1
12551,11807.0,11,attended,3,5,10,5,4,0,-2,7,Flagler College,Florida,org-org,,PROPN-PROPN,PROPN,compound-dobj,pobj,NNP-NNP,NNP,2,1
12552,11808.0,48,enjoy,6,3,10,7,2,37,3,4,Cuban,Padura,,org,ADJ,PROPN,amod,nsubj,JJ,NNP,2,1
12553,11811.0,42,picketed,1,4,7,3,3,34,-3,6,Larry Flynt,Hustler,-,per,PROPN-PROPN,PROPN,compound-poss,compound,NNP-NNP,NNP,1,1
12554,11812.0,28,receive,13,9,26,17,8,1,4,13,Kim Hyun Joong,Japan,per-per-per,,PROPN-PROPN-PROPN,PROPN,compound-compound-nsubj,compound,NNP-NNP-NNP,NNP,8,1
12555,11813.0,17,born,2,8,13,5,7,3,-6,11,Mesa,Red Mountain High School,per,---,PROPN,PROPN-PROPN-PROPN-PROPN,compound,compound-compound-compound-dobj,NNP,NNP-NNP-NNP-NNP,3,1
12556,11814.0,17,*,0,8,13,5,7,3,-8,13,Renault,France,,org,PROPN,PROPN,dobj,pobj,NNP,NNP,5,1
12557,11815.0,15,sponsors,5,1,13,12,0,1,4,8,New England Pest Control,Rhode Island,org-org-org-org,-,PROPN-PROPN-PROPN-PROPN,PROPN-PROPN,compound-compound-compound-nsubj,compound-pobj,NNP-NNP-NNP-NNP,NNP-NNP,4,1
12558,11816.0,118,USA,1,26,1,-25,25,116,-25,0,American Coach Lines,Coach America,per-per-per,-,PROPN-PROPN-PROPN,PROPN-PROPN,compound-compound-compound,compound-pobj,NNP-NNP-NNP,NNP-NNP,4,1
12559,11817.0,14,attended,1,1,13,12,0,0,0,12,He,Nashville,org,,PRON,PROPN,nsubj,pobj,PRP,NNP,1,1
12560,11819.0,13,began,1,8,12,4,7,0,-7,11,Deus,1989,per,,PROPN,NUM,dobj,pobj,NNP,CD,5,1
12561,11820.0,17,took,6,6,12,6,5,4,0,6,Kana,Japan,per,,PROPN,PROPN,conj,compound,NNP,NNP,2,1
12562,11823.0,21,signed,5,8,16,8,7,4,-3,11,Polydor Records,Eric Clapton,-,per-per,PROPN-PROPN,PROPN-PROPN,compound-pobj,compound-pobj,NNP-NNPS,NNP-NNP,5,1
12563,11824.0,13,signed,5,4,11,7,3,1,1,6,Dire Straits,Phonogram,org-org,,PROPN-PROPN,PROPN,compound-nsubj,compound,NNP-NNPS,NNP,4,1
12564,11825.0,12,opened,1,5,10,5,4,1,-4,9,Australia,Jason Donovan,org,-,PROPN,PROPN-PROPN,pobj,compound-dobj,NNP,NNP-NNP,3,1
12565,11828.0,28,returned,1,12,14,2,11,13,-11,13,Prime Minister,Lee Kuan Yew,-,org-org-org,PROPN-PROPN,PROPN-PROPN-PROPN,compound-compound,compound-compound-compound,NNP-NNP,NNP-NNP-NNP,2,1
12566,14250.0,25,is,7,3,5,2,2,19,4,-2,Prime Minister,Lee Kuan Yew,org-org,--,PROPN-PROPN,PROPN-PROPN-PROPN,compound-compound,compound-compound-nsubj,NNP-NNP,NNP-NNP-NNP,3,1
12567,11829.0,64,Some,0,5,35,30,4,28,-5,35,Cheung Kong Holdings,Hutchison Whampoa,--,per-per,PROPN-PROPN-PROPN,PROPN-PROPN,compound-compound-poss,compound-pobj,NNP-NNP-NNP,NNP-NNP,6,1
12568,11830.0,50,regarded,17,13,25,12,12,24,4,8,Ernesto Zedillo,Institutional Revolutionary Party,-,per-per-per,PROPN-PROPN,PROPN-PROPN-PROPN,compound-poss,compound-compound-poss,NNP-NNP,NNP-NNP-NNP,10,1
12569,11832.0,29,received,1,9,14,5,8,14,-8,13,Wilfrid Laurier University,Ontario,--,per,PROPN-PROPN-PROPN,PROPN,compound-compound-pobj,pobj,NNP-NNP-NNP,NNP,7,1
12570,11833.0,42,became,1,6,9,3,5,32,-5,8,Princeton University,New Jersey,org-org,-,PROPN-PROPN,PROPN-PROPN,compound-pobj,compound-pobj,NNP-NNP,NNP-NNP,2,1
12571,11834.0,29,parted,4,1,28,27,0,0,3,24,Klayton,Celldweller,,per,PROPN,PROPN,nsubj,pobj,NNP,NNP,4,1
12572,11835.0,35,counterattacked,11,6,17,11,5,17,5,6,Popular Movement,Simone Veil,org-org,-,PROPN-PROPN,PROPN-PROPN,compound-pobj,compound-nsubj,NNP-NNP,NNP-NNP,9,1
12573,11836.0,17,began,12,8,11,3,7,5,4,-1,Lin Biao,Cultural Revolution,org-org,-,PROPN-PROPN,PROPN-PROPN,compound-pobj,compound-nsubj,NNP-NNP,NNP-NNP,1,1
12574,11837.0,32,represents,5,8,17,9,7,14,-3,12,University of Richmond,NCAA,org-org-org,,PROPN-ADP-PROPN,PROPN,dobj-prep-pobj,nmod,NNP-IN-NNP,NNP,2,1
12575,11839.0,46,compete,1,1,13,12,0,32,0,12,They,NCAA,,org,PRON,PROPN,nsubj,nmod,PRP,NNP,1,1
12576,11840.0,15,joined,3,5,13,8,4,1,-2,10,VMware,Edouard Bugnion,org,-,PROPN,PROPN-PROPN,dobj,compound-conj,NNP,NNP-NNP,5,1
12577,11842.0,55,become,23,48,52,4,47,2,-25,29,Evo Morales,MAS,per-per,,PROPN-PROPN,PROPN,compound-pobj,nmod,NNP-NNPS,NNP,2,1
12578,11843.0,28,was,1,8,17,9,7,10,-7,16,United States,Jewel,per-per,,PROPN-PROPN,PROPN,compound-poss,appos,NNP-NNP,NNP,4,1
12579,11844.0,37,Chalabi,3,1,13,12,0,23,2,10,Iraq,Iraqi National Congress,,per-per-per,PROPN,PROPN-PROPN-PROPN,poss,compound-compound-nsubj,NNP,NNP-NNP-NNP,6,1
12580,11845.0,32,built,3,12,30,18,11,1,-9,27,Central California Traction,Stockton California,org-org-org,-,PROPN-PROPN-PROPN,PROPN-PROPN,compound-compound-compound,compound-pobj,NNP-NNP-NNP,NNP-NNP,7,1
12581,11846.0,33,disclosed,8,1,28,27,0,4,7,20,Martinez,Florida,,per,PROPN,PROPN,nsubj,pobj,NNP,NNP,9,1
12582,11850.0,27,regained,3,1,6,5,0,20,2,3,Manchester United,Premier League,-,org-org,PROPN-PROPN,PROPN-PROPN,compound-nsubj,compound-dobj,NNP-NNP,NNP-NNP,2,1
12583,11851.0,34,were,11,11,14,3,10,19,0,3,Yugoslavia,PGP-RTB,per,,PROPN,NOUN,pobj,attr,NNP,NN,2,1
12584,11852.0,34,were,19,7,18,11,6,15,12,-1,Bangko Sentral ng Pilipinas,Philippines,---,per,PROPN-PROPN-ADP-PROPN,PROPN,compound-compound-compound-pobj,pobj,NNP-NNP-IN-NNP,NNPS,5,1
12585,11856.0,30,left,3,2,11,9,1,18,1,8,Larry Norman,Capitol,per-per,,PROPN-PROPN,PROPN,compound-nsubj,nsubj,NNP-NNP,NNP,4,1
12586,11857.0,24,earned,10,8,18,10,7,5,2,8,Regence,Oregon,,org,PROPN,PROPN,nmod,pobj,NNP,NNP,5,1
12587,11858.0,43,returned,2,1,8,7,0,34,1,6,Winston,Australia,per,,PROPN,PROPN,nsubj,poss,NNP,NNP,6,1
12588,11859.0,30,Desperate,0,10,21,11,9,8,-10,21,Bobby Byrd,King,org-org,,PROPN-PROPN,PROPN,compound-oprd,compound,NNP-NNP,NNP,6,1
12589,11860.0,19,been,10,8,17,9,7,1,2,7,Obiang,Equatorial Guinea,org,-,PROPN,PROPN-PROPN,conj,compound-pobj,NNP,NNP-NNP,6,1
12590,11863.0,35,launched,23,8,10,2,7,24,15,-13,Fritt Ord,Foundation,-,per,PROPN-PROPN,PROPN,compound-compound,pobj,NNP-NNP,NNP,2,1
12591,11864.0,47,succeeded,41,23,45,22,22,1,18,4,Argentina,de San,,per-per,PROPN,PROPN-PROPN,appos,compound-pobj,NNP,NNP-NNP,5,1
12592,11865.0,32,said,27,5,6,1,4,25,22,-21,State,John Negroponte,per,-,PROPN,PROPN-PROPN,pobj,compound-nsubj,NNP,NNP-NNP,1,1
12593,11867.0,20,chose,7,4,4,0,3,15,3,-3,San Diego State College,San Diego State University,org-org-org-org,---,PROPN-PROPN-PROPN-PROPN,PROPN-PROPN-PROPN-PROPN,compound-compound-compound-dobj,compound-compound-compound-appos,NNP-NNP-NNP-NNP,NNP-NNP-NNP-NNP,0,1
12594,11868.0,26,invited,10,7,25,18,6,0,3,15,Codelco,Chile,per,,PROPN,PROPN,pobj,pobj,NNP,NNP,4,1
12595,11870.0,35,was,1,7,26,19,6,8,-6,25,Quebec,Pierre-Marc Johnson,,org-org,PROPN,PROPN-PROPN,pobj,compound-compound,NNP,NNP-NNP,8,1
12596,11871.0,26,features,3,1,22,21,0,3,2,19,The Script,Ireland,per-per,,DET-PROPN,PROPN,det-pobj,pobj,DT-NNP,NNP,8,1
12597,11873.0,15,encouraged,7,3,11,8,2,3,4,4,Henrik Pontoppidan,Danish,-,org,PROPN-PROPN,ADJ,compound-dobj,compound,NNP-NNP,JJ,3,1
12598,11874.0,11,was,1,1,6,5,0,4,0,5,Bonaparte,Navy,,per,PROPN,PROPN,nsubj,pobj,NNP,NNP,2,1
12599,11876.0,40,is,25,6,11,5,5,28,19,-14,Judith Malina,Julian Beck,-,per-per,PROPN-PROPN,PROPN-PROPN,compound-pobj,compound-appos,NNP-NNP,NNP-NNP,2,1
12600,11877.0,31,included,3,5,24,19,4,6,-2,21,William D. Coleman,United States,org-org-org,-,PROPN-PROPN-PROPN,PROPN-PROPN,compound-compound-dobj,compound-pobj,NNP-NNP-NNP,NNP-NNP,8,1
12601,14061.0,34,include,6,8,27,19,7,6,-2,21,William D. Coleman,United States,--,per-per,PROPN-PROPN-PROPN,PROPN-PROPN,compound-compound-dobj,compound-pobj,NNP-NNP-NNP,NNP-NNP,8,1
12602,11883.0,24,disputes,16,13,16,3,12,7,3,0,University of Oulu,Finland,per-per-per,,PROPN-ADP-PROPN,PROPN,pobj-prep-compound,pobj,NNP-IN-NNP,NNP,2,1
12603,11884.0,41,challenged,15,18,4,-14,17,36,-3,-11,Arlen Specter,Republican,per-per,,PROPN-PROPN,ADJ,compound-dobj,amod,NNP-NNP,JJ,5,1
12604,11885.0,74,slated,2,34,49,15,33,24,-32,47,England,Davey Boy Smith,,per-per-per,PROPN,PROPN-PROPN-PROPN,dobj,compound-compound-conj,NNP,NNP-NNP-NNP,9,1
12605,11886.0,21,attended,14,8,14,6,7,6,6,0,Georgia,Thomson,org,,PROPN,PROPN,compound,pobj,NNP,NNP,5,1
12606,11887.0,21,made,4,18,19,1,17,1,-14,15,director,Simon Wincer,,per-per,NOUN,PROPN-PROPN,compound,compound-pobj,NN,NNP-NNP,1,1
12607,11889.0,44,self-proclaimed,1,16,27,11,15,16,-15,26,Generation Investment Management,2004,per-per-per,,PROPN-PROPN-PROPN,NUM,compound-compound-compound,pobj,NNP-NNP-NNP,CD,5,1
12608,11890.0,26,has,2,2,10,8,1,15,0,8,university,Beirut,,org,NOUN,PROPN,nsubj,pobj,NN,NNP,3,1
12609,11891.0,25,created,3,17,20,3,16,4,-14,17,Sean Combs,New York City,per-per,--,PROPN-PROPN,PROPN-PROPN-PROPN,compound-poss,compound-compound-compound,NNP-NNPS,NNP-NNP-NNP,4,1
12610,11892.0,25,married,8,11,14,3,10,10,-3,6,York Wilson,Toronto,-,org,PROPN-PROPN,PROPN,compound-dobj,pobj,NNP-NNP,NNP,2,1
12611,11893.0,28,trading,3,9,27,18,8,0,-6,24,Antonio Di Pietro,Italy,org-org-org,,PROPN-PROPN-PROPN,PROPN,compound-compound-pobj,pobj,NNP-NNP-NNP,NNP,12,1
12612,11894.0,42,awarded,5,4,15,11,3,26,1,10,Richmond,Division I,org,-,PROPN,PROPN-PRON,appos,compound-compound,NNP,NNP-PRP,5,1
12613,11896.0,35,appeared,4,3,34,31,2,0,1,30,Pat Boone,Florida,per-per,,PROPN-PROPN,PROPN,compound-nsubj,pobj,NNP-NNP,NNP,2,1
12614,11897.0,22,was,4,2,21,19,1,0,2,17,Fred Meyer,Oregon,per-per,,PROPN-PROPN,PROPN,compound-compound,pobj,NNP-NNP,NNP,3,1
12615,11898.0,22,entered,4,4,19,15,3,2,0,15,she,USA,org,,PRON,PROPN,nsubj,conj,PRP,NNP,1,1
12616,11899.0,44,was,11,1,14,13,0,29,10,3,Robert Augustus Toombs,American,per-per-per,,PROPN-PROPN-PROPN,ADJ,compound-compound-nsubj,amod,NNP-NNP-NNP,JJ,6,1
12617,11900.0,21,Commission,2,2,7,5,1,13,0,5,Independent Commission Against Corruption,ICAC,per-per-per-per,,PROPN-PROPN-ADP-PROPN,PROPN,compound-ROOT-prep-pobj,appos,NNP-NNP-IN-NNP,NNP,1,1
12618,11901.0,25,Bachelet,0,1,10,9,0,14,-1,10,Bachelet,Health,org,,PROPN,PROPN,ROOT,compound,NNP,NNP,6,1
12619,11902.0,39,is,1,12,30,18,11,8,-11,29,Office of Science and Technology Policy,United States,-----,per-per,PROPN-ADP-PROPN-CCONJ-PROPN-PROPN,PROPN-PROPN,pobj-prep-pobj-cc-conj-conj,compound-pobj,NNP-IN-NNP-CC-NNP-NNP,NNP-NNP,9,1
12620,11904.0,63,owned,3,11,52,41,10,10,-8,49,Movie Central,Corus Entertainment,-,per-per,PROPN-PROPN,PROPN-PROPN,compound-poss,compound-conj,NNP-NNP,NNP-NNP,6,1
12621,11905.0,20,studied,8,12,18,6,11,1,-4,10,Los Angeles,Charles Lloyd,per-per,-,PROPN-PROPN,PROPN-PROPN,compound-pobj,compound-pobj,NNP-NNP,NNP-NNP,5,1
12622,11906.0,36,born,2,14,14,0,13,21,-12,12,Belmont High School,Belmont,per-per-per,,PROPN-PROPN-PROPN,PROPN,compound-compound-pobj,poss,NNP-NNP-NNP,NNP,0,1
12623,11908.0,29,situated,4,21,26,5,20,2,-17,22,Asian Institute of Technology,Thailand,org-org-org-org,,PROPN-PROPN-ADP-PROPN,PROPN,compound-pobj-prep-pobj,compound,NNP-NNP-IN-NNP,NNP,3,1
12624,11909.0,29,is,11,1,5,4,0,23,10,-6,Consumer Reports,Consumers Union,per-per,-,PROPN-NOUN,PROPN-PROPN,compound-nsubj,compound-pobj,NNP-NNS,NNPS-NNP,3,1
12625,11911.0,29,toyed,11,1,20,19,0,8,10,9,Baldwin,Worcestershire,org,,VERB,PROPN,nsubj,compound,VB,NNP,7,1
12626,11913.0,30,established,13,19,26,7,18,3,-6,13,University of Wisconsin-Madison,Madison,per-per-per,,PROPN-ADP-PROPN,PROPN,pobj-prep-amod,compound,NNP-IN-NNP,NNP,7,1
12627,11914.0,30,made,1,19,29,10,18,0,-18,28,Global TV,Indonesian,-,per,PROPN-PROPN,PROPN,compound-pobj,pobj,NNP-NNP,NNP,4,1
12628,11915.0,27,was,1,6,11,5,5,15,-5,10,Pagan,North Melbourne,per,-,PROPN,PROPN-PROPN,pobj,compound-pobj,NNP,NNP-NNP,3,1
12629,11916.0,27,met,1,3,9,6,2,17,-2,8,The Dawn,Afterimage,-,org,DET-PROPN,PROPN,det-dobj,pobj,DT-NNP,NNP,3,1
12630,11917.0,44,Singh,1,7,21,14,6,22,-6,20,Democratic Action Party,Manoharan,per-per-per,,PROPN-PROPN-PROPN,PROPN,nmod-nmod-nmod,pobj,NNP-NNP-NNP,NNP,-1,1
12631,11918.0,25,sold,2,1,18,17,0,6,1,16,Tranz Scenic,West Coast Railway,per-per,--,PROPN-ADJ,PROPN-PROPN-PROPN,compound-pobj,compound-compound-appos,NNP-JJ,NNP-NNP-NNP,6,1
12632,11920.0,21,beat,1,12,15,3,11,5,-11,14,Andrea Iannone,Italy,-,per,PROPN-PROPN,PROPN,compound-conj,pobj,NNP-NNP,NNP,3,1
12633,11921.0,75,0-7432-9423-8,1,29,70,41,28,4,-28,69,KDP,Nechervan Barzani,per,-,PROPN,PROPN-PROPN,compound,compound-nsubj,NNP,NNP-NNP,10,1
12634,11922.0,25,composed,1,1,23,22,0,1,0,22,Cline,Virginia Hensley,,per-per,NOUN,PROPN-PROPN,nsubj,compound-appos,NN,NNP-NNP,5,1
12635,11923.0,27,saw,5,7,9,2,6,17,-2,4,Middlesbrough,Steve Gibson,,org-org,PROPN,PROPN-PROPN,compound,compound-nsubj,NNP,NNP-NNP,1,1
12636,11924.0,10,is,2,1,9,8,0,0,1,7,Martha Shoffner,Arkansas,org-org,,PROPN-PROPN,PROPN,compound-nsubj,pobj,NNP-NNP,NNP,2,1
12637,11925.0,21,signed,2,1,11,10,0,9,1,9,The Breakers,Wicked Cool Records,per-per,--,DET-PROPN,PROPN-PROPN-PROPN,det-nsubj,compound-compound-nsubj,DT-NNPS,NNP-NNP-NNPS,5,1
12638,11927.0,19,is,2,1,11,10,0,7,1,9,Strathallan School,Scotland,per-per,,PROPN-PROPN,PROPN,compound-nsubj,pobj,NNP-NNP,NNP,3,1
12639,11930.0,22,said,4,10,16,6,9,5,-6,12,Karachi,Zardari,,org,PROPN,PROPN,pobj,pobj,NNP,NNP,1,1
12640,11931.0,48,used,15,38,39,1,37,8,-23,24,Eastern Air Defense Force,Air Defense Command,per-per-per-per,--,PROPN-PROPN-PROPN-PROPN,PROPN-PROPN-PROPN,compound-compound-compound-compound,compound-compound-pobj,NNP-NNP-NNP-NNP,NNP-NNP-NNP,1,1
12641,11933.0,22,Celio,0,1,20,19,0,1,-1,20,Celio,Saint-Ouen,,per,PROPN,PROPN,ROOT,compound,NNP,NNP,7,1
12642,11934.0,15,led,3,7,8,1,6,6,-4,5,Southern,California High School,per,--,PROPN,PROPN-PROPN-PROPN,compound,compound-compound-compound,NNP,NNP-NNP-NNP,3,1
12643,11935.0,16,displayed,4,8,15,7,7,0,-4,11,Green Howards,England,per-per,,PROPN-PROPN,PROPN,compound-compound,pobj,NNP-NNPS,NNP,4,1
12644,11936.0,27,represented,11,6,25,19,5,1,5,14,Chile,Manuel Balmaceda,org,-,PROPN,PROPN-PROPN,pobj,compound-pobj,NNP,NNP-NNP,10,1
12645,11937.0,23,married,6,8,13,5,7,9,-2,7,Peter Morton,Hard Rock Cafe,per-per,--,PROPN-PROPN,PROPN-PROPN-PROPN,compound-compound,compound-compound-compound,NNP-NNP,NNP-NNP-NNP,5,1
12646,11938.0,8,Named,2,1,4,3,0,3,1,2,Raul Castro,Cuba,per-per,,PROPN-PROPN,PROPN,compound-nsubj,poss,NNP-NNP,NNP,2,1
12647,11939.0,37,said,32,15,15,0,14,21,17,-17,Volkswagen Group of America,Volkswagen of America,per-per-per-per,--,PROPN-PROPN-ADP-PROPN,PROPN-ADP-PROPN,compound-pobj-prep-pobj,nmod-prep-pobj,NNP-NNP-IN-NNP,NNP-IN-NNP,0,1
12648,11942.0,25,became,4,17,23,6,16,1,-13,19,Defence,Boris Tadi?,org,-,PROPN,PROPN-PUNCT,compound,conj-npadvmod,NNP,NNP-'',1,1
12649,11943.0,21,said,18,9,11,2,8,9,9,-7,Prime Minister,Silvio Berlusconi,-,per-per,PROPN-PROPN,PROPN-PROPN,compound-compound,compound-poss,NNP-NNP,NNP-NNP,1,1
12650,11944.0,59,met,2,18,28,10,17,30,-16,26,Oscar Arias,Costa Rica,-,per-per,PROPN-PROPN,PROPN-PROPN,compound-pobj,compound-pobj,NNP-NNP,NNP-NNP,8,1
12651,11945.0,22,discovered,2,7,13,6,6,8,-5,11,Sue Carol,Alan Ladd,per-per,-,PROPN-PROPN,PROPN-PROPN,compound-appos,compound-pobj,NNP-NNP,NNP-NNP,3,1
12652,11947.0,20,is,6,4,12,8,3,7,2,6,Columbia National Guard,United States,org-org-org,-,PROPN-PROPN-PROPN,PROPN-PROPN,compound-compound-pobj,compound-compound,NNP-NNP-NNP,NNP-NNP,6,1
12653,11948.0,23,spent,9,16,19,3,15,3,-7,10,Dorset,The Thomas Hardye School,,per-per-per-per,PROPN,DET-PROPN-PROPN-PROPN,compound,det-compound-compound-pobj,NNP,DT-NNP-NNP-NNP,5,1
12654,11949.0,17,started,12,3,8,5,2,8,9,-4,university,2005,,per,NOUN,NUM,nsubj,nummod,NN,CD,3,1
12655,11950.0,24,established,3,1,8,7,0,15,2,5,Tsubakimoto Chain,Setsuzo Tsubakimoto,per-per,-,PROPN-PROPN,PROPN-PROPN,compound-nsubjpass,compound-pobj,NNP-NNP,NNP-NNP,3,1
12656,11952.0,37,was,2,26,33,7,25,3,-24,31,William Denison,Van Diemen's Land,per-per,--,PROPN-PROPN,PROPN-PROPN-PROPN,compound-pobj,compound-compound-pobj,NNP-NNP,NNP-NNP-NNP,5,1
12657,11953.0,37,gilded,4,25,26,1,24,10,-21,22,actress,Amanda Bynes,per,-,NOUN,PROPN-PROPN,compound,compound-compound,NN,NNP-NNP,3,1
12658,11954.0,23,was,2,5,9,4,4,13,-3,7,Azad Hind,Indian National Army,per-per,--,PROPN-PROPN,PROPN-PROPN-PROPN,compound-compound,compound-compound-nmod,NNP-NNP,NNP-NNP-NNP,4,1
12659,11955.0,43,contested,3,17,3,-14,16,39,-14,0,Theo Epstein,Sox,-,per,PROPN-PROPN,PROPN,compound-nsubj,poss,NNP-NNP,NNPS,3,1
12660,11957.0,18,refused,9,3,8,5,2,9,6,-1,Federal Energy Regulatory Commission,FERC,per-per-per-per,,PROPN-PROPN-PROPN-PROPN,PROPN,compound-compound-compound-nsubj,appos,NNP-NNP-NNP-NNP,NNP,3,1
12661,12897.0,29,regulated,3,14,19,5,13,9,-11,16,Federal Energy Regulatory Commission,FERC,per-per-per-per,,PROPN-PROPN-PROPN-PROPN,PROPN,compound-compound-compound-conj,appos,NNP-NNP-NNP-NNP,NNP,2,1
12662,11958.0,29,taught,4,21,23,2,20,5,-17,19,Jadavpur University,India,org-org,,PROPN-PROPN,PROPN,compound-compound,pobj,NNP-NNP,NNP,5,1
12663,11960.0,25,found,10,5,9,4,4,15,5,-1,Keynote Systems,California,per-per,,PROPN-PROPN,PROPN,compound-compound,pobj,NNP-NNP,NNP,3,1
12664,11961.0,33,had,1,14,24,10,13,8,-13,23,Aaliyah,United States,,per-per,PROPN,PROPN-PROPN,dobj,compound-pobj,NNP,NNP-NNP,6,1
12665,11963.0,32,learned,3,6,18,12,5,13,-3,15,Dewey Robertson,Hamilton,per-per,,PROPN-PROPN,PROPN,compound-nsubj,pobj,NNP-NNP,NNP,3,1
12666,11964.0,14,is,2,2,7,5,1,6,0,5,school,Letchworth,,per,NOUN,PROPN,nsubj,compound,NN,NNP,4,1
12667,11965.0,18,said,9,14,16,2,13,1,-5,7,Miami-Dade County,Carlos Alvarez,-,per-per,PROPN-PROPN,PROPN-PROPN,compound-compound,compound-pobj,NNP-NNP,NNP-NNP,2,1
12668,11966.0,30,served,1,1,22,21,0,7,0,21,He,Idaho,,per,PRON,PROPN,nsubj,poss,PRP,NNP,7,1
12669,11968.0,24,sold,19,3,11,8,2,12,16,-8,Tim Schafer,Fine,org-org,,PROPN-PROPN,ADJ,compound-compound,amod,NNP-NNP,JJ,7,1
12670,11969.0,43,said,8,6,8,2,5,34,2,0,Detroit,Levin,org,,PROPN,PROPN,pobj,nsubj,NNP,NNP,1,1
12671,11970.0,35,formed,1,21,27,6,20,7,-20,26,Jedi Mind Tricks,Stoupe the Enemy of Mankind,per-per-per,----,PROPN-PROPN-PROPN,PROPN-DET-PROPN-ADP-PROPN,compound-compound-poss,appos-det-appos-prep-pobj,NNP-NNP-NNPS,NNP-DT-NNP-IN-NNP,-1,1
12672,11972.0,16,stated,6,1,4,3,0,11,5,-2,Aftermath,Dawaun Parker,per,-,PROPN,PROPN-PROPN,compound,compound-nsubj,NNP,NNP-NNP,2,1
12673,11973.0,23,travelled,6,3,5,2,2,17,3,-1,Foreign Affairs,Ben Bot,per-per,-,PROPN-PROPN,PROPN-PROPN,compound-pobj,compound-appos,NNP-NNPS,NNP-NNP,3,1
12674,12746.0,30,opened,5,18,20,2,17,9,-13,15,Foreign Affairs,Ben Bot,-,org-org,PROPN-PROPN,PROPN-PROPN,compound-pobj,compound-ROOT,NNP-NNPS,NNP-NNP,3,1
12675,11975.0,28,was,10,1,23,22,0,4,9,13,Juan Bautista,Venezuela,per-per,,PROPN-PROPN,PROPN,compound-nsubj,pobj,NNP-NNP,NNP,4,1
12676,11976.0,17,played,1,13,15,2,12,1,-12,14,Division,Lincoln,per,,PROPN,PROPN,compound,compound,NNP,NNP,1,1
12677,11977.0,24,released,3,3,21,18,2,2,0,18,he,Toto,per,,PRON,PROPN,nsubj,compound,PRP,NNP,5,1
12678,11978.0,26,is,3,8,23,15,7,2,-5,20,Rosita Vai,New Zealand,per-per,-,PROPN-PROPN,PROPN-PROPN,compound-pobj,compound-compound,NNP-NNP,NNP-NNP,8,1
12679,11980.0,27,hosted,3,9,14,5,8,12,-6,11,d ?eljko Joksimov,the Belgr,per-per-per,-,NOUN-NOUN-VERB,DET-PROPN,amod-punct-ROOT,det-compound,NN-NN-VB,DT-NNP,-1,1
12680,11981.0,36,granted,10,9,15,6,8,20,1,5,Empire,Benito Mussolini,org,-,PROPN,PROPN-PROPN,pobj,compound-pobj,NNP,NNP-NNP,3,1
12681,11982.0,62,operates,6,2,2,0,1,59,4,-4,Plainview-Old Bethpage Central School District,Plainview-Old Bethpage,----,org-org,NOUN-PROPN-PROPN-PROPN-PROPN,NOUN-PROPN,compound-compound-compound-compound-nsubj,compound-compound,NN-NNP-NNP-NNP-NNP,NN-NNP,0,1
12682,11983.0,15,opened,2,4,10,6,3,4,-2,8,his,Maryland,,org,DET,PROPN,poss,pobj,PRP$,NNP,2,1
12683,11984.0,23,transferred,4,8,10,2,7,12,-4,6,North Carolina,Air National Guard,-,per-per-per,PROPN-PROPN,PROPN-PROPN-PROPN,compound-compound,compound-compound-pobj,NNP-NNP,NNP-NNP-NNP,2,1
12684,11985.0,20,is,2,8,11,3,7,8,-6,9,Berry,Chess,org,,PROPN,PROPN,poss,compound,NNP,NNP,2,1
12685,11987.0,41,Metro,2,2,17,15,1,23,0,15,Kolkata Metro,stem ser,org-org,-,PROPN-PROPN,NOUN-NOUN,compound-ROOT,compound-attr,NNP-NNP,NN-NN,2,1
12686,11989.0,34,moved,6,9,30,21,8,3,-3,24,Rochester,his,per,,PROPN,DET,compound,poss,NNP,PRP$,6,1
12687,11990.0,16,based,6,5,10,5,4,5,1,4,Namesys,California,per,,PROPN,PROPN,pobj,pobj,NNP,NNP,2,1
12688,11991.0,15,band,1,5,13,8,4,1,-4,12,Chicago,Maurice White,,per-per,PROPN,PROPN-PROPN,compound,compound-pobj,NNP,NNP-NNP,5,1
12689,11997.0,26,is,2,1,20,19,0,5,1,18,Hydrofunk Records,Resin Dogs,-,org-org,PROPN-PROPN,PROPN-PROPN,compound-nsubj,compound-pobj,NNP-NNPS,NNP-NNP,8,1
12690,11998.0,26,is,2,1,2,1,0,23,1,0,Westfield Group,Sydney,org-org,,PROPN-PROPN,PROPN,compound-pobj,compound,NNP-NNP,NNP,1,1
12691,12001.0,38,heard,16,9,28,19,8,9,7,12,Eric Peterson,Testament,per-per,,PROPN-PROPN,PROPN,compound-poss,poss,NNP-NNP,NNP,13,1
12692,12002.0,24,was,2,11,13,2,10,10,-9,11,Italy,Simone Corsi,,per-per,PROPN,PROPN-PROPN,poss,compound-pobj,NNP,NNP-NNP,2,1
12693,12003.0,21,has,1,1,7,6,0,13,0,6,Nicole,Tom Cruise,per,-,PROPN,PROPN-PROPN,nsubj,compound-compound,NNP,NNP-NNP,4,1
12694,12005.0,18,broadcasted,2,8,9,1,7,8,-6,7,TVM,Malta,,per,PROPN,PROPN,compound,poss,NNP,NNP,1,1
12695,12006.0,63,demand,6,19,31,12,18,31,-13,25,India,K. J. Yesudas,org,--,PROPN,PROPN-PROPN-PROPN,poss,compound-compound-compound,NNP,NNP-NNP-NNP,9,1
12696,12008.0,21,practiced,8,6,20,14,5,0,2,12,Coolidge,Northampton,,per,PROPN,PROPN,nsubj,pobj,NNP,NNP,5,1
12697,12010.0,20,Result,0,4,11,7,3,8,-4,11,Super 14,Crusaders,-,per,PROPN-NUM,PROPN,nmod-nummod,pobj,NNP-CD,NNPS,6,1
12698,12011.0,24,include,8,12,11,-1,11,12,-4,3,Tank Corps,2nd Guards Tank Corps,-,org-org-org-org,PROPN-PROPN,PROPN-PROPN-PROPN-PROPN,compound-compound,compound-compound-compound-dobj,NNP-NNP,NNP-NNP-NNP-NNP,1,1
12699,12012.0,39,said,7,27,36,9,26,2,-20,29,Brandon,Assiniboine Community College,,per-per-per,PROPN,PROPN-PROPN-PROPN,compound,compound-compound-pobj,NNP,NNP-NNP-NNP,7,1
12700,12013.0,31,holds,2,11,27,16,10,3,-9,25,Singapore,ST Engineering,org,-,PROPN,PROPN-PROPN,compound,compound-pobj,NNP,NNP-NNP,11,1
12701,12015.0,26,was,11,1,18,17,0,7,10,7,Muzito,Prime Minister,org,-,VERB,PROPN-PROPN,nsubj,compound-compound,VBN,NNP-NNP,7,1
12702,12016.0,23,proclaimed,18,17,21,4,16,1,1,3,Stepan Shahumyan,Baku,-,per,PROPN-PROPN,PROPN,compound-pobj,compound,NNP-NNP,NNP,6,1
12703,13398.0,10,moved,6,5,9,4,4,0,1,3,Stepan Shahumyan,Baku,per-per,,PROPN-PROPN,PROPN,compound-nsubj,pobj,NNP-NNP,NNP,2,1
12704,12017.0,37,birthday,7,15,24,9,14,12,-8,17,Depeche Mode,Wilder,-,org,PROPN-PROPN,PROPN,compound-pobj,pobj,NNP-NNP,NNP,4,1
12705,12018.0,40,Witherspoon,6,19,28,9,18,11,-13,22,Texas Christian University,Fort Worth,per-per-per,-,PROPN-PROPN-PROPN,PROPN-PROPN,compound-compound-compound,compound-appos,NNP-NNP-NNP,NNP-NNP,8,1
12706,12019.0,30,scored,3,10,27,17,9,2,-7,24,Brazil,volleyball World Cup,org,--,PROPN,NOUN-PROPN-PROPN,pobj,compound-compound-pobj,NNP,NN-NNP-NNP,10,1
12707,12020.0,47,joined,38,37,35,-2,36,11,1,-3,Kurtis Mantronik,Mantronix,-,per,PROPN-PROPN,PROPN,compound-pobj,dobj,NNP-NNP,NNP,2,1
12708,12021.0,37,headlined,5,20,29,9,19,7,-15,24,Hank Azaria,L.A.,per-per,,PROPN-PROPN,PROPN,compound-nsubj,pobj,NNP-NNP,NNP,5,1
12709,12022.0,24,is,5,7,13,6,6,10,-2,8,Jeff Merkley,Oregon House,-,per-per,PROPN-PROPN,PROPN-PROPN,compound-attr,compound-pobj,NNP-NNP,NNP-NNP,3,1
12710,12023.0,56,captured,6,16,33,17,15,22,-10,27,Australia,Neil Mann,,per-per,PROPN,PROPN-PROPN,nsubj,compound-ROOT,NNP,NNP-NNP,9,1
12711,12024.0,20,had,3,13,17,4,12,2,-10,14,Argentina,Gustavo Cerati,per,-,PROPN,PROPN-PROPN,conj,compound-appos,NNP,NNP-NNP,1,1
12712,12025.0,48,Conte,1,27,23,-4,26,24,-26,22,Muni Metro,San Francisco,-,per-per,PROPN-PROPN,PROPN-PROPN,compound-compound,compound-compound,NNP-NNP,NNP-NNP,4,1
12713,12026.0,23,played,6,6,21,15,5,1,0,15,team,MAC,per,,NOUN,PROPN,nsubj,appos,NN,NNP,3,1
12714,12027.0,18,is,2,1,16,15,0,1,1,14,Archway School,Gloucestershire,-,org,PROPN-PROPN,PROPN,compound-nsubj,compound,NNP-NNP,NNP,8,1
12715,12028.0,53,landed,1,8,48,40,7,4,-7,47,Joel Schumacher,producer,-,org,PROPN-PROPN,NOUN,compound-poss,compound,NNP-NNP,NN,-1,1
12716,12030.0,34,include,2,21,16,-5,20,17,-19,14,?eljko,of Bosnia and Herzegovi,org,---,NOUN,ADP-PROPN-CCONJ-PROPN,conj,prep-pobj-cc-conj,NN,IN-NNP-CC-NNP,3,1
12717,12031.0,39,is,1,13,14,1,12,24,-12,13,South Korea,Korea University,-,org-org,PROPN-PROPN,PROPN-PROPN,compound-pobj,compound-nmod,NNP-NNP,NNP-NNP,4,1
12718,12032.0,45,observed,6,3,4,1,2,40,3,-2,State,Dean Rusk,per,-,PROPN,PROPN-PROPN,pobj,compound-nsubj,NNP,NNP-NNP,1,1
12719,12033.0,23,is,1,1,8,7,0,14,0,7,etnies,Lake Forest,,per-per,NOUN,PROPN-PROPN,nsubj,compound-compound,NNS,NNP-NNP,5,1
12720,12034.0,35,continued,1,11,13,2,10,21,-10,12,American,Sally Ride,,org-org,ADJ,PROPN-PROPN,amod,compound-appos,JJ,NNP-NNP,1,1
12721,12035.0,33,Title,0,11,27,16,10,5,-11,27,Art History Location,United States,per-per-per,-,PROPN-PROPN-PROPN,PROPN-PROPN,compound-compound-conj,compound-nsubj,NNP-NNP-NNP,NNP-NNP,9,1
12722,12036.0,22,regarded,13,2,18,16,1,3,11,5,BANHARN SILPA-ARCHA,Thailand,per-per,,PROPN-PROPN,PROPN,compound-nmod,poss,NNP-NNP,NNP,4,1
12723,12037.0,25,signed,3,1,6,5,0,18,2,3,Five Hand Reel,Rubber,org-org-org,,NUM-PROPN-PROPN,PROPN,nummod-compound-nsubj,compound,CD-NNP-NNP,NNP,4,1
12724,12038.0,36,buried,33,11,24,13,10,11,22,-9,Eirene,Manuel I Komnenos,org,--,PROPN,PROPN-PROPN-PROPN,compound,compound-compound-pobj,NNP,NNP-NNP-NNP,11,1
12725,12040.0,15,lauded,4,1,10,9,0,4,3,6,St. Paul School,its,org-org-org,,PROPN-PROPN-PROPN,DET,compound-compound-nsubjpass,poss,NNP-NNP-NNP,PRP$,5,1
12726,12042.0,16,taught,4,3,10,7,2,5,1,6,he,Chicago,per,,PRON,PROPN,nsubj,pobj,PRP,NNP,5,1
12727,12043.0,19,deposited,2,8,17,9,7,1,-6,15,Andalas University,West Sumatra,per-per,-,PROPN-PROPN,PROPN-PROPN,compound-pobj,compound-pobj,NNP-NNP,NNP-NNP,5,1
12728,12044.0,55,Released,0,45,53,8,44,1,-45,53,Will Pearson,Mental Floss,org-org,-,PROPN-PROPN,PROPN-PROPN,compound-pobj,compound-pobj,NNP-NNP,NNP-NNP,7,1
12729,12048.0,26,promoted,3,7,14,7,6,11,-4,11,Serbian Superliga,Srpska Liga,-,org-org,PROPN-PROPN,PROPN-PROPN,compound-pobj,compound-oprd,NNP-NNP,NNP-NNP,4,1
12730,12050.0,54,is,5,14,14,0,13,39,-9,9,Ohio,Ohio Department of Transportation,,per-per-per-per,PROPN,PROPN-PROPN-ADP-PROPN,pobj,compound-nmod-prep-pobj,NNP,NNP-NNP-IN-NNP,0,1
12731,12052.0,49,recognized,15,23,28,5,22,20,-8,13,Oklahoma National Guard,United States,--,per-per,PROPN-PROPN-PROPN,PROPN-PROPN,compound-compound-pobj,compound-compound,NNP-NNP-NNP,NNP-NNP,3,1
12732,12053.0,26,recorded,4,3,24,21,2,1,1,20,Marianne Faithfull,NEMS,-,per,PROPN-PROPN,PROPN,compound-nsubj,nsubj,NNP-NNP,NNP,4,1
12733,12054.0,21,spent,1,1,6,5,0,14,0,5,She,Florida,org,,PRON,PROPN,nsubj,pobj,PRP,NNP,2,1
12734,12055.0,25,opens,14,3,6,3,2,18,11,-8,Thomas Edison,American,per-per,,PROPN-PROPN,ADJ,compound-nsubj,amod,NNP-NNP,JJ,1,1
12735,12056.0,19,attended,1,3,3,0,2,15,-2,2,Miami High School,Miami,org-org-org,,PROPN-PROPN-PROPN,PROPN,compound-compound-dobj,compound,NNP-NNP-NNP,NNP,0,1
12736,12057.0,41,joined,3,3,11,8,2,29,0,8,he,Argentina,per,,PRON,PROPN,nsubj,pobj,PRP,NNP,6,1
12737,12058.0,46,known,12,2,21,19,1,24,10,9,Hasan,lsqu,per,,PROPN,VERB,compound,ROOT,NNP,VB,2,1
12738,12059.0,42,established,8,5,18,13,4,23,3,10,NatWest,Royal Bank of Scotland Group,,per-per-per-per-per,PROPN,PROPN-PROPN-ADP-PROPN-PROPN,compound,compound-pobj-prep-compound-pobj,NNP,NNP-NNP-IN-NNP-NNP,7,1
12739,12060.0,23,licensed,4,11,17,6,10,5,-7,13,Indiana,William H. Block Co.,per,---,PROPN,PROPN-PROPN-PROPN-PROPN,pobj,compound-compound-compound-appos,NNP,NNP-NNP-NNP-NNP,3,1
12740,12061.0,8,headquartered,3,1,6,5,0,1,2,3,General Electric,Fairfield,-,per,PROPN-PROPN,PROPN,compound-nsubjpass,compound,NNP-NNP,NNP,3,1
12741,12062.0,26,launched,4,1,21,20,0,4,3,17,Rome,Draghi,org,,PROPN,PROPN,nsubj,nsubj,NNP,NNP,6,1
12742,12063.0,28,spoke,5,13,16,3,12,11,-8,11,Emory University,Atlanta,per-per,,PROPN-PROPN,PROPN,compound-pobj,pobj,NNP-NNP,NNP,3,1
12743,12064.0,27,Henri-Philippe,11,4,12,8,3,14,7,1,Minister,Henri-Philippe,org,,PROPN,PROPN,compound,ROOT,NNP,NNP,3,1
12744,12067.0,15,started,3,1,13,12,0,1,2,10,The Greenville News,A.M. Speights,org-org-org,-,DET-PROPN-PROPN,PROPN-PROPN,det-compound-nsubj,compound-pobj,DT-NNP-NNP,NNP-NNP,5,1
12745,12069.0,22,is,15,15,21,6,14,0,0,6,Abdominal,Canada,,per,PROPN,PROPN,appos,pobj,NNP,NNP,1,1
12746,12071.0,9,is,2,1,8,7,0,0,1,6,Gary Kuo,violinist,-,per,PROPN-PROPN,NOUN,compound-nsubj,conj,NNP-NNP,NN,2,1
12747,12072.0,32,competed,3,1,21,20,0,10,2,18,WidowPC,Boulder,per,,PROPN,PROPN,nsubj,compound,NNP,NNP,4,1
12748,12073.0,42,gathered,2,29,20,-9,28,21,-27,18,James R. Schlesinger,Defense,per-per-per,,PROPN-PROPN-PROPN,PROPN,compound-compound-pobj,pobj,NNP-NNP-NNP,NNP,5,1
12749,12074.0,33,salesman,4,15,21,6,14,11,-11,17,Rob Halford,Judas Priest,-,per-per,PROPN-PROPN,PROPN-PROPN,compound-dobj,compound-pobj,NNP-NNP,NNP-NNP,3,1
12750,12075.0,20,created,2,9,14,5,8,5,-7,12,Stax,Otis Redding,per,-,PROPN,PROPN-PROPN,pobj,compound-compound,NNP,NNP-NNP,4,1
12751,12077.0,23,reputed,9,17,20,3,16,2,-8,11,Johnny,Mr. Wrestling II,org,--,PROPN,PROPN-PROPN-PROPN,compound,compound-compound-appos,NNP,NNP-NNP-NNP,3,1
12752,12078.0,28,advised,19,15,18,3,14,9,4,-1,Sri Lankan,Arjuna Ranatunga,org-org,-,PROPN-PROPN,PROPN-PROPN,compound-compound,compound-nsubj,NNP-NNP,NNP-NNP,2,1
12753,12081.0,35,started,28,5,7,2,4,27,23,-21,Yugoslavia,Borisav Jovi?,per,-,PROPN,PROPN-PUNCT,pobj,compound-pobj,NNP,NNP-'',2,1
12754,12082.0,14,staged,7,1,7,6,0,6,6,0,Derbyshire County Cricket Club,1870,---,per,PROPN-PROPN-PROPN-PROPN,NUM,compound-compound-compound-nsubj,pobj,NNP-NNP-NNP-NNP,CD,3,1
12755,12084.0,23,meet,7,11,13,2,10,9,-4,6,Vice President,Zeng Qinghong,-,per-per,PROPN-PROPN,PROPN-PROPN,compound-compound,compound-pobj,NNP-NNP,NNP-NNP,1,1
12756,12085.0,52,shows,7,36,39,3,35,12,-29,32,ION,qubo,org,,PROPN,NOUN,compound,pobj,NNP,NN,4,1
12757,12086.0,14,received,2,9,12,3,8,1,-7,10,Seattle,band,,per,PROPN,NOUN,pobj,nsubj,NNP,NN,1,1
12758,12088.0,23,won,10,6,9,3,5,13,4,-1,Idaho State,Pocatello,per-per,,PROPN-PROPN,PROPN,compound-pobj,pobj,NNP-NNP,NNP,4,1
12759,12089.0,30,set,11,4,10,6,3,19,7,-1,Luxembourg,Luxair,per,,PROPN,PROPN,compound,nsubjpass,NNP,NNP,5,1
12760,12090.0,43,gave,12,1,10,9,0,32,11,-2,Liverpool F.C,Rafael Benitez,org-org,-,PROPN-PROPN,PROPN-PROPN,compound-poss,compound-conj,NNP-NNP,NNP-NNP,3,1
12761,12091.0,38,spent,3,16,19,3,15,18,-13,16,he,McGill University,org,-,PRON,PROPN-PROPN,nsubj,compound-pobj,PRP,NNP-NNP,2,1
12762,12092.0,58,compete,3,11,2,-9,10,55,-8,-1,NCAA,Northwestern University,,org-org,PROPN,PROPN-PROPN,poss,compound-pobj,NNP,NNP-NNP,7,1
12763,12093.0,18,wrote,7,1,7,6,0,10,6,0,de San,France,-,org,X-PROPN,PROPN,compound-nsubj,pobj,FW-NNP,NNP,2,1
12764,12094.0,27,climb,8,17,22,5,16,4,-9,14,Minister,Giulio Tremonti,per,-,PROPN,PROPN-PROPN,nmod,compound-nsubj,NNP,NNP-NNP,2,1
12765,12095.0,28,reports,4,1,3,2,0,24,3,-1,Pakistan,Daily Times,per,-,PROPN,PROPN-PROPN,poss,compound-nsubj,NNP,NNP-NNP,2,1
12766,12096.0,16,moved,2,7,13,6,6,2,-5,11,USA,Daughters,per,,PROPN,PROPN,pobj,dobj,NNP,NNP,4,1
12767,12097.0,14,interred,2,1,12,11,0,1,1,10,Langdon,Glendale,,per,PROPN,PROPN,nsubjpass,compound,NNP,NNP,5,1
12768,12098.0,44,According,0,17,43,26,16,0,-17,43,University of Freiburg Faculty of Medicine,Germany,org-org-org-org-org-org,,PROPN-ADP-PROPN-PROPN-ADP-PROPN,PROPN,nsubj-prep-compound-pobj-prep-pobj,pobj,NNP-IN-NNP-NNP-IN-NNP,NNP,12,1
12769,12099.0,27,are,19,7,7,0,6,19,12,-12,Tehran,Tehran University of Medical Sciences,,org-org-org-org-org,PROPN,PROPN-PROPN-ADP-PROPN-PROPN,compound,compound-pobj-prep-compound-compound,NNP,NNP-NNP-IN-NNP-NNPS,0,1
12770,12101.0,41,represented,5,2,17,15,1,23,3,12,Hill,Conservative,per,,PROPN,PROPN,pobj,compound,NNP,NNP,6,1
12771,12102.0,30,criticized,5,1,4,3,0,25,4,-1,Game Informer,Andrew Reiner,per-per,-,PROPN-PROPN,PROPN-PROPN,compound-poss,compound-nsubj,NNP-NNP,NNP-NNP,1,1
12772,12103.0,22,was,2,11,13,2,10,8,-9,11,Cambodia,his,,per,PROPN,DET,pobj,poss,NNP,PRP$,2,1
12773,12104.0,32,was,2,5,10,5,4,21,-3,8,Duchess,Princess Mary Adelaide of Cambridge,,per-per-per-per-per,PROPN,PROPN-PROPN-PROPN-ADP-PROPN,attr,compound-compound-appos-prep-pobj,NNP,NNP-NNP-NNP-IN-NNP,3,1
12774,12105.0,16,is,5,5,7,2,4,8,0,2,Minnesota,Mark Dayton,org,-,PROPN,PROPN-PROPN,pobj,compound-attr,NNP,NNP-NNP,1,1
12775,12107.0,18,appointed,2,6,15,9,5,2,-4,13,Elizabeth of Bohemia,England,org-org-org,,PROPN-ADP-PROPN,PROPN,pobj-prep-pobj,pobj,NNP-IN-NNP,NNP,4,1
12776,12108.0,49,was,2,21,17,-4,20,31,-19,15,Oregon,Reed College,per,-,PROPN,PROPN-PROPN,compound,compound-pobj,NNP,NNP-NNP,3,1
12777,12110.0,26,is,8,2,25,23,1,0,6,17,Stan Rogers,Canada,per-per,,PROPN-NOUN,PROPN,compound-dobj,pobj,NNP-NNS,NNP,6,1
12778,12112.0,19,represented,6,3,14,11,2,4,3,8,Ohio University,Division I,-,per-per,PROPN-PROPN,PROPN-PRON,compound-dobj,compound-compound,NNP-NNP,NNP-PRP,5,1
12779,12113.0,30,Following,0,22,22,0,21,7,-22,22,Edward,Edward V of England,org,---,PROPN,PROPN-PROPN-ADP-PROPN,appos,compound-appos-prep-pobj,NNP,NNP-NNP-IN-NNP,0,1
12780,12114.0,18,formed,3,1,6,5,0,11,2,3,Thomson Reuters,April 2008,-,per-per,PROPN-PROPN,PROPN-NUM,compound-nsubjpass,pobj-nummod,NNP-NNP,NNP-CD,4,1
12781,12116.0,38,launched,3,6,13,7,5,24,-3,10,March 15 2008,VH1 Denmark,per-per-per,-,PROPN-NUM-NUM,PROPN-PROPN,pobj-nummod-nummod,compound-pobj,NNP-CD-CD,NNP-NNP,7,1
12782,12118.0,38,was,1,16,26,10,15,11,-15,25,Lincoln Park High School,Chicago,---,per,PROPN-PROPN-PROPN-PROPN,PROPN,compound-compound-compound-appos,compound,NNP-NNP-NNP-NNP,NNP,5,1
12783,12121.0,36,said,25,27,32,5,26,3,-2,7,Leonard Mitzel,Alberta,per-per,,PROPN-PROPN,PROPN,compound-nsubj,poss,NNP-NNP,NNP,5,1
12784,12123.0,25,commissioned,4,10,24,14,9,0,-6,20,Dominique de Villepin,France,org-org-org,,PROPN-X-PROPN,PROPN,compound-compound-pobj,pobj,NNP-FW-NNP,NNP,9,1
12785,12125.0,19,ISBN,0,6,18,12,5,0,-6,18,New Haven,Yale,per-per,,PROPN-PROPN,PROPN,compound-compound,pobj,NNP-NNP,NNP,5,1
12786,12129.0,19,is,3,10,12,2,9,6,-7,9,Italian,Giuseppe Arcimboldo,org,-,ADJ,PROPN-PROPN,amod,compound-pobj,JJ,NNP-NNP,1,1
12787,12130.0,18,was,10,1,15,14,0,2,9,5,Laura Nyro,singer,-,per,PROPN-PROPN,NOUN,compound-nsubj,attr,NNP-NNP,NN,3,1
12788,12131.0,41,Established,0,20,30,10,19,10,-20,30,Philippine Airlines,China Airlines,-,org-org,PROPN-PROPN,PROPN-PROPN,compound-pobj,compound-nsubj,NNP-NNPS,NNP-NNP,7,1
12789,12132.0,34,charges,27,10,20,10,9,13,17,-7,Yahya Khan,Military,org-org,,PROPN-PROPN,PROPN,compound-poss,compound,NNP-NNP,NNP,7,1
12790,12133.0,16,announced,5,2,12,10,1,3,3,7,Jamaica,Hugh Shearer,,org-org,PROPN,PROPN-PROPN,compound,compound-pobj,NNP,NNP-NNP,5,1
12791,12135.0,21,was,2,1,13,12,0,7,1,11,John Faulkner,State,per-per,,PROPN-PROPN,PROPN,compound-nsubj,pobj,NNP-NNP,NNP,5,1
12792,12136.0,22,is,5,2,21,19,1,0,3,16,Dronfield Henry Fanshawe School,Derbyshire,per-per-per-per,,PROPN-PROPN-PROPN-PROPN,PROPN,compound-compound-compound-nsubj,pobj,NNP-NNP-NNP-NNP,NNP,10,1
12793,12137.0,47,is,6,18,28,10,17,18,-12,22,Stafford,New Jersey,org,-,PROPN,PROPN-PROPN,conj,compound-compound,NNP,NNP-NNP,3,1
12794,12138.0,58,BijnensE-mail,1,19,19,0,18,38,-18,18,Lund University,Lund,per-per,,PROPN-PROPN,PROPN,nmod-pobj,nmod,NNP-NNP,NNP,0,1
12795,12144.0,32,gets,1,1,9,8,0,22,0,8,Teen,United States,org,-,PROPN,PROPN-PROPN,nsubj,compound-compound,NNP,NNP-NNP,3,1
12796,12147.0,19,is,2,1,6,5,0,12,1,4,Chicago Heights,Bloom High School,per-per,--,PROPN-PROPN,PROPN-PROPN-PROPN,compound-nsubj,compound-compound-pobj,NNP-NNP,NNP-NNP-NNP,5,1
12797,12148.0,63,declare,19,8,21,13,7,41,11,2,; Ho Chi Min,d Vietna,org-org-org-org,-,PUNCT-PROPN-PROPN-PROPN,VERB-NOUN,punct-compound-compound-nsubj,punct-ROOT,:-NNP-NNP-NNP,VBN-NN,6,1
12798,12149.0,17,Stafford,1,1,11,10,0,5,0,10,Terell Stafford,Chicago,per-per,,PROPN-PROPN,PROPN,compound-ROOT,compound,NNP-NNP,NNP,4,1
12799,12151.0,23,was,6,5,22,17,4,0,1,16,Tun Ali,Sultanate,-,per,PROPN-PROPN,PROPN,compound-nsubj,pobj,NNP-NNP,NNP,2,1
12800,12152.0,83,During,0,21,22,1,20,60,-21,22,Defense,James R. Schlesinger,per,--,PROPN,PROPN-PROPN-PROPN,pobj,compound-compound-compound,NNP,NNP-NNP-NNP,2,1
12801,12153.0,36,voted,6,17,26,9,16,9,-11,20,USA,Redemption,org,,PROPN,PROPN,nmod,compound,NNP,NNP,6,1
12802,12155.0,28,is,1,6,16,10,5,11,-5,15,Luther College,Evangelical Lutheran Church in America,per-per,----,PROPN-PROPN,PROPN-PROPN-PROPN-ADP-PROPN,compound-pobj,compound-compound-pobj-prep-pobj,NNP-NNP,NNP-NNP-NNP-IN-NNP,8,1
12803,12156.0,26,comes,13,1,25,24,0,0,12,12,He,Memphis,,per,PRON,PROPN,nsubj,pobj,PRP,NNP,3,1
12804,12158.0,29,alloted,3,2,25,23,1,3,1,22,Institute,Sanjeev Bhargava,,per-per,PROPN,PROPN-PROPN,nsubjpass,compound-pobj,NNP,NNP-NNP,5,1
12805,12159.0,12,acquired,6,4,5,1,3,6,2,-1,1988,Linksys,,per,NUM,PROPN,pobj,nsubjpass,CD,NNP,4,1
12806,12160.0,23,praised,13,1,15,14,0,7,12,2,California,Knowland,,per,PROPN,PROPN,pobj,poss,NNP,NNP,5,1
12807,12161.0,20,done,4,7,18,11,6,1,-3,14,Stacy Codikow,Power Up,-,per-per,PROPN-PROPN,PROPN-PART,compound-pobj,compound-pobj,NNP-NNP,NNP-RP,-1,1
12808,12162.0,21,was,2,16,19,3,15,1,-14,17,Nirvana,Kurt Cobain,,per-per,PROPN,PROPN-PROPN,compound,compound-pobj,NNP,NNP-NNP,2,1
12809,12163.0,27,granted,5,4,17,13,3,9,1,12,Cambodia,him,org,,PROPN,PRON,nsubjpass,dative,NNP,PRP,3,1
12810,12164.0,48,Phuture,0,1,7,6,0,40,-1,7,Phuture,DJ Pierre,,per-per,NOUN,PROPN-PROPN,ROOT,compound-compound,NN,NNP-NNP,6,1
12811,12165.0,18,merged,8,6,7,1,5,10,2,-1,Henry Tate,Tate Lyle,-,per-per,PROPN-PROPN,PROPN-PROPN,compound-compound,compound-dobj,NNP-NNP,NNP-NNP,2,1
12812,12167.0,59,reached,1,11,17,6,10,41,-10,16,Teletoon,Corus Entertainment,,per-per,PROPN,PROPN-PROPN,pobj,compound-pobj,NNP,NNP-NNP,6,1
12813,12168.0,26,is,1,6,6,0,5,19,-5,5,Mizuho Corporate Bank,Mizuho Financial Group,--,per-per-per,PROPN-PROPN-PROPN,PROPN-PROPN-PROPN,compound-compound-compound,compound-compound-pobj,NNP-NNP-NNP,NNP-NNP-NNP,0,1
12814,12169.0,24,is,2,1,8,7,0,15,1,6,Anthony Martin,locksmith,org-org,,PROPN-PROPN,NOUN,compound-nsubj,attr,NNP-NNP,NN,3,1
12815,12170.0,27,said,13,21,26,5,20,0,-8,13,Japan Aerospace Exploration Agency,JAXA,---,org,PROPN-PROPN-PROPN-PROPN,PROPN,compound-compound-compound-pobj,conj,NNP-NNP-NNP-NNP,NNP,7,1
12816,13524.0,15,began,8,2,7,5,1,7,6,-1,Japan Aerospace Exploration Agency,JAXA,org-org-org-org,,PROPN-PROPN-PROPN-PROPN,PROPN,compound-compound-compound-nsubj,appos,NNP-NNP-NNP-NNP,NNP,3,1
12817,12171.0,43,engaged,4,31,34,3,30,8,-27,30,Helena Guergis,Rahim Jaffer,org-org,-,PROPN-PROPN,PROPN-PROPN,compound-nsubj,compound-conj,NNP-NNP,NNP-NNP,1,1
12818,12172.0,22,spent,1,9,17,8,8,4,-8,16,Maine Black Bears,Division I,per-per-per,-,PROPN-PROPN-PROPN,PROPN-PROPN,compound-compound-pobj,pobj-compound,NNP-NNP-NNPS,NNP-NNP,7,1
12819,12173.0,43,educated,5,23,25,2,22,17,-18,20,University of London,London Business School,--,org-org-org,PROPN-ADP-PROPN,PROPN-PROPN-PROPN,pobj-prep-pobj,compound-compound-conj,NNP-IN-NNP,NNP-NNP-NNP,3,1
12820,12175.0,26,became,3,2,3,1,1,22,1,0,Italy,Nino Taranto,,per-per,PROPN,PROPN-PROPN,pobj,compound-pobj,NNP,NNP-NNP,1,1
12821,12176.0,26,established,3,1,6,5,0,19,2,3,Shobhit University,Meerut,-,org,PROPN-PROPN,PROPN,compound-nsubjpass,compound,NNP-NNP,NNP,4,1
12822,12179.0,33,said,4,3,6,3,2,26,1,2,Patrick Cescau,Unilever,org-org,,PROPN-PROPN,PROPN,compound-nsubj,nsubj,NNP-NNP,NNP,3,1
12823,12183.0,26,represented,7,3,16,13,2,9,4,9,South Carolina Gamecocks,Southeastern Conference,org-org-org,-,PROPN-PROPN-PROPN,PROPN-PROPN,compound-compound-compound,compound-pobj,NNP-NNP-NNP,NNP-NNP,5,1
12824,12184.0,26,written,2,1,5,4,0,20,1,3,He,EMI,,per,PRON,PROPN,nsubj,pobj,PRP,NNP,4,1
12825,12185.0,16,is,7,2,5,3,1,10,5,-2,Reformed Church of France,France,---,per,PROPN-PROPN-ADP-PROPN,PROPN,compound-nsubj-prep-pobj,pobj,NNP-NNP-IN-NNP,NNP,2,1
12826,12187.0,23,speaking,2,17,20,3,16,2,-15,18,EU Commission,Jose Manuel Barroso,per-per,--,PROPN-PROPN,PROPN-PROPN-PROPN,compound-compound,compound-compound-pobj,NNP-NNP,NNP-NNP-NNP,3,1
12827,12188.0,36,develops,20,11,19,8,10,16,9,-1,Florida,Joint Center,per,-,PROPN,PROPN-PROPN,pobj,compound-conj,NNP,NNP-NNP,3,1
12828,12189.0,17,is,7,1,2,1,0,14,6,-5,Flight Alaska,Alaska,-,org,PROPN-PROPN,PROPN,compound-nsubj,compound,NNP-NNP,NNP,1,1
12829,12191.0,29,committed,5,12,18,6,11,10,-7,13,The Cars,Elektra,per-per,,DET-PROPN,PROPN,det-pobj,compound,DT-NNPS,NNP,7,1
12830,12192.0,25,purchased,3,9,7,-2,8,17,-6,4,1998,BBC Parliament,per,-,NUM,PROPN-PROPN,pobj,compound-dobj,CD,NNP-NNP,2,1
12831,12193.0,32,presented,4,11,18,7,10,13,-7,14,London,Kenneth MacMillan,,org-org,PROPN,PROPN-PROPN,pobj,compound-pobj,NNP,NNP-NNP,3,1
12832,12194.0,16,is,8,2,15,13,1,0,6,7,Canadian Federation of Students,Canada,---,per,PROPN-PROPN-ADP-PROPN,PROPN,compound-nsubj-prep-pobj,pobj,NNP-NNP-IN-NNP,NNP,2,1
12833,12195.0,28,are,22,15,19,4,14,8,7,-3,Michael Ignatieff,Ontario,org-org,,PROPN-PROPN,PROPN,compound-appos,compound,NNP-NNP,NNP,2,1
12834,12198.0,23,born,2,5,12,7,4,10,-3,10,Tehran,Iran University of Science and Technology,,per-per-per-per-per-per,PROPN,PROPN-PROPN-ADP-PROPN-CCONJ-PROPN,pobj,compound-pobj-prep-pobj-cc-conj,NNP,NNP-NNP-IN-NNP-CC-NNP,4,1
12835,12204.0,37,agreed,6,20,24,4,19,12,-14,18,Sheetz,Pennsylvania,per,,PROPN,PROPN,compound,pobj,NNP,NNP,2,1
12836,12205.0,23,was,10,1,18,17,0,4,9,8,John Hunn,Camden,org-org,,PROPN-PROPN,PROPN,compound-nsubj,pobj,NNP-NNP,NNP,5,1
12837,12206.0,73,included,4,2,8,6,1,64,2,4,Japan,DJ Krush,,org-org,PROPN,PROPN-PROPN,pobj,compound-compound,NNP,NNP-NNP,5,1
12838,12207.0,24,raised,15,3,12,9,2,11,12,-3,New York City Transit Authority,1953,per-per-per-per-per,,PROPN-PROPN-PROPN-PROPN-PROPN,NUM,compound-compound-compound-compound-nsubjpass,nummod,NNP-NNP-NNP-NNP-NNP,CD,5,1
12839,12211.0,62,went,2,22,28,6,21,33,-20,26,Gideon Rose,Council on Foreign Relations,per-per,---,PROPN-PROPN,PROPN-ADP-PROPN-PROPN,compound-pobj,pobj-prep-compound-pobj,NNP-NNP,NNP-IN-NNP-NNPS,4,1
12840,12213.0,24,is,18,1,18,17,0,5,17,0,Towa Carson,Sweden,per-per,,PROPN-PROPN,PROPN,compound-nsubj,pobj,NNP-NNP,NNP,5,1
12841,12215.0,11,is,1,7,9,2,6,1,-6,8,Prime Minister,Jean-Claude Juncker,-,per-per,PROPN-PROPN,PROPN-PROPN,compound-compound,compound-pobj,NNP-NNP,NNP-NNP,4,1
12842,12216.0,31,is,2,8,11,3,7,19,-6,9,Ding Lei,China,per-per,,PROPN-PROPN,PROPN,compound-nsubj,poss,NNP-NNP,NNP,3,1
12843,12218.0,38,provided,3,18,30,12,17,7,-15,27,Netherlands,European Central Bank,per,--,PROPN,PROPN-PROPN-PROPN,conj,compound-compound-pobj,NNP,NNP-NNP-NNP,7,1
12844,12219.0,9,attended,1,3,8,5,2,0,-2,7,Santana High School,California,org-org-org,,PROPN-PROPN-PROPN,PROPN,compound-compound-dobj,pobj,NNP-NNP-NNP,NNP,3,1
12845,12220.0,26,Center,9,1,6,5,0,19,8,-3,Jesse Levesque Hite,University of Louisville,--,per-per-per,PROPN-PROPN-PROPN,PROPN-ADP-PROPN,compound-compound-compound,nmod-prep-pobj,NNP-NNP-NNP,NNP-IN-NNP,3,1
12846,12221.0,34,put,14,25,28,3,24,5,-11,14,Chicago,Patrick Nash,per,-,PROPN,PROPN-PROPN,pobj,compound-pobj,NNP,NNP-NNP,5,1
12847,12222.0,36,is,17,16,24,8,15,11,1,7,Fat Joe,Terror Squad Entertainment,per-per,--,PROPN-PROPN,PROPN-PROPN-PROPN,compound-nsubj,compound-compound-pobj,NNP-NNP,NNP-NNP-NNP,9,1
12848,12223.0,20,was,1,9,11,2,8,8,-8,10,Viacom,VH1,,org,PROPN,PROPN,compound,npadvmod,NNP,NNP,3,1
12849,12224.0,20,bought,6,4,5,1,3,14,2,-1,Oxfordshire,Education Committee,,org-org,PROPN,PROPN-PROPN,compound,compound-nsubj,NNP,NNP-NNP,1,1
12850,12225.0,14,formed,6,3,8,5,2,5,3,2,Paris,Ulan Bator,org,-,PROPN,PROPN-PROPN,pobj,compound-dobj,NNP,NNP-NNP,3,1
12851,12226.0,27,returned,3,9,26,17,8,0,-6,23,Vladimir Vernadsky,Russia,-,org,PROPN-PROPN,PROPN,compound-dobj,pobj,NNP-NNP,NNP,3,1
12852,12227.0,43,issuer,16,7,21,14,6,21,9,5,Royal Bank of Scotland Group,NatWest,per-per-per-per-per,,PROPN-PROPN-ADP-PROPN-PROPN,PROPN,compound-nmod-prep-compound-pobj,nmod,NNP-NNP-IN-NNP-NNP,NNP,5,1
12853,12228.0,18,represented,6,3,9,6,2,8,3,3,Oregon Ducks,University of Oregon,-,org-org-org,PROPN-PROPN,PROPN-ADP-PROPN,compound-compound,dobj-prep-pobj,NNP-NNPS,NNP-IN-NNP,4,1
12854,12229.0,15,is,4,1,12,11,0,2,3,8,Lakelands Park Middle School,Gaithersburg,per-per-per-per,,PROPN-PROPN-PROPN-PROPN,PROPN,compound-compound-compound-nsubj,compound,NNP-NNP-NNP-NNP,NNP,7,1
12855,12230.0,15,ruled,2,7,14,7,6,0,-5,12,Canada,Khadr,per,,PROPN,PROPN,nsubj,dobj,NNP,NNP,3,1
12856,12231.0,17,ceased,1,7,16,9,6,0,-6,15,University of Eastern Finland,2010,---,org,PROPN-ADP-PROPN-PROPN,NUM,nsubj-prep-compound-pobj,nummod,NNP-IN-NNP-NNP,CD,5,1
12857,13986.0,29,was,21,3,10,7,2,18,18,-11,University of Eastern Finland,2010,org-org-org-org,,PROPN-ADP-PROPN-PROPN,NUM,nsubj-prep-compound-pobj,nummod,NNP-IN-NNP-NNP,CD,4,1
12858,12233.0,21,surrendered,6,10,19,9,9,1,-4,13,USSR,Soviet Navy,,per-per,PROPN,PROPN-PROPN,pobj,compound-pobj,NNP,NNP-NNP,6,1
12859,12234.0,40,sold,2,6,28,22,5,11,-4,26,W Network,New Zealand,-,per-per,PROPN-PROPN,PROPN-PROPN,compound-attr,compound-compound,NNP-NNP,NNP-NNP,10,1
12860,12239.0,22,announced,4,10,20,10,9,1,-6,16,Republican,Olympia Snowe,org,-,ADJ,PROPN-PROPN,amod,compound-dobj,JJ,NNP-NNP,7,1
12861,12240.0,25,succeeded,3,2,18,16,1,6,1,15,Mark Clark,15th Army Group,-,org-org-org,PROPN-PROPN,ADJ-PROPN-PROPN,compound-nsubj,amod-compound-dobj,NNP-NNP,JJ-NNP-NNP,5,1
12862,12241.0,28,started,4,2,13,11,1,14,2,9,Jonas Brothers,Nick,-,per,PROPN-PROPN,PROPN,compound-nsubj,pobj,NNP-NNPS,NNP,4,1
12863,12244.0,35,recorded,1,1,11,10,0,23,0,10,He,United Artists Records,,per-per-per,PRON,PROPN-PROPN-PROPN,nsubj,compound-compound-nsubjpass,PRP,NNP-NNP-NNPS,3,1
12864,12246.0,23,is,2,1,16,15,0,6,1,14,Death Vessel,ATP Recordings,-,org-org,NOUN-PROPN,PROPN-PROPN,compound-nsubj,compound-conj,NN-NNP,NNP-NNP,7,1
12865,12247.0,52,made,5,39,40,1,38,11,-34,35,Ryusuke Taguchi,Taguchi,per-per,,PROPN-PROPN,PROPN,compound-conj,dobj,NNP-NNP,NNP,3,1
12866,12249.0,29,Bill,0,1,1,0,0,27,-1,1,Bill,Bill Melinda Gates Foundation,,org-org-org-org,PROPN,PROPN-PROPN-PROPN-PROPN,ROOT,compound-compound-compound-dobj,NNP,NNP-NNP-NNP-NNP,0,1
12867,12250.0,10,Bird,3,3,6,3,2,3,0,3,Andrew Bird,Fat Possum,per-per,-,PROPN-PROPN,PROPN-PROPN,compound-ROOT,compound-compound,NNP-NNP,NNP-NNP,2,1
12868,12251.0,27,made,6,12,18,6,11,8,-6,12,Finland,Kaarlo Juho,org,-,PROPN,PROPN-PROPN,nsubj,compound-pobj,NNP,NNP-NNP,5,1
12869,12252.0,40,was,10,1,14,13,0,25,9,4,Reinaldo Arenas,poet,-,per,PROPN-PROPN,NOUN,compound-nsubj,compound,NNP-NNP,NN,2,1
12870,12253.0,34,has,2,29,33,4,28,0,-27,31,Miramonte High School,Orinda,--,org,PROPN-PROPN-PROPN,PROPN,compound-compound-conj,pobj,NNP-NNP-NNP,NNP,7,1
12871,12254.0,33,dare,3,11,18,7,10,14,-8,15,Li Zhaoxing,China,org-org,,PROPN-PROPN,PROPN,compound-dobj,nsubj,NNP-NNP,NNP,6,1
12872,12255.0,44,declared,18,3,9,6,2,34,15,-9,Bishop,Albany,,org,PROPN,PROPN,nsubj,compound,NNP,NNP,3,1
12873,12256.0,48,embarked,3,43,46,3,42,1,-40,43,Pete Doherty,The Libertines,-,per-per,PROPN-PROPN,DET-PROPN,compound-conj,det-pobj,NNP-NNP,DT-NNP,4,1
12874,12257.0,34,has,3,2,13,11,1,20,1,10,United States,Earth,org-org,,PROPN-PROPN,PROPN,compound-nsubj,dobj,NNP-NNP,NNP,7,1
12875,12258.0,20,replaced,1,5,14,9,4,5,-4,13,Gerald Myers,Texas Tech Red Raiders,-,per-per-per-per,PROPN-PROPN,PROPN-PROPN-PROPN-PROPN,compound-dobj,compound-compound-compound-pobj,NNP-NNP,NNP-NNP-NNP-NNPS,6,1
12876,12259.0,36,played,7,2,26,24,1,9,5,19,she,Roath,,per,PRON,PROPN,nsubj,pobj,PRP,NNP,10,1
12877,12260.0,41,met,8,3,37,34,2,3,5,29,his,Paris,,org,DET,PROPN,poss,poss,PRP$,NNP,10,1
12878,12261.0,53,said,17,6,6,0,5,46,11,-11,Skidaway Institute of Oceanography,Skidaway Island,---,org-org,PROPN-PROPN-ADP-PROPN,PROPN-PROPN,compound-pobj-prep-pobj,compound-pobj,NNP-NNP-IN-NNP,NNP-NNP,0,1
12879,12262.0,27,is,7,13,13,0,12,13,-6,6,Alaska Air National Guard,Alaska,---,per,PROPN-PROPN-PROPN-PROPN,PROPN,compound-compound-compound-pobj,ROOT,NNP-NNP-NNP-NNP,NNP,0,1
12880,12263.0,49,Born,0,12,35,23,11,13,-12,35,North American Soccer League,Washington Diplomats,org-org-org-org,-,PROPN-PROPN-PROPN-PROPN,PROPN-VERB,compound-compound-compound-pobj,compound-appos,NNP-NNP-NNP-NNP,NNP-VBZ,6,1
12881,12264.0,32,is,8,2,11,9,1,20,6,3,Harris,American,,org,PROPN,ADJ,nsubj,amod,NNP,JJ,6,1
12882,12265.0,29,is,4,3,12,9,2,16,1,8,Slater,London,per,,PROPN,PROPN,appos,pobj,NNP,NNP,5,1
12883,12266.0,14,is,2,1,13,12,0,0,1,11,The Prophet,Scantraxx,org-org,,DET-PROPN,PROPN,det-nsubj,dobj,DT-NNP,NNP,2,1
12884,12267.0,23,favoured,9,19,22,3,18,0,-10,13,Canadair,Montreal,per,,PROPN,PROPN,pobj,pobj,NNP,NNP,6,1
12885,12268.0,16,attended,7,4,4,0,3,11,3,-3,San Mateo,San Mateo High School,org-org,---,PROPN-PROPN,PROPN-PROPN-PROPN-PROPN,compound-compound,compound-compound-compound-dobj,NNP-NNP,NNP-NNP-NNP-NNP,0,1
12886,12271.0,33,said,15,17,28,11,16,4,-2,13,Lee Peterson,University of Colorado at Boulder,-,per-per-per-per-per,PROPN-PROPN,PROPN-ADP-PROPN-ADP-PROPN,compound-compound,pobj-prep-pobj-prep-pobj,NNP-NNP,NNP-IN-NNP-IN-NNP,9,1
12887,12272.0,18,gone,9,8,17,9,7,0,1,8,Deacons,ACC,per,,PROPN,PROPN,nsubj,pobj,NNPS,NNP,2,1
12888,12273.0,20,was,5,2,4,2,1,15,3,-1,Islamia College,Peshawar,-,org,PROPN-PROPN,PROPN,compound-compound,pobj,NNP-NNP,NNP,4,1
12889,12274.0,39,reunited,23,14,15,1,13,23,9,-8,Japan,David Sylvian,,per-per,PROPN,PROPN-PROPN,pobj,compound-compound,NNP,NNP-NNP,1,1
12890,12276.0,26,College,4,4,9,5,3,16,0,5,Pennsylvania College of Technology,Williamsport,per-per-per-per,,PROPN-PROPN-ADP-PROPN,PROPN,compound-ROOT-prep-pobj,pobj,NNP-NNP-IN-NNP,NNP,1,1
12891,12277.0,25,Masten,1,2,24,22,1,0,-1,23,Masten Space Systems,Mojave,per-per-per,,PROPN-PROPN-PROPN,PROPN,compound-compound-compound,pobj,NNP-NNP-NNPS,NNP,4,1
12892,12278.0,24,appeared,3,6,1,-5,5,22,-3,-2,October 1920,The Beaver,-,org-org,PROPN-NUM,DET-PROPN,pobj-nummod,det-compound,NNP-CD,DT-NNP,5,1
12893,12279.0,27,were,11,6,11,5,5,15,5,0,Wouter Bos,Finance,-,org,PROPN-PROPN,PROPN,compound-conj,pobj,NNP-NNP,NNP,2,1
12894,12281.0,18,born,2,10,14,4,9,3,-8,12,Manuel Balmaceda,Emilia de Toro Herrera,per-per,---,PROPN-PROPN,PROPN-PROPN-PROPN-PROPN,compound-pobj,compound-compound-compound-pobj,NNP-NNP,NNP-NNP-NNP-NNP,7,1
12895,12283.0,37,invited,17,20,27,7,19,9,-3,10,Franck Riboud,Groupe Danone,per-per,-,PROPN-PROPN,PROPN-PROPN,compound-pobj,compound-pobj,NNP-NNP,NNP-NNP,3,1
12896,12284.0,38,was,1,20,32,12,19,5,-19,31,Pittsburgh,PNC Financial Services,,per-per-per,PROPN,PROPN-PROPN-PROPN,compound,compound-compound-nsubj,NNP,NNP-NNP-NNPS,6,1
12897,12287.0,19,is,8,7,14,7,6,4,1,6,NWM,Saint Vincent and the Grenadines,,per-per-per-per-per,PROPN,PROPN-PROPN-CCONJ-DET-PROPN,appos,compound-pobj-cc-det-conj,NNP,NNP-NNP-CC-DT-NNPS,5,1
12898,12290.0,17,is,2,1,8,7,0,8,1,6,Richard Tofel,ProPublica,-,per,PROPN-PROPN,PROPN,compound-nsubj,pobj,NNP-NNP,NNP,4,1
12899,12291.0,38,involves,6,21,22,1,20,15,-15,16,King,Robert II of Scotland,,org-org-org-org,PROPN,PROPN-PROPN-ADP-PROPN,compound,compound-pobj-prep-pobj,NNP,NNP-NNP-IN-NNP,1,1
12900,12292.0,29,is,19,1,17,16,0,11,18,-2,Illinois,Quincy Newspapers,per,-,PROPN,PROPN-PROPN,compound,compound-pobj,NNP,NNP-NNPS,5,1
12901,12293.0,27,name,1,9,13,4,8,13,-8,12,Roy Rogers,; Dale Evan,-,org-org-org,PROPN-PROPN,PUNCT-PROPN-PROPN,compound-pobj,punct-compound-compound,NNP-NNP,:-NNP-NNP,-1,1
12902,12294.0,20,moved,9,6,17,11,5,2,3,8,his,New York City,per,--,DET,PROPN-PROPN-PROPN,poss,compound-compound-pobj,PRP$,NNP-NNP-NNP,10,1
12903,12295.0,35,found,6,2,6,4,1,28,4,0,Jackson,Motown,,per,PROPN,PROPN,poss,dobj,NNP,NNP,4,1
12904,12297.0,69,said,7,15,20,5,14,48,-8,13,Bret Schundler,New Jersey,per-per,-,PROPN-PROPN,PROPN-PROPN,compound-poss,compound-poss,NNP-NNP,NNP-NNP,4,1
12905,12599.0,22,was,6,8,20,12,7,1,-2,14,Bret Schundler,New Jersey,org-org,-,PROPN-PROPN,PROPN-PROPN,compound-attr,compound-pobj,NNP-NNP,NNP-NNP,2,1
12906,12298.0,18,were,4,2,12,10,1,5,2,8,York Region Shooters,Canadian Professional Soccer League,--,per-per-per-per,PROPN-PROPN-PROPN,PROPN-PROPN-PROPN-PROPN,compound-compound-nsubj,compound-compound-compound-pobj,NNP-NNP-NNPS,NNP-NNP-NNP-NNP,7,1
12907,12301.0,19,is,1,1,8,7,0,10,0,7,Amaral,Zaragoza,,org,PROPN,PROPN,nsubj,compound,NNP,NNP,2,1
12908,12302.0,33,are,5,17,29,12,16,3,-12,24,Owen Arthur,Barbados,-,per,PROPN-PROPN,PROPN,compound-appos,conj,NNP-NNP,NNP,5,1
12909,12303.0,30,moved,6,9,12,3,8,17,-3,6,Berlin,his,per,,PROPN,DET,pobj,poss,NNP,PRP$,2,1
12910,12304.0,36,said,34,5,22,17,4,13,29,-12,Germany,he,org,,PROPN,PRON,pobj,nsubj,NNP,PRP,3,1
12911,12309.0,33,headed,1,1,12,11,0,20,0,11,Bongo,PDG,,org,PROPN,PROPN,nsubj,appos,NNP,NNP,5,1
12912,12310.0,12,is,1,5,9,4,4,2,-4,8,Pratibha Patil,President,org-org,,PROPN-PROPN,PROPN,compound-pobj,appos,NNP-NNP,NNP,2,1
12913,12314.0,30,Dubai-based,4,7,11,4,6,18,-3,7,Libya,Libyan Airlines,org,-,PROPN,PROPN-PROPN,poss,amod-conj,NNP,NNP-NNPS,4,1
12914,12316.0,22,is,1,16,21,5,15,0,-15,20,Shizuoka University,Japan,per-per,,PROPN-PROPN,PROPN,compound-nmod,pobj,NNP-NNP,NNP,6,1
12915,12317.0,40,founded,2,7,19,12,6,20,-5,17,John D. Rockefeller,New York,--,per-per,PROPN-PROPN-PROPN,PROPN-PROPN,compound-compound-compound,compound-pobj,NNP-NNP-NNP,NNP-NNP,9,1
12916,12318.0,15,maintain,1,7,13,6,6,1,-6,12,Ramon Magsaysay Memorial Medical Center,UERMMMC,----,per,PROPN-PROPN-PROPN-PROPN-PROPN,PROPN,compound-compound-compound-compound-appos,appos,NNP-NNP-NNP-NNP-NNP,NNP,2,1
12917,12319.0,31,said,29,15,18,3,14,12,14,-11,Yang Jiechi,China,per-per,,PROPN-PROPN,PROPN,compound-appos,poss,NNP-NNP,NNP,4,1
12918,12320.0,37,sung,4,27,30,3,26,6,-23,26,The Supremes,Scherrie Payne,-,per-per,DET-PROPN,PROPN-PROPN,det-compound,compound-pobj,DT-NNP,NNP-NNP,2,1
12919,12322.0,34,made,7,7,13,6,6,20,0,6,Qadir,Afghanistan,,per,PROPN,PROPN,nsubj,pobj,NNP,NNP,1,1
12920,12323.0,46,said,39,41,43,2,40,2,-2,4,FDIC,Sheila C. Bair,per,--,PROPN,PROPN-PROPN-PROPN,compound,compound-compound-nsubj,NNP,NNP-NNP-NNP,2,1
12921,12325.0,24,pleaded,5,5,22,17,4,1,0,17,Northwest,NWA,per,,PROPN,PROPN,nsubj,compound,NNP,NNP,9,1
12922,12327.0,36,said,34,25,33,8,24,2,9,-1,Infosys,Kris Gopalakrishnan,per,-,PROPN,PROPN-PROPN,pobj,compound-appos,NNP,NNP-NNP,8,1
12923,12328.0,23,is,8,6,14,8,5,8,2,6,Angelo State University,Texas,per-per-per,,PROPN-PROPN-PROPN,PROPN,compound-compound-pobj,pobj,NNP-NNP-NNP,NNP,9,1
12924,12329.0,32,were,1,4,6,2,3,25,-3,5,Left and Democrats,Democrats,per-per-per,,PROPN-CCONJ-PROPN,PROPN,attr-cc-conj,pobj,NNP-CC-NNPS,NNPS,3,1
12925,12331.0,29,discovered,4,24,26,2,23,2,-20,22,Japanese,Seki Kw,per,-,ADJ,PROPN-PROPN,amod,compound-appos,JJ,NNP-NNP,1,1
12926,12332.0,26,became,8,1,8,7,0,17,7,0,St. Benet Biscop Catholic High School,Northumberland,-----,per,PROPN-PROPN-PROPN-PROPN-PROPN-PROPN,PROPN,compound-compound-compound-compound-compound-nsubj,pobj,NNP-NNP-NNP-NNP-NNP-NNP,NNP,2,1
12927,12333.0,21,built,4,18,19,1,17,1,-14,15,Ukraine,Leonid Kravchuk,per,-,PROPN,PROPN-PROPN,compound,compound-pobj,NNP,NNP-NNP,1,1
12928,12335.0,40,played,1,19,38,19,18,1,-18,37,Western Baseball League,Texas-Louisiana League,per-per-per,-,PROPN-PROPN-PROPN,PROPN-PROPN,compound-compound-pobj,compound-pobj,NNP-NNP-NNP,NNP-NNP,8,1
12929,12338.0,14,is,1,1,12,11,0,1,0,11,Green Party,Global Greens,-,per-per,PROPN-PROPN,PROPN-PROPN,compound-pobj,compound-conj,NNP-NNP,NNP-NNP,4,1
12930,12339.0,32,said,9,1,5,4,0,26,8,-4,Albert Ho,Hong Kong,-,org-org,PROPN-PROPN,PROPN-PROPN,compound-nsubj,compound-poss,NNP-NNP,NNP-NNP,4,1
12931,12341.0,29,START,2,5,13,8,4,15,-3,11,Mazda,Jujiro Matsuda,per,-,PROPN,PROPN-PROPN,nsubj,compound-compound,NNP,NNP-NNP,2,1
12932,12342.0,22,provided,4,7,10,3,6,11,-3,6,Adam and Company,Plc,org-org-org,,PROPN-CCONJ-PROPN,PROPN,pobj-cc-compound,conj,NNP-CC-NNP,NNP,3,1
12933,12343.0,35,completed,25,20,34,14,19,0,5,9,Loyola University Medical Center,Illinois,org-org-org-org,,PROPN-PROPN-PROPN-PROPN,PROPN,compound-compound-compound-pobj,pobj,NNP-NNP-NNP-NNP,NNP,6,1
12934,12344.0,28,graduated,1,4,4,0,3,23,-3,3,Santa Fe High School,Santa Fe,org-org-org-org,-,PROPN-PROPN-PROPN-PROPN,PROPN-PROPN,compound-compound-compound-pobj,compound-compound,NNP-NNP-NNP-NNP,NNP-NNP,0,1
12935,12345.0,9,shot,3,2,7,5,1,1,1,4,KGB,Moscow,per,,PROPN,PROPN,compound,compound,NNP,NNP,3,1
12936,12346.0,41,accredited,4,8,8,0,7,32,-4,4,Georgia,Georgia Department of Education,per,---,PROPN,PROPN-PROPN-ADP-PROPN,compound,compound-appos-prep-pobj,NNP,NNP-NNP-IN-NNP,0,1
12937,12347.0,27,is,2,9,23,14,8,3,-7,21,CBS,1927,org,,PROPN,NUM,compound,pobj,NNP,CD,9,1
12938,12348.0,23,jumped,13,1,11,10,0,11,12,-2,London,GSK,org,,PROPN,PROPN,poss,nsubjpass,NNP,NNP,6,1
12939,12349.0,34,said,19,29,31,2,28,2,-10,12,Scotland,University of Dundee,,org-org-org,PROPN,PROPN-ADP-PROPN,poss,pobj-prep-pobj,NNP,NNP-IN-NNP,3,1
12940,12350.0,8,moved,1,1,5,4,0,2,0,4,Eran,Melbourne,,per,PROPN,PROPN,nsubj,pobj,NNP,NNP,1,1
12941,12351.0,35,led,13,17,24,7,16,10,-4,11,Bernard Montgomery,Eighth Army,per-per,-,PROPN-PROPN,PROPN-PROPN,compound-pobj,compound-pobj,NNP-NNP,NNP-NNP,5,1
12942,12352.0,24,is,4,15,21,6,14,2,-11,17,Brandon DiCamillo,West Chester,-,org-org,PROPN-PROPN,PROPN-PROPN,compound-conj,compound-compound,NNP-NNP,NNP-NNP,4,1
12943,12353.0,21,was,7,2,12,10,1,8,5,5,Edgar,Edward the Martyr,,org-org-org,PROPN,PROPN-DET-PROPN,nsubj,ROOT-det-appos,NNP,NNP-DT-NNP,5,1
12944,12354.0,68,was,17,6,1,-5,5,66,11,-16,Earl Russell,Bertrand Russell,org-org,-,PROPN-PROPN,PROPN-PROPN,compound-compound,compound-pobj,NNP-NNP,NNP-NNP,2,1
12945,12355.0,22,Markwort,1,1,8,7,0,13,0,7,Helmut Markwort,Focus,org-org,,PROPN-PROPN,PROPN,compound-ROOT,pobj,NNP-NNP,NNP,2,1
12946,12356.0,16,acquired,7,1,5,4,0,10,6,-2,L. S. Ayres,Indianapolis,--,per,PROPN-PROPN-PROPN,PROPN,compound-compound-compound,compound,NNP-NNP-NNP,NNP,3,1
12947,12357.0,42,was,1,1,21,20,0,20,0,20,He,Joint Commission for Administering the Government,org,-----,PRON,PROPN-PROPN-ADP-VERB-DET-PROPN,nsubj,compound-pobj-prep-pcomp-det-dobj,PRP,NNP-NNP-IN-VBG-DT-NNP,7,1
12948,12361.0,45,was,1,14,17,3,13,27,-13,16,South Wales Borderers,British Army,--,per-per,PROPN-PROPN-PROPN,PROPN-PROPN,compound-compound-compound,compound-pobj,NNP-NNP-NNPS,NNP-NNP,2,1
12949,12362.0,29,replaced,8,16,28,12,15,0,-8,20,her,Argentina,per,,PRON,PROPN,nsubj,pobj,PRP,NNP,5,1
12950,12363.0,54,attended,7,26,27,1,25,26,-19,20,Philippines,Cesar Virata,per,-,PROPN,PROPN-PROPN,compound,compound-pobj,NNP,NNP-NNP,1,1
12951,12364.0,35,product,3,25,26,1,24,8,-22,23,India,National Spot Exchange,,org-org-org,PROPN,PROPN-PROPN-PROPN,compound,compound-compound-pobj,NNP,NNP-NNP-NNP,1,1
12952,12365.0,86,studied,9,15,70,55,14,15,-6,61,Royal College of Art,London,---,org,PROPN-PROPN-ADP-NOUN,PROPN,compound-pobj-prep-pobj,pobj,NNP-NNP-IN-NN,NNP,-1,1
12953,12367.0,43,Baum,4,17,17,0,16,25,-13,13,Pennsylvania Army National Guard,Pennsylvania,---,per,PROPN-PROPN-PROPN-PROPN,PROPN,compound-compound-compound-ROOT,nsubj,NNP-NNP-NNP-NNP,NNP,0,1
12954,12369.0,38,announced,6,9,31,22,8,6,-3,25,Beckham,England,,per,PROPN,PROPN,nsubj,nmod,NNP,NNP,9,1
12955,12370.0,34,said,4,23,26,3,22,7,-19,22,Jens Stoltenberg,Oslo,per-per,,PROPN-PROPN,PROPN,compound-pobj,pobj,NNP-NNP,NNP,3,1
12956,12372.0,22,is,3,8,21,13,7,0,-5,18,Adnan,Pakistan,,per,PROPN,PROPN,nsubj,pobj,NNP,NNP,3,1
12957,12373.0,19,is,4,1,14,13,0,4,3,10,Lansdale Catholic High School,Roman Catholic Archdiocese of Philadelphia,---,org-org-org-org-org,PROPN-PROPN-PROPN-PROPN,ADJ-PROPN-PROPN-ADP-PROPN,compound-compound-compound-nsubj,compound-compound-pobj-prep-pobj,NNP-NNP-NNP-NNP,JJ-NNP-NNP-IN-NNP,8,1
12958,12374.0,24,known,4,1,9,8,0,14,3,5,His,Venezuela,,per,DET,PROPN,poss,pobj,PRP$,NNP,3,1
12959,13296.0,19,characterized,3,1,15,14,0,3,2,12,His,Venezuela,per,,DET,PROPN,poss,poss,PRP$,NNP,3,1
12960,12375.0,12,supported,3,5,11,6,4,0,-2,8,William Emmett Dever,Chicago,per-per-per,,PROPN-PROPN-PROPN,PROPN,compound-compound-dobj,pobj,NNP-NNP-NNP,NNP,3,1
12961,12376.0,51,participated,4,40,41,1,39,9,-36,37,China,Shanghai Jiao Tong University,per,---,PROPN,PROPN-PROPN-PROPN-PROPN,pobj,compound-compound-compound-compound,NNP,NNP-NNP-NNP-NNP,2,1
12962,12377.0,36,appointed,3,6,21,15,5,14,-3,18,Mr. Jackson,MJ Publishing Trust,-,per-per-per,PROPN-PROPN,PROPN-PROPN-PROPN,compound-pobj,compound-compound-appos,NNP-NNP,NNP-NNP-NNP,5,1
12963,12378.0,23,Image,0,3,3,0,2,19,-3,3,Charles,Charles II of England,per,---,PROPN,PROPN-PROPN-ADP-PROPN,compound,compound-appos-prep-pobj,NNP,NNP-NNP-IN-NNP,0,1
12964,12379.0,42,been,37,12,13,1,11,28,25,-24,Western Bulldogs,Bulldogs,-,org,PROPN-PROPN,PROPN,compound-pobj,poss,NNP-NNPS,NNPS,3,1
12965,12380.0,31,is,2,1,6,5,0,24,1,4,Reliance Capital,India,org-org,,PROPN-PROPN,PROPN,compound-nsubj,pobj,NNP-NNP,NNP,5,1
12966,12381.0,51,serves,2,10,27,17,9,23,-8,25,The New School,NY,--,org,DET-PROPN-PROPN,PROPN,det-compound-ROOT,pobj,DT-NNP-NNP,NNP,9,1
12967,12382.0,32,said,15,17,20,3,16,11,-2,5,North Korean,Kim Jong-Il,per-per,-,ADJ-ADJ,PROPN-PROPN,amod-amod,compound-poss,JJ-JJ,NNP-NNP,3,1
12968,12383.0,67,known,3,10,50,40,9,16,-7,47,di Pisa,University of Pisa,per-per,--,ADP-PROPN,PROPN-ADP-PROPN,nmod-ROOT,pobj-prep-pobj,IN-NNP,NNP-IN-NNP,14,1
12969,12385.0,13,is,2,1,1,0,0,11,1,-1,Aylesbury College,Aylesbury,-,per,PROPN-PROPN,PROPN,compound-nsubj,compound,NNP-NNP,NNP,0,1
12970,12386.0,27,was,11,1,25,24,0,1,10,14,John Alexander,United States,per-per,-,PROPN-PROPN,PROPN-PROPN,compound-compound,compound-conj,NNP-NNP,NNP-NNP,7,1
12971,12388.0,22,is,4,14,20,6,13,1,-10,16,Sonny Cher,Atco,per-per,,PROPN-PROPN,PROPN,compound-pobj,compound,NNP-NNP,NNP,5,1
12972,12389.0,30,were,21,20,28,8,19,1,1,7,England,Anne Neville,,per-per,PROPN,PROPN-PROPN,pobj,compound-conj,NNP,NNP-NNP,9,1
12973,12391.0,26,helped,10,8,8,0,7,17,2,-2,Oregon State Bar,Oregon,per-per-per,,PROPN-PROPN-PROPN,PROPN,compound-compound-nsubj,compound,NNP-NNP-NNP,NNP,0,1
12974,12392.0,23,established,3,2,12,10,1,10,1,9,Group,Malaysia,per,,PROPN,PROPN,nsubjpass,pobj,NNP,NNP,-1,1
12975,12393.0,17,was,6,1,13,12,0,3,5,7,His,Judd,,per,DET,PROPN,poss,compound,PRP$,NNP,5,1
12976,12395.0,45,was,4,14,17,3,13,27,-10,13,Texas Tech University,Red Raiders,--,org-org,PROPN-PROPN-PROPN,PROPN-PROPN,compound-compound-compound,compound-pobj,NNP-NNP-NNP,NNP-NNPS,2,1
12977,12396.0,15,is,2,1,14,13,0,0,1,12,Harris Academy,Scotland,per-per,,PROPN-PROPN,PROPN,compound-nsubj,pobj,NNP-NNP,NNP,6,1
12978,12398.0,23,used,5,3,16,13,2,6,2,11,Hubert,Minnesota,per,,PROPN,PROPN,nsubj,pobj,NNP,NNP,7,1
12979,12403.0,10,became,3,3,7,4,2,2,0,4,Francesco,actor,per,,PROPN,NOUN,appos,attr,NNP,NN,2,1
12980,12405.0,36,asked,1,8,6,-2,7,29,-7,5,Bakunin,the socialist,org,-,PROPN,DET-ADJ,compound,det-amod,NNP,DT-JJ,2,1
12981,12406.0,32,destroyed,2,6,10,4,5,21,-4,8,Royal Naval Hospital,Hong Kong,org-org-org,-,PROPN-PROPN-PROPN,PROPN-PROPN,compound-compound-dobj,compound-pobj,NNP-NNP-NNP,NNP-NNP,2,1
12982,12407.0,22,begin,7,6,21,15,5,0,1,14,Westjet,Alberta,,per,PROPN,PROPN,nsubj,pobj,NNP,NNP,6,1
12983,12409.0,35,disagreed,5,17,30,13,16,4,-12,25,Dutch,Frans Hals,org,-,ADJ,PROPN-PROPN,amod,compound-compound,JJ,NNPS-NNPS,8,1
12984,12410.0,26,became,4,9,15,6,8,10,-5,11,Cryonics Institute,Robert Ettinger,org-org,-,PROPN-PROPN,PROPN-PROPN,compound-pobj,compound-dobj,NNPS-NNP,NNP-NNP,4,1
12985,12413.0,30,are,4,1,16,15,0,13,3,12,Sutherland Sharks,New South Wales Premier League,org-org,----,PROPN-PROPN,PROPN-PROPN-PROPN-PROPN-PROPN,compound-compound,compound-compound-compound-compound-pobj,NNP-NNP,NNP-NNP-NNP-NNP-NNP,9,1
12986,12414.0,18,moved,3,8,15,7,7,2,-5,12,IMI,Israel,,per,PROPN,PROPN,pobj,compound,NNP,NNP,5,1
12987,12415.0,27,took,7,1,6,5,0,20,6,-1,James W. Bradbury,Maine,per-per-per,,PROPN-PROPN-PROPN,PROPN,compound-compound-nsubj,compound,NNP-NNP-NNP,NNP,3,1
12988,12416.0,22,understand,1,14,20,6,13,1,-13,19,OpenSkies,British Airways,,org-org,PROPN,PROPN-PROPN,pobj,compound-pobj,NNP,NNP-NNPS,3,1
12989,12417.0,12,is,2,1,10,9,0,1,1,8,Kingshott School,Hertfordshire,-,per,PROPN-PROPN,PROPN,compound-nsubj,compound,NNP-NNP,NNP,4,1
12990,12418.0,24,Ghafouri-Shiraz,2,10,19,9,9,4,-8,17,Communications Engineering,Electrical and Computer Engineering,per-per,---,PROPN-PROPN,PROPN-CCONJ-PROPN-PROPN,compound-pobj,nmod-cc-conj-compound,NNP-NNP,NNP-CC-NNP-NNP,2,1
12991,12419.0,19,is,1,7,14,7,6,4,-6,13,James Darren,Gloria Terlitsky,-,org-org,PROPN-PROPN,PROPN-PROPN,compound-pobj,compound-compound,NNP-NNP,NNP-NNP,5,1
12992,12420.0,19,decided,2,1,2,1,0,16,1,0,Emperor,Maurice,per,,PROPN,PROPN,compound,nsubj,NNP,NNP,1,1
12993,12421.0,41,CEO,3,5,10,5,4,30,-2,7,Seven,Australia,,org,PROPN,PROPN,compound,appos,NNP,NNP,3,1
12994,12422.0,36,starred,2,28,29,1,27,6,-26,27,actor,Edgar Buchanan,org,-,NOUN,PROPN-PROPN,compound,compound-pobj,NN,NNP-NNP,1,1
12995,12423.0,16,is,7,2,15,13,1,0,5,8,Cheddi,Guyana,,org,PROPN,PROPN,poss,pobj,NNP,NNP,5,1
12996,12424.0,19,joined,1,1,10,9,0,8,0,9,He,Federal Republic,org,-,PRON,PROPN-PROPN,nsubj,compound-pobj,PRP,NNP-NNP,4,1
12997,12425.0,15,appointed,2,4,7,3,3,7,-2,5,Chief Commissioner,Victoria Police,org-org,-,PROPN-PROPN,PROPN-PROPN,compound-oprd,compound-pobj,NNP-NNP,NNP-NNP,2,1
12998,12426.0,21,was,1,1,18,17,0,2,0,17,MetroJet,1998,org,,PROPN,NUM,nsubj,pobj,NNP,CD,7,1
12999,12427.0,38,While,0,21,36,15,20,1,-21,36,Algeria,Ferhat Abbas,,org-org,PROPN,PROPN-PROPN,pobj,compound-appos,NNP,NNP-NNP,8,1
13000,12428.0,14,was,2,1,12,11,0,1,1,10,TechniGraphics,Wooster Ohio,org,-,PROPN,PROPN-PROPN,compound,compound-pobj,NNP,NNP-NNP,6,1
13001,12429.0,33,are,21,13,25,12,12,7,8,4,Coachella Valley High School,High School,---,org-org,PROPN-PROPN-PROPN-PROPN,PROPN-PROPN,nmod-compound-nmod-nmod,compound-attr,NNP-NNP-NNP-NNP,NNP-NNP,8,1
13002,12430.0,46,----,0,7,8,1,6,37,-7,8,CEO,Larry Ellison,,org-org,PROPN,PROPN-PROPN,pobj,compound-nsubj,NNP,NNP-NNP,1,1
13003,12431.0,43,called,25,14,23,9,13,19,11,-2,William Pitt the Younger,Prime Minister,per-per-per-per,-,PROPN-PROPN-DET-PROPN,PROPN-PROPN,compound-nsubj-det-appos,compound-oprd,NNP-NNP-DT-NNP,NNP-NNP,2,1
13004,12432.0,27,is,2,10,20,10,9,6,-8,18,Jordan,Marouf al-Bakhit,,org-org,PROPN,PROPN-PROPN,pobj,compound-pobj,NNP,NNP-NNP,12,1
13005,12433.0,21,moved,4,8,10,2,7,10,-4,6,Greece,he,per,,PROPN,PRON,pobj,nsubj,NNP,PRP,1,1
13006,12435.0,23,sells,13,1,7,6,0,15,12,-6,Lululemon,Canada,,per,PROPN,PROPN,nsubj,pobj,NNP,NNP,3,1
13007,12437.0,19,studied,1,12,17,5,11,1,-11,16,School of Visual Arts,New York,org-org-org-org,-,PROPN-ADP-PROPN-PROPN,PROPN-PROPN,pobj-prep-compound-pobj,compound-pobj,NNP-IN-NNP-NNP,NNP-NNP,3,1
13008,12438.0,29,school,4,1,1,0,0,27,3,-3,Peoria,Peoria Notre Dame High School,per,----,PROPN,PROPN-PROPN-PROPN-PROPN-PROPN,poss,compound-compound-compound-compound-compound,NNP,NNP-NNP-NNP-NNP-NNP,0,1
13009,12439.0,37,is,4,2,19,17,1,17,2,15,Redlight Children Campaign,Guy Jacobson,--,per-per,PROPN-PROPN-PROPN,PROPN-PROPN,compound-compound-nsubj,compound-pobj,NNP-NNP-NNP,NNP-NNP,10,1
13010,12441.0,26,runs,1,8,9,1,7,16,-7,8,Tim,O'Reilly Media,,per-per,PROPN,PROPN-PROPN,compound,compound-pobj,NNP,NNP-NNP,1,1
13011,12442.0,29,known,4,1,12,11,0,16,3,8,S.S. Felice Scandone,Avellino,--,per,PROPN-PROPN-PROPN,PROPN,compound-compound-nsubj,pobj,NNP-NNP-NNP,NNP,2,1
13012,12443.0,24,is,2,9,21,12,8,2,-7,19,Australian Football League,Collingwood Football Club,--,org-org-org,PROPN-PROPN-PROPN,PROPN-PROPN-PROPN,compound-compound-pobj,compound-compound-pobj,NNP-NNP-NNP,NNP-NNP-NNP,8,1
13013,12857.0,36,is,3,15,28,13,14,7,-12,25,Australian Football League,Collingwood Football Club,org-org-org,--,ADJ-PROPN-PROPN,PROPN-PROPN-PROPN,compound-compound-appos,compound-compound-pobj,JJ-NNP-NNP,NNP-NNP-NNP,7,1
13014,12444.0,19,broadcast,7,3,16,13,2,2,4,9,Czech Republic,f televi,per-per,-,PROPN-PROPN,X-NOUN,compound-pobj,det-compound,NNP-NNP,XX-NN,-1,1
13015,12445.0,54,attended,1,16,37,21,15,16,-15,36,Toronto,Dru,,per,PROPN,PROPN,pobj,ROOT,NNP,NNP,3,1
13016,12446.0,33,inspired,25,16,22,6,15,10,9,-3,1890,Asbury College,,org-org,NUM,PROPN-PROPN,pobj,compound-nsubjpass,CD,NNP-NNP,4,1
13017,12447.0,48,broadcast,3,8,8,0,7,39,-5,5,BBC,BBC,org,,PROPN,PROPN,compound,compound,NNP,NNP,0,1
13018,12448.0,43,advanced,2,7,13,6,6,29,-5,11,Jeffrey L. Bewkes,Time Warner,org-org-org,-,PROPN-PROPN-PROPN,PROPN-PROPN,compound-compound-pobj,compound-pobj,NNP-NNP-NNP,NNP-NNP,4,1
13019,12455.0,37,wondered,5,4,9,5,3,27,1,4,Stafford,United States,,org-org,PROPN,PROPN-PROPN,compound,compound-nsubj,NNP,NNP-NNP,5,1
13020,12456.0,25,went,1,1,9,8,0,15,0,8,He,South Africa,per,-,PRON,PROPN-PROPN,nsubj,compound-pobj,PRP,NNP-NNP,4,1
13021,12457.0,28,nominated,3,1,23,22,0,4,2,20,Tilda Swinton,Actress,per-per,,PROPN-PROPN,PROPN,compound-nsubjpass,pobj,NNP-NNP,NNP,8,1
13022,12458.0,26,released,6,1,22,21,0,3,5,16,Mr. Peterson,Telarc,-,org,PROPN-PROPN,PROPN,compound-poss,conj,NNP-NNP,NNP,8,1
13023,12459.0,44,are,9,1,1,0,0,42,8,-8,Fubon Financial Holding Co.,Fubon Bank,per-per-per-per,-,PROPN-PROPN-PROPN-PROPN,PROPN-PROPN,compound-compound-subtok-subtok,compound-ROOT,NNP-NNP-NNP-NNP,NNP-NNP,0,1
13024,12461.0,20,merged,13,5,18,13,4,1,8,5,Air Next,ANA,org-org,,PROPN-PROPN,PROPN,compound-compound,compound,NNP-NNP,NNP,5,1
13025,12463.0,18,moved,3,2,6,4,1,11,1,3,Kubrick,England,org,,PROPN,PROPN,compound,pobj,NNP,NNP,2,1
13026,12464.0,46,owns,2,1,2,1,0,43,1,0,Air China,China,-,per,PROPN-PROPN,PROPN,compound-nsubj,pobj,NNP-NNP,NNP,1,1
13027,12465.0,11,bid,6,4,9,5,3,1,2,3,Francesco Rutelli,Rome,-,org,PROPN-PROPN,PROPN,compound-compound,compound,NNP-NNP,NNP,4,1
13028,12468.0,29,said,3,1,27,26,0,1,2,24,British Airways PLC,BA CityFlyer,per-per-per,-,PROPN-PROPN-PROPN,PROPN-PROPN,compound-compound-nsubj,compound-appos,NNP-NNP-NNP,NNP-NNP,8,1
13029,12469.0,42,included,3,13,29,16,12,12,-10,26,Communist Party,Deng Xiaoping,-,org-org,PROPN-PROPN,PROPN-PROPN,compound-pobj,compound-pobj,NNP-NNP,NNP-NNP,6,1
13030,12470.0,34,was,1,25,11,-14,24,22,-24,10,Democratic Kampuchea,his,-,org,ADJ-PROPN,DET,compound-pobj,poss,JJ-NNP,PRP$,7,1
13031,12471.0,72,School,6,6,11,5,5,60,0,5,Pritzker School of Medicine,IL,---,per,PROPN-PROPN-ADP-PROPN,PROPN,compound-ROOT-prep-pobj,compound,NNP-NNP-IN-NNP,NNP,2,1
13032,12473.0,34,born,2,16,22,6,15,11,-14,20,e Vytautas Magnus Universit,n Kauna,org-org-org-org,-,PROPN-PROPN-PROPN-PROPN,CCONJ-PROPN,compound-compound-compound-compound,punct-poss,NNP-NNP-NNP-NNP,CC-NNP,-1,1
13033,12474.0,47,gif,0,3,8,5,2,38,-3,8,160th Special Operations Aviation Regiment,Night Stalkers,org-org-org-org-org,-,ADJ-PROPN-PROPN-PROPN-PROPN,PROPN-PROPN,ROOT-compound-compound-compound-compound,compound-ROOT,JJ-NNP-NNPS-NNP-NNP,NNP-NNPS,4,1
13034,12475.0,15,was,2,2,6,4,1,8,0,4,He,Germany,per,,PRON,PROPN,nsubj,pobj,PRP,NNP,1,1
13035,12476.0,14,share,8,3,5,2,2,8,5,-3,Medford,North Medford High School,,org-org-org-org,PROPN,PROPN-PROPN-PROPN-PROPN,nsubj,compound-compound-compound-conj,NNP,NNP-NNP-NNP-NNP,3,1
13036,12477.0,40,is,10,33,38,5,32,1,-23,28,Suffolk University Law School,Boston,org-org-org-org,,PROPN-PROPN-PROPN-PROPN,PROPN,compound-conj-compound-appos,compound,NNP-NNP-NNP-NNP,NNP,4,1
13037,12478.0,23,was,1,12,19,7,11,3,-11,18,National Patriotic,Charles Taylor,org-org,-,PROPN-PROPN,PROPN-PROPN,compound-compound,compound-poss,NNP-NNP,NNP-NNP,9,1
13038,12479.0,26,is,3,1,10,9,0,15,2,7,CNBC,NBC Universal,,per-per,PROPN,PROPN-PROPN,compound,compound-pobj,NNP,NNP-NNP,5,1
13039,12480.0,17,acquired,2,8,15,7,7,1,-6,13,Hyde Park,Eleanor Roosevelt,per-per,-,PROPN-PROPN,PROPN-PROPN,compound-compound,compound-pobj,NNP-NNP,NNP-NNP,8,1
13040,12483.0,35,led,5,14,26,12,13,8,-9,21,England,Derek Bailey,,per-per,PROPN,PROPN-PROPN,pobj,compound-conj,NNP,NNP-NNP,5,1
13041,12484.0,16,liberated,4,9,13,4,8,2,-5,9,Stanislaw Maczek,1st Armoured Division,-,per-per-per,PROPN-PROPN,NOUN-PROPN-PROPN,compound-poss,compound-compound-pobj,NNP-NNP,NN-NNP-NNP,2,1
13042,12485.0,33,is,11,1,19,18,0,13,10,8,Rafael Vicente Correa Delgado,Ecuador,per-per-per-per,,PROPN-PROPN-PROPN-PROPN,PROPN,compound-compound-compound-dep,pobj,NNP-NNP-NNP-NNP,NNP,4,1
13043,12486.0,34,said,32,14,16,2,13,17,18,-16,Taliban,Abdullah Mehsud,org,-,PROPN,PROPN-PROPN,compound,compound-nsubj,NNP,NNP-NNP,1,1
13044,12488.0,30,was,2,15,18,3,14,11,-13,16,Linda Arkley,North Tyneside,org-org,-,PROPN-PROPN,PROPN-PROPN,compound-conj,compound-pobj,NNP-NNP,NNP-NNP,4,1
13045,12489.0,12,owns,4,2,6,4,1,5,2,2,Press Holdings,The Business,org-org,-,PROPN-PROPN,DET-PROPN,compound-compound,det-dobj,NNP-NNPS,DT-NNP,3,1
13046,12490.0,35,became,3,3,16,13,2,18,0,13,Beaux,Pennsylvania,,org,PROPN,PROPN,nsubj,compound,NNP,NNP,5,1
13047,12491.0,26,won,2,17,20,3,16,5,-15,18,Fareed Zakaria,Newsweek,-,per,PROPN-PROPN,PROPN,compound-nsubj,pobj,NNP-NNP,NNP,6,1
13048,12492.0,17,is,5,1,16,15,0,0,4,11,St. Benet Biscop High School,Northumberland,org-org-org-org-org,,PROPN-PROPN-PROPN-PROPN-PROPN,PROPN,compound-compound-compound-compound-nsubj,pobj,NNP-NNP-NNP-NNP-NNP,NNP,3,1
13049,12493.0,15,founded,5,2,8,6,1,6,3,3,1946,Puerto Rican Independence Party,,per-per-per-per,NUM,ADJ-ADJ-PROPN-PROPN,pobj,compound-amod-compound-dobj,CD,JJ-JJ-NNP-NNP,4,1
13050,12494.0,26,is,2,2,19,17,1,6,0,17,program,Canada,,per,NOUN,PROPN,nsubj,pobj,NN,NNP,5,1
13051,12495.0,28,born,2,11,14,3,10,13,-9,12,Virginia,Thomas Lee,,org-org,PROPN,PROPN-PROPN,appos,compound-pobj,NNP,NNP-NNP,-1,1
13052,12496.0,24,was,6,13,20,7,12,3,-7,14,United States,presidency of George Washington,org-org,---,PROPN-PROPN,NOUN-ADP-PROPN-PROPN,compound-pobj,pobj-prep-compound-pobj,NNP-NNP,NN-IN-NNP-NNP,6,1
13053,12497.0,35,became,30,25,29,4,24,5,5,-1,Westfield School,1957,per-per,,PROPN-PROPN,NUM,compound-appos,pobj,NNP-NNP,CD,4,1
13054,12499.0,20,was,5,2,14,12,1,5,3,9,architect,John Lees,org,-,NOUN,PROPN-PROPN,nsubj,compound-pobj,NN,NNP-NNP,5,1
13055,12500.0,25,is,5,1,18,17,0,6,4,13,Spain,Seat,,org,PROPN,PROPN,poss,pobj,NNP,NNP,6,1
13056,12503.0,30,died,1,1,28,27,0,1,0,27,She,John Edwards,org,-,PRON,PROPN-PROPN,nsubj,compound-conj,PRP,NNP-NNP,6,1
13057,12504.0,117,served,2,19,29,10,18,87,-17,27,Chrysler,General Motors,,per-per,PROPN,PROPN-PROPN,pobj,compound-conj,NNP,NNP-NNPS,5,1
13058,12505.0,27,said,3,1,22,21,0,4,2,19,Lee,South Korea,per,-,PROPN,PROPN-PROPN,poss,compound-pobj,NNP,NNP-NNP,11,1
13059,12506.0,21,became,6,3,11,8,2,9,3,5,Daniel J. Layton,Delaware,per-per-per,,PROPN-PROPN-PROPN,PROPN,compound-compound-appos,pobj,NNP-NNP-NNP,NNP,5,1
13060,12507.0,21,based,7,2,13,11,1,7,5,6,Central Norway Regional Health Authority,Hospital Trust,----,org-org,PROPN-PROPN-PROPN-PROPN-PROPN,PROPN-PROPN,compound-compound-compound-compound-nsubjpass,compound-nsubj,NNP-NNP-NNP-NNP-NNP,NNP-NNP,4,1
13061,12508.0,27,is,4,11,16,5,10,10,-7,12,Grateful Dead,Bob Weir,org-org,-,PROPN-PROPN,PROPN-PROPN,compound-compound,compound-conj,NNP-NNP,NNP-NNP,4,1
13062,12509.0,20,was,2,1,8,7,0,11,1,6,Articolo 31,Milan,-,per,PROPN-NUM,PROPN,nsubj-nummod,compound,NNP-CD,NNP,5,1
13063,12510.0,49,moved,5,8,15,7,7,33,-3,10,Toei Doga,Tokyo,org-org,,PROPN-PROPN,PROPN,compound-pobj,pobj,NNP-NNP,NNP,4,1
13064,12511.0,21,graduated,2,1,18,17,0,2,1,16,Van Loan,Ontario,org-org,,PROPN-PROPN,PROPN,compound-nsubj,pobj,NNP-NNP,NNP,6,1
13065,12512.0,19,is,6,5,5,0,4,13,1,-1,Lehigh,Lehigh and Northampton Transportation Authority,,per-per-per-per-per,PROPN,PROPN-CCONJ-PROPN-PROPN-PROPN,compound,nmod-cc-compound-compound-pobj,NNP,NNP-CC-NNP-NNP-NNP,0,1
13066,12513.0,21,built,2,6,11,5,5,9,-4,9,Stabilimento Tecnico Triestino,Trieste,per-per-per,,PROPN-PROPN-PROPN,PROPN,compound-compound-compound,pobj,NNP-NNP-NNP,NNP,5,1
13067,12516.0,19,January,0,3,5,2,2,13,-3,5,1947,Nepali Rashtriya Congress,per,--,NUM,PROPN-PROPN-PROPN,nummod,compound-compound-nsubj,CD,NNP-NNP-NNP,-1,1
13068,12517.0,29,agreed,8,3,6,3,2,22,5,-2,HP,Palo Alto,org,-,PROPN,PROPN-PROPN,nummod,compound-compound,NNP,NNP-NNP,2,1
13069,12521.0,26,stylized,1,16,21,5,15,4,-15,20,VRT,Canvas,org,,PROPN,PROPN,pobj,dobj,NNP,NNP,4,1
13070,12522.0,26,named,3,11,20,9,10,5,-8,17,Serbian,Mihailo Petrovi?,,per-per,ADJ,NOUN-NOUN,amod,nmod-amod,JJ,NNS-NN,2,1
13071,12523.0,14,born,2,6,12,6,5,1,-4,10,England,Winchester College,,org-org,PROPN,PROPN-PROPN,pobj,compound-conj,NNP,NNP-NNP,5,1
13072,12524.0,56,collaborated,3,6,30,24,5,25,-3,27,Viggo Mortensen,Perceval,org-org,,PROPN-PROPN,PROPN,compound-pobj,compound,NNP-NNP,NNP,8,1
13073,12525.0,11,PM,1,7,9,2,6,1,-6,8,Trinity College,Hartford,org-org,,PROPN-PROPN,PROPN,compound-compound,compound,NNP-NNP,NNP,1,1
13074,12527.0,37,said,6,21,34,13,20,2,-15,28,Russia,Nemtsov,,per,PROPN,PROPN,compound,poss,NNP,NNP,9,1
13075,12528.0,23,said,21,2,4,2,1,18,19,-17,Indonesian,Abdurrahman Wahid,,org-org,ADJ,PROPN-PROPN,amod,compound-nsubj,JJ,NNP-NNP,1,1
13076,12530.0,27,is,18,1,26,25,0,0,17,8,Far Eastern University,Philippines,--,org,ADJ-PROPN-PROPN,PROPN,compound-compound-nsubj,pobj,JJ-NNP-NNP,NNP,4,1
13077,12531.0,20,entered,8,10,17,7,9,2,-2,9,Fork Union Military Academy,FUMA,per-per-per-per,,PROPN-PROPN-PROPN-PROPN,PROPN,compound-compound-compound-dobj,pobj,NNP-NNP-NNP-NNP,NNP,4,1
13078,12533.0,37,said,8,12,25,13,11,11,-4,17,she,Taiwan,per,,PRON,PROPN,nsubj,pobj,PRP,NNP,7,1
13079,12534.0,36,initiated,10,9,21,12,8,14,1,11,Gurgenidze,Georgia,org,,PROPN,PROPN,nsubj,pobj,NNP,NNP,5,1
13080,12535.0,25,denied,4,4,7,3,3,17,0,3,Klein,CNN,per,,PROPN,PROPN,nsubj,nsubj,NNP,NNP,2,1
13081,12536.0,25,made,7,13,24,11,12,0,-6,17,The Football League,Wales,per-per-per,,DET-PROPN-PROPN,PROPN,det-compound-pobj,pobj,DT-NNP-NNP,NNP,5,1
13082,12537.0,23,Department,7,18,21,3,17,1,-11,14,Tufts University,MA,per-per,,PROPN-PROPN,PROPN,compound-compound,compound,NNP-NNP,NNP,4,1
13083,12538.0,28,is,15,10,18,8,9,9,5,3,Ellian,professor,per,,PROPN,NOUN,pobj,attr,NNP,NN,11,1
13084,12539.0,108,was,1,89,45,-44,88,62,-88,44,Elisabeth of Bavaria,Austria,per-per-per,,PROPN-ADP-PROPN,PROPN,pobj-prep-pobj,pobj,NNP-IN-NNP,NNP,7,1
13085,12540.0,18,complained,4,3,14,11,2,3,1,10,Navy,him,per,,PROPN,PRON,compound,dobj,NNP,PRP,4,1
13086,12545.0,34,resigned,10,6,9,3,5,24,4,-1,Team Ninja,Tomonobu Itagaki,per-per,-,PROPN-PROPN,PROPN-PROPN,compound-pobj,compound-nsubj,NNP-NNP,NNP-NNP,2,1
13087,12546.0,12,located,4,1,1,0,0,10,3,-3,Fife High School,Fife,org-org-org,,PROPN-PROPN-PROPN,PROPN,compound-compound-nsubjpass,compound,NNP-NNP-NNP,NNP,0,1
13088,12547.0,41,affiliated,7,2,15,13,1,25,5,8,Buick,General Motors,per,-,PROPN,PROPN-PROPN,compound,compound-pobj,NNP,NNP-NNPS,5,1
13089,12548.0,31,left,22,1,30,29,0,0,21,8,Sorensen,Washington,,per,PROPN,PROPN,nsubj,pobj,NNP,NNP,2,1
13090,12550.0,17,served,4,11,16,5,10,0,-7,12,John Carroll University,Ohio,org-org-org,,PROPN-PROPN-PROPN,PROPN,compound-compound-pobj,pobj,NNP-NNP-NNP,NNP,7,1
13091,12551.0,22,established,7,10,18,8,9,3,-3,11,Trans Australia Airlines,Australian Airlines,--,per-per,PROPN-PROPN-PROPN,PROPN-PROPN,compound-compound-pobj,compound-dobj,NNP-NNP-NNPS,NNP-NNPS,5,1
13092,12552.0,19,brought,10,7,13,6,6,5,3,3,Ma,Kuomintang,,per,PROPN,PROPN,poss,dobj,NNP,NNP,6,1
13093,13752.0,27,appear,17,1,8,7,0,18,16,-9,Ma,Kuomintang,org,,PROPN,PROPN,nsubj,compound,NNP,NNP,4,1
13094,12553.0,41,declared,7,14,37,23,13,3,-7,30,Tito,Ljubljana,org,,PROPN,PROPN,compound,compound,NNP,NNP,5,1
13095,12554.0,39,joined,3,23,29,6,22,9,-20,26,Estonia,bank,per,,PROPN,NOUN,conj,poss,NNP,NN,5,1
13096,12557.0,40,features,11,13,22,9,12,17,-2,11,American,Jasper Francis Cropsey,per,--,ADJ,PROPN-PROPN-PROPN,amod,compound-compound-compound,JJ,NNP-NNP-NNP,10,1
13097,12558.0,47,issued,4,22,26,4,21,20,-18,22,Dave Faulkner,Perth,-,org,PROPN-PROPN,ADJ,compound-dobj,compound,NNP-NNP,JJ,1,1
13098,12561.0,22,claimed,15,5,15,10,4,6,10,0,October 4 1962,ABU,--,org,PROPN-NUM-NUM,PROPN,pobj-nummod-nummod,nsubj,NNP-CD-CD,NNP,5,1
13099,12562.0,40,challenge,14,2,5,3,1,34,12,-9,Ron Wyden,Oregon,-,per,PROPN-PROPN,PROPN,compound-nsubj,pobj,NNP-NNP,NNP,2,1
13100,12564.0,21,announced,2,1,18,17,0,2,1,16,Bertie Ahern,UK Electoral Commission,org-org,--,PROPN-PROPN,PROPN-PROPN-PROPN,compound-nsubj,compound-compound-pobj,NNP-NNP,NNP-NNP-NNP,5,1
13101,12565.0,27,is,1,1,25,24,0,1,0,24,Speed,News Corporation,,per-per,NOUN,PROPN-PROPN,nsubj,compound-pobj,NN,NNP-NNP,8,1
13102,12566.0,24,was,7,3,13,10,2,10,4,6,New York Volunteer Infantry Regiment,Union,----,org,PROPN-PROPN-PROPN-PROPN-PROPN,PROPN,compound-compound-compound-compound-nsubj,compound,NNP-NNP-NNP-NNP-NNP,NNP,5,1
13103,12567.0,35,scheduled,26,18,21,3,17,13,8,-5,Executive Airlines,San Juan,per-per,-,PROPN-PROPN,PROPN-PROPN,compound-pobj,compound-pobj,NNP-NNPS,NNP-NNP,4,1
13104,12569.0,17,is,9,1,16,15,0,0,8,7,Leslie David Baker,actor,--,per,PROPN-PROPN-PROPN,NOUN,compound-compound-nsubj,attr,NNP-NNP-NNP,NN,3,1
13105,12570.0,12,named,2,8,9,1,7,2,-6,7,Virginia,Littleton Waller Tazewell,per,--,PROPN,PROPN-PROPN-PROPN,pobj,compound-compound-pobj,NNP,NNP-NNP-NNP,2,1
13106,12571.0,14,resides,1,1,4,3,0,9,0,3,He,Minneapolis,org,,PRON,PROPN,nsubj,compound,PRP,NNP,2,1
13107,12573.0,18,is,4,1,15,14,0,2,3,11,Fox Lane High School,Bedford,---,org,PROPN-PROPN-PROPN-PROPN,PROPN,compound-compound-compound-nsubj,compound,NNP-NNP-NNP-NNP,NNP,9,1
13108,12574.0,29,came,6,9,10,1,8,18,-3,4,KC,Wizards,org,,PROPN,PROPN,compound,nsubj,NNP,NNP,1,1
13109,12576.0,9,became,5,2,5,3,1,3,3,0,1,LFK,per,,NUM,PROPN,nummod,nsubj,CD,NNP,2,1
13110,12577.0,47,was,6,1,20,19,0,26,5,14,Charles Langlois,Sweden,-,per,PROPN-PROPN,PROPN,compound-nsubj,pobj,NNP-NNP,NNP,5,1
13111,12578.0,35,Salinas,3,1,11,10,0,23,2,8,Luis Adolfo Siles Salinas,Bolivia,---,per,PROPN-PROPN-PROPN-PROPN,PROPN,compound-compound-compound-ROOT,compound,NNP-NNP-NNP-NNP,NNP,4,1
13112,12579.0,41,recounts,8,10,17,7,9,23,-2,9,his,Florida,org,,DET,PROPN,poss,poss,PRP$,NNP,7,1
13113,12737.0,20,said,4,2,19,17,1,0,2,15,his,Florida,per,,DET,PROPN,poss,pobj,PRP$,NNP,3,1
13114,12580.0,22,played,11,6,19,13,5,2,5,8,Australian National Academy of Music,Melbourne,per-per-per-per-per,,PROPN-PROPN-PROPN-ADP-PROPN,PROPN,compound-compound-pobj-prep-pobj,compound,NNP-NNP-NNP-IN-NNP,NNP,9,1
13115,12581.0,29,said,8,6,7,1,5,21,2,-1,President,Bharrat Jagdeo,,per-per,PROPN,PROPN-PROPN,compound,compound-nsubj,NNP,NNP-NNP,1,1
13116,12583.0,44,changed,37,25,25,0,24,18,12,-12,Livingston,Livingston F.C.,per,-,PROPN,PROPN-PROPN,pobj,compound-pobj,NNP,NNP-NNP,0,1
13117,12584.0,29,followed,2,17,10,-7,16,18,-15,8,Patrick T. Harker,University of Delaware,--,org-org-org,PROPN-PROPN-PROPN,PROPN-ADP-PROPN,compound-compound-appos,pobj-prep-pobj,NNP-NNP-NNP,NNP-IN-NNP,5,1
13118,12587.0,58,is,5,13,18,5,12,39,-8,13,Communist Party of Greece,KKE,per-per-per-per,,PROPN-PROPN-ADP-PROPN,PROPN,compound-pobj-prep-pobj,compound,NNP-NNP-IN-NNP,NNP,1,1
13119,12588.0,30,introduced,2,12,5,-7,11,24,-10,3,French,Chagall,per,,ADJ,PROPN,amod,nsubj,JJ,NNP,4,1
13120,12591.0,38,Vazquez,4,12,12,0,11,25,-8,8,Illinois Army National Guard,Illinois,per-per-per-per,,PROPN-PROPN-PROPN-PROPN,PROPN,compound-compound-compound-ROOT,ROOT,NNP-NNP-NNP-NNP,NNP,0,1
13121,12592.0,23,represents,6,2,2,0,1,20,4,-4,Richmond Spiders,Richmond,org-org,,PROPN-PROPN,PROPN,compound-compound,compound,NNP-NNPS,NNP,0,1
13122,12593.0,32,was,12,18,23,5,17,8,-6,11,screenwriter,Henry Ephron,per,-,NOUN,PROPN-PROPN,conj,compound-pobj,NN,NNP-NNP,3,1
13123,12595.0,32,was,1,12,17,5,11,14,-11,16,Chiang Kai-shek,Nanchang,org-org,,PROPN-PROPN,PROPN,compound-poss,pobj,NNP-NNP,NNP,2,1
13124,12596.0,19,is,2,12,18,6,11,0,-10,16,Dr Pepper Snapple Group,Texas,---,per,PROPN-PROPN-PROPN-PROPN,PROPN,compound-compound-compound-pobj,pobj,NNP-NNP-NNP-NNP,NNP,7,1
13125,12600.0,43,is,10,2,9,7,1,33,8,-1,Institute of Road and Transport Technology,IRTT,-----,per,PROPN-ADP-PROPN-CCONJ-PROPN-PROPN,PROPN,nsubj-prep-pobj-cc-compound-conj,appos,NNP-IN-NNP-CC-NNP-NNP,NNP,3,1
13126,12601.0,23,proved,13,1,21,20,0,1,12,8,Sharett,Israeli,org,,PROPN,ADJ,poss,amod,NNP,JJ,7,1
13127,12603.0,10,produced,6,4,6,2,3,3,2,0,Island Records,he,org-org,,PROPN-PROPN,PRON,compound-pobj,nsubj,NNP-NNPS,PRP,3,1
13128,12606.0,18,completed,9,1,17,16,0,0,8,8,Royal Caribbean,Miami,-,org,PROPN-PROPN,PROPN,compound-poss,pobj,NNP-NNP,NNP,3,1
13129,12607.0,16,attended,1,3,8,5,2,7,-2,7,Mineola High School,Texas,org-org-org,,PROPN-PROPN-PROPN,PROPN,compound-compound-dobj,pobj,NNP-NNP-NNP,NNP,3,1
13130,12609.0,29,founded,3,21,21,0,20,7,-18,18,Dresden University of Technology,Dresden,---,per,PROPN-PROPN-ADP-PROPN,PROPN,compound-pobj-prep-pobj,appos,NNP-NNP-IN-NNP,NNP,0,1
13131,12612.0,15,is,2,1,10,9,0,4,1,8,Michael Hayes,CBS,org-org,,PROPN-PROPN,PROPN,compound-nsubj,pobj,NNP-NNP,NNP,4,1
13132,12615.0,11,graduated,1,3,3,0,2,7,-2,2,Tumwater High School,Tumwater,per-per-per,,PROPN-PROPN-PROPN,PROPN,compound-compound-dobj,compound,NNP-NNP-NNP,NNP,0,1
13133,12617.0,24,introduced,1,1,11,10,0,12,0,10,Carmichael,Toronto,,org,PROPN,PROPN,nsubj,pobj,NNP,NNP,4,1
13134,12619.0,20,represented,7,3,15,12,2,4,4,8,Duquesne University,Division I,org-org,-,PROPN-PROPN,PROPN-PROPN,compound-dobj,compound-compound,NNP-NNP,NNP-NNP,7,1
13135,12620.0,42,took,40,2,2,0,1,39,38,-38,Hong Kong Monetary Authority,Hong Kong,per-per-per-per,-,PROPN-PROPN-PROPN-PROPN,PROPN-PROPN,compound-compound-compound-nsubj,compound-compound,NNP-NNP-NNP-NNP,NNP-NNP,0,1
13136,12621.0,25,make,5,2,3,1,1,21,3,-2,Swedbank,SEB,per,,PROPN,PROPN,compound,nsubj,NNP,NNP,1,1
13137,12622.0,56,enabled,7,24,29,5,23,26,-17,22,Ma Rainey,Columbus,-,per,PROPN-PROPN,PROPN,compound-compound,compound,NNP-NNP,NNP,3,1
13138,12623.0,28,hired,8,5,15,10,4,12,3,7,Bruce Arena,Los Angeles Galaxy,org-org,--,PROPN-PROPN,PROPN-PROPN-PROPN,compound-nsubjpass,compound-compound-pobj,NNP-NNP,NNP-NNP-NNP,8,1
13139,12624.0,23,produced,4,1,17,16,0,5,3,13,Izzy Stradlin,Guns N ' Roses,per-per,---,PROPN-PROPN,PROPN-PROPN-PUNCT-PROPN,compound-nsubj,compound-subtok-subtok-pobj,NNP-NNP,NNP-NNP-''-NNPS,7,1
13140,12625.0,22,reports,3,7,15,8,6,6,-4,12,Pennsylvania,the Triangle,,per-per,PROPN,DET-PROPN,compound,det-poss,NNP,DT-NNP,6,1
13141,12629.0,38,combined,6,3,25,22,2,12,3,19,BOAC,1974,,org,NOUN,NUM,pobj,pobj,NN,CD,7,1
13142,12631.0,47,said,45,29,34,5,28,12,16,-11,Fradkov,Foreign Intelligence Service,,per-per-per,PROPN,PROPN-PROPN-PROPN,conj,compound-compound-pobj,NNP,NNP-NNP-NNP,5,1
13143,12632.0,39,Rock,0,23,31,8,22,7,-23,31,Orson Welles,United States,org-org,-,PROPN-PROPN,PROPN-PROPN,compound-poss,compound-pobj,NNP-NNP,NNP-NNP,7,1
13144,12635.0,21,born,2,6,10,4,5,10,-4,8,London,Mill Hill School,per,--,PROPN,PROPN-PROPN-PROPN,pobj,compound-compound-pobj,NNP,NNP-NNP-NNP,5,1
13145,12636.0,28,elected,20,1,24,23,0,3,19,4,Henry S. Bienen,Northwestern,--,org,PROPN-PROPN-PROPN,PROPN,compound-compound-nsubjpass,pobj,NNP-NNP-NNP,NNP,5,1
13146,12637.0,34,be,2,14,17,3,13,16,-12,15,Carol Christian,astronomer,per-per,,PROPN-PROPN,NOUN,compound-nsubj,nsubj,NNP-NNP,NN,2,1
13147,12638.0,37,break,23,29,30,1,28,6,-6,7,American,Bradley,per,,PROPN,PROPN,compound,pobj,NNP,NNP,3,1
13148,12639.0,19,raised,2,13,16,3,12,2,-11,14,Rufus Wainwright,Montreal,-,per,PROPN-PROPN,PROPN,compound-appos,compound,NNP-NNP,NNP,3,1
13149,12640.0,24,went,10,2,10,8,1,13,8,0,Kostov,leader,per,,PROPN,NOUN,nsubj,conj,NNP,NN,3,1
13150,12642.0,41,made,7,18,21,3,17,19,-11,14,Sri Lankan,H. R. Jothipala,-,per-per-per,PROPN-PROPN,PROPN-PROPN-PROPN,compound-compound,compound-compound-pobj,NNP-NNP,NNP-NNP-NNP,3,1
13151,12644.0,33,form,7,4,29,25,3,3,3,22,Kanemura,Japan,per,,PROPN,PROPN,nsubj,compound,NNP,NNP,7,1
13152,12645.0,21,elects,5,8,18,10,7,2,-3,13,Chiang Kai-shek,Republic,-,org,PROPN-PROPN,PROPN,compound-dobj,pobj,NNP-NNP,NNP,9,1
13153,12646.0,20,born,3,1,7,6,0,12,2,4,John Pyper-Ferguson,Australia,per-per,,PROPN-PROPN,PROPN,compound-nsubjpass,pobj,NNP-NNP,NNP,5,1
13154,12649.0,31,chosen,10,18,30,12,17,0,-8,20,Constant,Switzerland,org,,PROPN,PROPN,pobj,appos,NNP,NNP,8,1
13155,12650.0,34,cited,24,5,27,22,4,6,19,3,Chicago,Phuture,,org,PROPN,PROPN,compound,poss,NNP,NNP,7,1
13156,12653.0,22,served,1,1,13,12,0,8,0,12,Prentice,Calgary,per,,PROPN,PROPN,nsubj,compound,NNP,NNP,3,1
13157,13450.0,24,ran,7,7,14,7,6,9,0,7,Prentice,Calgary,per,,PROPN,PROPN,pobj,compound,NNP,NNP,5,1
13158,12654.0,26,le,24,11,14,3,10,11,13,-10,France,Pierre Samuel du Pont de Nemours,per,-----,PROPN,PROPN-PROPN-PROPN-PROPN-PROPN-PROPN,pobj,compound-compound-nmod-nmod-nmod-pobj,NNP,NNP-NNP-NNP-NNP-NNP-NNP,3,1
13159,12655.0,19,is,13,1,12,11,0,6,12,-1,Sonia Radeva,Bulgaria,org-org,,PROPN-PROPN,PROPN,compound-nsubj,pobj,NNP-NNP,NNP,2,1
13160,12658.0,33,began,2,12,26,14,11,6,-10,24,Death Row,Tupac Shakur,-,org-org,PROPN-PROPN,PROPN-PROPN,compound-compound,compound-pobj,NNP-NNP,NNP-NNP,8,1
13161,12659.0,64,Born,0,11,18,7,10,45,-11,18,Sheridan College,Oakville,per-per,,PROPN-PROPN,PROPN,compound-compound,compound,NNP-NNP,NNP,2,1
13162,12660.0,21,introduced,16,8,8,0,7,12,8,-8,Barry Orton,Barry,per-per,,PROPN-PROPN,PROPN,compound-dobj,compound,NNP-NNP,NNP,0,1
13163,12661.0,37,marked,7,24,30,6,23,6,-17,23,his,Chicago,per,,DET,PROPN,poss,nmod,PRP$,NNP,3,1
13164,12662.0,16,College,1,6,10,4,5,5,-5,9,Mizoram University,Aizawl,org-org,,PROPN-PROPN,PROPN,compound-compound,pobj,NNP-NNP,NNP,3,1
13165,12663.0,41,consisted,2,12,1,-11,11,39,-10,-1,Clem Curtis,The Foundations,-,per-per,PROPN-PROPN,DET-PROPN,compound-appos,det-pobj,NNP-NNP,DT-NNPS,4,1
13166,12664.0,23,Following,0,8,19,11,7,3,-8,19,27,Undergroove,org,,NUM,PROPN,nummod,pobj,CD,NNP,7,1
13167,12665.0,34,was,13,4,6,2,3,27,9,-7,Butt,26 August 1910,,per-per-per,PROPN,NUM-PROPN-NUM,nsubj,nummod-appos-nummod,NNP,CD-NNP-CD,2,1
13168,12666.0,24,owns,2,2,6,4,1,17,0,4,bank,Buffalo,,org,NOUN,PROPN,nsubj,compound,NN,NNP,2,1
13169,12667.0,32,proven,12,1,31,30,0,0,11,19,Fillon,France,org,,NOUN,PROPN,nsubj,pobj,NN,NNP,4,1
13170,12668.0,51,released,1,1,6,5,0,44,0,5,ROIR,Bad Brains,per,-,PROPN,PROPN-PROPN,nsubj,compound-pobj,NNP,NNP-NNP,2,1
13171,12669.0,36,approved,9,18,18,0,17,17,-9,9,Jim Pattison,Jim Pattison Group,org-org,--,PROPN-PROPN,PROPN-PROPN-PROPN,compound-compound,compound-compound-pobj,NNP-NNP,NNP-NNP-NNP,0,1
13172,12670.0,25,sold,5,10,4,-6,9,20,-5,-1,William S. Paley,Columbia Broadcasting System,--,per-per-per,PROPN-PROPN-PROPN,PROPN-PROPN-PROPN,compound-compound-pobj,compound-compound-pobj,NNP-NNP-NNP,NNP-NNP-NNP,4,1
13173,12672.0,15,is,5,2,14,12,1,0,3,9,airline,Dubai,per,,NOUN,PROPN,poss,pobj,NN,NNP,8,1
13174,12674.0,18,met,10,1,17,16,0,0,9,7,His,Netherlands,org,,DET,PROPN,poss,pobj,PRP$,NNP,-1,1
13175,12675.0,30,defined,2,6,21,15,5,8,-4,19,New Zealand,Department of the Prime Minister and Cabinet,-,per-per-per-per-per-per-per,PROPN-PROPN,PROPN-ADP-DET-PROPN-PROPN-CCONJ-PROPN,compound-compound,pobj-prep-det-compound-pobj-cc-compound,NNP-NNP,NNP-IN-DT-NNP-NNP-CC-NNP,8,1
13176,12677.0,39,teamed,9,3,14,11,2,24,6,5,David Hart,Next Generation Hart Foundation,per-per,---,PROPN-PROPN,PROPN-PROPN-PROPN-PROPN,compound-compound,compound-compound-compound-pobj,NNP-NNP,NNP-NNP-NNP-NNP,6,1
13177,12678.0,13,is,2,1,12,11,0,0,1,10,Cheltenham College,England,org-org,,PROPN-PROPN,PROPN,compound-nsubj,pobj,NNP-NNP,NNP,6,1
13178,12679.0,36,built,25,2,19,17,1,16,23,-6,Armstrong World Industries,Strip District,per-per-per,-,PROPN-PROPN-PROPN,PROPN-PROPN,compound-compound-pobj,compound-compound,NNP-NNP-NNPS,NNP-NNP,9,1
13179,12680.0,31,born,2,26,29,3,25,1,-24,27,Lawrence University,Appleton,-,per,PROPN-PROPN,PROPN,compound-conj,compound,NNP-NNP,NNP,2,1
13180,12681.0,28,include,3,3,8,5,2,19,0,5,Toorak,Loreto Mandeville Hall,per,--,PROPN,PROPN-PROPN-PROPN,pobj,compound-compound-compound,NNP,NNP-NNP-NNP,3,1
13181,12682.0,19,junior,2,5,14,9,4,4,-3,12,Metro Christian Academy,Oklahoma,org-org-org,,PROPN-PROPN-PROPN,PROPN,compound-compound-pobj,pobj,NNP-NNP-NNP,NNP,8,1
13182,12683.0,26,came,9,12,21,9,11,4,-3,12,Germany,Academy of Media Arts,per,---,PROPN,PROPN-ADP-PROPN-PROPN,pobj,nmod-prep-compound-pobj,NNP,NNP-IN-NNP-NNP,8,1
13183,12684.0,63,include,2,22,39,17,21,23,-20,37,National Oceanic and Atmospheric Administration,Susan Solomon,org-org-org-org-org,-,PROPN-PROPN-CCONJ-PROPN-PROPN,PROPN-PROPN,compound-conj-cc-compound-conj,compound-conj,NNP-NNP-CC-NNP-NNP,NNP-NNP,10,1
13184,12686.0,15,is,8,1,13,12,0,1,7,5,Ken Waddell,Manitoba,per-per,,PROPN-PROPN,PROPN,compound-nsubj,compound,NNP-NNP,NNP,4,1
13185,12687.0,22,tells,1,10,19,9,9,2,-9,18,Samyuktha Varma,Biju Menon,-,per-per,PROPN-PROPN,PROPN-PROPN,compound-appos,compound-appos,NNP-NNP,NNP-NNP,6,1
13186,12688.0,43,was,9,1,12,11,0,30,8,3,Kollwitz,German,org,,PROPN,ADJ,nsubj,amod,NNP,JJ,5,1
13187,12689.0,41,formed,23,5,19,14,4,21,18,-4,Thomas Cook Group,2007,org-org-org,,PROPN-PROPN-PROPN,NUM,compound-compound-compound,nummod,NNP-NNP-NNP,CD,7,1
13188,12690.0,30,include,12,14,22,8,13,7,-2,10,DJ,Ali Shaheed Muhammad,per,--,PROPN,PROPN-PROPN-PROPN,compound,compound-compound-conj,NNP,NNP-NNP-NNP,2,1
13189,12691.0,49,was,8,23,28,5,22,20,-15,20,Premier League,Sheffield Tigers,-,org-org,PROPN-PROPN,PROPN-PROPN,compound-compound,compound-pobj,NNP-NNP,NNP-NNP,2,1
13190,14272.0,30,is,8,20,23,3,19,6,-12,15,Premier League,Sheffield Tigers,org-org,-,PROPN-PROPN,PROPN-PROPN,compound-pobj,compound-compound,NNP-NNP,NNP-NNP,2,1
13191,12692.0,46,is,1,10,15,5,9,30,-9,14,Sonny Clark,Blue Note,org-org,-,PROPN-PROPN,PROPN-PROPN,compound-pobj,compound-compound,NNP-NNP,NNP-NNP,6,1
13192,12693.0,39,ceased,1,13,23,10,12,15,-12,22,Champion Aircraft,Wisconsin,org-org,,PROPN-PROPN,PROPN,compound-compound,pobj,NNP-NNP,NNP,5,1
13193,12694.0,22,Target,0,12,16,4,11,5,-12,16,UK,Bank of England,per,--,PROPN,PROPN-ADP-PROPN,pobj,pobj-prep-pobj,NNP,NNP-IN-NNP,3,1
13194,12695.0,54,is,14,1,22,21,0,31,13,8,Gary Duncan,The Brogues,-,org-org,PROPN-PROPN,DET-PROPN,compound-nsubj,det-pobj,NNP-NNP,DT-NNPS,4,1
13195,12696.0,26,Tarantino,2,11,14,3,10,11,-9,12,University of Pisa,Italy,per-per-per,,PROPN-ADP-PROPN,PROPN,pobj-prep-compound,pobj,NNP-IN-NNP,NNP,5,1
13196,12697.0,30,was,16,1,29,28,0,0,15,13,Charles Pierce Davey,Michigan,org-org-org,,PROPN-PROPN-PROPN,PROPN,compound-compound-nsubj,pobj,NNP-NNP-NNP,NNP,9,1
13197,12699.0,33,led,7,6,10,4,5,22,1,3,1800PetMeds,Robert C. Schweitzer,per,--,NUM,PROPN-PROPN-PROPN,npadvmod,compound-compound-compound,CD,NNP-NNP-NNP,5,1
13198,12700.0,35,seen,27,18,19,1,17,15,9,-8,Air Nelson,Nelson,per-per,,PROPN-PROPN,PROPN,compound-poss,compound,NNP-NNP,NNP,3,1
13199,12701.0,13,is,1,7,11,4,6,1,-6,10,Gallaher Group,Japan Tobacco,-,org-org,PROPN-PROPN,PROPN-PROPN,compound-compound,compound-pobj,NNP-NNP,NNP-NNP,3,1
13200,12705.0,58,started,1,1,16,15,0,41,0,15,Johan,Belgium,,org,PROPN,PROPN,nsubj,pobj,NNP,NNP,4,1
13201,12707.0,11,shifted,5,4,10,6,3,0,1,5,Seminary,Kakinada,,org,PROPN,PROPN,nsubjpass,pobj,NNP,NNP,2,1
13202,12708.0,30,formed,9,15,24,9,14,5,-6,15,Peter Christopherson,Psychic TV,per-per,-,PROPN-PROPN,PROPN-PROPN,compound-nsubj,compound-dobj,NNP-NNP,NNP-NNP,1,1
13203,12709.0,41,served,6,11,24,13,10,16,-5,18,Jersey City,Frank H. Eggers,-,per-per-per,PROPN-PROPN,PROPN-PROPN-PROPN,compound-compound,compound-compound-pobj,NNP-NNP,NNP-NNP-NNP,9,1
13204,12711.0,25,operated,20,9,9,0,8,15,11,-11,Ontario,Ontario Lottery and Gaming Corporation,org,----,PROPN,PROPN-PROPN-CCONJ-PROPN-PROPN,pobj,compound-pobj-cc-compound-conj,NNP,NNP-NNP-CC-NNP-NNP,0,1
13205,12712.0,45,built,10,1,5,4,0,39,9,-5,Foxconn,Hon Hai Precision Industry,org,---,PROPN,PROPN-PROPN-PROPN-PROPN,nsubj,compound-compound-compound-compound,NNP,NNP-NNP-NNP-NNP,3,1
13206,12714.0,30,trained,15,7,14,7,6,15,8,-1,Pacific Southwest Airlines,San Diego,per-per-per,-,PROPN-PROPN-PROPN,PROPN-PROPN,compound-compound-pobj,compound-pobj,NNP-NNP-NNPS,NNP-NNP,5,1
13207,12715.0,42,was,32,15,9,-6,14,32,17,-23,England,Isabella of France,,per-per-per,PROPN,PROPN-ADP-PROPN,pobj,pobj-prep-pobj,NNP,NNP-IN-NNP,5,1
13208,12716.0,21,recorded,7,4,19,15,3,1,3,12,John Lee Hooker,Chess,per-per-per,,PROPN-PROPN-PROPN,PROPN,compound-compound-compound,compound,NNP-NNP-NNP,NNP,9,1
13209,12718.0,34,is,10,2,4,2,1,29,8,-6,University of Colombo School of Computing,Colombo,-----,org,PROPN-ADP-PROPN-PROPN-ADP-PROPN,PROPN,nmod-prep-pobj-nsubj-prep-pobj,pobj,NNP-IN-NNP-NNP-IN-NNP,NNP,2,1
13210,12721.0,31,2011,4,14,15,1,13,15,-10,11,actress,Sevigny,per,,NOUN,PROPN,compound,conj,NN,NNP,1,1
13211,12723.0,58,said,35,15,19,4,14,38,20,-16,Vietnam,VPA,,org,PROPN,PROPN,compound,appos,NNP,NNP,2,1
13212,12725.0,27,said,11,14,17,3,13,9,-3,6,England,FDA,per,,PROPN,PROPN,nsubj,compound,NNP,NNP,2,1
13213,12727.0,21,kept,15,6,12,6,5,8,9,-3,Richard,Isabella of Valois,per,--,PROPN,PROPN-ADP-PROPN,compound,appos-prep-pobj,NNP,NNP-IN-NNP,7,1
13214,12728.0,30,collaborated,10,6,22,16,5,7,4,12,Virginia,Leroy Hutson,per,-,PROPN,PROPN-PROPN,pobj,compound-nsubj,NNP,NNP-NNP,6,1
13215,12729.0,14,Born,0,8,9,1,7,4,-8,9,Iran,Kasravi,org,,PROPN,PROPN,compound,nsubj,NNP,NNP,1,1
13216,12730.0,51,knows,34,9,29,20,8,21,25,-5,Serjical Strike,Tankian,-,per,PROPN-PROPN,PROPN,compound-compound,poss,NNP-NNP,NNP,5,1
13217,12731.0,28,relate,5,9,17,8,8,10,-4,12,Dubai World,Nakheel,org-org,,PROPN-PROPN,PROPN,compound-pobj,compound,NNP-NNP,NNP,7,1
13218,12734.0,27,opened,6,6,19,13,5,7,0,13,Tucson,Linda,per,,PROPN,PROPN,pobj,poss,NNP,NNP,5,1
13219,12735.0,26,found,17,14,16,2,13,9,3,-1,Fairport Convention,Richard Thompson,per-per,-,PROPN-PROPN,PROPN-PROPN,compound-compound,compound-nsubj,NNP-NNP,NNP-NNP,1,1
13220,12736.0,20,ran,14,3,12,9,2,7,11,-2,People's Action Party,Lee Kuan Yew,--,per-per-per,PROPN-PROPN-PROPN,PROPN-PROPN-PROPN,compound-compound-nsubj,compound-compound-pobj,NNP-NNP-NNP,NNP-NNP-NNP,6,1
13221,12738.0,27,merged,3,3,11,8,2,15,0,8,CTV,MCTV,,per,PROPN,PROPN,nsubj,compound,NNP,NNP,3,1
13222,12741.0,39,recruited,16,15,20,5,14,18,1,4,Hanoch,Nahal,org,,PROPN,PROPN,nsubjpass,compound,NNP,NNP,4,1
13223,12742.0,20,is,9,11,15,4,10,4,-2,6,Mark Durkan,Social Democratic and Labour Party,per-per,----,PROPN-PROPN,PROPN-PROPN-CCONJ-PROPN-PROPN,compound-attr,nmod-amod-cc-compound-pobj,NNP-NNP,NNP-NNP-CC-NNP-NNP,3,1
13224,12744.0,22,established,2,15,16,1,14,5,-13,14,King,William IV of the United Kingdom,org,-----,PROPN,PROPN-PROPN-ADP-DET-PROPN-PROPN,compound,compound-pobj-prep-det-compound-pobj,NNP,NNP-NNP-IN-DT-NNP-NNP,1,1
13225,12745.0,40,began,11,37,38,1,36,1,-26,27,Australia,Murray Gleeson,per,-,PROPN,PROPN-PROPN,compound,compound-pobj,NNP,NNP-NNP,1,1
13226,12747.0,35,grew,1,5,5,0,4,29,-4,4,Teaneck,Teaneck High School,org,--,PROPN,PROPN-PROPN-PROPN,compound,compound-compound-pobj,NNP,NNP-NNP-NNP,0,1
13227,12748.0,26,said,10,12,20,8,11,5,-2,10,Michael J. Long,Arrow Electronics,org-org-org,-,PROPN-PROPN-PROPN,PROPN-PROPN,compound-compound-nsubj,compound-pobj,NNP-NNP-NNP,NNP-NNP,4,1
13228,12749.0,29,have,5,23,27,4,22,1,-18,22,Great Wheel Corporation,Florian Bollen,per-per-per,-,PROPN-PROPN-PROPN,PROPN-PROPN,compound-compound-compound,compound-ccomp,NNP-NNP-NNP,NNP-NNP,2,1
13229,12750.0,34,connected,5,13,15,2,12,18,-8,10,Sweden,Sibel,,per,PROPN,PROPN,pobj,nsubj,NNP,NNP,1,1
13230,12752.0,27,Chafee,7,4,7,3,3,19,3,0,Rhode Island,Lincoln Chafee,-,org-org,PROPN-PROPN,PROPN-PROPN,compound-compound,compound-ROOT,NNP-NNP,NNP-NNP,2,1
13231,12753.0,21,shot,6,1,4,3,0,16,5,-2,Arkansas,Bill Gwatney,,per-per,PROPN,PROPN-PROPN,compound,compound-nsubjpass,NNP,NNP-NNP,2,1
13232,12755.0,38,said,17,8,32,24,7,5,9,15,England,Hurley,,org,PROPN,PROPN,compound,poss,NNP,NNP,14,1
13233,12756.0,29,be,6,20,28,8,19,0,-14,22,Frank Reed,America,per-per,,PROPN-PROPN,PROPN,compound-compound,pobj,NNP-NNP,NNP,8,1
13234,12757.0,26,fainted,9,23,24,1,22,1,-14,15,Japan,Kiichi Miyazawa,org,-,PROPN,PROPN-PROPN,pobj,compound-pobj,NNP,NNP-NNP,1,1
13235,12758.0,31,joined,19,17,22,5,16,8,2,3,Institute of Technology,National Collegiate Athletic Association,--,org-org-org-org,PROPN-ADP-PROPN,PROPN-PROPN-PROPN-PROPN,nsubj-prep-pobj,compound-compound-compound-dobj,NNP-IN-NNP,NNP-NNP-NNP-NNP,4,1
13236,12759.0,25,referred,6,1,24,23,0,0,5,18,Lyons Township High School,Illinois,per-per-per-per,,NOUN-PROPN-PROPN-PROPN,PROPN,compound-compound-compound-nsubj,pobj,NNS-NNP-NNP-NNP,NNP,3,1
13237,12760.0,26,elected,6,5,14,9,4,11,1,8,DeWine,Ohio,org,,PROPN,PROPN,nsubjpass,pobj,NNP,NNP,2,1
13238,12762.0,69,was,5,22,15,-7,21,53,-17,10,University of Valladolid,Valladolid,org-org-org,,PROPN-ADP-PROPN,PROPN,pobj-prep-pobj,pobj,NNP-IN-NNP,NNP,5,1
13239,12766.0,20,accepted,3,8,14,6,7,5,-5,11,Utrecht University,Biomolecular Mass Spectrometry and Proteomics Group,-,per-per-per-per-per-per,PROPN-PROPN,PROPN-PROPN-PROPN-CCONJ-PROPN-PROPN,compound-pobj,compound-compound-pobj-cc-compound-conj,NNP-NNP,NNP-NNP-NNP-CC-NNP-NNP,9,1
13240,12768.0,27,said,8,24,25,1,23,1,-16,17,president,Laurent Gbagbo,per,-,NOUN,PROPN-PROPN,compound,compound-pobj,NN,NNP-NNP,2,1
13241,12769.0,50,credited,4,38,42,4,37,7,-34,38,Haley,Buddah,per,,PROPN,PROPN,pobj,compound,NNP,NNP,6,1
13242,12770.0,74,are,2,37,49,12,36,24,-35,47,Phor Tay High School,Malaysia,per-per-per-per,,PROPN-PROPN-PROPN-PROPN,PROPN,compound-compound-compound-ROOT,pobj,NNP-NNP-NNP-NNP,NNP,-1,1
13243,12771.0,23,founded,3,2,6,4,1,16,1,3,1993,Safe Auto Insurance Company,org,---,NUM,PROPN-PROPN-PROPN-PROPN,pobj,compound-compound-compound-dative,CD,NNP-NNP-NNP-NNP,5,1
13244,12773.0,13,is,1,1,11,10,0,1,0,10,Unibanco,Paulo,org,,PROPN,PROPN,nsubj,compound,NNP,NNP,5,1
13245,12774.0,10,is,2,1,9,8,0,0,1,7,Aero Africa,Swaziland,per-per,,PROPN-PROPN,PROPN,compound-nsubj,pobj,NNP-NNP,NNP,2,1
13246,12775.0,24,represented,8,5,11,6,4,12,3,3,Wildcats,University of Arizona,org,--,PROPN,PROPN-ADP-PROPN,compound,dobj-prep-pobj,NNPS,NNP-IN-NNP,3,1
13247,12776.0,34,made,9,3,8,5,2,25,6,-1,she,Ernest Shipman,,org-org,PRON,PROPN-PROPN,nsubj,compound-nsubj,PRP,NNP-NNP,2,1
13248,12779.0,22,brought,4,9,18,9,8,3,-5,14,Atlantic,Wilson Pickett,per,-,PROPN,PROPN-PROPN,compound,compound-conj,NNP,NNP-NNP,3,1
13249,12782.0,26,is,8,1,7,6,0,18,7,-1,Bank,Poland,org,,PROPN,PROPN,appos,pobj,NNP,NNP,1,1
13250,12784.0,35,heard,7,1,13,12,0,21,6,6,Dom,Australia,,org,PROPN,PROPN,poss,compound,NNP,NNP,7,1
13251,12785.0,27,landed,10,2,4,2,1,22,8,-6,Free French,2nd Armored Division,-,per-per-per,ADJ-ADJ,NOUN-PROPN-PROPN,compound-compound,compound-compound-nsubj,JJ-JJ,NN-NNP-NNP,2,1
13252,12786.0,65,was,27,48,3,-45,47,61,-21,-24,Anneli,Finland,,per,PROPN,PROPN,advmod,pobj,NNPS,NNP,8,0
13253,12787.0,73,was,9,9,24,15,8,48,0,15,Afghanistan,Burhanuddin Rabbani,per,-,PROPN,PROPN-PROPN,pobj,compound-nsubj,NNP,NNP-NNP,3,0
13254,14180.0,33,were,2,15,20,5,14,12,-13,18,Afghanistan,Burhanuddin Rabbani,,per-per,PROPN,PROPN-PROPN,pobj,compound-conj,NNP,NNP-NNP,3,0
13255,12788.0,50,began,20,18,27,9,17,22,2,7,1st Cavalry Division,1 September 1984,org-org-org,--,PROPN-PROPN-PROPN,NUM-PROPN-NUM,pobj-compound-nsubj,nummod-pobj-nummod,NNP-NNP-NNP,CD-NNP-CD,7,0
13256,12789.0,29,is,10,9,23,14,8,5,1,13,Toronto,Princeton University,org,-,PROPN,PROPN-PROPN,pobj,compound-compound,NNP,NNP-NNP,7,0
13257,12791.0,38,titled,8,2,3,1,1,34,6,-5,172nd Infantry Brigade,Infantry Brigade,--,per-per,PROPN-PROPN-PROPN,PROPN-PROPN,compound-compound-nsubj,compound-nsubjpass,NNP-NNP-NNP,NNP-NNP,1,0
13258,12792.0,28,is,2,2,17,15,1,10,0,15,school,1869,,per,NOUN,NUM,nsubj,npadvmod,NN,CD,2,0
13259,12793.0,19,made,7,3,7,4,2,11,4,0,director,Lewis,,org,NOUN,PROPN,compound,nsubj,NN,NNP,1,0
13260,12794.0,22,gave,2,1,13,12,0,8,1,11,Alan Wilder,Depeche Mode,-,org-org,PROPN-PROPN,PROPN-PROPN,compound-nsubj,compound-compound,NNP-NNP,NNP-NNP,6,0
13261,12795.0,24,spent,10,15,23,8,14,0,-5,13,New World School of the Arts,Florida,per-per-per-per-per-per,,PROPN-PROPN-PROPN-ADP-DET-PROPN,PROPN,compound-compound-pobj-prep-det-pobj,pobj,NNP-NNP-NNP-IN-DT-NNPS,NNP,4,0
13262,12796.0,15,was,1,1,3,2,0,11,0,2,Chirac,Paris,org,,PROPN,PROPN,nsubj,compound,NNP,NNP,1,0
13263,12797.0,25,is,1,1,3,2,0,21,0,2,Knowledge,British Columbia,,per-per,PROPN,PROPN-PROPN,nsubj,compound-poss,NNP,NNP-NNP,2,0
13264,12798.0,21,born,2,1,10,9,0,10,1,8,Shaver,Canada,per,,PROPN,PROPN,nsubjpass,appos,NNP,NNP,6,0
13265,12799.0,23,is,13,1,10,9,0,12,12,-3,China,COSCO,org,,PROPN,PROPN,compound,pobj,NNP,NNP,6,0
13266,12800.0,15,born,2,7,12,5,6,2,-5,10,Kent,Kentridge High School,,org-org-org,PROPN,PROPN-PROPN-PROPN,compound,compound-compound-pobj,NNP,NNP-NNP-NNP,6,0
13267,12806.0,12,was,3,1,10,9,0,1,2,7,Woodham High School,Pensacola Florida,per-per-per,-,PROPN-PROPN-PROPN,PROPN-PROPN,compound-compound-nsubj,compound-pobj,NNP-NNP-NNP,NNP-NNP,6,0
13268,12807.0,44,was,6,4,5,1,3,38,2,-1,State,John Sherman,,org-org,PROPN,PROPN-PROPN,pobj,compound-nsubj,NNP,NNP-NNP,1,0
13269,12808.0,25,separated,11,3,9,6,2,15,8,-2,Kate Winslet,Sam Mendes,-,org-org,PROPN-PROPN,PROPN-PROPN,compound-nsubj,compound-conj,NNP-NNP,NNP-NNP,3,0
13270,12809.0,32,appointed,3,6,10,4,5,21,-3,7,Israel,Ehud Barak,,per-per,PROPN,PROPN-PROPN,poss,compound-pobj,NNP,NNP-NNP,3,0
13271,12810.0,24,stepped,11,1,8,7,0,15,10,-3,Abdel Aziz,High Council,-,per-per,PROPN-PROPN,PROPN-PROPN,compound-nsubj,compound-pobj,NNP-NNP,NNP-NNP,4,0
13272,12812.0,33,opened,14,6,9,3,5,23,8,-5,Royal London Hospital,England,--,per,PROPN-PROPN-PROPN,PROPN,compound-compound-compound,poss,NNP-NNP-NNP,NNP,2,0
13273,12813.0,56,described,10,7,10,3,6,45,3,0,Neiman Marcus,Texas,org-org,,PROPN-PROPN,PROPN,compound-nsubj,pobj,NNP-NNP,NNP,4,0
13274,12815.0,42,was,1,9,32,23,8,9,-8,31,Abigail Smith Adams,John Adams,per-per-per,-,PROPN-PROPN-PROPN,PROPN-PROPN,compound-compound-appos,compound-pobj,NNP-NNP-NNP,NNP-NNP,12,0
13275,12816.0,37,moved,5,8,14,6,7,22,-3,9,La Mesa,Helix High School,-,per-per-per,PROPN-PROPN,PROPN-PROPN-PROPN,compound-pobj,compound-compound-compound,NNP-NNP,NNP-NNP-NNP,9,0
13276,12817.0,16,regarded,3,1,15,14,0,0,2,12,He,Thailand,,per,PRON,PROPN,nsubjpass,pobj,PRP,NNP,2,0
13277,12818.0,26,left,3,7,11,4,6,14,-4,8,Al-Azhar University,Egypt,-,per,PROPN-PROPN,PROPN,compound-pobj,pobj,NNP-NNP,NNP,6,0
13278,12819.0,32,reported,28,4,28,24,3,3,24,0,Airbus,EADS,per,,PROPN,PROPN,appos,nsubj,NNP,NNP,2,0
13279,12821.0,50,ART-FASHION-FUSION,0,15,17,2,14,32,-15,17,Japanese,Takashi Murakami,,per-per,ADJ,PROPN-PROPN,amod,compound-appos,JJ,NNP-NNP,4,0
13280,12822.0,37,Based,0,6,10,4,5,26,-6,10,London,Jim Bob,per,-,PROPN,PROPN-PROPN,compound,compound-conj,NNP,NNP-NNP,7,0
13281,12827.0,31,showed,16,5,5,0,4,25,11,-11,Chapman University,Chapman College,-,per-per,PROPN-PROPN,PROPN-PROPN,compound-poss,compound-compound,NNP-NNP,NNP-NNP,0,0
13282,12830.0,24,named,8,5,10,5,4,13,3,2,Russian,Roudyk,,org,ADJ,PROPN,amod,oprd,JJ,NNP,2,0
13283,12831.0,29,purchased,15,2,9,7,1,19,13,-6,May Department Stores,Famous-Barr,--,org,PROPN-PROPN-PROPN,PROPN,compound-compound-compound,nmod,NNP-NNP-NNPS,NNP,5,0
13284,12832.0,15,is,2,11,14,3,10,0,-9,12,Jugnauth,Mauritius,org,,PROPN,PROPN,compound,pobj,NNP,NNP,5,0
13285,12834.0,24,achieved,7,2,7,5,1,16,5,0,Tribhuvan University,Shrestha,per-per,,PROPN-PROPN,PROPN,compound-pobj,nsubj,NNP-NNP,NNP,2,0
13286,12835.0,31,tell,6,2,5,3,1,25,4,-1,Levy Mwanawasa,Zambia,-,per,PROPN-PROPN,PROPN,compound-nsubj,pobj,NNP-NNP,NNP,2,0
13287,13762.0,28,raised,4,20,25,5,19,2,-16,21,Levy Mwanawasa,Zambia,per-per,,PROPN-PROPN,PROPN,compound-appos,dobj,NNP-NNP,NNP,1,0
13288,14069.0,18,said,4,3,9,6,2,8,1,5,Levy Mwanawasa,Zambia,org-org,,PROPN-PROPN,PROPN,compound-nsubj,nsubj,NNP-NNP,NNP,2,0
13289,12836.0,26,started,4,3,20,17,2,5,1,16,1906,Kellogg Company,,per-per,NUM,PROPN-PROPN,pobj,compound-attr,CD,NNP-NNP,5,0
13290,12837.0,49,invest,2,1,28,27,0,20,1,26,ZTE,Hou Weigui,org,-,PROPN,PROPN-PROPN,nsubj,compound-appos,NNP,NNP-NNP,7,0
13291,12839.0,21,moved,8,2,16,14,1,4,6,8,he,Kansas,per,,PRON,PROPN,nsubj,pobj,PRP,NNP,4,0
13292,12841.0,40,started,1,27,34,7,26,5,-26,33,Michael Somare,Prime Minister,-,org-org,PROPN-PROPN,PROPN-PROPN,compound-pobj,compound-attr,NNP-NNP,NNP-NNP,2,0
13293,12843.0,29,were,21,1,13,12,0,15,20,-8,Marilyn,Kingston,per,,PROPN,PROPN,compound,compound,NNP,NNP,4,0
13294,12844.0,27,extradited,7,4,10,6,3,16,3,3,Alberto Fujimori,Peru,-,org,PROPN-PROPN,PROPN,compound-nsubjpass,pobj,NNP-NNP,NNP,2,0
13295,12845.0,67,shown,6,46,49,3,45,17,-40,43,Once TV,Mexico,org-org,,ADP-NOUN,PROPN,advmod-conj,compound,IN-NN,NNP,8,0
13296,12846.0,24,published,2,7,16,9,6,7,-5,14,ASCII Media Works,Dengeki Daioh,--,per-per,PROPN-PROPN-VERB,PROPN-PROPN,compound-compound-pobj,compound-appos,NNP-NNP-VBZ,NNP-NNP,6,0
13297,12849.0,19,F.C.,2,1,18,17,0,0,1,16,Aberystwyth University,Wales,org-org,,PROPN-PROPN,PROPN,compound-compound,pobj,NNP-NNP,NNP,3,0
13298,12850.0,17,born,2,9,9,0,8,7,-7,7,Groton,Groton School,per,-,PROPN,PROPN-PROPN,compound,compound-pobj,NNP,NNP-NNP,0,0
13299,12851.0,18,buried,2,12,14,2,11,3,-10,12,George,Martha Washington,,per-per,PROPN,PROPN-PROPN,poss,compound-conj,NNP,NNP-NNP,3,0
13300,12852.0,28,sent,7,5,10,5,4,17,2,3,Lou Henry Hoover,Herbert Hoover,--,per-per,PROPN-PROPN-PROPN,PROPN-PROPN,compound-compound-pobj,compound-dobj,NNP-NNP-NNP,NNP-NNP,5,0
13301,12854.0,46,Jaros?aw,0,15,21,6,14,24,-15,21,he University of Bia?ys,in Bia?y,org-org-org-org,-,PRON-PROPN-ADP-PROPN,ADP-ADJ,nmod-pobj-prep-pobj,prep-pobj,PRP-NNP-IN-NNP,IN-JJ,4,0
13302,12856.0,17,dropped,2,11,16,5,10,0,-9,14,airline,1988,per,,NOUN,NUM,nsubj,nummod,NN,CD,1,0
13303,12858.0,28,declared,7,11,27,16,10,0,-4,20,Gould,Maine,org,,PROPN,PROPN,poss,pobj,NNP,NNP,6,0
13304,12859.0,23,meet,15,10,14,4,9,8,5,-1,Germany,Willi Stoph,,org-org,PROPN,PROPN-PROPN,conj,compound-conj,NNP,NNP-NNP,2,0
13305,12861.0,19,is,8,1,14,13,0,4,7,6,Dorce Gamalama,singer,org-org,,PROPN-PROPN,NOUN,compound-nsubj,compound,NNP-NNP,NN,3,0
13306,12862.0,25,represent,9,4,12,8,3,12,5,3,Cincinnati Bearcats,University of Cincinnati,org-org,--,PROPN-PROPN,PROPN-ADP-PROPN,nmod-nmod,dobj-prep-pobj,NNP-NNPS,NNP-IN-NNP,3,0
13307,12863.0,28,was,17,5,7,2,4,20,12,-10,UPN,The CW Television Network,,per-per-per-per,PROPN,DET-PROPN-PROPN-PROPN,pobj,det-compound-compound-pobj,NNP,DT-NNP-NNP-NNP,2,0
13308,12864.0,21,represents,7,3,15,12,2,5,4,8,James Madison University,NCAA,per-per-per,,PROPN-PROPN-PROPN,PROPN,compound-compound-dobj,compound,NNP-NNP-NNP,NNP,4,0
13309,14011.0,24,represented,9,4,18,14,3,5,5,9,James Madison University,NCAA,--,per,PROPN-PROPN-PROPN,PROPN,compound-compound-dobj,compound,NNP-NNP-NNP,NNP,6,0
13310,12865.0,105,1991,0,54,82,28,53,22,-54,82,ECW,Eddie Guerrero,,per-per,PROPN,PROPN-PROPN,nsubj,compound-compound,NNP,NNP-NNP,5,0
13311,12866.0,52,signed,9,8,12,4,7,39,1,3,Childs,Records,org,,PROPN,PROPN,pobj,pobj,NNP,NNPS,2,0
13312,12867.0,56,count,45,5,13,8,4,42,40,-32,9th Bomb Group,25 February 1942,--,per-per-per,ADJ-PROPN-PROPN,NUM-PROPN-NUM,compound-compound-pobj,nummod-pobj-nummod,JJ-NNP-NNP,CD-NNP-CD,7,0
13313,12870.0,25,returned,3,6,11,5,5,13,-3,8,Turkey,Turkish Airlines,per,-,PROPN,PROPN-PROPN,pobj,compound-pobj,NNP,NNP-NNPS,4,0
13314,12871.0,43,contacted,37,16,23,7,15,19,21,-14,Liverpool,Brian Epstein,,per-per,PROPN,PROPN-PROPN,compound,compound-nsubj,NNP,NNP-NNP,5,0
13315,12872.0,28,voted,3,1,9,8,0,18,2,6,Iceland,Geir,org,,PROPN,PROPN,poss,dobj,NNP,NNP,4,0
13316,12873.0,36,limited,12,5,26,21,4,9,7,14,MSUFCU,Michigan,,org,PROPN,PROPN,compound,compound,NNP,NNP,9,0
13317,12879.0,31,made,2,10,19,9,9,11,-8,17,Football League,Rangers,org-org,,PROPN-PROPN,PROPN,compound-pobj,conj,NNP-NNP,NNP,7,0
13318,12880.0,26,travelled,3,6,9,3,5,16,-3,6,London,Attenborough,per,,PROPN,PROPN,pobj,dobj,NNP,NNP,3,0
13319,12882.0,20,said,1,14,19,5,13,0,-13,18,university,Beijing,per,,NOUN,PROPN,pobj,pobj,NN,NNP,5,0
13320,12886.0,34,is,9,1,8,7,0,25,8,-1,Colette Mann,Australia,-,per,PROPN-PROPN,PROPN,compound-nsubj,pobj,NNP-NNP,NNP,1,0
13321,12888.0,29,player,4,16,19,3,15,9,-12,15,Ontario,Weeping Tile,org,-,PROPN,PROPN-PROPN,compound,compound-compound,NNP,NNP-NNP,7,0
13322,12892.0,15,decided,4,11,12,1,10,2,-7,8,Defense,Charles Erwin Wilson,per,--,PROPN,PROPN-PROPN-PROPN,pobj,compound-compound-pobj,NNP,NNP-NNP-NNP,2,0
13323,12893.0,39,Kallasvuo,2,1,2,1,0,36,1,0,CEO,Olli-Pekka Kallasvuo,,per-per,PROPN,PROPN-PROPN,compound,compound-ROOT,NNP,NNP-NNP,2,0
13324,12894.0,31,was,11,19,29,10,18,1,-8,18,Ontario,Cineplex Odeon,per,-,PROPN,PROPN-PROPN,pobj,compound-pobj,NNP,NNP-NNP,5,0
13325,12896.0,30,started,2,10,12,2,9,17,-8,10,SDRC,Structural Dynamics Research Corporation,org,---,PROPN,PROPN-PROPN-PROPN-PROPN,conj,compound-compound-compound-ROOT,NNP,NNP-NNPS-NNP-NNP,2,0
13326,12902.0,20,struggled,11,4,10,6,3,9,7,-1,Southeastern Conference,Georgia Bulldogs,org-org,-,PROPN-PROPN,PROPN-PROPN,compound-compound,compound-nsubj,NNP-NNP,NNP-NNPS,5,0
13327,12905.0,34,announced,14,5,12,7,4,21,9,-2,Harris Bankcorp Inc.,Bank of Montreal,--,per-per-per,PROPN-PROPN-PROPN,PROPN-ADP-PROPN,compound-compound-pobj,pobj-prep-pobj,NNP-NNP-NNP,NNP-IN-NNP,5,0
13328,12907.0,41,issued,8,7,23,16,6,17,1,15,Dana Cohen,Banana Republic,-,per-per,PROPN-PROPN,PROPN-PROPN,compound-nsubj,compound-dobj,NNP-NNP,NNP-NNP,6,0
13329,12909.0,33,aims,5,17,30,13,16,2,-12,25,Quebec,separatist Bloc Quebecois,per,--,PROPN,ADJ-PROPN-PROPN,pobj,pobj-compound-appos,NNP,JJ-NNP-NNP,10,0
13330,12910.0,45,said,16,23,29,6,22,15,-7,13,Movement for Democratic Change,Arthur Mutambara,---,org-org,PROPN-ADP-PROPN-PROPN,PROPN-PROPN,pobj-prep-compound-pobj,compound-compound,NNP-IN-NNP-NNP,NNP-NNP,8,0
13331,13011.0,29,mediating,3,12,27,15,11,1,-9,24,Movement for Democratic Change,Arthur Mutambara,---,per-per,PROPN-ADP-ADJ-PROPN,PROPN-PROPN,pobj-prep-compound-compound,compound-appos,NNP-IN-JJ-NNP,NNP-NNP,4,0
13332,12912.0,53,was,5,19,34,15,18,18,-14,29,Benesh Movement Notation,Balanchine,--,per,PROPN-PROPN-PROPN,PROPN,compound-compound-pobj,nsubj,NNP-NNP-NNP,NNP,-1,0
13333,12913.0,27,won,4,2,9,7,1,17,2,5,Sioux Falls Storm,UIF,--,org,PROPN-PROPN-PROPN,PROPN,compound-compound-nsubj,compound,NNP-NNP-NNP,NNP,3,0
13334,12914.0,14,attended,5,7,7,0,6,6,-2,2,London Central Secondary School,London,---,per,PROPN-PROPN-PROPN-PROPN,PROPN,compound-compound-compound-dobj,compound,NNP-NNP-NNP-NNP,NNP,0,0
13335,13600.0,20,located,5,1,1,0,0,18,4,-4,London Central Secondary School,London,per-per-per-per,,PROPN-PROPN-PROPN-PROPN,PROPN,compound-compound-compound-nsubjpass,compound,NNP-NNP-NNP-NNP,NNP,0,0
13336,12916.0,23,participate,2,2,6,4,1,16,0,4,Falcons,Division I,per,-,PROPN,PROPN-PROPN,nsubj,pobj-dobj,NNPS,NNP-NNP,2,0
13337,12917.0,31,met,8,11,20,9,10,10,-3,12,Arlington,Martin High School,per,--,PROPN,PROPN-PROPN-PROPN,compound,compound-compound-pobj,NNP,NNP-NNP-NNP,7,0
13338,12918.0,61,is,4,3,13,10,2,47,1,9,Gordon Lightfoot,Canada,org-org,,PROPN-PROPN,PROPN,compound-nsubj,pobj,NNP-NNP,NNP,3,0
13339,12919.0,28,Bouzar,1,8,26,18,7,1,-7,25,stagenam,Algiers,per,,NOUN,PROPN,pobj,compound,NN,NNP,9,0
13340,12920.0,36,seen,7,20,25,5,19,10,-13,18,Social Democrats,Hans Hedtoft,-,org-org,PROPN-PROPN,PROPN-PROPN,compound-pobj,compound-appos,NNP-NNPS,NNP-NNP,10,0
13341,12921.0,29,takes,1,12,19,7,11,9,-11,18,Gellar,New York City,org,--,PROPN,PROPN-PROPN-PROPN,appos,compound-compound-pobj,NNP,NNP-NNP-NNP,8,0
13342,12922.0,16,says,1,1,14,13,0,1,0,13,McCain,Republican,per,,PROPN,PROPN,nsubj,compound,NNP,NNP,6,0
13343,12923.0,61,included,3,44,48,4,43,12,-41,45,Ellen DeGeneres,Portia de Rossi,per-per,--,PROPN-PROPN,PROPN-PROPN-PROPN,compound-pobj,nmod-nmod-compound,NNP-NNP,NNP-NNP-NNP,3,0
13344,12926.0,28,Under,0,10,12,2,9,15,-10,12,Foreign Affairs,Luis Ernesto Derbez,per-per,--,PROPN-PROPN,PROPN-PROPN-PROPN,compound-pobj,compound-compound-nsubjpass,NNP-NNPS,NNP-NNP-NNP,1,0
13345,12927.0,35,said,4,22,23,1,21,11,-18,19,Mayor,Ma Ying-jeou,per,-,PROPN,PROPN-VERB,compound,compound-conj,NNP,NNP-VBD,2,0
13346,12928.0,38,faced,2,1,22,21,0,15,1,20,Ali Khan,Pakistan,per-per,,PROPN-PROPN,PROPN,compound-nsubj,conj,NNP-NNP,NNP,3,0
13347,12930.0,48,moved,6,16,34,18,15,13,-10,28,Dublin,Gabriel Byrne,,per-per,PROPN,PROPN-PROPN,pobj,compound-appos,NNP,NNP-NNP,8,0
13348,12932.0,38,set,22,12,37,25,11,0,10,15,Warhammer Records,D-Rok,-,per,PROPN-PROPN,NOUN,compound-appos,conj,NNP-NNPS,NN,12,0
13349,12934.0,33,was,11,1,25,24,0,7,10,14,Bernard J. Berry,Jersey City,--,org-org,PROPN-PROPN-PROPN,PROPN-PROPN,compound-compound-nsubj,compound-compound,NNP-NNP-NNP,NNP-NNP,9,0
13350,12936.0,11,has,4,2,10,8,1,0,2,6,National Airlines,Florida,-,per,PROPN-PROPN,PROPN,compound-compound,pobj,NNP-NNP,NNP,3,0
13351,12937.0,58,jpg,0,9,18,9,8,39,-9,18,Amrita Sher-Gil,India,per-per,,PROPN-PROPN,PROPN,compound-nsubj,poss,NNP-NNP,NNP,-1,0
13352,12938.0,65,question,3,6,49,43,5,15,-3,46,Lin Biao,Communist Party of China,org-org,---,PROPN-PROPN,PROPN-PROPN-ADP-PROPN,compound-nsubj,compound-pobj-prep-pobj,NNP-NNP,NNP-NNP-IN-NNP,-1,0
13353,12940.0,18,owned,4,7,13,6,6,4,-3,9,East Midlands Newspapers Ltd.,Johnston Press,org-org-org-org,-,PROPN-PROPN-PROPN-PROPN,PROPN-PROPN,compound-compound-compound-compound,compound-compound,NNP-NNP-NNPS-NNP,NNP-NNP,5,0
13354,12941.0,40,found,4,22,28,6,21,11,-18,24,Whig,William Henry Harrison,org,--,PROPN,PROPN-PROPN-PROPN,nmod,compound-compound-dobj,NNP,NNP-NNP-NNP,4,0
13355,12942.0,40,said,8,1,7,6,0,32,7,-1,Duncan Niederauer,NYSE Euronext,per-per,-,PROPN-PROPN,PROPN-PROPN,compound-nmod,compound-pobj,NNP-NNP,NNP-NNP,3,0
13356,12943.0,8,born,2,1,7,6,0,0,1,5,Musgrave,Germany,,per,PROPN,PROPN,nsubjpass,pobj,NNP,NNP,4,0
13357,12944.0,24,witnessed,6,5,6,1,4,17,1,0,Vienna,Seitz,,per,PROPN,PROPN,compound,pobj,NNP,NNP,4,0
13358,12946.0,15,said,6,1,5,4,0,9,5,-1,RCTV,Marcel Granier,org,-,PROPN,PROPN-PROPN,poss,compound-appos,NNP,NNP-NNP,4,0
13359,12947.0,45,published,29,8,10,2,7,34,21,-19,Environment,Alfonso Pecoraro Scanio,,org-org-org,PROPN,PROPN-PROPN-PROPN,compound,compound-compound-compound,NNP,NNP-NNP-NNP,1,0
13360,12948.0,22,shows,2,13,18,5,12,3,-11,16,Emma,Ethelred the Unready,,org-org-org,PROPN,PROPN-DET-PROPN,poss,pobj-det-appos,NNP,NNP-DT-NNP,6,0
13361,12949.0,13,considered,2,9,11,2,8,1,-7,9,singer,Ahmed Rushdi,org,-,NOUN,PROPN-PROPN,attr,compound-pobj,NN,NNP-NNP,1,0
13362,12951.0,71,removed,2,30,37,7,29,33,-28,35,f Romani,g Grigore Preoteas,org-org,--,X-PROPN,PROPN-PROPN-PROPN,det-nsubj,det-compound-dobj,XX-NNP,NNP-NNP-NNP,3,0
13363,12952.0,42,forced,9,12,41,29,11,0,-3,32,company,Vermont,per,,NOUN,PROPN,dobj,pobj,NN,NNP,7,0
13364,12955.0,37,joined,1,8,18,10,7,18,-7,17,Lincoln,Division,,per,PROPN,PROPN,compound,pobj,NNP,NNP,3,0
13365,12956.0,17,are,10,3,4,1,2,12,7,-6,Surya,Sivakumar,,per,PROPN,PROPN,compound,compound,NNP,NNP,1,0
13366,12957.0,16,became,3,2,3,1,1,12,1,0,Indiana,he,per,,PROPN,PRON,pobj,nsubj,NNP,PRP,1,0
13367,12958.0,23,Before,0,5,9,4,4,13,-5,9,Division I,UNC,per-per,,PROPN-NUM,PROPN,pobj-ROOT,nsubj,NNP-CD,NNP,4,0
13368,12959.0,28,issued,19,17,18,1,16,9,2,-1,France,Jean-Pierre Raffarin,,per-per,PROPN,PROPN-PROPN,pobj,compound-nsubj,NNP,NNP-NNP,2,0
13369,12960.0,50,inaugurated,3,31,49,18,30,0,-28,46,Edgar Faure,France,-,per,PROPN-PROPN,PROPN,nmod-nmod,pobj,NNP-NNP,NNP,3,0
13370,12962.0,22,failed,4,7,8,1,6,13,-3,4,Henry Ford,Ford Motor Company,org-org,--,PROPN-PROPN,PROPN-PROPN-PROPN,compound-nsubj,compound-compound-compound,NNP-NNP,NNP-NNP-NNP,1,0
13371,12963.0,14,inducted,2,1,7,6,0,6,1,5,He,American,org,,PRON,PROPN,nsubjpass,compound,PRP,NNP,4,0
13372,12965.0,82,established,2,33,40,7,32,41,-31,38,Philippines,Central Philippine University,org,--,PROPN,PROPN-PROPN-PROPN,pobj,compound-compound-pobj,NNPS,NNP-NNP-NNP,5,0
13373,12966.0,29,became,2,1,13,12,0,15,1,11,He,New York City,org,--,PRON,PROPN-PROPN-PROPN,nsubj,compound-compound-compound,PRP,NNP-NNP-NNP,8,0
13374,12967.0,28,became,6,2,23,21,1,4,4,17,Ukraine,Yuriy Yekhanurov,per,-,PROPN,PROPN-PROPN,poss,compound-conj,NNP,NNP-NNP,5,0
13375,12968.0,28,labeled,8,1,6,5,0,21,7,-2,Guillermo Ortiz,Bank,org-org,,PROPN-PROPN,PROPN,compound-compound,pobj,NNP-NNP,NNP,4,0
13376,12969.0,15,saw,1,6,13,7,5,1,-5,12,Marist College Ashgrove,Brother Ignatius,--,per-per,PROPN-PROPN-PROPN,PROPN-PROPN,compound-compound-pobj,compound-appos,NNP-NNP-NNP,NNP-NNP,6,0
13377,12971.0,43,said,26,28,33,5,27,9,-2,7,Billy Ho,Mitac,-,org,PROPN-PROPN,PROPN,compound-nsubj,compound,NNP-NNP,NNP,3,0
13378,12973.0,17,has,3,1,10,9,0,6,2,7,Emmaus Bible College,USA,org-org-org,,PROPN-PROPN-PROPN,PROPN,compound-compound-nsubj,compound,NNP-NNP-NNP,NNP,6,0
13379,12974.0,34,played,26,14,19,5,13,14,12,-7,LNFA,L'Hospitalet Pioners,,per-per,PROPN,PROPN-PROPN,compound,compound-compound,NNP,NNP-NNPS,4,0
13380,12976.0,27,derived,6,5,14,9,4,12,1,8,Viro,Lennart Meri,,per-per,PROPN,PROPN-PROPN,pobj,compound-pobj,NNP,NNP-NNP,5,0
13381,12977.0,52,was,17,36,50,14,35,1,-19,33,Guinea-Bissau,Bernardo Vieira,,per-per,PROPN,PROPN-PROPN,pobj,compound-pobj,NNP,NNP-NNP,8,0
13382,12978.0,41,was,11,14,3,-11,13,37,-3,-8,East Tamaki,Fisher Paykel,-,org-org,PROPN-PROPN,PROPN-PROPN,compound-compound,compound-dobj,NNP-NNP,NNP-NNP,5,0
13383,12980.0,49,continued,3,39,38,-1,38,10,-36,35,London,ITV plc,org,-,PROPN,PROPN-NOUN,compound,compound-compound,NNP,NNP-NN,1,0
13384,12981.0,17,co-founded,1,3,6,3,2,10,-2,5,comScore,1999,org,,PROPN,NUM,compound,pobj,NNP,CD,3,0
13385,12982.0,48,was,1,10,18,8,9,29,-9,17,CTI,Hubbard,per,,PROPN,PROPN,compound,poss,NNP,NNP,11,0
13386,12983.0,26,is,7,12,15,3,11,10,-5,8,Agriculture and Agri-Food Canada,Canada,---,org,PROPN-CCONJ-PROPN-PROPN,PROPN,pobj-cc-compound-poss,pobj,NNP-CC-NNP-NNP,NNP,4,0
13387,12984.0,54,established,10,2,18,16,1,35,8,8,Stone Temple Pilots,Scott Weiland,per-per-per,-,PROPN-PROPN-PROPN,PROPN-PROPN,compound-compound-nsubj,compound-dobj,NNP-NNP-NNPS,NNP-NNP,5,0
13388,12985.0,31,left,3,2,17,15,1,13,1,14,Gus G.,Firewind,-,per,PROPN-PROPN,PROPN,compound-nsubj,nsubjpass,NNP-NNP,NNP,8,0
13389,12986.0,40,said,26,28,36,8,27,3,-2,10,Mike Leavitt,Health and Human Services,org-org,---,PROPN-PROPN,PROPN-CCONJ-PROPN-PROPN,compound-compound,pobj-cc-compound-conj,NNP-NNP,NNP-CC-NNP-NNPS,6,0
13390,12987.0,28,agreed,3,7,7,0,6,20,-4,4,Trinidad and Tobago,Trinidad and Tobago national football team,per-per-per,-----,PROPN-CCONJ-PROPN,PROPN-CCONJ-PROPN-ADJ-NOUN-NOUN,dobj-cc-conj,pobj-cc-nmod-amod-compound-conj,NNP-CC-NNP,NNP-CC-NNP-JJ-NN-NN,0,0
13391,12991.0,18,said,3,8,9,1,7,8,-5,6,Parliament,Nino Burjanadze,,org-org,PROPN,PROPN-PROPN,pobj,compound-appos,NNP,NNP-NNP,1,0
13392,13695.0,35,said,4,1,3,2,0,31,3,-1,Parliament,Nino Burjanadze,,per-per,NOUN,PROPN-PROPN,compound,compound-nsubj,NN,NNP-NNP,1,0
13393,12992.0,26,graduated,1,21,25,4,20,0,-20,24,Central European University,Budapest,--,per,PROPN-PROPN-PROPN,PROPN,compound-compound-pobj,pobj,NNP-NNP-NNP,NNP,5,0
13394,12993.0,34,was,16,5,11,6,4,22,11,-5,Johnson,Texas,per,,PROPN,PROPN,poss,pobj,NNP,NNP,5,0
13395,12994.0,30,suffered,15,9,12,3,8,17,6,-3,his,Tasmania,,per,DET,PROPN,poss,pobj,PRP$,NNP,3,0
13396,12996.0,35,known,3,6,27,21,5,7,-3,24,Italy,Italia 1,,per-per,PROPN,PROPN-NUM,pobj,oprd-nummod,NNP,NNP-CD,6,0
13397,12997.0,34,added,2,24,28,4,23,5,-22,26,Islamic State of Iraq,Abu Omar al-Baghdadi,---,per-per-per,PROPN-PROPN-ADP-PROPN,PROPN-PROPN-VERB,compound-nmod-prep-pobj,compound-compound-nmod,NNP-NNP-IN-NNP,NNP-NNP-VBZ,3,0
13398,12998.0,18,led,2,13,17,4,12,0,-11,15,Chas Chandler,manager,-,org,PROPN-PROPN,NOUN,compound-conj,pobj,NNP-NNP,NN,6,0
13399,12999.0,32,houses,2,5,31,26,4,0,-3,29,Chinese University of Hong Kong,China,org-org-org-org-org,,PROPN-PROPN-ADP-PROPN-PROPN,PROPN,compound-nmod-prep-compound-pobj,pobj,NNP-NNP-IN-NNP-NNP,NNP,12,0
13400,13000.0,30,founded,2,10,19,9,9,10,-8,17,Symbiosis International University,UGC,per-per-per,,PROPN-PROPN-PROPN,PROPN,compound-compound-pobj,compound,NNP-NNP-NNP,NNP,8,0
13401,13001.0,40,launched,20,29,35,6,28,4,-9,15,sassination o,Prime M,-,org-org,NOUN-NOUN,PROPN-PROPN,pobj-pobj,compound-compound,NN-NN,NNP-NNP,-1,0
13402,13005.0,20,Silajd?i?,7,6,10,4,5,9,1,3,Presidency,nd ?eljko,,per-per,PROPN,NOUN-NOUN,compound,dobj-punct,NNP,NN-NN,-1,0
13403,13006.0,17,is,2,9,13,4,8,3,-7,11,Shantou University,China,per-per,,PROPN-PROPN,PROPN,compound-pobj,poss,NNP-NNP,NNP,4,0
13404,13007.0,20,received,5,2,5,3,1,14,3,0,Minister,Mastella,per,,PROPN,PROPN,nmod,nsubj,NNP,NNP,3,0
13405,13008.0,25,son,1,3,19,16,2,5,-2,18,Roger Sherman,Connecticut,-,per,PROPN-PROPN,PROPN,compound-compound,compound,NNP-NNP,NNP,6,0
13406,13009.0,17,is,3,1,16,15,0,0,2,13,Delta Air Lines,1924,per-per-per,,PROPN-PROPN-PROPN,NUM,compound-compound-nsubj,pobj,NNP-NNP-NNP,CD,3,0
13407,13010.0,22,paved,10,6,9,3,5,12,4,-1,Fania,Seguida,org,,PROPN,PROPN,compound,nsubj,NNP,NNP,6,0
13408,13013.0,37,is,20,4,4,0,3,32,16,-16,Northern Football League,Northern League,per-per-per,-,PROPN-PROPN-PROPN,PROPN-PROPN,compound-compound-compound,compound-pobj,NNP-NNP-NNP,NNP-NNP,0,0
13409,13014.0,28,constructed,2,14,20,6,13,7,-12,18,Navy Midshipmen,United States Naval Academy,-,per-per-per-per,PROPN-PROPN,PROPN-PROPN-PROPN-PROPN,compound-compound,compound-compound-compound-pobj,NNP-NNP,NNP-NNP-NNP-NNP,4,0
13410,13174.0,25,represented,8,4,11,7,3,13,4,3,Navy Midshipmen,United States Naval Academy,org-org,---,PROPN-PROPN,PROPN-PROPN-PROPN-PROPN,compound-compound,compound-compound-compound-dobj,NNP-NNP,NNP-NNP-NNP-NNP,6,0
13411,13015.0,34,work,14,13,30,17,12,3,1,16,Spain,ECB,,per,PROPN,PROPN,conj,compound,NNP,NNP,6,0
13412,13016.0,23,lasted,11,6,18,12,5,4,5,7,singer,his,,org,NOUN,DET,pobj,poss,NN,PRP$,7,0
13413,13018.0,29,elected,9,1,6,5,0,22,8,-3,Nouri al-Maliki,Islamic Dawa Party,-,per-per-per,PROPN-PROPN,PROPN-PROPN-PROPN,compound-nsubjpass,compound-compound-pobj,NNP-NNP,NNP-NNP-NNP,4,0
13414,13019.0,48,are,1,21,23,2,20,24,-20,22,France,EDF Energy,per,-,PROPN,PROPN-PROPN,poss,compound-compound,NNP,NNP-NNP,3,0
13415,13020.0,9,performs,3,1,2,1,0,6,2,-1,Singer,Jamie Cullum,,per-per,PROPN,PROPN-PROPN,compound,compound-nsubj,NNP,NNP-NNP,1,0
13416,13021.0,60,played,13,56,59,3,55,0,-43,46,Stephen Wolfram,Caltech,org-org,,PROPN-PROPN,PROPN,compound-pobj,pobj,NNP-NNP,NNP,15,0
13417,13022.0,38,based,3,2,11,9,1,26,1,8,SANDF,South African Army,per,--,PROPN,ADJ-ADJ-PROPN,nsubjpass,amod-compound-compound,NNP,JJ-JJ-NNP,8,0
13418,13023.0,53,treated,4,24,27,3,23,25,-20,23,George Kenney,Fifth Air Force,per-per,--,PROPN-PROPN,PROPN-PROPN-PROPN,compound-poss,compound-compound-compound,NNP-NNP,NNP-NNP-NNP,4,0
13419,13024.0,31,attempts,6,10,30,20,9,0,-4,24,him,Indonesia,,per,PRON,PROPN,dobj,pobj,PRP,NNP,3,0
13420,13025.0,30,reassigned,4,9,12,3,8,17,-5,8,John Pope,Army of Virginia,-,org-org-org,PROPN-PROPN,PROPN-ADP-PROPN,compound-poss,pobj-prep-pobj,NNP-NNP,NNP-IN-NNP,2,0
13421,13026.0,35,founded,3,1,15,14,0,19,2,12,Geneva College,Beaver Falls,-,per-per,PROPN-PROPN,PROPN-PROPN,compound-nsubjpass,compound-pobj,NNP-NNP,NNP-NNP,4,0
13422,13027.0,28,popularized,22,5,7,2,4,20,17,-15,Mamoru Mohri,Japan,-,org,PROPN-PROPN,PROPN,compound-compound,poss,NNP-NNP,NNP,2,0
13423,13028.0,50,served,16,1,2,1,0,47,15,-14,Historian,Carlos Mesa,per,-,PROPN,PROPN-PROPN,compound,compound-nsubj,NNP,NNP-NNP,1,0
13424,13029.0,26,le,24,10,14,4,9,11,14,-10,Paris,Pierre Samuel du Pont de Nemours,,per-per-per-per-per-per,PROPN,PROPN-PROPN-PROPN-PROPN-PROPN-PROPN,compound,compound-compound-nmod-nmod-nmod-pobj,NNP,NNP-NNP-NNP-NNP-NNP-NNP,4,0
13425,13031.0,18,is,2,14,17,3,13,0,-12,15,University of Coimbra,Portugal,org-org-org,,PROPN-ADP-PROPN,PROPN,pobj-prep-compound,pobj,NNP-IN-NNP,NNP,5,0
13426,13032.0,18,founded,3,1,11,10,0,6,2,8,MTR Western,Darren Berg,-,per-per,PROPN-PROPN,PROPN-PROPN,compound-nsubjpass,compound-pobj,NNP-NNP,NNP-NNP,3,0
13427,13033.0,23,founded,3,1,13,12,0,9,2,10,Guy de Rothschild,France,--,per,PROPN-X-PROPN,PROPN,nmod-nmod-nsubj,poss,NNP-FW-NNP,NNP,7,0
13428,13034.0,121,is,25,3,54,51,2,66,22,29,Stax,Albert King,,per-per,PROPN,PROPN-PROPN,compound,compound-nsubj,NNP,NNP-NNP,7,0
13429,13036.0,57,publish,2,12,21,9,11,35,-10,19,South African Broadcasting Corporation,Dali Mpofu,---,per-per,PROPN-PROPN-PROPN-PROPN,PROPN-PROPN,compound-compound-compound-pobj,compound-appos,NNP-NNP-NNP-NNP,NNP-NNP,2,0
13430,13037.0,29,was,1,7,12,5,6,16,-6,11,Theodore Roosevelt High School,Des Moines,org-org-org-org,-,PROPN-PROPN-PROPN-PROPN,PROPN-PROPN,compound-compound-compound-pobj,compound-compound,NNP-NNP-NNP-NNP,NNP-NNP,4,0
13431,13039.0,21,negotiated,1,6,8,2,5,12,-5,7,Hollywood,Jack Warner,,per-per,PROPN,PROPN-PROPN,compound,compound-pobj,NNP,NNP-NNP,1,0
13432,13040.0,86,is,10,9,25,16,8,60,1,15,Italy,Dino Risi,,org-org,PROPN,PROPN-PROPN,appos,compound-pobj,NNP,NNP-NNP,8,0
13433,13041.0,51,are,4,25,34,9,24,16,-21,30,Peoria,Richwoods High School,,per-per-per,PROPN,PROPN-PROPN-PROPN,compound,compound-compound-pobj,NNP,NNP-NNP-NNP,10,0
13434,13042.0,98,saw,4,67,71,4,66,26,-63,67,editor,Joseph Howe,,per-per,NOUN,PROPN-PROPN,pobj,compound-pobj,NN,NNP-NNP,3,0
13435,13043.0,44,took,3,10,16,6,9,27,-7,13,Millard Fillmore,U.S. House,org-org,-,PROPN-PROPN,PROPN-PROPN,compound-pobj,compound-nmod,NNP-NNP,NNP-NNP,4,0
13436,13044.0,24,returned,1,1,10,9,0,13,0,9,She,Wise,,per,PRON,PROPN,nsubj,compound,PRP,NNP,3,0
13437,13045.0,19,brought,2,8,11,3,7,7,-6,9,India,he,per,,PROPN,PRON,pobj,nsubjpass,NNP,PRP,3,0
13438,13046.0,30,appointed,6,5,10,5,4,19,1,4,Alger,Governor,org,,PROPN,PROPN,nsubjpass,compound,NNP,NNP,4,0
13439,13049.0,38,lost,5,25,35,10,24,2,-20,30,United Malays National Organisation,Barisan Nasional,---,per-per,PROPN-PROPN-PROPN-PROPN,PROPN-ADJ,compound-compound-compound-pobj,compound-amod,NNP-NNP-NNP-NNP,NNP-JJ,6,0
13440,13050.0,32,born,2,6,25,19,5,6,-4,23,Delaware,Tatnall School,,org-org,PROPN,PROPN-PROPN,pobj,compound-pobj,NNP,NNP-NNP,6,0
13441,13051.0,58,Description,1,8,14,6,7,43,-7,13,New York,LaGuardia Community College,per-per,--,PROPN-PROPN,PROPN-PROPN-PROPN,compound-pobj,compound-compound-nsubj,NNP-NNP,NNP-NNP-NNP,5,0
13442,13052.0,40,partnered,4,3,25,22,2,14,1,21,Shougang Group,Tung Wing Steel,-,per-per-per,PROPN-PROPN,PROPN-PROPN-PROPN,compound-nsubj,compound-compound-pobj,NNP-NNP,NNP-NNP-NNP,9,0
13443,13053.0,33,served,6,10,12,2,9,20,-4,6,chairman,Tekelec,per,,NOUN,PROPN,pobj,poss,NN,NNP,2,0
13444,13054.0,29,born,2,1,7,6,0,21,1,5,Nash,England,org,,PROPN,PROPN,nsubjpass,pobj,NNP,NNP,2,0
13445,13055.0,21,associated,6,10,12,2,9,8,-4,6,University of Maryland,Maryland Terrapins,--,org-org,PROPN-ADP-PROPN,PROPN-PROPN,nmod-prep-compound,compound-oprd,NNP-IN-NNP,NNP-NNPS,3,0
13446,13058.0,47,received,6,5,15,10,4,31,1,9,George Clinton,Plainfield,org-org,,PROPN-PROPN,PROPN,compound-nsubj,compound,NNP-NNP,NNP,5,0
13447,13059.0,26,grew,1,14,7,-7,13,18,-13,6,Heart,her,org,,NOUN,PRON,compound,dobj,NN,PRP,4,0
13448,13061.0,38,continued,8,6,17,11,5,20,2,9,Taraki,Afghanistan,,per,PROPN,PROPN,pobj,pobj,NNP,NNP,6,0
13449,13062.0,34,formed,3,1,11,10,0,22,2,8,The Chameleons,Mark Burgess,-,per-per,DET-PROPN,PROPN-PROPN,det-nsubjpass,compound-pobj,DT-NNPS,NNP-NNP,3,0
13450,13064.0,37,grew,2,6,13,7,5,23,-4,11,Timely Comics,1939,-,per,PROPN-PROPN,NUM,amod-pobj,pobj,NNP-NNPS,CD,6,0
13451,13065.0,26,issued,11,8,4,-4,7,21,3,-7,RCA Records,Rogers,-,org,PROPN-PROPN,PROPN,compound-compound,poss,NNP-NNPS,NNP,3,0
13452,13066.0,18,was,1,7,9,2,6,8,-6,8,Queen consort,Elizabeth Woodville,org-org,-,PROPN-NOUN,PROPN-PROPN,pobj-compound,compound-appos,NNP-NN,NNP-NNP,1,0
13453,13067.0,47,Shusheng,1,12,15,3,11,31,-11,14,Zhejiang University,Hangzhou,-,per,PROPN-PROPN,PROPN,compound-pobj,pobj,NNP-NNP,NNP,3,0
13454,13129.0,20,squeezed,2,11,19,8,10,0,-9,17,Zhejiang University,Hangzhou,-,org,PROPN-PROPN,PROPN,compound-dobj,pobj,NNP-NNP,NNP,3,0
13455,13068.0,46,returned,1,17,36,19,16,9,-16,35,Sun Records,Jerry Lee Lewis,org-org,--,PROPN-PROPN,PROPN-PROPN-PROPN,compound-pobj,compound-compound-compound,NNP-NNPS,NNP-NNP-NNP,9,0
13456,13070.0,30,lost,1,6,21,15,5,8,-5,20,Peter MacKay,Nova Scotia,per-per,-,PROPN-PROPN,PROPN-PROPN,compound-pobj,compound-pobj,NNP-NNP,NNP-NNP,4,0
13457,13071.0,24,managed,3,7,12,5,6,11,-4,9,Alaska Department of Fish and Game,Game,per-per-per-per-per-per,,PROPN-PROPN-ADP-PROPN-CCONJ-PROPN,PROPN,compound-pobj-prep-pobj-cc-conj,pobj,NNP-NNP-IN-NNP-CC-NNP,NNP,2,0
13458,13072.0,24,become,2,1,9,8,0,14,1,7,He,Communist Party,,org-org,PRON,PROPN-PROPN,nsubj,compound-pobj,PRP,NNP-NNP,4,0
13459,13073.0,30,hired,4,22,28,6,21,1,-18,24,Razorline,Clive Barker,,per-per,PROPN,PROPN-PROPN,compound,compound-pobj,NNP,NNP-NNP,3,0
13460,13074.0,24,had,2,9,22,13,8,1,-7,20,Singapore,Sellapan Ramanathan,per,-,PROPN,PROPN-PROPN,pobj,compound-pobj,NNP,NNP-NNP,5,0
13461,13075.0,27,became,7,1,3,2,0,23,6,-4,Baltimore,Eubie Blake,per,-,PROPN,PROPN-PROPN,poss,compound-nsubj,NNP,NNP-NNP,2,0
13462,13076.0,19,born,3,1,11,10,0,7,2,8,Nazia Hassan,Pakistan,-,per,PROPN-PROPN,PROPN,compound-nsubjpass,pobj,NNP-NNP,NNP,2,0
13463,13079.0,38,recruited,18,8,14,6,7,23,10,-4,Secret Intelligence Service,MI6,per-per-per,,PROPN-PROPN-PROPN,NOUN,compound-compound-appos,pobj,NNP-NNP-NNP,NNS,6,0
13464,13080.0,23,is,6,2,12,10,1,10,4,6,Harry Witchel,Brighton and Sussex Medical School,-,per-per-per-per-per,PROPN-PROPN,PROPN-CCONJ-PROPN-PROPN-PROPN,compound-nsubj,pobj-cc-compound-compound-conj,NNP-NNP,NNP-CC-NNP-NNP-NNP,5,0
13465,13081.0,33,Set,0,3,14,11,2,18,-3,14,Iran,Afshin,,org,PROPN,PROPN,pobj,compound,NNP,NNP,6,0
13466,13082.0,35,needed,4,11,11,0,10,23,-7,7,Columbia Records,Columbia Phonographic Broadcasting System,org-org,---,PROPN-PROPN,PROPN-PROPN-PROPN-PROPN,compound-pobj,compound-compound-compound-oprd,NNP-NNPS,NNP-NNP-NNP-NNP,0,0
13467,13083.0,37,said,10,2,21,19,1,15,8,11,Pound,Canada,per,,PROPN,PROPN,nsubj,pobj,NNP,NNP,6,0
13468,13086.0,5,Skil-Shimano,3,1,3,2,0,1,2,0,Yukihiro,Japan,per,,PROPN,PROPN,compound,compound,NNP,NNP,2,0
13469,13087.0,26,is,12,1,24,23,0,1,11,12,Patricia Manterola,Mexico,per-per,,PROPN-PROPN,PROPN,compound-nsubj,compound,NNP-NNP,NNP,5,0
13470,13089.0,20,is,5,3,3,0,2,16,2,-2,Mississippi College,Mississippi College Choctaws,-,per-per-per,PROPN-PROPN,PROPN-PROPN-PROPN,compound-compound,compound-compound-conj,NNP-NNP,NNP-NNP-NNP,0,0
13471,13090.0,24,born,2,1,5,4,0,18,1,3,Croes,Aruba,,per,NOUN,PROPN,nsubjpass,pobj,NNS,NNP,4,0
13472,13092.0,41,rebranded,20,14,25,11,13,15,6,5,British Leyland,Rover Group,-,per-per,PROPN-PROPN,PROPN-PROPN,amod-nmod,compound-nsubj,NNP-NNP,NNP-NNP,4,0
13473,13093.0,26,was,8,2,2,0,1,23,6,-6,Maryland,Maryland State Police,per,--,PROPN,PROPN-PROPN-PROPN,nsubj,compound-compound-compound,NNP,NNP-NNP-NNPS,0,0
13474,13094.0,42,is,1,1,23,22,0,18,0,22,Hattie Jacques,John Le Mesurier,org-org,--,PROPN-PROPN,PROPN-PROPN-PROPN,compound-appos,compound-compound-pobj,NNP-NNP,NNP-NNP-NNP,6,0
13475,13095.0,55,is,8,2,5,3,1,49,6,-3,Mexican,Frida Kahlo,,per-per,ADJ,PROPN-PROPN,amod,compound-poss,JJ,NNP-NNP,2,0
13476,13098.0,25,entered,12,5,12,7,4,12,7,0,Michigan,Norvell,org,,PROPN,PROPN,pobj,pobj,NNP,NNP,3,0
13477,13099.0,60,started,2,2,9,7,1,50,0,7,Cariou,Manitoba,,org,PROPN,PROPN,nsubj,compound,NNP,NNP,4,0
13478,13100.0,25,released,2,9,19,10,8,5,-7,17,Mercury Nashville,Twain,-,org,PROPN-PROPN,PROPN,compound-compound,poss,NNP-NNP,NNP,9,0
13479,13101.0,21,invested,6,5,9,4,4,11,1,3,William,Duke of Normandy,,per-per-per,PROPN,PROPN-ADP-PROPN,nsubjpass,pobj-prep-pobj,NNP,NNP-IN-NNP,3,0
13480,13104.0,48,Ministers,2,5,12,7,4,35,-3,10,Australia,Joseph Cook,,org-org,PROPN,PROPN-PROPN,pobj,compound-nsubjpass,NNP,NNP-NNP,2,0
13481,13106.0,68,based,3,39,39,0,38,28,-36,36,Florida Board of Governors,Florida,per-per-per-per,,PROPN-PROPN-ADP-PROPN,PROPN,compound-nsubj-prep-pobj,pobj,NNP-NNP-IN-NNPS,NNP,0,0
13482,13108.0,20,is,3,1,13,12,0,6,2,10,The Priory School,Shropshire,--,org,DET-PROPN-PROPN,PROPN,det-compound-nsubj,compound,DT-NNP-NNP,NNP,8,0
13483,13110.0,24,operates,3,1,19,18,0,4,2,16,Henry Ford Hospital,Michigan,--,org,PROPN-PROPN-PROPN,PROPN,compound-compound-nsubj,pobj,NNP-NNP-NNP,NNP,4,0
13484,13111.0,16,owns,1,1,3,2,0,12,0,2,Nawrocki,Les Pages Noires,org,--,PROPN,PROPN-PROPN-PROPN,nsubj,compound-compound-dobj,NNP,NNP-NNP-NNP,2,0
13485,13112.0,13,was,3,1,10,9,0,2,2,7,Tun Perpatih Putih,Sultanate,per-per-per,,PROPN-PROPN-PROPN,PROPN,compound-compound-nsubj,pobj,NNP-NNP-NNP,NNP,6,0
13486,13113.0,41,said,15,1,12,11,0,28,14,-3,Time Warner,CNN,-,per,PROPN-PROPN,PROPN,compound-compound,dobj,NNP-NNP,NNP,-1,0
13487,13114.0,13,is,3,1,1,0,0,11,2,-2,Udmurt State University,Udmurt Republic,--,per-per,PROPN-PROPN-PROPN,PROPN-PROPN,compound-compound-nsubj,compound-pobj,NNP-NNP-NNP,NNP-NNP,0,0
13488,13115.0,34,is,8,1,21,20,0,12,7,13,Scaled Composites,Northrop Grumman,per-per,-,PROPN-PROPN,PROPN-PROPN,compound-nsubj,compound-pobj,NNP-NNPS,NNP-NNP,6,0
13489,13116.0,14,resides,1,1,5,4,0,8,0,4,He,Minnesota,org,,PRON,PROPN,nsubj,pobj,PRP,NNP,1,0
13490,13117.0,18,was,2,12,16,4,11,1,-10,14,lyricist,Anna Tsuchiya,org,-,NOUN,PROPN-PROPN,compound,compound-conj,NN,NNP-NNP,4,0
13491,13122.0,18,placed,7,6,14,8,5,3,1,7,Spain,group,org,,PROPN,NOUN,compound,dobj,NNP,NN,7,0
13492,13123.0,97,wrote,2,66,75,9,65,21,-64,73,London,Dame Eileen,per,-,PROPN,PROPN-PROPN,nsubj,compound-nsubj,NNP,NNP-NNP,-1,0
13493,13125.0,26,was,1,8,10,2,7,15,-7,9,Caltech,Robert Andrews Millikan,,per-per-per,PROPN,PROPN-PROPN-PROPN,compound,compound-compound-pobj,NNP,NNP-NNP-NNP,2,0
13494,13127.0,21,entrusted,4,6,20,14,5,0,-2,16,King,London,,per,PROPN,PROPN,dobj,pobj,NNP,NNP,2,0
13495,13130.0,15,provided,2,12,13,1,11,1,-10,11,President,Lee Teng-hui,,per-per,PROPN,PROPN-PROPN,compound,compound-pobj,NNP,NNP-NNP,2,0
13496,13132.0,29,come,6,20,22,2,19,6,-14,16,Italy,Alitalia,org,,PROPN,PROPN,poss,pobj,NNP,NNP,8,0
13497,13133.0,43,notified,2,36,41,5,35,1,-34,39,United States Secret Service,USSS,per-per-per-per,,PROPN-PROPN-PROPN-PROPN,PROPN,compound-compound-compound-conj,appos,NNP-NNP-NNP-NNP,NNP,2,0
13498,13134.0,28,know,16,3,6,3,2,21,13,-10,General Motors,NYSE,-,org,PROPN-PROPN,PROPN,compound-pobj,appos,NNP-NNPS,NNP,2,0
13499,13137.0,11,is,2,1,10,9,0,0,1,8,Hull College,England,org-org,,PROPN-PROPN,PROPN,compound-nsubj,pobj,NNP-NNP,NNP,2,0
13500,13138.0,29,Upon,0,13,19,6,12,9,-13,19,Lawson Software,St. Paul,-,org-org,PROPN-PROPN,PROPN-PROPN,compound-appos,compound-compound,NNP-NNP,NNP-NNP,8,0
13501,13139.0,21,enacted,1,1,11,10,0,9,0,10,He,Central America,per,-,PRON,PROPN-PROPN,nsubj,compound-pobj,PRP,NNP-NNP,5,0
13502,13140.0,22,is,11,5,10,5,4,11,6,-1,University of Silesia,Katowice,org-org-org,,PROPN-ADP-PROPN,PROPN,pobj-prep-pobj,appos,NNP-IN-NNP,NNP,4,0
13503,13141.0,16,attend,4,2,2,0,1,13,2,-2,Lake Forest,Lake Forest High School,per-per,---,PROPN-PROPN,PROPN-PROPN-PROPN-PROPN,compound-compound,compound-compound-compound-conj,NNP-NNP,NNP-NNP-NNP-NNP,0,0
13504,13142.0,29,said,4,1,4,3,0,24,3,0,EADS,Grube,per,,PROPN,PROPN,compound,nsubj,NNP,NNP,2,0
13505,13145.0,13,is,3,2,6,4,1,6,1,3,Denise Jones,dancer,-,per,PROPN-PROPN,NOUN,compound-nsubj,compound,NNP-NNP,NN,5,0
13506,13147.0,68,was,11,1,43,42,0,24,10,32,Alex Reece,Fallen Angels,org-org,-,PROPN-PROPN,PROPN-PROPN,compound-nsubj,compound-pobj,NNP-NNP,NNP-NNPS,13,0
13507,13150.0,33,living,2,9,26,17,8,6,-7,24,Charlottesville,Anderson,org,,PROPN,PROPN,compound,poss,NNP,NNP,9,0
13508,13151.0,46,is,3,1,11,10,0,34,2,8,Yellowhead Tribal College,Alberta,--,per,PROPN-PROPN-PROPN,PROPN,compound-compound-nsubj,pobj,NNP-NNP-NNP,NNP,7,0
13509,13152.0,29,is,11,2,20,18,1,8,9,9,University of Nottingham Medical School,UK,org-org-org-org-org,,PROPN-ADP-PROPN-PROPN-PROPN,PROPN,dobj-prep-compound-compound-pobj,pobj,NNP-IN-NNP-NNP-NNP,NNP,9,0
13510,13153.0,17,is,2,1,1,0,0,15,1,-1,The Atlantic,The Atlantic Monthly,-,per-per-per,DET-PROPN,DET-PROPN-PROPN,det-nsubj,det-compound-pobj,DT-NNP,DT-NNP-NNP,0,0
13511,13157.0,25,was,1,6,13,7,5,11,-5,12,Gallegos,Caracas,per,,PROPN,PROPN,compound,pobj,NNP,NNP,4,0
13512,13158.0,36,is,2,1,19,18,0,16,1,17,Jyske Bank,Silkeborg,org-org,,PROPN-PROPN,PROPN,compound-nsubj,compound,NNP-NNP,NNP,2,0
13513,13159.0,56,asked,35,29,32,3,28,23,6,-3,Fifth Air Force,Lieutenant General,--,per-per,PROPN-PROPN-PROPN,PROPN-PROPN,compound-compound-compound,compound-compound,NNP-NNP-NNP,NNP-NNP,2,0
13514,13160.0,33,donated,2,8,12,4,7,20,-6,10,Coastal Carolina University,Conway,--,per,PROPN-PROPN-PROPN,PROPN,compound-compound-pobj,compound,NNP-NNP-NNP,NNP,2,0
13515,13161.0,24,left,12,11,14,3,10,9,1,2,Jerome Brailey,Parliament-Funkadelic,per-per,,PROPN-PROPN,PROPN,compound-conj,oprd,NNP-NNP,NNP,5,0
13516,13162.0,15,given,3,10,12,2,9,2,-7,9,Swedish,Elias Magnus Fries,,per-per-per,ADJ,PROPN-PROPN-PROPN,amod,compound-compound-pobj,JJ,NNP-NNP-NNP,2,0
13517,13164.0,30,is,4,2,8,6,1,21,2,4,External Assessments Bureau,New Zealand,org-org-org,-,PROPN-PROPN-PROPN,PROPN-PROPN,compound-compound-nsubj,compound-poss,NNP-NNPS-NNP,NNP-NNP,6,0
13518,13165.0,24,cast,4,8,13,5,7,10,-4,9,Lita Ford,The Runaways,-,org-org,PROPN-PROPN,DET-PROPN,compound-dobj,det-ROOT,NNP-NNP,DT-NNPS,2,0
13519,13166.0,20,located,3,10,13,3,9,6,-7,10,Pakistan,its,,per,PROPN,DET,compound,poss,NNP,PRP$,7,0
13520,13167.0,40,Isham,1,9,19,10,8,20,-8,18,Gary Moon,Night Ranger,org-org,-,PROPN-PROPN,PROPN-PROPN,compound-pobj,compound-pobj,NNP-NNP,NNP-NNP,4,0
13521,13168.0,26,represents,7,6,20,14,5,5,1,13,ESA,Netherlands,per,,PROPN,PROPN,pobj,compound,NNP,NNP,4,0
13522,13169.0,35,was,6,5,24,19,4,10,1,18,Anne Murray,Nova Scotia,org-org,-,PROPN-PROPN,PROPN-PROPN,compound-nsubj,compound-pobj,NNP-NNP,NNP-NNP,-1,0
13523,13170.0,36,is,8,18,18,0,17,17,-10,10,PLA,PLA Air Force,,per-per-per,PROPN,PROPN-PROPN-PROPN,appos,compound-compound-pobj,NNP,NNP-NNP-NNP,0,0
13524,13171.0,38,is,2,1,24,23,0,13,1,22,Samsung Telecommunications,Telecommunication Systems Division,per-per,--,PROPN-PROPN,PROPN-PROPN-PROPN,compound-nsubj,compound-compound-compound,NNP-NNPS,NNP-NNPS-NNP,8,0
13525,13172.0,24,played,4,7,9,2,6,14,-3,5,Rancid,Tim Armstrong,per,-,PROPN,PROPN-PROPN,poss,compound-pobj,NNP,NNP-NNP,2,0
13526,13175.0,32,passed,8,2,7,5,1,24,6,-1,University and College Union,UCU,per-per-per-per,,PROPN-CCONJ-PROPN-PROPN,PROPN,nmod-cc-conj-nsubj,appos,NNP-CC-NNP-NNP,NNP,3,0
13527,13176.0,25,is,7,3,14,11,2,10,4,7,Nelson,professor,,per,PROPN,NOUN,nsubj,conj,NNP,NN,6,0
13528,13178.0,23,represented,8,3,3,0,2,19,5,-5,Arizona State Sun Devils,Arizona State University,---,org-org-org,PROPN-PROPN-PROPN-PROPN,PROPN-PROPN-PROPN,compound-compound-compound-compound,compound-compound-dobj,NNP-NNP-NNP-NNP,NNP-NNP-NNP,0,0
13529,13179.0,56,Me,0,23,3,-20,22,52,-23,3,Cold Chillin,Biz Markie,-,per-per,PROPN-PROPN,PROPN-PROPN,compound-poss,compound-conj,NNP-NNP,NNP-NNP,5,0
13530,13181.0,20,go,2,1,12,11,0,7,1,10,He,Alberta,,per,PRON,PROPN,nsubj,pobj,PRP,NNP,3,0
13531,13182.0,60,became,33,50,51,1,49,8,-17,18,Minutemen,D. Boon,per,-,PROPN,PROPN-PROPN,compound,compound-poss,NNP,NNP-NNP,2,0
13532,13183.0,30,defined,2,21,28,7,20,1,-19,26,Department of the Prime Minister and Cabinet,Maarten Wevers,------,per-per,PROPN-ADP-DET-PROPN-PROPN-CCONJ-PROPN,PROPN-PROPN,pobj-prep-det-compound-pobj-cc-compound,compound-conj,NNP-IN-DT-NNP-NNP-CC-NNP,NNP-NNP,4,0
13533,13184.0,41,led,3,33,39,6,32,1,-30,36,Institute of Marine Sciences,Turkey,per-per-per-per,,PROPN-ADP-PROPN-PROPN,PROPN,conj-prep-compound-pobj,appos,NNP-IN-NNP-NNPS,NNP,2,0
13534,13185.0,12,sworn,3,1,11,10,0,0,2,8,Khaleda Zia,Bangladesh,-,per,PROPN-PROPN,PROPN,compound-nsubjpass,pobj,NNP-NNP,NNP,2,0
13535,13186.0,12,pledges,3,1,3,2,0,8,2,0,Venezuela,Chavez,per,,PROPN,PROPN,poss,nsubj,NNP,NNP,3,0
13536,13190.0,23,are,6,2,2,0,1,20,4,-4,BMW,BMW Motorrad,,per-per,PROPN,PROPN-PROPN,nmod,compound-pobj,NNP,NNP-NNP,0,0
13537,13191.0,35,is,8,1,22,21,0,12,7,14,Heinz,Germany,,per,PROPN,PROPN,compound,pobj,NNP,NNP,4,0
13538,13192.0,15,met,5,9,13,4,8,1,-4,8,DJ,Uncle Kracker,,org-org,PROPN,PROPN-PROPN,compound,compound-dobj,NNP,NNP-NNP,3,0
13539,13193.0,28,located,10,4,25,21,3,2,6,15,Texas Department of Criminal Justice,Austin,----,per,PROPN-PROPN-ADP-PROPN-PROPN,PROPN,compound-pobj-prep-compound-compound,poss,NNP-NNP-IN-NNP-NNP,NNP,11,0
13540,13194.0,21,represented,7,3,3,0,2,17,4,-4,Mississippi,Mississippi State University,org,--,PROPN,PROPN-PROPN-PROPN,compound,compound-compound-dobj,NNP,NNP-NNP-NNP,0,0
13541,13195.0,24,is,5,5,21,16,4,2,0,16,ABC1,Australian Broadcasting,,per-per,PROPN,PROPN-PROPN,pobj,compound-compound,NNP,NNP-NNP,7,0
13542,13196.0,33,Tell,2,8,13,5,7,19,-6,11,British,BBC Three,per,-,ADJ,PROPN-NUM,amod,compound-pobj,JJ,NNP-CD,4,0
13543,13197.0,36,retained,15,1,34,33,0,1,14,19,He,British Columbia,org,-,PRON,PROPN-PROPN,nsubjpass,compound-pobj,PRP,NNP-NNP,8,0
13544,13200.0,30,cited,1,1,18,17,0,11,0,17,PPR,CFAO,org,,PROPN,PROPN,nsubj,appos,NNP,NNP,3,0
13545,13202.0,22,is,2,1,8,7,0,13,1,6,The LeeVees,New York City,-,org-org-org,DET-PROPN,PROPN-PROPN-PROPN,det-nsubj,compound-compound-pobj,DT-NNP,NNP-NNP-NNP,5,0
13546,13203.0,17,located,4,1,16,15,0,0,3,12,Indiana State University,IN,per-per-per,,PROPN-PROPN-PROPN,PROPN,compound-compound-nsubjpass,advmod,NNP-NNP-NNP,NNP,3,0
13547,13204.0,45,started,3,6,13,7,5,31,-3,10,Carnegie Mellon University,Luis von Ahn,--,per-per-per,PROPN-PROPN-PROPN,PROPN-PROPN-PROPN,nmod-nmod-pobj,compound-compound-ROOT,NNP-NNP-NNP,NNP-NNP-NNP,-1,0
13548,13205.0,25,moved,4,3,15,12,2,9,1,11,Jason Lee,Salem,-,per,PROPN-PROPN,PROPN,compound-nsubj,acomp,NNP-NNP,NNP,5,0
13549,13207.0,38,pump,2,1,17,16,0,20,1,15,Ireland,Anglo Irish Bank,,org-org-org,NOUN,PROPN-PROPN-PROPN,nsubj,compound-compound-compound,NN,NNP-NNP-NNP,5,0
13550,13208.0,23,served,1,1,9,8,0,13,0,8,She,Cambrian College,org,-,PRON,PROPN-PROPN,nsubj,compound-pobj,PRP,NNP-NNP,6,0
13551,13209.0,16,located,7,4,10,6,3,5,3,3,Durham college,Oshawa,-,org,PROPN-NOUN,PROPN,conj-compound,pobj,NNP-NN,NNP,3,0
13552,13211.0,29,gained,1,12,27,15,11,1,-11,26,Illinois,Peter Fitzgerald,per,-,PROPN,PROPN-PROPN,compound,compound-dobj,NNP,NNP-NNP,12,0
13553,13212.0,42,writes,5,5,9,4,4,32,0,4,Paige,Education,,per,PROPN,PROPN,nsubj,pobj,NNP,NNP,3,0
13554,13213.0,17,been,9,3,7,4,2,9,6,-2,KiwiRail,New Zealand,per,-,PROPN,PROPN-PROPN,compound,compound-pobj,NNP,NNP-NNP,3,0
13555,13214.0,37,donated,3,13,33,20,12,3,-10,30,United States,John Cooksey,per-per,-,PROPN-PROPN,PROPN-PROPN,compound-compound,compound-pobj,NNP-NNP,NNP-NNP,11,0
13556,13215.0,18,were,2,1,15,14,0,2,1,13,The Fuse,1998,per-per,,DET-PROPN,NUM,det-nsubj,pobj,DT-NNP,CD,7,0
13557,13216.0,21,cut,3,11,19,8,10,1,-8,16,New Jersey,William Hughes,org-org,-,PROPN-PROPN,PROPN-PROPN,compound-compound,compound-pobj,NNP-NNP,NNP-NNP,9,0
13558,13218.0,12,renamed,2,7,8,1,6,3,-5,6,Hilliard,Darby High School,org,--,PROPN,PROPN-PROPN-PROPN,compound,compound-compound-nsubj,NNP,NNP-NNP-NNP,2,0
13559,13219.0,21,is,1,1,17,16,0,3,0,16,Klute,DJ,,org,PROPN,PROPN,nsubj,conj,NNP,NNP,2,0
13560,13220.0,45,said,2,24,26,2,23,18,-22,24,Venezuela,CANTV,org,,PROPN,PROPN,pobj,conj,NNP,NNP,6,0
13561,13221.0,22,is,5,3,20,17,2,1,2,15,Joan,Barcelona,,org,PROPN,PROPN,compound,compound,NNP,NNP,12,0
13562,13223.0,49,are,5,3,7,4,2,41,2,2,10,Bloomberg,,per,NUM,PROPN,nummod,attr,CD,NNP,3,0
13563,13224.0,19,PETERSON,1,1,10,9,0,8,0,9,OSCAR PETERSON,pianist,org-org,,PROPN-PROPN,NOUN,compound-ROOT,compound,NNP-NNP,NN,-1,0
13564,13225.0,38,married,2,1,23,22,0,14,1,21,She,Charles Hughesdon,org,-,PRON,PROPN-PROPN,nsubj,compound-appos,PRP,NNP-NNP,5,0
13565,13226.0,28,is,2,1,16,15,0,11,1,14,Stanwell School,Penarth,per-per,,PROPN-PROPN,PROPN,compound-nsubj,compound,NNP-NNP,NNP,5,0
13566,13229.0,23,agreed,3,2,7,5,1,15,1,4,party,Popescu-Tariceanu,org,,NOUN,PROPN,nsubj,dobj,NN,NNP,4,0
13567,13230.0,68,ticketsAdult,2,42,42,0,41,25,-40,40,Nova Scotia Community College,Nova Scotia,per-per-per-per,-,PROPN-PROPN-PROPN-PROPN,PROPN-PROPN,compound-compound-compound-nsubjpass,compound-compound,NNP-NNP-NNP-NNP,NNP-NNP,0,0
13568,13231.0,39,was,8,1,11,10,0,27,7,3,James Madison,American,-,org,PROPN-PROPN,ADJ,compound-compound,amod,NNP-NNP,JJ,4,0
13569,13232.0,15,withdrew,4,7,13,6,6,1,-3,9,India,RPG Group,per,-,PROPN,PROPN-PROPN,pobj,compound-pobj,NNP,NNP-NNP,4,0
13570,13233.0,32,founded,2,1,20,19,0,11,1,18,Endemol,John de Mol,per,--,PROPN,PROPN-PROPN-PROPN,nsubjpass,compound-nmod-conj,NNP,NNP-NNP-NNP,10,0
13571,13235.0,21,participated,9,9,16,7,8,4,0,7,he,Mauritanian,,per,PRON,ADJ,nsubj,amod,PRP,JJ,5,0
13572,13236.0,56,showcase,7,45,46,1,44,9,-38,39,director,Abel Ferrara,,per-per,NOUN,PROPN-PROPN,compound,compound-pobj,NN,NNP-NNP,2,0
13573,13237.0,34,was,11,2,27,25,1,6,9,16,Mohamed Khir Bin Toyo,Selangor,---,per,PROPN-PROPN-PROPN-PROPN,PROPN,compound-compound-compound-nsubj,pobj,NNP-NNP-NNP-NNP,NNP,8,0
13574,13238.0,60,known,6,2,9,7,1,50,4,3,Marsha Stern Talmudical Academy,Yeshiva University High School for Boys,org-org-org-org,-----,PROPN-PROPN-PROPN-PROPN,PROPN-PROPN-PROPN-PROPN-ADP-PROPN,compound-compound-compound-nsubj,compound-compound-compound-pobj-prep-pobj,NNP-NNP-NNP-NNP,NNP-NNP-NNP-NNP-IN-NNPS,5,0
13575,13239.0,16,has,3,8,13,5,7,2,-5,10,United Airlines,Star Alliance,org-org,-,PROPN-PROPN,PROPN-PROPN,compound-pobj,compound-compound,NNP-NNP,NNP-NNP,5,0
13576,13240.0,41,see,9,25,36,11,24,4,-16,27,Konrad Adenauer,Berlin,-,org,PROPN-PROPN,PROPN,compound-compound,subtok,NNP-NNP,NNP,5,0
13577,13242.0,31,located,13,5,22,17,4,8,8,9,Carlsberg Visitors Centre,Denmark,org-org-org,,PROPN-PROPN-PROPN,PROPN,compound-compound-nsubjpass,pobj,NNP-NNPS-NNP,NNP,6,0
13578,13244.0,27,founded,3,1,8,7,0,18,2,5,Rolls-Royce,Henry Royce,per,-,PROPN,PROPN-PROPN,amod,compound-pobj,NNP,NNP-NNP,3,0
13579,13245.0,23,says,5,2,4,2,1,18,3,-1,Australia,Qantas,org,,PROPN,PROPN,nsubj,compound,NNP,NNP,2,0
13580,13246.0,49,married,3,1,18,17,0,30,2,15,Cameron,Gale Anne Hurd,org,--,PROPN,PROPN-PROPN-PROPN,nsubjpass,compound-compound-ROOT,NNP,NNP-NNP-NNP,-1,0
13581,13247.0,48,is,1,1,14,13,0,33,0,13,Canada,Jeff Wall,org,-,PROPN,PROPN-PROPN,nsubj,compound-pobj,NNP,NNP-NNP,3,0
13582,13250.0,20,incorporated,16,7,12,5,6,7,9,-4,Oakville,Tim Hortons,org,-,PROPN,PROPN-PROPN,pobj,compound-compound,NNP,NNP-NNP,1,0
13583,13251.0,10,oversees,3,2,6,4,1,3,1,3,Navy,Royal Thai Marine Corps,org,---,PROPN,PROPN-PROPN-PROPN-PROPN,nsubj,compound-compound-compound-dobj,NNP,NNP-NNP-NNP-NNP,3,0
13584,13254.0,24,were,8,4,7,3,3,16,4,-1,Mary Cassatt,American,-,org,PROPN-PROPN,ADJ,compound-pobj,amod,NNP-NNP,JJ,4,0
13585,13255.0,16,situated,2,1,6,5,0,9,1,4,It,Oxfordshire,org,,PRON,PROPN,nsubjpass,compound,PRP,NNP,3,0
13586,13256.0,27,held,9,20,25,5,19,1,-11,16,Marshall-Wythe School of Law,Williamsburg,per-per-per-per,,PROPN-PROPN-ADP-PROPN,PROPN,compound-pobj-prep-pobj,compound,NNP-NNP-IN-NNP,NNP,1,0
13587,13257.0,22,is,4,1,1,0,0,20,3,-3,West Bromwich Building Society,West Bromwich,org-org-org-org,-,PROPN-PROPN-PROPN-PROPN,PROPN-PROPN,compound-compound-compound-nsubj,compound-pobj,NNP-NNP-NNP-NNP,NNP-NNP,0,0
13588,13258.0,61,defined,6,3,4,1,2,56,3,-2,Chairman,Hu Jintao,org,-,PROPN,PROPN-PROPN,compound,compound-nsubj,NNP,NNP-NNP,1,0
13589,13260.0,31,slept,6,16,24,8,15,6,-10,18,her,Berlin,per,,DET,PROPN,poss,compound,PRP$,NNP,8,0
13590,13261.0,51,lined,11,3,7,4,2,43,8,-4,United States,Duke Energy,org-org,-,PROPN-PROPN,PROPN-PROPN,compound-compound,compound-pobj,NNP-NNP,NNP-NNP,1,0
13591,13262.0,32,met,9,1,3,2,0,28,8,-6,Japan,Prince Akishino,org,-,PROPN,PROPN-PROPN,poss,compound-nsubj,NNP,NNP-NNP,2,0
13592,13265.0,13,flitted,6,6,12,6,5,0,0,6,she,Reprise,,org,PRON,PROPN,nsubj,conj,PRP,NNP,1,0
13593,13268.0,35,led,18,10,31,21,9,3,8,13,NDP,Ahmed Nazif,per,-,PROPN,PROPN-PROPN,pobj,compound-poss,NNP,NNP-NNP,12,0
13594,13269.0,10,was,1,6,9,3,5,0,-5,8,Punjabi University,India,-,per,PROPN-PROPN,PROPN,pobj-compound,attr,NNP-NNP,NNP,3,0
13595,13270.0,41,said,39,17,18,1,16,22,22,-21,President,Bamir Topi,org,-,PROPN,PROPN-PROPN,compound,compound-pobj,NNP,NNP-NNP,2,0
13596,13746.0,21,received,5,15,19,4,14,1,-10,14,President,Bamir Topi,,per-per,PROPN,PROPN-PROPN,pobj,compound-pobj,NNP,NNP-NNP,5,0
13597,13271.0,9,attended,1,1,6,5,0,2,0,5,Newman,California,org,,PROPN,PROPN,nsubj,pobj,NNP,NNP,2,0
13598,13272.0,39,lamented,17,5,14,9,4,24,12,-3,Democratic Action Party,Lim Kit Siang,per-per-per,--,PROPN-PROPN-PROPN,PROPN-PROPN-PROPN,amod-compound-compound,compound-compound-conj,NNP-NNP-NNP,NNP-NNP-NNP,5,0
13599,13273.0,28,awarded,5,8,13,5,7,14,-3,8,Winnipeg,Canwest,,per,PROPN,PROPN,nmod,pobj,NNP,NNP,6,0
13600,13274.0,50,moved,9,34,38,4,33,11,-25,29,United States,International Hockey League,per-per,--,PROPN-PROPN,PROPN-PROPN-PROPN,compound-pobj,compound-compound-pobj,NNP-NNP,NNP-NNP-NNP,2,0
13601,13276.0,28,is,10,2,20,18,1,7,8,10,Namibia Food and Allied Workers Union,National Union of Namibian Workers,-----,per-per-per-per-per,PROPN-PROPN-CCONJ-PROPN-PROPN-PROPN,PROPN-PROPN-ADP-PROPN-PROPN,compound-nsubj-cc-compound-compound-conj,compound-pobj-prep-compound-pobj,NNP-NNP-CC-NNP-NNPS-NNP,NNP-NNP-IN-NNP-NNPS,6,0
13602,13277.0,42,led,1,8,13,5,7,28,-7,12,United World College of the,Atlantic College,org-org-org-org-org,-,PROPN-PROPN-PROPN-ADP-DET,PROPN-PROPN,compound-compound-appos-prep-det,compound-nsubjpass,NNP-NNP-NNP-IN-DT,NNP-NNP,4,0
13603,13278.0,19,considering,3,5,14,9,4,4,-2,11,Eve,United States,per,-,PROPN,PROPN-PROPN,dobj,compound-compound,NNP,NNP-NNP,4,0
13604,13279.0,34,known,11,1,8,7,0,25,10,-3,Stan Stammers,England,-,per,PROPN-PROPN,PROPN,compound-nsubj,npadvmod,NNP-NNP,NNP,1,0
13605,13280.0,22,represented,6,3,9,6,2,12,3,3,Kentucky Wildcats,University of Kentucky,org-org,--,PROPN-PROPN,PROPN-ADP-PROPN,compound-compound,dobj-prep-pobj,NNP-NNP,NNP-IN-NNP,4,0
13606,13281.0,26,known,4,1,15,14,0,10,3,11,The Who,Keith Moon,-,org-org,DET-PRON,PROPN-PROPN,det-nsubj,compound-nsubj,DT-WP,NNP-NNP,3,0
13607,13282.0,29,accused,15,1,6,5,0,22,14,-9,Gibson,Parliament,,org,PROPN,PROPN,nsubjpass,pobj,NNP,NNP,2,0
13608,13284.0,15,headquartered,8,5,6,1,4,8,3,-2,Guam,Continental Micronesia,per,-,PROPN,PROPN-PROPN,compound,compound-pobj,NNP,NNP-NNP,1,0
13609,13286.0,26,brought,5,7,10,3,6,15,-2,5,Rider University,NCAA,per-per,,PROPN-PROPN,PROPN,compound-dobj,nmod,NNP-NNP,NNP,4,0
13610,13287.0,44,elected,4,3,9,6,2,34,1,5,House,Betty Boothroyd,org,-,PROPN,PROPN-PROPN,nsubj,compound-dobj,NNP,NNP-NNP,2,0
13611,13288.0,28,led,10,2,24,22,1,3,8,14,1951,TAE Greek National Airlines,per,---,NUM,PROPN-PROPN-PROPN-PROPN,pobj,compound-compound-compound-pobj,CD,NNP-NNP-NNP-NNPS,8,0
13612,13289.0,17,has,1,1,10,9,0,6,0,9,CBS,New York,org,-,PROPN,PROPN-PROPN,nsubj,compound-compound,NNP,NNP-NNP,6,0
13613,13290.0,36,had,4,4,24,20,3,11,0,20,Lee,United States,org,-,PROPN,PROPN-PROPN,nsubj,compound-compound,NNP,NNP-NNP,7,0
13614,13291.0,51,built,14,14,36,22,13,14,0,22,Mayer,California,,per,PROPN,PROPN,nsubj,compound,NNP,NNP,5,0
13615,13293.0,22,is,7,14,16,2,13,5,-7,9,University of Portland,Portland,--,per,PROPN-ADP-PROPN,PROPN,pobj-prep-pobj,compound,NNP-IN-NNP,NNP,2,0
13616,13294.0,32,dismissed,5,4,22,18,3,9,1,17,Hank,Tijuana,org,,PROPN,PROPN,nsubj,compound,NNP,NNP,8,0
13617,13295.0,23,y,21,10,20,10,9,2,11,-1,e Allied Joint Force Command Naple,; Ital,per-per-per-per-per-per,-,PROPN-PROPN-PROPN-PROPN-PROPN-PROPN,PUNCT-PROPN,det-compound-compound-compound-compound-dobj,punct-nsubj,NNP-NNP-NNP-NNP-NNP-NNP,:-NNP,3,0
13618,13298.0,30,check,3,6,6,0,5,23,-3,3,National Archives,National Archives and Records Administration,per-per,----,PROPN-PROPN,PROPN-PROPN-CCONJ-PROPN-PROPN,compound-compound,nmod-nmod-cc-conj-pobj,NNP-NNPS,NNP-NNPS-CC-NNPS-NNP,0,0
13619,13301.0,36,is,12,8,11,3,7,24,4,-1,Mechanical Engineers,SLEME,org-org,,ADJ-NOUN,PROPN,compound-pobj,appos,JJ-NNS,NNP,3,0
13620,13302.0,22,convoking,5,2,3,1,1,18,3,-2,President,Michelle Bachelet,,per-per,PROPN,PROPN-PROPN,compound,compound-nsubj,NNP,NNP-NNP,1,0
13621,13303.0,30,became,4,4,8,4,3,21,0,4,he,Transport,org,,PRON,PROPN,nsubj,pobj,PRP,NNP,2,0
13622,13305.0,24,acknowledged,7,5,23,18,4,0,2,16,Nano Reid,Ireland,org-org,,PROPN-PROPN,PROPN,compound-appos,pobj,NNP-NNP,NNP,9,0
13623,13306.0,21,is,2,5,8,3,4,12,-3,6,United States,Judge,-,org,PROPN-PROPN,PROPN,compound-compound,attr,NNP-NNP,NNP,2,0
13624,13307.0,18,became,4,4,15,11,3,2,0,11,Curtin,Commonwealth Grants Commission,per,--,PROPN,PROPN-PROPN-PROPN,nsubj,compound-compound-pobj,NNP,NNP-NNPS-NNP,4,0
13625,13308.0,28,wrote,7,4,16,12,3,11,3,9,Eva Hesse,Germany,-,org,PROPN-PROPN,PROPN,compound-appos,pobj,NNP-NNP,NNP,6,0
13626,13312.0,21,earned,1,1,14,13,0,6,0,13,Coppenrath,French Polynesia,per,-,NOUN,PROPN-PROPN,nsubj,compound-poss,NN,NNP-NNP,6,0
13627,13314.0,29,worked,1,1,8,7,0,20,0,7,COGAM,Spain,org,,NOUN,PROPN,nsubj,pobj,NN,NNP,3,0
13628,13319.0,24,put,6,20,22,2,19,1,-14,16,Medford,Lithia Motors,per,-,PROPN,PROPN-PROPN,pobj,compound-conj,NNP,NNP-NNP,2,0
13629,13320.0,26,born,2,19,21,2,18,4,-17,19,Perfume,Yuka Kashino,,org-org,PROPN,PROPN-PROPN,compound,compound-appos,NNP,NNP-NNP,2,0
13630,13321.0,24,led,1,1,4,3,0,19,0,3,Mao,Hunan,org,,PROPN,PROPN,nsubj,compound,NNP,NNP,2,0
13631,13323.0,21,appointed,4,12,20,8,11,0,-8,16,Pierre Trudeau,Quebec,-,per,PROPN-PROPN,PROPN,compound-pobj,pobj,NNP-NNP,NNP,3,0
13632,13324.0,33,said,12,14,25,11,13,7,-2,13,Valerie Steele,Fashion Institute of Technology,per-per,---,PROPN-PROPN,PROPN-PROPN-ADP-PROPN,compound-compound,compound-pobj-prep-pobj,NNP-NNP,NNP-NNP-IN-NNP,6,0
13633,13326.0,41,composer,2,11,31,20,10,9,-9,29,guitarist,Hugh Masekela,per,-,NOUN,PROPN-PROPN,compound,compound-nsubjpass,NN,NNP-NNP,5,0
13634,13331.0,34,established,5,2,7,5,1,26,3,2,1835,Albion College,org,-,NUM,PROPN-PROPN,pobj,compound-dobj,CD,NNP-NNP,4,0
13635,13332.0,20,is,1,10,10,0,9,9,-9,9,Tata Motors,Tata Group,per-per,-,PROPN-PROPN,PROPN-PROPN,compound-compound,compound-pobj,NNP-NNP,NNP-NNP,0,0
13636,13333.0,26,employs,4,1,3,2,0,22,3,-1,San Jose,State University,org-org,-,PROPN-PROPN,PROPN-PROPN,compound-compound,compound-nsubj,NNP-NNP,NNP-NNP,2,0
13637,13334.0,23,released,8,3,16,13,2,6,5,8,Lowe,Demon Records,,org-org,PROPN,PROPN-PROPN,pobj,compound-pobj,NNP,NNP-NNPS,6,0
13638,13335.0,14,is,2,1,12,11,0,1,1,10,Air Wisconsin,United States,per-per,-,PROPN-PROPN,PROPN-PROPN,compound-nsubj,compound-pobj,NNP-NNP,NNP-NNP,4,0
13639,13336.0,19,is,3,2,18,16,1,0,1,15,Kirby Company,USA,-,per,PROPN-PROPN,PROPN,compound-nsubj,pobj,NNP-NNP,NNP,2,0
13640,13338.0,32,succeeded,4,3,26,23,2,5,1,22,he,France,,per,PRON,PROPN,nsubj,nsubj,PRP,NNP,7,0
13641,13340.0,19,called,9,7,17,10,6,1,2,8,Barack Obama,I,org-org,,PROPN-PROPN,PRON,compound-nsubj,nsubj,NNP-NNP,PRP,8,0
13642,13341.0,76,held,3,26,30,4,25,45,-23,27,Jilin University,People Republic of China,-,per-per-per-per,PROPN-PROPN,PROPN-PROPN-ADP-PROPN,compound-pobj,compound-pobj-prep-pobj,NNP-NNP,NNPS-NNP-IN-NNP,2,0
13643,13342.0,26,be,8,22,25,3,21,0,-14,17,ESAC,Spain,,per,PROPN,PROPN,pobj,pobj,NNP,NNP,5,0
13644,13344.0,13,served,4,10,11,1,9,1,-6,7,WMATA,Metrobus,per,,PROPN,PROPN,compound,compound,NNP,NNP,1,0
13645,13345.0,31,signed,2,5,10,5,4,20,-3,8,Tragic Hero Records,Music,org-org-org,,PROPN-PROPN-PROPN,PROPN,compound-compound-pobj,conj,NNP-NNP-NNPS,NNP,5,0
13646,13347.0,12,sworn,5,3,11,8,2,0,2,6,Rafael Caldera,Venezuela,-,per,PROPN-PROPN,PROPN,compound-nsubjpass,pobj,NNP-NNP,NNP,2,0
13647,13348.0,35,were,1,18,21,3,17,13,-17,20,Illinois,Doug Scott,,per-per,PROPN,PROPN-PROPN,compound,compound-dobj,NNP,NNP-NNP,2,0
13648,13349.0,31,signed,5,22,29,7,21,1,-17,24,Beluga Heights,Sean Kingston,per-per,-,PROPN-PROPN,PROPN-PROPN,compound-conj,compound-dobj,NNP-NNP,NNP-NNP,7,0
13649,13350.0,29,named,4,1,16,15,0,12,3,12,Electronic Data Systems,Chairman,--,org,PROPN-PROPN-PROPN,PROPN,compound-compound-compound,compound,NNP-NNPS-NNP,NNP,4,0
13650,13352.0,47,re-mixed,14,5,10,5,4,36,9,-4,Barry Manilow,Bell,per-per,,PROPN-PROPN,PROPN,compound-compound,compound,NNP-NNP,NNP,7,0
13651,13353.0,37,is,1,12,20,8,11,16,-11,19,2003,Canara Bank,per,-,NUM,PROPN-PROPN,pobj,compound-compound,CD,NNP-NNP,5,0
13652,13354.0,9,born,2,1,8,7,0,0,1,6,Tobin,Brazil,org,,PROPN,PROPN,nsubjpass,pobj,NNP,NNP,2,0
13653,13355.0,30,seen,18,7,15,8,6,14,11,-3,Severina Vu?kovi,of Croat,per-per,-,PROPN-PROPN,ADP-PROPN,nmod-subtok,prep-pobj,NNP-NNPS,IN-NNP,-1,0
13654,13357.0,23,educated,7,3,15,12,2,7,4,8,Adelaide,University of Adelaide,per,--,PROPN,PROPN-ADP-PROPN,compound,nsubj-prep-pobj,NNP,NNP-IN-NNP,7,0
13655,13358.0,24,established,3,2,7,5,1,16,1,4,company,2000,,per,NOUN,NUM,nsubjpass,nummod,NN,CD,3,0
13656,13359.0,32,elaborates,1,10,23,13,9,8,-9,22,her,Judds,org,,DET,PROPN,poss,nsubj,PRP$,NNP,9,0
13657,13360.0,21,consists,4,18,20,2,17,0,-14,16,Russia,Atomstroyexport,,per,PROPN,PROPN,poss,pobj,NNP,NNP,10,0
13658,13361.0,24,was,2,1,10,9,0,13,1,8,Emmett Hardy,New Orleans Rhythm Kings,per-per,---,PROPN-PROPN,PROPN-PROPN-PROPN-NOUN,compound-nsubj,compound-compound-compound-pobj,NNP-NNP,NNP-NNP-NNP-NNS,6,0
13659,13364.0,18,settled,1,1,6,5,0,11,0,5,He,Missouri,,org,PRON,PROPN,nsubj,pobj,PRP,NNP,1,0
13660,13974.0,29,sought,1,1,12,11,0,16,0,11,He,Missouri,per,,PRON,PROPN,nsubj,compound,PRP,NNP,4,0
13661,13365.0,26,operated,22,2,25,23,1,0,20,3,Georgia,GNRR,per,,PROPN,PROPN,compound,pobj,NNP,NNP,3,0
13662,13369.0,36,serving,1,15,20,5,14,15,-14,19,Klein,Alberta,per,,PROPN,PROPN,poss,compound,NNP,NNP,6,0
13663,13371.0,28,written,3,1,13,12,0,14,2,10,His,Chicago,,per,DET,PROPN,poss,pobj,PRP$,NNP,3,0
13664,13372.0,19,is,1,4,14,10,3,4,-3,13,Baugh,Molossia,per,,PROPN,PROPN,nmod,poss,NNP,NNP,5,0
13665,13373.0,25,formed,6,5,12,7,4,12,1,6,MediaNews Group,Times,-,per,PROPN-PROPN,PROPN,compound-conj,poss,NNP-NNP,NNP,6,0
13666,13375.0,35,uses,11,8,10,2,7,24,3,-1,Brooklyn,Betty Smith,,org-org,PROPN,PROPN-PROPN,pobj,compound-pobj,NNP,NNP-NNP,1,0
13667,13376.0,34,is,3,24,32,8,23,1,-21,29,Wellington,Tranz Metro,,org-org,PROPN,PROPN-PROPN,poss,compound-pobj,NNP,NNP-NNP,5,0
13668,13377.0,25,believed,2,4,22,18,3,2,-2,20,Rockefeller,New York,,per-per,PROPN,PROPN-PROPN,nsubj,compound-compound,NNP,NNP-NNP,9,0
13669,13378.0,21,broken,3,9,16,7,8,4,-6,13,Eastern Institute of Technology,New Zealand,---,org-org,PROPN-PROPN-ADP-PROPN,PROPN-PROPN,compound-pobj-prep-pobj,compound-pobj,NNP-NNP-IN-NNP,NNP-NNP,3,0
13670,13379.0,20,co-founded,2,1,8,7,0,11,1,6,Zipcar,Robin Chase,org,-,PROPN,PROPN-PROPN,nsubjpass,compound-conj,NNP,NNP-NNP,4,0
13671,13380.0,30,ProSiebenSat,1,2,9,7,1,20,-1,8,ProSiebenSat .1 Media,its,per-per-per,,NOUN-PUNCT-PROPN,DET,ROOT-punct-compound,poss,NN-.-NNP,PRP$,7,0
13672,13382.0,35,started,1,8,25,17,7,9,-7,24,University of California,UCSB,--,per,PROPN-ADP-PROPN,PROPN,nmod-prep-pobj,poss,NNP-IN-NNP,NNP,12,0
13673,13384.0,19,influenced,3,6,16,10,5,2,-3,13,Kurt Hahn,Gordonstoun,per-per,,PROPN-PROPN,PROPN,compound-pobj,conj,NNP-NNP,NNP,3,0
13674,13389.0,22,began,5,12,16,4,11,5,-7,11,DeLonge,California,,org,PROPN,PROPN,poss,pobj,NNP,NNP,6,0
13675,13391.0,14,was,5,1,13,12,0,0,4,8,Christoforos Nezer,Greece,-,org,PROPN-PROPN,PROPN,compound-nsubj,pobj,NNP-NNP,NNP,4,0
13676,13394.0,34,coached,1,3,31,28,2,2,-2,30,Duke,NCAA,per,,PROPN,PROPN,poss,compound,NNP,NNP,11,0
13677,13395.0,26,nicknamed,7,2,10,8,1,15,5,3,University of Wyoming,Cowboys and Cowgirls,per-per-per,--,PROPN-ADP-PROPN,PROPN-CCONJ-PROPN,nmod-prep-pobj,oprd-cc-conj,NNP-IN-NNP,NNPS-CC-NNP,5,0
13678,13399.0,23,found,4,3,22,19,2,0,1,18,Stewart,London,,per,PROPN,PROPN,pobj,pobj,NNP,NNP,2,0
13679,13400.0,24,researched,4,10,15,5,9,8,-6,11,University of Hanover,Schwartz,--,per,PROPN-ADP-PROPN,PROPN,pobj-prep-pobj,pobj,NNP-IN-NNP,NNP,6,0
13680,13401.0,22,born,2,1,7,6,0,14,1,5,Hawthorne,England,,per,PROPN,PROPN,nsubjpass,pobj,NNP,NNP,5,0
13681,13403.0,12,been,2,1,5,4,0,6,1,3,Anheuser-Busch,St. Louis,per,-,PROPN,PROPN-PROPN,nsubj,compound-compound,NNP,NNP-NNP,4,0
13682,13404.0,54,met,10,32,1,-31,31,52,-22,-9,Elektra,The Cars,org,-,PROPN,DET-NOUN,compound,det-ROOT,NNP,DT-NNS,9,0
13683,13405.0,19,born,2,7,7,0,6,11,-5,5,Oak Park,Oak Park and River Forest High School,per-per,------,PROPN-PROPN,PROPN-PROPN-CCONJ-PROPN-PROPN-PROPN-PROPN,compound-compound,compound-dobj-cc-compound-compound-compound-conj,NNP-NNP,NNP-NNP-CC-NNP-NNP-NNP-NNP,0,0
13684,13406.0,30,considered,3,1,8,7,0,21,2,5,Mikl,Austrian,per,,PROPN,ADJ,nsubjpass,amod,NNP,JJ,3,0
13685,13410.0,18,born,2,9,13,4,8,4,-7,11,New York,Bayard Veiller,-,per-per,PROPN-PROPN,PROPN-PROPN,compound-compound,compound-pobj,NNP-NNP,NNP-NNP,5,0
13686,13411.0,60,include,3,35,37,2,34,22,-32,34,DJ,Armand Van Helden,per,--,NOUN,PROPN-PROPN-PROPN,compound,compound-compound-nsubj,NN,NNP-NNP-NNP,3,0
13687,13412.0,37,Today's,1,13,18,5,12,18,-12,17,James Francis Edward Stuart,Prince,---,per,PROPN-PROPN-PROPN-PROPN,PROPN,compound-compound-compound-pobj,appos,NNP-NNP-NNP-NNP,NNP,2,0
13688,13413.0,45,group,2,1,19,18,0,25,1,17,Raila,Kenya,per,,PROPN,PROPN,poss,pobj,NNP,NNP,4,0
13689,13414.0,22,located,17,1,20,19,0,1,16,3,Fort Zumwalt West High School,O'Fallon,----,org,PROPN-PROPN-PROPN-PROPN-PROPN,PROPN,compound-compound-compound-compound-nsubjpass,compound,NNP-NNP-NNP-NNP-NNP,NNP,4,0
13690,13415.0,19,is,9,8,13,5,7,5,1,4,VMGR-452,United States,,per-per,PROPN,PROPN-PROPN,appos,compound-compound,NNP,NNP-NNP,5,0
13691,13417.0,11,is,2,1,9,8,0,1,1,7,Kimberly Burrell,Houston,per-per,,PROPN-PROPN,PROPN,compound-nsubj,compound,NNP-NNP,NNP,4,0
13692,13418.0,57,In,0,2,24,22,1,32,-2,24,La Jornada,Mexico,-,per,PROPN-PROPN,PROPN,compound-pobj,pobj,NNP-NNP,NNP,-1,0
13693,13419.0,32,decided,5,17,23,6,16,8,-12,18,Kuomintang,Republic of China,per,--,PROPN,PROPN-ADP-PROPN,dobj,nmod-prep-pobj,NNP,NNP-IN-NNP,3,0
13694,13421.0,14,structured,1,6,12,6,5,1,-5,11,them,Stax,,org,PRON,PROPN,nsubj,compound,PRP,NNP,3,0
13695,13424.0,32,became,23,23,31,8,22,0,0,8,College,1859,per,,PROPN,NUM,pobj,nummod,NNP,CD,7,0
13696,13425.0,36,is,9,1,8,7,0,27,8,-1,Neal Hargrove,Reno Riggins,org-org,-,PROPN-PROPN,PROPN-PROPN,compound-nsubj,compound-nsubj,NNP-NNP,NNP-NNP,4,0
13697,13426.0,28,is,10,1,21,20,0,6,9,11,Nodar Vladimirovich Khashba,Abkhazia,org-org-org,,NOUN-PROPN-PROPN,PROPN,compound-compound-nsubj,pobj,NN-NNP-NNP,NNP,7,0
13698,13428.0,14,features,3,5,13,8,4,0,-2,10,Jon Bon Jovi,Dorothea,per-per-per,,PROPN-PROPN-PROPN,PROPN,compound-compound-poss,appos,NNP-NNP-NNP,NNP,4,0
13699,13430.0,32,was,11,8,13,5,7,18,3,2,Connecticut,Prescott Bush,,per-per,PROPN,PROPN-PROPN,dobj,compound-attr,NNP,NNP-NNP,3,0
13700,13431.0,25,belongs,7,18,20,2,17,4,-11,13,Deutsche Telekom,AG,org-org,,PROPN-PROPN,PROPN,compound-compound,conj,NNP-NNP,NNP,2,0
13701,13432.0,20,Hunter,1,1,19,18,0,0,0,18,James Hunter,singer,org-org,,PROPN-PROPN,NOUN,compound-ROOT,attr,NNP-NNP,NN,4,0
13702,13433.0,37,founded,7,2,10,8,1,26,5,3,World Wind Energy Association,2001,org-org-org-org,,PROPN-PROPN-PROPN-PROPN,NUM,compound-compound-compound-compound,pobj,NNP-NNP-NNP-NNP,CD,5,0
13703,13434.0,36,conducted,4,17,35,18,16,0,-13,31,John McEwen,Australia,org-org,,PROPN-PROPN,PROPN,compound-pobj,conj,NNP-NNP,NNP,5,0
13704,13435.0,26,composed,7,4,1,-3,3,24,3,-6,Health Sciences Centre,Vancouver General Hospital,org-org-org,--,PROPN-PROPN-PROPN,PROPN-PROPN-PROPN,compound-conj-nsubjpass,compound-compound-compound,NNP-NNPS-NNP,NNP-NNP-NNP,2,0
13705,13436.0,24,said,11,18,22,4,17,1,-7,11,Liberal,Wayne Easter,,per-per,ADJ,PROPN-PROPN,amod,compound-appos,JJ,NNP-NNP,-1,0
13706,13437.0,15,contains,8,1,6,5,0,8,7,-2,SWV,RCA,per,,PROPN,PROPN,poss,nmod,NNP,NNP,5,0
13707,13439.0,24,finished,1,1,5,4,0,18,0,4,He,Belgrade,,per,PRON,PROPN,nsubj,pobj,PRP,NNP,1,0
13708,13441.0,26,signed,3,12,18,6,11,7,-9,15,Ministry for the Environment,New Zealand,per-per-per-per,-,PROPN-ADP-DET-PROPN,PROPN-PROPN,appos-prep-det-compound,compound-appos,NNP-IN-DT-NNP,NNP-NNP,1,0
13709,13442.0,34,nominated,12,6,25,19,5,8,6,13,Jeff Sessions,Alabama,per-per,,PROPN-PROPN,PROPN,compound-pobj,pobj,NNP-NNPS,NNP,5,0
13710,13443.0,37,emerged,2,13,13,0,12,23,-11,11,Cyprus,Cyprus National Football Team,,org-org-org-org,PROPN,PROPN-PROPN-PROPN-PROPN,pobj,compound-compound-compound-nsubj,NNP,NNP-NNP-NNP-NNP,0,0
13711,13445.0,24,rose,4,4,19,15,3,4,0,15,Cruz,Cuba,per,,PROPN,PROPN,nsubj,dobj,NNP,NNP,1,0
13712,13446.0,28,acquired,6,5,16,11,4,11,1,10,Lanka Hospitals Corporation PLC,Apollo Hospitals,per-per-per-per,-,PROPN-PROPN-PROPN-PROPN,PROPN-PROPN,compound-compound-compound-dobj,compound-compound,NNP-NNPS-NNP-NNP,NNP-NNPS,3,0
13713,13447.0,45,started,2,18,24,6,17,20,-16,22,Parkash Singh Badal,Shiromani Akali Dal,--,org-org-org,PROPN-PROPN-PROPN,PROPN-PROPN-PROPN,compound-compound-pobj,compound-compound-compound,NNP-NNP-NNP,NNP-NNP-NNP,6,0
13714,13448.0,35,serialized,11,14,16,2,13,18,-3,5,Shueisha,Weekly Shnen Jum,org,--,PROPN,PROPN-PROPN-PROPN,poss,compound-compound-nmod,NNP,NNP-NNP-NNP,5,0
13715,13452.0,17,released,9,8,12,4,7,4,1,3,Winger,Frontiers,per,,PROPN,PROPN,pobj,compound,NNP,NNP,6,0
13716,13453.0,29,toyed,11,1,10,9,0,18,10,-1,Baldwin,Conservative,per,,VERB,PROPN,nsubj,compound,VB,NNP,6,0
13717,13454.0,20,enjoyed,2,7,19,12,6,0,-5,17,Yoshitoshi,Edo,,per,PROPN,PROPN,nsubj,pobj,NNP,NNP,4,0
13718,13455.0,48,collaborated,3,16,31,15,15,16,-13,28,DONG Energy,Denmark,per-per,,PROPN-PROPN,PROPN,conj-dobj,pobj,NNP-NNP,NNP,12,0
13719,13456.0,23,founded,5,14,17,3,13,5,-9,12,Grand Haven,Alter,-,org,PROPN-PROPN,PROPN,compound-compound,compound,NNP-NNP,NNP,3,0
13720,13458.0,14,speaks,8,1,6,5,0,7,7,-2,Nick Griffin,British National Party,-,per-per-per,PROPN-PROPN,PROPN-PROPN-PROPN,compound-compound,compound-compound-pobj,NNP-NNP,NNP-NNP-NNP,4,0
13721,13459.0,24,proceeded,2,19,21,2,18,2,-17,19,ASU,Kenneth E. Peacock,org,--,PROPN,PROPN-PROPN-PROPN,compound,compound-compound-pobj,NNP,NNP-NNP-NNP,2,0
13722,13460.0,65,born,11,7,9,2,6,55,4,-2,Greek,Konstantinos Karamanlis,per,-,ADJ,PROPN-PROPN,amod,compound-pobj,JJ,NNP-NNP,1,0
13723,13461.0,14,released,5,1,13,12,0,0,4,8,Workman,Canada,per,,PROPN,PROPN,poss,appos,NNP,NNP,6,0
13724,13462.0,28,is,2,7,12,5,6,15,-5,10,Pulte Homes,USA,per-per,,PROPN-PROPN,PROPN,compound-pobj,poss,NNP-NNP,NNP,5,0
13725,13463.0,29,founded,4,1,27,26,0,1,3,23,The Freedom Association,John Gouriet,per-per-per,-,DET-PROPN-PROPN,PROPN-PROPN,det-compound-nsubjpass,compound-conj,DT-NNP-NNP,NNP-NNP,7,0
13726,13464.0,55,defeated,13,12,11,-1,11,43,1,-2,Ben Chifley,Australia,org-org,,PROPN-PROPN,PROPN,compound-pobj,pobj,NNP-NNP,NNP,1,0
13727,13944.0,47,defeated,13,12,11,-1,11,35,1,-2,Ben Chifley,Australia,per-per,,PROPN-PROPN,PROPN,compound-pobj,pobj,NNP-NNP,NNP,1,0
13728,13465.0,55,was,7,1,39,38,0,15,6,32,Hans Theodor Bucherer,University of Munich University of Karlsruhe,per-per-per,-----,PROPN-PROPN-PROPN,PROPN-ADP-PROPN-PROPN-ADP-PROPN,compound-compound-nsubj,pobj-prep-compound-pobj-prep-pobj,NNP-NNP-NNP,NNP-IN-NNP-NNP-IN-NNP,7,0
13729,13467.0,25,received,5,11,17,6,10,7,-6,12,Governorate,Giovanni Lajolo,org,-,PROPN,PROPN-PROPN,pobj,compound-pobj,NNP,NNP-NNP,4,0
13730,13468.0,45,is,1,1,10,9,0,34,0,9,Milan,Silvio Berlusconi,per,-,PROPN,PROPN-PROPN,nsubj,compound-poss,NNP,NNP-NNP,3,0
13731,13469.0,27,is,3,16,20,4,15,6,-13,17,Fiji Teachers Union,FTU,org-org-org,,PROPN-PROPN-PROPN,PROPN,compound-compound-pobj,appos,NNP-NNPS-NNP,NNP,3,0
13732,13471.0,20,contained,5,1,7,6,0,12,4,2,The Wailers,Bob Marley,-,org-org,DET-PROPN,PROPN-PROPN,det-nsubj,compound-compound,DT-NNPS,NNP-NNP,3,0
13733,13473.0,28,is,4,6,6,0,5,21,-2,2,Alaska,Alaska Air National Guard,,org-org-org-org,PROPN,PROPN-PROPN-PROPN-PROPN,poss,compound-compound-compound-conj,NNP,NNP-NNP-NNP-NNP,0,0
13734,13474.0,35,has,27,22,26,4,21,8,5,-1,Ed Schafer,Agriculture,-,per,PROPN-PROPN,PROPN,compound-pobj,compound,NNP-NNP,NNP,8,0
13735,13477.0,75,By,0,47,52,5,46,22,-47,52,Frontier Force Regiment,Army,org-org-org,,PROPN-PROPN-PROPN,PROPN,compound-compound-compound,ROOT,NNP-NNP-NNP,NNP,2,0
13736,13478.0,29,spread,5,20,25,5,19,3,-15,20,Cosmote,OTE,org,,PROPN,PROPN,pobj,compound,NNP,NNP,5,0
13737,13480.0,23,granted,17,2,11,9,1,11,15,-6,his,United States,per,-,DET,PROPN-PROPN,poss,compound-compound,PRP$,NNP-NNP,6,0
13738,13481.0,32,designed,3,12,18,6,11,13,-9,15,R. J. Mitchell,Supermarine,--,per,PROPN-PROPN-PROPN,PROPN,compound-nmod-compound,compound,NNP-NNP-NNP,NNP,4,0
13739,13484.0,23,received,2,17,21,4,16,1,-15,19,his,Connecticut,org,,DET,PROPN,poss,conj,PRP$,NNP,2,0
13740,13485.0,44,composed,2,7,7,0,6,36,-5,5,Joint,Joint Force Headquarters National Capital Region,per,-----,PROPN,PROPN-PROPN-PROPN-PROPN-PROPN-PROPN,compound,compound-compound-compound-compound-compound-compound,NNP,NNP-NNP-NNP-NNP-NNP-NNP,0,0
13741,13487.0,36,was,1,13,13,0,12,22,-12,12,Washington Hospital Center,Washington,per-per-per,,PROPN-PROPN-PROPN,PROPN,compound-compound-pobj,compound,NNP-NNP-NNP,NNP,0,0
13742,13489.0,22,affiliated,2,6,11,5,5,10,-4,9,New Jersey Medical School,UMDNJ,per-per-per-per,,PROPN-PROPN-PROPN-PROPN,PROPN,compound-compound-compound-pobj,pobj,NNP-NNP-NNP-NNP,NNP,2,0
13743,13493.0,26,considered,16,5,25,20,4,0,11,9,Sinn Sisamouth,Cambodia,-,per,PROPN-PROPN,PROPN,compound-pobj,pobj,NNP-NNP,NNP,5,0
13744,13494.0,21,On,0,15,20,5,14,0,-15,20,his,Brooklyn,org,,DET,PROPN,poss,pobj,PRP$,NNP,2,0
13745,13495.0,39,said,2,15,19,4,14,19,-13,17,Vanity Fair,United States,-,per-per,PROPN-PROPN,PROPN-PROPN,compound-appos,compound-pobj,NNP-NNP,NNP-NNP,4,0
13746,13496.0,93,organized,3,11,23,12,10,69,-8,20,Sri Lanka Police,Special Task Force,--,org-org-org,PROPN-PROPN-PROPN,PROPN-PROPN-PROPN,compound-compound-compound,compound-compound-nsubj,NNP-NNP-NNP,NNP-NNP-NNP,-1,0
13747,13497.0,31,confirmed,11,6,11,5,5,19,5,0,G-Unit,Banks,per,,PROPN,PROPN,punct,pobj,NNP,NNP,4,0
13748,13498.0,33,came,2,2,8,6,1,24,0,6,Desmond,San Francisco,per,-,PROPN,PROPN-PROPN,nsubj,compound-pobj,NNP,NNP-NNP,4,0
13749,13500.0,25,Incorporated,0,4,22,18,3,2,-4,22,Great Eastern Life,Singapore,org-org-org,,ADJ-PROPN-PROPN,PROPN,compound-compound-compound,pobj,JJ-NNP-NNP,NNP,7,0
13750,13501.0,52,OrgName,0,3,19,16,2,32,-3,19,Charter Communications,MO,-,per,PROPN-PROPN,NOUN,compound-compound,compound,NNP-NNPS,NN,3,0
13751,13502.0,28,is,9,19,25,6,18,2,-10,16,the Hartt School,West Hartford,--,per-per,DET-PROPN-PROPN,PROPN-PROPN,det-compound-pobj,compound-compound,DT-NNP-NNP,NNP-NNP,4,0
13752,13503.0,34,mentioned,1,13,18,5,12,15,-12,17,Ontario,Marie Bountrogianni,per,-,PROPN,PROPN-PROPN,poss,compound-nsubj,NNP,NNP-NNP,3,0
13753,13504.0,32,is,1,1,21,20,0,10,0,20,B4U,Lakshmi Mittal,per,-,PROPN,PROPN-PROPN,nsubj,compound-compound,NNP,NNP-NNP,9,0
13754,13505.0,31,played,24,12,14,2,11,16,12,-10,Seconds,Kevin Seconds,org,-,PROPN,PROPN-PROPN,compound,compound-appos,NNPS,NNP-NNP,1,0
13755,13507.0,36,continued,26,13,20,7,12,15,13,-6,Columbia,Clarence White,,per-per,PROPN,PROPN-PROPN,compound,compound-compound,NNP,NNP-NNP,5,0
13756,13508.0,84,had,2,43,46,3,42,37,-41,44,Marshall Mathers,Eminem,per-per,,PROPN-PROPN,PROPN,compound-compound,compound,NNP-NNP,NNP,3,0
13757,13509.0,19,faces,1,1,9,8,0,9,0,8,Collins,Maine,org,,PROPN,PROPN,nsubj,pobj,NNP,NNP,2,0
13758,13510.0,34,Monte,2,18,28,10,17,5,-16,26,Rhode Island Hospital,Brown University,--,org-org,PROPN-PROPN-PROPN,PROPN-PROPN,compound-compound-conj,compound-compound,NNP-NNP-NNP,NNP-NNP,6,0
13759,13511.0,20,include,4,15,19,4,14,0,-11,15,Royal Canadian Mint,Ottawa,per-per-per,,PROPN-PROPN-PROPN,PROPN,compound-compound-conj,pobj,NNP-NNP-NNP,NNP,7,0
13760,13512.0,40,are,7,12,28,16,11,11,-5,21,Illinois,Parkland College,per,-,PROPN,PROPN-PROPN,compound,compound-compound,NNP,NNP-NNP,8,0
13761,13514.0,41,was,1,9,25,16,8,15,-8,24,Rangoon,Ne Win,per,-,PROPN,PROPN-PROPN,compound,compound-poss,NNP,NNP-NNP,13,0
13762,13515.0,41,received,2,2,7,5,1,33,0,5,Shapley,Princeton University,org,-,PROPN,PROPN-PROPN,nsubj,compound-pobj,NNP,NNP-NNP,3,0
13763,13516.0,47,made,17,26,29,3,25,17,-9,12,Greece,Emporiki Bank,per,-,PROPN,PROPN-PROPN,poss,compound-dobj,NNP,NNP-NNP,3,0
13764,13518.0,27,was,4,2,24,22,1,2,2,20,Dungeon of Doom,1995,--,per,PROPN-ADP-PROPN,NUM,nsubj-prep-pobj,pobj,NNP-IN-NNP,CD,7,0
13765,13519.0,18,was,1,7,10,3,6,7,-6,9,University of Northern Colorado,Colorado,per-per-per-per,,PROPN-ADP-PROPN-PROPN,PROPN,pobj-prep-compound-pobj,pobj,NNP-IN-NNP-NNP,NNP,4,0
13766,13520.0,12,is,2,1,1,0,0,10,1,-1,Gulbarga University,Gulbarga,per-per,,PROPN-PROPN,PROPN,compound-nsubj,compound,NNP-NNP,NNP,0,0
13767,13521.0,25,became,2,10,16,6,9,8,-8,14,1929,Southern Vectis,,per-per,NUM,PROPN-PROPN,pobj,compound-compound,CD,NNP-NNP,4,0
13768,13523.0,27,is,10,21,25,4,20,1,-11,15,Las Vegas,Wynn Resorts,per-per,-,PROPN-PROPN,PROPN-PROPN,compound-compound,compound-pobj,NNP-NNP,NNP-NNPS,2,0
13769,13525.0,48,is,2,1,21,20,0,26,1,19,Yrigoyen,Argentina,per,,PROPN,PROPN,compound,pobj,NNP,NNP,5,0
13770,13526.0,46,bought,9,4,19,15,3,26,5,10,his,New York,org,-,DET,PROPN-PROPN,poss,nmod-nmod,PRP$,NNP-NNP,7,0
13771,13528.0,25,distributed,19,1,9,8,0,15,18,-10,Locus Computing Corporation,Gerald J. Popek,--,org-org-org,PROPN-PROPN-PROPN,PROPN-PROPN-PROPN,compound-compound-nsubjpass,compound-compound-pobj,NNP-NNP-NNP,NNP-NNP-NNP,5,0
13772,13529.0,17,is,4,2,3,1,1,13,2,-1,Royal Gibraltar Regiment,Gibraltar,org-org-org,,PROPN-PROPN-PROPN,PROPN,compound-compound-nsubj,pobj,NNP-NNP-NNP,NNP,1,0
13773,13530.0,32,been,4,9,30,21,8,1,-5,26,Italy,Vittorio Gassman,per,-,PROPN,PROPN-PROPN,pobj,compound-dobj,NNP,NNP-NNP,6,0
13774,13531.0,47,filed,4,3,10,7,2,36,1,6,Rogers Cable,Ontario,-,org,PROPN-PROPN,PROPN,compound-nsubj,compound,NNP-NNP,NNP,3,0
13775,13532.0,24,ranked,8,4,6,2,3,17,4,-2,Iowa,UNI,org,,PROPN,PROPN,nsubjpass,appos,NNP,NNP,2,0
13776,13533.0,20,established,2,1,12,11,0,7,1,10,IETV,Israeli Ministry of Education,per,---,PROPN,ADJ-PROPN-ADP-PROPN,nsubjpass,amod-pobj-prep-pobj,NNP,JJ-NNP-IN-NNP,5,0
13777,13534.0,25,opened,2,6,10,4,5,14,-4,8,Hesburger,Turku,,org,PROPN,PROPN,dobj,pobj,NNP,NNP,4,0
13778,13535.0,51,continued,4,13,49,36,12,1,-9,45,Iran,MIO,,per,PROPN,PROPN,poss,appos,NNP,NNP,-1,0
13779,13537.0,43,Cooper,2,23,13,-10,22,29,-21,11,Fremantle Football Club,Australian Football League,org-org-org,--,PROPN-PROPN-PROPN,PROPN-PROPN-PROPN,compound-compound-pobj,compound-compound-pobj,NNP-NNP-NNP,NNP-NNP-NNP,6,0
13780,13538.0,41,starred,28,20,26,6,19,14,8,-2,Megan Mullally,Nick Offerman,per-per,-,PROPN-ADV,PROPN-PROPN,compound-advmod,compound-compound,NNP-RB,NNP-NNP,8,0
13781,13539.0,43,followed,2,8,19,11,7,23,-6,17,Thai,Banharn Silpa-archa,,org-org,PROPN,PROPN-PROPN,compound,compound-appos,NNP,NNP-NNP,9,0
13782,13540.0,24,defeated,2,1,15,14,0,8,1,13,Hackenschmidt,England,,org,PROPN,PROPN,nsubj,pobj,NNP,NNP,4,0
13783,13541.0,27,is,3,1,17,16,0,9,2,14,York High School,2007,per-per-per,,PROPN-PROPN-PROPN,NUM,compound-compound-nsubj,pobj,NNP-NNP-NNP,CD,5,0
13784,13544.0,14,earned,1,1,9,8,0,4,0,8,He,University of Stockholm,per,--,PRON,PROPN-ADP-PROPN,nsubj,pobj-prep-pobj,PRP,NNP-IN-NNP,3,0
13785,13545.0,41,continued,8,3,8,5,2,32,5,0,Brooklyn,Paley,per,,PROPN,PROPN,pobj,nsubj,NNP,NNP,2,0
13786,13547.0,36,become,5,17,28,11,16,7,-12,23,John Lennon,The Quarrymen,-,org-org,PROPN-PROPN,DET-PROPN,compound-poss,det-appos,NNP-NNP,DT-NNP,7,0
13787,13549.0,47,unravels,17,9,15,6,8,31,8,-2,London,Gemma Jones,per,-,PROPN,PROPN-PROPN,compound,compound-conj,NNP,NNP-NNP,2,0
13788,13550.0,46,documented,6,24,33,9,23,12,-18,27,Brazilian Catholic Apostolic Church,1945,org-org-org-org,,ADJ-PROPN-PROPN-PROPN,NUM,amod-compound-compound-dobj,pobj,JJ-NNP-NNP-NNP,CD,-1,0
13789,13553.0,8,is,5,2,5,3,1,2,3,0,Keren Woodward,Bananarama,org-org,,PROPN-PROPN,PROPN,compound-nsubj,pobj,NNP-NNP,NNP,1,0
13790,13555.0,31,established,5,1,15,14,0,15,4,10,Medway School of Pharmacy,Kent,per-per-per-per,,PROPN-PROPN-ADP-PROPN,PROPN,compound-nsubjpass-prep-pobj,pobj,NNP-NNP-IN-NNP,NNP,8,0
13791,13556.0,35,said,22,1,21,20,0,13,21,-1,Bulgaria,Sergey Stanishev,per,-,PROPN,PROPN-PROPN,poss,compound-nsubj,NNP,NNP-NNP,5,0
13792,13557.0,41,are,2,23,34,11,22,6,-21,32,Cuba,Gerardo Machado,per,-,PROPN,PROPN-PROPN,pobj,compound-pobj,NNP,NNP-NNP,8,0
13793,13558.0,55,built,3,31,43,12,30,11,-28,40,Catholic University of Leuven,Katholieke Universiteit Leuven,---,per-per-per,PROPN-PROPN-ADP-PROPN,PROPN-PROPN-PROPN,compound-pobj-prep-pobj,compound-compound-appos,NNP-NNP-IN-NNP,NNP-NNP-NNP,12,0
13794,13560.0,87,is,1,10,16,6,9,70,-9,15,Al-Quds University,Sari Nusseibeh,org-org,-,PROPN-PROPN,PROPN-PROPN,compound-nsubj,compound-pobj,NNP-NNP,NNP-NNP,4,0
13795,13561.0,21,were,3,2,15,13,1,5,1,12,Middlesbrough Bears,1939,-,per,PROPN-PROPN,NUM,compound-nsubj,pobj,NNP-NNP,CD,4,0
13796,13562.0,50,said,16,8,15,7,7,34,8,-1,Wake Forest University,North Carolina,--,per-per,PROPN-PROPN-PROPN,PROPN-PROPN,compound-compound-compound,compound-pobj,NNP-NNP-NNP,NNP-NNP,6,0
13797,13563.0,35,In,0,7,9,2,6,25,-7,9,Polydor,he,,per,PROPN,PRON,compound,nsubj,NNP,PRP,7,0
13798,13564.0,18,moved,2,1,7,6,0,10,1,5,She,Ohio,org,,PRON,PROPN,nsubj,pobj,PRP,NNP,2,0
13799,13565.0,22,said,8,2,7,5,1,14,6,-1,Kenya Airways,Titus Naikuni,per-per,-,PROPN-PROPN,PROPN-PROPN,compound-compound,compound-nsubj,NNP-NNP,NNP-NNP,3,0
13800,13566.0,31,created,3,8,20,12,7,10,-5,17,2006,Kollektivtransportproduksjon,per,,NUM,PROPN,nummod,dobj,CD,NNP,7,0
13801,13568.0,15,finished,2,2,12,10,1,2,0,10,Orange,Big East,,org-org,PROPN,PROPN-PROPN,nsubj,compound-compound,NNP,NNP-NNP,4,0
13802,13569.0,40,was,5,11,26,15,10,13,-6,21,Ely Ould Mohamed Vall,Mauritania,---,org,PROPN-PROPN-PROPN-PROPN,PROPN,compound-compound-compound-conj,pobj,NNP-NNP-NNP-NNP,NNP,9,0
13803,13571.0,76,born,3,7,26,19,6,49,-4,23,Alabama,Miles College,per,-,PROPN,PROPN-PROPN,pobj,compound-conj,NNP,NNP-NNP,6,0
13804,13572.0,27,mounted,6,21,26,5,20,0,-15,20,Italy,Fastweb,,org,PROPN,PROPN,poss,appos,NNP,NNP,8,0
13805,13573.0,13,is,3,2,2,0,1,10,1,-1,Geely,Geely Automobile,per,-,PROPN,PROPN-PROPN,compound,compound-pobj,NNP,NNP-NNP,0,0
13806,13574.0,66,faces,4,40,63,23,39,2,-36,59,Barcelona,La Liga,org,-,PROPN,PROPN-PROPN,conj,compound-compound,NNP,NNP-NNP,10,0
13807,13575.0,15,is,1,9,14,5,8,0,-8,13,Trinity College of Music,London,per-per-per-per,,PROPN-PROPN-ADP-PROPN,PROPN,compound-pobj-prep-pobj,pobj,NNP-NNP-IN-NNP,NNP,6,0
13808,13578.0,30,Breathless,0,18,29,11,17,0,-18,29,Jean Seberg,Paris,org-org,,PROPN-PROPN,PROPN,compound-conj,pobj,NNP-NNP,NNP,7,0
13809,13580.0,31,is,15,13,28,15,12,2,2,13,Aerial,Texas,,org,PROPN,PROPN,compound,compound,NNP,NNP,11,0
13810,13581.0,36,known,1,4,35,31,3,0,-3,34,Issaquah School District,district,--,per,PROPN-PROPN-PROPN,NOUN,compound-compound-pobj,pobj,NNP-NNP-NNP,NN,5,0
13811,13582.0,25,forged,12,2,10,8,1,14,10,-2,Ritchie,Maryland,per,,PROPN,PROPN,poss,dobj,NNP,NNP,3,0
13812,13583.0,24,launched,3,11,11,0,10,12,-8,8,Manchester,Manchester Metropolitan University,,per-per-per,PROPN,PROPN-PROPN-PROPN,compound,compound-compound-parataxis,NNP,NNP-NNP-NNP,0,0
13813,13584.0,31,is,1,22,29,7,21,1,-21,28,Andy Whittall,Zimbabwean,per-per,,PROPN-PROPN,ADJ,compound-pobj,amod,NNP-NNP,JJ,5,0
13814,13586.0,21,was,1,8,8,0,7,12,-7,7,Taylor Wimpey,Taylor Woodrow,org-org,-,PROPN-PROPN,PROPN-PROPN,compound-compound,compound-compound,NNP-NNP,NNP-NNP,0,0
13815,13587.0,31,merged,4,2,8,6,1,22,2,4,2003,Communist Party of India,org,---,NUM,PROPN-PROPN-ADP-PROPN,pobj,compound-dobj-prep-pobj,CD,NNP-NNP-IN-NNP,4,0
13816,13588.0,26,was,5,5,4,-1,4,21,0,-1,Adelaide of Saxe-Meiningen,Queen consort,--,per-per,PROPN-ADP-PROPN,PROPN-NOUN,pobj-prep-compound,conj-appos,NNP-IN-NNP,NNP-NN,3,0
13817,13591.0,56,lawsuit,1,5,8,3,4,47,-4,7,Pioneer Hi-Bred,DuPont,org-org,,PROPN-VERB,PROPN,pobj-prep,compound,NNP-VBD,NNP,6,0
13818,13592.0,27,elected,10,9,14,5,8,12,1,4,Cook,New South Wales,org,--,PROPN,PROPN-PROPN-PROPN,pobj,compound-compound-compound,NNP,NNP-NNP-NNP,5,0
13819,13595.0,39,had,6,4,24,20,3,14,2,18,Italy,Antena 3,org,-,PROPN,PROPN-NUM,poss,npadvmod-nummod,NNP,NNP-CD,7,0
13820,13596.0,29,is,9,8,12,4,7,16,1,3,Switzerland,Swiss Super League,,per-per-per,PROPN,PROPN-PROPN-PROPN,appos,compound-compound-pobj,NNP,NNP-NNP-NNP,5,0
13821,13597.0,29,include,7,25,27,2,24,1,-18,20,Canada,Railpower Technologies,,per-per,PROPN,PROPN-PROPN,poss,compound-pobj,NNP,NNP-NNPS,3,0
13822,13598.0,78,exist,5,13,29,16,12,48,-8,24,Marx Brothers,Leonard,-,per,PROPN-PROPN,PROPN,compound-pobj,compound,NNP-NNPS,NNP,5,0
13823,13599.0,20,is,6,12,19,7,11,0,-6,13,University of Engineering and Technology,Pakistan,----,org,PROPN-ADP-PROPN-CCONJ-PROPN,PROPN,pobj-prep-pobj-cc-conj,pobj,NNP-IN-NNP-CC-NNP,NNP,5,0
13824,13603.0,23,is,16,15,19,4,14,3,1,3,Gerrie Coetzee,South African,-,org-org,PROPN-PROPN,ADJ-ADJ,compound-pobj,amod-amod,NNP-NNP,JJ-JJ,3,0
13825,13607.0,33,lets,18,13,26,13,12,6,5,8,Merseyside Passenger Transport Executive,London,---,org,PROPN-PROPN-PROPN-PROPN,PROPN,compound-compound-compound-nsubj,pobj,NNP-NNP-NNP-NNP,NNP,3,0
13826,13608.0,29,released,3,12,15,3,11,13,-9,12,Geoff Rickly,Thursday,-,org,PROPN-PROPN,PROPN,compound-conj,poss,NNP-NNP,NNP,4,0
13827,13609.0,68,was,2,38,48,10,37,19,-36,46,Prime Minister,John A. Macdonald,org-org,--,PROPN-PROPN,PROPN-PROPN-PROPN,compound-poss,compound-compound-advcl,NNP-NNP,NNP-NNP-NNP,5,0
13828,13610.0,25,established,3,17,24,7,16,0,-14,21,Shahjalal University,Bangladesh,org-org,,PROPN-PROPN,PROPN,compound-nmod,pobj,NNP-NNP,NNP,6,0
13829,13611.0,23,father,1,8,9,1,7,13,-7,8,Justice,Robert Badinter,org,-,PROPN,PROPN-PROPN,compound,compound-nsubj,NNP,NNP-NNP,1,0
13830,13612.0,33,met,15,8,12,4,7,20,7,-3,his,Laos,,org,DET,PROPN,poss,compound,PRP$,NNP,3,0
13831,13613.0,17,is,7,13,15,2,12,1,-6,8,Morrissey,The Smiths,per,-,PROPN,DET-PROPN,pobj,det-conj,NNP,DT-NNPS,2,0
13832,13614.0,24,retained,4,13,16,3,12,7,-9,12,Mahyar Monshipour,France,-,org,PROPN-PROPN,PROPN,compound-dobj,pobj,NNP-NNP,NNP,2,0
13833,13615.0,44,BEIJING,0,1,9,8,0,34,-1,9,BEIJING,Beihai Fleet,org,-,PROPN,PROPN-PROPN,ROOT,compound-nsubj,NNP,NNP-NNP,-1,0
13834,13616.0,31,CITY,1,10,22,12,9,8,-9,21,Kuwait,National Bank of Kuwait,per,---,PROPN,PROPN-PROPN-ADP-PROPN,poss,compound-nsubj-prep-pobj,NNP,NNP-NNP-IN-NNP,6,0
13835,13618.0,20,remained,2,6,18,12,5,1,-4,16,Pierce,New Hampshire,,per-per,PROPN,PROPN-PROPN,compound,compound-pobj,NNP,NNP-NNP,9,0
13836,13620.0,32,opened,20,1,23,22,0,8,19,3,Good Samaritan Hospital,1852,org-org-org,,PROPN-PROPN-PROPN,NUM,amod-compound-nsubjpass,pobj,NNP-NNP-NNP,CD,-1,0
13837,13622.0,23,sunk,3,14,18,4,13,4,-11,15,Duncan Sheik,composer,per-per,,PROPN-PROPN,NOUN,compound-nmod,nsubj,NNP-NNP,NN,5,0
13838,13623.0,32,formed,2,6,24,18,5,7,-4,22,2000,AgustaWestland,org,,NUM,PROPN,nummod,dobj,CD,NNP,3,0
13839,13624.0,27,Stephen,1,1,2,1,0,24,0,1,King,Stephen of England,,org-org-org,PROPN,PROPN-ADP-PROPN,compound,ROOT-prep-pobj,NNP,NNP-IN-NNP,1,0
13840,13626.0,11,includes,2,7,10,3,6,0,-5,8,George Pettit,Alexisonfire,org-org,,PROPN-PROPN,PROPN,compound-pobj,pobj,NNP-NNP,NNP,4,0
13841,13627.0,72,included,27,65,69,4,64,2,-38,42,Amy Gutmann,University of Pennsylvania,-,org-org-org,PROPN-PROPN,PROPN-ADP-PROPN,compound-conj,pobj-prep-pobj,NNP-NNP,NNP-IN-NNP,3,0
13842,13628.0,41,said,6,15,21,6,14,19,-9,15,Houston,Continental Airlines,,per-per,PROPN,PROPN-PROPN,pobj,compound-dobj,NNP,NNP-NNPS,8,0
13843,13632.0,31,is,8,2,8,6,1,22,6,0,University of Strathclyde,Scotland,per-per-per,,PROPN-ADP-PROPN,PROPN,nsubj-prep-pobj,nsubj,NNP-IN-NNP,NNP,2,0
13844,13634.0,37,born,2,5,17,12,4,19,-3,15,Solihull School,West Midlands,per-per,-,PROPN-PROPN,PROPN-PROPN,compound-pobj,compound-pobj,NNP-NNP,NNP-NNPS,7,0
13845,13635.0,21,asked,6,2,4,2,1,16,4,-2,his,Missouri,,per,DET,PROPN,poss,compound,PRP$,NNP,1,0
13846,13637.0,24,Kaludova,2,9,19,10,8,4,-7,17,#44; b,popula,-,per,NOUN-ADV,ADJ,nsubj-det,nmod,NNS-RB,JJ,6,0
13847,13638.0,19,located,13,1,1,0,0,17,12,-12,Harrison,Harrison High School,per,--,PROPN,PROPN-PROPN-PROPN,poss,compound-compound-conj,NNP,NNP-NNP-NNP,0,0
13848,13639.0,26,is,3,1,25,24,0,0,2,22,Carl August Tidemann,Winds,per-per-per,,PROPN-PROPN-PROPN,PROPN,compound-compound-nsubj,conj,NNP-NNP-NNP,NNP,11,0
13849,13641.0,41,flown,9,16,25,9,15,15,-7,16,309th Aerospace Maintenance and Regeneration Group,Air Force,org-org-org-org-org-org,-,PROPN-PROPN-PROPN-CCONJ-PROPN-PROPN,PROPN-PROPN,amod-nmod-pobj-cc-compound-compound,compound-compound,NNP-NNP-NNP-CC-NNP-NNP,NNP-NNP,5,0
13850,13642.0,32,entrepreneur,3,19,30,11,18,1,-16,27,William E. Macaulay Honors College,CUNY,----,per,PROPN-PROPN-PROPN-PROPN-PROPN,PROPN,compound-compound-compound-compound-pobj,compound,NNP-NNP-NNP-NNP-NNP,NNP,7,0
13851,13643.0,24,sent,6,11,23,12,10,0,-5,17,Yudhoyono,Indonesia,org,,PROPN,PROPN,pobj,conj,NNP,NNP,3,0
13852,13644.0,35,attacked,7,10,14,4,9,20,-3,7,Indian Institute of Science,Bangalore,---,per,PROPN-PROPN-ADP-PROPN,PROPN,compound-dobj-prep-compound,pobj,NNP-NNP-IN-NNP,NNP,4,0
13853,13645.0,15,had,3,2,13,11,1,1,1,10,Greece,Manos Hadjidakis,,per-per,PROPN,PROPN-PROPN,pobj,compound-conj,NNP,NNP-NNP,5,0
13854,13647.0,32,is,1,10,17,7,9,14,-9,16,John McCain,Arizona,per-per,,PROPN-PROPN,PROPN,compound-nmod,pobj,NNP-NNP,NNP,7,0
13855,13648.0,16,In,0,7,8,1,6,7,-7,8,Austria,Thomas Klestil,org,-,PROPN,PROPN-PROPN,pobj,compound-nsubj,NNP,NNP-NNP,1,0
13856,13649.0,36,cutting,4,16,19,3,15,16,-12,15,Italian Communist Party,Palmiro Togliatti,org-org-org,-,PROPN-PROPN-PROPN,PROPN-PROPN,amod-compound-pobj,compound-appos,NNP-NNP-NNP,NNP-NNP,3,0
13857,13651.0,21,aired,2,10,15,5,9,5,-8,13,NBC,United States,,per-per,PROPN,PROPN-PROPN,nmod,compound-pobj,NNP,NNP-NNP,3,0
13858,13653.0,65,operated,2,34,16,-18,33,48,-32,14,Australia,University of Western Sydney,org,---,PROPN,PROPN-ADP-PROPN-PROPN,ROOT,appos-prep-compound-pobj,NNP,NNP-IN-NNP-NNP,10,0
13859,13654.0,40,suggested,8,7,13,6,6,26,1,5,The Cars,Ric Ocasek,org-org,-,DET-PROPN,PROPN-PROPN,det-pobj,compound-compound,DT-NNPS,NNP-NNP,9,0
13860,13655.0,24,were,2,11,23,12,10,0,-9,21,Coastal Plain League,1997,org-org-org,,PROPN-PROPN-PROPN,NUM,compound-compound-compound,pobj,NNP-NNP-NNP,CD,8,0
13861,13656.0,22,won,1,11,16,5,10,5,-10,15,Hawaii,Inouye,org,,PROPN,PROPN,compound,conj,NNP,NNP,3,0
13862,13658.0,23,cut,6,4,22,18,3,0,2,16,Norske Skog,Norway,per-per,,PROPN-PROPN,PROPN,compound-nsubj,pobj,NNP-NNP,NNP,2,0
13863,13659.0,44,Delivered,1,10,7,-3,9,36,-9,6,Kingston,Royal Military College of Canada,org,----,PROPN,PROPN-PROPN-PROPN-ADP-PROPN,compound,compound-compound-dobj-prep-compound,NNP,NNP-NNP-NNP-IN-NNP,3,0
13864,13660.0,16,is,1,5,14,9,4,1,-4,13,Nile,Tony Laureano,,org-org,PROPN,PROPN-PROPN,compound,compound-pobj,NNP,NNP-NNP,5,0
13865,13664.0,36,joined,13,18,21,3,17,14,-5,8,Woodstock,Danko,,per,PROPN,PROPN,compound,compound,NNP,NNP,2,0
13866,13665.0,33,Institute,3,9,11,2,8,21,-6,8,IGIDR,Mumbai,,org,PROPN,PROPN,appos,nsubj,NNP,NNP,-1,0
13867,13666.0,29,created,4,7,22,15,6,6,-3,18,Venezolana,Maracaibo,,org,PROPN,PROPN,nmod,compound,NNP,NNP,8,0
13868,13667.0,63,serviced,2,1,1,0,0,61,1,-1,Covington,Covington High School,org,--,PROPN,PROPN-PROPN-PROPN,nsubjpass,compound-compound-appos,NNP,NNP-NNP-NNP,0,0
13869,13669.0,27,introduced,17,21,23,2,20,3,-4,6,Louisiana,Wayne Toups,org,-,PROPN,PROPN-PROPN,pobj,compound-pobj,NNP,NNP-NNP,1,0
13870,13670.0,33,based,3,30,32,2,29,0,-27,29,Avro,Company,per,,PROPN,PROPN,compound,pobj,NNP,NNP,7,0
13871,13671.0,16,was,2,10,11,1,9,4,-8,9,Senators,Lamar Alexander,,org-org,PROPN,PROPN-PROPN,pobj,compound-appos,NNP,NNP-NNP,1,0
13872,13673.0,45,known,11,8,15,7,7,29,3,4,HBC,The Bay,,org-org,PROPN,DET-PROPN,appos,det-nsubj,NNP,DT-NNP,6,0
13873,13674.0,21,became,7,5,9,4,4,11,2,2,Tong Sang,President,per-per,,PROPN-PROPN,PROPN,compound-nsubj,attr,NNP-NNP,NNP,2,0
13874,13675.0,32,is,1,1,14,13,0,17,0,13,ITV2,Isle of Man,,org-org-org,PROPN,PROPN-ADP-PROPN,nsubj,pobj-prep-pobj,NNP,NNP-IN-NNP,4,0
13875,13677.0,38,began,5,4,19,15,3,18,1,14,Jean-Luc Dehaene,Belgium,-,org,PROPN-PROPN,PROPN,compound-nsubj,poss,NNP-NNP,NNP,9,0
13876,13678.0,91,include,6,15,50,35,14,40,-9,44,New York City,Baruch College,per-per-per,-,PROPN-PROPN-PROPN,PROPN-PROPN,compound-compound-compound,compound-compound,NNP-NNP-NNP,NNP-NNP,13,0
13877,13679.0,52,was,1,1,6,5,0,45,0,5,Postmus,San Bernardino County,per,--,PROPN,PROPN-PROPN-PROPN,nsubj,compound-compound-compound,NNP,NNP-NNP-NNP,5,0
13878,13680.0,19,is,5,15,17,2,14,1,-10,12,RAF Tangmere,West Sussex,per-per,-,PROPN-PROPN,PROPN-PROPN,compound-compound,compound-pobj,NNP-NNP,NNP-NNP,1,0
13879,13681.0,17,attended,1,3,8,5,2,8,-2,7,Woodrow Wilson High School,Washington,---,org,PROPN-PROPN-PROPN-PROPN,PROPN,compound-compound-compound-dobj,compound,NNP-NNP-NNP-NNP,NNP,4,0
13880,13682.0,19,denied,10,1,15,14,0,3,9,5,Portugal,Salazar,per,,PROPN,PROPN,poss,conj,NNP,NNP,5,0
13881,13683.0,53,Following,5,15,20,5,14,32,-10,15,Tim DeLaughter,Dallas,org-org,,PROPN-PROPN,PROPN,compound-attr,compound,NNP-NNP,NNP,4,0
13882,13686.0,18,was,4,1,15,14,0,2,3,11,Trondheim Bilruter,1951,per-per,,PROPN-PROPN,NUM,compound-nsubj,pobj,NNP-NNP,CD,5,0
13883,13688.0,20,notified,10,5,9,4,4,10,5,-1,her,Warner,,per,PRON,PROPN,dobj,compound,PRP,NNP,4,0
13884,13689.0,32,included,5,24,27,3,23,4,-19,22,Gerard Arpey,American Airlines,-,org-org,PROPN-PROPN,PROPN-PROPN,compound-conj,compound-pobj,NNP-NNP,NNP-NNP,3,0
13885,13691.0,20,was,3,2,8,6,1,11,1,5,1987,News on Sunday,,org-org-org,NUM,PROPN-ADP-PROPN,pobj,pobj-prep-pobj,CD,NNP-IN-NNP,3,0
13886,13693.0,27,attended,11,10,11,1,9,15,1,0,Massachusetts,he,org,,PROPN,PRON,pobj,nsubj,NNP,PRP,1,0
13887,13694.0,101,worked,1,40,68,28,39,32,-39,67,University of Zambia,Zambia,org-org-org,,PROPN-ADP-PROPN,PROPN,nmod-prep-pobj,conj,NNP-IN-NNP,NNP,-1,0
13888,13696.0,19,moved,4,7,12,5,6,6,-3,8,Cyprus,Olympiakos Nicosia,,per-per,PROPN,PROPN-PROPN,pobj,compound-pobj,NNP,NNP-NNP,4,0
13889,13698.0,21,recorded,4,3,12,9,2,8,1,8,Dorothy Moore,Jackson,-,per,PROPN-PROPN,PROPN,compound-nsubj,compound,NNP-NNP,NNP,2,0
13890,13699.0,23,is,1,3,16,13,2,6,-2,15,Tarja Turunen,Finland,per-per,,PROPN-PROPN,PROPN,compound-nsubj,poss,NNP-NNP,NNP,8,0
13891,13703.0,37,Chang,1,11,18,7,10,18,-10,17,Mahathir bin Mohamad,Malaysia,--,per,PROPN-PROPN-PROPN,PROPN,compound-compound-nmod,pobj,NNP-NNP-NNP,NNP,4,0
13892,13704.0,30,encompass,3,2,23,21,1,6,1,20,Armed Forces,British Army,org-org,-,PROPN-PROPN,ADJ-PROPN,compound-nsubj,compound-conj,NNP-NNPS,JJ-NNP,6,0
13893,13705.0,16,is,2,1,13,12,0,2,1,11,Load Records,Providence,-,per,PROPN-PROPN,PROPN,compound-nsubj,compound,NNP-NNPS,NNP,5,0
13894,13706.0,46,was,5,14,37,23,13,8,-9,32,Minnesota,Midwestern Higher Education Compact,per,---,PROPN,PROPN-PROPN-PROPN-PROPN,compound,compound-compound-compound-appos,NNP,NNP-NNP-NNP-NNP,9,0
13895,13708.0,15,runs,1,1,8,7,0,6,0,7,Comcast,Style Network,per,-,PROPN,PROPN-PROPN,nsubj,compound-pobj,NNP,NNP-NNP,3,0
13896,13709.0,21,surrendered,11,7,11,4,6,9,4,0,Ukraine,Yurii,,org,PROPN,PROPN,pobj,nsubj,NNP,NNP,2,0
13897,13711.0,35,participating,2,13,19,6,12,15,-11,17,Jean,Canada,per,,PROPN,PROPN,nsubj,nsubj,NNP,NNP,2,0
13898,13714.0,26,resigned,1,10,16,6,9,9,-9,15,Pakistan,Ghulam Ishaq Khan,org,--,PROPN,PROPN-PROPN-PROPN,poss,compound-compound-appos,NNP,NNP-NNP-NNP,10,0
13899,13715.0,21,created,2,1,15,14,0,5,1,13,Nexient,Canada,,per,PROPN,PROPN,nsubjpass,poss,NNP,NNP,10,0
13900,13717.0,10,fonded,2,1,5,4,0,4,1,3,MEMRI,Yigal Carmon,,org-org,PROPN,PROPN-PROPN,nsubjpass,nmod-pobj,NNP,NNP-NNP,3,0
13901,13719.0,13,studied,9,2,8,6,1,4,7,-1,Stow College,Glasgow,-,org,PROPN-PROPN,PROPN,compound-pobj,pobj,NNP-NNP,NNP,3,0
13902,13720.0,32,established,3,9,16,7,8,15,-6,13,1836,University College London,per,--,NUM,PROPN-PROPN-PROPN,pobj,compound-compound-appos,CD,NNP-NNP-NNP,5,0
13903,13721.0,40,are,7,12,13,1,11,26,-5,6,actress,Samantha Mumba,,org-org,NOUN,PROPN-PROPN,conj,compound-compound,NN,NNP-NNP,1,0
13904,13723.0,23,plumber,1,9,18,9,8,4,-8,17,Dean,Richmond,,per,PROPN,PROPN,nsubj,compound,NNP,NNP,1,0
13905,13724.0,19,went,3,3,7,4,2,11,0,4,she,Berlin,,per,PRON,PROPN,nsubj,dobj,PRP,NNP,3,0
13906,13727.0,25,Born,0,4,22,18,3,2,-4,22,United Kingdom,Royal Air Force,per-per,--,PROPN-PROPN,PROPN-PROPN-PROPN,compound-compound,compound-compound-pobj,NNP-NNP,NNP-NNP-NNP,7,0
13907,13729.0,28,died,1,1,9,8,0,18,0,8,He,Dimple Kapadia,per,-,PRON,PROPN-PROPN,nsubj,compound-compound,PRP,NNP-NNP,7,0
13908,13730.0,13,hired,1,1,10,9,0,2,0,9,Prima,New Orleans,org,-,PROPN,PROPN-PROPN,nsubj,compound-compound,NNP,NNP-NNP,2,0
13909,13731.0,21,is,3,1,12,11,0,8,2,9,Latymer Upper School,London,per-per-per,,PROPN-PROPN-PROPN,PROPN,compound-compound-nsubj,compound,NNP-NNP-NNP,NNP,5,0
13910,13732.0,67,handed,4,35,53,18,34,13,-31,49,Mahmoud Abbas,President,-,org,PROPN-PROPN,PROPN,compound-pobj,compound,NNP-NNP,NNP,12,0
13911,13733.0,20,purchase,3,14,18,4,13,1,-11,15,Littlejohn Co.,Greenwich,per-per,,PROPN-PROPN,PROPN,compound-pobj,compound,NNP-NNP,NNP,5,0
13912,13734.0,12,is,2,1,9,8,0,2,1,7,Amanda Falk,Winnipeg,per-per,,PROPN-PROPN,PROPN,compound-nsubj,compound,NNP-NNP,NNP,5,0
13913,13735.0,58,crossed,33,13,19,6,12,38,20,-14,JA 55th Divisi,al Hiroshi Takeuc,--,org-org-org,PROPN-ADJ-NOUN,PROPN-PROPN-PROPN,compound-compound-appos,compound-compound-pobj,NNP-JJ-NNS,NNP-NNP-NNP,7,0
13914,13736.0,23,leading,4,6,3,-3,5,19,-2,-1,Spain,he,,org,PROPN,PRON,poss,nsubj,NNP,PRP,4,0
13915,13738.0,20,is,5,12,12,0,11,7,-7,7,Dubai Media City,Dubai,org-org-org,,PROPN-PROPN-PROPN,PROPN,compound-compound-pobj,compound,NNP-NNP-NNP,NNP,0,0
13916,13740.0,24,is,12,1,10,9,0,13,11,-2,Letta Mbulu,South Africa,-,per-per,PROPN-PROPN,PROPN-PROPN,compound-nsubj,compound-pobj,NNP-NNP,NNP-NNP,3,0
13917,13741.0,11,is,8,1,2,1,0,8,7,-6,Actor,Luis Armand Garcia,per,--,PROPN,PROPN-PROPN-PROPN,compound,compound-compound-nsubj,NNP,NNP-NNP-NNP,2,0
13918,13742.0,31,known,5,13,15,2,12,15,-8,10,Military of Serbia,Serbia,--,per,PROPN-ADP-PROPN,PROPN,pobj-prep-pobj,poss,NNP-IN-NNP,NNP,7,0
13919,13743.0,31,said,12,11,20,9,10,10,1,8,Stockholm University,Sweden,-,per,PROPN-PROPN,PROPN,compound-pobj,nsubj,NNP-NNP,NNP,3,0
13920,13744.0,34,CAIRO,0,19,25,6,18,8,-19,25,Yasser Arafat,Egypt,-,per,PROPN-PROPN,PROPN,compound-pobj,poss,NNP-NNP,NNP,8,0
13921,13747.0,36,donated,13,6,12,6,5,23,7,-1,Superfast Ferries,Attica Group,-,org-org,PROPN-PROPN,PROPN-PROPN,compound-appos,compound-conj,NNP-NNPS,NNP-NNP,1,0
13922,13748.0,18,Eftimov,2,2,16,14,1,1,0,14,Nikola Eftimov,Skopje,org-org,,PROPN-PROPN,PROPN,compound-ROOT,pobj,NNP-NNP,NNP,8,0
13923,13750.0,14,situated,4,1,13,12,0,0,3,9,Lafayette High School,Gravesend,--,per,PROPN-PROPN-PROPN,PROPN,compound-compound-nsubjpass,pobj,NNP-NNP-NNP,NNP,3,0
13924,13751.0,22,pardoned,4,1,10,9,0,11,3,6,Florida,Jim Morrison,,per-per,PROPN,PROPN-PROPN,poss,compound-dobj,NNP,NNP-NNP,4,0
13925,13753.0,8,is,2,1,4,3,0,3,1,2,Hinduja Foundries,India,org-org,,PROPN-PROPN,PROPN,compound-nsubj,nmod,NNP-NNP,NNP,3,0
13926,13756.0,50,found,10,18,24,6,17,25,-8,14,AJS,Andover,,org,PROPN,PROPN,compound,pobj,NNP,NNP,3,0
13927,13757.0,29,is,7,3,7,4,2,21,4,0,March 30 1910,university,per-per-per,,PROPN-NUM-NUM,NOUN,pobj-nummod-nummod,nsubj,NNP-CD-CD,NN,4,0
13928,13761.0,38,signed,12,6,10,4,5,27,6,-2,Ontario,Brad Duguid,,org-org,PROPN,PROPN-PROPN,compound,compound-nsubj,NNP,NNP-NNP,3,0
13929,13763.0,23,included,3,6,8,2,5,14,-3,5,French,Albert Lebrun,,per-per,ADJ,PROPN-PROPN,amod,compound-dobj,JJ,NNP-NNP,1,0
13930,13764.0,33,was,14,5,18,13,4,14,9,4,Ion Irimescu,Romania,org-org,,PROPN-PROPN,PROPN,compound-nsubj,poss,NNP-NNP,NNP,6,0
13931,13766.0,105,Hearns,4,7,20,13,6,84,-3,16,USA,Ray Charles,per,-,PROPN,PROPN-PROPN,appos,compound-compound,NNP,NNP-NNP,4,0
13932,13768.0,7,USA,5,1,6,5,0,0,4,1,Trinity Lutheran School,USA,per-per-per,,PROPN-PROPN-PROPN,PROPN,compound-compound-compound,ROOT,NNP-NNP-NNP,NNP,2,0
13933,13769.0,21,is,3,1,11,10,0,9,2,8,Three Days Grace,Norwood,org-org-org,,NUM-PROPN-PROPN,PROPN,nummod-compound-nsubj,compound,CD-NNPS-NNP,NNP,6,0
13934,13770.0,47,received,39,3,15,12,2,31,36,-24,Collins,President,per,,PROPN,PROPN,pobj,compound,NNP,NNP,8,0
13935,13772.0,48,claims,1,18,20,2,17,27,-17,19,Brandon Paris,Band,-,org,PROPN-PROPN,PROPN,compound-appos,nmod,NNP-NNP,NNP,3,0
13936,13775.0,49,become,2,8,13,5,7,35,-6,11,Kiev,Vladimir Horowitz,org,-,PROPN,PROPN-PROPN,compound,compound-dobj,NNP,NNP-NNP,2,0
13937,13776.0,34,said,18,20,25,5,19,8,-2,7,Jeff Cooper,St. Louis,-,per-per,PROPN-PROPN,PROPN-PROPN,compound-nsubj,compound-compound,NNP-NNP,NNP-NNP,4,0
13938,13777.0,45,recruiting,10,35,40,5,34,4,-25,30,New York Stock Exchange,Nasdaq,per-per-per-per,,PROPN-PROPN-PROPN-PROPN,PROPN,compound-compound-compound-pobj,conj,NNP-NNP-NNP-NNP,NNP,8,0
13939,13781.0,17,is,7,2,4,2,1,12,5,-3,NORFORCE,North-West Mobile Force,per,--,PROPN,PROPN-PROPN-PROPN,nsubj,compound-compound-appos,NNP,NNP-NNP-NNP,3,0
13940,13783.0,30,Title,0,19,22,3,18,7,-19,22,Education Location,Kingsville,-,org,PROPN-PROPN,PROPN,pobj-ROOT,compound,NNP-NNP,NNP,3,0
13941,13784.0,42,says,1,10,18,8,9,23,-9,17,Najaf,Abdul Aziz al-Hakim,,per-per-per,PROPN,PROPN-PROPN-VERB,pobj,compound-nsubj-ccomp,NNP,NNP-NNP-VBD,6,0
13942,13785.0,29,Paris-based,0,2,15,13,1,13,-2,15,European Space Agency,France,--,org,PROPN-PROPN-PROPN,PROPN,compound-compound-dobj,dative,NNP-NNP-NNP,NNP,5,0
13943,13786.0,42,was,13,2,23,21,1,18,11,10,Julio Argentino Roca,Argentina,org-org-org,,PROPN-PROPN-PROPN,PROPN,compound-compound-compound,pobj,NNP-NNP-NNP,NNP,5,0
13944,13787.0,48,offers,33,3,20,17,2,27,30,-13,Ho Chi Minh City National University,Vietnam,-----,per,PROPN-PROPN-PROPN-PROPN-PROPN-PROPN,PROPN,compound-compound-compound-compound-compound-nsubj,compound,NNP-NNP-NNP-NNP-NNP-NNP,NNP,8,0
13945,13789.0,39,comprises,7,2,15,13,1,23,5,8,MTA Regional Bus Operations,New York City Transit,---,per-per-per-per,PROPN-PROPN-PROPN-PROPN,PROPN-PROPN-PROPN-PROPN,compound-compound-compound-compound,compound-compound-compound-appos,NNP-NNP-NNP-NNP,NNP-NNP-NNP-NNP,8,0
13946,13791.0,52,was,5,42,45,3,41,6,-37,40,Brigham Young University,J. Reuben Clark Law School,per-per-per,----,PROPN-PROPN-PROPN,PROPN-PROPN-PROPN-PROPN-PROPN,compound-compound-compound,compound-compound-compound-compound-pobj,NNP-NNP-NNP,NNP-NNP-NNP-NNP-NNP,2,0
13947,13793.0,21,represented,8,4,11,7,3,9,4,3,Arkansas Razorbacks,University of Arkansas,per-per,--,PROPN-PROPN,PROPN-ADP-PROPN,compound-compound,dobj-prep-pobj,NNP-NNP,NNP-IN-NNP,4,0
13948,13796.0,53,freed,26,7,8,1,6,44,19,-18,California,Substance Abuse,,per-per,PROPN,PROPN-PROPN,compound,compound-compound,NNP,NNP-NNP,1,0
13949,13798.0,55,is,8,1,24,23,0,30,7,16,Geto Boys,Prince Johnny,org-org,-,PROPN-PROPN,PROPN-PROPN,compound-nsubj,compound-compound,NNP-NNPS,NNP-NNP,2,0
13950,13799.0,26,is,3,1,10,9,0,15,2,7,Salt Lake City,Utah Symphony Orchestra,org-org-org,--,PROPN-PROPN-PROPN,PROPN-PROPN-PROPN,compound-compound-nsubj,compound-compound-pobj,NNP-NNP-NNP,NNP-NNP-NNP,6,0
13951,13801.0,18,was,1,9,17,8,8,0,-8,16,Ruhollah Khomeini,Iran,per-per,,PROPN-PROPN,PROPN,compound-pobj,pobj,NNP-NNP,NNP,4,0
13952,13802.0,77,Center,4,43,48,5,42,28,-39,44,Harvard School of Public Health,Boston,org-org-org-org-org,,PROPN-PROPN-ADP-PROPN-PROPN,PROPN,compound-appos-prep-compound-compound,pobj,NNP-NNP-IN-NNP-NNP,NNP,3,0
13953,13803.0,32,been,2,20,23,3,19,8,-18,21,General Director,Aeroflot,-,per,PROPN-PROPN,PROPN,compound-pobj,pobj,NNP-NNP,NNP,3,0
13954,13804.0,54,see,7,7,19,12,6,34,0,12,Isabella,Spain,per,,PROPN,PROPN,compound,pobj,NNP,NNP,2,0
13955,13805.0,28,is,4,14,26,12,13,1,-10,22,Scottish Premier League,1998,per-per-per,,PROPN-PROPN-PROPN,NUM,compound-compound-pobj,pobj,NNP-NNP-NNP,CD,10,0
13956,13807.0,47,let,1,40,42,2,39,4,-39,41,Ric Ocasek,The Cars,per-per,-,PROPN-PROPN,DET-NOUN,compound-pobj,det-ROOT,NNP-NNP,DT-NNS,3,0
13957,13808.0,14,was,7,1,7,6,0,6,6,0,His,Canada,,per,DET,PROPN,poss,pobj,PRP$,NNP,2,0
13958,13809.0,22,won,6,5,10,5,4,11,1,4,Houston Cougars,Conference USA,per-per,-,PROPN-PROPN,PROPN-PROPN,compound-nsubj,compound-compound,NNP-NNPS,NNP-NNP,3,0
13959,13810.0,28,was,10,10,15,5,9,12,0,5,Clynes,scientist,,per,PROPN,NOUN,nsubj,attr,NNPS,NN,7,0
13960,13811.0,28,is,1,1,14,13,0,13,0,13,MedFlight,Columbus,org,,PROPN,PROPN,nsubj,compound,NNP,NNP,1,0
13961,13813.0,52,established,3,9,28,19,8,23,-6,25,Evangelical Presbyterian Church,Church-Evangelical Synod,org-org-org,-,PROPN-PROPN-PROPN,PROPN-PROPN,amod-compound-pobj,amod-dobj,NNP-NNP-NNP,NNP-NNP,6,0
13962,13815.0,24,referred,6,1,4,3,0,19,5,-2,American University in Bulgaria,Bulgaria,---,per,PROPN-PROPN-ADP-PROPN,PROPN,compound-nsubj-prep-pobj,pobj,NNP-NNP-IN-NNP,NNP,2,0
13963,13818.0,39,served,2,2,21,19,1,17,0,19,Wisconsin,Mitchell,per,,PROPN,PROPN,compound,pobj,NNP,NNP,3,0
13964,13819.0,16,is,5,1,4,3,0,11,4,-1,Wintershall,Kassel,per,,PROPN,PROPN,nsubj,compound,NNP,NNP,2,0
13965,13821.0,19,visited,9,11,17,6,10,1,-2,8,Baku,Huseyngulu Sarabski,,org-org,PROPN,PROPN-PROPN,dobj,compound-dobj,NNP,NNP-NNP,2,0
13966,13822.0,18,formed,6,2,17,15,1,0,4,11,Presbyterian Church of Australia,1901,---,org,PROPN-PROPN-ADP-PROPN,NUM,amod-nsubjpass-prep-pobj,pobj,NNP-NNP-IN-NNP,CD,2,0
13967,13823.0,18,is,8,1,8,7,0,9,7,0,Pathumwan Institute of Technology,) is,---,per-per,PROPN-PROPN-ADP-PROPN,PUNCT-VERB,compound-nsubj-prep-pobj,punct-ROOT,NNP-NNP-IN-NNP,-RRB--VBZ,1,0
13968,13825.0,50,include,6,30,16,-14,29,33,-24,10,London,University of the Arts London,org,----,PROPN,PROPN-ADP-DET-PROPN-PROPN,pobj,pobj-prep-det-compound-pobj,NNP,NNP-IN-DT-NNPS-NNP,10,0
13969,13826.0,20,is,3,1,17,16,0,2,2,14,Bedford High School,Greater Manchester,per-per-per,-,PROPN-PROPN-PROPN,PROPN-PROPN,compound-compound-nsubj,compound-compound,NNP-NNP-NNP,NNP-NNP,8,0
13970,13830.0,35,be,2,31,34,3,30,0,-29,32,University of,Hungary,-,per,PROPN-ADP,PROPN,pobj-prep,pobj,NNP-IN,NNP,6,0
13971,13832.0,15,purchased,3,1,9,8,0,5,2,6,Valiant Comics,Acclaim Entertainment,org-org,-,PROPN-PROPN,PROPN-PROPN,compound-nsubjpass,compound-pobj,NNP-NNP,NNP-NNP,3,0
13972,13833.0,18,is,1,1,13,12,0,4,0,12,He,Cape Verde,per,-,PRON,PROPN-PROPN,nsubj,compound-pobj,PRP,NNP-NNP,5,0
13973,13834.0,48,came,12,5,15,10,4,32,7,3,BRAC,Bangladesh,per,,PROPN,PROPN,pobj,pobj,NNP,NNP,6,0
13974,13835.0,21,is,8,1,12,11,0,8,7,4,Ann-Margret,actress,,per,PROPN,NOUN,compound,compound,NNP,NN,5,0
13975,13837.0,33,conceded,5,2,5,3,1,27,3,0,Lisa Murkowski,Alaska,org-org,,PROPN-PROPN,PROPN,compound-nsubj,pobj,NNP-NNP,NNP,1,0
13976,13841.0,65,was,3,15,29,14,14,35,-12,26,Duncan of Jordanstone College of Art and Design,University of Dundee,-------,org-org-org,PROPN-ADP-PROPN-PROPN-ADP-PROPN-CCONJ-PROPN,PROPN-ADP-PROPN,pobj-prep-compound-pobj-prep-pobj-cc-conj,pobj-prep-pobj,NNP-IN-NNP-NNP-IN-NNP-CC-NNP,NNP-IN-NNP,10,0
13977,13843.0,27,told,16,11,14,3,10,12,5,-2,Economic Development,Pier Luigi Bersani,per-per,--,PROPN-PROPN,PROPN-PROPN-PROPN,compound-compound,compound-compound-nsubj,NNP-NNP,NNP-NNP-NNP,4,0
13978,13846.0,19,served,1,1,14,13,0,4,0,13,Rawlings,Baltimore,per,,NOUN,PROPN,nsubj,pobj,NNS,NNP,3,0
13979,13848.0,14,toured,2,1,11,10,0,2,1,9,Velocity Girl,Sub Pop,-,per-per,PROPN-PROPN,PROPN-PROPN,compound-nsubj,compound-compound,NNP-NNP,NNP-NNP,5,0
13980,13851.0,33,is,1,8,18,10,7,14,-7,17,George Michael,Virgin,-,org,PROPN-PROPN,PROPN,compound-pobj,compound,NNP-NNP,NNP,5,0
13981,13852.0,36,died,2,1,20,19,0,15,1,18,Thomas Edison,West Orange,-,per-per,PROPN-PROPN,PROPN-PROPN,compound-nsubj,compound-compound,NNP-NNP,NNP-NNP,7,0
13982,13853.0,25,written,3,8,13,5,7,11,-5,10,Guy McDonough,guitarist,-,per,PROPN-PROPN,NOUN,compound-pobj,dobj,NNP-NNP,NN,1,0
13983,13856.0,29,ensured,15,11,14,3,10,14,4,-1,Banca d'Italia,Antonio Fazio,per-per,-,PROPN-PROPN,PROPN-PROPN,compound-compound,compound-conj,NNP-NNP,NNP-NNP,3,0
13984,13858.0,21,is,10,2,8,6,1,12,8,-2,University of Haifa,Soraya Nazarian Library,per-per-per,--,PROPN-ADP-PROPN,PROPN-PROPN-PROPN,poss-prep-pobj,conj-compound-conj,NNP-IN-NNP,NNP-NNP-NNP,3,0
13985,13860.0,36,gave,1,1,10,9,0,25,0,9,Bruce,Edinburgh,,per,PROPN,PROPN,nsubj,pobj,NNP,NNP,2,0
13986,13861.0,43,provided,14,8,28,20,7,14,6,14,People,Beijing,,per,PROPN,PROPN,poss,compound,NNPS,NNP,11,0
13987,13863.0,32,joined,1,5,18,13,4,13,-4,17,Sarah Harding,Girls Aloud,org-org,-,PROPN-PROPN,PROPN-PROPN,compound-compound,compound-appos,NNP-NNP,NNP-NNP,5,0
13988,13864.0,39,On,0,9,17,8,8,21,-9,17,Kriangsak Chomanan,Thailand,per-per,,PROPN-PROPN,PROPN,compound-pobj,pobj,NNP-NNP,NNP,2,0
13989,13865.0,25,formed,5,4,12,8,3,12,1,7,Burning Witch,Seattle,-,org,PROPN-PROPN,PROPN,compound-appos,pobj,NNP-NNP,NNP,5,0
13990,13866.0,25,competed,10,13,19,6,12,5,-3,9,NCAA,Mercer University,,org-org,PROPN,PROPN-PROPN,pobj,compound-pobj,NNP,NNP-NNP,5,0
13991,13867.0,42,has,2,1,13,12,0,28,1,11,France,Blut Aus Nord,,per-per-per,PROPN,PROPN-PROPN-PROPN,nsubj,compound-compound-compound,NNP,NNP-NNP-NNP,5,0
13992,13868.0,21,split,5,3,11,8,2,9,2,6,Arctic College,Nunavut Arctic College,-,per-per-per,PROPN-PROPN,PROPN-PROPN-PROPN,compound-nsubjpass,compound-compound-conj,NNP-NNP,NNP-NNP-NNP,4,0
13993,13871.0,11,established,4,1,1,0,0,9,3,-3,Valdosta State University,Valdosta,--,org,PROPN-PROPN-PROPN,PROPN,compound-compound-nsubjpass,compound,NNP-NNP-NNP,NNP,0,0
13994,13872.0,19,is,3,11,18,7,10,0,-8,15,Recordland,Venezuela,per,,PROPN,PROPN,pobj,pobj,NNP,NNP,4,0
13995,13873.0,31,operates,4,1,24,23,0,6,3,20,MTV Networks Africa,VH1,per-per-per,,PROPN-PROPN-PROPN,PROPN,compound-compound-nsubj,compound,NNP-NNP-NNP,NNP,9,0
13996,13874.0,32,became,1,27,31,4,26,0,-26,30,Central High School,Philadelphia,per-per-per,,PROPN-PROPN-PROPN,PROPN,compound-compound-pobj,pobj,NNP-NNP-NNP,NNP,8,0
13997,13875.0,23,said,21,16,20,4,15,2,5,-1,Air France-Klm,Pierre-Henri Gourgeon,org-org,-,PROPN-PROPN,PROPN-PROPN,nmod-nmod,amod-conj,NNP-NNP,NNP-NNP,2,0
13998,13877.0,18,is,2,1,16,15,0,1,1,14,Culburnie,Alasdair Fraser,org,-,PROPN,PROPN-PROPN,compound,compound-pobj,NNP,NNP-NNP,8,0
13999,13878.0,32,is,1,8,27,19,7,4,-7,26,Royal Academy of Music,London,---,per,PROPN-PROPN-ADP-PROPN,PROPN,compound-pobj-prep-pobj,compound,NNP-NNP-IN-NNP,NNP,7,0
14000,13879.0,17,ended,3,6,9,3,5,7,-3,6,1922,Harvard School of Public Health,org,----,NUM,PROPN-PROPN-ADP-PROPN-PROPN,pobj,compound-nsubjpass-prep-compound-pobj,CD,NNP-NNP-IN-NNP-NNP,2,0
14001,13880.0,22,nominated,2,1,7,6,0,14,1,5,He,Environment and Housing,per,--,PRON,PROPN-CCONJ-PROPN,nsubjpass,pobj-cc-conj,PRP,NNP-CC-NNP,5,0
14002,13881.0,54,enabled,14,19,46,27,18,7,-5,32,and K,rom Pra,org-org,-,CCONJ-PROPN,ADP-PROPN,cc-compound,ROOT-compound,CC-NNP,IN-NNP,-1,0
14003,13883.0,23,drafted,7,2,6,4,1,16,5,-1,FOX,McCulloch,,org,PROPN,PROPN,nsubj,nsubjpass,NNP,NNP,2,0
14004,13884.0,45,released,4,2,15,13,1,29,2,11,Verve,Ella Fitzgerald,,per-per,PROPN,PROPN-PROPN,nsubj,compound-compound,NNP,NNP-NNP,4,0
14005,13885.0,30,examines,3,5,15,10,4,14,-2,12,Smith,NMU,org,,PROPN,PROPN,dobj,pobj,NNP,NNP,3,0
14006,13886.0,41,saw,21,8,20,12,7,20,13,-1,Robert Peliza,Gibraltar,-,per,PROPN-PROPN,PROPN,compound-pobj,compound,NNP-NNP,NNP,8,0
14007,13887.0,28,featured,6,4,5,1,3,22,2,-1,Juvenile,UTP,,org,PROPN,PROPN,compound,pobj,NNP,NNP,5,0
14008,13891.0,12,followed,9,7,8,1,6,3,2,-1,Columbia,Ms. Stafford,per,-,PROPN,PROPN-PROPN,compound,compound-pobj,NNP,NNP-NNP,1,0
14009,13892.0,45,was,1,36,43,7,35,1,-35,42,University of Michigan,Ann Arbor,org-org-org,-,PROPN-ADP-PROPN,PROPN-PROPN,nmod-prep-pobj,compound-pobj,NNP-IN-NNP,NNP-NNP,5,0
14010,13894.0,54,affiliated,7,2,42,40,1,11,5,35,Johns Hopkins Bayview Medical Center,Maryland,per-per-per-per-per,,PROPN-PROPN-PROPN-PROPN-PROPN,PROPN,compound-compound-compound-compound-compound,nmod,NNP-NNP-NNP-NNP-NNP,NNP,11,0
14011,13895.0,28,Louis,0,1,1,0,0,26,-1,1,Louis the Younger,Louis,per-per-per,,PROPN-DET-PROPN,PROPN,ROOT-det-appos,compound,NNP-DT-NNP,NNP,0,0
14012,13897.0,27,traces,4,2,9,7,1,17,2,5,University of Delaware,1743,--,org,PROPN-ADP-PROPN,NUM,nsubj-prep-pobj,pobj,NNP-IN-NNP,CD,4,0
14013,13900.0,24,republished,3,11,19,8,10,4,-8,16,Johannes Rau,Germany,-,per,PROPN-PROPN,PROPN,compound-pobj,pobj,NNP-NNP,NNP,6,0
14014,13901.0,16,was,5,7,12,5,6,3,-2,7,tom Bradley,Los Angeles,-,org-org,NOUN-PROPN,PROPN-PROPN,compound-compound,compound-pobj,NN-NNP,NNP-NNP,2,0
14015,13902.0,30,Sapunxhiu,1,1,15,14,0,14,0,14,Riza Sapunxhiu,r 2008,per-per,-,PROPN-PROPN,NOUN-NUM,compound-ROOT,punct-appos,NNP-NNP,NN-CD,2,0
14016,13905.0,26,is,4,2,11,9,1,14,2,7,Harold A. Schaitberger,IAFF,org-org-org,,PROPN-PROPN-PROPN,PROPN,compound-compound-nsubj,nmod,NNP-NNP-NNP,NNP,7,0
14017,13906.0,50,referred,3,35,37,2,34,12,-32,34,Interior,Francesco Cossiga,,per-per,PROPN,PROPN-PROPN,compound,compound-dobj,NNP,NNP-NNP,3,0
14018,13907.0,30,is,18,2,26,24,1,3,16,8,Polytechnic University of Puerto Rico,San Juan,org-org-org-org-org,-,PROPN-PROPN-ADP-PROPN-PROPN,PROPN-PROPN,compound-nsubj-prep-compound-pobj,compound-compound,NNP-NNP-IN-NNP-NNP,NNP-NNP,5,0
14019,13908.0,20,ended,6,5,19,14,4,0,1,13,Abe,Japan,,per,PROPN,PROPN,nsubj,pobj,NNP,NNP,2,0
14020,13911.0,18,was,11,1,14,13,0,3,10,3,George Clinton,United States,-,per-per,PROPN-PROPN,PROPN-PROPN,compound-compound,nmod-nmod,NNP-NNP,NNP-NNP,4,0
14021,13913.0,79,served,20,19,40,21,18,38,1,20,Frank Forde,Australia,org-org,,PROPN-PROPN,PROPN,compound-nsubj,poss,NNP-NNP,NNP,-1,0
14022,13916.0,17,was,7,6,7,1,5,9,1,0,Finland,Paasikivi,org,,PROPN,PROPN,compound,pobj,NNP,NNP,4,0
14023,13917.0,44,appeared,6,3,18,15,2,25,3,12,New York City,Ben Hecht,org-org-org,-,PROPN-PROPN-PROPN,PROPN-PROPN,compound-compound-compound,compound-pobj,NNP-NNP-NNP,NNP-NNP,7,0
14024,13918.0,38,announced,6,25,34,9,24,3,-19,28,NISL,United States,,per-per,PROPN,PROPN-PROPN,dobj,compound-pobj,NNP,NNP-NNP,7,0
14025,13921.0,22,is,6,1,13,12,0,8,5,7,Cassie,United States,,per-per,PROPN,PROPN-PROPN,compound,compound-pobj,NNP,NNP-NNP,4,0
14026,13923.0,61,is,11,35,4,-31,34,56,-24,-7,E. Claiborne Robins School of Business,Richmond,-----,per,PROPN-PROPN-PROPN-PROPN-ADP-PROPN,PROPN,compound-compound-compound-conj-prep-pobj,pobj,NNP-NNP-NNP-NNP-IN-NNP,NNP,6,0
14027,13924.0,37,said,19,21,30,9,20,6,-2,11,Johnsee Lee,Industrial Technology Research Institute,org-org,---,PROPN-PROPN,PROPN-PROPN-PROPN-PROPN,compound-nsubj,compound-compound-compound-pobj,NNP-NNP,NNP-NNP-NNP-NNP,5,0
14028,13925.0,50,was,1,8,33,25,7,16,-7,32,5th Infantry Division,United Kingdom,org-org-org,-,NOUN-PROPN-PROPN,PROPN-PROPN,compound-compound-pobj,compound-pobj,NN-NNP-NNP,NNP-NNP,12,0
14029,13927.0,17,re-elected,4,9,14,5,8,2,-5,10,Ukraine,For United Ukraine,per,--,PROPN,ADP-PROPN-PROPN,compound,pcomp-compound-pobj,NNP,IN-NNP-NNP,7,0
14030,13928.0,87,conducted,7,6,17,11,5,69,1,10,Aruba,Air Aruba,org,-,PROPN,PROPN-PROPN,pobj,compound-compound,NNP,NNP-NNP,-1,0
14031,13929.0,38,After,0,11,17,6,10,20,-11,17,Smith,Rhodesia,per,,PROPN,PROPN,nsubj,nsubj,NNP,NNP,3,0
14032,13931.0,11,is,1,1,10,9,0,0,0,9,Jean-de-La-Fontaine,France,per,,PROPN,PROPN,nsubj,pobj,NNP,NNP,5,0
14033,13932.0,17,finished,3,1,11,10,0,5,2,8,Plank,Jaki Liebezeit,,per-per,PROPN,PROPN-PROPN,nsubj,compound-pobj,NNP,NNP-NNP,7,0
14034,13934.0,34,Spain's,0,26,28,2,25,5,-26,28,Germany,Sandro Cortese,,per-per,PROPN,PROPN-PROPN,poss,nmod-nmod,NNP,NNP-NNP,5,0
14035,13936.0,39,checked,1,1,10,9,0,28,0,9,Kiedis,Grand Rapids,per,-,PROPN,PROPN-PROPN,nsubj,compound-pobj,NNP,NNP-NNP,4,0
14036,13937.0,20,undertaken,8,2,12,10,1,7,6,4,New Zealand,Parliamentary Commissioner for the Environment,-,per-per-per-per-per,PROPN-PROPN,PROPN-PROPN-ADP-DET-PROPN,compound-pobj,compound-pobj-prep-det-pobj,NNP-NNP,NNP-NNP-IN-DT-NNP,4,0
14037,13938.0,30,wanted,12,8,27,19,7,2,4,15,Reinhard Heydrich,Bohemia and Moravia,org-org,--,PROPN-PROPN,PROPN-CCONJ-PROPN,compound-pobj,pobj-cc-conj,NNP-NNP,NNP-CC-NNP,9,0
14038,13939.0,30,is,7,1,14,13,0,15,6,7,Klinik,Belgium,per,,PROPN,PROPN,nsubj,pobj,NNP,NNP,6,0
14039,13940.0,20,is,4,1,17,16,0,2,3,13,Crescent Heights High School,Calgary,per-per-per-per,,PROPN-PROPN-PROPN-PROPN,PROPN,compound-compound-compound-nsubj,compound,NNP-NNP-NNP-NNP,NNP,3,0
14040,13941.0,29,is,6,18,24,6,17,4,-12,18,Kazakhstan,Karim Massimov,,per-per,PROPN,PROPN-PROPN,pobj,compound-pobj,NNP,NNP-NNP,5,0
14041,13942.0,24,praised,13,8,15,7,7,8,5,2,Puerto Rico,Camacho,per-per,,PROPN-PROPN,PROPN,compound-pobj,poss,NNP-NNP,NNP,6,0
14042,13945.0,34,names,2,15,7,-8,14,26,-13,5,Sumner Redstone,CBS Corporation,per-per,-,PROPN-PROPN,PROPN-PROPN,compound-compound,compound-conj,NNP-NNP,NNP-NNP,3,0
14043,13946.0,32,found,7,27,31,4,26,0,-20,24,Rampton Secure Hospital,Nottinghamshire,per-per-per,,PROPN-PROPN-PROPN,PROPN,compound-compound-pobj,pobj,NNP-NNP-NNP,NNP,8,0
14044,13947.0,23,is,8,17,20,3,16,2,-9,12,Colorado Rapids,Major League Soccer,per-per,--,PROPN-PROPN,PROPN-PROPN-PROPN,compound-pobj,compound-compound-pobj,NNP-NNPS,NNP-NNP-NNP,3,0
14045,13948.0,35,is,9,21,31,10,20,3,-12,22,f Slovaki,r Robert Fic,-,per-per-per,X-PROPN,NOUN-PROPN-PROPN,pobj-npadvmod,pobj-compound-compound,XX-NNP,NN-NNP-NNP,6,0
14046,13949.0,36,participates,1,1,1,0,0,34,0,0,Timken,Timken Senior High School,org,---,PROPN,PROPN-PROPN-PROPN-PROPN,compound,compound-compound-compound-nsubjpass,NNP,NNP-NNP-NNP-NNP,0,0
14047,13950.0,24,joined,4,19,20,1,18,3,-15,16,Premier,Bill Bennett,,per-per,PROPN,PROPN-PROPN,compound,compound-pobj,NNP,NNP-NNP,1,0
14048,13951.0,27,dates,4,4,20,16,3,6,0,16,WUST,Zhang Zhidong,,per-per,PROPN,PROPN-PROPN,pobj,compound-pobj,NNP,NNP-NNP,6,0
14049,13952.0,17,born,2,1,16,15,0,0,1,14,Enya,Ireland,org,,PROPN,PROPN,nsubjpass,pobj,NNP,NNP,2,0
14050,13954.0,20,acting,6,11,11,0,10,8,-5,5,Maastricht School of Management,Maastricht,per-per-per-per,,PROPN-PROPN-ADP-PROPN,PROPN,compound-pobj-prep-pobj,compound,NNP-NNP-IN-NNP,NNP,0,0
14051,13957.0,28,was,3,12,17,5,11,10,-9,14,Doane College,Crete,per-per,,PROPN-PROPN,PROPN,compound-compound,compound,NNP-NNP,NNP,4,0
14052,13959.0,37,announced,19,6,34,28,5,2,13,15,MLB Network,January 1 2009,per-per,--,PROPN-PROPN,PROPN-NUM-NUM,compound-nsubjpass,npadvmod-nummod-nummod,NNP-NNP,NNP-CD-CD,7,0
14053,13960.0,22,was,5,13,21,8,12,0,-8,16,South Asian Association for Regional Cooperation,Nepal,org-org-org-org-org-org,,PROPN-PROPN-PROPN-ADP-PROPN-PROPN,PROPN,compound-compound-pobj-prep-compound-pobj,pobj,NNP-NNP-NNP-IN-NNP-NNP,NNP,7,0
14054,13961.0,17,performed,2,7,15,8,6,1,-5,13,Chris Trousdale,Dream Street,-,per-per,PROPN-PROPN,PROPN-PROPN,compound-pobj,compound-pobj,NNP-NNP,NNP-NNP,3,0
14055,13962.0,29,Due,0,10,23,13,9,5,-10,23,Stax,Dave,org,,PROPN,PROPN,pobj,poss,NNP,NNP,12,0
14056,13963.0,53,spent,30,44,9,-35,43,43,-14,-21,England,Adeliza of Leuven,per,--,PROPN,PROPN-ADP-PROPN,pobj,appos-prep-pobj,NNP,NNP-IN-NNP,11,0
14057,13965.0,40,decreed,2,1,5,4,0,34,1,3,Mr.,Venezuela,org,,PROPN,PROPN,nsubj,nsubj,NNP,NNP,3,0
14058,13968.0,37,defeated,15,7,24,17,6,12,8,9,Japan,Satoshi Kojima,org,-,PROPN,PROPN-PROPN,poss,compound-conj,NNP,NNP-NNP,8,0
14059,13970.0,22,was,5,1,15,14,0,6,4,10,His,deacon,per,,DET,NOUN,poss,pobj,PRP$,NN,5,0
14060,13971.0,13,was,1,6,12,6,5,0,-5,11,Benjamin Wright Raymond,Chicago,--,per,PROPN-PROPN-PROPN,PROPN,nmod-nmod-pobj,pobj,NNP-NNP-NNP,NNP,5,0
14061,13972.0,20,went,1,1,19,18,0,0,0,18,Harold,dancer,org,,PROPN,NOUN,nsubj,conj,NNP,NN,1,0
14062,13973.0,21,General,3,8,10,2,7,10,-5,7,University of Malta,Malta,--,org,PROPN-ADP-PROPN,PROPN,nmod-prep-pobj,compound,NNP-IN-NNP,NNP,2,0
14063,13975.0,17,sits,3,2,2,0,1,14,1,-1,Lawrenceville School,Lawrenceville,per-per,,PROPN-PROPN,PROPN,compound-nsubj,pobj,NNP-NNP,NNP,0,0
14064,13976.0,17,born,3,1,12,11,0,4,2,9,Marcel Marceau,France,-,org,PROPN-PROPN,PROPN,compound-nsubjpass,pobj,NNP-NNP,NNP,2,0
14065,13977.0,25,made,3,1,20,19,0,4,2,17,Paramount Pictures,Television,-,per,PROPN-PROPN,PROPN,compound-nsubj,nmod,NNP-NNP,NNP,7,0
14066,13978.0,32,decided,8,8,14,6,7,17,0,6,Moore,ABC,,per,PROPN,PROPN,pobj,compound,NNP,NNP,2,0
14067,14082.0,25,wrote,1,1,22,21,0,2,0,21,Moore,ABC,,org,PROPN,PROPN,nsubj,poss,NNP,NNP,4,0
14068,13979.0,48,accessed,9,18,25,7,17,22,-9,16,Traian B?sesc,f Buchares,-,org-org,PROPN-PROPN,X-PROPN,compound-compound,det-compound,NNP-NNP,XX-NNP,6,0
14069,13980.0,39,is,14,10,31,21,9,7,4,17,Bharti,India,per,,PROPN,PROPN,poss,pobj,NNP,NNP,11,0
14070,13981.0,23,moved,1,5,13,8,4,9,-4,12,Cambridgeshire,Hinchingbrooke school,per,-,PROPN,PROPN-NOUN,pobj,compound-dobj,NNP,NNP-NN,3,0
14071,13984.0,26,moved,6,9,23,14,8,2,-3,17,Winona Lake,Grace Theological Seminary,-,per-per-per,PROPN-PROPN,PROPN-PROPN-PROPN,compound-pobj,compound-compound-pobj,NNP-NNP,NNP-NNP-NNP,6,0
14072,13985.0,16,is,2,9,11,2,8,4,-7,9,folk,Bert Jansch,,per-per,NOUN,PROPN-PROPN,compound,compound-nsubj,NN,NNP-NNP,1,0
14073,13988.0,31,provided,10,23,25,2,22,5,-13,15,UK,Costa Coffee,org,-,PROPN,PROPN-PROPN,compound,compound-dobj,NNP,NNP-NNP,1,0
14074,13989.0,12,is,1,1,7,6,0,4,0,6,Hood,Leeds,per,,PROPN,PROPN,nsubj,pobj,NNP,NNP,2,0
14075,13990.0,27,toppled,7,14,25,11,13,1,-7,18,Carlos Mesa,La Paz,-,per-per,PROPN-PROPN,PROPN-PROPN,compound-pobj,compound-pobj,NNP-NNP,NNP-NNP,8,0
14076,13993.0,11,was,1,6,8,2,5,2,-5,7,Maine,Nathan A. Farwell,,per-per-per,PROPN,PROPN-PROPN-PROPN,compound,compound-compound-pobj,NNP,NNP-NNP-NNP,2,0
14077,13994.0,28,lost,13,12,18,6,11,9,1,5,Argentina,he,per,,PROPN,PRON,compound,nsubj,NNP,PRP,5,0
14078,13995.0,23,blames,1,10,17,7,9,5,-9,16,Kurt Cobain,Nirvana,per-per,,PROPN-PROPN,PROPN,compound-pobj,pobj,NNP-NNP,NNP,3,0
14079,13996.0,24,judged,4,15,10,-5,14,13,-11,6,France,her,per,,PROPN,DET,pobj,poss,NNP,PRP$,2,0
14080,13997.0,61,went,21,24,42,18,23,18,-3,21,Italy,Louis Moholo,per,-,PROPN,PROPN-PROPN,pobj,compound-conj,NNP,NNP-NNP,10,0
14081,13998.0,25,held,14,13,13,0,12,11,1,-1,China,China Agricultural University,per,--,PROPN,PROPN-PROPN-PROPN,pobj,compound-compound-compound,NNP,NNP-NNP-NNP,0,0
14082,14004.0,27,http://www.quinlanroad.com/newsandviews/currentupdates.asp?id=913,0,2,5,3,1,21,-2,5,Quinlan Road,Loreena McKennitt,-,per-per,PROPN-PROPN,PROPN-PROPN,compound-nsubj,compound-poss,NNP-NNP,NNP-NNP,2,0
14083,14005.0,36,was,3,1,1,0,0,34,2,-2,Reno,Reno Air,per,-,PROPN,PROPN-PROPN,compound,compound-pobj,NNP,NNP-NNP,0,0
14084,14006.0,24,graduated,2,7,12,5,6,11,-5,10,Royal Institute of Technology,Sweden,per-per-per-per,,PROPN-PROPN-ADP-PROPN,PROPN,compound-pobj-prep-pobj,pobj,NNP-NNP-IN-NNP,NNP,3,0
14085,14008.0,36,founded,5,2,10,8,1,25,3,5,University of Zurich,1833,per-per-per,,PROPN-ADP-PROPN,NUM,nsubjpass-prep-pobj,nummod,NNP-IN-NNP,CD,4,0
14086,14012.0,24,introduced,4,3,11,8,2,12,1,7,Indian Airlines,Air India,org-org,-,PROPN-PROPN,PROPN-PROPN,compound-nsubj,compound-nsubj,NNP-NNPS,NNP-NNP,4,0
14087,14014.0,30,said,1,4,21,17,3,8,-3,20,his,Austria,per,,DET,PROPN,poss,poss,PRP$,NNP,11,0
14088,14015.0,53,entered,3,47,51,4,46,1,-44,48,Evangelical Presbyterian Church,1981,per-per-per,,PROPN-PROPN-PROPN,NUM,amod-compound-conj,appos,NNP-NNP-NNP,CD,2,0
14089,14017.0,35,includes,4,4,4,0,3,30,0,0,Brighton,Brighton Grammar School,,org-org-org,PROPN,PROPN-PROPN-PROPN,pobj,compound-compound-compound,NNP,NNP-NNP-NNP,0,0
14090,14019.0,24,is,9,8,12,4,7,11,1,3,VMAQ-4,United States,org,-,PROPN,PROPN-PROPN,appos,compound-compound,NNP,NNP-NNP,4,0
14091,14021.0,22,submitted,7,4,7,3,3,14,3,0,Florida,Ferlita,,org,PROPN,PROPN,compound,nsubj,NNP,NNP,5,0
14092,14022.0,15,released,6,4,9,5,3,5,2,3,Jo Stafford,Columbia,-,org,PROPN-PROPN,PROPN,compound-pobj,compound,NNP-NNP,NNP,5,0
14093,14023.0,22,incorporated,2,9,9,0,8,12,-7,7,Staffordshire,Staffordshire Fire and Rescue Service,per,----,PROPN,PROPN-PROPN-CCONJ-PROPN-PROPN,compound,compound-pobj-cc-compound-conj,NNP,NNP-NNP-CC-NNP-NNP,0,0
14094,14025.0,29,is,13,4,18,14,3,10,9,5,Luxembourg,Prince Louis of Luxembourg,per,---,PROPN,PROPN-PROPN-ADP-PROPN,pobj,compound-pobj-prep-pobj,NNP,NNP-NNP-IN-NNP,7,0
14095,14026.0,47,include,7,13,16,3,12,30,-6,9,Jennifer Nettles,Sugarland,org-org,,PROPN-PROPN,PROPN,compound-dobj,pobj,NNP-NNPS,NNP,-1,0
14096,14027.0,64,inspect,4,6,60,54,5,3,-2,56,Hezbollah,Lebanon,,per,PROPN,PROPN,compound,pobj,NNP,NNP,-1,0
14097,14028.0,48,was,12,18,21,3,17,26,-6,9,India,Indira Gandhi,,per-per,PROPN,PROPN-PROPN,pobj,compound-nsubj,NNP,NNP-NNP,2,0
14098,14032.0,36,said,8,7,24,17,6,11,1,16,Illinois,Clinton,per,,PROPN,PROPN,compound,dobj,NNP,NNP,6,0
14099,14033.0,29,is,1,4,23,19,3,5,-3,22,American,Tom Araya,per,-,ADJ,PROPN-PROPN,amod,compound-dobj,JJ,NNP-NNP,9,0
14100,14034.0,19,is,14,1,13,12,0,5,13,-1,Diane Tell,Canada,org-org,,PROPN-PROPN,PROPN,compound-nsubj,pobj,NNP-NNP,NNP,1,0
14101,14036.0,23,was,13,19,20,1,18,2,-6,7,King,John of England,,per-per-per,PROPN,PROPN-ADP-PROPN,compound,pobj-prep-pobj,NNP,NNP-IN-NNP,1,0
14102,14037.0,17,raised,2,1,6,5,0,10,1,4,Attieh,Lebanon,,per,PROPN,PROPN,nsubjpass,pobj,NNP,NNP,2,0
14103,14039.0,15,assigned,6,5,10,5,4,4,1,4,Cumbria Constabulary,Steve Johnson,-,org-org,PROPN-PROPN,PROPN-PROPN,compound-appos,compound-dobj,NNP-NNP,NNP-NNP,3,0
14104,14040.0,56,is,2,29,25,-4,28,30,-27,23,Bruce Foxton,The Jam,org-org,-,PROPN-PROPN,DET-PROPN,compound-dobj,det-compound,NNP-NNP,DT-NNP,2,0
14105,14041.0,20,Nazia,0,1,12,11,0,7,-1,12,Nazia,op group,,org-org,PROPN,NOUN-NOUN,ROOT,compound-attr,NNP,NN-NN,3,0
14106,14042.0,15,inherited,3,1,2,1,0,12,2,-1,Mayor,Wellington Webb,,per-per,PROPN,PROPN-PROPN,compound,compound-nsubj,NNP,NNP-NNP,1,0
14107,14043.0,35,recorded,19,7,26,19,6,8,12,7,St. Nicholas,Columbia Records,org-org,-,PROPN-PROPN,PROPN-PROPN,compound-compound,compound-pobj,NNP-NNP,NNP-NNPS,7,0
14108,14044.0,19,chose,2,6,17,11,5,1,-4,15,Humble Pie,Immediate,-,per,PROPN-PROPN,PROPN,compound-appos,compound,NNP-NNP,NNP,7,0
14109,14045.0,13,is,5,2,2,0,1,10,3,-3,Nicaragua national baseball team,Nicaragua,org-org-org-org,,PROPN-ADJ-NOUN-NOUN,PROPN,nmod-amod-compound-nsubj,pobj,NNP-JJ-NN-NN,NNP,0,0
14110,14046.0,28,urged,5,8,27,19,7,0,-3,22,United States,MCain,per-per,,PROPN-PROPN,PROPN,compound-dobj,pobj,NNP-NNP,NNP,9,0
14111,14049.0,31,Bliss,0,23,28,5,22,2,-23,28,Oliver,Landon Pigg,,per-per,PROPN,PROPN-PROPN,oprd,compound-appos,NNP,NNP-NNP,1,0
14112,14051.0,43,delivered,3,6,13,7,5,29,-3,10,Zhang Ping,National Development and Reform Commission,org-org,----,PROPN-PROPN,PROPN-PROPN-CCONJ-PROPN-PROPN,compound-compound,nmod-nmod-cc-conj-pobj,NNP-NNP,NNP-NNP-CC-NNP-NNP,8,0
14113,14053.0,39,level,10,19,28,9,18,10,-9,18,Tennessee,Ohio Valley Conference,org,--,PROPN,PROPN-PROPN-PROPN,pobj,compound-compound-pobj,NNP,NNP-NNP-NNP,6,0
14114,14054.0,19,unveiled,10,15,17,2,14,1,-5,7,The Narcissist,Lex Luger,org-org,-,DET-PROPN,PROPN-PROPN,det-compound,compound-ROOT,DT-NNP,NNP-NNP,1,0
14115,14055.0,18,is,2,1,8,7,0,9,1,6,Fudan University,Universitas,-,org,PROPN-PROPN,PROPN,compound-nsubj,pobj,NNP-NNP,NNP,5,0
14116,14056.0,16,Anne,1,2,2,0,1,13,-1,1,Anne,Anne of Great Britain,,per-per-per-per,PROPN,PROPN-ADP-PROPN-PROPN,ROOT,attr-prep-compound-pobj,NNP,NNP-IN-NNP-NNP,0,0
14117,14057.0,31,represented,6,1,8,7,0,22,5,2,Elitsa Todorova,Bulgaria,-,per,PROPN-PROPN,PROPN,compound-nsubj,dobj,NNP-NNP,NNP,2,0
14118,14058.0,49,By,0,8,12,4,7,36,-8,12,Singapore,Wee Kim Wee,org,--,PROPN,PROPN-PROPN-PROPN,compound,compound-compound-nsubj,NNP,NNP-NNP-NNP,4,0
14119,14059.0,20,is,2,1,18,17,0,1,1,16,Soilent Green,New Orleans,per-per,-,PROPN-PROPN,PROPN-PROPN,compound-nsubj,compound-pobj,NNP-NNP,NNP-NNP,6,0
14120,14062.0,33,becomes,20,2,9,7,1,23,18,-11,Matt Santos,United States,-,per-per,PROPN-PROPN,PROPN-PROPN,compound-nsubjpass,compound-pobj,NNP-NNP,NNP-NNP,4,0
14121,14063.0,12,Labels,0,3,6,3,2,5,-3,6,Australia,John Howard,per,-,PROPN,PROPN-PROPN,nsubj,compound-compound,NNP,NNP-NNP,6,0
14122,14064.0,28,During,0,12,14,2,11,13,-12,14,People,Army,per,,PROPN,PROPN,poss,nsubj,NNPS,NNP,3,0
14123,14065.0,23,maneuvered,13,15,21,6,14,1,-2,8,himself,United States,per,-,PRON,PROPN-PROPN,dobj,compound-pobj,PRP,NNP-NNP,3,0
14124,14067.0,29,Discussing,0,8,27,19,7,1,-8,27,Hynde,Akron,org,,PROPN,PROPN,poss,compound,NNP,NNP,9,0
14125,14068.0,20,left,7,5,10,5,4,9,2,3,Mike Jost,band,per-per,,PROPN-PROPN,NOUN,compound-nsubj,dobj,NNP-NNP,NN,3,0
14126,14070.0,16,made,5,7,10,3,6,5,-2,5,her,Shimmer Women Athletes,per,--,DET,PROPN-PROPN-PROPN,poss,compound-compound-pobj,PRP$,NNP-NNP-NNP,4,0
14127,14073.0,16,established,2,1,12,11,0,3,1,10,FRELIMO,Samora Machel,per,-,ADP,PROPN-PROPN,nsubj,compound-pobj,IN,NNP-NNP,6,0
14128,14075.0,18,compared,1,11,14,3,10,3,-10,13,Scott Stapp,Creed,-,per,PROPN-PROPN,PROPN,compound-pobj,pobj,NNP-NNP,NNP,3,0
14129,14076.0,44,type,15,29,30,1,28,13,-14,15,USSR,Navy,,per,PROPN,PROPN,compound,pobj,NNP,NNP,2,0
14130,14078.0,31,attempted,25,6,23,17,5,7,19,-2,Provincial League,Thailand,-,org,PROPN-PROPN,PROPN,compound-pobj,pobj,NNP-NNP,NNP,4,0
14131,14079.0,28,is,1,11,27,16,10,0,-10,26,Meek,London,,per,PROPN,PROPN,poss,pobj,NNP,NNP,7,0
14132,14081.0,36,said,2,22,22,0,21,13,-20,20,Chicago,Chicago Mercantile Exchange,per,--,PROPN,PROPN-PROPN-PROPN,compound,compound-compound-appos,NNP,NNP-NNP-NNP,0,0
14133,14083.0,41,reported,28,7,25,18,6,15,21,-3,Mitterrand,Paris,per,,PROPN,PROPN,nsubj,pobj,NNP,NNP,2,0
14134,14085.0,15,were,3,7,11,4,6,3,-4,8,Chiodos,Cinematic Sunrise,,per-per,PROPN,PROPN-PROPN,pobj,compound-nsubjpass,NNP,NNP-NNP,3,0
14135,14086.0,11,is,6,1,10,9,0,0,5,4,Issa,musician,,org,PROPN,NOUN,compound,attr,NNP,NN,2,0
14136,14087.0,14,backed,1,6,9,3,5,4,-5,8,his,Studio One,,per-per,DET,PROPN-PROPN,poss,nmod-nummod,PRP$,NNP-NNP,6,0
14137,14089.0,10,are,6,3,5,2,2,4,3,-1,Melvins,Buzz Osborne,per,-,PROPN,PROPN-PROPN,compound,compound-conj,NNPS,NNP-NNP,2,0
14138,14090.0,16,is,8,1,13,12,0,2,7,5,Moscow,University of Idaho,,per-per-per,PROPN,PROPN-ADP-PROPN,nsubj,pobj-prep-pobj,NNP,NNP-IN-NNP,6,0
14139,14091.0,25,selected,8,6,10,4,5,14,2,2,Los Angeles Galaxy,Taylor,per-per-per,,PROPN-PROPN-PROPN,PROPN,compound-compound-nsubj,dobj,NNP-NNP-NNP,NNP,3,0
14140,14093.0,21,is,1,7,12,5,6,8,-6,11,Shahrukh Khan,Red Chillies Entertainment,-,org-org-org,PROPN-PROPN,PROPN-PROPN-PROPN,compound-poss,compound-compound-nmod,NNP-NNP,NNP-NNPS-NNP,3,0
14141,14094.0,41,posted,13,9,19,10,8,21,4,6,Clostermann,No. 341 Squadron RAF,,per-per-per-per,PROPN,NOUN-NUM-PROPN-PROPN,npadvmod,nmod-nummod-compound-pobj,NNP,NN-CD-NNP-NNP,5,0
14142,14095.0,30,heading,25,21,4,-17,20,25,4,-21,Tun,Dr Mahathir,org,-,PROPN,PROPN-PROPN,compound,compound-pobj,NNP,NNP-NNP,9,0
14143,14096.0,43,stated,28,21,26,5,20,16,7,-2,DMK,Murasoli,,per,PROPN,PROPN,compound,compound,NNP,NNP,3,0
14144,14097.0,58,served,2,12,52,40,11,5,-10,50,Treasury,Selwyn Lloyd,,per-per,PROPN,PROPN-PROPN,pobj,compound-pobj,NNP,NNP-NNP,7,0
14145,14098.0,17,said,10,2,9,7,1,7,8,-1,Ron Sandler,Northern Rock,per-per,-,PROPN-PROPN,PROPN-PROPN,compound-nsubj,compound-pobj,NNP-NNP,NNP-NNP,3,0
14146,14100.0,14,is,3,1,13,12,0,0,2,10,The Manila Times,Philippines,--,org,DET-PROPN-PROPN,PROPN,det-compound-nsubj,pobj,DT-NNP-NNP,NNP,3,0
14147,14101.0,59,Solvent,9,15,24,9,14,34,-6,15,Mark E. Smith,songwriter,org-org-org,,PROPN-PROPN-PROPN,NOUN,compound-compound-pobj,appos,NNP-NNP-NNP,NN,9,0
14148,14102.0,31,said,28,19,27,8,18,3,9,-1,BHP Billiton,Marius Kloppers,org-org,-,PROPN-PROPN,PROPN-PROPN,compound-poss,compound-nsubj,NNP-NNP,NNP-NNP,4,0
14149,14105.0,46,Known,0,30,39,9,29,6,-30,39,California,Phil Lesh,,org-org,PROPN,PROPN-PROPN,pobj,compound-dobj,NNP,NNP-NNP,4,0
14150,14106.0,38,became,18,7,17,10,6,20,11,-1,Allied,RAF Gibraltar,,org-org,PROPN,PROPN-PROPN,amod,compound-nsubj,NNP,NNP-NNP,6,0
14151,14108.0,38,won,1,12,16,4,11,21,-11,15,Alfonso Portillo,Guatemalan Republican Front,per-per,--,PROPN-PROPN,PROPN-PROPN-PROPN,compound-dobj,compound-compound-pobj,NNP-NNP,NNP-NNP-NNP,3,0
14152,14111.0,36,competed,8,21,35,14,20,0,-13,27,CAR Castel Beer Trophy,Niger,---,per,PROPN-PROPN-PROPN-PROPN,PROPN,compound-compound-compound-pobj,pobj,NNP-NNP-NNP-NNP,NNP,8,0
14153,14112.0,36,was,11,1,22,21,0,13,10,11,Zubir Said,Indonesia,-,org,PROPN-VERB,PROPN,compound-compound,pobj,NNP-VBD,NNP,5,0
14154,14113.0,21,joined,4,3,12,9,2,8,1,8,Randy Jackson,Motown Records,-,per-per,PROPN-PROPN,PROPN-PROPN,compound-nsubj,compound-pobj,NNP-NNP,NNP-NNPS,4,0
14155,14114.0,23,served,4,1,19,18,0,3,3,15,Russell A. Alger,U.S.,--,org,PROPN-NOUN-PROPN,PROPN,compound-compound-compound,compound,NNP-NN-NNP,NNP,8,0
14156,14115.0,37,said,1,1,18,17,0,18,0,17,Qureshi,Pakistan,,per,PROPN,PROPN,nsubj,compound,NNP,NNP,8,0
14157,14116.0,26,are,3,3,13,10,2,12,0,10,Okonkwo,Voice of Nigeria,,per-per-per,PROPN,PROPN-ADP-PROPN,conj,conj-prep-pobj,NNP,NNP-IN-NNP,5,0
14158,14120.0,29,recognized,19,6,18,12,5,10,13,-1,National Defense Medical Center,1902,---,per,PROPN-PROPN-PROPN-PROPN,NUM,compound-compound-compound-pobj,pobj,NNP-NNP-NNP-NNP,CD,5,0
14159,14121.0,45,broadcast,9,36,42,6,35,2,-27,33,Kilmarnock,Scotland,per,,PROPN,PROPN,compound,poss,NNP,NNP,8,0
14160,14122.0,21,nominated,8,3,5,2,2,15,5,-3,New York,William H. Seward,org-org,--,PROPN-PROPN,PROPN-PROPN-PROPN,compound-compound,compound-compound-pobj,NNP-NNP,NNP-NNP-NNP,2,0
14161,14125.0,24,attended,9,12,14,2,11,9,-3,5,Prime Minister,Jean Eyeghe Ndong,per-per,--,PROPN-PROPN,PROPN-PROPN-PROPN,compound-compound,compound-compound-pobj,NNP-NNP,NNP-NNP-NNP,2,0
14162,14171.0,30,reappointed,10,5,7,2,4,22,5,-3,Prime Minister,Jean Eyeghe Ndong,org-org,--,PROPN-PROPN,PROPN-PROPN-PROPN,compound-compound,compound-compound-pobj,NNP-NNP,NNP-NNP-NNP,3,0
14163,14127.0,39,after,4,15,15,0,14,23,-11,11,Archduke,Archduke Franz Ferdinand of Austria,,per-per-per-per-per,PROPN,PROPN-PROPN-PROPN-ADP-PROPN,compound,compound-compound-pobj-prep-pobj,NNP,NNP-NNP-NNP-IN-NNP,0,0
14164,14128.0,19,says,3,14,17,3,13,1,-11,14,Iranian,Saeed Jalili,,per-per,ADJ,PROPN-PROPN,amod,compound-pobj,JJ,NNP-NNP,2,0
14165,14129.0,18,opened,3,1,17,16,0,0,2,14,Shawnee Mission Northwest,1969,per-per-per,,PROPN-PROPN-PROPN,NUM,compound-compound-conj,pobj,NNP-NNP-NNP,CD,3,0
14166,14131.0,39,said,6,11,13,2,10,25,-5,7,SNP,Alex Salmond,,per-per,PROPN,PROPN-PROPN,compound,compound-dobj,NNP,NNP-NNP,1,0
14167,14132.0,32,wrote,13,6,12,6,5,19,7,-1,Congress of South African Trade Unions,Zwelinzima Vavi,per-per-per-per-per-per,-,PROPN-ADP-PROPN-PROPN-PROPN-PROPN,PROPN-PROPN,pobj-prep-compound-compound-compound-compound,compound-nsubj,NNP-IN-NNP-NNP-NNP-NNPS,NNP-NNP,1,0
14168,14133.0,25,dismissed,13,5,23,18,4,1,8,10,East Cameroon,Ahmadou Ahidjo,per-per,-,PROPN-PROPN,PROPN-PROPN,compound-compound,compound-pobj,NNP-NNP,NNP-NNP,7,0
14169,14134.0,29,is,2,1,22,21,0,6,1,20,Tigon Studios,Vin Diesel,org-org,-,PROPN-PROPN,PROPN-PROPN,compound-nsubj,compound-dobj,NNP-NNPS,NNP-NNP,6,0
14170,14136.0,22,fell,11,4,11,7,3,10,7,0,Saravanan,Army,per,,PROPN,PROPN,appos,pobj,NNP,NNP,6,0
14171,14137.0,39,remain,10,1,9,8,0,29,9,-1,HSBC,1865,,per,PROPN,NUM,nsubj,pobj,NNP,CD,2,0
14172,14138.0,21,is,1,16,18,2,15,2,-15,17,Prime Minister,Lester B. Pearson,per-per,--,PROPN-PROPN,PROPN-PROPN-PROPN,compound-compound,compound-compound-pobj,NNP-NNP,NNP-NNP-NNP,2,0
14173,14139.0,66,testified,39,43,49,6,42,16,-4,10,Ramos-Horta,East Timor,per,-,PROPN,PROPN-PROPN,amod,compound-pobj,NNP,NNP-NNP,4,0
14174,14140.0,39,came,15,11,14,3,10,24,4,-1,Toshio Suzuki,Studio Ghibli,org-org,-,PROPN-PROPN,PROPN-PROPN,compound-nsubj,compound-pobj,NNP-NNP,NNP-NNP,2,0
14175,14141.0,27,carried,1,11,20,9,10,6,-10,19,Division I,Georgia Southern Eagles,-,per-per-per,PROPN-PROPN,PROPN-PROPN-PROPN,pobj-ROOT,compound-compound-pobj,NNP-NNP,NNP-NNP-NNPS,9,0
14176,14145.0,16,won,4,4,9,5,3,6,0,5,MAS,Evo Morales,,per-per,PROPN,PROPN-PROPN,nsubj,compound-nsubj,NNP,NNP-NNPS,2,0
14177,14146.0,22,held,4,8,19,11,7,2,-4,15,David Christopherson,Hamilton,-,org,PROPN-PROPN,PROPN,compound-pobj,pobj,NNP-NNP,NNP,6,0
14178,14147.0,49,is,2,9,15,6,8,33,-7,13,Warringah,Tony Abbott,,per-per,PROPN,PROPN-PROPN,pobj,compound-pobj,NNP,NNP-NNP,5,0
14179,14150.0,11,joined,5,4,10,6,3,0,1,5,Anita Baker,Detroit,-,org,PROPN-PROPN,PROPN,compound-nsubj,pobj,NNP-NNP,NNP,2,0
14180,14151.0,48,reminds,4,30,34,4,29,13,-26,30,George Meade,Army of the Potomac,-,per-per-per-per,PROPN-PROPN,PROPN-ADP-DET-PROPN,compound-poss,nsubj-prep-det-pobj,NNP-NNP,NNP-IN-DT-NNP,6,0
14181,14153.0,43,was,7,1,21,20,0,21,6,14,Miller,Paris,,per,PROPN,PROPN,nsubj,pobj,NNP,NNP,6,0
14182,14154.0,14,criticized,1,3,5,2,2,8,-2,4,Overstock.com,Patrick Byrne,per,-,PROPN,PROPN-PROPN,compound,compound-dobj,NNP,NNP-NNP,1,0
14183,14155.0,20,PARTY,3,2,12,10,1,7,1,9,JAPANESE COMMUNIST PARTY,1922,per-per-per,,ADJ-PROPN-NOUN,NUM,compound-compound-ROOT,pobj,JJ-NNP-NN,CD,3,0
14184,14158.0,12,recommended,8,1,5,4,0,6,7,-3,Scorsese,screenwriter,,per,PROPN,NOUN,nsubj,nmod,NNP,NN,3,0
14185,14159.0,30,was,20,1,1,0,0,28,19,-19,Westminster,Westminster Academy,org,-,PROPN,PROPN-PROPN,nsubj,compound-pobj,NNP,NNP-NNP,0,0
14186,14160.0,19,went,1,1,5,4,0,13,0,4,Griffo,Rome,per,,PROPN,PROPN,nsubj,nmod,NNP,NNP,4,0
14187,14161.0,17,is,7,2,7,5,1,9,5,0,Heritage High School,1996,per-per-per,,PROPN-PROPN-PROPN,NUM,compound-compound-nsubj,pobj,NNP-NNP-NNP,CD,2,0
14188,14163.0,33,were,19,7,9,2,6,23,12,-10,Georgia,Walter F. George,,org-org-org,PROPN,PROPN-PROPN-PROPN,compound,compound-compound-pobj,NNP,NNP-NNP-NNP,2,0
14189,14164.0,7,established,3,2,6,4,1,0,1,3,league,1989,per,,NOUN,NUM,nsubjpass,pobj,NN,CD,2,0
14190,14166.0,43,accompanied,13,35,38,3,34,4,-22,25,Beach Boys,Mike Kowalski,per-per,-,PROPN-PROPN,PROPN-PROPN,compound-nsubj,compound-dobj,NNP-NNPS,NNP-NNP,2,0
14191,14167.0,31,earned,2,11,16,5,10,14,-9,14,FIBA World Championship,1950,org-org-org,,PROPN-PROPN-PROPN,NUM,compound-compound-pobj,pobj,NNP-NNP-NNP,CD,4,0
14192,14168.0,55,Burne-Jones,3,2,21,19,1,33,1,18,Edward Coley Burne-Jones,designer,--,per,PROPN-PROPN-PROPN,NOUN,compound-compound-ROOT,conj,NNP-NNP-NNP,NN,6,0
14193,14169.0,18,married,1,4,7,3,3,10,-3,6,actor,Jack May,,per-per,NOUN,PROPN-VERB,dobj,compound-npadvmod,NN,NNP-MD,1,0
14194,14170.0,17,student,2,9,13,4,8,3,-7,11,West Bank,Birzeit University,per-per,-,PROPN-PROPN,PROPN-PROPN,compound-poss,compound-pobj,NNP-NNP,NNP-NNP,1,0
14195,14172.0,52,include,12,33,36,3,32,15,-21,24,ormer,ember Vlada Di,,per-per-per,ADJ,VERB-PROPN-PROPN,amod,compound-compound-compound,JJR,VB-NNP-NNP,2,0
14196,14173.0,33,forced,11,8,9,1,7,23,3,-2,The Jackson 5,Jackson,org-org-org,,DET-PROPN-NUM,PROPN,det-nsubjpass-nummod,nmod,DT-NNP-CD,NNP,1,0
14197,14174.0,12,presented,2,5,6,1,4,5,-3,4,singer,Ralph McTell,per,-,NOUN,PROPN-PROPN,compound,compound-pobj,NN,NNP-NNP,1,0
14198,14175.0,15,mentioned,1,5,6,1,4,8,-4,5,doctor,Lovisa,per,,NOUN,PROPN,dobj,appos,NN,NNP,1,0
14199,14176.0,12,is,3,1,11,10,0,0,2,8,North Leigh F.C.,1908,--,org,PROPN-PROPN-PROPN,NUM,compound-compound-nsubj,pobj,NNP-NNP-NNP,CD,3,0
14200,14177.0,25,appointed,2,10,21,11,9,3,-8,19,Quebec,William Lyon Mackenzie King,,org-org-org-org,PROPN,PROPN-PROPN-PROPN-PROPN,compound,compound-compound-compound-pobj,NNP,NNP-NNP-NNP-NNP,7,0
14201,14178.0,74,chalet,55,24,28,4,23,45,31,-27,Paul von Hindenburg,Neudeck,per-per-per,,PROPN-PROPN-PROPN,PROPN,compound-compound-poss,compound,NNP-NNP-NNP,NNP,3,0
14202,14182.0,38,are,4,22,23,1,21,14,-18,19,Shaan,Sonu Nigam,per,-,PROPN,PROPN-PROPN,ROOT,compound-compound,NNP,NNP-NNP,2,0
14203,14183.0,38,Dayuan,1,8,18,10,7,19,-7,17,nyin :,ean of Renmin University of China Law,per-per,------,ADV-PUNCT,NOUN-ADP-PROPN-PROPN-ADP-PROPN-PROPN,appos-punct,attr-prep-nmod-nmod-prep-pobj-compound,RB-:,NN-IN-NNP-NNP-IN-NNP-NNP,5,0
14204,14185.0,10,sponsors,4,1,3,2,0,6,3,-1,Dubai,Emirates airline,,org-org,PROPN,PROPN-NOUN,poss,compound-nsubj,NNP,NNP-NN,2,0
14205,14186.0,79,jpeg,0,6,39,33,5,39,-6,39,United Arab Emirates,Al Nahyan,org-org-org,-,PROPN-PROPN-PROPN,PROPN-PROPN,compound-compound-conj,compound-compound,NNP-NNP-NNPS,NNP-NNP,-1,0
14206,14187.0,52,ascended,27,5,18,13,4,33,22,-9,Wentz,Chicago,,per,PROPN,PROPN,poss,compound,NNP,NNP,7,0
14207,14188.0,41,painted,1,13,38,25,12,2,-12,37,John LaFarge,New York City,-,org-org-org,PROPN-PROPN,PROPN-PROPN-PROPN,compound-pobj,compound-compound-conj,NNP-NNP,NNP-NNP-NNP,5,0
14208,14189.0,19,received,4,3,15,12,2,3,1,11,Dennis Tito,Star City,-,org-org,PROPN-PROPN,PROPN-PROPN,compound-nsubj,compound-pobj,NNP-NNP,NNP-NNP,5,0
14209,14190.0,85,rates,2,48,61,13,47,23,-46,59,Traveling Wilburys,Roy Orbison,-,per-per,VERB-NOUN,PROPN-PROPN,compound-conj,compound-pobj,VBG-NNS,NNP-NNP,5,0
14210,14191.0,28,become,12,19,25,6,18,2,-7,13,Army of the Cumberland,William S. Rosecrans,org-org-org-org,--,PROPN-ADP-DET-PROPN,PROPN-PROPN-PROPN,pobj-prep-det-pobj,compound-compound-pobj,NNP-IN-DT-NNP,NNP-NNP-NNP,6,0
14211,14192.0,35,given,27,2,10,8,1,24,25,-17,Tony Sheridan,musician,-,per,PROPN-PROPN,NOUN,compound-compound,attr,NNP-NNP,NN,5,0
14212,14194.0,40,is,36,15,17,2,14,22,21,-19,Castro,President,per,,PROPN,PROPN,attr,appos,NNP,NNP,2,0
14213,14196.0,21,elected,3,6,19,13,5,1,-3,16,Windsor,Rick Limoges,per,-,PROPN,PROPN-PROPN,compound,compound-pobj,NNP,NNP-NNP,6,0
14214,14197.0,34,is,2,18,22,4,17,11,-16,20,Timken Senior High School,Trojans,org-org-org-org,,PROPN-PROPN-PROPN-PROPN,PROPN,compound-compound-compound-compound,compound,NNP-NNP-NNP-NNP,NNPS,4,0
14215,14198.0,22,founded,13,6,21,15,5,0,7,8,Mount de Sales Academy,1876,per-per-per-per,,PROPN-PROPN-PROPN-PROPN,NUM,nmod-compound-compound-nsubjpass,pobj,NNP-NNP-NNP-NNP,CD,6,0
14216,14199.0,28,was,5,8,26,18,7,1,-3,21,Quebec,Robert Bourassa,,per-per,PROPN,PROPN-PROPN,compound,compound-pobj,NNP,NNP-NNP,7,0
14217,14200.0,13,was,6,1,12,11,0,0,5,6,Collins,actor,,per,NOUN,NOUN,poss,attr,NNS,NN,4,0
14218,14202.0,32,is,2,1,24,23,0,7,1,22,AMREP Corporation,1961,-,per,PROPN-PROPN,NUM,compound-nsubj,pobj,NNP-NNP,CD,3,0
14219,14203.0,48,began,1,13,33,20,12,14,-12,32,UBBS,1964,per,,PROPN,NUM,pobj,pobj,NNP,CD,-1,0
14220,14205.0,16,stayed,1,1,4,3,0,11,0,3,Sirikitiya,San Diego,,per-per,PROPN,PROPN-PROPN,nsubj,compound-pobj,NNP,NNP-NNP,2,0
14221,14206.0,33,made,6,30,31,1,29,1,-24,25,hunter,Ted Nugent,org,-,NOUN,PROPN-PROPN,compound,compound-dobj,NN,NNP-NNP,1,0
14222,14209.0,17,is,9,1,15,14,0,1,8,6,Jason Scott Lee,martial artist,per-per-per,-,PROPN-PROPN-PROPN,ADJ-NOUN,compound-compound-nsubj,amod-conj,NNP-NNP-NNP,JJ-NN,4,0
14223,14210.0,11,is,3,2,7,5,1,3,1,4,Bernie Mac,Chicago,per-per,,PROPN-PROPN,PROPN,compound-nsubj,compound,NNP-NNP,NNP,3,0
14224,14212.0,27,started,3,1,12,11,0,14,2,9,Copal Partners,Joel Perlman,per-per,-,PROPN-PROPN,PROPN-PROPN,compound-nsubjpass,compound-dative,NNP-NNPS,NNP-NNP,3,0
14225,14213.0,29,left,1,5,17,12,4,11,-4,16,Ottawa,Le Droit,org,-,PROPN,PROPN-PROPN,pobj,compound-nsubj,NNP,NNP-NNP,5,0
14226,14214.0,31,Worry,2,12,30,18,11,0,-10,28,Joey Ramone,singer,per-per,,PROPN-PROPN,NOUN,compound-pobj,pobj,NNP-NNP,NN,5,0
14227,14215.0,16,was,4,12,14,2,11,1,-8,10,Sammy Cahn,Lyricist,org-org,,PROPN-PROPN,PROPN,compound-compound,compound,NNP-NNP,NNP,2,0
14228,14217.0,26,named,6,5,10,5,4,15,1,4,SPD,Gesine Schwan,,per-per,PROPN,PROPN-PROPN,appos,compound-oprd,NNP,NNP-NNP,4,0
14229,14218.0,51,remain,2,31,41,10,30,9,-29,39,Foreign Affairs,Maxime Verhagen,per-per,-,PROPN-PROPN,PROPN-PROPN,compound-pobj,compound-nsubj,NNP-NNPS,NNP-NNP,6,0
14230,14219.0,53,include,6,18,20,2,17,32,-12,14,URI,Robert Carothers,,per-per,PROPN,PROPN-PROPN,compound,compound-compound,NNP,NNP-NNP,3,0
14231,14220.0,33,released,4,6,17,11,5,15,-2,13,Willie Nelson,The Highwaymen,-,per-per,PROPN-PROPN,DET-PROPN,compound-pobj,det-conj,NNP-NNP,DT-NNPS,5,0
14232,14221.0,21,make,10,9,16,7,8,4,1,6,UK,GKN,,per,PROPN,PROPN,compound,compound,NNP,NNP,6,0
14233,14222.0,24,represented,3,7,21,14,6,2,-4,18,Argentine,Daniel Filmus,,per-per,PROPN,PROPN-PROPN,compound,compound-conj,NNP,NNP-NNP,8,0
14234,14223.0,31,dominated,1,1,24,23,0,6,0,23,Japan,Ken,,per,PROPN,PROPN,compound,compound,NNP,NNP,3,0
14235,14224.0,65,founded,5,2,10,8,1,54,3,5,University of Wales,1893,org-org-org,,PROPN-ADP-PROPN,NUM,nsubjpass-prep-pobj,pobj,NNP-IN-NNP,CD,3,0
14236,14225.0,36,played,6,14,18,4,13,17,-8,12,Radcliffe,London,org,,PROPN,PROPN,pobj,compound,NNP,NNP,5,0
14237,14226.0,31,was,1,1,13,12,0,17,0,12,Marmalade,Glasgow,org,,PROPN,PROPN,nsubj,pobj,NNP,NNP,7,0
14238,14227.0,41,invaded,8,6,10,4,5,30,2,2,Louis the German,Swabia,org-org-org,,PROPN-DET-PROPN,PROPN,pobj-det-nsubj,compound,NNP-DT-NNP,NNP,4,0
14239,14229.0,15,requires,1,1,14,13,0,0,0,13,She,Houston,org,,PRON,PROPN,nsubj,pobj,PRP,NNP,1,0
14240,14230.0,33,are,2,24,28,4,23,4,-22,26,Chinese,Jia Qinglin,,per-per,ADJ,PROPN-PROPN,amod,compound-nsubj,JJ,NNP-NNP,2,0
14241,14231.0,34,born,2,9,28,19,8,5,-7,26,England,Charles,,org,PROPN,PROPN,pobj,nsubj,NNP,NNP,5,0
14242,14233.0,29,For,0,12,24,12,11,4,-12,24,Jeanne Moreau,Paris,-,per,PROPN-PROPN,PROPN,compound-pobj,nmod,NNP-NNP,NNP,7,0
14243,14234.0,35,said,20,1,14,13,0,20,19,-6,Tim Berners-Lee,World Wide Web Consortium,per-per,---,PROPN-VERB,PROPN-ADJ-NOUN-PROPN,compound-nsubj,compound-compound-compound-pobj,NNP-VB,NNP-JJ-NN-NNP,6,0
14244,14235.0,39,was,10,29,32,3,28,6,-19,22,Moses Hazen,2nd Canadian Regiment,-,org-org-org,PROPN-PROPN,ADJ-ADJ-PROPN,compound-poss,compound-compound-pobj,NNP-NNP,JJ-JJ-NNP,3,0
14245,14236.0,34,created,3,2,12,10,1,21,1,9,AECL,2002,org,,PROPN,NUM,nsubjpass,pobj,NNP,CD,2,0
14246,14237.0,22,was,12,1,15,14,0,6,11,3,William Pugsley,politician,-,per,PROPN-PROPN,NOUN,compound-compound,attr,NNP-NNP,NN,4,0
14247,14238.0,31,is,4,14,24,10,13,6,-10,20,The Moody Blues,Ray Thomas,per-per-per,-,DET-PROPN-PROPN,PROPN-PROPN,det-compound-nsubjpass,compound-pobj,DT-NNP-NNPS,NNP-NNP,9,0
14248,14239.0,32,released,3,17,18,1,16,13,-14,15,artist,Joe Petagno,org,-,NOUN,PROPN-PROPN,pobj,compound-appos,NN,NNP-NNP,1,0
14249,14240.0,35,was,11,20,3,-17,19,31,-9,-8,Edmund C. Lynch,Merrill Lynch,--,per-per,PROPN-PROPN-PROPN,PROPN-PROPN,compound-compound-pobj,compound-compound,NNP-NNP-NNP,NNP-NNP,5,0
14250,14241.0,28,was,6,14,15,1,13,12,-8,9,singer,Syreeta Wright,,per-per,NOUN,PROPN-PROPN,pobj,compound-appos,NN,NNP-NNP,1,0
14251,14243.0,36,was,10,15,34,19,14,1,-5,24,Amos Kendall,Gallaudet University,-,per-per,PROPN-PROPN,PROPN-PROPN,compound-pobj,compound-attr,NNP-NNP,NNP-NNP,5,0
14252,14244.0,28,worked,5,4,8,4,3,19,1,3,director,Tod Browning,,per-per,NOUN,PROPN-PROPN,pobj,compound-poss,NN,NNP-NNP,4,0
14253,14245.0,30,began,6,11,27,16,10,2,-5,21,Lashley,Bobby Lashley,,org-org,PROPN,PROPN-PROPN,pobj,compound-compound,NNP,NNP-NNP,8,0
14254,14247.0,68,CAE,4,38,46,8,37,21,-34,42,Portland,University of Portland,,org-org-org,PROPN,PROPN-ADP-PROPN,compound,nmod-prep-compound,NNP,NNP-IN-NNP,6,0
14255,14248.0,55,MacLachlan,3,10,19,9,9,35,-7,16,director,Norton,org,,NOUN,PROPN,conj,nsubj,NN,NNP,3,0
14256,14249.0,31,discontinued,16,12,22,10,11,8,4,6,league,Hamburg Sea Devils,per,--,NOUN,PROPN-PROPN-PROPN,pobj,compound-compound-nsubjpass,NN,NNP-NNP-NNP,8,0
14257,14251.0,63,was,6,15,17,2,14,45,-9,11,Prime Minister,Recep Tayyip Erdo?a,org-org,--,PROPN-PROPN,PROPN-PROPN-PROPN,compound-pobj,compound-compound-compound,NNP-NNP,NNP-NNP-NNP,1,0
14258,14252.0,37,It's,0,18,35,17,17,1,-18,35,Boston,Northeastern University,,per-per,PROPN,PROPN-PROPN,pobj,compound-pobj,NNP,NNP-NNP,11,0
14259,14253.0,21,is,11,11,17,6,10,3,0,6,Alice,University of Fort Hare,,per-per-per-per,PROPN,PROPN-ADP-PROPN-PROPN,pobj,pobj-prep-compound-pobj,NNP,NNP-IN-NNP-NNP,4,0
14260,14254.0,23,joined,4,4,7,3,3,15,0,3,Jr.,Versus,per,,PROPN,PROPN,nsubj,compound,NNP,NNP,2,0
14261,14255.0,36,began,1,30,31,1,29,4,-29,30,King,George I of Great Britain,,org-org-org-org-org,PROPN,PROPN-PRON-ADP-PROPN-PROPN,compound,dobj-appos-prep-compound-pobj,NNP,NNP-PRP-IN-NNP-NNP,1,0
14262,14256.0,10,located,6,1,4,3,0,5,5,-2,Sydney,Grace Bros,per,-,PROPN,PROPN-PROPN,poss,compound-nsubjpass,NNP,NNP-NNP,2,0
14263,14257.0,48,revoked,28,26,27,1,25,20,2,-1,Emperor,Constantine IV,org,-,PROPN,PROPN-PROPN,compound,compound-nsubj,NNP,NNP-NNP,1,0
14264,14261.0,24,includes,2,2,14,12,1,9,0,12,VPA,Air Force,,per-per,PROPN,PROPN-PROPN,nsubj,compound-compound,NNP,NNP-NNP,4,0
14265,14262.0,19,declined,1,5,17,12,4,1,-4,16,United States,James Buchanan,-,per-per,PROPN-PROPN,PROPN-PROPN,compound-compound,compound-pobj,NNP-NNP,NNP-NNP,7,0
14266,14263.0,43,took,2,18,18,0,17,24,-16,16,California,California Highway Patrol,org,--,PROPN,PROPN-PROPN-PROPN,compound,compound-compound-pobj,NNP,NNP-NNP-NNP,0,0
14267,14264.0,33,left,2,22,30,8,21,2,-20,28,Olympiakos Nicosia,Cypriot Second Division,per-per,--,PROPN-PROPN,PROPN-PROPN-PROPN,pobj-compound,compound-compound-pobj,NNP-NNP,NNP-NNP-NNP,15,0
14268,14265.0,39,questioned,6,12,21,9,11,17,-6,15,n Republika Srpsk,f Radovan Karad?,--,per-per-per,CCONJ-PROPN-PROPN,X-PROPN-VERB,ROOT-compound-ROOT,det-compound-ROOT,CC-NNP-NNP,XX-NNP-VBZ,8,0
14269,14267.0,61,were,2,36,51,15,35,9,-34,49,National League,Southampton Saints,-,per-per,PROPN-PROPN,PROPN-PROPN,compound-dobj,compound-pobj,NNP-NNP,NNP-NNPS,5,0
14270,14269.0,86,is,2,15,56,41,14,29,-13,54,Colleges of the Fenway,Simmons College,---,per-per,PROPN-ADP-DET-PROPN,PROPN-PROPN,pobj-prep-det-compound,compound-compound,NNPS-IN-DT-NNP,NNP-NNP,14,0
14271,14270.0,26,takes,9,8,8,0,7,17,1,-1,Russian Federation,Russian Navy,-,per-per,PROPN-PROPN,ADJ-PROPN,compound-pobj,amod-pobj,NNP-NNP,JJ-NNP,0,0
14272,14271.0,25,transferred,1,4,8,4,3,16,-3,7,Texas Christian University,TCU Horned Frogs,--,per-per-per,PROPN-PROPN-PROPN,PROPN-PROPN-PROPN,compound-compound-pobj,compound-compound-compound,NNP-NNP-NNP,NNP-NNP-NNP,4,0
14273,14273.0,26,play,8,11,16,5,10,9,-3,8,NCAA,Virginia Wesleyan College,,per-per-per,PROPN,PROPN-PROPN-PROPN,compound,compound-compound-poss,NNP,NNP-NNP-NNP,6,0
14274,14274.0,34,league,3,6,9,3,5,24,-3,6,Eredivisie,PSV Eindhoven,per,-,PROPN,PROPN-PROPN,nmod,compound-nsubj,NNP,NNP-NNP,4,0
