,sent_index,sentence_length,root_word,root_index,entity_1_index,entity_2_index,entity_distance,no_words_before_entity_1,no_words_after_entity_2,entity_1_root_distance,entity_2_root_distance,entity 1 name,entity 2 name,entity_type_1,entity_type_2,entity_pos_1,entity_pos_2,entity_dep_1,entity_dep_2,entity_tag_1,entity_tag_2,shortest_distance,label
0,0.0,20,is,4,2,2,0,1,17,2,-2,Traveling Wilburys Collection,Traveling Wilburys,MISC-MISC-MISC,ORG-ORG,VERB-PROPN-PROPN,VERB-PROPN,compound-compound-nsubj,compound-appos,VBG-NNP-NNP,VBG-NNPS,0,1
1,4.0,30,completed,6,13,21,8,12,8,-7,15,Jeff Lynne,Wilburys,PER-PER,ORG,PROPN-PROPN,PROPN,compound-pobj,dobj,NNP-NNP,NNPS,7,1
2,4.0,30,completed,6,26,29,3,25,0,-20,23,Harrison,Dhani,PER,PER,PROPN,PROPN,poss,appos,NNP,NNP,4,1
3,4.0,30,completed,6,21,23,2,20,6,-15,17,Wilburys,1988,ORG,TIME,PROPN,NUM,dobj,pobj,NNPS,CD,3,1
0,1.0,24,was,4,11,22,11,10,1,-7,18,Battle Shinhwa,Good Entertainment,MISC-MISC,ORG-ORG,PROPN-PROPN,PROPN-PROPN,compound-pobj,compound-pobj,NNP-NNP,NNP-NNP,8,1
1,2.0,58,going,5,35,37,2,34,20,-30,32,Spica,Yang Jiwon,ORG,PER-PER,PROPN,PROPN-PROPN,compound,compound-appos,NNP,NNP-NNP,1,1
2,3.0,30,discovered,3,1,6,5,0,23,2,3,Hyoseong,TS Entertainment,PER,ORG-ORG,PROPN,PROPN-PROPN,nsubjpass,compound-pobj,NNP,NNP-NNP,3,1
3,4.0,23,debuted,4,7,22,15,6,0,-3,18,Song Jieun,Secret,PER-PER,ORG,PROPN-PROPN,PROPN,compound-pobj,appos,NNP-NNP,NNP,3,1
4,4.0,23,debuted,4,10,22,12,9,0,-6,18,Han Sunhwa,Secret,PER-PER,ORG,PROPN-PROPN,PROPN,compound-conj,appos,NNP-NNP,NNP,4,1
5,4.0,23,debuted,4,13,22,9,12,0,-9,18,Jung Hana,Secret,PER-PER,ORG,PROPN-PROPN,PROPN,compound-conj,appos,NNP-NNP,NNP,5,1
0,0.0,24,was,3,2,15,13,1,8,1,12,Rankenian Club,1716,ORG-ORG,TIME,PROPN-PROPN,NUM,compound-nsubj,pobj,NNP-NNP,CD,6,1
1,3.0,118,were,2,34,37,3,33,80,-32,35,John Stevenson,1695,PER-PER,TIME,PROPN-PROPN,NUM,compound-appos,appos,NNP-NNP,CD,3,1
2,3.0,118,were,2,64,67,3,63,50,-62,65,Marischal College,Aberdeen,ORG-ORG,LOC,PROPN-PROPN,PROPN,compound-pobj,appos,NNP-NNP,NNP,4,1
3,3.0,118,were,2,69,72,3,68,45,-67,70,Robert Wallace,1697,PER-PER,TIME,PROPN-PROPN,NUM,compound-conj,npadvmod,NNP-NNP,CD,3,1
4,3.0,118,were,2,82,85,3,81,32,-80,83,William Wishart,1691,PER-PER,TIME,PROPN-PROPN,NUM,compound-conj,npadvmod,NNP-NNP,CD,3,1
5,3.0,118,were,2,101,106,5,100,11,-99,104,Colin MacLaurin,1746,PER-PER,TIME,PROPN-PROPN,NUM,compound-conj,prep,NNP-NNP,CD,5,1
6,3.0,118,were,2,101,10,-91,100,107,-99,8,Colin MacLaurin,Scottish,PER-PER,LOC,PROPN-PROPN,ADJ,compound-conj,amod,NNP-NNP,JJ,10,1
0,0.0,13,is,2,1,10,9,0,2,1,8,Groat Road,Alberta,LOC-LOC,LOC,PROPN-PROPN,PROPN,compound-nsubj,npadvmod,NNP-NNP,NNP,6,1
1,0.0,13,is,2,1,12,11,0,0,1,10,Groat Road,Canada,LOC-LOC,LOC,PROPN-PROPN,PROPN,compound-nsubj,appos,NNP-NNP,NNP,2,1
2,0.0,13,is,2,8,10,2,7,2,-6,8,Edmonton,Alberta,LOC,LOC,PROPN,PROPN,pobj,npadvmod,NNP,NNP,3,1
3,0.0,13,is,2,8,12,4,7,0,-6,10,Edmonton,Canada,LOC,LOC,PROPN,PROPN,pobj,appos,NNP,NNP,5,1
4,0.0,13,is,2,10,12,2,9,0,-8,10,Alberta,Canada,LOC,LOC,PROPN,PROPN,npadvmod,appos,NNP,NNP,6,1
0,0.0,45,was,12,1,5,4,0,39,11,-7,Malcolm Mitchell Young,6 January 1953,PER-PER-PER,TIME-TIME-TIME,PROPN-PROPN-PROPN,NUM-PROPN-NUM,compound-compound-nsubj,nummod-appos-nummod,NNP-NNP-NNP,CD-NNP-CD,2,1
1,0.0,45,was,12,1,15,14,0,29,11,3,Malcolm Mitchell Young,Scottish,PER-PER-PER,LOC,PROPN-PROPN-PROPN,ADJ,compound-compound-nsubj,amod,NNP-NNP-NNP,JJ,5,1
2,2.0,22,inducted,10,1,14,13,0,7,9,4,Young,Rock and Roll Hall of Fame,PER,MISC-MISC-MISC-MISC-MISC-MISC,PROPN,PROPN-CCONJ-PROPN-PROPN-ADP-PROPN,nsubjpass,nmod-cc-conj-pobj-prep-pobj,NNP,NNP-CC-NNP-NNP-IN-NNP,6,1
3,3.0,27,described,15,14,5,-9,13,21,1,-10,Malcolm,Angus,PER,PER,PROPN,PROPN,nsubjpass,appos,NNP,NNP,2,1
0,0.0,22,is,3,1,6,5,0,15,2,3,Gustavo Bolívar Moreno,Colombian,PER-PER-PER,LOC,PROPN-PROPN-PROPN,ADJ,compound-compound-nsubj,amod,NNP-NNP-NNP,JJ,3,1
0,0.0,36,is,4,7,13,6,6,22,-3,9,Canadian,Prince Edward Island,LOC,LOC-LOC-LOC,ADJ,PROPN-PROPN-PROPN,amod,compound-compound-appos,JJ,NNP-NNP-NNP,5,1
1,0.0,36,is,4,11,13,2,10,22,-7,9,Charlottetown,Prince Edward Island,LOC,LOC-LOC-LOC,PROPN,PROPN-PROPN-PROPN,pobj,compound-compound-appos,NNP,NNP-NNP-NNP,3,1
0,3.0,39,crashed,19,11,16,5,10,22,8,-3,Lokomotiv Yaroslavl,Kontinental Hockey League,ORG-ORG,ORG-ORG-ORG,PROPN-PROPN,PROPN-PROPN-PROPN,compound-compound,compound-compound-pobj,NNP-NNP,NNP-NNP-NNP,4,1
1,3.0,39,crashed,19,11,24,13,10,14,8,5,Lokomotiv Yaroslavl,Russia,ORG-ORG,LOC,PROPN-PROPN,PROPN,compound-compound,appos,NNP-NNP,NNP,5,1
2,3.0,39,crashed,19,29,31,2,28,7,-10,12,Minsk,Belarus,LOC,LOC,PROPN,PROPN,pobj,appos,NNP,NNP,6,1
0,0.0,16,was,11,1,4,3,0,11,10,-7,Fanny Navarro,1 June 1920,PER-PER,TIME-TIME-TIME,PROPN-PROPN,NUM-PROPN-NUM,compound-nsubj,nummod-appos-nummod,NNP-NNP,CD-NNP-CD,1,1
1,0.0,16,was,11,1,8,7,0,7,10,-3,Fanny Navarro,18 March 1971,PER-PER,TIME-TIME-TIME,PROPN-PROPN,NUM-PROPN-NUM,compound-nsubj,nummod-appos-nummod,NNP-NNP,CD-NNP-CD,2,1
2,0.0,16,was,11,1,14,13,0,1,10,3,Fanny Navarro,Argentine,PER-PER,LOC,PROPN-PROPN,ADJ,compound-nsubj,amod,NNP-NNP,JJ,2,1
3,1.0,69,ángeles,39,39,45,6,38,23,0,6,Dos ángeles y un pecador,1945,MISC-MISC-MISC-MISC-MISC,TIME,PROPN-NOUN-NOUN-INTJ-NOUN,NUM,nsubj-ROOT-det-compound-dobj,appos,NNP-NNS-NN-UH-NN,CD,2,1
4,1.0,69,ángeles,39,48,50,2,47,18,-9,11,Marihuana,1950,MISC,TIME,PROPN,NUM,appos,appos,NNP,CD,2,1
5,1.0,69,ángeles,39,53,55,2,52,13,-14,16,Deshonra,1952,MISC,TIME,PROPN,NUM,appos,appos,NNP,CD,2,1
6,1.0,69,ángeles,39,58,61,3,57,7,-19,22,Marta Ferrari,1956,MISC-MISC,TIME,PROPN-PROPN,NUM,compound-appos,appos,NNP-NNP,CD,1,1
7,1.0,69,ángeles,39,64,67,3,63,1,-25,28,La Calesita,1969,MISC-MISC,TIME,PROPN-PROPN,NUM,compound-conj,appos,NNP-NNP,CD,1,1
8,1.0,69,ángeles,39,6,9,3,5,59,33,-30,Melodías porteñas,1937,MISC-MISC,TIME,PROPN-NOUN,NUM,compound-dobj,appos,NNP-NN,CD,1,1
0,0.0,47,signed,15,33,43,10,32,3,-18,28,State of Lithuania,Vilnius,LOC-LOC-LOC,LOC,PROPN-ADP-PROPN,PROPN,pobj-prep-pobj,pobj,NNP-IN-NNP,NNP,5,1
1,10.0,18,became,14,11,2,-9,10,15,3,-12,Wars of Independence,Lithuania,MISC-MISC-MISC,LOC,PROPN-ADP-PROPN,PROPN,dobj-prep-pobj,nsubj,NNPS-IN-NNP,NNP,4,1
2,15.0,19,found,9,18,16,-2,17,2,-9,7,Germany,Berlin,LOC,LOC,PROPN,PROPN,appos,pobj,NNP,NNP,6,1
0,0.0,24,is,8,1,5,4,0,18,7,-3,Christopher Austin,14 November 1968,PER-PER,TIME-TIME-TIME,PROPN-PROPN,NUM-PROPN-NUM,compound-nsubj,nummod-npadvmod-nummod,NNP-NNP,CD-NNP-CD,2,1
1,0.0,24,is,8,1,11,10,0,12,7,3,Christopher Austin,British,PER-PER,LOC,PROPN-PROPN,ADJ,compound-nsubj,amod,NNP-NNP,JJ,2,1
2,8.0,17,teaches,1,1,10,9,0,6,0,9,Austin,Royal Academy of Music,PER,ORG-ORG-ORG-ORG,NOUN,PROPN-PROPN-ADP-PROPN,nsubj,compound-pobj-prep-pobj,NN,NNP-NNP-IN-NNP,3,1
3,8.0,17,teaches,1,10,16,6,9,0,-9,15,Royal Academy of Music,London,ORG-ORG-ORG-ORG,LOC,PROPN-PROPN-ADP-PROPN,PROPN,compound-pobj-prep-pobj,pobj,NNP-NNP-IN-NNP,NNP,4,1
0,7.0,16,is,2,13,9,-4,12,6,-11,7,Tripoli,Lebanon,LOC,LOC,PROPN,PROPN,conj,pobj,NNP,NNP,3,1
1,7.0,16,is,2,15,9,-6,14,6,-13,7,Sidon,Lebanon,LOC,LOC,PROPN,PROPN,conj,pobj,NNP,NNP,3,1
0,0.0,30,is,12,2,10,8,1,19,10,-2,Iberian worm lizard,Blanus,MISC-MISC-MISC,LOC,ADJ-NOUN-NOUN,PROPN,amod-compound-nsubj,compound,JJ-NN-NN,NNP,3,1
1,0.0,30,is,12,2,21,19,1,8,10,9,Iberian worm lizard,Blanidae,MISC-MISC-MISC,LOC,ADJ-NOUN-NOUN,PROPN,amod-compound-nsubj,appos,JJ-NN-NN,NNP,5,1
2,0.0,30,is,12,10,21,11,9,8,2,9,Blanus,Blanidae,LOC,LOC,PROPN,PROPN,compound,appos,NNP,NNP,6,1
3,0.0,30,is,12,10,29,19,9,0,2,17,Blanus,Amphisbaenia,LOC,MISC,PROPN,PROPN,compound,appos,NNP,NNP,4,1
4,0.0,30,is,12,21,29,8,20,0,-9,17,Blanidae,Amphisbaenia,LOC,MISC,PROPN,PROPN,appos,appos,NNP,NNP,4,1
0,4.0,44,became,28,18,40,22,17,3,10,12,Ivan Fomin,Soviet,PER-PER,LOC,PROPN-PROPN,ADJ,compound-pobj,amod,NNP-NNP,JJ,6,1
1,4.0,44,became,28,21,40,19,20,3,7,12,Vladimir Shchuko,Soviet,PER-PER,LOC,PROPN-PROPN,ADJ,compound-conj,amod,NNP-NNP,JJ,7,1
2,4.0,44,became,28,18,40,22,17,3,10,12,Ivan Zholtovsky,Soviet,PER-PER,LOC,PROPN-PROPN,ADJ,compound-appos,amod,NNP-NNP,JJ,6,1
0,0.0,31,was,11,1,4,3,0,26,10,-7,Bertel Thorvaldsen,19 November 1770,PER-PER,TIME-TIME-TIME,PROPN-PROPN,NUM-PROPN-NUM,compound-compound,nummod-npadvmod-nummod,NNP-NNP,CD-NNP-CD,2,1
1,0.0,31,was,11,1,8,7,0,22,10,-3,Bertel Thorvaldsen,24 March 1844,PER-PER,TIME-TIME-TIME,PROPN-PROPN,NUM-PROPN-NUM,compound-compound,nummod-appos-nummod,NNP-NNP,CD-NNP-CD,2,1
2,0.0,31,was,11,1,14,13,0,16,10,3,Bertel Thorvaldsen,Danish,PER-PER,LOC,PROPN-PROPN,ADJ,compound-compound,amod,NNP-NNP,JJ,3,1
3,1.0,32,born,2,1,5,4,0,26,1,3,Thorvaldsen,Copenhagen,PER,LOC,PROPN,PROPN,nsubjpass,pobj,NNP,NNP,2,1
4,1.0,32,born,2,1,21,20,0,10,1,19,Thorvaldsen,Royal Danish Academy of Art,PER,ORG-ORG-ORG-ORG-ORG,PROPN,PROPN-PROPN-PROPN-ADP-NOUN,nsubjpass,compound-compound-pobj-prep-pobj,NNP,NNP-NNP-NNP-IN-NN,5,1
5,4.0,13,made,4,4,2,-2,3,10,0,-2,Thorvaldsen,Rome,PER,LOC,PROPN,PROPN,nsubj,pobj,NNP,NNP,1,1
0,0.0,18,is,1,1,16,15,0,1,0,15,Queequeg,Herman Melville,PER,PER-PER,PROPN,PROPN-PROPN,nsubj,compound-pobj,NNP,NNP-NNP,6,1
0,4.0,29,is,3,16,13,-3,15,15,-13,10,Amman,Jordan,LOC,LOC,PROPN,PROPN,appos,poss,NNP,NNP,5,1
1,4.0,29,is,3,28,26,-2,27,2,-25,23,Baghdad,Iraqi,LOC,LOC,PROPN,ADJ,appos,amod,NNP,JJ,4,1
0,6.0,18,was,9,12,16,4,11,1,-3,7,Battle of Kazan,July 1774,MISC-MISC-MISC,TIME-TIME,PROPN-ADP-PROPN,PROPN-NUM,attr-prep-pobj,pobj-nummod,NNP-IN-NNP,NNP-CD,4,1
1,9.0,13,captured,2,1,9,8,0,3,1,7,Pugachev,Moscow,PER,LOC,PROPN,PROPN,nsubjpass,pobj,NNP,NNP,3,1
2,9.0,13,captured,2,1,11,10,0,1,1,9,Pugachev,January 1775,PER,TIME-TIME,PROPN,PROPN-NUM,nsubjpass,pobj-nummod,NNP,NNP-CD,5,1
0,0.0,33,is,1,1,12,11,0,20,0,11,Nimbin,Australian,LOC,LOC,PROPN,ADJ,nsubj,amod,NNP,JJ,5,1
1,5.0,28,become,2,1,7,6,0,20,1,5,Nimbin,Australian,LOC,LOC,PROPN,ADJ,nsubj,amod,NNP,JJ,5,1
2,0.0,33,is,1,1,15,14,0,17,0,14,Nimbin,New South Wales,LOC,LOC-LOC-LOC,PROPN,PROPN-PROPN-PROPN,nsubj,compound-compound-pobj,NNP,NNP-NNP-NNP,8,1
3,0.0,33,is,1,7,12,5,6,20,-6,11,Northern Rivers,Australian,LOC-LOC,LOC,PROPN-PROPN,ADJ,compound-compound,amod,NNP-NNPS,JJ,3,1
4,0.0,33,is,1,7,15,8,6,17,-6,14,Northern Rivers,New South Wales,LOC-LOC,LOC-LOC-LOC,PROPN-PROPN,PROPN-PROPN-PROPN,compound-compound,compound-compound-pobj,NNP-NNPS,NNP-NNP-NNP,6,1
5,0.0,33,is,1,12,15,3,11,17,-11,14,Australian,New South Wales,LOC,LOC-LOC-LOC,ADJ,PROPN-PROPN-PROPN,amod,compound-compound-pobj,JJ,NNP-NNP-NNP,3,1
0,0.0,10,is,1,1,6,5,0,3,0,5,Hemnes,Nordland county,LOC,LOC-LOC,PROPN,PROPN-NOUN,nsubj,compound-pobj,NNP,NNP-NN,3,1
1,0.0,10,is,1,6,9,3,5,0,-5,8,Nordland county,Norway,LOC-LOC,LOC,PROPN-NOUN,PROPN,compound-pobj,appos,NNP-NN,NNP,4,1
0,1.0,41,is,1,6,23,17,5,17,-5,22,The Apprentice,Donald Trump,MISC-MISC,PER-PER,DET-PROPN,PROPN-PROPN,det-compound,compound-ROOT,DT-NNP,NNP-NNP,-1,1
1,1.0,41,is,1,20,23,3,19,17,-19,22,U.S.,Donald Trump,LOC,PER-PER,PROPN,PROPN-PROPN,compound,compound-ROOT,NNP,NNP-NNP,-1,1
2,1.0,41,is,1,34,36,2,33,4,-33,35,California,Arnold Schwarzenegger,LOC,PER-PER,PROPN,PROPN-PROPN,compound,compound-conj,NNP,NNP-NNP,1,1
3,2.0,20,said,11,7,10,3,6,9,4,-1,NBC Entertainment,Bob Greenblatt,ORG-ORG,PER-PER,PROPN-PROPN,PROPN-PROPN,compound-compound,compound-nsubj,NNP-NNP,NNP-NNP,2,1
4,3.0,22,is,10,13,20,7,12,1,-3,10,For the Love of Money,The O'Jays,MISC-MISC-MISC-MISC-MISC,PER-PER,ADP-DET-NOUN-ADP-NOUN,DET-PROPN,prep-det-pobj-prep-pobj,det-pobj,IN-DT-NN-IN-NN,DT-NNP,5,1
0,0.0,32,is,13,1,6,5,0,25,12,-7,Oakdale,Washington County,LOC,LOC-LOC,PROPN,PROPN-PROPN,nsubj,compound-pobj,NNP,NNP-NNP,3,1
1,0.0,32,is,13,6,9,3,5,22,7,-4,Washington County,Minnesota,LOC-LOC,LOC,PROPN-PROPN,PROPN,compound-pobj,conj,NNP-NNP,NNP,2,1
0,0.0,19,is,5,2,16,14,1,2,3,11,Caniapiscau River,Quebec,LOC-LOC,LOC,PROPN-PROPN,PROPN,compound-nsubj,conj,NNP-NNP,NNP,6,1
1,0.0,19,is,5,2,18,16,1,0,3,13,Caniapiscau River,Canada,LOC-LOC,LOC,PROPN-PROPN,PROPN,compound-nsubj,appos,NNP-NNP,NNP,2,1
2,0.0,19,is,5,11,16,5,10,2,-6,11,Koksoak River,Quebec,LOC-LOC,LOC,PROPN-PROPN,PROPN,compound-pobj,conj,NNP-NNP,NNP,6,1
3,0.0,19,is,5,11,18,7,10,0,-6,13,Koksoak River,Canada,LOC-LOC,LOC,PROPN-PROPN,PROPN,compound-pobj,appos,NNP-NNP,NNP,4,1
4,0.0,19,is,5,14,16,2,13,2,-9,11,Nunavik,Quebec,LOC,LOC,PROPN,PROPN,pobj,conj,NNP,NNP,3,1
5,0.0,19,is,5,14,18,4,13,0,-9,13,Nunavik,Canada,LOC,LOC,PROPN,PROPN,pobj,appos,NNP,NNP,5,1
6,0.0,19,is,5,16,18,2,15,0,-11,13,Quebec,Canada,LOC,LOC,PROPN,PROPN,conj,appos,NNP,NNP,6,1
7,6.0,27,drain,17,5,21,16,4,5,12,4,Caniapiscau River,La Grande River,LOC-LOC,LOC-LOC-LOC,PROPN-PROPN,PROPN-PROPN-PROPN,compound-pobj,compound-compound-pobj,NNP-NNP,NNP-NNP-NNP,6,1
8,6.0,27,drain,17,21,25,4,20,1,-4,8,La Grande River,James Bay,LOC-LOC-LOC,LOC-LOC,PROPN-PROPN-PROPN,PROPN-PROPN,compound-compound-pobj,compound-pobj,NNP-NNP-NNP,NNP-NNP,3,1
0,0.0,23,took,15,2,9,7,1,13,13,-6,first inauguration of Ulysses S. Grant,the United States,MISC-MISC-MISC-MISC-MISC-MISC,LOC-LOC-LOC,ADJ-NOUN-ADP-PROPN-PROPN-PROPN,DET-PROPN-PROPN,amod-nsubj-prep-compound-compound-pobj,det-compound-pobj,JJ-NN-IN-NNP-NNP-NNP,DT-NNP-NNP,3,1
0,6.0,32,was,2,21,9,-12,20,22,-19,7,Dutch Top 40,Netherlands,MISC-MISC-MISC,LOC,PROPN-PROPN-NUM,PROPN,compound-pobj-nummod,pobj,NNP-NNP-CD,NNP,7,1
0,0.0,31,is,8,15,24,9,14,6,-7,16,Shathashrunga,Indian,LOC,LOC,PROPN,ADJ,compound,amod,NNP,JJ,7,1
1,0.0,31,is,8,24,27,3,23,3,-16,19,Indian,Karnataka,LOC,LOC,ADJ,PROPN,amod,pobj,JJ,NNP,3,1
0,0.0,24,Cecere,1,1,5,4,0,18,0,4,Gaetano Cecere,"November 26 , 1894",PER-PER,TIME-TIME-TIME-TIME,PROPN-PROPN,PROPN-NUM-PUNCT-NUM,compound-ROOT,appos-nummod-punct-nummod,NNP-NNP,"NNP-CD-,-CD",2,1
1,0.0,24,Cecere,1,1,10,9,0,13,0,9,Gaetano Cecere,1985,PER-PER,TIME,PROPN-PROPN,NUM,compound-ROOT,nummod,NNP-NNP,CD,1,1
2,0.0,24,Cecere,1,1,12,11,0,11,0,11,Gaetano Cecere,American,PER-PER,LOC,PROPN-PROPN,ADJ,compound-ROOT,amod,NNP-NNP,JJ,-1,1
0,2.0,32,purchased,1,1,17,16,0,14,0,16,Allaire Iron Works,New York,ORG-ORG-ORG,LOC-LOC,PROPN-PROPN-PROPN,PROPN-PROPN,compound-compound-pobj,compound-pobj,NNP-NNP-NNP,NNP-NNP,5,1
0,0.0,35,is,2,1,28,27,0,6,1,26,Bare Island,New South Wales,LOC-LOC,LOC-LOC-LOC,PROPN-PROPN,PROPN-PROPN-PROPN,compound-nsubj,compound-compound-pobj,NNP-NNP,NNP-NNP-NNP,9,1
1,0.0,35,is,2,1,34,33,0,0,1,32,Bare Island,Australia,LOC-LOC,LOC,PROPN-PROPN,PROPN,compound-nsubj,pobj,NNP-NNP,NNP,2,1
2,0.0,35,is,2,14,28,14,13,6,-12,26,Sydney,New South Wales,LOC,LOC-LOC-LOC,PROPN,PROPN-PROPN-PROPN,pobj,compound-compound-pobj,NNP,NNP-NNP-NNP,8,1
3,0.0,35,is,2,14,34,20,13,0,-12,32,Sydney,Australia,LOC,LOC,PROPN,PROPN,pobj,pobj,NNP,NNP,3,1
4,0.0,35,is,2,18,28,10,17,6,-16,26,City of Randwick,New South Wales,LOC-LOC-LOC,LOC-LOC-LOC,PROPN-ADP-PROPN,PROPN-PROPN-PROPN,pobj-prep-nmod,compound-compound-pobj,NNP-IN-NNP,NNP-NNP-NNP,8,1
5,0.0,35,is,2,18,34,16,17,0,-16,32,City of Randwick,Australia,LOC-LOC-LOC,LOC,PROPN-ADP-PROPN,PROPN,pobj-prep-nmod,pobj,NNP-IN-NNP,NNP,5,1
6,0.0,35,is,2,28,34,6,27,0,-26,32,New South Wales,Australia,LOC-LOC-LOC,LOC,PROPN-PROPN-PROPN,PROPN,compound-compound-pobj,pobj,NNP-NNP-NNP,NNP,9,1
0,1.0,18,is,5,2,17,15,1,0,3,12,Ramon Magsaysay Technological University,1910,ORG-ORG-ORG-ORG,TIME,PROPN-PROPN-PROPN-PROPN,NUM,compound-compound-compound-nsubj,pobj,NNP-NNP-NNP-NNP,CD,3,1
1,2.0,18,located,7,11,15,4,10,2,-4,8,Municipality of Iba,Province of Zambales,LOC-LOC-LOC,LOC-LOC-LOC,PROPN-ADP-PROPN,PROPN-ADP-PROPN,pobj-prep-pobj,appos-prep-pobj,NNP-IN-NNP,NNP-IN-NNP,3,1
2,3.0,24,named,3,16,22,6,15,1,-13,19,Republic of the Philippines,Ramon Magsaysay,LOC-LOC-LOC-LOC,PER-PER,PROPN-ADP-DET-PROPN,PROPN-PROPN,pobj-prep-det-pobj,compound-appos,NNP-IN-DT-NNPS,NNP-NNP,8,1
3,5.0,19,Cruz,0,5,18,13,4,0,-5,18,Masinloc,Zambales,LOC,LOC,PROPN,PROPN,conj,pobj,NNP,NNP,4,1
4,5.0,19,Cruz,0,7,18,11,6,0,-7,18,Botolan,Zambales,LOC,LOC,PROPN,PROPN,conj,pobj,NNP,NNP,5,1
5,5.0,19,Cruz,0,9,18,9,8,0,-9,18,San Marcelino,Zambales,LOC-LOC,LOC,PROPN-PROPN,PROPN,compound-conj,pobj,NNP-NNP,NNP,5,1
6,5.0,19,Cruz,0,12,18,6,11,0,-12,18,Castillejos,Zambales,LOC,LOC,PROPN,PROPN,npadvmod,pobj,NNP,NNP,8,1
7,5.0,19,Cruz,0,18,3,-15,17,15,-18,3,Zambales,Candelaria,LOC,LOC,PROPN,PROPN,pobj,conj,NNP,NNP,3,1
0,0.0,23,was,14,1,5,4,0,17,13,-9,Bobby Jack Oliver,"January 9 , 1936",PER-PER-PER,TIME-TIME-TIME-TIME,PROPN-PROPN-PROPN,PROPN-NUM-PUNCT-NUM,compound-compound-nsubj,appos-nummod-punct-nummod,NNP-NNP-NNP,"NNP-CD-,-CD",3,1
1,0.0,23,was,14,1,10,9,0,12,13,-4,Bobby Jack Oliver,"December 15 , 2012",PER-PER-PER,TIME-TIME-TIME-TIME,PROPN-PROPN-PROPN,PROPN-NUM-PUNCT-NUM,compound-compound-nsubj,npadvmod-nummod-punct-nummod,NNP-NNP-NNP,"NNP-CD-,-CD",3,1
2,1.0,21,was,6,6,14,8,5,6,0,8,Oliver,Chicago Cardinals,PER,ORG-ORG,PROPN,PROPN-PROPN,nsubj,compound-pobj,NNP,NNP-NNPS,3,1
3,1.0,21,was,6,14,18,4,13,2,-8,12,Chicago Cardinals,1958 NFL Draft,ORG-ORG,MISC-MISC-MISC,PROPN-PROPN,NUM-PROPN-PROPN,compound-pobj,nummod-compound-pobj,NNP-NNPS,CD-NNP-NNP,5,1
4,4.0,33,enjoyed,1,1,24,23,0,8,0,23,Oliver,Jeff Russel Memorial Trophy,PER,MISC-MISC-MISC-MISC,PROPN,PROPN-PROPN-PROPN-PROPN,nsubj,compound-compound-compound-dobj,NNP,NNP-NNP-NNP-NNP,4,1
0,0.0,33,"""",0,2,5,3,1,27,-2,5,My Gift Is You,You Make It Feel Like Christmas,MISC-MISC-MISC-MISC,MISC-MISC-MISC-MISC-MISC-MISC,DET-NOUN-VERB-PRON,PRON-VERB-PRON-VERB-ADP-PROPN,poss-nsubj-ROOT-nsubj,nsubj-ROOT-nsubj-ccomp-prep-pobj,PRP$-NN-VBZ-PRP,PRP-VBP-PRP-VB-IN-NNP,2,1
1,0.0,33,"""",0,5,31,26,4,1,-5,31,You Make It Feel Like Christmas,2017,MISC-MISC-MISC-MISC-MISC-MISC,TIME,PRON-VERB-PRON-VERB-ADP-PROPN,NUM,nsubj-ROOT-nsubj-ccomp-prep-pobj,appos,PRP-VBP-PRP-VB-IN-NNP,CD,8,1
0,0.0,23,is,2,14,13,-1,13,9,-12,11,BBC,the United Kingdom,ORG,LOC-LOC-LOC,PROPN,DET-PROPN-PROPN,pobj,det-compound-pobj,NNP,DT-NNP-NNP,1,1
0,1.0,26,lives,1,15,18,3,14,7,-14,17,United States,Texas,LOC-LOC,LOC,PROPN-PROPN,PROPN,compound-pobj,appos,NNP-NNP,NNP,2,1
1,1.0,26,lives,1,15,20,5,14,5,-14,19,United States,New Mexico,LOC-LOC,LOC-LOC,PROPN-PROPN,PROPN-PROPN,compound-pobj,compound-conj,NNP-NNP,NNP-NNP,2,1
2,1.0,26,lives,1,15,24,9,14,1,-14,23,United States,Arizona,LOC-LOC,LOC,PROPN-PROPN,PROPN,compound-pobj,conj,NNP-NNP,NNP,1,1
0,0.0,18,is,8,1,5,4,0,12,7,-3,Roland Bruce Harvey,11 December 1945,PER-PER-PER,TIME-TIME-TIME,PROPN-PROPN-PROPN,NUM-PROPN-NUM,compound-compound-nsubj,nummod-appos-nummod,NNP-NNP-NNP,CD-NNP-CD,2,1
1,0.0,18,is,8,1,11,10,0,6,7,3,Roland Bruce Harvey,Australian,PER-PER-PER,LOC,PROPN-PROPN-PROPN,ADJ,compound-compound-nsubj,amod,NNP-NNP-NNP,JJ,4,1
2,7.0,14,born,3,1,6,5,0,7,2,3,Roland Harvey,Melbourne,PER-PER,LOC,PROPN-PROPN,PROPN,compound-nsubjpass,pobj,NNP-NNP,NNP,4,1
3,7.0,14,born,3,6,8,2,5,5,-3,5,Melbourne,Victoria,LOC,LOC,PROPN,PROPN,pobj,conj,NNP,NNP,4,1
0,1.0,19,formed,1,6,9,3,5,9,-5,8,M2 M,Marit Larsen,ORG-ORG,PER-PER,PROPN-PROPN,PROPN-PROPN,compound-dobj,compound-pobj,NNP-NNP,NNP-NNP,3,1
1,2.0,26,Am,22,1,10,9,0,15,21,-12,Raven,Atlantic Records,PER,ORG-ORG,PROPN,PROPN-PROPN,nsubjpass,compound-pobj,NNP,NNP-NNPS,5,1
2,2.0,26,Am,22,21,25,4,20,0,1,3,Here I Am,2005,MISC-MISC-MISC,TIME,ADV-PRON-VERB,NUM,advmod-nsubj-ROOT,pobj,RB-PRP-VBP,CD,2,1
3,3.0,41,signed,5,4,13,9,3,27,1,8,Raven,Eleven Seven,PER,ORG-ORG,PROPN,PROPN-NUM,nsubjpass,compound-appos,NNP,NNP-CD,4,1
4,7.0,18,married,6,6,10,4,5,7,0,4,Raven,Andreas Wiig,PER,PER-PER,PROPN,PROPN-PROPN,nsubj,compound-dobj,NNP,NNP-NNP,2,1
0,5.0,55,promulgated,6,37,41,4,36,13,-31,35,Massacre of Vassy,1 March 1562,MISC-MISC-MISC,TIME-TIME-TIME,PROPN-ADP-PROPN,NUM-PROPN-NUM,pobj-prep-pobj,nummod-pobj-nummod,NNP-IN-NNP,CD-NNP-CD,3,1
1,6.0,28,promulgated,17,3,14,11,2,13,14,-3,Edict of Fontainebleau,October 1685,MISC-MISC-MISC,TIME-TIME,PROPN-ADP-PROPN,PROPN-NUM,nsubjpass-prep-pobj,pobj-nummod,NNP-IN-NNP,NNP-CD,5,1
0,0.0,34,were,4,31,33,2,30,0,-27,29,Sydney,Australia,LOC,LOC,PROPN,PROPN,pobj,appos,NNP,NNP,4,1
0,3.0,22,carry,3,13,15,2,12,6,-10,12,Signals,Grace Under Pressure,MISC,MISC-MISC-MISC,NOUN,PROPN-ADP-PROPN,appos,appos-prep-pobj,NNS,NNP-IN-NNP,3,1
1,3.0,22,carry,3,15,20,5,14,1,-12,17,Grace Under Pressure,Power Windows,MISC-MISC-MISC,MISC-MISC,PROPN-ADP-PROPN,PROPN-PROPN,appos-prep-pobj,compound-conj,NNP-IN-NNP,NNP-NNP,2,1
2,5.0,36,appeared,10,21,27,6,20,8,-11,17,New World Man,1982,MISC-MISC-MISC,TIME,PROPN-PROPN-PROPN,NUM,nmod-compound-pobj,pobj,NNP-NNP-NNP,CD,5,1
3,6.0,33,appeared,2,16,5,-11,15,27,-14,3,Time Machine Tour,Rush,MISC-MISC-MISC,ORG,PROPN-PROPN-PROPN,PROPN,compound-compound-nsubj,poss,NNP-NNP-NNP,NNP,8,1
0,0.0,36,is,6,1,5,4,0,30,5,-1,René Brülhart,1972,PER-PER,TIME,PROPN-PROPN,NUM,compound-nsubj,npadvmod,NNP-NNP,CD,1,1
1,2.0,18,raised,2,1,11,10,0,6,1,9,Brühlhart,University of Fribourg,PER,ORG-ORG-ORG,PROPN,PROPN-ADP-PROPN,nsubjpass,pobj-prep-pobj,NNP,NNP-IN-NNP,5,1
0,0.0,14,is,9,1,12,11,0,1,8,3,Ridge Canipe,American,PER-PER,LOC,PROPN-PROPN,ADJ,compound-nsubj,amod,NNP-NNP,JJ,2,1
1,1.0,38,known,3,9,17,8,8,20,-6,14,Walk the Line,Johnny Cash,MISC-MISC-MISC,PER-PER,PROPN-DET-NOUN,PROPN-PROPN,pobj-det-appos,compound-dobj,NNP-DT-NN,NNP-NNP,7,1
2,1.0,38,known,3,26,29,3,25,8,-23,26,Baby Blues,2008,MISC-MISC,TIME,PROPN-PROPN,NUM,compound-appos,pobj,NNP-NNPS,CD,2,1
3,6.0,15,appeared,3,7,14,7,6,0,-4,11,Dean Winchester,Supernatural,PER-PER,MISC,PROPN-PROPN,PROPN,compound-pobj,appos,NNP-NNP,NNP,3,1
0,0.0,15,was,9,1,8,7,0,6,8,-1,Roger Le Geyt Hetherington,1990,PER-PER-PER-PER,TIME,PROPN-PROPN-PROPN-PROPN,NUM,compound-compound-compound-nsubj,nummod,NNP-NNP-NNP-NNP,CD,2,1
1,0.0,15,was,9,1,12,11,0,2,8,3,Roger Le Geyt Hetherington,British,PER-PER-PER-PER,LOC,PROPN-PROPN-PROPN-PROPN,ADJ,compound-compound-compound-nsubj,amod,NNP-NNP-NNP-NNP,JJ,4,1
2,1.0,24,born,2,1,5,4,0,18,1,3,Hetherington,London,PER,LOC,PROPN,PROPN,nsubjpass,pobj,NNP,NNP,2,1
3,1.0,24,born,2,1,7,6,0,16,1,5,Hetherington,20 December 1908,PER,TIME-TIME-TIME,PROPN,NUM-PROPN-NUM,nsubjpass,nummod-pobj-nummod,NNP,CD-NNP-CD,3,1
4,1.0,24,born,2,1,16,15,0,7,1,14,Hetherington,Roger Gaskell Hetherington,PER,PER-PER-PER,PROPN,PROPN-PROPN-PROPN,nsubjpass,compound-compound-pobj,NNP,NNP-NNP-NNP,6,1
5,1.0,24,born,2,1,22,21,0,1,1,20,Hetherington,Honoria Ford,PER,PER-PER,PROPN,PROPN-PROPN,nsubjpass,compound-appos,NNP,NNP-NNP,7,1
6,1.0,24,born,2,16,22,6,15,1,-14,20,Roger Gaskell Hetherington,Honoria Ford,PER-PER-PER,PER-PER,PROPN-PROPN-PROPN,PROPN-PROPN,compound-compound-pobj,compound-appos,NNP-NNP-NNP,NNP-NNP,3,1
7,2.0,7,entered,3,3,5,2,2,1,0,2,Hetherington,Highgate School,PER,ORG-ORG,PROPN,PROPN-PROPN,nsubj,compound-dobj,NNP,NNP-NNP,1,1
0,0.0,43,is,16,1,24,23,0,18,15,8,The Ship That Died of Shame,1955,MISC-MISC-MISC-MISC-MISC-MISC,TIME,DET-PROPN-DET-VERB-ADP-PROPN,NUM,det-nsubj-nsubj-relcl-prep-pobj,npadvmod,DT-NNP-WDT-VBD-IN-NNP,CD,-1,1
1,0.0,43,is,16,1,31,30,0,11,15,15,The Ship That Died of Shame,Basil Dearden,MISC-MISC-MISC-MISC-MISC-MISC,PER-PER,DET-PROPN-DET-VERB-ADP-PROPN,PROPN-PROPN,det-nsubj-nsubj-relcl-prep-pobj,compound-pobj,DT-NNP-WDT-VBD-IN-NNP,NNP-NNP,-1,1
2,0.0,43,is,16,1,35,34,0,7,15,19,The Ship That Died of Shame,George Baker,MISC-MISC-MISC-MISC-MISC-MISC,PER-PER,DET-PROPN-DET-VERB-ADP-PROPN,PROPN-PROPN,det-nsubj-nsubj-relcl-prep-pobj,compound-dobj,DT-NNP-WDT-VBD-IN-NNP,NNP-NNP,-1,1
3,0.0,43,is,16,1,38,37,0,4,15,22,The Ship That Died of Shame,Richard Attenborough,MISC-MISC-MISC-MISC-MISC-MISC,PER-PER,DET-PROPN-DET-VERB-ADP-PROPN,PROPN-PROPN,det-nsubj-nsubj-relcl-prep-pobj,compound-conj,DT-NNP-WDT-VBD-IN-NNP,NNP-NNP,-1,1
4,0.0,43,is,16,1,41,40,0,1,15,25,The Ship That Died of Shame,Bill Owen,MISC-MISC-MISC-MISC-MISC-MISC,PER-PER,DET-PROPN-DET-VERB-ADP-PROPN,PROPN-PROPN,det-nsubj-nsubj-relcl-prep-pobj,compound-conj,DT-NNP-WDT-VBD-IN-NNP,NNP-NNP,-1,1
5,0.0,43,is,16,14,24,10,13,18,2,8,PT Raiders,1955,MISC-MISC,TIME,PROPN-PROPN,NUM,compound-pobj,npadvmod,NNP-NNP,CD,-1,1
6,0.0,43,is,16,14,31,17,13,11,2,15,PT Raiders,Basil Dearden,MISC-MISC,PER-PER,PROPN-PROPN,PROPN-PROPN,compound-pobj,compound-pobj,NNP-NNP,NNP-NNP,-1,1
7,0.0,43,is,16,14,35,21,13,7,2,19,PT Raiders,George Baker,MISC-MISC,PER-PER,PROPN-PROPN,PROPN-PROPN,compound-pobj,compound-dobj,NNP-NNP,NNP-NNP,-1,1
8,0.0,43,is,16,14,38,24,13,4,2,22,PT Raiders,Richard Attenborough,MISC-MISC,PER-PER,PROPN-PROPN,PROPN-PROPN,compound-pobj,compound-conj,NNP-NNP,NNP-NNP,-1,1
9,0.0,43,is,16,14,41,27,13,1,2,25,PT Raiders,Bill Owen,MISC-MISC,PER-PER,PROPN-PROPN,PROPN-PROPN,compound-pobj,compound-conj,NNP-NNP,NNP-NNP,-1,1
0,0.0,27,is,1,24,26,2,23,0,-23,25,Victoria,Australia,LOC,LOC,PROPN,PROPN,pobj,appos,NNP,NNP,11,1
0,1.0,37,credited,8,21,16,-5,20,20,-13,8,Martín García Óñez de Loyola,Spanish,PER-PER-PER-PER-PER,LOC,PROPN-PROPN-PROPN-X-PROPN,PROPN,compound-compound-compound-compound-appos,amod,NNP-NNP-NNP-FW-NNP,NNP,6,1
0,0.0,19,Mailer,2,1,5,4,0,13,1,3,Andrew Caldwell Mailer,"April 4 , 1853",PER-PER-PER,TIME-TIME-TIME-TIME,PROPN-PROPN-PROPN,PROPN-NUM-PUNCT-NUM,compound-compound-ROOT,appos-nummod-punct-nummod,NNP-NNP-NNP,"NNP-CD-,-CD",3,1
1,0.0,19,Mailer,2,1,17,16,0,1,1,15,Andrew Caldwell Mailer,American,PER-PER-PER,LOC,PROPN-PROPN-PROPN,ADJ,compound-compound-ROOT,amod,NNP-NNP-NNP,JJ,3,1
2,3.0,41,born,2,1,12,11,0,28,1,10,Mailer,Lawrence University,PER,ORG-ORG,PROPN,PROPN-PROPN,nsubjpass,compound-dobj,NNP,NNP-NNP,3,1
3,3.0,41,born,2,1,33,32,0,7,1,31,Mailer,Bellevue Hospital Medical College,PER,ORG-ORG-ORG-ORG,PROPN,PROPN-PROPN-PROPN-PROPN,nsubjpass,compound-compound-compound-conj,NNP,NNP-NNP-NNP-NNP,6,1
4,3.0,41,born,2,1,5,4,0,35,1,3,Mailer,De Pere,PER,LOC-LOC,PROPN,PROPN-PROPN,nsubjpass,compound-nmod,NNP,NNP-NNP,3,1
5,3.0,41,born,2,12,15,3,11,25,-10,13,Lawrence University,Appleton,ORG-ORG,LOC,PROPN-PROPN,PROPN,compound-dobj,pobj,NNP-NNP,NNP,1,1
6,3.0,41,born,2,13,22,9,12,18,-11,20,University of Michigan,Ann Arbor,ORG-ORG-ORG,LOC-LOC,PROPN-ADP-PROPN,PROPN-PROPN,appos-prep-pobj,compound-pobj,NNP-IN-NNP,NNP-NNP,4,1
7,3.0,41,born,2,25,29,4,24,11,-23,27,Rush Medical College,Chicago,ORG-ORG-ORG,LOC,PROPN-PROPN-PROPN,PROPN,compound-compound-appos,pobj,NNP-NNP-NNP,NNP,3,1
0,0.0,29,was,13,1,4,3,0,24,12,-9,Lloyd Morey,"January 15 , 1886",PER-PER,TIME-TIME-TIME-TIME,PROPN-PROPN,PROPN-NUM-PUNCT-NUM,compound-nsubj,nmod-nummod-punct-nummod,NNP-NNP,"NNP-CD-,-CD",2,1
1,0.0,29,was,13,1,16,15,0,12,12,3,Lloyd Morey,American,PER-PER,LOC,PROPN-PROPN,ADJ,compound-nsubj,amod,NNP-NNP,JJ,2,1
2,1.0,19,went,7,7,3,-4,6,15,0,-4,Morey,Laddonia,PER,LOC,PROPN,PROPN,nsubj,pobj,NNP,NNP,4,1
3,1.0,19,went,7,7,11,4,6,7,0,4,Morey,Gem City Business College,PER,ORG-ORG-ORG-ORG,PROPN,PROPN-PROPN-PROPN-PROPN,nsubj,compound-compound-compound-pobj,NNP,NNP-NNP-NNP-NNP,3,1
4,5.0,16,died,1,1,4,3,0,11,0,3,Morey,Champaign,PER,LOC,PROPN,PROPN,nsubj,pobj,NNP,NNP,3,1
0,0.0,20,is,11,1,5,4,0,14,10,-6,Niklas Bergqvist,6 October 1962,PER-PER,TIME-TIME-TIME,PROPN-PROPN,NUM-PROPN-NUM,compound-nsubj,nummod-npadvmod-nummod,NNP-NNP,CD-NNP-CD,2,1
1,0.0,20,is,11,1,9,8,0,10,10,-2,Niklas Bergqvist,Stockholm,PER-PER,LOC,PROPN-PROPN,PROPN,compound-nsubj,pobj,NNP-NNP,NNP,1,1
2,0.0,20,is,11,1,14,13,0,5,10,3,Niklas Bergqvist,Swedish,PER-PER,LOC,PROPN-PROPN,ADJ,compound-nsubj,amod,NNP-NNP,JJ,2,1
3,0.0,20,is,11,9,14,5,8,5,2,3,Stockholm,Swedish,LOC,LOC,PROPN,ADJ,pobj,amod,NNP,JJ,3,1
4,4.0,16,produced,9,15,12,-3,14,3,-6,3,Harpo,Swedish,PER,LOC,PROPN,ADJ,pobj,amod,NNP,JJ,5,1
0,0.0,26,Tunbao,1,20,25,5,19,0,-19,24,Guizhou,China,LOC,LOC,PROPN,PROPN,nmod,appos,NNP,NNP,6,1
1,0.0,26,Tunbao,1,22,25,3,21,0,-21,24,Yunnan,China,LOC,LOC,PROPN,PROPN,conj,appos,NNP,NNP,4,1
0,9.0,33,returned,5,21,23,2,20,9,-16,18,Suzhou,Jiangsu,LOC,LOC,PROPN,PROPN,pobj,npadvmod,NNP,NNP,2,1
0,0.0,38,is,3,2,2,0,1,35,1,-1,Chevrolet Chevette,Chevrolet,MISC-MISC,ORG,PROPN-PROPN,PROPN,compound-nsubj,pobj,NNP-NNP,NNP,0,1
1,3.0,10,employed,2,4,2,-2,3,7,-2,0,General Motors,Chevette,ORG-ORG,ORG,PROPN-PROPN,PROPN,compound-poss,nsubj,NNP-NNPS,NNP,2,1
0,0.0,12,is,2,1,11,10,0,0,1,9,David Livingstone,UK,PER-PER,LOC,PROPN-PROPN,PROPN,compound-nsubj,pobj,NNP-NNP,NNP,2,1
1,0.0,12,is,2,7,11,4,6,0,-5,9,Sky Sports,UK,ORG-ORG,LOC,PROPN-PROPN,PROPN,compound-pobj,pobj,NNP-NNPS,NNP,4,1
2,3.0,41,joined,1,17,3,-14,16,37,-16,2,Sky Sports,BSkyB,ORG-ORG,ORG,PROPN-PROPN,NOUN,compound-pobj,dobj,NNP-NNPS,NN,6,1
3,3.0,41,joined,1,3,9,6,2,31,-2,8,BSkyB,1990,ORG,TIME,NOUN,NUM,dobj,pobj,NN,CD,2,1
4,3.0,41,joined,1,3,17,14,2,23,-2,16,BSkyB,Sky,ORG,ORG,NOUN,PROPN,dobj,nsubj,NN,NNP,6,1
0,2.0,38,decided,3,33,23,-10,32,14,-30,20,Supreme Court of New Brunswick,Canada,ORG-ORG-ORG-ORG-ORG,LOC,PROPN-PROPN-ADP-PROPN-PROPN,PROPN,compound-pobj-prep-compound-pobj,pobj,NNP-NNP-IN-NNP-NNP,NNP,8,1
1,3.0,59,considered,2,51,4,-47,50,54,-49,2,Houlton,the United States,LOC,LOC-LOC-LOC,PROPN,DET-PROPN-PROPN,pobj,det-compound-pobj,NNP,DT-NNP-NNP,12,1
2,3.0,59,considered,2,53,4,-49,52,54,-51,2,Maine,the United States,LOC,LOC-LOC-LOC,PROPN,DET-PROPN-PROPN,appos,det-compound-pobj,NNP,DT-NNP-NNP,14,1
0,0.0,20,is,10,1,5,4,0,14,9,-5,Predrag Jokić,3 February 1983,PER-PER,TIME-TIME-TIME,PROPN-PROPN,NUM-PROPN-NUM,compound-nsubj,nummod-npadvmod-nummod,NNP-NNP,CD-NNP-CD,2,1
1,0.0,20,is,10,1,9,8,0,10,9,-1,Predrag Jokić,Kotor,PER-PER,LOC,PROPN-PROPN,PROPN,compound-nsubj,pobj,NNP-NNP,NNP,1,1
0,1.0,16,was,3,5,11,6,4,4,-2,8,Frank MacKay,Independence Party of New York,PER-PER,ORG-ORG-ORG-ORG-ORG,PROPN-PROPN,PROPN-PROPN-ADP-PROPN-PROPN,compound-attr,compound-pobj-prep-compound-pobj,NNP-NNP,NNP-NNP-IN-NNP-NNP,3,1
1,2.0,26,agreed,15,1,6,5,0,19,14,-9,Dean Barkley,United States,PER-PER,LOC-LOC,PROPN-PROPN,PROPN-PROPN,compound-nsubj,nmod-nmod,NNP-NNP,NNP-NNP,3,1
2,2.0,26,agreed,15,1,10,9,0,15,14,-5,Dean Barkley,Independence Party of Minnesota,PER-PER,ORG-ORG-ORG-ORG,PROPN-PROPN,PROPN-PROPN-ADP-PROPN,compound-nsubj,conj-nmod-prep-pobj,NNP-NNP,NNP-NNP-IN-NNP,1,1
0,0.0,18,is,8,13,16,3,12,1,-5,8,Uva Province,Sri Lanka,LOC-LOC,LOC-LOC,PROPN-PROPN,PROPN-PROPN,compound-pobj,compound-appos,NNP-NNP,NNP-NNP,1,1
0,0.0,15,is,2,1,12,11,0,2,1,10,Forgotten Freshness,Insane Clown Posse,MISC-MISC,ORG-ORG-ORG,ADJ-PROPN,PROPN-PROPN-PROPN,compound-nsubj,compound-compound-appos,JJ-NNP,NNP-NNP-NNP,6,1
1,4.0,38,Zone,2,2,7,5,1,30,0,5,Ghetto Zone,Life At Risk,MISC-MISC,MISC-MISC-MISC,PROPN-PROPN,PROPN-ADP-PROPN,compound-ROOT,conj-prep-pobj,NNP-NNP,NNP-IN-NNP,2,1
0,0.0,24,was,12,1,5,4,0,18,11,-7,William Wilkie Collins,8 January 1824,PER-PER-PER,TIME-TIME-TIME,PROPN-PROPN-PROPN,NUM-PROPN-NUM,compound-compound-nsubj,nummod-appos-nummod,NNP-NNP-NNP,CD-NNP-CD,2,1
1,0.0,24,was,12,1,9,8,0,14,11,-3,William Wilkie Collins,23 September 1889,PER-PER-PER,TIME-TIME-TIME,PROPN-PROPN-PROPN,NUM-PROPN-NUM,compound-compound-nsubj,nummod-npadvmod-nummod,NNP-NNP-NNP,CD-NNP-CD,3,1
2,11.0,44,split,13,1,35,34,0,8,12,22,Collins,Martha Rudd,PER,PER-PER,NOUN,PROPN-PROPN,nsubj,compound-appos,NNS,NNP-NNP,3,1
0,0.0,28,is,12,22,24,2,21,3,-10,12,Nagoya,Aichi,LOC,LOC,PROPN,PROPN,pobj,compound,NNP,NNP,5,1
0,1.0,37,founded,2,1,9,8,0,27,1,7,RSC,Pranab Mukherjee,ORG,PER-PER,PROPN,PROPN-PROPN,nsubjpass,compound-pobj,NNP,NNP-NNP,3,1
1,1.0,37,founded,2,1,17,16,0,19,1,15,RSC,India,ORG,LOC,PROPN,PROPN,nsubjpass,pobj,NNP,NNP,2,1
2,2.0,14,was,1,13,5,-8,12,8,-12,4,India,Rajiv Gandhi,LOC,PER-PER,PROPN,PROPN-PROPN,pobj,compound-pobj,NNP,NNP-NNP,3,1
0,0.0,14,is,1,1,6,5,0,7,0,5,Soknedal,Midtre Gauldal,LOC,LOC-LOC,PROPN,PROPN-PROPN,nsubj,compound-compound,NNP,NNP-NNP,4,1
1,0.0,14,is,1,1,13,12,0,0,0,12,Soknedal,Norway,LOC,LOC,PROPN,PROPN,nsubj,appos,NNP,NNP,1,1
2,0.0,14,is,1,6,10,4,5,3,-5,9,Midtre Gauldal,Trøndelag,LOC-LOC,LOC,PROPN-PROPN,PROPN,compound-compound,compound,NNP-NNP,NNP,3,1
3,0.0,14,is,1,6,13,7,5,0,-5,12,Midtre Gauldal,Norway,LOC-LOC,LOC,PROPN-PROPN,PROPN,compound-compound,appos,NNP-NNP,NNP,5,1
4,0.0,14,is,1,10,13,3,9,0,-9,12,Trøndelag,Norway,LOC,LOC,PROPN,PROPN,compound,appos,NNP,NNP,6,1
5,1.0,18,located,3,8,17,9,7,0,-5,14,Sokna,Gaula,LOC,LOC,PROPN,PROPN,appos,appos,NNP,NNP,5,1
0,5.0,21,is,4,2,13,11,1,7,2,9,Pakistan,Khyber Pakhtunkhwa,LOC,LOC-LOC,PROPN,PROPN-PROPN,pobj,compound-pobj,NNP,NNP-NNP,6,1
1,5.0,21,is,4,2,20,18,1,0,2,16,Pakistan,Balochistan,LOC,LOC,PROPN,PROPN,pobj,pobj,NNP,NNP,2,1
2,8.0,22,belongs,1,1,5,4,0,16,0,4,Pashto,Northeastern Iranian,MISC,LOC-LOC,PROPN,PROPN-ADJ,nsubj,amod-amod,NNP,NNP-JJ,3,1
3,8.0,22,belongs,1,1,20,19,0,1,0,19,Pashto,Southeastern Iranian,MISC,LOC-LOC,PROPN,PROPN-PROPN,nsubj,compound-pobj,NNP,NNP-NNP,3,1
0,0.0,44,was,15,1,6,5,0,37,14,-9,William Ruben Rowley,"February 8 , 1824",PER-PER-PER,TIME-TIME-TIME-TIME,PROPN-PROPN-PROPN,PROPN-NUM-PUNCT-NUM,compound-compound-nsubj,appos-nummod-punct-npadvmod,NNP-NNP-NNP,"NNP-CD-,-CD",3,1
1,0.0,44,was,15,1,6,5,0,37,14,-9,William Ruben Rowley,"February 9 , 1886",PER-PER-PER,TIME-TIME-TIME-TIME,PROPN-PROPN-PROPN,PROPN-NUM-PUNCT-NUM,compound-compound-nsubj,appos-nummod-punct-nummod,NNP-NNP-NNP,"NNP-CD-,-CD",3,1
2,0.0,44,was,15,29,34,5,28,9,-14,19,Ulysses S. Grant,American Civil War,PER-PER-PER,MISC-MISC-MISC,PROPN-PROPN-PROPN,PROPN-PROPN-PROPN,compound-compound-pobj,compound-compound-pobj,NNP-NNP-NNP,NNP-NNP-NNP,6,1
0,1.0,34,premiered,1,8,12,4,7,21,-7,11,Teatro San Carlo,Naples,LOC-LOC-LOC,LOC,PROPN-PROPN-PROPN,PROPN,compound-compound-pobj,pobj,NNP-NNP-NNP,NNP,4,1
1,3.0,30,influenced,4,19,25,6,18,4,-15,21,Karl Bryullov,The Last Day of Pompeii,PER-PER,MISC-MISC-MISC-MISC-MISC,PROPN-PROPN,DET-ADJ-PROPN-ADP-PROPN,compound-poss,det-amod-appos-prep-pobj,NNP-NNP,DT-JJ-NNP-IN-NNP,4,1
0,0.0,39,was,11,1,4,3,0,34,10,-7,Edith Williams,24 June 1899,PER-PER,TIME-TIME-TIME,PROPN-PROPN,NUM-PROPN-NUM,compound-nsubj,nummod-appos-nummod,NNP-NNP,CD-NNP-CD,1,1
1,0.0,39,was,11,1,4,3,0,34,10,-7,Edith Williams,24 November 1979,PER-PER,TIME-TIME-TIME,PROPN-PROPN,NUM-PROPN-NUM,compound-nsubj,nummod-appos-nummod,NNP-NNP,CD-NNP-CD,1,1
0,0.0,26,is,2,1,25,24,0,0,1,23,Outotec Oyj,2006,ORG-ORG,TIME,PROPN-PROPN,NUM,compound-nsubj,pobj,NNP-NNP,CD,2,1
0,0.0,26,is,3,2,10,8,1,15,1,7,Center Hall,the United States,LOC-LOC,LOC-LOC-LOC,PROPN-PROPN,DET-PROPN-PROPN,compound-nsubj,det-compound-pobj,NNP-NNP,DT-NNP-NNP,5,1
1,0.0,26,is,3,15,10,-5,14,15,-12,7,White House,the United States,LOC-LOC,LOC-LOC-LOC,PROPN-PROPN,DET-PROPN-PROPN,compound-pobj,det-compound-pobj,NNP-NNP,DT-NNP-NNP,3,1
0,3.0,21,contained,3,20,18,-2,19,2,-17,15,Redbird,2005,MISC,TIME,PROPN,NUM,appos,nummod,NNP,CD,5,1
0,0.0,18,was,13,1,8,7,0,9,12,-5,Alfred Louis Olivier Legrand Des Cloizeaux,17 October 18176 May 1897,PER-PER-PER-PER-PER-PER,TIME-TIME-TIME-TIME-TIME,PROPN-PROPN-PROPN-PROPN-PROPN-PROPN,NUM-PROPN-NUM-PROPN-NUM,compound-compound-compound-compound-compound-nsubj,nummod-appos-nummod-appos-nummod,NNP-NNP-NNP-NNP-NNP-NNP,CD-NNP-CD-NNP-CD,3,1
1,1.0,13,born,3,1,6,5,0,6,2,3,Des Cloizeaux,Beauvais,PER-PER,LOC,PROPN-PROPN,PROPN,compound-nsubjpass,pobj,NNP-NNP,NNP,2,1
2,1.0,13,born,3,6,12,6,5,0,-3,9,Beauvais,Oise,LOC,LOC,PROPN,PROPN,pobj,pobj,NNP,NNP,2,1
3,3.0,21,became,1,8,20,12,7,0,-7,19,École Normale Supérieure,Paris,ORG-ORG-ORG,LOC,PROPN-PROPN-PROPN,PROPN,compound-compound-pobj,pobj,NNP-NNP-NNP,NNP,5,1
4,3.0,21,became,1,15,20,5,14,0,-14,19,Muséum National d'Histoire Naturelle,Paris,ORG-ORG-ORG-ORG,LOC,PROPN-PROPN-PROPN-PROPN,PROPN,compound-compound-compound-pobj,pobj,NNP-NNP-NNP-NNP,NNP,4,1
5,8.0,28,named,1,23,26,3,22,1,-22,25,Christian VIII,Denmark,PER-PER,LOC,ADJ-PROPN,PROPN,compound-pobj,pobj,JJ-NNP,NNP,6,1
6,10.0,23,elected,3,1,10,9,0,12,2,7,Des Cloizeaux,French Academy of Sciences,PER-PER,ORG-ORG-ORG-ORG,PROPN-PROPN,PROPN-PROPN-ADP-PROPN,compound-nsubjpass,compound-pobj-prep-pobj,NNP-NNP,NNP-NNP-IN-NNPS,5,1
0,0.0,29,is,4,18,28,10,17,0,-14,24,Bolshaya Neva,Russia,LOC-LOC,LOC,PROPN-PROPN,PROPN,compound-pobj,appos,NNP-NNP,NNP,6,1
1,0.0,29,is,4,25,28,3,24,0,-21,24,Saint Petersburg,Russia,LOC-LOC,LOC,PROPN-PROPN,PROPN,compound-pobj,appos,NNP-NNP,NNP,5,1
0,0.0,36,"""",0,2,12,10,1,23,-2,12,We Lost the Road,Bee Gees,MISC-MISC-MISC-MISC,ORG-ORG,PRON-VERB-DET-NOUN,PROPN-PROPN,nsubj-ccomp-det-dobj,compound-pobj,PRP-VBD-DT-NN,NNP-NNPS,4,1
0,0.0,24,is,2,1,15,14,0,8,1,13,Cape Bonavista,Newfoundland,LOC-LOC,LOC,PROPN-PROPN,PROPN,compound-nsubj,pobj,NNP-NNP,NNP,8,1
1,0.0,24,is,2,1,18,17,0,5,1,16,Cape Bonavista,Canadian,LOC-LOC,LOC,PROPN-PROPN,ADJ,compound-nsubj,amod,NNP-NNP,JJ,9,1
2,0.0,24,is,2,1,15,14,0,8,1,13,Cape Bonavista,Newfoundland and Labrador,LOC-LOC,LOC-LOC-LOC,PROPN-PROPN,PROPN-CCONJ-PROPN,compound-nsubj,pobj-cc-conj,NNP-NNP,NNP-CC-NNP,8,1
3,0.0,24,is,2,18,15,-3,17,8,-16,13,Canadian,Newfoundland and Labrador,LOC,LOC-LOC-LOC,ADJ,PROPN-CCONJ-PROPN,amod,pobj-cc-conj,JJ,NNP-CC-NNP,1,1
0,0.0,17,is,5,2,15,13,1,1,3,10,Grooves & Gravy Tour,ZZ Top,MISC-MISC-MISC-MISC,ORG-ORG,PROPN-CCONJ-PROPN-PROPN,PROPN-PROPN,nsubj-cc-compound-conj,compound-pobj,NNPS-CC-NNP-NNP,NNP-NNP,5,1
1,1.0,20,was,10,3,15,12,2,4,7,5,ZZ Top,Southern Rock,ORG-ORG,MISC-MISC,PROPN-NOUN,PROPN-PROPN,compound-pobj,compound-compound,NNP-NN,NNP-NNP,5,1
2,3.0,23,"""",0,18,21,3,17,1,-18,21,ZZ Top,Billy Gibbons,ORG-ORG,PER-PER,PROPN-PROPN,PROPN-PROPN,compound-amod,compound-nsubj,NNP-NNP,NNP-NNPS,2,1
0,0.0,58,is,12,1,53,52,0,4,11,41,Ocean County,New Jersey,LOC-LOC,LOC-LOC,PROPN-PROPN,PROPN-PROPN,compound-pobj,compound-conj,NNP-NNP,NNP-NNP,12,1
1,0.0,58,is,12,1,56,55,0,1,11,44,Ocean County,United States,LOC-LOC,LOC-LOC,PROPN-PROPN,PROPN-PROPN,compound-pobj,compound-conj,NNP-NNP,NNP-NNP,12,1
2,0.0,58,is,12,53,56,3,52,1,-41,44,New Jersey,United States,LOC-LOC,LOC-LOC,PROPN-PROPN,PROPN-PROPN,compound-conj,compound-conj,NNP-NNP,NNP-NNP,2,1
0,0.0,9,are,3,2,8,6,1,0,1,5,Arikaree Breaks,Kansas,LOC-LOC,LOC,PROPN-PROPN,PROPN,compound-nsubj,pobj,NNP-NNPS,NNP,2,1
1,2.0,21,extend,2,20,17,-3,19,3,-18,15,Colorado,Yuma County,LOC,LOC-LOC,PROPN,PROPN-PROPN,appos,compound-pobj,NNP,NNP-NNP,4,1
0,1.0,64,chartered,3,29,33,4,28,30,-26,30,Anthony John Stastny,1885,PER-PER-PER,TIME,PROPN-PROPN-PROPN,NUM,compound-compound-appos,nummod,NNP-NNP-NNP,CD,2,1
1,1.0,64,chartered,3,29,35,6,28,28,-26,32,Anthony John Stastny,1923,PER-PER-PER,TIME,PROPN-PROPN-PROPN,NUM,compound-compound-appos,nummod,NNP-NNP-NNP,CD,2,1
2,5.0,23,held,5,15,21,6,14,1,-10,16,Green Grove Avenue,New Jersey,LOC-LOC-LOC,LOC-LOC,PROPN-PROPN-PROPN,PROPN-PROPN,compound-compound-npadvmod,compound-appos,NNP-NNP-NNP,NNP-NNP,3,1
0,0.0,13,is,1,6,9,3,5,3,-5,8,Rennesøy,Rogaland county,LOC,LOC-LOC,PROPN,PROPN-NOUN,compound,compound-pobj,NNP,NNP-NN,2,1
1,0.0,13,is,1,6,12,6,5,0,-5,11,Rennesøy,Norway,LOC,LOC,PROPN,PROPN,compound,appos,NNP,NNP,4,1
2,0.0,13,is,1,9,12,3,8,0,-8,11,Rogaland county,Norway,LOC-LOC,LOC,PROPN-NOUN,PROPN,compound-pobj,appos,NNP-NN,NNP,6,1
0,0.0,27,is,10,17,19,2,16,7,-7,9,Salvador,Bahia,LOC,LOC,PROPN,PROPN,pobj,pobj,NNP,NNP,2,1
0,0.0,23,was,13,7,9,2,6,13,6,-4,Turku,Sweden,LOC,LOC,PROPN,PROPN,pobj,npadvmod,NNP,NNP,4,1
0,0.0,24,is,1,1,10,9,0,13,0,9,Ryczów,Gmina Spytkowice,LOC,LOC-LOC,PROPN,PROPN-PROPN,nsubj,compound-pobj,NNP,NNP-NNP,5,1
1,0.0,24,is,1,1,18,17,0,5,0,17,Ryczów,Poland,LOC,LOC,PROPN,PROPN,nsubj,pobj,NNP,NNP,1,1
2,0.0,24,is,1,10,14,4,9,9,-9,13,Gmina Spytkowice,Wadowice County,LOC-LOC,LOC-LOC,PROPN-PROPN,PROPN-PROPN,compound-pobj,compound-pobj,NNP-NNP,NNP-NNP,7,1
3,0.0,24,is,1,10,17,7,9,6,-9,16,Gmina Spytkowice,Lesser Poland Voivodeship,LOC-LOC,LOC-LOC-LOC,PROPN-PROPN,PROPN-PROPN-PROPN,compound-pobj,compound-compound-appos,NNP-NNP,NNP-NNP-NNP,7,1
4,0.0,24,is,1,10,18,8,9,5,-9,17,Gmina Spytkowice,Poland,LOC-LOC,LOC,PROPN-PROPN,PROPN,compound-pobj,pobj,NNP-NNP,NNP,6,1
5,0.0,24,is,1,14,17,3,13,6,-13,16,Wadowice County,Lesser Poland Voivodeship,LOC-LOC,LOC-LOC-LOC,PROPN-PROPN,PROPN-PROPN-PROPN,compound-pobj,compound-compound-appos,NNP-NNP,NNP-NNP-NNP,4,1
6,0.0,24,is,1,14,18,4,13,5,-13,17,Wadowice County,Poland,LOC-LOC,LOC,PROPN-PROPN,PROPN,compound-pobj,pobj,NNP-NNP,NNP,3,1
7,0.0,24,is,1,17,18,1,16,5,-16,17,Lesser Poland Voivodeship,Poland,LOC-LOC-LOC,LOC,PROPN-PROPN-PROPN,PROPN,compound-compound-appos,pobj,NNP-NNP-NNP,NNP,1,1
0,2.0,45,came,3,30,33,3,29,11,-27,30,The Chaser,2008,MISC-MISC,TIME,DET-PROPN,NUM,det-dobj,appos,DT-NNP,CD,1,1
1,3.0,66,become,3,27,47,20,26,18,-24,44,Sea Fog,2014,MISC-MISC,TIME,PROPN-PROPN,NUM,compound-conj,appos,NNP-NNP,CD,4,1
2,3.0,66,become,3,19,22,3,18,43,-16,19,Running Turtle,2009,MISC-MISC,TIME,PROPN-PROPN,NUM,compound-pobj,appos,NNP-NNP,CD,1,1
0,0.0,43,was,10,1,7,6,0,35,9,-3,Robert Humpston VC,22 December 1884,PER-PER-PER,TIME-TIME-TIME,PROPN-PROPN-PROPN,NUM-PROPN-NUM,compound-compound-nsubj,nummod-npadvmod-nummod,NNP-NNP-NNP,CD-NNP-CD,2,1
1,1.0,45,was,1,26,30,4,25,14,-25,29,British Army,Crimean War,ORG-ORG,MISC-MISC,ADJ-PROPN,PROPN-PROPN,compound-appos,compound-pobj,JJ-NNP,NNP-NNP,2,1
2,4.0,19,displayed,4,16,18,2,15,0,-12,14,Winchester,England,LOC,LOC,PROPN,PROPN,pobj,pobj,NNP,NNP,4,1
3,5.0,15,buried,8,6,5,-1,5,9,2,-3,Robert Humpston,1884,PER-PER,TIME,PROPN-PROPN,NUM,compound-pobj,pobj,NNP-NNP,CD,1,1
0,0.0,23,is,6,12,19,7,11,3,-6,13,North Fork John Day River,U.S.,LOC-LOC-LOC-LOC-LOC,LOC,PROPN-PROPN-PROPN-PROPN-PROPN,PROPN,compound-compound-compound-compound-pobj,compound,NNP-NNP-NNP-NNP-NNP,NNP,3,1
1,0.0,23,is,6,12,22,10,11,0,-6,16,North Fork John Day River,Oregon,LOC-LOC-LOC-LOC-LOC,LOC,PROPN-PROPN-PROPN-PROPN-PROPN,PROPN,compound-compound-compound-compound-pobj,pobj,NNP-NNP-NNP-NNP-NNP,NNP,5,1
2,0.0,23,is,6,19,22,3,18,0,-13,16,U.S.,Oregon,LOC,LOC,PROPN,PROPN,compound,pobj,NNP,NNP,6,1
0,0.0,52,spelled,7,23,30,7,22,21,-16,23,School of Oriental and African Studies,University of London,ORG-ORG-ORG-ORG-ORG-ORG,ORG-ORG-ORG,PROPN-ADP-ADJ-CCONJ-PROPN-PROPN,PROPN-ADP-PROPN,pobj-prep-amod-cc-conj-pobj,appos-prep-pobj,NNP-IN-JJ-CC-NNP-NNPS,NNP-IN-NNP,3,1
0,0.0,45,Challenges,3,27,42,15,26,2,-24,39,Mohammed bin Rashid Al Maktoum,United Arab Emirates,PER-PER-PER-PER-PER,LOC-LOC-LOC,PROPN-PROPN-PROPN-PROPN-PROPN,PROPN-PROPN-PROPN,compound-compound-compound-compound-pobj,compound-compound-pobj,NNP-NNP-NNP-NNP-NNP,NNP-NNP-NNPS,7,1
0,0.0,26,is,14,1,17,16,0,8,13,3,Bicycle Thieves,1948,MISC-MISC,TIME,PROPN-PROPN,NUM,compound-compound,nummod,NNP-NNPS,CD,-1,1
1,0.0,26,is,14,1,23,22,0,2,13,9,Bicycle Thieves,Vittorio De Sica,MISC-MISC,PER-PER-PER,PROPN-PROPN,PROPN-PROPN-PROPN,compound-compound,compound-compound-pobj,NNP-NNPS,NNP-NNP-NNP,-1,1
2,0.0,26,is,14,11,17,6,10,8,3,3,The Bicycle Thief,1948,MISC-MISC-MISC,TIME,DET-PROPN-PROPN,NUM,det-compound-pobj,nummod,DT-NNP-NNP,CD,-1,1
3,0.0,26,is,14,11,23,12,10,2,3,9,The Bicycle Thief,Vittorio De Sica,MISC-MISC-MISC,PER-PER-PER,DET-PROPN-PROPN,PROPN-PROPN-PROPN,det-compound-pobj,compound-compound-pobj,DT-NNP-NNP,NNP-NNP-NNP,-1,1
4,2.0,43,regarded,35,32,17,-15,31,25,3,-18,Bicycle Thieves,Lamberto Maggiorani,MISC-MISC,PER-PER,PROPN-PROPN,PROPN-PROPN,compound-nsubjpass,compound-dobj,NNP-NNPS,NNP-NNP,4,1
5,2.0,43,regarded,35,32,24,-8,31,18,3,-11,Bicycle Thieves,Enzo Staiola,MISC-MISC,PER-PER,PROPN-PROPN,PROPN-PROPN,compound-nsubjpass,compound-conj,NNP-NNPS,NNP-NNP,7,1
6,2.0,43,regarded,35,32,6,-26,31,36,3,-29,Bicycle Thieves,Cesare Zavattini,MISC-MISC,PER-PER,PROPN-PROPN,PROPN-PROPN,compound-nsubjpass,compound-pobj,NNP-NNPS,NNP-NNP,4,1
0,0.0,15,is,4,1,14,13,0,0,3,10,Kunlun Station,Antarctica,LOC-LOC,LOC,PROPN-PROPN,PROPN,compound-nsubj,pobj,NNP-NNP,NNP,2,1
1,3.0,24,located,2,12,23,11,11,0,-10,21,East Antarctic Ice Sheet,Antarctica,LOC-LOC-LOC-LOC,LOC,PROPN-PROPN-PROPN-PROPN,PROPN,compound-compound-compound-pobj,pobj,NNP-NNP-NNP-NNP,NNP,6,1
2,10.0,19,installed,14,17,8,-9,16,10,-3,-6,Kunlun Station,Antarctica Schmidt telescopes,LOC-LOC,MISC-MISC-MISC,PROPN-PROPN,PROPN-PROPN-NOUN,compound-pobj,compound-compound-pobj,NNP-NNP,NNP-NNP-NNS,6,1
0,0.0,19,is,2,1,14,13,0,4,1,12,Sandy Hook,New Jersey,LOC-LOC,LOC-LOC,PROPN-PROPN,PROPN-PROPN,compound-nsubj,compound-conj,NNP-NNP,NNP-NNP,6,1
1,0.0,19,is,2,1,17,16,0,1,1,15,Sandy Hook,United States,LOC-LOC,LOC-LOC,PROPN-PROPN,PROPN-PROPN,compound-nsubj,compound-conj,NNP-NNP,NNP-NNP,5,1
2,0.0,19,is,2,8,11,3,7,7,-6,9,Middletown Township,Monmouth County,LOC-LOC,LOC-LOC,PROPN-PROPN,PROPN-PROPN,compound-pobj,compound-conj,NNP-NNP,NNP-NNP,1,1
3,0.0,19,is,2,8,17,9,7,1,-6,15,Middletown Township,United States,LOC-LOC,LOC-LOC,PROPN-PROPN,PROPN-PROPN,compound-pobj,compound-conj,NNP-NNP,NNP-NNP,1,1
4,0.0,19,is,2,11,14,3,10,4,-9,12,Monmouth County,New Jersey,LOC-LOC,LOC-LOC,PROPN-PROPN,PROPN-PROPN,compound-conj,compound-conj,NNP-NNP,NNP-NNP,1,1
5,0.0,19,is,2,11,17,6,10,1,-9,15,Monmouth County,United States,LOC-LOC,LOC-LOC,PROPN-PROPN,PROPN-PROPN,compound-conj,compound-conj,NNP-NNP,NNP-NNP,2,1
6,0.0,19,is,2,14,17,3,13,1,-12,15,New Jersey,United States,LOC-LOC,LOC-LOC,PROPN-PROPN,PROPN-PROPN,compound-conj,compound-conj,NNP-NNP,NNP-NNP,3,1
7,2.0,30,encloses,1,7,25,18,6,4,-6,24,Lower New York Bay,Atlantic Ocean,LOC-LOC-LOC-LOC,LOC-LOC,PROPN-PROPN-PROPN-PROPN,PROPN-PROPN,compound-compound-compound-pobj,compound-pobj,NNP-NNP-NNP-NNP,NNP-NNP,10,1
8,2.0,30,encloses,1,8,25,17,7,4,-7,24,New York City,Atlantic Ocean,LOC-LOC-LOC,LOC-LOC,PROPN-PROPN-PROPN,PROPN-PROPN,compound-compound-pobj,compound-pobj,NNP-NNP-NNP,NNP-NNP,9,1
0,0.0,41,was,12,1,5,4,0,35,11,-7,Hans Achim Litten,19 June 1903,PER-PER-PER,TIME-TIME-TIME,PROPN-PROPN-PROPN,NUM-PROPN-NUM,compound-compound-nsubj,nummod-nmod-nummod,NNP-NNP-NNP,CD-NNP-CD,2,1
1,0.0,41,was,12,1,9,8,0,31,11,-3,Hans Achim Litten,5 February 1938,PER-PER-PER,TIME-TIME-TIME,PROPN-PROPN-PROPN,NUM-PROPN-NUM,compound-compound-nsubj,nummod-appos-nummod,NNP-NNP-NNP,CD-NNP-CD,2,1
2,0.0,41,was,12,1,39,38,0,1,11,27,Hans Achim Litten,Weimar Republic,PER-PER-PER,LOC-LOC,PROPN-PROPN-PROPN,PROPN-PROPN,compound-compound-nsubj,compound-pobj,NNP-NNP-NNP,NNP-NNP,6,1
3,7.0,32,portrayed,6,17,28,11,16,3,-11,22,The Man Who Crossed Hitler,Berlin,MISC-MISC-MISC-MISC-MISC,LOC,DET-PROPN-PRON-PROPN-PROPN,PROPN,det-dobj-dep-compound-ROOT,pobj,DT-NNP-WP-NNP-NNP,NNP,5,1
0,0.0,35,is,15,12,14,2,11,20,3,-1,Brussels,Belgium,LOC,LOC,PROPN,PROPN,pobj,appos,NNP,NNP,2,1
0,0.0,15,is,4,1,7,6,0,7,3,3,Francesco 's Mediterranean Voyage,BBC Television,MISC-MISC-MISC-MISC,ORG-ORG,PROPN-PART-PROPN-PROPN,PROPN-PROPN,poss-case-compound-nsubj,compound-compound,NNP-POS-NNP-NNP,NNP-NNP,5,1
0,0.0,39,Adams,5,1,8,7,0,30,4,3,"Marian "" Clover "" Hooper Adams","September 13 , 1843",PER-PER-PER-PER-PER-PER,TIME-TIME-TIME-TIME,ADJ-PUNCT-PROPN-PUNCT-PROPN-PROPN,PROPN-NUM-PUNCT-NUM,amod-punct-nmod-punct-compound-ROOT,appos-nummod-punct-nummod,JJ-``-NNP-``-NNP-NNP,"NNP-CD-,-CD",3,1
1,0.0,39,Adams,5,1,13,12,0,25,4,8,"Marian "" Clover "" Hooper Adams","December 6 , 1885",PER-PER-PER-PER-PER-PER,TIME-TIME-TIME-TIME,ADJ-PUNCT-PROPN-PUNCT-PROPN-PROPN,PROPN-NUM-PUNCT-NUM,amod-punct-nmod-punct-compound-ROOT,nsubj-nummod-punct-nummod,JJ-``-NNP-``-NNP-NNP,"NNP-CD-,-CD",3,1
2,1.0,36,was,29,1,12,11,0,23,28,-17,Clover,Henry Adams,PER,PER-PER,PROPN,PROPN-PROPN,nsubj,compound-dobj,NNP,NNP-NNP,7,1
3,1.0,36,was,29,12,15,3,11,20,17,-14,Henry James,Daisy Miller,PER-PER,MISC-MISC,PROPN-PROPN,PROPN-PROPN,compound-poss,compound-pobj,NNP-NNP,NNP-NNP,1,1
4,1.0,36,was,29,12,21,9,11,14,17,-8,Henry James,The Portrait of a Lady,PER-PER,MISC-MISC-MISC-MISC-MISC,PROPN-PROPN,DET-PROPN-ADP-DET-PROPN,compound-poss,det-conj-prep-det-pobj,NNP-NNP,DT-NNP-IN-DT-NNP,4,1
5,1.0,36,was,29,21,27,6,20,8,8,-2,The Portrait of a Lady,1881,MISC-MISC-MISC-MISC-MISC,TIME,DET-PROPN-ADP-DET-PROPN,NUM,det-conj-prep-det-pobj,appos,DT-NNP-IN-DT-NNP,CD,1,1
0,3.0,20,is,1,17,10,-7,16,9,-16,9,Umkhonto we Sizwe,African National Congress,ORG-ORG-ORG,ORG-ORG-ORG,PROPN-PRON-PROPN,PROPN-PROPN-PROPN,compound-compound-appos,compound-compound-pobj,NNP-PRP-NNP,NNP-NNP-NNP,4,1
0,0.0,16,was,11,1,4,3,0,11,10,-7,Brian Warsop,12 January 1904,PER-PER,TIME-TIME-TIME,PROPN-PROPN,NUM-PROPN-NUM,compound-nsubj,nummod-appos-nummod,NNP-NNP,CD-NNP-CD,1,1
1,7.0,11,died,1,4,6,2,3,4,-3,5,Melbourne,Australia,LOC,LOC,PROPN,PROPN,nmod,pobj,NNP,NNP,3,1
0,0.0,32,is,4,2,27,25,1,4,2,23,Paulsboro Public Schools,New Jersey,LOC-LOC-LOC,LOC-LOC,PROPN-PROPN-PROPN,PROPN-PROPN,compound-compound-nsubj,compound-conj,NNP-NNP-NNPS,NNP-NNP,7,1
1,0.0,32,is,4,2,30,28,1,1,2,26,Paulsboro Public Schools,United States,LOC-LOC-LOC,LOC-LOC,PROPN-PROPN-PROPN,PROPN-PROPN,compound-compound-nsubj,compound-appos,NNP-NNP-NNPS,NNP-NNP,7,1
2,0.0,32,is,4,2,24,22,1,7,2,20,Paulsboro,Gloucester County,LOC,LOC-LOC,PROPN,PROPN-PROPN,pobj,compound-pobj,NNP,NNP-NNP,6,1
3,0.0,32,is,4,2,30,28,1,1,2,26,Paulsboro,United States,LOC,LOC-LOC,PROPN,PROPN-PROPN,pobj,compound-appos,NNP,NNP-NNP,7,1
4,0.0,32,is,4,24,27,3,23,4,-20,23,Gloucester County,New Jersey,LOC-LOC,LOC-LOC,PROPN-PROPN,PROPN-PROPN,compound-pobj,compound-conj,NNP-NNP,NNP-NNP,1,1
5,0.0,32,is,4,24,30,6,23,1,-20,26,Gloucester County,United States,LOC-LOC,LOC-LOC,PROPN-PROPN,PROPN-PROPN,compound-pobj,compound-appos,NNP-NNP,NNP-NNP,1,1
6,0.0,32,is,4,27,30,3,26,1,-23,26,New Jersey,United States,LOC-LOC,LOC-LOC,PROPN-PROPN,PROPN-PROPN,compound-conj,compound-appos,NNP-NNP,NNP-NNP,2,1
0,2.0,19,continues,1,15,18,3,14,0,-14,17,Christopher Nolan,Interstellar,PER-PER,MISC,PROPN-PROPN,PROPN,compound-compound,pobj,NNP-NNP,NNP,5,1
1,3.0,35,awarded,5,4,8,4,3,26,1,3,Thorne,Nobel Prize in Physics,PER,MISC-MISC-MISC-MISC,PROPN,PROPN-PROPN-ADP-PROPN,nsubjpass,compound-dobj-prep-pobj,NNP,NNP-NNP-IN-NNP,2,1
0,0.0,19,is,8,2,18,16,1,0,6,10,Hanau - Gelnhausen high - speed railway,Germany,LOC-LOC-LOC-LOC-LOC-LOC-LOC,LOC,PROPN-PUNCT-PROPN-ADJ-PUNCT-NOUN-NOUN,PROPN,npadvmod-punct-amod-amod-punct-compound-nsubj,pobj,NNP-HYPH-NNP-JJ-HYPH-NN-NN,NNP,4,1
1,0.0,19,is,8,2,18,16,1,0,6,10,Hanau,Germany,LOC,LOC,PROPN,PROPN,attr,pobj,NNP,NNP,4,1
2,0.0,19,is,8,4,18,14,3,0,4,10,Gelnhausen,Germany,LOC,LOC,PROPN,PROPN,conj,pobj,NNP,NNP,4,1
0,0.0,22,is,11,5,8,3,4,13,6,-3,Islay,County of Argyll,LOC,LOC-LOC-LOC,PROPN,PROPN-ADP-PROPN,pobj,pobj-prep-pobj,NNP,NNP-IN-NNP,2,1
1,11.0,24,were,19,4,22,18,3,1,15,3,Charles Morrison,Conservative,PER-PER,ORG,PROPN-PROPN,ADJ,compound-nsubj,amod,NNP-NNP,JJ,2,1
2,11.0,24,were,19,10,22,12,9,1,9,3,Peter Morrison,Conservative,PER-PER,ORG,PROPN-PROPN,ADJ,compound-conj,amod,NNP-NNP,JJ,3,1
0,0.0,67,is,3,2,13,11,1,53,1,10,Nicholas Rush,Metro - Goldwyn - Mayer - Syfy,PER-PER,MISC-MISC-MISC-MISC-MISC-MISC-MISC,PROPN-PROPN,PROPN-PUNCT-PROPN-PUNCT-PROPN-PUNCT-PROPN,compound-nsubj,compound-punct-compound-punct-compound-punct-compound,NNP-NNP,NNP-HYPH-NNP-HYPH-NNP-HYPH-NNP,6,1
0,1.0,42,were,21,2,4,2,1,37,19,-17,Henry,1553,PER,TIME,PROPN,NUM,nsubj,nummod,NNP,CD,2,1
1,1.0,42,were,21,2,6,4,1,35,19,-15,Henry,1610,PER,TIME,PROPN,NUM,nsubj,nummod,NNP,CD,2,1
2,3.0,34,married,12,32,18,-14,31,15,-20,6,Louis XIII,Marie de ' Medici,PER-PER,PER-PER-PER-PER,PROPN-PROPN,PROPN-PROPN-PUNCT-PROPN,compound-pobj,compound-subtok-subtok-appos,NNP-NNP,NNP-NNP-''-NNP,5,1
3,8.0,33,were,8,10,16,6,9,16,-2,8,Gabrielle d'Estrées,1599,PER-PER,TIME,PROPN-PROPN,NUM,compound-attr,pobj,NNP-NNP,CD,2,1
0,4.0,45,was,3,1,32,31,0,12,2,29,Sofia 's Diary,Channel Five,MISC-MISC-MISC,ORG-ORG,PROPN-PART-PROPN,PROPN-NUM,poss-case-nsubj,compound-pobj,NNP-POS-NNP,NNP-CD,7,1
1,4.0,45,was,3,1,36,35,0,8,2,33,Sofia 's Diary,Sony Pictures Television International,MISC-MISC-MISC,ORG-ORG-ORG-ORG,PROPN-PART-PROPN,PROPN-PROPN-PROPN-PROPN,poss-case-nsubj,compound-compound-compound-pobj,NNP-POS-NNP,NNP-NNP-NNP-NNP,7,1
0,0.0,40,was,13,1,6,5,0,33,12,-7,José Rafael Carrera Turcios,24 October 1814,PER-PER-PER-PER,TIME-TIME-TIME,PROPN-PROPN-PROPN-PROPN,NUM-PROPN-NUM,compound-compound-compound-nsubj,nummod-appos-nummod,NNP-NNP-NNP-NNP,CD-NNP-CD,2,1
1,0.0,40,was,13,1,10,9,0,29,12,-3,José Rafael Carrera Turcios,14 April 1865,PER-PER-PER-PER,TIME-TIME-TIME,PROPN-PROPN-PROPN-PROPN,NUM-PROPN-NUM,compound-compound-compound-nsubj,nummod-npadvmod-nummod,NNP-NNP-NNP-NNP,CD-NNP-CD,2,1
2,0.0,40,was,13,1,18,17,0,21,12,5,José Rafael Carrera Turcios,Guatemala,PER-PER-PER-PER,LOC,PROPN-PROPN-PROPN-PROPN,PROPN,compound-compound-compound-nsubj,pobj,NNP-NNP-NNP-NNP,NNP,4,1
3,0.0,40,was,13,1,12,11,0,27,12,-1,José Rafael Carrera Turcios,1865,PER-PER-PER-PER,TIME,PROPN-PROPN-PROPN-PROPN,NUM,compound-compound-compound-nsubj,pobj,NNP-NNP-NNP-NNP,CD,2,1
4,1.0,63,facing,13,36,27,-9,35,35,-23,14,Civil War,the United States,MISC-MISC,LOC-LOC-LOC,PROPN-PROPN,DET-PROPN-PROPN,compound-conj,det-compound-pobj,NNP-NNP,DT-NNP-NNP,4,1
5,1.0,63,facing,13,49,11,-38,48,51,-36,-2,Belize,Central America,LOC,LOC-LOC,PROPN,PROPN-PROPN,conj,compound-pobj,NNP,NNP-NNP,6,1
6,6.0,33,led,1,11,14,3,10,18,-10,13,Mariano Galvez,Guatemala,PER-PER,LOC,PROPN-PROPN,PROPN,compound-pobj,pobj,NNP-NNP,NNP,6,1
0,0.0,26,was,7,6,17,11,5,8,1,10,Bjerringbro,Viborg County,LOC,LOC-LOC,PROPN,PROPN-PROPN,compound,compound-pobj,NNP,NNP-NNP,4,1
1,0.0,26,was,7,6,25,19,5,0,1,18,Bjerringbro,Denmark,LOC,LOC,PROPN,PROPN,compound,pobj,NNP,NNP,2,1
2,0.0,26,was,7,17,25,8,16,0,-10,18,Viborg County,Denmark,LOC-LOC,LOC,PROPN-PROPN,PROPN,compound-pobj,pobj,NNP-NNP,NNP,4,1
3,0.0,26,was,7,21,25,4,20,0,-14,18,Jutland,Denmark,LOC,LOC,PROPN,PROPN,compound,pobj,NNP,NNP,4,1
0,0.0,24,marked,10,4,5,1,3,18,6,-5,Galicia,Spain,LOC,LOC,PROPN,PROPN,compound,pobj,NNP,NNP,1,1
1,0.0,24,marked,10,4,23,19,3,0,6,13,Galicia,Atlantic,LOC,LOC,PROPN,PROPN,compound,pobj,NNP,NNP,4,1
2,1.0,18,was,4,2,17,15,1,0,2,13,World War II,1945,MISC-MISC-MISC,TIME,PROPN-PROPN-PROPN,NUM,compound-compound-nsubj,pobj,NNP-NNP-NNP,CD,3,1
0,0.0,10,discography,1,4,8,4,3,1,-3,7,Chief Keef,American,PER-PER,LOC,PROPN-PROPN,ADJ,compound-pobj,amod,NNP-NNP,JJ,1,1
1,1.0,39,released,2,8,11,3,7,27,-6,9,Finally Rich,2012,MISC-MISC,TIME,PROPN-PROPN,NUM,compound-appos,pobj,NNP-NNP,CD,2,1
0,0.0,21,is,7,14,17,3,13,3,-7,10,Chilton County,Alabama,LOC-LOC,LOC,PROPN-PROPN,PROPN,compound-pobj,conj,NNP-NNP,NNP,1,1
1,0.0,21,is,7,17,19,2,16,1,-10,12,Alabama,United States,LOC,LOC-LOC,PROPN,PROPN-PROPN,conj,compound-appos,NNP,NNP-NNP,2,1
0,0.0,21,Douglass,2,1,6,5,0,14,1,4,Sarah Hallam Douglass,Philadelphia,PER-PER-PER,LOC,PROPN-PROPN-PROPN,PROPN,compound-compound-ROOT,nsubj,NNP-NNP-NNP,NNP,3,1
1,0.0,21,Douglass,2,1,8,7,0,12,1,6,Sarah Hallam Douglass,1773,PER-PER-PER,TIME,PROPN-PROPN-PROPN,NUM,compound-compound-ROOT,appos,NNP-NNP-NNP,CD,3,1
2,0.0,21,Douglass,2,6,15,9,5,5,-4,13,Philadelphia,American,LOC,LOC,PROPN,ADJ,nsubj,amod,NNP,JJ,6,1
0,0.0,42,is,3,2,12,10,1,29,1,9,Big Drift,U.S.,LOC-LOC,LOC,PROPN-PROPN,PROPN,compound-nsubj,compound,NNP-NNP,NNP,3,1
1,0.0,42,is,3,2,15,13,1,26,1,12,Big Drift,Montana,LOC-LOC,LOC,PROPN-PROPN,PROPN,compound-nsubj,pobj,NNP-NNP,NNP,2,1
2,0.0,42,is,3,6,12,6,5,29,-3,9,Glacier National Park,U.S.,LOC-LOC-LOC,LOC,PROPN-PROPN-PROPN,PROPN,compound-compound-pobj,compound,NNP-NNP-NNP,NNP,5,1
3,0.0,42,is,3,6,15,9,5,26,-3,12,Glacier National Park,Montana,LOC-LOC-LOC,LOC,PROPN-PROPN-PROPN,PROPN,compound-compound-pobj,pobj,NNP-NNP-NNP,NNP,4,1
4,0.0,42,is,3,12,15,3,11,26,-9,12,U.S.,Montana,LOC,LOC,PROPN,PROPN,compound,pobj,NNP,NNP,3,1
0,0.0,20,is,7,1,10,9,0,9,6,3,Moolaadé,2004,MISC,TIME,PROPN,NUM,nsubj,nummod,NNP,CD,4,1
1,0.0,20,is,7,1,18,17,0,1,6,11,Moolaadé,Ousmane Sembène,MISC,PER-PER,PROPN,PROPN-PROPN,nsubj,compound-conj,NNP,NNP-NNP,7,1
0,0.0,16,was,3,1,6,5,0,9,2,3,Viking Aircraft Inc.,American,ORG-ORG-ORG,LOC,PROPN-PROPN-PROPN,ADJ,compound-compound-nsubj,amod,NNP-NNP-NNP,JJ,4,1
1,0.0,16,was,3,1,11,10,0,4,2,8,Viking Aircraft Inc.,Panama City Beach,ORG-ORG-ORG,LOC-LOC-LOC,PROPN-PROPN-PROPN,PROPN-PROPN-PROPN,compound-compound-nsubj,compound-compound-pobj,NNP-NNP-NNP,NNP-NNP-NNP,7,1
2,0.0,16,was,3,6,15,9,5,0,-3,12,American,Florida,LOC,LOC,ADJ,PROPN,amod,appos,JJ,NNP,3,1
0,0.0,20,is,8,1,18,17,0,1,7,10,Märchen Awakens Romance,Nobuyuki Anzai,MISC-MISC-MISC,PER-PER,PROPN-PROPN-PROPN,PROPN-PROPN,compound-compound-nsubj,compound-pobj,NNP-NNP-NNP,NNP-NNP,7,1
1,3.0,51,acquired,3,27,34,7,26,16,-24,31,Toonami,Cartoon Network,MISC,ORG-ORG,PROPN,PROPN-PROPN,compound,compound-pobj,NNP,NNP-NNP,3,1
0,1.0,20,published,3,9,16,7,8,3,-6,13,Hora Cero,Argentina,MISC-MISC,LOC,PROPN-PROPN,PROPN,compound-appos,appos,NNP-NNP,NNP,4,1
1,1.0,20,published,3,9,19,10,8,0,-6,16,Hora Cero,1957,MISC-MISC,TIME,PROPN-PROPN,NUM,compound-appos,pobj,NNP-NNP,CD,4,1
2,1.0,20,published,3,13,16,3,12,3,-10,13,Buenos Aires,Argentina,LOC-LOC,LOC,PROPN-PROPN,PROPN,compound-pobj,appos,NNP-NNP,NNP,3,1
0,1.0,10,is,1,5,7,2,4,2,-4,6,Texas,the United States,LOC,LOC-LOC-LOC,PROPN,DET-PROPN-PROPN,pobj,det-compound-pobj,NNP,DT-NNP-NNP,2,1
0,3.0,17,Lüdenscheid,6,4,1,-3,3,15,2,-5,Rot - Weiß Lüdenscheid,Bundesliga Nord,ORG-ORG-ORG-ORG,ORG-ORG,PROPN-PUNCT-PROPN-PROPN,PROPN-PROPN,compound-punct-compound-ROOT,compound-compound,NNP-HYPH-NNP-NNP,NNP-NNP,4,1
0,4.0,32,led,6,5,24,19,4,7,1,18,Petr Vorobiev,Russia,PER-PER,LOC,PROPN-PROPN,PROPN,compound-nsubj,poss,NNP-NNP,NNP,4,1
0,0.0,30,Lovrić,1,1,5,4,0,24,0,4,Đuka Lovrić,23 August 1927,PER-PER,TIME-TIME-TIME,PROPN-PROPN,NUM-PROPN-NUM,compound-ROOT,nummod-npadvmod-nummod,NNP-NNP,CD-NNP-CD,2,1
1,0.0,30,Lovrić,1,1,16,15,0,13,0,15,Đuka Lovrić,20 February 1957,PER-PER,TIME-TIME-TIME,PROPN-PROPN,NUM-PROPN-NUM,compound-ROOT,nummod-npadvmod-nummod,NNP-NNP,CD-NNP-CD,2,1
0,1.0,57,was,1,9,27,18,8,29,-8,26,Lochlann,Amlaíb Conung,LOC,PER-PER,PROPN,PROPN-PROPN,pobj,compound-pobj,NNP,NNP-NNP,6,1
0,0.0,25,was,16,3,9,6,2,15,13,-7,Basilio Arturo Ignacio Lami Dozo,1 February 1929,PER-PER-PER-PER-PER,TIME-TIME-TIME,PROPN-PROPN-PROPN-PROPN-PROPN,NUM-PROPN-NUM,compound-compound-compound-compound-nsubj,nummod-appos-nummod,NNP-NNP-NNP-NNP-NNP,CD-NNP-CD,3,1
1,0.0,25,was,16,3,9,6,2,15,13,-7,Basilio Arturo Ignacio Lami Dozo,1 February 2017,PER-PER-PER-PER-PER,TIME-TIME-TIME,PROPN-PROPN-PROPN-PROPN-PROPN,NUM-PROPN-NUM,compound-compound-compound-compound-nsubj,nummod-appos-nummod,NNP-NNP-NNP-NNP-NNP,CD-NNP-CD,3,1
2,0.0,25,was,16,3,22,19,2,2,13,6,Basilio Arturo Ignacio Lami Dozo,Argentine Air Force,PER-PER-PER-PER-PER,ORG-ORG-ORG,PROPN-PROPN-PROPN-PROPN-PROPN,PROPN-PROPN-PROPN,compound-compound-compound-compound-nsubj,compound-compound-pobj,NNP-NNP-NNP-NNP-NNP,NNP-NNP-NNP,7,1
3,1.0,45,participated,1,10,14,4,9,30,-9,13,National Reorganisation Process,1976,MISC-MISC-MISC,TIME,PROPN-PROPN-PROPN,NUM,compound-compound-pobj,nummod,NNP-NNP-NNP,CD,2,1
0,0.0,56,is,12,30,32,2,29,23,-18,20,Istria,Croatia,LOC,LOC,PROPN,PROPN,pobj,pobj,NNP,NNP,8,1
0,6.0,18,Smith,2,1,11,10,0,6,1,9,Christopher H. Smith,US Congress,PER-PER-PER,ORG-ORG,PROPN-PROPN-PROPN,PROPN-PROPN,compound-compound-ROOT,compound-pobj,NNP-NNP-NNP,NNP-NNP,3,1
0,4.0,52,gained,8,34,50,16,33,1,-26,42,Action démocratique du Québec,January 2012,ORG-ORG-ORG-ORG,TIME-TIME,PROPN-NOUN-PROPN-PROPN,PROPN-NUM,nmod-amod-nmod-pobj,pobj-nummod,NNP-NN-NNP-NNP,NNP-CD,11,1
0,0.0,66,were,9,12,55,43,11,10,-3,46,Hispano - Celtic,Spain,ORG-ORG-ORG,LOC,PROPN-PUNCT-ADJ,PROPN,compound-punct-compound,pobj,NNP-HYPH-JJ,NNP,4,1
1,0.0,66,were,9,21,55,34,20,10,-12,46,Hispania,Spain,LOC,LOC,PROPN,PROPN,pobj,pobj,NNP,NNP,2,1
2,0.0,66,were,9,32,55,23,31,10,-23,46,Principality of Asturias,Spain,LOC-LOC-LOC,LOC,PROPN-ADP-PROPN,PROPN,pobj-prep-pobj,pobj,NNP-IN-NNP,NNP,5,1
3,0.0,66,were,9,40,55,15,39,10,-31,46,León,Spain,LOC,LOC,PROPN,PROPN,pobj,pobj,NNP,NNP,8,1
4,0.0,66,were,9,51,55,4,50,10,-42,46,Zamora,Spain,LOC,LOC,PROPN,PROPN,pobj,pobj,NNP,NNP,3,1
5,0.0,66,were,9,61,65,4,60,0,-52,56,Trás os Montes,Portugal,LOC-LOC-LOC,LOC,PROPN-ADP-PROPN,PROPN,pobj-prep-pobj,pobj,NNP-IN-NNP,NNP,5,1
0,3.0,18,described,2,16,13,-3,15,4,-14,11,American Pie,1999,MISC-MISC,TIME,PROPN-PROPN,NUM,compound-pobj,nummod,NNP-NNP,CD,2,1
1,5.0,28,lives,2,5,8,3,4,19,-3,6,Cape Town,South Africa,LOC-LOC,LOC-LOC,PROPN-PROPN,PROPN-PROPN,compound-pobj,compound-appos,NNP-NNP,NNP-NNP,1,1
0,0.0,19,is,2,9,13,4,8,5,-7,11,Broadbeach Waters,Gold Coast,LOC-LOC,LOC-LOC,PROPN-PROPN,PROPN-PROPN,compound-pobj,compound-pobj,NNP-NNP,NNP-NNP,2,1
1,0.0,19,is,2,9,18,9,8,0,-7,16,Broadbeach Waters,Australia,LOC-LOC,LOC,PROPN-PROPN,PROPN,compound-pobj,appos,NNP-NNP,NNP,4,1
2,0.0,19,is,2,16,18,2,15,0,-14,16,Queensland,Australia,LOC,LOC,PROPN,PROPN,conj,appos,NNP,NNP,8,1
3,2.0,25,developed,3,1,12,11,0,12,2,9,Pacific Fair,1977,LOC-LOC,TIME,PROPN-PROPN,NUM,compound-nsubjpass,pobj,NNP-NNP,CD,3,1
0,0.0,23,is,8,1,5,4,0,17,7,-3,Didier Dinart,18 January 1977,PER-PER,TIME-TIME-TIME,PROPN-PROPN,NUM-PROPN-NUM,compound-nsubj,nummod-npadvmod-nummod,NNP-NNP,CD-NNP-CD,2,1
1,7.0,25,represented,2,18,23,5,17,1,-16,21,Beijing Olympics,London Olympics,MISC-MISC,MISC-MISC,PROPN-PROPN,PROPN-PROPN,compound-pobj,compound-conj,NNP-NNPS,NNP-NNPS,1,1
0,4.0,49,succeeded,25,12,36,24,11,12,13,11,Henry V,England,PER-PER,LOC,PROPN-PROPN,PROPN,compound-pobj,pobj,NNP-NNP,NNP,8,1
1,4.0,49,succeeded,25,12,12,0,11,36,13,-13,Henry V,Henry VI,PER-PER,PER-PER,PROPN-PROPN,PROPN-PROPN,compound-pobj,compound-pobj,NNP-NNP,NNP-NNP,0,1
0,0.0,31,are,3,18,29,11,17,1,-15,26,Venezuelan,Nicolás Maduro,LOC,PER-PER,ADJ,PROPN-PROPN,amod,compound-appos,JJ,NNP-NNP,9,1
0,2.0,30,appeared,5,24,27,3,23,2,-19,22,Hype,WB Television Network,MISC,ORG-ORG-ORG,PROPN,PROPN-PROPN-PROPN,appos,compound-compound-pobj,NNP,NNP-NNP-NNP,2,1
1,6.0,8,Beat,0,4,7,3,3,0,-4,7,Highland Park,California,LOC-LOC,LOC,PROPN-PROPN,PROPN,compound-pobj,appos,NNP-NNP,NNP,4,1
0,1.0,16,joined,1,11,14,3,10,1,-10,13,Final Fantasy,Hironobu Sakaguchi,MISC-MISC,PER-PER,PROPN-PROPN,PROPN-PROPN,compound-compound,compound-dobj,NNP-NNP,NNP-NNP,2,1
1,3.0,27,left,8,8,22,14,7,4,0,14,Uematsu,Dog Ear Records,PER,ORG-ORG-ORG,PROPN,PROPN-PROPN-PROPN,appos,compound-compound-compound,NNP,NNP-NNP-NNP,6,1
0,0.0,20,is,12,1,11,10,0,8,11,-1,Roberto Fernandez Canuto,Gijon,PER-PER-PER,LOC,PROPN-PROPN-PROPN,PROPN,compound-compound-nsubj,pobj,NNP-NNP-NNP,NNP,2,1
1,3.0,29,directs,5,14,24,10,13,4,-9,19,Xu Xiaoxi,China,PER-PER,LOC,PROPN-PROPN,PROPN,compound-appos,pobj,NNP-NNP,NNP,7,1
0,0.0,18,is,3,10,12,2,9,5,-7,9,Paris,France,LOC,LOC,PROPN,PROPN,pobj,appos,NNP,NNP,4,1
1,2.0,23,Dzeladin,0,22,12,-10,21,10,-22,12,Macedonia,Sutka,LOC,LOC,PROPN,PROPN,pobj,pobj,NNP,NNP,4,1
2,2.0,23,Dzeladin,0,22,17,-5,21,5,-22,17,Macedonia,Skopje,LOC,LOC,PROPN,PROPN,pobj,pobj,NNP,NNP,7,1
0,0.0,24,born,13,1,5,4,0,18,12,-8,Thomas Simon,1623,PER-PER,TIME,PROPN-PROPN,NUM,compound-nsubjpass,nummod,NNP-NNP,CD,1,1
1,0.0,24,born,13,1,21,20,0,2,12,8,Thomas Simon,Yorkshire,PER-PER,LOC,PROPN-PROPN,PROPN,compound-nsubjpass,pobj,NNP-NNP,NNP,4,1
0,0.0,23,was,3,2,8,6,1,14,1,5,Palais Lanckoroński,Vienna,LOC-LOC,LOC,PROPN-PROPN,PROPN,compound-nsubj,pobj,NNP-NNP,NNP,5,1
1,0.0,23,was,3,2,10,8,1,12,1,7,Palais Lanckoroński,Austria,LOC-LOC,LOC,PROPN-PROPN,PROPN,compound-nsubj,appos,NNP-NNP,NNP,5,1
2,0.0,23,was,3,8,10,2,7,12,-5,7,Vienna,Austria,LOC,LOC,PROPN,PROPN,pobj,appos,NNP,NNP,2,1
3,0.0,23,was,3,8,21,13,7,1,-5,18,Vienna,Landstraße District,LOC,LOC-LOC,PROPN,PROPN-PROPN,pobj,compound-pobj,NNP,NNP-NNP,6,1
0,0.0,26,Bonaparte,2,1,10,9,0,15,1,8,Paul Marie Bonaparte,Canino,PER-PER-PER,LOC,PROPN-PROPN-PROPN,PROPN,compound-compound-ROOT,compound,NNP-NNP-NNP,NNP,2,1
1,0.0,26,Bonaparte,2,1,12,11,0,13,1,10,Paul Marie Bonaparte,"September 7 , 1827",PER-PER-PER,TIME-TIME-TIME-TIME,PROPN-PROPN-PROPN,PROPN-NUM-PUNCT-NUM,compound-compound-ROOT,nsubj-nummod-punct-nummod,NNP-NNP-NNP,"NNP-CD-,-CD",3,1
2,0.0,26,Bonaparte,2,1,17,16,0,8,1,15,Paul Marie Bonaparte,Nafplio,PER-PER-PER,LOC,PROPN-PROPN-PROPN,PROPN,compound-compound-ROOT,pobj,NNP-NNP-NNP,NNP,3,1
3,1.0,15,was,3,1,9,8,0,5,2,6,Paul Marie Bonaparte,Lucien Bonaparte,PER-PER-PER,PER-PER,PROPN-PROPN-PROPN,PROPN-PROPN,compound-compound-nsubj,compound-pobj,NNP-NNP-NNP,NNP-NNP,5,1
4,1.0,15,was,3,1,12,11,0,2,2,9,Paul Marie Bonaparte,Alexandrine de Bleschamp,PER-PER-PER,PER-PER-PER,PROPN-PROPN-PROPN,PROPN-ADP-PROPN,compound-compound-nsubj,compound-compound-conj,NNP-NNP-NNP,NNP-IN-NNP,7,1
5,1.0,15,was,3,9,12,3,8,2,-6,9,Lucien Bonaparte,Alexandrine de Bleschamp,PER-PER,PER-PER-PER,PROPN-PROPN,PROPN-ADP-PROPN,compound-pobj,compound-compound-conj,NNP-NNP,NNP-IN-NNP,2,1
0,8.0,21,was,2,8,11,3,7,9,-6,9,László Fenyvesi,Hungary,PER-PER,LOC,PROPN-PROPN,PROPN,compound-conj,pobj,NNP-NNP,NNP,4,1
1,8.0,21,was,2,16,19,3,15,1,-14,17,Jiří Plíšek,Czech Republic,PER-PER,LOC-LOC,PROPN-PROPN,PROPN-PROPN,compound-npadvmod,compound-pobj,NNP-NNP,NNP-NNP,2,1
2,8.0,21,was,2,19,6,-13,18,14,-17,4,Czech Republic,Czechoslovakia,LOC-LOC,LOC,PROPN-PROPN,PROPN,compound-pobj,pobj,NNP-NNP,NNP,6,1
0,2.0,29,worshipped,18,26,28,2,25,0,-8,10,Kaaba,Mecca,LOC,LOC,PROPN,PROPN,pobj,pobj,NNP,NNP,6,1
0,0.0,23,is,3,2,13,11,1,9,1,10,Pylon Assemblage,British Columbia,LOC-LOC,LOC-LOC,PROPN-PROPN,PROPN-PROPN,compound-nsubj,compound-pobj,NNP-NNP,NNP-NNP,6,1
1,0.0,23,is,3,2,16,14,1,6,1,13,Pylon Assemblage,Canada,LOC-LOC,LOC,PROPN-PROPN,PROPN,compound-nsubj,appos,NNP-NNP,NNP,5,1
2,0.0,23,is,3,13,16,3,12,6,-10,13,British Columbia,Canada,LOC-LOC,LOC,PROPN-PROPN,PROPN,compound-pobj,appos,NNP-NNP,NNP,3,1
0,1.0,33,sold,10,8,3,-5,7,29,2,-7,Hit Records,1962,ORG-ORG,TIME,PROPN-PROPN,NUM,compound-nsubjpass,pobj,NNP-NNPS,CD,3,1
1,1.0,33,sold,10,8,5,-3,7,27,2,-5,Hit Records,Bill Beasley,ORG-ORG,PER-PER,PROPN-PROPN,PROPN-PROPN,compound-nsubjpass,compound-pobj,NNP-NNPS,NNP-NNP,4,1
0,0.0,17,is,8,1,5,4,0,11,7,-3,Marc Kimmich,21 January 1983,PER-PER,TIME-TIME-TIME,PROPN-PROPN,NUM-PROPN-NUM,compound-nsubj,nummod-npadvmod-nummod,NNP-NNP,CD-NNP-CD,2,1
1,1.0,16,born,2,1,5,4,0,10,1,3,Kimmich,West Germany,PER,LOC-LOC,PROPN,PROPN-PROPN,nsubjpass,compound-pobj,NNP,NNP-NNP,3,1
2,3.0,26,lost,10,21,18,-3,20,7,-11,8,Igor Andreev,Russian,PER-PER,LOC,PROPN-PROPN,ADJ,compound-pobj,amod,NNP-NNP,JJ,2,1
3,3.0,26,lost,10,24,18,-6,23,7,-14,8,Nikolay Davydenko,Russian,PER-PER,LOC,PROPN-PROPN,ADJ,compound-conj,amod,NNP-NNP,JJ,5,1
0,0.0,33,serves,20,1,31,30,0,1,19,11,Delaware Valley Regional High School,United States,ORG-ORG-ORG-ORG-ORG,LOC-LOC,PROPN-PROPN-PROPN-PROPN-PROPN,PROPN-PROPN,compound-compound-compound-compound-nsubj,compound-pobj,NNP-NNP-NNP-NNP-NNP,NNP-NNP,7,1
1,0.0,33,serves,20,24,28,4,23,4,-4,8,western Hunterdon County,New Jersey,LOC-LOC-LOC,LOC-LOC,ADJ-PROPN-PROPN,PROPN-PROPN,amod-compound-pobj,compound-conj,JJ-NNP-NNP,NNP-NNP,2,1
2,0.0,33,serves,20,24,31,7,23,1,-4,11,western Hunterdon County,United States,LOC-LOC-LOC,LOC-LOC,ADJ-PROPN-PROPN,PROPN-PROPN,amod-compound-pobj,compound-pobj,JJ-NNP-NNP,NNP-NNP,2,1
3,0.0,33,serves,20,28,31,3,27,1,-8,11,New Jersey,United States,LOC-LOC,LOC-LOC,PROPN-PROPN,PROPN-PROPN,compound-conj,compound-pobj,NNP-NNP,NNP-NNP,2,1
0,0.0,29,was,11,1,4,3,0,24,10,-7,Yvonne Printemps,25 July 1894,PER-PER,TIME-TIME-TIME,PROPN-PROPN,NUM-PROPN-NUM,compound-nsubj,nummod-nmod-nummod,NNP-NNP,CD-NNP-CD,2,1
1,0.0,29,was,11,1,8,7,0,20,10,-3,Yvonne Printemps,19 January 1977,PER-PER,TIME-TIME-TIME,PROPN-PROPN,NUM-PROPN-NUM,compound-nsubj,nummod-appos-nummod,NNP-NNP,CD-NNP-CD,3,1
2,0.0,29,was,11,1,26,25,0,2,10,15,Yvonne Printemps,France,PER-PER,LOC,PROPN-PROPN,PROPN,compound-nsubj,pobj,NNP-NNP,NNP,6,1
3,3.0,24,remarried,2,15,23,8,14,0,-13,21,Pierre Fresnay,1975,PER-PER,TIME,PROPN-PROPN,NUM,compound-pobj,pobj,NNP-NNP,CD,6,1
0,3.0,32,was,6,21,30,9,20,1,-15,24,Moravský Krumlov,Czech Republic,LOC-LOC,LOC-LOC,PROPN-PROPN,PROPN-PROPN,compound-pobj,compound-pobj,NNP-NNP,NNP-NNP,6,1
1,3.0,32,was,6,25,30,5,24,1,-19,24,South Moravian Region,Czech Republic,LOC-LOC-LOC,LOC-LOC,PROPN-PROPN-PROPN,PROPN-PROPN,compound-compound-pobj,compound-pobj,NNP-NNP-NNP,NNP-NNP,3,1
0,0.0,10,is,1,1,9,8,0,0,0,8,Anakpawis,Philippines,ORG,LOC,PROPN,PROPN,nsubj,pobj,NNP,NNP,1,1
0,4.0,23,consists,2,20,12,-8,19,10,-18,10,Parliament of India,Lok Sabha,ORG-ORG-ORG,ORG-ORG,PROPN-ADP-PROPN,PROPN-PROPN,pobj-prep-pobj,compound-pobj,NNP-IN-NNP,NNP-NNP,4,1
1,11.0,15,headed,4,7,12,5,6,2,-3,8,Murli Manohar Joshi,Bharatiya Janata Party,PER-PER-PER,ORG-ORG-ORG,PROPN-PROPN-PROPN,PROPN-PROPN-PROPN,compound-compound-pobj,compound-compound-pobj,NNP-NNP-NNP,NNP-NNP-NNP,6,1
0,0.0,19,is,9,1,6,5,0,12,8,-3,Hellmut G. Haasis,7 January 1942,PER-PER-PER,TIME-TIME-TIME,PROPN-PROPN-PROPN,NUM-PROPN-NUM,compound-compound-nsubj,nummod-npadvmod-nummod,NNP-NNP-NNP,CD-NNP-CD,3,1
1,1.0,60,was,44,34,41,7,33,18,10,-3,Joseph Süß Oppenheimer,1738,PER-PER-PER,TIME,PROPN-PROPN-PROPN,NUM,compound-compound-conj,pobj,NNP-NNP-NNP,CD,3,1
2,2.0,31,born,2,1,5,4,0,25,1,3,Haasis,Mühlacker,PER,LOC,NOUN,PROPN,nsubjpass,pobj,NN,NNP,4,1
3,2.0,31,born,2,1,22,21,0,8,1,20,Haasis,Swabian,PER,MISC,NOUN,ADJ,nsubjpass,amod,NN,JJ,5,1
4,2.0,31,born,2,11,14,3,10,16,-9,12,Swabia,Germany,LOC,LOC,PROPN,PROPN,compound,pobj,NNP,NNP,6,1
0,0.0,14,is,1,1,13,12,0,0,0,12,Strathcona,Canada,LOC,LOC,PROPN,PROPN,nsubj,appos,NNP,NNP,1,1
1,0.0,14,is,1,9,11,2,8,2,-8,10,Edmonton,Alberta,LOC,LOC,PROPN,PROPN,pobj,npadvmod,NNP,NNP,3,1
2,0.0,14,is,1,11,13,2,10,0,-10,12,Alberta,Canada,LOC,LOC,PROPN,PROPN,npadvmod,appos,NNP,NNP,6,1
0,0.0,17,was,11,1,4,3,0,12,10,-7,Amalie Raiffeisen,2 August 1846,PER-PER,TIME-TIME-TIME,PROPN-PROPN,NUM-PROPN-NUM,compound-nsubj,nummod-appos-npadvmod,NNP-NNP,CD-NNP-CD,2,1
1,0.0,17,was,11,1,8,7,0,8,10,-3,Amalie Raiffeisen,11 January 1897,PER-PER,TIME-TIME-TIME,PROPN-PROPN,NUM-PROPN-NUM,compound-nsubj,nummod-appos-nummod,NNP-NNP,CD-NNP-CD,1,1
2,0.0,17,was,11,1,14,13,0,2,10,3,Amalie Raiffeisen,German,PER-PER,LOC,PROPN-PROPN,ADJ,compound-nsubj,amod,NNP-NNP,JJ,3,1
3,5.0,19,continued,11,2,9,7,1,9,9,-2,Friedrich Wilhelm Raiffeisen,1888,PER-PER-PER,TIME,PROPN-PROPN-PROPN,NUM,compound-compound-nsubj,pobj,NNP-NNP-NNP,CD,4,1
0,2.0,20,moved,7,5,3,-2,4,16,2,-4,Till - Mobley,Mississippi,PER-PER-PER,LOC,PROPN-PUNCT-PROPN,PROPN,compound-punct-nsubj,pobj,NNP-HYPH-NNP,NNP,3,1
0,0.0,15,was,8,1,5,4,0,9,7,-3,Mary Spencer Nay,1913,PER-PER-PER,TIME,PROPN-PROPN-PROPN,NUM,compound-compound-nsubj,nummod,NNP-NNP-NNP,CD,3,1
1,0.0,15,was,8,1,7,6,0,7,7,-1,Mary Spencer Nay,1993,PER-PER-PER,TIME,PROPN-PROPN-PROPN,NUM,compound-compound-nsubj,nummod,NNP-NNP-NNP,CD,2,1
2,0.0,15,was,8,1,11,10,0,3,7,3,Mary Spencer Nay,American,PER-PER-PER,LOC,PROPN-PROPN-PROPN,ADJ,compound-compound-nsubj,amod,NNP-NNP-NNP,JJ,3,1
0,3.0,14,attended,1,1,4,3,0,9,0,3,Kittiratt,Assumption College,PER,ORG-ORG,PROPN,PROPN-PROPN,nsubj,compound-dobj,NNP,NNP-NNP,1,1
1,10.0,14,became,4,4,9,5,3,4,0,5,Kittiratt,Thais United party,PER,ORG-ORG-ORG,PROPN,PROPN-PROPN-NOUN,nsubj,compound-compound-pobj,NNP,NNP-NNP-NN,4,1
0,2.0,91,known,4,86,90,4,85,0,-82,86,Super Bowl XXVI,1992,MISC-MISC-MISC,TIME,PROPN-PROPN-PROPN,NUM,compound-compound-pobj,pobj,NNP-NNP-NNP,CD,8,1
0,1.0,55,became,41,48,54,6,47,0,-7,13,Gerrit Dou,Leiden,PER-PER,LOC,PROPN-PROPN,PROPN,compound-pobj,pobj,NNP-NNP,NNP,6,1
0,1.0,24,began,1,9,13,4,8,10,-8,12,Lily Lebowski,NBC,PER-PER,ORG,PROPN-PROPN,PROPN,compound-dobj,compound,NNP-NNP,NNP,4,1
1,1.0,24,began,1,17,20,3,16,3,-16,19,Crossing Jordan,2001,MISC-MISC,TIME,PROPN-PROPN,NUM,compound-appos,nummod,NNP-NNP,CD,2,1
2,2.0,76,went,1,39,42,3,38,33,-38,41,Step Brothers,2008,MISC-MISC,TIME,PROPN-PROPN,NUM,compound-npadvmod,appos,NNP-NNP,CD,1,1
3,2.0,76,went,1,45,49,4,44,26,-44,48,Our Idiot Brother,2011,MISC-MISC-MISC,TIME,DET-PROPN-PROPN,NUM,poss-compound-conj,appos,PRP$-NNP-NNP,CD,2,1
4,2.0,76,went,1,23,32,9,22,43,-22,31,How to Lose a Guy in 10 Days,2003,MISC-MISC-MISC-MISC-MISC-MISC-MISC-MISC,TIME,ADV-PART-VERB-DET-PROPN-ADP-NUM-NOUN,NUM,advmod-aux-relcl-det-dobj-prep-nummod-pobj,appos,WRB-TO-VB-DT-NNP-IN-CD-NNS,CD,4,1
5,3.0,22,starred,6,15,20,5,14,1,-9,14,Afternoon Delight,Jill Soloway,MISC-MISC,PER-PER,PROPN-PROPN,PROPN-PROPN,compound-appos,compound-pobj,NNP-NNP,NNP-NNP,4,1
6,4.0,27,had,1,10,13,3,9,13,-9,12,Bad Moms,2016,MISC-MISC,TIME,PROPN-PROPN,NUM,compound-appos,appos,NNP-NNP,CD,1,1
7,5.0,46,appeared,3,19,26,7,18,19,-16,23,This Is Where I Leave You,2014,MISC-MISC-MISC-MISC-MISC-MISC,TIME,DET-VERB-ADV-PRON-VERB-PRON,NUM,nsubj-ROOT-advmod-nsubj-ccomp-dobj,npadvmod,DT-VBZ-WRB-PRP-VBP-PRP,CD,3,1
0,0.0,26,Tod,1,1,22,21,0,3,0,21,David Tod,U.S.,PER-PER,LOC,PROPN-PROPN,PROPN,compound-ROOT,compound,NNP-NNP,NNP,4,1
1,0.0,26,Tod,1,16,25,9,15,0,-15,24,American,Ohio,LOC,LOC,ADJ,PROPN,amod,pobj,JJ,NNP,2,1
2,0.0,26,Tod,1,22,25,3,21,0,-21,24,U.S.,Ohio,LOC,LOC,PROPN,PROPN,compound,pobj,NNP,NNP,4,1
0,0.0,30,"""",0,2,26,24,1,3,-2,26,I 'm Real,J.Lo,MISC-MISC-MISC,MISC,PRON-VERB-ADJ,PROPN,nsubj-ccomp-acomp,appos,PRP-VBP-JJ,NNP,4,1
1,0.0,30,"""",0,2,28,26,1,1,-2,28,I 'm Real,2001,MISC-MISC-MISC,TIME,PRON-VERB-ADJ,NUM,nsubj-ccomp-acomp,npadvmod,PRP-VBP-JJ,CD,5,1
2,0.0,30,"""",0,26,28,2,25,1,-26,28,J.Lo,2001,MISC,TIME,PROPN,NUM,appos,npadvmod,NNP,CD,1,1
3,1.0,66,wrote,18,50,52,2,49,13,-32,34,J.Lo,July 2001,MISC,TIME-TIME,PROPN,PROPN-NUM,pobj,pobj-nummod,NNP,NNP-CD,6,1
4,1.0,66,wrote,18,13,16,3,12,49,5,-2,Ja Rule,Murder Inc Records,PER-PER,ORG-ORG-ORG,PROPN-PROPN,PROPN-PROPN-PROPN,compound-nsubj,compound-compound-pobj,NNP-NNP,NNP-NNP-NNPS,3,1
5,1.0,66,wrote,18,32,52,20,31,13,-14,34,I 'm Real ( Murder Remix ),July 2001,MISC-MISC-MISC-MISC-MISC-MISC-MISC,TIME-TIME,PRON-VERB-PROPN-PUNCT-PROPN-PROPN-PUNCT,PROPN-NUM,nsubj-ROOT-attr-punct-compound-appos-punct,pobj-nummod,PRP-VBP-NNP--LRB--NNP-NNP--RRB-,NNP-CD,10,1
6,2.0,20,Is,14,1,4,3,0,15,13,-10,The Remixes,2002,MISC-MISC,TIME,DET-PROPN,NUM,det-nsubj,appos,DT-NNPS,CD,1,1
7,2.0,20,Is,14,14,18,4,13,1,0,4,Pain Is Love,2001,MISC-MISC-MISC,TIME,PROPN-VERB-NOUN,NUM,conj-ROOT-attr,appos,NNP-VBZ-NN,CD,2,1
8,2.0,20,Is,14,14,8,-6,13,11,0,-6,Pain Is Love,Ja Rule,MISC-MISC-MISC,PER-PER,PROPN-VERB-NOUN,PROPN-PROPN,conj-ROOT-attr,compound-poss,NNP-VBZ-NN,NNP-NNP,4,1
0,0.0,25,is,3,1,23,22,0,1,2,20,Chains of Gold,John Travolta,MISC-MISC-MISC,PER-PER,NOUN-ADP-PROPN,PROPN-PROPN,nsubj-prep-pobj,compound-pobj,NNS-IN-NNP,NNP-NNP,6,1
1,2.0,20,film,1,5,12,7,4,7,-4,11,Showtime,United States,ORG,LOC-LOC,PROPN,PROPN-PROPN,pobj,compound-pobj,NNP,NNP-NNP,3,1
2,5.0,11,shot,3,6,10,4,5,0,-3,7,Miami,USA,LOC,LOC,PROPN,PROPN,pobj,appos,NNP,NNP,4,1
3,5.0,11,shot,3,8,10,2,7,0,-5,7,Florida,USA,LOC,LOC,PROPN,PROPN,conj,appos,NNP,NNP,5,1
0,0.0,18,is,2,1,16,15,0,1,1,14,Circus Black,Amberian Dawn,MISC-MISC,ORG-ORG,PROPN-PROPN,PROPN-PROPN,compound-nsubj,compound-pobj,NNP-NNP,NNP-NNP,5,1
1,9.0,40,is,4,35,38,3,34,1,-31,34,Finnvox Studios,Finland,ORG-ORG,LOC,PROPN-PROPN,PROPN,compound-pobj,pobj,NNP-NNPS,NNP,3,1
0,3.0,27,was,2,8,23,15,7,3,-6,21,Louis XIV,Louise de La Vallière,PER-PER,PER-PER-PER-PER,PROPN-PROPN,PROPN-PROPN-PROPN-PROPN,compound-pobj,compound-compound-compound-conj,NNP-NNP,NNP-NNP-NNP-NNP,7,1
0,0.0,29,is,4,1,7,6,0,21,3,3,Tin Pan Alley Cats,1943,MISC-MISC-MISC-MISC,TIME,PROPN-PROPN-PROPN-PROPN,NUM,compound-compound-compound-nsubj,nummod,NNP-NNP-NNP-NNPS,CD,4,1
1,1.0,56,focuses,24,21,19,-2,20,36,3,-5,Tin Pan Alley Cats,1943,MISC-MISC-MISC-MISC,TIME,PROPN-PROPN-PROPN-PROPN,NUM,compound-compound-compound-nsubj,pobj,NNP-NNP-NNP-NNP,CD,4,1
2,0.0,29,is,4,1,17,16,0,11,3,13,Tin Pan Alley Cats,Leon Schlesinger Productions,MISC-MISC-MISC-MISC,ORG-ORG-ORG,PROPN-PROPN-PROPN-PROPN,PROPN-PROPN-PROPN,compound-compound-compound-nsubj,compound-compound-pobj,NNP-NNP-NNP-NNPS,NNP-NNP-NNPS,9,1
3,0.0,29,is,4,1,26,25,0,2,3,22,Tin Pan Alley Cats,Merrie Melodies,MISC-MISC-MISC-MISC,MISC-MISC,PROPN-PROPN-PROPN-PROPN,PROPN-PROPN,compound-compound-compound-nsubj,compound-compound,NNP-NNP-NNP-NNPS,NNP-NNP,9,1
4,2.0,25,is,4,16,19,3,15,5,-12,15,Looney Tunes,Porky in Wackyland,MISC-MISC,MISC-MISC-MISC,PROPN-PROPN,PROPN-ADP-PROPN,compound-nmod,pobj-prep-pobj,NNP-NNP,NNP-IN-NNP,2,1
5,2.0,25,is,4,19,23,4,18,1,-15,19,Porky in Wackyland,1938,MISC-MISC-MISC,TIME,PROPN-ADP-PROPN,NUM,pobj-prep-pobj,appos,NNP-IN-NNP,CD,2,1
6,2.0,25,is,4,19,11,-8,18,13,-15,7,Porky in Wackyland,Clampett,MISC-MISC-MISC,PER,PROPN-ADP-PROPN,PROPN,pobj-prep-pobj,poss,NNP-IN-NNP,NNP,4,1
7,4.0,31,withheld,15,29,8,-21,28,22,-14,-7,Censored Eleven,Warner Bros.,MISC-MISC,ORG-ORG,PROPN-PROPN,PROPN-PROPN,compound-pobj,compound-conj,NNP-NNP,NNP-NNPS,6,1
0,0.0,61,was,43,23,25,2,22,35,20,-18,Borlang,Gorkha,LOC,LOC,PROPN,PROPN,conj,compound,NNP,NNP,3,1
1,2.0,23,was,4,3,9,6,2,13,1,5,Ganesh Kumari,Kaji Nain Singh Thapa,PER-PER,PER-PER-PER-PER,PROPN-PROPN,PROPN-PROPN-PROPN-PROPN,compound-appos,compound-compound-compound-pobj,NNP-NNP,NNP-NNP-NNP-NNP,6,1
0,0.0,25,is,5,2,19,17,1,5,3,14,Robert C. Byrd Bridge,West Virginia,LOC-LOC-LOC-LOC,LOC-LOC,PROPN-PROPN-PROPN-PROPN,PROPN-PROPN,compound-compound-compound-nsubj,compound-conj,NNP-NNP-NNP-NNP,NNP-NNP,9,1
1,7.0,47,named,4,7,26,19,6,20,-3,22,Robert C. Byrd Bridge,West Virginia,LOC-LOC-LOC-LOC,LOC-LOC,PROPN-PROPN-PROPN-PROPN,PROPN-PROPN,compound-compound-compound-oprd,compound-pobj,NNP-NNP-NNP-NNP,NNP-NNP,6,1
2,0.0,25,is,5,2,14,12,1,10,3,9,Robert C. Byrd Bridge,Ohio,LOC-LOC-LOC-LOC,LOC,PROPN-PROPN-PROPN-PROPN,PROPN,compound-compound-compound-nsubj,appos,NNP-NNP-NNP-NNP,NNP,6,1
3,7.0,47,named,4,6,26,20,5,20,-2,22,the U.S.,West Virginia,LOC-LOC,LOC-LOC,DET-PROPN,PROPN-PROPN,det-compound,compound-pobj,DT-NNP,NNP-NNP,6,1
0,0.0,22,was,3,2,6,4,1,15,1,3,Le Blon,French,MISC-MISC,LOC,PROPN-PROPN,ADJ,compound-nsubj,amod,NNP-NNP,JJ,2,1
0,3.0,16,educated,2,12,5,-7,11,10,-10,3,Charlotte Square,Edinburgh,LOC-LOC,LOC,PROPN-PROPN,PROPN,compound-pobj,appos,NNP-NNP,NNP,5,1
0,0.0,60,name,5,41,56,15,40,3,-36,51,Wat Saket,Buddhist,LOC-LOC,ORG,PROPN-PROPN,ADJ,compound-pobj,compound,NNP-NNP,JJ,7,1
0,0.0,19,is,8,4,4,0,3,14,4,-4,Ottawa Road # 72,Ottawa,LOC-LOC-LOC-LOC,LOC,PROPN-PROPN-SYM-NUM,PROPN,compound-appos-quantmod-appos,pobj,NNP-NNP-$-CD,NNP,0,1
1,0.0,19,is,8,4,18,14,3,0,4,10,Ottawa Road # 72,Canada,LOC-LOC-LOC-LOC,LOC,PROPN-PROPN-SYM-NUM,PROPN,compound-appos-quantmod-appos,appos,NNP-NNP-$-CD,NNP,3,1
2,0.0,19,is,8,4,16,12,3,2,4,8,Ottawa,Ontario,LOC,LOC,PROPN,PROPN,pobj,conj,NNP,NNP,7,1
3,6.0,19,was,1,16,10,-6,15,8,-15,9,Ottawa,Ontario,LOC,LOC,PROPN,PROPN,pobj,appos,NNP,NNP,5,1
4,0.0,19,is,8,4,18,14,3,0,4,10,Ottawa,Canada,LOC,LOC,PROPN,PROPN,pobj,appos,NNP,NNP,3,1
5,0.0,19,is,8,16,18,2,15,0,-8,10,Ontario,Canada,LOC,LOC,PROPN,PROPN,conj,appos,NNP,NNP,6,1
6,6.0,19,was,1,8,10,2,7,8,-7,9,Archville,Ontario,LOC,LOC,PROPN,PROPN,pobj,appos,NNP,NNP,2,1
0,0.0,35,is,4,2,27,25,1,7,2,23,Riverside Township,Burlington County,LOC-LOC,LOC-LOC,PROPN-PROPN,PROPN-PROPN,compound-pobj,compound-pobj,NNP-NNP,NNP-NNP,6,1
1,0.0,35,is,4,2,33,31,1,1,2,29,Riverside Township,United States,LOC-LOC,LOC-LOC,PROPN-PROPN,PROPN-PROPN,compound-pobj,compound-appos,NNP-NNP,NNP-NNP,7,1
2,0.0,35,is,4,27,30,3,26,4,-23,26,Burlington County,New Jersey,LOC-LOC,LOC-LOC,PROPN-PROPN,PROPN-PROPN,compound-pobj,compound-conj,NNP-NNP,NNP-NNP,1,1
3,0.0,35,is,4,27,33,6,26,1,-23,29,Burlington County,United States,LOC-LOC,LOC-LOC,PROPN-PROPN,PROPN-PROPN,compound-pobj,compound-appos,NNP-NNP,NNP-NNP,1,1
4,0.0,35,is,4,30,33,3,29,1,-26,29,New Jersey,United States,LOC-LOC,LOC-LOC,PROPN-PROPN,PROPN-PROPN,compound-conj,compound-appos,NNP-NNP,NNP-NNP,2,1
0,0.0,22,is,8,1,21,20,0,0,7,13,Android,Google,MISC,ORG,PROPN,PROPN,nmod,pobj,NNP,NNP,-1,1
1,7.0,21,indicate,5,12,5,-7,11,15,-7,0,Android,Google,MISC,ORG,PROPN,PROPN,compound,pobj,NNP,NNP,4,1
2,7.0,21,indicate,5,5,5,0,4,15,0,0,Google Play,Google,MISC-MISC,ORG,PROPN-PROPN,PROPN,compound-dobj,pobj,NNP-NNP,NNP,0,1
0,1.0,50,known,3,44,9,-35,43,40,-41,6,Finding Nemo,Pixar,MISC-MISC,ORG,PROPN-PROPN,PROPN,acl-dobj,pobj,NNP-NNP,NNP,9,1
1,1.0,50,known,3,47,9,-38,46,40,-44,6,Cars,Pixar,MISC,ORG,PROPN,PROPN,conj,pobj,NNP,NNP,11,1
2,1.0,50,known,3,49,9,-40,48,40,-46,6,Ratatouille,Pixar,MISC,ORG,PROPN,PROPN,conj,pobj,NNP,NNP,6,1
3,1.0,50,known,3,25,25,0,24,24,-22,22,Toy Story,Toy Story 2,MISC-MISC,MISC-MISC-MISC,PROPN-PROPN,PROPN-PROPN-NUM,compound-pobj,compound-appos-nummod,NNP-NNP,NNP-NNP-CD,0,1
4,3.0,29,directed,4,12,9,-3,11,19,-8,5,Boundin,Pixar,MISC,ORG,PROPN,PROPN,appos,nmod,NNP,NNP,2,1
0,0.0,31,wrote,5,22,29,7,21,1,-17,24,Make Way for Tomorrow,Leo McCarey,MISC-MISC-MISC-MISC,PER-PER,VERB-NOUN-ADP-PROPN,PROPN-PROPN,conj-dobj-prep-pobj,compound-pobj,VB-NN-IN-NNP,NNP-NNP,4,1
1,4.0,34,screened,2,31,23,-8,30,10,-29,21,New York City,US,LOC-LOC-LOC,LOC,PROPN-PROPN-PROPN,PROPN,compound-compound-pobj,compound,NNP-NNP-NNP,NNP,8,1
0,0.0,34,was,13,1,4,3,0,29,12,-9,Jan Šťastný,c.1764,PER-PER,TIME,PROPN-PROPN,NUM,compound-nsubj,compound,NNP-NNP,CD,2,1
0,0.0,19,was,11,1,4,3,0,14,10,-7,Vito Frazzi,1 August 1888,PER-PER,TIME-TIME-TIME,PROPN-PROPN,NUM-PROPN-NUM,compound-nsubj,nummod-nmod-nummod,NNP-NNP,CD-NNP-CD,1,1
0,0.0,17,is,3,2,13,11,1,3,1,10,Ibergeregg Pass,Swiss,LOC-LOC,LOC,PROPN-PROPN,ADJ,compound-nsubj,amod,NNP-NNP,JJ,6,1
1,0.0,17,is,3,13,16,3,12,0,-10,13,Swiss,Schwyz,LOC,LOC,ADJ,PROPN,amod,pobj,JJ,NNP,6,1
2,2.0,29,are,12,5,11,6,4,17,7,-1,Minster,Sihl,LOC,LOC,PROPN,PROPN,pobj,pobj,NNP,NNP,3,1
0,0.0,40,was,11,1,7,6,0,32,10,-4,Joseph Isaac Clanton,"June 1 , 1887",PER-PER-PER,TIME-TIME-TIME-TIME,PROPN-PROPN-PROPN,PROPN-NUM-PUNCT-NUM,compound-compound-nsubj,npadvmod-nummod-punct-nummod,NNP-NNP-NNP,"NNP-CD-,-CD",3,1
1,0.0,40,was,11,1,23,22,0,16,10,12,Joseph Isaac Clanton,The Cowboys,PER-PER-PER,ORG-ORG,PROPN-PROPN-PROPN,DET-PROPN,compound-compound-nsubj,det-pobj,NNP-NNP-NNP,DT-NNPS,10,1
0,0.0,48,is,9,1,6,5,0,41,8,-3,Linda Jean Burney,25 April 1957,PER-PER-PER,TIME-TIME-TIME,PROPN-PROPN-PROPN,NUM-PROPN-NUM,compound-compound-nsubj,nummod-npadvmod-nummod,NNP-NNP-NNP,CD-NNP-CD,3,1
1,0.0,48,is,9,12,27,15,11,20,-3,18,Australian,Canterbury,LOC,LOC,ADJ,PROPN,amod,dobj,JJ,NNP,5,1
2,0.0,48,is,9,21,27,6,20,20,-12,18,New South Wales Legislative Assembly,Canterbury,ORG-ORG-ORG-ORG-ORG,LOC,PROPN-PROPN-PROPN-PROPN-PROPN,PROPN,compound-compound-compound-compound-pobj,dobj,NNP-NNP-NNP-NNP-NNP,NNP,5,1
0,0.0,22,was,3,10,19,9,9,2,-7,16,Eurovision Song Contest 2004,Knut Anders Sørum,MISC-MISC-MISC-MISC,PER-PER-PER,PROPN-PROPN-PROPN-NUM,PROPN-PROPN-PROPN,compound-compound-pobj-appos,compound-compound-pobj,NNP-NNP-NNP-CD,NNP-NNP-NNP,8,1
1,4.0,30,performed,4,15,11,-4,14,18,-11,7,Du bist,Tie Break,MISC-MISC,MISC-MISC,PROPN-NOUN,PROPN-PROPN,compound-pobj,compound-pobj,NNP-NN,NNP-NNP,2,1
0,0.0,28,is,10,1,13,12,0,14,9,3,Behzad Mirkhani,Persian,PER-PER,LOC,PROPN-PROPN,ADJ,compound-nsubj,amod,NNP-NNP,JJ,2,1
1,4.0,21,released,5,18,20,2,17,0,-13,15,Baby,USA,MISC,LOC,PROPN,PROPN,pobj,npadvmod,NNP,NNP,5,1
0,0.0,29,Orr,2,1,6,5,0,22,1,4,Stanley Gordon Orr,28 September 1916,PER-PER-PER,TIME-TIME-TIME,PROPN-PROPN-PROPN,NUM-PROPN-NUM,compound-compound-ROOT,nummod-appos-nummod,NNP-NNP-NNP,CD-NNP-CD,2,1
1,0.0,29,Orr,2,1,10,9,0,18,1,8,Stanley Gordon Orr,11 August 2003,PER-PER-PER,TIME-TIME-TIME,PROPN-PROPN-PROPN,NUM-PROPN-NUM,compound-compound-ROOT,nummod-nsubj-nummod,NNP-NNP-NNP,CD-NNP-CD,3,1
0,0.0,22,was,12,15,20,5,14,1,-3,8,Labour Party,United Kingdom,ORG-ORG,LOC-LOC,PROPN-PROPN,PROPN-PROPN,compound-compound,compound-pobj,NNP-NNP,NNP-NNP,3,1
1,1.0,16,born,3,10,15,5,9,0,-7,12,Metropolitan Borough of Hackney,London,LOC-LOC-LOC-LOC,LOC,PROPN-PROPN-ADP-PROPN,PROPN,compound-pobj-prep-pobj,pobj,NNP-NNP-IN-NNP,NNP,3,1
2,4.0,28,Parliament,4,26,24,-2,25,3,-22,20,Seymour Cocks,Labour,PER-PER,ORG,PROPN-PROPN,PROPN,compound-dobj,compound,NNP-NNPS,NNP,1,1
0,0.0,11,is,1,1,8,7,0,2,0,7,Serpentine,Victoria,LOC,LOC,PROPN,PROPN,nsubj,pobj,NNP,NNP,4,1
1,0.0,11,is,1,1,10,9,0,0,0,9,Serpentine,Australia,LOC,LOC,PROPN,PROPN,nsubj,appos,NNP,NNP,1,1
2,0.0,11,is,1,8,10,2,7,0,-7,9,Victoria,Australia,LOC,LOC,PROPN,PROPN,pobj,appos,NNP,NNP,5,1
3,3.0,15,named,3,6,13,7,5,1,-3,10,Serpentine Creek,Loddon River,LOC-LOC,LOC-LOC,PROPN-PROPN,PROPN-PROPN,compound-pobj,compound-pobj,NNP-NNP,NNP-NNP,3,1
0,0.0,51,was,17,1,9,8,0,41,16,-8,Julio Nalundasan,20 September 1935,PER-PER,TIME-TIME-TIME,PROPN-PROPN,NUM-PROPN-NUM,compound-nsubj,nummod-npadvmod-nummod,NNP-NNP,CD-NNP-CD,2,1
1,0.0,51,was,17,1,13,12,0,37,16,-4,Julio Nalundasan,Batac,PER-PER,LOC,PROPN-PROPN,PROPN,compound-nsubj,appos,NNP-NNP,NNP,3,1
2,0.0,51,was,17,1,20,19,0,30,16,3,Julio Nalundasan,Filipino,PER-PER,LOC,PROPN-PROPN,ADJ,compound-nsubj,compound,NNP-NNP,JJ,2,1
3,0.0,51,was,17,1,49,48,0,1,16,32,Julio Nalundasan,Philippines,PER-PER,LOC,PROPN-PROPN,PROPN,compound-nsubj,pobj,NNP-NNP,NNPS,2,1
4,0.0,51,was,17,20,38,18,19,12,-3,21,Filipino,Ferdinand Marcos,LOC,PER-PER,ADJ,PROPN-PROPN,compound,compound-pobj,JJ,NNP-NNP,9,1
5,0.0,51,was,17,33,49,16,32,1,-16,32,Mariano Marcos,Philippines,PER-PER,LOC,PROPN-PROPN,PROPN,compound-pobj,pobj,NNP-NNP,NNPS,8,1
6,0.0,51,was,17,38,49,11,37,1,-21,32,Ferdinand Marcos,Philippines,PER-PER,LOC,PROPN-PROPN,PROPN,compound-pobj,pobj,NNP-NNP,NNPS,11,1
7,2.0,24,convicted,19,1,6,5,0,17,18,-13,Mariano Marcos,Ferdinand,PER-PER,PER,PROPN-PROPN,PROPN,compound-poss,conj,NNP-NNP,NNP,3,1
8,3.0,34,overturned,5,21,13,-8,20,20,-16,8,Jose P. Laurel,Philippines,PER-PER-PER,LOC,PROPN-PROPN-PROPN,PROPN,compound-compound-pobj,pobj,NNP-NNP-NNP,NNPS,6,1
0,0.0,17,is,1,1,7,6,0,9,0,6,Southwood,Queensland,LOC,LOC,PROPN,PROPN,nsubj,pobj,NNP,NNP,4,1
1,0.0,17,is,1,1,9,8,0,7,0,8,Southwood,Australia,LOC,LOC,PROPN,PROPN,nsubj,appos,NNP,NNP,4,1
2,0.0,17,is,1,7,9,2,6,7,-6,8,Queensland,Australia,LOC,LOC,PROPN,PROPN,pobj,appos,NNP,NNP,2,1
0,11.0,31,have,14,2,7,5,1,23,12,-7,Canada,British Columbia,LOC,LOC-LOC,PROPN,PROPN-PROPN,pobj,compound-pobj,NNP,NNP-NNP,4,1
1,11.0,31,have,14,2,10,8,1,20,12,-4,Canada,Newfoundland,LOC,LOC,PROPN,PROPN,pobj,conj,NNP,NNP,6,1
2,11.0,31,have,14,2,13,11,1,17,12,-1,Canada,Ontario,LOC,LOC,PROPN,PROPN,pobj,conj,NNP,NNP,2,1
0,0.0,13,is,1,1,7,6,0,5,0,6,Koonya,Tasman Peninsula,LOC,LOC-LOC,PROPN,PROPN-PROPN,nsubj,compound-pobj,NNP,NNP-NNP,3,1
1,0.0,13,is,1,1,12,11,0,0,0,11,Koonya,Australia,LOC,LOC,PROPN,PROPN,nsubj,appos,NNP,NNP,1,1
2,0.0,13,is,1,7,10,3,6,2,-6,9,Tasman Peninsula,Tasmania,LOC-LOC,LOC,PROPN-PROPN,PROPN,compound-pobj,conj,NNP-NNP,NNP,2,1
3,0.0,13,is,1,7,12,5,6,0,-6,11,Tasman Peninsula,Australia,LOC-LOC,LOC,PROPN-PROPN,PROPN,compound-pobj,appos,NNP-NNP,NNP,4,1
4,0.0,13,is,1,10,12,2,9,0,-9,11,Tasmania,Australia,LOC,LOC,PROPN,PROPN,conj,appos,NNP,NNP,6,1
0,0.0,26,is,3,1,6,5,0,19,2,3,Super Mario World,1990,MISC-MISC-MISC,TIME,PROPN-PROPN-PROPN,NUM,compound-compound-nsubj,nummod,NNP-NNP-NNP,CD,5,1
1,0.0,26,is,3,1,16,15,0,9,2,13,Super Mario World,Nintendo,MISC-MISC-MISC,ORG,PROPN-PROPN-PROPN,PROPN,compound-compound-nsubj,pobj,NNP-NNP-NNP,NNP,6,1
2,2.0,37,control,13,19,10,-9,18,26,-6,-3,Luigi,Mario,PER,PER,PROPN,PROPN,appos,dobj,NNP,NNP,7,1
3,11.0,74,was,9,16,33,17,15,40,-7,24,Super Mario World : Super Mario Advance 2,Game Boy Advance,MISC-MISC-MISC-MISC-MISC-MISC-MISC-MISC,MISC-MISC-MISC,PROPN-PROPN-PROPN-PUNCT-PROPN-PROPN-PROPN-NUM,PROPN-PROPN-PROPN,compound-compound-pobj-punct-compound-compound-ROOT-nummod,compound-compound-pobj,NNP-NNP-NNP-:-NNP-NNP-NNP-CD,NNP-NNP-NNP,8,1
4,11.0,74,was,9,16,50,34,15,23,-7,41,Super Mario World : Super Mario Advance 2,Virtual Console,MISC-MISC-MISC-MISC-MISC-MISC-MISC-MISC,MISC-MISC,PROPN-PROPN-PROPN-PUNCT-PROPN-PROPN-PROPN-NUM,PROPN-PROPN,compound-compound-pobj-punct-compound-compound-ROOT-nummod,compound-pobj,NNP-NNP-NNP-:-NNP-NNP-NNP-CD,NNP-NNP,8,1
5,11.0,74,was,9,16,54,38,15,19,-7,45,Super Mario World : Super Mario Advance 2,Wii,MISC-MISC-MISC-MISC-MISC-MISC-MISC-MISC,MISC,PROPN-PROPN-PROPN-PUNCT-PROPN-PROPN-PROPN-NUM,PROPN,compound-compound-pobj-punct-compound-compound-ROOT-nummod,pobj,NNP-NNP-NNP-:-NNP-NNP-NNP-CD,NNP,9,1
6,11.0,74,was,9,16,54,38,15,19,-7,45,Super Mario World : Super Mario Advance 2,Wii U,MISC-MISC-MISC-MISC-MISC-MISC-MISC-MISC,MISC-MISC,PROPN-PROPN-PROPN-PUNCT-PROPN-PROPN-PROPN-NUM,PROPN-NOUN,compound-compound-pobj-punct-compound-compound-ROOT-nummod,compound-conj,NNP-NNP-NNP-:-NNP-NNP-NNP-CD,NNP-NN,9,1
7,11.0,74,was,9,16,60,44,15,13,-7,51,Super Mario World : Super Mario Advance 2,New Nintendo 3DS,MISC-MISC-MISC-MISC-MISC-MISC-MISC-MISC,MISC-MISC-MISC,PROPN-PROPN-PROPN-PUNCT-PROPN-PROPN-PROPN-NUM,PROPN-PROPN-NUM,compound-compound-pobj-punct-compound-compound-ROOT-nummod,nmod-nmod-nummod,NNP-NNP-NNP-:-NNP-NNP-NNP-CD,NNP-NNP-CD,12,1
8,11.0,74,was,9,16,27,11,15,46,-7,18,Super Mario All - Stars + Super Mario World,SNES,MISC-MISC-MISC-MISC-MISC-MISC-MISC-MISC-MISC,MISC,PROPN-PROPN-PROPN-PUNCT-PROPN-SYM-PROPN-PROPN-PROPN,PROPN,compound-appos-compound-punct-nsubjpass-cc-compound-compound-conj,pobj,NNP-NNP-NNP-HYPH-NNPS-SYM-NNP-NNP-NNP,NNP,5,1
0,3.0,45,said,33,14,25,11,13,19,19,-8,You Only Live Twice,1967,MISC-MISC-MISC-MISC,TIME,PRON-ADV-VERB-PROPN,NUM,nmod-advmod-compound-pobj,nummod,PRP-RB-VBP-NNP,CD,7,1
0,0.0,20,is,9,1,6,5,0,13,8,-3,Marco Amelia,2 April 1982,PER-PER,TIME-TIME-TIME,PROPN-PROPN,NUM-PROPN-NUM,compound-nsubj,nummod-npadvmod-nummod,NNP-NNP,CD-NNP-CD,2,1
1,2.0,37,spent,6,6,15,9,5,21,0,9,Amelia,Livorno,PER,ORG,PROPN,PROPN,nsubj,pobj,NNP,NNP,6,1
0,0.0,17,was,12,1,5,4,0,11,11,-7,Peter Arnoldus Petersen,21 March 1851,PER-PER-PER,TIME-TIME-TIME,PROPN-PROPN-PROPN,NUM-PROPN-NUM,compound-compound-nsubj,nummod-appos-nummod,NNP-NNP-NNP,CD-NNP-CD,2,1
1,0.0,17,was,12,1,9,8,0,7,11,-3,Peter Arnoldus Petersen,12 August 1916,PER-PER-PER,TIME-TIME-TIME,PROPN-PROPN-PROPN,NUM-PROPN-NUM,compound-compound-nsubj,nummod-appos-nummod,NNP-NNP-NNP,CD-NNP-CD,3,1
2,0.0,17,was,12,1,15,14,0,1,11,3,Peter Arnoldus Petersen,Norwegian,PER-PER-PER,LOC,PROPN-PROPN-PROPN,ADJ,compound-compound-nsubj,amod,NNP-NNP-NNP,JJ,3,1
3,2.0,33,died,3,24,29,5,23,3,-21,26,Peter J. K. Petersen,1821,PER-PER-PER-PER,TIME,PROPN-PROPN-PROPN-PROPN,NUM,compound-compound-compound-pobj,nummod,NNP-NNP-NNP-NNP,CD,3,1
0,0.0,23,is,6,12,14,2,11,8,-6,8,Cincinnati,Ohio,LOC,LOC,PROPN,PROPN,pobj,appos,NNP,NNP,4,1
0,0.0,19,is,1,1,8,7,0,10,0,7,Bristol,Hartford County,LOC,LOC-LOC,PROPN,PROPN-PROPN,nsubj,compound-pobj,NNP,NNP-NNP,4,1
1,0.0,19,is,1,1,11,10,0,7,0,10,Bristol,Connecticut,LOC,LOC,PROPN,PROPN,nsubj,conj,NNP,NNP,5,1
2,0.0,19,is,1,8,11,3,7,7,-7,10,Hartford County,Connecticut,LOC-LOC,LOC,PROPN-PROPN,PROPN,compound-pobj,conj,NNP-NNP,NNP,1,1
3,0.0,19,is,1,8,13,5,7,5,-7,12,Hartford County,United States,LOC-LOC,LOC-LOC,PROPN-PROPN,PROPN-PROPN,compound-pobj,compound-conj,NNP-NNP,NNP-NNP,1,1
4,0.0,19,is,1,11,13,2,10,5,-10,12,Connecticut,United States,LOC,LOC-LOC,PROPN,PROPN-PROPN,conj,compound-conj,NNP,NNP-NNP,2,1
5,4.0,19,is,1,6,9,3,5,9,-5,8,Lake Compounce,1846,LOC-LOC,TIME,PROPN-PROPN,NUM,compound-pobj,appos,NNP-NNP,CD,1,1
0,0.0,34,was,13,1,5,4,0,28,12,-8,Walther von Brauchitsch,4 October 1881,PER-PER-PER,TIME-TIME-TIME,PROPN-PROPN-PROPN,NUM-PROPN-NUM,compound-compound-nsubj,nummod-nmod-nummod,NNP-NNP-NNP,CD-NNP-CD,2,1
1,0.0,34,was,13,1,10,9,0,23,12,-3,Walther von Brauchitsch,18 October 1948,PER-PER-PER,TIME-TIME-TIME,PROPN-PROPN-PROPN,NUM-PROPN-NUM,compound-compound-nsubj,nummod-appos-nummod,NNP-NNP-NNP,CD-NNP-CD,2,1
2,6.0,20,played,1,8,14,6,7,5,-7,13,Battle of France,German,MISC-MISC-MISC,LOC,PROPN-ADP-PROPN,ADJ,pobj-prep-pobj,amod,NNP-IN-NNP,JJ,5,1
0,0.0,26,Siong,2,1,7,6,0,18,1,5,Wong Nai Siong,1849—1924,PER-PER-PER,TIME,PROPN-PROPN-PROPN,PUNCT,compound-compound-ROOT,ROOT,NNP-NNP-NNP,LS,2,1
1,1.0,42,served,1,37,41,4,36,0,-36,40,Republic of China,Taiwan,LOC-LOC-LOC,LOC,PROPN-ADP-PROPN,PROPN,pobj-prep-pobj,pobj,NNP-IN-NNP,NNP,12,1
2,2.0,20,led,2,14,19,5,13,0,-12,17,Malaysia,Sarawak,LOC,LOC,PROPN,PROPN,pobj,appos,NNP,NNP,7,1
3,2.0,20,led,2,17,19,2,16,0,-15,17,Sibu,Sarawak,LOC,LOC,PROPN,PROPN,appos,appos,NNP,NNP,8,1
0,0.0,23,is,3,1,19,18,0,3,2,16,Shaoxing,Zhejiang province,LOC,LOC-LOC,VERB,PROPN-NOUN,compound,compound-pobj,VBG,NNP-NN,9,1
1,0.0,23,is,3,1,22,21,0,0,2,19,Shaoxing,China,LOC,LOC,VERB,PROPN,compound,appos,VBG,NNP,3,1
2,0.0,23,is,3,15,19,4,14,3,-12,16,Hangzhou Bay,Zhejiang province,LOC-LOC,LOC-LOC,PROPN-PROPN,PROPN-NOUN,compound-pobj,compound-pobj,NNP-NNP,NNP-NN,2,1
3,0.0,23,is,3,15,22,7,14,0,-12,19,Hangzhou Bay,China,LOC-LOC,LOC,PROPN-PROPN,PROPN,compound-pobj,appos,NNP-NNP,NNP,6,1
4,0.0,23,is,3,19,22,3,18,0,-16,19,Zhejiang province,China,LOC-LOC,LOC,PROPN-NOUN,PROPN,compound-pobj,appos,NNP-NN,NNP,8,1
0,0.0,33,is,15,1,11,10,0,21,14,-4,Igor Yuriyevich Nikulin,Moscow,PER-PER-PER,LOC,PROPN-PROPN-PROPN,PROPN,compound-compound-compound,pobj,NNP-NNP-NNP,NNP,2,1
1,1.0,15,won,1,8,12,4,7,2,-7,11,1992 Olympic Games,Barcelona,MISC-MISC-MISC,LOC,NUM-PROPN-PROPN,PROPN,nummod-compound-pobj,pobj,CD-NNP-NNPS,NNP,4,1
2,1.0,15,won,1,8,14,6,7,0,-7,13,1992 Olympic Games,Spain,MISC-MISC-MISC,LOC,NUM-PROPN-PROPN,PROPN,nummod-compound-pobj,appos,CD-NNP-NNPS,NNP,4,1
3,1.0,15,won,1,12,14,2,11,0,-11,13,Barcelona,Spain,LOC,LOC,PROPN,PROPN,pobj,appos,NNP,NNP,6,1
4,3.0,18,finished,4,4,15,11,3,2,0,11,Yury,1964 Summer Olympics,PER,MISC-MISC-MISC,PROPN,NUM-PROPN-PROPN,appos,nummod-compound-pobj,NNP,CD-NNP-NNPS,3,1
0,0.0,31,was,11,1,4,3,0,26,10,-7,Leslie Mynard,19 December 1925,PER-PER,TIME-TIME-TIME,PROPN-PROPN,NUM-PROPN-NUM,compound-nsubj,nummod-nmod-nummod,NNP-NNP,CD-NNP-CD,1,1
1,0.0,31,was,11,1,26,25,0,4,10,15,Leslie Mynard,Derby County,PER-PER,ORG-ORG,PROPN-PROPN,PROPN-PROPN,compound-nsubj,compound-conj,NNP-NNP,NNP-NNP,6,1
2,0.0,31,was,11,1,29,28,0,1,10,18,Leslie Mynard,Scunthorpe United,PER-PER,ORG-ORG,PROPN-PROPN,PROPN-PROPN,compound-nsubj,compound-conj,NNP-NNP,NNP-NNP,7,1
3,1.0,14,joined,1,1,13,12,0,0,0,12,Mynard,Bewdley,PER,ORG,ADJ,PROPN,nsubj,pobj,JJ,NNP,1,1
0,0.0,34,Andreas,0,1,7,6,0,26,-1,7,Andreas ( Andres ) Berlin,20 May 1746,PER-PER-PER-PER-PER,TIME-TIME-TIME,PROPN-PUNCT-PROPN-PUNCT-PROPN,NUM-PROPN-NUM,ROOT-punct-appos-punct-nsubj,nummod-nmod-nummod,NNP--LRB--NNP--RRB--NNP,CD-NNP-CD,4,1
1,1.0,70,son,1,4,7,3,3,62,-3,6,Henrik Berlin,1704,PER-PER,TIME,PROPN-PROPN,NUM,compound-pobj,nummod,NNP-NNP,CD,3,1
2,1.0,70,son,1,14,18,4,13,51,-13,17,Anna Catharina Hellström,1711,PER-PER-PER,TIME,PROPN-PROPN-PROPN,NUM,compound-appos-appos,nummod,NNP-NNP-NNP,CD,3,1
0,0.0,18,was,9,1,6,5,0,11,8,-3,Vera Ilyinichna Matveyeva,1945,PER-PER-PER,TIME,PROPN-PROPN-PROPN,NUM,compound-compound-nsubj,npadvmod,NNP-NNP-NNP,CD,4,1
1,1.0,17,born,2,1,5,4,0,11,1,3,Matveyeva,Kuybyshevka - Vostochnaya,PER,LOC-LOC-LOC,PROPN,PROPN-PUNCT-PROPN,nsubjpass,compound-punct-pobj,NNP,NNP-HYPH-NNP,4,1
2,4.0,16,enrolled,4,4,7,3,3,8,0,3,Matveyeva,Moscow Institute of Construction Engineering,PER,ORG-ORG-ORG-ORG-ORG,PROPN,PROPN-PROPN-ADP-PROPN-PROPN,nsubj,compound-pobj-prep-compound-pobj,NNP,NNP-NNP-IN-NNP-NNP,2,1
0,0.0,35,was,18,1,4,3,0,30,17,-14,Ernest Durig,1894,PER-PER,TIME,PROPN-PROPN,NUM,compound-nsubj,appos,NNP-NNP,CD,1,1
1,0.0,35,was,18,1,6,5,0,28,17,-12,Ernest Durig,Zurich,PER-PER,LOC,PROPN-PROPN,PROPN,compound-nsubj,pobj,NNP-NNP,NNP,4,1
2,0.0,35,was,18,1,10,9,0,24,17,-8,Ernest Durig,1962,PER-PER,TIME,PROPN-PROPN,NUM,compound-nsubj,nummod,NNP-NNP,CD,5,1
3,0.0,35,was,18,6,8,2,5,26,12,-10,Zurich,Switzerland,LOC,LOC,PROPN,PROPN,pobj,compound,NNP,NNP,2,1
4,3.0,17,included,2,8,6,-2,7,10,-6,4,Harry S. Truman,US,PER-PER-PER,LOC,PROPN-PROPN-PROPN,PROPN,compound-compound-conj,compound,NNP-NNP-NNP,NNP,2,1
0,0.0,30,is,7,2,29,27,1,0,5,22,Cairns - to - Kuranda Railway,Australia,LOC-LOC-LOC-LOC-LOC-LOC,LOC,PROPN-PUNCT-ADP-PUNCT-PROPN-PROPN,PROPN,nmod-punct-prep-punct-pobj-nsubj,appos,NNP-HYPH-IN-HYPH-NNP-NNP,NNP,4,1
1,0.0,30,is,7,2,27,25,1,2,5,20,Cairns Region,Queensland,LOC-LOC,LOC,PROPN-PROPN,PROPN,compound-pobj,pobj,NNP-NNP,NNP,7,1
2,0.0,30,is,7,2,29,27,1,0,5,22,Cairns Region,Australia,LOC-LOC,LOC,PROPN-PROPN,PROPN,compound-pobj,appos,NNP-NNP,NNP,4,1
3,0.0,30,is,7,27,29,2,26,0,-20,22,Queensland,Australia,LOC,LOC,PROPN,PROPN,pobj,appos,NNP,NNP,5,1
4,1.0,28,commences,1,4,9,5,3,18,-3,8,Redlynch,Cairns,LOC,LOC,PROPN,PROPN,pobj,pobj,NNP,NNPS,4,1
0,0.0,53,is,3,1,6,5,0,46,2,3,Caren Zeldie Turner,Democratic,PER-PER-PER,ORG,PROPN-PROPN-PROPN,ADJ,compound-compound-nsubj,amod,NNP-NNP-NNP,JJ,3,1
0,1.0,30,attempted,11,16,20,4,15,9,-5,9,Antoine Lahad,South Lebanon Army,PER-PER,ORG-ORG-ORG,PROPN-PROPN,PROPN-PROPN-PROPN,compound-dobj,compound-compound-pobj,NNP-NNP,NNP-NNP-NNP,3,1
1,9.0,32,used,6,15,18,3,14,13,-9,12,Incendies,Denis Villeneuve,MISC,PER-PER,PROPN,PROPN-PROPN,appos,compound-nsubj,NNPS,NNP-NNP,3,1
0,0.0,25,"""",0,2,14,12,1,10,-2,14,Irony,Wonder Girls,MISC,ORG-ORG,PROPN,PROPN-PROPN,nsubj,compound-appos,NNP,NNP-NNP,6,1
1,1.0,28,released,2,16,26,10,15,1,-14,24,The Wonder Years,JYP Entertainment,MISC-MISC-MISC,ORG-ORG,DET-PROPN-PROPN,PROPN-PROPN,det-compound-pobj,compound-pobj,DT-NNP-NNP,NNP-NNP,4,1
0,1.0,13,used,2,5,7,2,4,5,-3,5,AOL,AIM,ORG,MISC,PROPN,PROPN,poss,compound,NNP,NNP,4,1
1,7.0,12,carried,3,9,7,-2,8,4,-6,4,MobileMe,Apple,MISC,ORG,PROPN,PROPN,compound,poss,NNP,NNP,2,1
2,10.0,40,released,7,10,7,-3,9,32,-3,0,AIM SDK,AOL,MISC-MISC,ORG,PROPN-PROPN,PROPN,compound-dobj,nsubj,NNP-NNP,NNP,1,1
3,10.0,40,released,7,10,7,-3,9,32,-3,0,AIM Triton,AOL,MISC-MISC,ORG,PROPN-PROPN,PROPN,compound-pobj,nsubj,NNP-NNP,NNP,1,1
0,0.0,26,is,9,1,6,5,0,19,8,-3,Saidai Samiyappan Duraisamy,16 February 1952,PER-PER-PER,TIME-TIME-TIME,PROPN-PROPN-PROPN,NUM-PROPN-NUM,compound-compound-nsubj,nummod-npadvmod-nummod,NNP-NNP-NNP,CD-NNP-CD,3,1
1,0.0,26,is,9,1,12,11,0,13,8,3,Saidai Samiyappan Duraisamy,Indian,PER-PER-PER,LOC,PROPN-PROPN-PROPN,ADJ,compound-compound-nsubj,amod,NNP-NNP-NNP,JJ,-1,1
0,0.0,22,"""",0,2,11,9,1,10,-2,11,January February,Barbara Dickson,MISC-MISC,PER-PER,PROPN-PROPN,PROPN-PROPN,compound-nsubj,compound-pobj,NNP-NNP,NNP-NNP,4,1
1,0.0,22,"""",0,2,20,18,1,1,-2,20,January February,Epic Records,MISC-MISC,ORG-ORG,PROPN-PROPN,PROPN-PROPN,compound-nsubj,compound-pobj,NNP-NNP,NNP-NNPS,5,1
2,0.0,22,"""",0,11,20,9,10,1,-11,20,Barbara Dickson,Epic Records,PER-PER,ORG-ORG,PROPN-PROPN,PROPN-PROPN,compound-pobj,compound-pobj,NNP-NNP,NNP-NNPS,5,1
0,4.0,100,becomes,34,5,8,3,4,91,29,-26,Jack Donaghy,Alec Baldwin,PER-PER,PER-PER,PROPN-PROPN,PROPN-PROPN,compound-nsubj,compound-appos,NNP-NNP,NNP-NNP,1,1
1,4.0,100,becomes,34,29,32,3,28,67,5,-2,Liz Lemon,Tina Fey,PER-PER,PER-PER,PROPN-PROPN,PROPN-PROPN,compound-nsubj,compound-appos,NNP-NNP,NNP-NNP,1,1
2,4.0,100,becomes,34,64,67,3,63,32,-30,33,Jenna Maroney,Jane Krakowski,PER-PER,PER-PER,PROPN-PROPN,PROPN-PROPN,compound-nsubj,compound-appos,NNP-NNP,NNP-NNP,1,1
0,0.0,22,McCrate,2,1,10,9,0,11,1,8,John Dennis McCrate,"September 11 , 1879",PER-PER-PER,TIME-TIME-TIME-TIME,PROPN-PROPN-PROPN,PROPN-NUM-PUNCT-NUM,compound-compound-ROOT,nsubj-nummod-punct-nummod,NNP-NNP-NNP,"NNP-CD-,-CD",3,1
1,2.0,8,graduated,1,1,4,3,0,3,0,3,McCrate,Bowdoin College,PER,ORG-ORG,PROPN,PROPN-PROPN,nsubj,compound-pobj,NNP,NNP-NNP,2,1
2,5.0,24,elected,2,1,6,5,0,17,1,4,McCrate,Democrat,PER,ORG,PROPN,PROPN,nsubjpass,pobj,NNP,NNP,2,1
0,0.0,26,was,13,20,25,5,19,0,-7,12,Paris Foreign Missions Society,Vietnam,ORG-ORG-ORG-ORG,LOC,PROPN-PROPN-PROPN-PROPN,PROPN,compound-compound-compound-pobj,pobj,NNP-NNP-NNPS-NNP,NNP,6,1
1,2.0,8,born,2,5,7,2,4,0,-3,5,Montperreux,Doubs,LOC,LOC,PROPN,PROPN,pobj,appos,NNP,NNP,4,1
0,2.0,16,made,1,7,9,2,6,6,-6,8,Vaali,1999,PER,TIME,PROPN,NUM,pobj,pobj,NNP,CD,4,1
1,3.0,26,include,4,11,13,2,10,12,-7,9,New,2004,MISC,TIME,PROPN,NUM,appos,appos,NNP,CD,2,1
2,3.0,26,include,4,16,19,3,15,6,-12,15,Anbe Aaruyire,2005,MISC-MISC,TIME,PROPN-PROPN,NUM,compound-appos,appos,NNP-NNP,CD,1,1
3,3.0,26,include,4,22,24,2,21,1,-18,20,Isai,2015,MISC,TIME,PROPN,NUM,conj,npadvmod,NNP,CD,2,1
4,4.0,47,made,1,16,19,3,15,27,-15,18,Kalvanin Kadhali,2006,MISC-MISC,TIME,PROPN-PROPN,NUM,compound-pobj,appos,NNP-NNP,CD,1,1
0,0.0,34,"""",0,19,22,3,18,11,-19,22,Eurovision Song Contest,1992,MISC-MISC-MISC,TIME,PROPN-PROPN-PROPN,NUM,compound-compound-pobj,appos,NNP-NNP-NNP,CD,5,1
1,0.0,34,"""",0,19,31,12,18,2,-19,31,Eurovision Song Contest,Ondina Veloso,MISC-MISC-MISC,LOC-LOC,PROPN-PROPN-PROPN,PROPN-PROPN,compound-compound-pobj,compound-dobj,NNP-NNP-NNP,NNP-NNP,9,1
0,7.0,37,is,18,2,28,26,1,8,16,10,Afghanistan,Dari,LOC,MISC,PROPN,PROPN,pobj,oprd,NNP,NNP,4,1
1,8.0,33,diverged,2,5,11,6,4,21,-3,9,Persian,Iran,MISC,LOC,PROPN,PROPN,pobj,conj,NNP,NNP,2,1
0,0.0,16,was,11,1,4,3,0,11,10,-7,René Frémin,1 October 1672,PER-PER,TIME-TIME-TIME,PROPN-PROPN,NUM-PROPN-NUM,compound-nsubj,nummod-appos-nummod,NNP-NNP,CD-NNP-CD,1,1
1,0.0,16,was,11,1,8,7,0,7,10,-3,René Frémin,17 February 1744,PER-PER,TIME-TIME-TIME,PROPN-PROPN,NUM-PROPN-NUM,compound-nsubj,nummod-appos-nummod,NNP-NNP,CD-NNP-CD,2,1
2,4.0,23,produced,5,15,20,5,14,2,-10,15,Hall of Mirrors,Palace of Versailles,LOC-LOC-LOC,LOC-LOC-LOC,PROPN-ADP-PROPN,PROPN-ADP-PROPN,conj-prep-pobj,pobj-prep-pobj,NNP-IN-NNPS,NNP-IN-NNPS,4,1
3,6.0,30,worked,6,9,16,7,8,13,-3,10,Madrid,Spain,LOC,LOC,PROPN,PROPN,pobj,pobj,NNP,NNP,2,1
4,6.0,30,worked,6,13,16,3,12,13,-7,10,Philip V,Spain,PER-PER,LOC,PROPN-PROPN,PROPN,compound-nsubj,pobj,NNP-NNP,NNP,1,1
0,0.0,28,is,5,18,2,-16,17,25,-13,-3,Shapingba,Chongqing,LOC,LOC,PROPN,PROPN,compound,pobj,NNP,NNP,6,1
0,0.0,36,is,4,2,7,5,1,28,2,3,Book of Abraham,1835,MISC-MISC-MISC,TIME,PROPN-ADP-PROPN,NUM,nsubj-prep-pobj,nummod,NNP-IN-NNP,CD,3,1
0,0.0,22,was,17,1,4,3,0,17,16,-13,Franz Breit,1 July 1817,PER-PER,TIME-TIME-TIME,PROPN-PROPN,NUM-PROPN-NUM,compound-nsubj,nummod-appos-nummod,NNP-NNP,CD-NNP-CD,1,1
1,0.0,22,was,17,1,9,8,0,12,16,-8,Franz Breit,Mieders,PER-PER,LOC,PROPN-PROPN,PROPN,compound-nsubj,compound,NNP-NNP,NNP,1,1
2,0.0,22,was,17,1,11,10,0,10,16,-6,Franz Breit,17 August 1868,PER-PER,TIME-TIME-TIME,PROPN-PROPN,NUM-PROPN-NUM,compound-nsubj,nummod-appos-nummod,NNP-NNP,CD-NNP-CD,2,1
3,0.0,22,was,17,1,16,15,0,5,16,-1,Franz Breit,Tübingen,PER-PER,LOC,PROPN-PROPN,PROPN,compound-nsubj,pobj,NNP-NNP,NNP,2,1
4,1.0,33,studied,1,5,32,27,4,0,-4,31,Vienna General Hospital,Austria,ORG-ORG-ORG,LOC,PROPN-PROPN-PROPN,PROPN,compound-compound-pobj,pobj,NNP-NNP-NNP,NNP,4,1
5,1.0,33,studied,1,5,5,0,4,27,-4,4,Vienna General Hospital,Vienna,ORG-ORG-ORG,LOC,PROPN-PROPN-PROPN,PROPN,compound-compound-pobj,pobj,NNP-NNP-NNP,NNP,0,1
6,1.0,33,studied,1,32,5,-27,31,27,-31,4,Austria,Vienna,LOC,LOC,PROPN,PROPN,pobj,pobj,NNP,NNP,4,1
0,0.0,27,born,3,1,5,4,0,21,2,2,Timo Werner,6 March 1996,PER-PER,TIME-TIME-TIME,PROPN-PROPN,NUM-PROPN-NUM,compound-compound,nummod-npadvmod-nummod,NNP-NNP,CD-NNP-CD,2,1
1,0.0,27,born,3,1,24,23,0,2,2,21,Timo Werner,Germany national team,PER-PER,ORG-ORG-ORG,PROPN-PROPN,PROPN-ADJ-NOUN,compound-compound,nmod-amod-conj,NNP-NNP,NNP-JJ-NN,-1,1
2,1.0,28,became,9,9,17,8,8,10,0,8,Werner,VfB Stuttgart,PER,ORG-ORG,PROPN,NOUN-PROPN,nsubj,compound-dobj,NNP,NN-NNP,3,1
0,0.0,34,is,24,1,23,22,0,10,23,-1,Ljubljana Town Hall,Slovenia,LOC-LOC-LOC,LOC,PROPN-PROPN-PROPN,PROPN,compound-compound-nsubj,pobj,NNP-NNP-NNP,NNP,4,1
1,0.0,34,is,24,1,23,22,0,10,23,-1,Ljubljana,Slovenia,LOC,LOC,PROPN,PROPN,pobj,pobj,NNP,NNP,4,1
2,0.0,34,is,24,1,30,29,0,3,23,6,Ljubljana,City Municipality of Ljubljana,LOC,LOC-LOC-LOC-LOC,PROPN,PROPN-PROPN-ADP-PROPN,pobj,compound-pobj-prep-pobj,NNP,NNP-NNP-IN-NNP,6,1
3,0.0,34,is,24,23,30,7,22,3,1,6,Slovenia,City Municipality of Ljubljana,LOC,LOC-LOC-LOC-LOC,PROPN,PROPN-PROPN-ADP-PROPN,pobj,compound-pobj-prep-pobj,NNP,NNP-NNP-IN-NNP,4,1
0,0.0,34,was,10,2,23,21,1,10,8,13,Vilayet,Ottoman Empire,LOC,LOC-LOC,PROPN,PROPN-PROPN,nsubj,compound-pobj,NNP,NNP-NNP,5,1
0,6.0,21,elected,2,1,6,5,0,14,1,4,Kocher,U.S. National Academy of Engineering,PER,ORG-ORG-ORG-ORG-ORG,PROPN,PROPN-PROPN-PROPN-ADP-PROPN,nsubjpass,compound-compound-pobj-prep-pobj,NNP,NNP-NNP-NNP-IN-NNP,4,1
0,0.0,73,is,12,69,19,-50,68,53,-57,7,Philadelphia,America,LOC,LOC,PROPN,PROPN,conj,poss,NNP,NNP,-1,1
1,0.0,73,is,12,71,19,-52,70,53,-59,7,Pennsylvania,America,LOC,LOC,PROPN,PROPN,npadvmod,poss,NNP,NNP,-1,1
2,0.0,73,is,12,19,36,17,18,36,-7,24,America,Florida,LOC,LOC,PROPN,PROPN,poss,npadvmod,NNP,NNP,-1,1
0,0.0,12,was,7,1,4,3,0,7,6,-3,Gerard Dillon,191614 June 1971,PER-PER,TIME-TIME-TIME,PROPN-PROPN,NUM-PROPN-NUM,compound-nsubj,subtok-appos-nummod,NNP-NNP,CD-NNP-CD,2,1
0,1.0,94,was,8,89,93,4,88,0,-81,85,Arlington Hall Station,Virginia,LOC-LOC-LOC,LOC,PROPN-PROPN-PROPN,PROPN,compound-compound-conj,appos,NNP-NNP-NNP,NNP,9,1
0,0.0,27,is,1,1,25,24,0,1,0,24,Mükemmel,Poll Production,MISC,ORG-ORG,PROPN,PROPN-PROPN,nsubj,compound-pobj,NNP,NNP-NNP,4,1
1,0.0,27,is,1,14,25,11,13,1,-13,24,Hande Yener,Poll Production,PER-PER,ORG-ORG,PROPN-PROPN,PROPN-PROPN,compound-pobj,compound-pobj,NNP-NNP,NNP-NNP,5,1
0,2.0,38,sustained,10,16,36,20,15,1,-6,26,Go - Go 's,IRS Records,MISC-MISC-MISC-MISC,MISC-MISC,PROPN-PUNCT-VERB-PART,PROPN-PROPN,compound-punct-pobj-case,compound-appos,NNP-HYPH-VB-POS,NNP-NNPS,2,1
1,8.0,24,appeared,15,4,14,10,3,9,11,-1,Androgynous,American Girl,MISC,MISC-MISC,PROPN,PROPN-PROPN,appos,compound-nsubj,NNP,NNP-NNP,4,1
2,10.0,18,was,12,1,10,9,0,7,11,-2,Miles Copeland III,Stewart Copeland,PER-PER-PER,PER-PER,PROPN-PROPN-PROPN,PROPN-PROPN,compound-compound-nsubj,compound-pobj,NNP-NNP-NNP,NNP-NNP,4,1
0,0.0,28,is,4,15,2,-13,14,25,-11,-2,Lee Hills Hall,Missouri,LOC-LOC-LOC,LOC,PROPN-PROPN-PROPN,PROPN,compound-compound-pobj,appos,NNP-NNP-NNP,NNP,7,1
1,0.0,28,is,4,2,2,0,1,25,2,-2,Missouri School of Journalism,Missouri,ORG-ORG-ORG-ORG,LOC,PROPN-PROPN-ADP-PROPN,PROPN,compound-pobj-prep-pobj,appos,NNP-NNP-IN-NNP,NNP,0,1
0,7.0,21,is,12,15,19,4,14,1,-3,7,Crazy,Gnarls Barkley,MISC,PER-PER,PROPN,PROPN-PROPN,attr,compound-pobj,NNP,NNP-NNP,4,1
0,1.0,12,born,2,11,8,-3,10,3,-9,6,Ohio,Delaware County,LOC,LOC-LOC,PROPN,PROPN-PROPN,appos,compound-pobj,NNP,NNP-NNP,5,1
1,7.0,11,died,1,4,6,2,3,4,-3,5,Bellville,Richland County,LOC,LOC-LOC,PROPN,PROPN-PROPN,pobj,compound-appos,NNP,NNP-NNP,2,1
2,7.0,11,died,1,6,10,4,5,0,-5,9,Richland County,Ohio,LOC-LOC,LOC,PROPN-PROPN,PROPN,compound-appos,appos,NNP-NNP,NNP,4,1
0,0.0,34,was,10,2,16,14,1,17,8,6,Duchy of Nassau,1806,LOC-LOC-LOC,TIME,PROPN-ADP-PROPN,NUM,nsubj-prep-pobj,pobj,NNP-IN-NNP,CD,6,1
1,1.0,17,was,1,7,15,8,6,1,-6,14,Confederation of the Rhine,German Confederation,ORG-ORG-ORG-ORG,ORG-ORG,PROPN-ADP-DET-NOUN,PROPN-PROPN,pobj-prep-det-pobj,amod-pobj,NNP-IN-DT-NN,NNP-NNP,7,1
0,0.0,28,is,4,1,15,14,0,12,3,11,Pa'l Mundo,Wisin & Yandel,MISC-MISC,ORG-ORG-ORG,PROPN-PROPN,PROPN-CCONJ-PROPN,compound-nsubj,pobj-cc-conj,NNP-NNP,NNP-CC-NNP,5,1
1,0.0,28,is,4,1,26,25,0,1,3,22,Pa'l Mundo,Machete Music,MISC-MISC,ORG-ORG,PROPN-PROPN,PROPN-PROPN,compound-nsubj,compound-pobj,NNP-NNP,NNP-NNP,5,1
2,0.0,28,is,4,15,26,11,14,1,-11,22,Wisin & Yandel,Machete Music,ORG-ORG-ORG,ORG-ORG,PROPN-CCONJ-PROPN,PROPN-PROPN,pobj-cc-conj,compound-pobj,NNP-CC-NNP,NNP-NNP,6,1
0,0.0,19,is,6,1,11,10,0,7,5,5,The Tuen Ma line,MTR,LOC-LOC-LOC-LOC,ORG,DET-PROPN-PROPN-NOUN,PROPN,det-compound-compound-nsubj,compound,DT-NNP-NNP-NN,NNP,5,1
0,0.0,17,played,8,1,7,6,0,9,7,-1,Kaji Biraj Thapa Magar,1721,PER-PER-PER-PER,TIME,PROPN-PROPN-PROPN-PROPN,NUM,compound-compound-compound-nsubj,npadvmod,NNP-NNP-NNP-NNP,CD,3,1
1,3.0,20,taken,7,9,14,5,8,5,-2,7,Narabhupal Shah,Malikavati,PER-PER,PER,PROPN-PROPN,PROPN,compound-dobj,appos,NNP-NNP,NNP,2,1
2,6.0,20,began,10,5,19,14,4,0,5,9,Prithvi Narayan Shah,Nepal,PER-PER-PER,LOC,PROPN-PROPN-PROPN,PROPN,compound-compound-appos,dobj,NNP-NNP-NNP,NNP,4,1
0,0.0,33,was,16,1,3,2,0,29,15,-13,Doublehead,1744,PER,TIME,PROPN,NUM,nsubj,nummod,NNP,CD,3,1
1,0.0,33,was,16,1,5,4,0,27,15,-11,Doublehead,1807,PER,TIME,PROPN,NUM,nsubj,nummod,NNP,CD,2,1
2,2.0,18,was,3,12,14,2,11,3,-9,11,U.S.,George Washington,LOC,PER-PER,PROPN,PROPN-PROPN,compound,compound-dobj,NNP,NNP-NNP,1,1
3,3.0,30,served,12,7,10,3,6,19,5,-2,Tellico Blockhouse,1794,LOC-LOC,TIME,PROPN-PROPN,NUM,compound-pobj,pobj,NNP-NNP,CD,5,1
4,4.0,31,chosen,17,10,14,4,9,16,7,-3,John Watts,1802,PER-PER,TIME,PROPN-PROPN,NUM,compound-nsubjpass,pobj,NNP-NNP,CD,2,1
0,0.0,28,is,6,15,26,11,14,1,-9,20,Sabrina Carpenter,Hollywood Records,PER-PER,ORG-ORG,PROPN-PROPN,PROPN-PROPN,compound-pobj,compound-pobj,NNP-NNP,NNP-NNPS,5,1
1,4.0,26,followed,2,8,16,8,7,9,-6,14,All We Have Is Love,Run and Hide,MISC-MISC-MISC-MISC-MISC,MISC-MISC-MISC,DET-PRON-VERB-VERB-NOUN,PROPN-CCONJ-PROPN,nsubj-nsubj-relcl-ROOT-attr,conj-cc-conj,DT-PRP-VBP-VBZ-NN,NNP-CC-NNP,5,1
0,0.0,33,was,12,1,5,4,0,27,11,-7,Rahul Dev Burman,27 June 1939,PER-PER-PER,TIME-TIME-TIME,PROPN-PROPN-PROPN,NUM-PROPN-NUM,compound-compound-nsubj,nummod-appos-nummod,NNP-NNP-NNP,CD-NNP-CD,2,1
1,0.0,33,was,12,1,9,8,0,23,11,-3,Rahul Dev Burman,4 January 1994,PER-PER-PER,TIME-TIME-TIME,PROPN-PROPN-PROPN,NUM-PROPN-NUM,compound-compound-nsubj,nummod-appos-nummod,NNP-NNP-NNP,CD-NNP-CD,2,1
2,1.0,15,was,4,2,12,10,1,2,2,8,Pancham,Sachin Dev Burman,PER,PER-PER-PER,PROPN,PROPN-PROPN-PROPN,npadvmod,compound-compound-pobj,NNP,NNP-NNP-NNP,-1,1
3,4.0,26,did,1,1,6,5,0,19,0,5,Burman,Asha Bhosle,PER,PER-PER,PROPN,PROPN-PROPN,nsubj,compound-pobj,NNP,NNP-NNP,2,1
0,1.0,26,released,2,22,11,-11,21,14,-20,9,Bad,1987,MISC,TIME,ADJ,NUM,appos,npadvmod,JJ,CD,5,1
1,3.0,54,featured,14,33,37,4,32,16,-19,23,The Ultimate Collection,2004,MISC-MISC-MISC,TIME,DET-PROPN-PROPN,NUM,det-compound-conj,pobj,DT-NNP-NNP,CD,2,1
2,3.0,54,featured,14,49,53,4,48,0,-35,39,This Is It,2009,MISC-MISC-MISC,TIME,DET-VERB-PRON,NUM,conj-ROOT-nsubj,pobj,DT-VBZ-PRP,CD,1,1
3,9.0,54,performed,4,28,33,5,27,20,-24,29,This Is It,2009,MISC-MISC-MISC,TIME,DET-VERB-PRON,NUM,pobj-ROOT-nsubj,pobj,DT-VBZ-PRP,CD,3,1
0,0.0,26,is,5,2,14,12,1,11,3,9,Luv Your Life,Silverchair,MISC-MISC-MISC,ORG,VERB-DET-NOUN,PROPN,csubj-poss-dobj,pobj,VB-PRP$-NN,NNP,5,1
1,0.0,26,is,5,2,25,23,1,0,3,20,Luv Your Life,2002,MISC-MISC-MISC,TIME,VERB-DET-NOUN,NUM,csubj-poss-dobj,pobj,VB-PRP$-NN,CD,4,1
2,0.0,26,is,5,19,25,6,18,0,-14,20,Diorama,2002,MISC,TIME,PROPN,NUM,appos,pobj,NNP,CD,5,1
0,2.0,9,Lashkar,0,1,7,6,0,1,-1,7,Lashkar,1989,MISC,TIME,PROPN,NUM,ROOT,nummod,NNP,CD,4,1
1,3.0,18,Laskhar,0,1,7,6,0,10,-1,7,Laskhar,2008,MISC,TIME,PROPN,NUM,ROOT,nummod,NNP,CD,5,1
2,3.0,18,Laskhar,0,1,17,16,0,0,-1,17,Laskhar,HarperCollins,MISC,ORG,PROPN,PROPN,ROOT,pobj,NNP,NNP,3,1
3,6.0,12,Lashkargah,0,1,7,6,0,4,-1,7,Lashkargah,Afghanistan,LOC,LOC,PROPN,PROPN,ROOT,pobj,NNP,NNP,3,1
4,6.0,12,Lashkargah,0,1,11,10,0,0,-1,11,Lashkargah,Helmand Province,LOC,LOC-LOC,PROPN,PROPN-PROPN,ROOT,compound-pobj,NNP,NNP-NNP,5,1
5,6.0,12,Lashkargah,0,7,11,4,6,0,-7,11,Afghanistan,Helmand Province,LOC,LOC-LOC,PROPN,PROPN-PROPN,pobj,compound-pobj,NNP,NNP-NNP,4,1
0,0.0,21,is,2,1,18,17,0,2,1,16,The Moviegoer,Vintage,MISC-MISC,ORG,DET-PROPN,PROPN,det-nsubj,pobj,DT-NNP,NNP,3,1
1,0.0,21,is,2,1,20,19,0,0,1,18,The Moviegoer,1961,MISC-MISC,TIME,DET-PROPN,NUM,det-nsubj,pobj,DT-NNP,CD,2,1
2,8.0,27,draws,3,8,25,17,7,1,-5,22,Dante,Divine Comedy,PER,MISC-MISC,PROPN,PROPN-PROPN,pobj,compound-pobj,NNP,NNP-NNP,7,1
0,0.0,28,DesBrisay,3,1,6,5,0,21,2,3,Lestock Peach Wilson DesBrisay,"March 28 , 1820",PER-PER-PER-PER,TIME-TIME-TIME-TIME,PROPN-PROPN-PROPN-PROPN,PROPN-NUM-PUNCT-NUM,compound-compound-compound-ROOT,appos-nummod-punct-nummod,NNP-NNP-NNP-NNP,"NNP-CD-,-CD",4,1
1,0.0,28,DesBrisay,3,1,11,10,0,16,2,8,Lestock Peach Wilson DesBrisay,"December 10 , 1872",PER-PER-PER-PER,TIME-TIME-TIME-TIME,PROPN-PROPN-PROPN-PROPN,PROPN-NUM-PUNCT-NUM,compound-compound-compound-ROOT,nsubj-nummod-punct-nummod,NNP-NNP-NNP-NNP,"NNP-CD-,-CD",5,1
0,2.0,41,have,3,38,12,-26,37,28,-35,9,New Zealand,Elizabeth II,LOC-LOC,PER-PER,PROPN-PROPN,PROPN-PROPN,compound-pobj,compound-pobj,NNP-NNP,NNP-NNP,11,1
1,2.0,41,have,3,34,12,-22,33,28,-31,9,Canada,Elizabeth II,LOC,PER-PER,PROPN,PROPN-PROPN,pobj,compound-pobj,NNP,NNP-NNP,9,1
2,3.0,26,have,5,1,15,14,0,10,4,10,New Zealand,United Nations,LOC-LOC,ORG-ORG,PROPN-PROPN,PROPN-PROPN,compound-nsubj,compound-conj,NNP-NNP,NNP-NNP,3,1
3,3.0,26,have,5,4,15,11,3,10,1,10,Canada,United Nations,LOC,ORG-ORG,PROPN,PROPN-PROPN,conj,compound-conj,NNP,NNP-NNP,3,1
0,2.0,23,donated,6,19,21,2,18,1,-13,15,Steve,Terri Irwin,PER,PER-PER,PROPN,PROPN-PROPN,pobj,compound-conj,NNP,NNP-NNP,2,1
0,0.0,24,was,13,1,6,5,0,17,12,-7,Johann Heinrich Rudolf Schenck,31 January 1860,PER-PER-PER-PER,TIME-TIME-TIME,PROPN-PROPN-PROPN-PROPN,NUM-PROPN-NUM,compound-compound-compound-nsubj,nummod-nmod-nummod,NNP-NNP-NNP-NNP,CD-NNP-CD,2,1
1,0.0,24,was,13,1,10,9,0,13,12,-3,Johann Heinrich Rudolf Schenck,25 June 1927,PER-PER-PER-PER,TIME-TIME-TIME,PROPN-PROPN-PROPN-PROPN,NUM-PROPN-NUM,compound-compound-compound-nsubj,nummod-appos-nummod,NNP-NNP-NNP-NNP,CD-NNP-CD,2,1
2,2.0,41,studied,3,25,29,4,24,11,-22,26,August Wilhelm Eichler,1839,PER-PER-PER,TIME,PROPN-PROPN-PROPN,NUM,compound-compound-pobj,nummod,NNP-NNP-NNP,CD,3,1
3,2.0,41,studied,3,25,31,6,24,9,-22,28,August Wilhelm Eichler,1887,PER-PER-PER,TIME,PROPN-PROPN-PROPN,NUM,compound-compound-pobj,nummod,NNP-NNP-NNP,CD,2,1
4,2.0,41,studied,3,34,37,3,33,3,-31,34,Simon Schwendener,1829,PER-PER,TIME,PROPN-PROPN,NUM,compound-conj,nummod,NNP-NNP,CD,2,1
5,2.0,41,studied,3,34,39,5,33,1,-31,36,Simon Schwendener,1919,PER-PER,TIME,PROPN-PROPN,NUM,compound-conj,nummod,NNP-NNP,CD,1,1
6,3.0,23,returned,2,10,13,3,9,9,-8,11,Eduard Strasburger,1844,PER-PER,TIME,PROPN-PROPN,NUM,compound-pobj,nummod,NNP-NNP,CD,4,1
7,3.0,23,returned,2,10,15,5,9,7,-8,13,Eduard Strasburger,1912,PER-PER,TIME,PROPN-PROPN,NUM,compound-pobj,nummod,NNP-NNP,CD,4,1
8,7.0,31,accompanied,5,7,12,5,6,18,-2,7,Andreas Franz Wilhelm Schimper,1856,PER-PER-PER-PER,TIME,PROPN-PROPN-PROPN-PROPN,NUM,compound-compound-compound-dobj,nummod,NNP-NNP-NNP-NNP,CD,3,1
9,7.0,31,accompanied,5,7,14,7,6,16,-2,9,Andreas Franz Wilhelm Schimper,1901,PER-PER-PER-PER,TIME,PROPN-PROPN-PROPN-PROPN,NUM,compound-compound-compound-dobj,nummod,NNP-NNP-NNP-NNP,CD,2,1
10,8.0,20,was,10,2,5,3,1,14,8,-5,George Karsten,1863,PER-PER,TIME,PROPN-PROPN,NUM,compound-pobj,nummod,NNP-NNP,CD,2,1
11,8.0,20,was,10,2,7,5,1,12,8,-3,George Karsten,1937,PER-PER,TIME,PROPN-PROPN,NUM,compound-pobj,nummod,NNP-NNP,CD,1,1
0,0.0,58,is,38,44,46,2,43,11,-6,8,Andes,Bolivia,LOC,LOC,PROPN,PROPN,pobj,pobj,NNP,NNP,4,1
0,0.0,32,was,17,5,10,5,4,21,12,-7,Charles Putnam Symonds,11 April 1890,PER-PER-PER,TIME-TIME-TIME,PROPN-PROPN-PROPN,NUM-PROPN-NUM,compound-compound-nsubj,nummod-nmod-nummod,NNP-NNP-NNPS,CD-NNP-CD,2,1
1,0.0,32,was,17,5,14,9,4,17,12,-3,Charles Putnam Symonds,7 December 1978,PER-PER-PER,TIME-TIME-TIME,PROPN-PROPN-PROPN,NUM-PROPN-NUM,compound-compound-nsubj,nummod-npadvmod-nummod,NNP-NNP-NNPS,CD-NNP-CD,2,1
2,4.0,39,completed,12,34,9,-25,33,29,-22,-3,Royal Flying Corps,United Kingdom,ORG-ORG-ORG,LOC-LOC,PROPN-PROPN-PROPN,PROPN-PROPN,compound-compound-pobj,compound-pobj,NNP-NNP-NNP,NNP-NNP,12,1
0,0.0,47,spelled,8,39,46,7,38,0,-31,38,South America,Colombia,LOC-LOC,LOC,PROPN-PROPN,PROPN,compound-pobj,pobj,NNP-NNP,NNP,4,1
1,5.0,14,suggested,3,10,12,2,9,1,-7,9,Cervantes,Don Quixote,PER,MISC-MISC,PROPN,PROPN-PROPN,poss,compound-pobj,NNP,NNP-NNP,2,1
0,0.0,19,is,14,1,6,5,0,12,13,-8,Yousef Mangoush,Benghazi,PER-PER,LOC,PROPN-PROPN,PROPN,compound-nsubj,pobj,NNP-NNP,NNP,4,1
1,0.0,19,is,14,1,8,7,0,10,13,-6,Yousef Mangoush,Cyrenaica,PER-PER,LOC,PROPN-PROPN,PROPN,compound-nsubj,conj,NNP-NNP,NNP,5,1
2,0.0,19,is,14,1,13,12,0,5,13,-1,Yousef Mangoush,1950,PER-PER,TIME,PROPN-PROPN,NUM,compound-nsubj,pobj,NNP-NNP,CD,2,1
3,0.0,19,is,14,6,10,4,5,8,8,-4,Benghazi,Libya,LOC,LOC,PROPN,PROPN,pobj,appos,NNP,NNP,6,1
4,0.0,19,is,14,8,10,2,7,8,6,-4,Cyrenaica,Libya,LOC,LOC,PROPN,PROPN,conj,appos,NNP,NNP,7,1
5,4.0,43,arrested,19,26,11,-15,25,31,-7,-8,Brega,Libyan,LOC,LOC,PROPN,ADJ,pobj,amod,NNP,JJ,4,1
6,4.0,43,arrested,19,42,11,-31,41,31,-23,-8,Tripoli,Libyan,LOC,LOC,PROPN,ADJ,pobj,amod,NNP,JJ,4,1
0,0.0,20,was,10,1,4,3,0,15,9,-6,Roberto Lardera,"December , 1911",PER-PER,TIME-TIME-TIME,PROPN-PROPN,PROPN-PUNCT-NUM,compound-nsubj,appos-punct-nummod,NNP-NNP,"NNP-,-CD",2,1
1,0.0,20,was,10,1,14,13,0,5,9,4,Roberto Lardera,Italian,PER-PER,LOC,PROPN-PROPN,ADJ,compound-nsubj,amod,NNP-NNP,JJ,2,1
2,2.0,16,born,2,5,8,3,4,7,-3,6,La Spezia,Italy,LOC-LOC,LOC,PROPN-PROPN,PROPN,compound-pobj,appos,NNP-NNP,NNP,2,1
3,4.0,16,moved,3,3,6,3,2,9,0,3,Lardera,Paris,PER,LOC,PROPN,PROPN,nsubj,pobj,NNP,NNP,3,1
0,0.0,23,is,2,1,22,21,0,0,1,20,Mazinaw Rock,Canada,LOC-LOC,LOC,PROPN-PROPN,PROPN,compound-nsubj,appos,NNP-NNP,NNP,2,1
1,0.0,23,is,2,9,20,11,8,2,-7,18,Addington Highlands,Ontario,LOC-LOC,LOC,PROPN-PROPN,PROPN,compound-pobj,conj,NNP-NNP,NNP,6,1
2,0.0,23,is,2,9,22,13,8,0,-7,20,Addington Highlands,Canada,LOC-LOC,LOC,PROPN-PROPN,PROPN,compound-pobj,appos,NNP-NNP,NNP,4,1
3,0.0,23,is,2,15,20,5,14,2,-13,18,Kaladar,Ontario,LOC,LOC,PROPN,PROPN,pobj,conj,NNP,NNP,3,1
4,0.0,23,is,2,15,22,7,14,0,-13,20,Kaladar,Canada,LOC,LOC,PROPN,PROPN,pobj,appos,NNP,NNP,3,1
5,0.0,23,is,2,20,22,2,19,0,-18,20,Ontario,Canada,LOC,LOC,PROPN,PROPN,conj,appos,NNP,NNP,4,1
6,2.0,24,reaches,9,19,22,3,18,1,-10,13,Ontario,Great Lakes,LOC,LOC-LOC,PROPN,PROPN-PROPN,pobj,compound-pobj,NNP,NNP-NNPS,1,1
0,0.0,93,coined,7,13,16,3,12,76,-6,9,Theodor Adorno,1903,PER-PER,TIME,PROPN-PROPN,NUM,compound-appos,nummod,NNP-NNP,CD,2,1
1,0.0,93,coined,7,13,18,5,12,74,-6,11,Theodor Adorno,1969,PER-PER,TIME,PROPN-PROPN,NUM,compound-appos,nummod,NNP-NNP,CD,1,1
2,0.0,93,coined,7,13,52,39,12,40,-6,45,Theodor Adorno,Dialectic of Enlightenment,PER-PER,MISC-MISC-MISC,PROPN-PROPN,PROPN-ADP-PROPN,compound-appos,appos-prep-pobj,NNP-NNP,NNP-IN-NNP,10,1
3,0.0,93,coined,7,21,24,3,20,68,-14,17,Max Horkheimer,1895,PER-PER,TIME,PROPN-PROPN,NUM,compound-conj,nummod,NNP-NNP,CD,2,1
4,0.0,93,coined,7,21,26,5,20,66,-14,19,Max Horkheimer,1973,PER-PER,TIME,PROPN-PROPN,NUM,compound-conj,nummod,NNP-NNP,CD,1,1
5,0.0,93,coined,7,21,52,31,20,40,-14,45,Max Horkheimer,Dialectic of Enlightenment,PER-PER,MISC-MISC-MISC,PROPN-PROPN,PROPN-ADP-PROPN,compound-conj,appos-prep-pobj,NNP-NNP,NNP-IN-NNP,8,1
6,0.0,93,coined,7,52,56,4,51,36,-45,49,Dialectic of Enlightenment,1944,MISC-MISC-MISC,TIME,PROPN-ADP-PROPN,NUM,appos-prep-pobj,appos,NNP-IN-NNP,CD,2,1
0,0.0,25,located,7,2,6,4,1,18,5,-1,First Baptist Church of Tarrytown,Tarrytown,ORG-ORG-ORG-ORG-ORG,LOC,PROPN-PROPN-PROPN-ADP-PROPN,PROPN,compound-compound-nsubjpass-prep-pobj,pobj,NNP-NNP-NNP-IN-NNP,NNP,3,1
1,0.0,25,located,7,2,23,21,1,1,5,16,First Baptist Church of Tarrytown,United States,ORG-ORG-ORG-ORG-ORG,LOC-LOC,PROPN-PROPN-PROPN-ADP-PROPN,PROPN-PROPN,compound-compound-nsubjpass-prep-pobj,compound-appos,NNP-NNP-NNP-IN-NNP,NNP-NNP,9,1
2,0.0,25,located,7,6,23,17,5,1,1,16,Tarrytown,United States,LOC,LOC-LOC,PROPN,PROPN-PROPN,pobj,compound-appos,NNP,NNP-NNP,8,1
3,0.0,25,located,7,20,23,3,19,1,-13,16,New York,United States,LOC-LOC,LOC-LOC,PROPN-PROPN,PROPN-PROPN,compound-conj,compound-appos,NNP-NNP,NNP-NNP,1,1
0,7.0,11,Smt,9,6,4,-2,5,6,3,-5,Shri Pranab Mukharjee,India,PER-PER-PER,LOC,PROPN-PROPN-PROPN,PROPN,compound-compound-appos,pobj,NNP-NNP-NNP,NNP,2,1
0,0.0,16,is,1,1,15,14,0,0,0,14,Meiningen,Germany,LOC,LOC,PROPN,PROPN,nsubj,appos,NNP,NNP,1,1
1,0.0,16,is,1,13,15,2,12,0,-12,14,Thuringia,Germany,LOC,LOC,PROPN,PROPN,pobj,appos,NNP,NNP,9,1
0,0.0,27,is,8,2,15,13,1,11,6,7,Jakarta International Film Festival,Indonesia,MISC-MISC-MISC-MISC,LOC,PROPN-PROPN-PROPN-PROPN,PROPN,compound-compound-compound-nsubj,pobj,NNP-NNP-NNP-NNP,NNP,3,1
1,0.0,27,is,8,2,26,24,1,0,6,18,Jakarta International Film Festival,1999,MISC-MISC-MISC-MISC,TIME,PROPN-PROPN-PROPN-PROPN,NUM,compound-compound-compound-nsubj,pobj,NNP-NNP-NNP-NNP,CD,3,1
2,0.0,27,is,8,15,2,-13,14,24,-7,-6,Indonesia,Jakarta,LOC,LOC,PROPN,PROPN,pobj,appos,NNP,NNP,3,1
0,0.0,34,is,4,2,31,29,1,2,2,27,Capital City Trail,Victoria,LOC-LOC-LOC,LOC,PROPN-PROPN-PROPN,PROPN,compound-compound-nsubj,conj,NNP-NNP-NNP,NNP,10,1
1,0.0,34,is,4,2,33,31,1,0,2,29,Capital City Trail,Australia,LOC-LOC-LOC,LOC,PROPN-PROPN-PROPN,PROPN,compound-compound-nsubj,appos,NNP-NNP-NNP,NNP,3,1
2,0.0,34,is,4,31,33,2,30,0,-27,29,Victoria,Australia,LOC,LOC,PROPN,PROPN,conj,appos,NNP,NNP,9,1
0,0.0,38,is,14,1,6,5,0,31,13,-8,Luisa Etxenike,10 July 1957,PER-PER,TIME-TIME-TIME,PROPN-PROPN,NUM-PROPN-NUM,compound-nsubj,nummod-pobj-nummod,NNP-NNP,CD-NNP-CD,3,1
1,0.0,38,is,14,1,10,9,0,27,13,-4,Luisa Etxenike,San Sebastián,PER-PER,LOC-LOC,PROPN-PROPN,PROPN-PROPN,compound-nsubj,compound-npadvmod,NNP-NNP,NNP-NNP,1,1
2,0.0,38,is,14,10,13,3,9,24,4,-1,San Sebastián,Spain,LOC-LOC,LOC,PROPN-PROPN,PROPN,compound-npadvmod,appos,NNP-NNP,NNP,2,1
3,0.0,38,is,14,10,20,10,9,17,4,6,San Sebastián,Basque Country,LOC-LOC,LOC-LOC,PROPN-PROPN,PROPN-PROPN,compound-npadvmod,compound-pobj,NNP-NNP,NNP-NNP,5,1
0,0.0,21,is,5,10,20,10,9,0,-5,15,Belgium,Flanders,LOC,LOC,PROPN,PROPN,pobj,pobj,NNP,NNP,2,1
1,3.0,17,is,1,1,5,4,0,11,0,4,Antwerp,River Scheldt,LOC,LOC-LOC,PROPN,PROPN-PROPN,nsubj,compound-pobj,NNP,NNP-NNP,2,1
2,3.0,17,is,1,5,11,6,4,5,-4,10,River Scheldt,North Sea,LOC-LOC,LOC-LOC,PROPN-PROPN,PROPN-PROPN,compound-pobj,compound-pobj,NNP-NNP,NNP-NNP,5,1
3,7.0,31,been,3,21,24,3,20,6,-18,21,Spanish Fury,1576,MISC-MISC,TIME,ADJ-PROPN,NUM,compound-pobj,appos,JJ-NNP,CD,1,1
0,0.0,26,was,21,1,5,4,0,20,20,-16,William Julius Mickle,29 September 1734,PER-PER-PER,TIME-TIME-TIME,PROPN-PROPN-PROPN,NUM-PROPN-NUM,compound-compound-nsubj,nummod-appos-nummod,NNP-NNP-NNP,CD-NNP-CD,2,1
1,0.0,26,was,21,1,9,8,0,16,20,-12,William Julius Mickle,Langholm,PER-PER-PER,LOC,PROPN-PROPN-PROPN,PROPN,compound-compound-nsubj,pobj,NNP-NNP-NNP,NNP,2,1
2,0.0,26,was,21,1,15,14,0,10,20,-6,William Julius Mickle,28 October 1788,PER-PER-PER,TIME-TIME-TIME,PROPN-PROPN-PROPN,NUM-PROPN-NUM,compound-compound-nsubj,nummod-appos-nummod,NNP-NNP-NNP,CD-NNP-CD,2,1
3,0.0,26,was,21,1,24,23,0,1,20,3,William Julius Mickle,Scottish,PER-PER-PER,LOC,PROPN-PROPN-PROPN,ADJ,compound-compound-nsubj,amod,NNP-NNP-NNP,JJ,3,1
4,2.0,17,moved,1,13,16,3,12,0,-12,15,Clarendon Press,Oxford,ORG-ORG,ORG,PROPN-PROPN,PROPN,compound-pobj,pobj,NNP-NNP,NNP,8,1
5,2.0,17,moved,1,16,4,-12,15,12,-15,3,Oxford,England,ORG,LOC,PROPN,PROPN,pobj,pobj,NNP,NNP,5,1
6,4.0,31,had,1,22,28,6,21,2,-21,27,Lusiad,Luís de Camões,MISC,PER-PER-PER,PROPN,PROPN-ADP-PROPN,pobj,compound-compound-pobj,NNP,NNP-IN-NNP,6,1
0,0.0,20,is,10,1,13,12,0,6,9,3,Joel Gordon Hodgson,American,PER-PER-PER,LOC,PROPN-PROPN-PROPN,ADJ,compound-compound-nsubj,amod,NNP-NNP-NNP,JJ,3,1
0,0.0,19,is,2,1,5,4,0,13,1,3,Wonder Boys,2000,MISC-MISC,TIME,PROPN-PROPN,NUM,compound-nsubj,nummod,NNP-NNPS,CD,4,1
1,0.0,19,is,2,1,12,11,0,6,1,10,Wonder Boys,Curtis Hanson,MISC-MISC,PER-PER,PROPN-PROPN,PROPN-PROPN,compound-nsubj,compound-pobj,NNP-NNPS,NNP-NNP,5,1
2,0.0,19,is,2,1,17,16,0,1,1,15,Wonder Boys,Steve Kloves,MISC-MISC,PER-PER,PROPN-PROPN,PROPN-PROPN,compound-nsubj,compound-pobj,NNP-NNPS,NNP-NNP,6,1
0,0.0,22,is,1,1,13,12,0,8,0,12,Cianjur,Indonesia,LOC,LOC,PROPN,PROPN,nsubj,pobj,NNP,NNP,1,1
1,0.0,22,is,1,1,1,0,0,20,0,0,Cianjur,Cianjur Regency,LOC,LOC-LOC,PROPN,PROPN-PROPN,nsubj,compound-pobj,NNP,NNP-NNP,0,1
2,0.0,22,is,1,9,13,4,8,8,-8,12,West Java,Indonesia,LOC-LOC,LOC,PROPN-PROPN,PROPN,compound-compound,pobj,NNP-NNP,NNP,5,1
0,0.0,21,born,4,1,6,5,0,14,3,2,Oleksandr Valentynovych Turchynov,31 March 1964,PER-PER-PER,TIME-TIME-TIME,PROPN-PROPN-PROPN,NUM-PROPN-NUM,compound-compound-compound,nummod-npadvmod-nummod,NNP-NNP-NNP,CD-NNP-CD,3,1
1,0.0,21,born,4,1,12,11,0,8,3,8,Oleksandr Valentynovych Turchynov,Ukrainian,PER-PER-PER,LOC,PROPN-PROPN-PROPN,ADJ,compound-compound-compound,amod,NNP-NNP-NNP,JJ,-1,1
2,2.0,36,is,1,30,24,-6,29,11,-29,23,Ukrainian,Petro Poroshenko,LOC,PER-PER,ADJ,PROPN-PROPN,amod,compound-nsubjpass,JJ,NNP-NNP,3,1
3,2.0,36,is,1,8,1,-7,7,34,-7,0,Ukraine,Turchynov,LOC,PER,PROPN,PROPN,pobj,nsubj,NNP,NNP,2,1
4,2.0,36,is,1,8,16,8,7,19,-7,15,Ukraine,Viktor Yanukovych,LOC,PER-PER,PROPN,PROPN-PROPN,pobj,compound-pobj,NNP,NNP-NNP,5,1
5,2.0,36,is,1,8,24,16,7,11,-7,23,Ukraine,Petro Poroshenko,LOC,PER-PER,PROPN,PROPN-PROPN,pobj,compound-nsubjpass,NNP,NNP-NNP,4,1
6,4.0,56,served,2,47,43,-4,46,12,-45,41,Mykola Azarov,Ukrainian,PER-PER,LOC,PROPN-PROPN,ADJ,compound-dobj,amod,NNP-NNP,JJ,3,1
7,6.0,30,was,1,11,28,17,10,1,-10,27,Batkivshchyna,Yulia Tymoshenko,ORG,PER-PER,PROPN,PROPN-PROPN,nmod,compound-pobj,NNP,NNP-NNP,9,1
0,0.0,26,Nippold,3,1,6,5,0,19,2,3,Friedrich Wilhelm Franz Nippold,"September 15 , 1838",PER-PER-PER-PER,TIME-TIME-TIME-TIME,PROPN-PROPN-PROPN-PROPN,PROPN-NUM-PUNCT-NUM,compound-compound-compound-ROOT,appos-nummod-punct-npadvmod,NNP-NNP-NNP-NNP,"NNP-CD-,-CD",3,1
1,0.0,26,Nippold,3,1,11,10,0,14,2,8,Friedrich Wilhelm Franz Nippold,"August 4 , 1918",PER-PER-PER-PER,TIME-TIME-TIME-TIME,PROPN-PROPN-PROPN-PROPN,PROPN-NUM-PUNCT-NUM,compound-compound-compound-ROOT,nsubj-nummod-punct-nummod,NNP-NNP-NNP-NNP,"NNP-CD-,-CD",3,1
2,0.0,26,Nippold,3,1,23,22,0,2,2,20,Friedrich Wilhelm Franz Nippold,Emmerich am Rhein,PER-PER-PER-PER,LOC-LOC-LOC,PROPN-PROPN-PROPN-PROPN,PROPN-VERB-PROPN,compound-compound-compound-ROOT,pobj-ccomp-attr,NNP-NNP-NNP-NNP,NNP-VBP-NNP,3,1
0,0.0,24,is,6,1,15,14,0,8,5,9,Umreth,Anand District,LOC,LOC-LOC,PROPN,PROPN-PROPN,nsubj,compound-pobj,NNP,NNP-NNP,7,1
1,0.0,24,is,6,1,21,20,0,2,5,15,Umreth,Gujarat,LOC,LOC,PROPN,PROPN,nsubj,pobj,NNP,NNP,10,1
2,0.0,24,is,6,1,23,22,0,0,5,17,Umreth,India,LOC,LOC,PROPN,PROPN,nsubj,appos,NNP,NNP,4,1
3,0.0,24,is,6,5,23,18,4,0,1,17,ઉમરેઠ,India,LOC,LOC,PUNCT,PROPN,npadvmod,appos,LS,NNP,4,1
4,0.0,24,is,6,15,21,6,14,2,-9,15,Anand District,Gujarat,LOC-LOC,LOC,PROPN-PROPN,PROPN,compound-pobj,pobj,NNP-NNP,NNP,7,1
5,0.0,24,is,6,15,23,8,14,0,-9,17,Anand District,India,LOC-LOC,LOC,PROPN-PROPN,PROPN,compound-pobj,appos,NNP-NNP,NNP,5,1
6,0.0,24,is,6,21,23,2,20,0,-15,17,Gujarat,India,LOC,LOC,PROPN,PROPN,pobj,appos,NNP,NNP,8,1
0,2.0,19,used,8,11,15,4,10,3,-3,7,Air National Guard,U.S.,ORG-ORG-ORG,LOC,PROPN-PROPN-PROPN,PROPN,compound-compound-pobj,npadvmod,NNP-NNP-NNP,NNP,3,1
0,0.0,40,is,19,1,11,10,0,28,18,-8,Tomer Yosef,Kfar Saba,PER-PER,LOC-LOC,PROPN-PROPN,PROPN-PROPN,compound-nsubj,compound-pobj,NNP-NNP,NNP-NNP,3,1
1,0.0,40,is,19,1,14,13,0,25,18,-5,Tomer Yosef,Israel,PER-PER,LOC,PROPN-PROPN,PROPN,compound-nsubj,appos,NNP-NNP,NNP,2,1
2,0.0,40,is,19,1,16,15,0,23,18,-3,Tomer Yosef,8 September 1975,PER-PER,TIME-TIME-TIME,PROPN-PROPN,NUM-PROPN-NUM,compound-nsubj,nummod-pobj-nummod,NNP-NNP,CD-NNP-CD,3,1
3,0.0,40,is,19,11,14,3,10,25,8,-5,Kfar Saba,Israel,LOC-LOC,LOC,PROPN-PROPN,PROPN,compound-pobj,appos,NNP-NNP,NNP,3,1
4,8.0,33,started,3,16,16,0,15,16,-13,13,Balkan Beat Box,Balkan Beat Box,MISC-MISC-MISC,ORG-ORG-ORG,PROPN-PROPN-PROPN,PROPN-PROPN-PROPN,compound-compound-oprd,compound-compound-dobj,NNP-NNP-NNP,NNP-NNP-NNP,0,1
0,0.0,15,is,6,1,1,0,0,13,5,-5,Sogndal Airport,Sogndal,LOC-LOC,LOC,PROPN-PROPN,PROPN,compound-nsubj,dobj,NNP-NNP,NNP,0,1
1,0.0,15,is,6,1,14,13,0,0,5,8,Sogndal Airport,Norway,LOC-LOC,LOC,PROPN-PROPN,PROPN,compound-nsubj,appos,NNP-NNP,NNP,2,1
2,0.0,15,is,6,4,14,10,3,0,2,8,Haukåsen,Norway,LOC,LOC,PROPN,PROPN,compound,appos,NNP,NNP,3,1
3,0.0,15,is,6,1,14,13,0,0,5,8,Sogndal,Norway,LOC,LOC,PROPN,PROPN,dobj,appos,NNP,NNP,2,1
0,0.0,53,is,10,2,6,4,1,46,8,-4,Primary Reserve,Canadian Armed Forces,ORG-ORG,ORG-ORG-ORG,PROPN-PROPN,PROPN-PROPN-PROPN,compound-nsubj,compound-compound-pobj,NNP-NNP,NNP-NNP-NNPS,3,1
1,3.0,59,consists,3,2,51,49,1,7,1,48,Primary Reserve,CF,ORG-ORG,ORG,PROPN-PROPN,PROPN,compound-nsubj,compound,NNP-NNP,NNP,5,1
0,0.0,28,is,3,1,21,20,0,6,2,18,Eat Your Face,2004,MISC-MISC-MISC,TIME,VERB-DET-NOUN,NUM,csubj-poss-dobj,pobj,VB-PRP$-NN,CD,6,1
1,5.0,19,embarked,6,16,5,-11,15,13,-10,-1,Eat Your Face,2004,MISC-MISC-MISC,TIME,PROPN-DET-NOUN,NUM,compound-poss-pobj,pobj,NNP-PRP$-NN,CD,7,1
2,11.0,29,be,2,26,18,-8,25,10,-24,16,Shave the Planet,Volcom,MISC-MISC-MISC,ORG,PROPN-DET-PROPN,PROPN,compound-det-npadvmod,pobj,NNP-DT-NNP,NNP,4,1
0,1.0,6,born,2,1,5,4,0,0,1,3,Jitomirskaya,Kharkiv,PER,LOC,PROPN,PROPN,nsubjpass,pobj,NNP,NNP,2,1
0,0.0,39,was,15,1,4,3,0,34,14,-11,Jerzy Kłoczowski,29 December 1924,PER-PER,TIME-TIME-TIME,PROPN-PROPN,NUM-PROPN-NUM,compound-nsubj,nummod-appos-nummod,NNP-NNP,CD-NNP-CD,1,1
1,0.0,39,was,15,1,8,7,0,30,14,-7,Jerzy Kłoczowski,Bogdany,PER-PER,LOC,PROPN-PROPN,PROPN,compound-nsubj,appos,NNP-NNP,NNP,2,1
2,0.0,39,was,15,1,10,9,0,28,14,-5,Jerzy Kłoczowski,Poland,PER-PER,LOC,PROPN-PROPN,PROPN,compound-nsubj,compound,NNP-NNP,NNP,1,1
3,0.0,39,was,15,1,12,11,0,26,14,-3,Jerzy Kłoczowski,2 December 2017,PER-PER,TIME-TIME-TIME,PROPN-PROPN,NUM-PROPN-NUM,compound-nsubj,nummod-appos-nummod,NNP-NNP,CD-NNP-CD,1,1
4,0.0,39,was,15,1,18,17,0,20,14,3,Jerzy Kłoczowski,Polish,PER-PER,LOC,PROPN-PROPN,ADJ,compound-nsubj,amod,NNP-NNP,JJ,2,1
5,0.0,39,was,15,1,24,23,0,14,14,9,Jerzy Kłoczowski,John Paul II Catholic University of Lublin,PER-PER,ORG-ORG-ORG-ORG-ORG-ORG-ORG,PROPN-PROPN,PROPN-PROPN-PROPN-PROPN-PROPN-ADP-PROPN,compound-nsubj,compound-compound-compound-compound-pobj-prep-pobj,NNP-NNP,NNP-NNP-NNP-NNP-NNP-IN-NNP,7,1
6,0.0,39,was,15,8,10,2,7,28,7,-5,Bogdany,Poland,LOC,LOC,PROPN,PROPN,appos,compound,NNP,NNP,3,1
7,0.0,39,was,15,8,18,10,7,20,7,3,Bogdany,Polish,LOC,LOC,PROPN,ADJ,appos,amod,NNP,JJ,4,1
8,1.0,35,was,6,22,2,-20,21,32,-16,-4,Warsaw Uprising,World War II,MISC-MISC,MISC-MISC-MISC,PROPN-PROPN,PROPN-PROPN-PROPN,compound-pobj,compound-compound-pobj,NNP-NNP,NNP-NNP-NNP,6,1
9,2.0,38,went,10,13,17,4,12,20,-3,7,Adam Mickiewicz University,Poznań,ORG-ORG-ORG,LOC,PROPN-PROPN-PROPN,PROPN,compound-compound-pobj,pobj,NNP-NNP-NNP,NNP,4,1
10,3.0,48,elected,19,4,16,12,3,31,15,-3,anti - communist Solidarity movement,Poland,MISC-MISC-MISC-MISC-MISC,LOC,ADJ-ADJ-ADJ-PROPN-NOUN,PROPN,subtok-subtok-amod-compound-pobj,pobj,JJ-JJ-JJ-NNP-NN,NNP,5,1
0,1.0,19,is,2,1,15,14,0,3,1,13,Mikhail Epstein,Emory University,PER-PER,ORG-ORG,PROPN-PROPN,PROPN-PROPN,compound-nsubj,compound-pobj,NNP-NNP,NNP-NNP,4,1
1,2.0,20,worked,1,11,14,3,10,5,-10,13,Durham University,UK,ORG-ORG,LOC,PROPN-PROPN,PROPN,compound-pobj,appos,NNP-NNP,NNP,7,1
2,5.0,63,include,4,20,16,-4,19,46,-16,12,Pushkin,Russian,PER,LOC,PROPN,ADJ,appos,amod,NNP,JJ,2,1
3,5.0,63,include,4,22,16,-6,21,46,-18,12,Gogol,Russian,PER,LOC,PROPN,ADJ,conj,amod,NNP,JJ,3,1
4,5.0,63,include,4,24,16,-8,23,46,-20,12,Dostoevsky,Russian,PER,LOC,PROPN,ADJ,conj,amod,NNP,JJ,4,1
0,0.0,30,was,17,1,5,4,0,24,16,-12,Michel Étienne Descourtilz,25 November 1777,PER-PER-PER,TIME-TIME-TIME,PROPN-PROPN-PROPN,NUM-PROPN-NUM,compound-compound-nsubj,nummod-appos-nummod,NNP-NNP-NNP,CD-NNP-CD,2,1
1,0.0,30,was,17,1,9,8,0,20,16,-8,Michel Étienne Descourtilz,Boiste,PER-PER-PER,LOC,PROPN-PROPN-PROPN,PROPN,compound-compound-nsubj,appos,NNP-NNP-NNP,NNP,3,1
2,0.0,30,was,17,1,11,10,0,18,16,-6,Michel Étienne Descourtilz,Pithiviers,PER-PER-PER,LOC,PROPN-PROPN-PROPN,PROPN,compound-compound-nsubj,compound,NNP-NNP-NNP,NNPS,5,1
3,0.0,30,was,17,1,13,12,0,16,16,-4,Michel Étienne Descourtilz,1835,PER-PER-PER,TIME,PROPN-PROPN-PROPN,NUM,compound-compound-nsubj,nummod,NNP-NNP-NNP,CD,3,1
4,0.0,30,was,17,1,15,14,0,14,16,-2,Michel Étienne Descourtilz,Paris,PER-PER-PER,LOC,PROPN-PROPN-PROPN,PROPN,compound-compound-nsubj,npadvmod,NNP-NNP-NNP,NNP,2,1
5,0.0,30,was,17,1,20,19,0,9,16,3,Michel Étienne Descourtilz,French,PER-PER-PER,LOC,PROPN-PROPN-PROPN,ADJ,compound-compound-nsubj,amod,NNP-NNP-NNP,JJ,3,1
6,0.0,30,was,17,11,20,9,10,9,6,3,Pithiviers,French,LOC,LOC,PROPN,ADJ,compound,amod,NNPS,JJ,6,1
7,6.0,26,returned,3,16,6,-10,15,19,-13,3,Beaumont,France,LOC,LOC,PROPN,PROPN,pobj,pobj,NNP,NNP,3,1
8,7.0,13,circumscribed,4,8,11,3,7,1,-4,7,Nauchea,Fabaceae,MISC,MISC,PROPN,PROPN,dobj,appos,NNP,NNP,3,1
0,0.0,9,is,2,1,5,4,0,3,1,3,Alan Tew,British,PER-PER,LOC,PROPN-PROPN,ADJ,compound-nsubj,amod,NNP-NNP,JJ,2,1
1,4.0,25,used,12,22,19,-3,21,5,-10,7,Van der Valk,British,MISC-MISC-MISC,LOC,PROPN-NOUN-PROPN,ADJ,compound-compound-dobj,amod,NNP-NN-NNP,JJ,7,1
2,6.0,27,made,5,21,25,4,20,1,-16,20,The Magnificent Westerns,1969,MISC-MISC-MISC,TIME,DET-PROPN-NOUN,NUM,det-compound-ROOT,appos,DT-NNP-NNS,CD,2,1
0,0.0,16,"""",0,2,13,11,1,2,-2,13,The Puerto Rican Day,NBC,MISC-MISC-MISC-MISC,ORG,DET-ADJ-ADJ-PROPN,PROPN,det-compound-amod-nsubj,compound,DT-JJ-JJ-NNP,NNP,6,1
1,0.0,16,"""",0,2,15,13,1,0,-2,15,The Puerto Rican Day,Seinfeld,MISC-MISC-MISC-MISC,MISC,DET-ADJ-ADJ-PROPN,PROPN,det-compound-amod-nsubj,appos,DT-JJ-JJ-NNP,NNP,4,1
0,0.0,47,is,3,1,6,5,0,40,2,3,Grace Is Gone,2007,MISC-MISC-MISC,TIME,NOUN-VERB-VERB,NUM,nsubj-auxpass-appos,nummod,NN-VBZ-VBN,CD,4,1
1,0.0,47,is,3,1,10,9,0,36,2,7,Grace Is Gone,John Cusack,MISC-MISC-MISC,PER-PER,NOUN-VERB-VERB,PROPN-PROPN,nsubj-auxpass-appos,compound-dobj,NN-VBZ-VBN,NNP-NNP,5,1
2,1.0,20,won,7,10,17,7,9,2,-3,10,Audience Award for Drama,Sundance Film Festival,MISC-MISC-MISC-MISC,MISC-MISC-MISC,PROPN-PROPN-ADP-PROPN,PROPN-PROPN-PROPN,compound-dobj-prep-pobj,compound-compound-pobj,NNP-NNP-IN-NNP,NNP-NNP-NNP,4,1
0,2.0,18,studied,1,1,5,4,0,12,0,4,Rutanen,University of Helsinki,PER,ORG-ORG-ORG,PROPN,PROPN-ADP-PROPN,nsubj,pobj-prep-pobj,NNP,NNP-IN-NNP,3,1
1,4.0,32,sent,6,2,15,13,1,16,4,9,the United States,Washington,LOC-LOC-LOC,LOC,DET-PROPN-PROPN,PROPN,det-compound-pobj,compound,DT-NNP-NNP,NNP,4,1
0,3.0,9,acquired,2,1,5,4,0,3,1,3,Vudu,Walmart,ORG,ORG,PROPN,PROPN,nsubjpass,pobj,NNP,NNP,2,1
0,0.0,27,appeared,8,6,12,6,5,14,2,4,Star Soldier,MSX,MISC-MISC,MISC,PROPN-PROPN,PROPN,compound-oprd,pobj,NNP-NNP,NNP,6,1
1,0.0,27,appeared,8,6,14,8,5,12,2,6,Star Soldier,NES,MISC-MISC,MISC,PROPN-PROPN,PROPN,compound-oprd,conj,NNP-NNP,NNP,4,1
2,0.0,27,appeared,8,6,16,10,5,10,2,8,Star Soldier,1986,MISC-MISC,TIME,PROPN-PROPN,NUM,compound-oprd,pobj,NNP-NNP,CD,4,1
3,1.0,47,received,4,1,11,10,0,35,3,7,Star Soldier,GameCube,MISC-MISC,MISC,PROPN-PROPN,PROPN,compound-nsubj,pobj,NNP-NNP,NNP,5,1
4,1.0,47,received,4,1,13,12,0,33,3,9,Star Soldier,PlayStation 2,MISC-MISC,MISC-MISC,PROPN-PROPN,PROPN-NUM,compound-nsubj,conj-nummod,NNP-NNP,NNP-CD,6,1
5,1.0,47,received,4,1,13,12,0,33,3,9,Star Soldier,PlayStation Portable,MISC-MISC,MISC-MISC,PROPN-PROPN,PROPN-PROPN,compound-nsubj,compound-pobj,NNP-NNP,NNP-NNP,6,1
6,1.0,47,received,4,1,40,39,0,6,3,36,Star Soldier,Wii,MISC-MISC,MISC,PROPN-PROPN,PROPN,compound-nsubj,pobj,NNP-NNP,NNP,3,1
7,2.0,40,released,19,4,25,21,3,14,15,6,Super Star Soldier,Virtual Console,MISC-MISC-MISC,MISC-MISC,PROPN-PROPN-PROPN,PROPN-PROPN,compound-compound-nsubj,compound-pobj,NNP-NNP-NNP,NNP-NNP,5,1
8,2.0,40,released,19,4,31,27,3,8,15,12,Super Star Soldier,PC Engine,MISC-MISC-MISC,MISC-MISC,PROPN-PROPN-PROPN,PROPN-PROPN,compound-compound-nsubj,compound-poss,NNP-NNP-NNP,NNP-NNP,7,1
9,2.0,40,released,19,4,39,35,3,0,15,20,Super Star Soldier,PSP,MISC-MISC-MISC,MISC,PROPN-PROPN-PROPN,PROPN,compound-compound-nsubj,pobj,NNP-NNP-NNP,NNP,4,1
10,2.0,40,released,19,4,23,19,3,16,15,4,Super Star Soldier,Wii,MISC-MISC-MISC,MISC,PROPN-PROPN-PROPN,PROPN,compound-compound-nsubj,poss,NNP-NNP-NNP,NNP,7,1
11,2.0,40,released,19,8,25,17,7,14,11,6,Final Soldier,Virtual Console,MISC-MISC,MISC-MISC,PROPN-PROPN,PROPN-PROPN,compound-conj,compound-pobj,NNP-NNP,NNP-NNP,5,1
12,2.0,40,released,19,8,31,23,7,8,11,12,Final Soldier,PC Engine,MISC-MISC,MISC-MISC,PROPN-PROPN,PROPN-PROPN,compound-conj,compound-poss,NNP-NNP,NNP-NNP,7,1
13,2.0,40,released,19,8,39,31,7,0,11,20,Final Soldier,PSP,MISC-MISC,MISC,PROPN-PROPN,PROPN,compound-conj,pobj,NNP-NNP,NNP,4,1
14,2.0,40,released,19,8,23,15,7,16,11,4,Final Soldier,Wii,MISC-MISC,MISC,PROPN-PROPN,PROPN,compound-conj,poss,NNP-NNP,NNP,7,1
15,2.0,40,released,19,6,25,19,5,14,13,6,Soldier Blade,Virtual Console,MISC-MISC,MISC-MISC,PROPN-PROPN,PROPN-PROPN,compound-conj,compound-pobj,NNP-NNP,NNP-NNP,5,1
16,2.0,40,released,19,6,31,25,5,8,13,12,Soldier Blade,PC Engine,MISC-MISC,MISC-MISC,PROPN-PROPN,PROPN-PROPN,compound-conj,compound-poss,NNP-NNP,NNP-NNP,7,1
17,2.0,40,released,19,6,39,33,5,0,13,20,Soldier Blade,PSP,MISC-MISC,MISC,PROPN-PROPN,PROPN,compound-conj,pobj,NNP-NNP,NNP,4,1
18,2.0,40,released,19,6,23,17,5,16,13,4,Soldier Blade,Wii,MISC-MISC,MISC,PROPN-PROPN,PROPN,compound-conj,poss,NNP-NNP,NNP,7,1
19,2.0,40,released,19,5,25,20,4,14,14,6,Star Parodier,Virtual Console,MISC-MISC,MISC-MISC,PROPN-PROPN,PROPN-PROPN,compound-conj,compound-pobj,NNP-NNP,NNP-NNP,4,1
20,2.0,40,released,19,5,31,26,4,8,14,12,Star Parodier,PC Engine,MISC-MISC,MISC-MISC,PROPN-PROPN,PROPN-PROPN,compound-conj,compound-poss,NNP-NNP,NNP-NNP,6,1
21,2.0,40,released,19,5,23,18,4,16,14,4,Star Parodier,Wii,MISC-MISC,MISC,PROPN-PROPN,PROPN,compound-conj,poss,NNP-NNP,NNP,6,1
0,0.0,40,was,17,32,35,3,31,4,-15,18,Pasay City,Metro Manila,LOC-LOC,LOC-LOC,PROPN-PROPN,PROPN-PROPN,compound-pobj,compound-appos,NNP-NNP,NNP-NNP,3,1
1,0.0,40,was,17,32,39,7,31,0,-15,22,Pasay City,Philippines,LOC-LOC,LOC,PROPN-PROPN,PROPN,compound-pobj,pobj,NNP-NNP,NNP,7,1
2,4.0,21,founded,3,6,14,8,5,6,-3,11,Asian Spirit,Philippines,ORG-ORG,LOC,PROPN-PROPN,PROPN,compound-pobj,pobj,NNP-NNP,NNPS,3,1
0,0.0,33,is,5,2,14,12,1,18,3,9,Push the Button,Sugababes,MISC-MISC-MISC,ORG,VERB-DET-PROPN,PROPN,csubj-det-dobj,appos,VB-DT-NNP,NNP,5,1
1,0.0,33,is,5,2,26,24,1,6,3,21,Push the Button,Taller in More Ways,MISC-MISC-MISC,MISC-MISC-MISC-MISC,VERB-DET-PROPN,PROPN-ADP-ADJ-NOUN,csubj-det-dobj,appos-prep-amod-pobj,VB-DT-NNP,NNP-IN-JJR-NNS,12,1
2,0.0,33,is,5,2,31,29,1,1,3,26,Push the Button,2005,MISC-MISC-MISC,TIME,VERB-DET-PROPN,NUM,csubj-det-dobj,appos,VB-DT-NNP,CD,14,1
3,0.0,33,is,5,26,31,5,25,1,-21,26,Taller in More Ways,2005,MISC-MISC-MISC-MISC,TIME,PROPN-ADP-ADJ-NOUN,NUM,appos-prep-amod-pobj,appos,NNP-IN-JJR-NNS,CD,2,1
4,2.0,19,is,7,4,12,8,3,6,3,5,Push the Button,R&B,MISC-MISC-MISC,MISC,VERB-DET-PROPN,NOUN,csubj-det-dobj,conj,VB-DT-NNP,NN,4,1
5,7.0,13,nominated,2,5,10,5,4,2,-3,8,Best British Single,2006 Brit Awards,MISC-MISC-MISC,MISC-MISC-MISC,PROPN-PROPN-PROPN,NUM-PROPN-PROPN,amod-compound-pobj,nummod-compound-pobj,NNP-NNP-NNP,CD-NNP-NNPS,6,1
0,0.0,32,is,6,2,31,29,1,0,4,25,Hope Island Resort Tennis Centre,Australia,LOC-LOC-LOC-LOC-LOC,LOC,PROPN-PROPN-PROPN-PROPN-PROPN,PROPN,compound-compound-compound-compound-nsubj,appos,NNP-NNP-NNP-NNP-NNP,NNP,3,1
1,0.0,32,is,6,2,29,27,1,2,4,23,Hope Island Road,Queensland,LOC-LOC-LOC,LOC,PROPN-PROPN-PROPN,PROPN,compound-compound-pobj,conj,NNP-NNP-NNP,NNP,12,1
2,0.0,32,is,6,2,31,29,1,0,4,25,Hope Island Road,Australia,LOC-LOC-LOC,LOC,PROPN-PROPN-PROPN,PROPN,compound-compound-pobj,appos,NNP-NNP-NNP,NNP,3,1
3,0.0,32,is,6,20,29,9,19,2,-14,23,Activa Way,Queensland,LOC-LOC,LOC,PROPN-NOUN,PROPN,compound-conj,conj,NNP-NN,NNP,4,1
4,0.0,32,is,6,20,31,11,19,0,-14,25,Activa Way,Australia,LOC-LOC,LOC,PROPN-NOUN,PROPN,compound-conj,appos,NNP-NN,NNP,7,1
5,0.0,32,is,6,2,26,24,1,5,4,20,Hope Island,Gold Coast,LOC-LOC,LOC-LOC,PROPN-PROPN,PROPN-PROPN,compound-conj,compound-conj,NNP-NNP,NNP-NNP,10,1
6,0.0,32,is,6,2,29,27,1,2,4,23,Hope Island,Queensland,LOC-LOC,LOC,PROPN-PROPN,PROPN,compound-conj,conj,NNP-NNP,NNP,12,1
7,0.0,32,is,6,2,31,29,1,0,4,25,Hope Island,Australia,LOC-LOC,LOC,PROPN-PROPN,PROPN,compound-conj,appos,NNP-NNP,NNP,3,1
8,0.0,32,is,6,26,29,3,25,2,-20,23,Gold Coast,Queensland,LOC-LOC,LOC,PROPN-PROPN,PROPN,compound-conj,conj,NNP-NNP,NNP,2,1
9,0.0,32,is,6,26,31,5,25,0,-20,25,Gold Coast,Australia,LOC-LOC,LOC,PROPN-PROPN,PROPN,compound-conj,appos,NNP-NNP,NNP,9,1
10,0.0,32,is,6,29,31,2,28,0,-23,25,Queensland,Australia,LOC,LOC,PROPN,PROPN,conj,appos,NNP,NNP,11,1
11,3.0,36,relocated,19,3,12,9,2,23,16,-7,Queensland Tennis Centre,Tennyson,LOC-LOC-LOC,LOC,PROPN-PROPN-PROPN,PROPN,compound-compound-dobj,pobj,NNP-NNP-NNP,NNP,4,1
0,0.0,26,is,2,12,24,12,11,1,-10,22,Red Hot Chili Peppers,EMI Records,ORG-ORG-ORG-ORG,ORG-ORG,PROPN-PROPN-PROPN-PROPN,PROPN-PROPN,compound-compound-compound-pobj,compound-pobj,NNP-NNP-NNP-NNPS,NNP-NNPS,6,1
0,0.0,18,is,1,1,4,3,0,13,0,3,Kamboji,2017,MISC,TIME,PROPN,NUM,nsubj,nummod,NNP,CD,2,1
1,0.0,18,is,1,1,6,5,0,11,0,5,Kamboji,Malayalam,MISC,MISC,PROPN,PROPN,nsubj,nmod,NNP,NNP,3,1
2,0.0,18,is,1,1,16,15,0,1,0,15,Kamboji,Vinod Mankara,MISC,PER-PER,PROPN,PROPN-PROPN,nsubj,compound-pobj,NNP,NNP-NNP,5,1
3,4.0,50,unites,28,6,9,3,5,40,22,-19,Palakkad,Kerala,LOC,LOC,PROPN,PROPN,compound,pobj,NNP,NNP,5,1
0,0.0,27,is,10,1,6,5,0,20,9,-4,Francesco Pazienza,Monteparano,PER-PER,LOC,PROPN-PROPN,PROPN,compound-nsubj,pobj,NNP-NNP,NNP,2,1
1,0.0,27,is,10,1,9,8,0,17,9,-1,Francesco Pazienza,1946,PER-PER,TIME,PROPN-PROPN,NUM,compound-nsubj,pobj,NNP-NNP,CD,1,1
2,2.0,12,holds,1,1,9,8,0,2,0,8,Pazienza,University of Rome,PER,ORG-ORG-ORG,PROPN,PROPN-ADP-PROPN,nsubj,pobj-prep-pobj,NNP,NNP-IN-NNP,3,1
0,0.0,21,was,13,1,6,5,0,14,12,-7,Samuel Musgrave,29 September 1732,PER-PER,TIME-TIME-TIME,PROPN-PROPN,NUM-PROPN-NUM,compound-nsubj,nummod-appos-nummod,NNP-NNP,CD-NNP-CD,2,1
1,0.0,21,was,13,1,10,9,0,10,12,-3,Samuel Musgrave,5 July 1780,PER-PER,TIME-TIME-TIME,PROPN-PROPN,NUM-PROPN-NUM,compound-nsubj,nummod-appos-nummod,NNP-NNP,CD-NNP-CD,2,1
2,1.0,17,born,2,1,5,4,0,11,1,3,Musgrave,Washfield,PER,LOC,PROPN,PROPN,nsubjpass,pobj,NNP,NNP,4,1
3,1.0,17,born,2,1,7,6,0,9,1,5,Musgrave,Devon,PER,LOC,PROPN,PROPN,nsubjpass,pobj,NNP,NNP,2,1
4,4.0,75,went,1,39,43,4,38,31,-38,42,Treaty of Paris,1763,MISC-MISC-MISC,TIME,PROPN-ADP-PROPN,NUM,dobj-prep-pobj,appos,NNP-IN-NNP,CD,6,1
0,0.0,39,"""",0,2,37,35,1,1,-2,37,Bouge de là,MC Solaar,MISC-MISC-MISC,PER-PER,PROPN-PROPN-X,PROPN-PROPN,compound-compound-ROOT,compound-pobj,NNP-NNP-FW,NNP-NNP,6,1
0,0.0,28,is,3,22,25,3,21,2,-19,22,USA,Donald Trump,LOC,PER-PER,PROPN,PROPN-PROPN,pobj,compound-compound,NNP,NNP-NNP,2,1
1,1.0,37,alleged,2,15,19,4,14,17,-13,17,Lars Vilks,Swedish,PER-PER,LOC,PROPN-PROPN,ADJ,compound-dobj,amod,NNP-NNP,JJ,1,1
2,5.0,21,traveled,11,3,10,7,2,10,8,-1,Colleen LaRose,Islam,PER-PER,ORG,PROPN-PROPN,PROPN,compound-conj,pobj,NNP-NNP,NNP,3,1
0,1.0,27,is,2,2,13,11,1,13,0,11,IBRD,World Bank Group,ORG,ORG-ORG-ORG,PROPN,PROPN-PROPN-PROPN,nsubj,compound-compound-dobj,NNP,NNP-NNP-NNP,6,1
1,1.0,27,is,2,2,25,23,1,1,0,23,IBRD,United States,ORG,LOC-LOC,PROPN,PROPN-PROPN,nsubj,compound-appos,NNP,NNP-NNP,4,1
2,1.0,27,is,2,13,25,12,12,1,-11,23,World Bank Group,United States,ORG-ORG-ORG,LOC-LOC,PROPN-PROPN-PROPN,PROPN-PROPN,compound-compound-dobj,compound-appos,NNP-NNP-NNP,NNP-NNP,10,1
3,3.0,29,known,15,10,19,9,9,9,5,4,International Development Association,World Bank,ORG-ORG-ORG,ORG-ORG,PROPN-PROPN-PROPN,PROPN-PROPN,compound-compound-appos,compound-pobj,NNP-NNP-NNP,NNP-NNP,5,1
0,6.0,18,taught,8,8,4,-4,7,13,0,-4,Reinkemeyer,University of Michigan,PER,ORG-ORG-ORG,PROPN,PROPN-ADP-PROPN,nsubj,pobj-prep-pobj,NNP,NNP-IN-NNP,3,1
1,7.0,23,took,6,17,22,5,16,0,-11,16,Bowling Green State University,Ohio,ORG-ORG-ORG-ORG,LOC,PROPN-PROPN-PROPN-PROPN,PROPN,compound-compound-compound-pobj,pobj,NNP-NNP-NNP-NNP,NNP,5,1
0,0.0,27,is,9,1,8,7,0,18,8,-1,"Gerard "" Gerry "" Brady",1948,PER-PER-PER-PER-PER,TIME,PROPN-PUNCT-PROPN-PUNCT-PROPN,NUM,nmod-punct-nmod-punct-nsubj,npadvmod,NNP-``-NNP-``-NNP,CD,2,1
1,0.0,27,is,9,1,14,13,0,12,8,5,"Gerard "" Gerry "" Brady",Fianna Fáil,PER-PER-PER-PER-PER,ORG-ORG,PROPN-PUNCT-PROPN-PUNCT-PROPN,PROPN-PROPN,nmod-punct-nmod-punct-nsubj,compound-compound,NNP-``-NNP-``-NNP,NNP-NNP,4,1
2,5.0,26,been,10,3,6,3,2,19,7,-4,Tom Kitt,Michael P. Kitt,PER-PER,PER-PER-PER,PROPN-PROPN,PROPN-PROPN-PROPN,compound-appos,compound-compound-conj,NNP-NNP,NNP-NNP-NNP,2,1
3,5.0,26,been,10,3,12,9,2,13,7,2,Tom Kitt,Fianna Fáil,PER-PER,ORG-ORG,PROPN-PROPN,PROPN-PROPN,compound-appos,compound-compound,NNP-NNP,NNP-NNP,4,1
4,5.0,26,been,10,6,12,6,5,13,4,2,Michael P. Kitt,Fianna Fáil,PER-PER-PER,ORG-ORG,PROPN-PROPN-PROPN,PROPN-PROPN,compound-compound-conj,compound-compound,NNP-NNP-NNP,NNP-NNP,6,1
5,5.0,26,been,10,6,12,6,5,13,4,2,Michael F. Kitt,Fianna Fáil,PER-PER-PER,ORG-ORG,PROPN-PROPN-PROPN,PROPN-PROPN,compound-compound-appos,compound-compound,NNP-NNP-NNP,NNP-NNP,6,1
0,0.0,53,took,5,2,4,2,1,48,3,-1,Battle of Stamford Bridge,Stamford Bridge,MISC-MISC-MISC-MISC,LOC-LOC,PROPN-ADP-PROPN-PROPN,PROPN-PROPN,nsubj-prep-compound-pobj,compound-pobj,NNP-IN-NNP-NNP,NNP-NNP,1,1
1,0.0,53,took,5,2,15,13,1,37,3,10,Battle of Stamford Bridge,East Riding,MISC-MISC-MISC-MISC,LOC-LOC,PROPN-ADP-PROPN-PROPN,PROPN-PROPN,nsubj-prep-compound-pobj,compound-appos,NNP-IN-NNP-NNP,NNP-NNP,7,1
2,0.0,53,took,5,2,18,16,1,34,3,13,Battle of Stamford Bridge,Yorkshire,MISC-MISC-MISC-MISC,LOC,PROPN-ADP-PROPN-PROPN,PROPN,nsubj-prep-compound-pobj,pobj,NNP-IN-NNP-NNP,NNP,3,1
3,0.0,53,took,5,2,23,21,1,29,3,18,Battle of Stamford Bridge,25 September 1066,MISC-MISC-MISC-MISC,TIME-TIME-TIME,PROPN-ADP-PROPN-PROPN,NUM-PROPN-NUM,nsubj-prep-compound-pobj,nummod-pobj-nummod,NNP-IN-NNP-NNP,CD-NNP-CD,4,1
4,0.0,53,took,5,51,33,-18,50,19,-46,28,Tostig Godwinson,Harold Godwinson,PER-PER,PER-PER,PROPN-PROPN,PROPN-PROPN,compound-appos,compound-pobj,NNP-NNP,NNP-NNP,8,1
5,3.0,55,presented,5,18,38,20,17,16,-13,33,Scandinavian,Denmark,LOC,LOC,ADJ,PROPN,amod,pobj,JJ,NNP,6,1
6,3.0,55,presented,5,18,48,30,17,6,-13,43,Scandinavian,Norway,LOC,LOC,ADJ,PROPN,amod,pobj,JJ,NNP,6,1
7,3.0,55,presented,5,35,38,3,34,16,-30,33,Sweyn Estrithson,Denmark,PER-PER,LOC,PROPN-PROPN,PROPN,compound-pobj,pobj,NNP-NNP,NNP,3,1
8,3.0,55,presented,5,45,48,3,44,6,-40,43,Magnus Barefoot,Norway,PER-PER,LOC,PROPN-PROPN,PROPN,conj-appos,pobj,NNP-NNP,NNP,2,1
9,3.0,55,presented,5,45,54,9,44,0,-40,49,Magnus Barefoot,1103,PER-PER,TIME,PROPN-PROPN,NUM,conj-appos,nummod,NNP-NNP,CD,7,1
0,0.0,18,were,3,2,16,14,1,1,1,13,Adelaide,South Australia,LOC,LOC-LOC,PROPN,PROPN-PROPN,pobj,compound-appos,NNP,NNP-NNP,6,1
1,6.0,23,remain,1,11,10,-1,10,12,-10,9,Australia,South Australia,LOC,LOC-LOC,PROPN,PROPN-PROPN,pobj,compound-pobj,NNP,NNP-NNP,6,1
0,9.0,20,were,9,8,1,-7,7,18,1,-8,Ealhhelm,Ælfhere,PER,PER,PROPN,ADV,pobj,nsubj,NNP,RB,3,1
1,9.0,20,were,9,8,3,-5,7,16,1,-6,Ealhhelm,Ælfheah,PER,PER,PROPN,PROPN,pobj,conj,NNP,NNP,4,1
0,5.0,19,Wars,0,7,10,3,6,8,-7,10,Finnish War,1808,MISC-MISC,TIME,PROPN-PROPN,NUM,compound-pobj,nummod,NNP-NNP,CD,2,1
1,5.0,19,Wars,0,7,12,5,6,6,-7,12,Finnish War,1809,MISC-MISC,TIME,PROPN-PROPN,NUM,compound-pobj,npadvmod,NNP-NNP,CD,1,1
2,5.0,19,Wars,0,7,16,9,6,2,-7,16,Finnish War,Sweden,MISC-MISC,LOC,PROPN-PROPN,PROPN,compound-pobj,nsubj,NNP-NNP,NNP,4,1
0,0.0,22,is,1,1,16,15,0,5,0,15,Technique,30 January 1989,MISC,TIME-TIME-TIME,NOUN,NUM-PROPN-NUM,nsubj,nummod-pobj-nummod,NN,CD-NNP-CD,4,1
1,5.0,33,was,1,19,5,-14,18,27,-18,4,Fine Time,New Order,MISC-MISC,ORG-ORG,PROPN-PROPN,PROPN-PROPN,compound-nsubj,compound-compound,NNP-NNP,NNP-NNP,3,1
0,0.0,15,is,3,1,13,12,0,1,2,10,Dong,Jia Zhangke,MISC,PER-PER,PROPN,PROPN-PROPN,nsubj,compound-appos,NNP,NNP-NNP,3,1
0,0.0,20,was,12,1,5,4,0,14,11,-7,Hans Raj Khanna,3 July 1912,PER-PER-PER,TIME-TIME-TIME,PROPN-PROPN-PROPN,NUM-PROPN-NUM,compound-compound-nsubj,nummod-nmod-nummod,NNP-NNP-NNP,CD-NNP-CD,2,1
1,0.0,20,was,12,1,9,8,0,10,11,-3,Hans Raj Khanna,25 February 2008,PER-PER-PER,TIME-TIME-TIME,PROPN-PROPN-PROPN,NUM-PROPN-NUM,compound-compound-nsubj,nummod-appos-nummod,NNP-NNP-NNP,CD-NNP-CD,2,1
2,5.0,63,superseded,13,36,35,-1,35,27,-23,22,Indira Gandhi,India,PER-PER,LOC,PROPN-PROPN,PROPN,compound-pobj,compound,NNP-NNP,NNP,1,1
3,8.0,22,awarded,5,8,21,13,7,0,-3,16,Padma Vibhushan,India,MISC-MISC,LOC,PROPN-PROPN,PROPN,compound-dobj,pobj,NNP-NNP,NNP,2,1
0,8.0,20,lamented,11,1,5,4,0,14,10,-6,Pham Van Dong,Vietnam,PER-PER-PER,LOC,PROPN-PROPN-PROPN,PROPN,compound-compound-nsubj,poss,NNP-NNP-NNP,NNP,4,1
1,9.0,37,ranked,14,5,8,3,4,28,9,-6,Pham Hung,1988,PER-PER,TIME,PROPN-PROPN,NUM,compound-pobj,pobj,NNP-NNP,CD,5,1
2,9.0,37,ranked,14,5,24,19,4,12,9,10,Pham Hung,Communist Party 's Politburo,PER-PER,ORG-ORG-ORG-ORG,PROPN-PROPN,PROPN-PROPN-PART-PROPN,compound-pobj,compound-poss-case-pobj,NNP-NNP,NNP-NNP-POS-NNP,11,1
3,9.0,37,ranked,14,24,36,12,23,0,-10,22,Communist Party 's Politburo,Vietnam,ORG-ORG-ORG-ORG,LOC,PROPN-PROPN-PART-PROPN,PROPN,compound-poss-case-pobj,pobj,NNP-NNP-POS-NNP,NNP,8,1
0,0.0,28,is,2,1,8,7,0,19,1,6,El Escorial,Autonomous Community of Madrid,LOC-LOC,LOC-LOC-LOC-LOC,PROPN-PROPN,PROPN-PROPN-ADP-PROPN,compound-nsubj,compound-pobj-prep-pobj,NNP-NNP,NNP-NNP-IN-NNP,4,1
1,0.0,28,is,2,1,25,24,0,2,1,23,El Escorial,Spanish,LOC-LOC,LOC,PROPN-PROPN,ADJ,compound-nsubj,amod,NNP-NNP,JJ,5,1
2,0.0,28,is,2,8,25,17,7,2,-6,23,Autonomous Community of Madrid,Spanish,LOC-LOC-LOC-LOC,LOC,PROPN-PROPN-ADP-PROPN,ADJ,compound-pobj-prep-pobj,amod,NNP-NNP-IN-NNP,JJ,7,1
3,0.0,28,is,2,25,11,-14,24,16,-23,9,Spanish,Madrid,LOC,LOC,ADJ,PROPN,amod,appos,JJ,NNP,4,1
0,0.0,32,is,21,4,8,4,3,23,17,-13,Newfoundland and Labrador,Canada,LOC-LOC-LOC,LOC,PROPN-CCONJ-PROPN,PROPN,conj-cc-conj,appos,NNP-CC-NNP,NNP,4,1
0,0.0,19,was,12,1,5,4,0,13,11,-7,Edvard Alexander Westermarck,20 November 1862,PER-PER-PER,TIME-TIME-TIME,PROPN-PROPN-PROPN,NUM-PROPN-NUM,compound-compound-nsubj,nummod-appos-nummod,NNP-NNP-NNP,CD-NNP-CD,2,1
1,0.0,19,was,12,1,9,8,0,9,11,-3,Edvard Alexander Westermarck,3 September 1939,PER-PER-PER,TIME-TIME-TIME,PROPN-PROPN-PROPN,NUM-PROPN-NUM,compound-compound-nsubj,nummod-appos-nummod,NNP-NNP-NNP,CD-NNP-CD,2,1
2,0.0,19,was,12,1,15,14,0,3,11,3,Edvard Alexander Westermarck,Finnish,PER-PER-PER,LOC,PROPN-PROPN-PROPN,ADJ,compound-compound-nsubj,amod,NNP-NNP-NNP,JJ,3,1
3,2.0,60,is,6,1,58,57,0,1,5,52,The History of Human Marriage,1891,MISC-MISC-MISC-MISC-MISC,TIME,DET-NOUN-ADP-PROPN-PROPN,NUM,det-appos-prep-compound-pobj,appos,DT-NN-IN-NNP-NNP,CD,3,1
4,4.0,30,found,2,19,27,8,18,2,-17,25,Leonard Trelawny Hobhouse,University of London,PER-PER-PER,ORG-ORG-ORG,PROPN-PROPN-PROPN,PROPN-ADP-PROPN,compound-compound-pobj,pobj-prep-pobj,NNP-NNP-NNP,NNP-IN-NNP,6,1
0,0.0,17,was,12,1,5,4,0,11,11,-7,Ellis Wellwood Sifton,12 October 1891,PER-PER-PER,TIME-TIME-TIME,PROPN-PROPN-PROPN,NUM-PROPN-NUM,compound-compound-nsubj,nummod-appos-nummod,NNP-NNP-NNP,CD-NNP-CD,2,1
1,0.0,17,was,12,1,9,8,0,7,11,-3,Ellis Wellwood Sifton,9 April 1917,PER-PER-PER,TIME-TIME-TIME,PROPN-PROPN-PROPN,NUM-PROPN-NUM,compound-compound-nsubj,nummod-appos-nummod,NNP-NNP-NNP,CD-NNP-CD,2,1
2,0.0,17,was,12,1,15,14,0,1,11,3,Ellis Wellwood Sifton,Canadian,PER-PER-PER,LOC,PROPN-PROPN-PROPN,ADJ,compound-compound-nsubj,amod,NNP-NNP-NNP,JJ,3,1
3,1.0,33,was,1,7,29,22,6,3,-6,28,Victoria Cross,British,ORG-ORG,LOC,PROPN-PROPN,PROPN,compound-pobj,amod,NNP-NNP,NNP,12,1
4,3.0,74,were,18,12,57,45,11,16,6,39,Battle of Vimy Ridge,First World War,MISC-MISC-MISC-MISC,MISC-MISC-MISC,PROPN-ADP-PROPN-PROPN,PROPN-PROPN-PROPN,pobj-prep-compound-pobj,compound-compound-pobj,NNP-IN-NNP-NNP,NNP-NNP-NNP,-1,1
5,3.0,74,were,18,20,57,37,19,16,-2,39,Thain Wendell MacDowell,First World War,PER-PER-PER,MISC-MISC-MISC,PROPN-PROPN-PROPN,PROPN-PROPN-PROPN,compound-compound-attr,compound-compound-pobj,NNP-NNP-NNP,NNP-NNP-NNP,-1,1
6,3.0,74,were,18,24,57,33,23,16,-6,39,William Johnstone Milne,First World War,PER-PER-PER,MISC-MISC-MISC,PROPN-PROPN-PROPN,PROPN-PROPN-PROPN,compound-compound-conj,compound-compound-pobj,NNP-NNP-NNP,NNP-NNP-NNP,-1,1
7,3.0,74,were,18,28,57,29,27,16,-10,39,John George Pattison,First World War,PER-PER-PER,MISC-MISC-MISC,PROPN-PROPN-PROPN,PROPN-PROPN-PROPN,compound-compound-conj,compound-compound-pobj,NNP-NNP-NNP,NNP-NNP-NNP,-1,1
8,3.0,74,were,18,52,57,5,51,16,-34,39,Canadian Expeditionary Force,First World War,ORG-ORG-ORG,MISC-MISC-MISC,PROPN-PROPN-PROPN,PROPN-PROPN-PROPN,compound-compound-appos,compound-compound-pobj,NNP-NNP-NNP,NNP-NNP-NNP,4,1
0,2.0,24,raised,1,1,23,22,0,0,0,22,Lisberg,Fámjin,PER,LOC,PROPN,PROPN,nsubj,pobj,NNP,NNP,1,1
0,0.0,48,was,14,10,45,35,9,2,4,31,Hood 's Tennessee Campaign,American Civil War,MISC-MISC-MISC-MISC,MISC-MISC-MISC,PROPN-PART-PROPN-PROPN,PROPN-PROPN-PROPN,poss-case-compound-pobj,compound-compound-pobj,NNP-POS-NNP-NNP,NNP-NNP-NNP,10,1
1,0.0,48,was,14,22,45,23,21,2,-8,31,Western Theater,American Civil War,LOC-LOC,MISC-MISC-MISC,PROPN-PROPN,PROPN-PROPN-PROPN,compound-pobj,compound-compound-pobj,NNP-NNP,NNP-NNP-NNP,9,1
2,1.0,32,drove,12,10,2,-8,9,29,2,-10,John Bell Hood,Confederate Army,PER-PER-PER,ORG-ORG,PROPN-PROPN-PROPN,PROPN-PROPN,compound-compound-pobj,compound-nsubj,NNP-NNP-NNP,NNP-NNP,-1,1
3,2.0,37,returned,9,9,22,13,8,14,0,13,Sherman,Union forces,PER,ORG-ORG,PROPN,PROPN-NOUN,nsubj,compound-dobj,NNP,NNP-NNS,3,1
4,3.0,46,hoped,1,29,34,5,28,11,-28,33,Battle of Spring Hill,November 29,MISC-MISC-MISC-MISC,TIME-TIME,PROPN-ADP-PROPN-PROPN,PROPN-NUM,pobj-prep-compound-pobj,pobj-nummod,NNP-IN-NNP-NNP,NNP-CD,6,1
0,0.0,27,is,3,1,8,7,0,18,2,5,Bawean,Indonesia,LOC,LOC,PROPN,PROPN,nsubj,pobj,NNP,NNP,3,1
1,0.0,27,is,3,8,19,11,7,7,-5,16,Indonesia,Java,LOC,LOC,PROPN,PROPN,pobj,pobj,NNP,NNP,2,1
2,0.0,27,is,3,16,19,3,15,7,-13,16,Surabaya,Java Sea,LOC,LOC-LOC,PROPN,PROPN-PROPN,pobj,compound-pobj,NNP,NNP-NNP,1,1
3,1.0,11,administered,2,5,8,3,4,2,-3,6,Gresik Regency,East Java,ORG-ORG,LOC-LOC,PROPN-PROPN,PROPN-PROPN,compound-pobj,compound-compound,NNP-NNP,NNP-NNP,3,1
0,0.0,17,was,12,1,5,4,0,11,11,-7,Henry David Keigwin,14 May 1881,PER-PER-PER,TIME-TIME-TIME,PROPN-PROPN-PROPN,NUM-PROPN-NUM,compound-compound-nsubj,nummod-nmod-nummod,NNP-NNP-NNP,CD-NNP-CD,2,1
1,0.0,17,was,12,1,9,8,0,7,11,-3,Henry David Keigwin,20 September 1916,PER-PER-PER,TIME-TIME-TIME,PROPN-PROPN-PROPN,NUM-PROPN-NUM,compound-compound-nsubj,nummod-npadvmod-nummod,NNP-NNP-NNP,CD-NNP-CD,2,1
2,1.0,15,born,2,12,14,2,11,0,-10,12,Thiepval,France,LOC,LOC,PROPN,PROPN,pobj,appos,NNP,NNP,5,1
3,2.0,17,educated,2,16,5,-11,15,11,-14,3,Herbert Keigwin,Clifton College,PER-PER,ORG-ORG,PROPN-PROPN,PROPN-PROPN,compound-conj,compound-pobj,NNP-NNP,NNP-NNP,7,1
4,6.0,26,returned,1,9,18,9,8,7,-8,17,Lancashire Fusiliers,Great War,ORG-ORG,MISC-MISC,PROPN-PROPN,PROPN-PROPN,compound-pobj,compound-pobj,NNP-NNPS,NNP-NNP,8,1
0,0.0,22,reigned,2,14,21,7,13,0,-12,19,Shewa,Ethiopia,LOC,LOC,PROPN,PROPN,pobj,pobj,NNP,NNP,5,1
1,0.0,22,reigned,2,18,21,3,17,0,-16,19,Amhara,Ethiopia,LOC,LOC,PROPN,PROPN,appos,pobj,NNP,NNP,5,1
0,0.0,30,is,9,1,8,7,0,21,8,-1,Olga Yakovlevna Ivanova,1945,PER-PER-PER,TIME,PROPN-PROPN-PROPN,NUM,compound-compound-nsubj,npadvmod,NNP-NNP-NNP,CD,-1,1
1,1.0,33,graduated,1,1,5,4,0,27,0,4,Ivanova,Moscow State Institute of International Relations,PER,ORG-ORG-ORG-ORG-ORG-ORG,PROPN,PROPN-PROPN-PROPN-ADP-PROPN-PROPN,nsubj,compound-compound-pobj-prep-compound-pobj,NNP,NNP-NNP-NNP-IN-NNP-NNPS,3,1
2,2.0,40,From,0,37,39,2,36,0,-37,39,Paris,France,LOC,LOC,PROPN,PROPN,pobj,appos,NNP,NNP,5,1
0,0.0,31,is,22,1,6,5,0,24,21,-16,Jason Sheldon Zimmerman,"February 5 , 1989",PER-PER-PER,TIME-TIME-TIME-TIME,PROPN-PROPN-PROPN,PROPN-NUM-PUNCT-NUM,compound-compound-nsubj,npadvmod-nummod-punct-nummod,NNP-NNP-NNP,"NNP-CD-,-CD",4,1
1,0.0,31,is,22,1,25,24,0,5,21,3,Jason Sheldon Zimmerman,American,PER-PER-PER,LOC,PROPN-PROPN-PROPN,ADJ,compound-compound-nsubj,amod,NNP-NNP-NNP,JJ,5,1
2,3.0,18,is,1,14,7,-7,13,10,-13,6,Project M,Super Smash Bros.,ORG-ORG,MISC-MISC-MISC,PROPN-PROPN,PROPN-PROPN-PROPN,compound-conj,compound-compound-pobj,NNP-NNP,NNP-NNP-NNP,7,1
3,6.0,15,is,12,14,2,-12,13,12,-2,-10,Cloud,Super Smash Bros.,PER,MISC-MISC-MISC,PROPN,PROPN-PROPN-PROPN,attr,compound-compound-pobj,NNP,NNP-NNP-NNP,4,1
0,0.0,23,Pritt,2,1,7,6,0,15,1,5,Denis Nowell Pritt,22 September 1887,PER-PER-PER,TIME-TIME-TIME,PROPN-PROPN-PROPN,NUM-PROPN-NUM,compound-compound-ROOT,nummod-npadvmod-nummod,NNP-NNP-NNP,CD-NNP-CD,3,1
1,0.0,23,Pritt,2,1,11,10,0,11,1,9,Denis Nowell Pritt,23 May 1972,PER-PER-PER,TIME-TIME-TIME,PROPN-PROPN-PROPN,NUM-PROPN-NUM,compound-compound-ROOT,nummod-nsubj-nummod,NNP-NNP-NNP,CD-NNP-CD,2,1
2,0.0,23,Pritt,2,1,17,16,0,5,1,15,Denis Nowell Pritt,British,PER-PER-PER,LOC,PROPN-PROPN-PROPN,ADJ,compound-compound-ROOT,amod,NNP-NNP-NNP,JJ,3,1
0,3.0,64,is,3,7,7,0,6,56,-4,4,Microsoft Visual C++,Microsoft,MISC-MISC-MISC,ORG,PROPN-PROPN-PROPN,PROPN,compound-compound-pobj,pobj,NNP-NNP-NNP,NNP,0,1
0,0.0,58,was,15,1,12,11,0,45,14,-3,Stephen Báthory,12 December 1586,PER-PER,TIME-TIME-TIME,PROPN-PROPN,NUM-PROPN-NUM,compound-compound,nummod-npadvmod-nummod,NNP-NNP,CD-NNP-CD,-1,1
1,0.0,58,was,15,38,47,9,37,10,-23,32,Anna Jagiellon,Poland,PER-PER,LOC,PROPN-PROPN,PROPN,compound-poss,pobj,NNP-NNP,NNP,5,1
2,1.0,36,was,17,6,4,-2,5,31,11,-13,Báthory,Stephen VIII Báthory,PER,PER-PER-PER,PROPN,PROPN-PROPN-PROPN,nsubj,compound-compound-pobj,NNP,NNP-NNP-NNP,4,1
0,0.0,19,is,1,1,12,11,0,6,0,11,Lora,Croatia,LOC,LOC,PROPN,PROPN,nsubj,appos,NNP,NNP,6,1
1,0.0,19,is,1,10,12,2,9,6,-9,11,Split,Croatia,LOC,LOC,PROPN,PROPN,pobj,appos,NNP,NNP,2,1
2,0.0,19,is,1,10,16,6,9,2,-9,15,Split,Bay of Kaštela,LOC,LOC-LOC-LOC,PROPN,PROPN-ADP-PROPN,pobj,pobj-prep-pobj,NNP,NNP-IN-NNP,8,1
3,8.0,19,is,12,11,8,-3,10,10,1,-4,Velebit,Croatian Navy,MISC,ORG-ORG,PROPN,PROPN-PROPN,appos,compound-pobj,NNP,NNP-NNP,5,1
0,0.0,35,Renavent,1,1,8,7,0,26,0,7,Georges Renavent,"April 23 , 1892",PER-PER,TIME-TIME-TIME-TIME,PROPN-PROPN,PROPN-NUM-PUNCT-NUM,compound-ROOT,npadvmod-nummod-punct-nummod,NNP-NNP,"NNP-CD-,-CD",3,1
1,0.0,35,Renavent,1,1,13,12,0,21,0,12,Georges Renavent,"January 2 , 1969",PER-PER,TIME-TIME-TIME-TIME,PROPN-PROPN,PROPN-NUM-PUNCT-NUM,compound-ROOT,nsubj-nummod-punct-nummod,NNP-NNP,"NNP-CD-,-CD",2,1
2,0.0,35,Renavent,1,1,20,19,0,14,0,19,Georges Renavent,French,PER-PER,LOC,PROPN-PROPN,ADJ,compound-ROOT,amod,NNP-NNP,JJ,4,1
3,2.0,18,immigrated,4,17,8,-9,16,9,-13,4,Vermont,United States,LOC,LOC-LOC,PROPN,PROPN-PROPN,conj,compound-pobj,NNP,NNP-NNP,3,1
4,3.0,33,was,1,5,13,8,4,19,-4,12,Selena Royle,Edwin Milton Royle,PER-PER,PER-PER-PER,PROPN-PROPN,PROPN-PROPN-PROPN,compound-pobj,compound-compound-pobj,NNP-NNP,NNP-NNP-NNP,4,1
0,0.0,18,is,9,14,16,2,13,1,-5,7,China,Jiangxi province,LOC,LOC-LOC,PROPN,PROPN-NOUN,poss,compound-pobj,NNP,NNP-NN,2,1
0,0.0,37,formed,10,2,6,4,1,30,8,-4,Battle of Mansfield,8 April 1864,MISC-MISC-MISC,TIME-TIME-TIME,PROPN-ADP-PROPN,NUM-PROPN-NUM,nsubj-prep-pobj,nummod-pobj-nummod,NNP-IN-NNP,CD-NNP-CD,3,1
1,0.0,37,formed,10,2,15,13,1,21,8,5,Battle of Mansfield,Red River Campaign,MISC-MISC-MISC,MISC-MISC-MISC,PROPN-ADP-PROPN,PROPN-PROPN-PROPN,nsubj-prep-pobj,compound-compound-pobj,NNP-IN-NNP,NNP-NNP-NNP,6,1
2,0.0,37,formed,10,2,20,18,1,16,8,10,Battle of Mansfield,American Civil War,MISC-MISC-MISC,MISC-MISC-MISC,PROPN-ADP-PROPN,PROPN-PROPN-PROPN,nsubj-prep-pobj,compound-compound-pobj,NNP-IN-NNP,NNP-NNP-NNP,5,1
3,0.0,37,formed,10,2,36,34,1,0,8,26,Battle of Mansfield,Shreveport,MISC-MISC-MISC,LOC,PROPN-ADP-PROPN,PROPN,nsubj-prep-pobj,appos,NNP-IN-NNP,NNP,3,1
4,0.0,37,formed,10,15,20,5,14,16,-5,10,Red River Campaign,American Civil War,MISC-MISC-MISC,MISC-MISC-MISC,PROPN-PROPN-PROPN,PROPN-PROPN-PROPN,compound-compound-pobj,compound-compound-pobj,NNP-NNP-NNP,NNP-NNP-NNP,7,1
5,1.0,30,chose,9,28,24,-4,27,5,-19,15,Nathaniel Banks,Union army,PER-PER,ORG-ORG,PROPN-PROPN,PROPN-NOUN,compound-pobj,compound-pobj,NNP-NNPS,NNP-NN,2,1
0,0.0,35,Kinzie,1,1,4,3,0,30,0,3,John Kinzie,"December 3 , 1763",PER-PER,TIME-TIME-TIME-TIME,PROPN-PROPN,PROPN-NUM-PUNCT-NUM,compound-ROOT,appos-nummod-punct-nummod,NNP-NNP,"NNP-CD-,-CD",2,1
1,0.0,35,Kinzie,1,1,9,8,0,25,0,8,John Kinzie,"January 6 , 1828",PER-PER,TIME-TIME-TIME-TIME,PROPN-PROPN,PROPN-NUM-PUNCT-NUM,compound-ROOT,nsubj-nummod-punct-nummod,NNP-NNP,"NNP-CD-,-CD",3,1
2,0.0,35,Kinzie,1,1,19,18,0,15,0,18,John Kinzie,Quebec,PER-PER,LOC,PROPN-PROPN,PROPN,compound-ROOT,pobj,NNP-NNP,NNP,6,1
3,0.0,35,Kinzie,1,24,33,9,23,1,-23,32,Detroit,United States,LOC,LOC-LOC,PROPN,PROPN-PROPN,pobj,compound-pobj,NNP,NNP-NNP,5,1
4,0.0,35,Kinzie,1,29,33,4,28,1,-28,32,Northwest Territory,United States,LOC-LOC,LOC-LOC,PROPN-PROPN,PROPN-PROPN,compound-attr,compound-pobj,NNP-NNP,NNP-NNP,2,1
5,3.0,25,believed,11,3,9,6,2,15,8,-2,Ellen Marion Kinzie,1805,PER-PER-PER,TIME,PROPN-PROPN-PROPN,NUM,compound-compound-appos,pobj,NNP-NNP-NNP,CD,4,1
6,6.0,30,accused,13,3,28,25,2,1,10,15,War of 1812,Great Britain,MISC-MISC-MISC,LOC-LOC,PROPN-ADP-NUM,PROPN-PROPN,pobj-prep-pobj,compound-pobj,NNP-IN-CD,NNP-NNP,10,1
7,7.0,16,returned,4,13,7,-6,12,8,-9,3,Chicago,American,LOC,LOC,PROPN,ADJ,pobj,amod,NNP,JJ,4,1
0,0.0,19,is,4,1,14,13,0,4,3,10,Xue Pan,Dream of the Red Chamber,PER-PER,MISC-MISC-MISC-MISC-MISC,PROPN-PROPN,PROPN-ADP-DET-PROPN-PROPN,compound-nsubj,pobj-prep-det-compound-pobj,NNP-NNP,NNP-IN-DT-NNP-NNP,5,1
0,0.0,22,was,15,1,4,3,0,17,14,-11,Peter Merian,20 December 1795,PER-PER,TIME-TIME-TIME,PROPN-PROPN,NUM-PROPN-NUM,compound-nsubj,nummod-appos-nummod,NNP-NNP,CD-NNP-CD,1,1
1,0.0,22,was,15,1,10,9,0,11,14,-5,Peter Merian,8 February 1883,PER-PER,TIME-TIME-TIME,PROPN-PROPN,NUM-PROPN-NUM,compound-nsubj,nummod-appos-nummod,NNP-NNP,CD-NNP-CD,2,1
2,1.0,35,studied,1,31,6,-25,30,28,-30,5,Johann Friedrich Ludwig Hausmann,University of Göttingen,PER-PER-PER-PER,ORG-ORG-ORG,PROPN-PROPN-PROPN-PROPN,PROPN-ADP-PROPN,compound-compound-compound-pobj,pobj-prep-pobj,NNP-NNP-NNP-NNP,NNP-IN-NNP,8,1
0,0.0,40,was,7,2,17,15,1,22,5,10,Stajićevo,Serbia,LOC,LOC,PROPN,PROPN,pobj,appos,NNP,NNP,3,1
1,0.0,40,was,7,2,38,36,1,1,5,31,Stajićevo,Serbian,LOC,LOC,PROPN,ADJ,pobj,amod,NNP,JJ,9,1
2,0.0,40,was,7,15,17,2,14,22,-8,10,Zrenjanin,Serbia,LOC,LOC,PROPN,PROPN,pobj,appos,NNP,NNP,8,1
3,0.0,40,was,7,15,38,23,14,1,-8,31,Zrenjanin,Serbian,LOC,LOC,PROPN,ADJ,pobj,amod,NNP,JJ,14,1
4,0.0,40,was,7,17,22,5,16,17,-10,15,Serbia,SFR Yugoslavia,LOC,LOC-LOC,PROPN,PROPN-PROPN,appos,compound-pobj,NNP,NNP-NNP,4,1
5,0.0,40,was,7,17,26,9,16,13,-10,19,Serbia,FRY,LOC,LOC,PROPN,PROPN,appos,appos,NNP,NNP,6,1
6,0.0,40,was,7,22,26,4,21,13,-15,19,SFR Yugoslavia,FRY,LOC-LOC,LOC,PROPN-PROPN,PROPN,compound-pobj,appos,NNP-NNP,NNP,2,1
7,0.0,40,was,7,26,38,12,25,1,-19,31,FRY,Serbian,LOC,LOC,PROPN,ADJ,appos,amod,NNP,JJ,4,1
8,4.0,22,cited,3,20,18,-2,19,3,-17,15,Slobodan Milošević,Serbian,PER-PER,LOC,PROPN-PROPN,ADJ,compound-pobj,amod,NNP-NNP,JJ,1,1
0,0.0,45,Squires,2,1,5,4,0,39,1,3,John C. Squires,"May 19 , 1925",PER-PER-PER,TIME-TIME-TIME-TIME,PROPN-PROPN-PROPN,PROPN-NUM-PUNCT-NUM,compound-compound-ROOT,appos-nummod-punct-npadvmod,NNP-NNP-NNP,"NNP-CD-,-CD",3,1
1,0.0,45,Squires,2,1,5,4,0,39,1,3,John C. Squires,"May 23 , 1944",PER-PER-PER,TIME-TIME-TIME-TIME,PROPN-PROPN-PROPN,VERB-NUM-PUNCT-NUM,compound-compound-ROOT,nsubj-nummod-punct-nummod,NNP-NNP-NNP,"MD-CD-,-CD",3,1
2,0.0,45,Squires,2,1,17,16,0,27,1,15,John C. Squires,United States Army,PER-PER-PER,ORG-ORG-ORG,PROPN-PROPN-PROPN,PROPN-PROPN-PROPN,compound-compound-ROOT,compound-compound-compound,NNP-NNP-NNP,NNP-NNP-NNP,5,1
3,0.0,45,Squires,2,1,25,24,0,19,1,23,John C. Squires,the United States,PER-PER-PER,LOC-LOC-LOC,PROPN-PROPN-PROPN,DET-PROPN-PROPN,compound-compound-ROOT,det-compound-compound,NNP-NNP-NNP,DT-NNP-NNP,9,1
4,0.0,45,Squires,2,1,42,41,0,2,1,40,John C. Squires,World War II,PER-PER-PER,MISC-MISC-MISC,PROPN-PROPN-PROPN,PROPN-PROPN-PROPN,compound-compound-ROOT,compound-compound-pobj,NNP-NNP-NNP,NNP-NNP-NNP,9,1
5,0.0,45,Squires,2,17,42,25,16,2,-15,40,United States Army,World War II,ORG-ORG-ORG,MISC-MISC-MISC,PROPN-PROPN-PROPN,PROPN-PROPN-PROPN,compound-compound-compound,compound-compound-pobj,NNP-NNP-NNP,NNP-NNP-NNP,8,1
6,1.0,41,joined,1,1,4,3,0,36,0,3,Squires,Army,PER,ORG,NOUN,PROPN,nsubj,dobj,NNS,NNP,1,1
7,2.0,38,braved,14,9,11,2,8,26,5,-3,Padiglione,Italy,LOC,LOC,PROPN,PROPN,pobj,appos,NNP,NNP,4,1
8,5.0,23,buried,9,12,22,10,11,0,-3,13,Zachary Taylor National Cemetery,Kentucky,LOC-LOC-LOC-LOC,LOC,PROPN-PROPN-PROPN-PROPN,PROPN,compound-compound-compound-pobj,appos,NNP-NNP-NNP-NNP,NNP,4,1
0,0.0,25,is,3,1,14,13,0,10,2,11,World of Fantasy,Capsule,MISC-MISC-MISC,ORG,PROPN-ADP-PROPN,PROPN,nsubj-prep-pobj,appos,NNP-IN-NNP,NNP,4,1
1,0.0,25,is,3,14,24,10,13,0,-11,21,Capsule,Japan,ORG,LOC,PROPN,PROPN,appos,pobj,NNP,NNP,3,1
0,5.0,24,has,1,8,19,11,7,4,-7,18,Travemünde,river Trave,LOC,LOC-LOC,PROPN,NOUN-PROPN,pobj,pobj-appos,NNP,NN-NNP,7,1
1,5.0,24,has,1,8,13,5,7,10,-7,12,Travemünde,Lübeck Bay,LOC,LOC-LOC,PROPN,PROPN-PROPN,pobj,compound-pobj,NNP,NNP-NNP,3,1
2,5.0,24,has,1,8,13,5,7,10,-7,12,Travemünde,Lübeck,LOC,LOC,PROPN,PROPN,pobj,pobj,NNP,NNP,3,1
3,5.0,24,has,1,19,13,-6,18,10,-18,12,river Trave,Lübeck Bay,LOC-LOC,LOC-LOC,NOUN-PROPN,PROPN-PROPN,pobj-appos,compound-pobj,NN-NNP,NNP-NNP,4,1
0,0.0,31,was,15,1,12,11,0,18,14,-3,Antonie Philips van Leeuwenhoek,26 August 1723,PER-PER-PER-PER,TIME-TIME-TIME,PROPN-PROPN-PROPN-PROPN,NUM-PROPN-NUM,compound-compound-compound-compound,nummod-appos-nummod,NNP-NNP-NNP-NNP,CD-NNP-CD,6,1
1,3.0,24,worked,9,3,5,2,2,18,6,-4,Delft,Dutch Republic,LOC,LOC-LOC,PROPN,PROPN-PROPN,pobj,compound-conj,NNP,NNP-NNP,2,1
0,0.0,18,was,13,1,6,5,0,11,12,-7,Émile Louis Fortuné Pessard,29 May 1843,PER-PER-PER-PER,TIME-TIME-TIME,PROPN-PROPN-PROPN-PROPN,NUM-PROPN-NUM,compound-compound-compound-nsubj,nummod-nmod-nummod,NNP-NNP-NNP-NNP,CD-NNP-CD,2,1
1,0.0,18,was,13,1,10,9,0,7,12,-3,Émile Louis Fortuné Pessard,10 February 1917,PER-PER-PER-PER,TIME-TIME-TIME,PROPN-PROPN-PROPN-PROPN,NUM-PROPN-NUM,compound-compound-compound-nsubj,nummod-appos-nummod,NNP-NNP-NNP-NNP,CD-NNP-CD,3,1
2,1.0,8,born,2,1,7,6,0,0,1,5,Pessard,Paris,PER,LOC,PROPN,PROPN,nsubjpass,pobj,NNP,NNP,2,1
0,0.0,14,is,3,2,9,7,1,4,1,6,Rammstein,German,MISC,LOC,NOUN,ADJ,nsubj,amod,NN,JJ,8,1
0,5.0,42,gone,2,32,34,2,31,7,-30,32,Kindred,2012,MISC,TIME,PROPN,NUM,pobj,npadvmod,NNP,CD,2,1
1,5.0,42,gone,2,32,37,5,31,4,-30,35,Kindred,Rival Dealer,MISC,MISC-MISC,PROPN,PROPN-PROPN,pobj,compound-conj,NNP,NNP-NNP,2,1
2,5.0,42,gone,2,37,40,3,36,1,-35,38,Rival Dealer,2013,MISC-MISC,TIME,PROPN-PROPN,NUM,compound-conj,npadvmod,NNP-NNP,CD,1,1
0,0.0,37,was,13,1,9,8,0,27,12,-4,Conrad Baker,"April 28 , 1885",PER-PER,TIME-TIME-TIME-TIME,PROPN-PROPN,PROPN-NUM-PUNCT-NUM,compound-nsubj,appos-nummod-punct-nummod,NNP-NNP,"NNP-CD-,-CD",3,1
1,0.0,37,was,13,29,32,3,28,4,-16,19,U.S.,Indiana,LOC,LOC,PROPN,PROPN,compound,pobj,NNP,NNP,3,1
2,1.0,46,served,2,1,6,5,0,39,1,4,Baker,Union Army,PER,ORG-ORG,PROPN,PROPN-PROPN,nsubj,compound-pobj,NNP,NNP-NNP,3,1
3,1.0,46,served,2,1,10,9,0,35,1,8,Baker,American Civil War,PER,MISC-MISC-MISC,PROPN,PROPN-PROPN-PROPN,nsubj,compound-compound-pobj,NNP,NNP-NNP-NNP,4,1
0,0.0,9,is,1,1,8,7,0,0,0,7,Taraklı,Turkey,LOC,LOC,PROPN,PROPN,nsubj,pobj,NNP,NNP,1,1
0,0.0,29,is,1,1,26,25,0,2,0,25,Boisdale,Shire of Wellington,LOC,LOC-LOC-LOC,PROPN,PROPN-ADP-PROPN,nsubj,pobj-prep-pobj,NNP,NNP-IN-NNP,4,1
1,0.0,29,is,1,7,11,4,6,17,-6,10,Central Gippsland,Victoria,LOC-LOC,LOC,PROPN-PROPN,PROPN,compound-compound,pobj,NNP-NNP,NNP,4,1
2,0.0,29,is,1,7,13,6,6,15,-6,12,Central Gippsland,Australia,LOC-LOC,LOC,PROPN-PROPN,PROPN,compound-compound,appos,NNP-NNP,NNP,4,1
3,0.0,29,is,1,11,26,15,10,2,-10,25,Victoria,Shire of Wellington,LOC,LOC-LOC-LOC,PROPN,PROPN-ADP-PROPN,pobj,pobj-prep-pobj,NNP,NNP-IN-NNP,8,1
4,0.0,29,is,1,22,26,4,21,2,-21,25,Maffra,Shire of Wellington,LOC,LOC-LOC-LOC,PROPN,PROPN-ADP-PROPN,pobj,pobj-prep-pobj,NNP,NNP-IN-NNP,6,1
5,5.0,20,is,1,14,19,5,13,0,-13,18,Melbourne,Victoria,LOC,LOC,PROPN,PROPN,appos,pobj,NNP,NNP,6,1
6,5.0,20,is,1,14,8,-6,13,11,-13,7,Melbourne,Australia,LOC,LOC,PROPN,PROPN,appos,poss,NNP,NNP,4,1
7,6.0,28,was,1,20,24,4,19,3,-19,23,South Uist,Outer Hebrides,LOC-LOC,LOC-LOC,PROPN-PROPN,PROPN-PROPN,compound-pobj,compound-pobj,NNP-NNP,NNP-NNP,2,1
8,6.0,28,was,1,20,27,7,19,0,-19,26,South Uist,Scotland,LOC-LOC,LOC,PROPN-PROPN,PROPN,compound-pobj,appos,NNP-NNP,NNP,8,1
9,6.0,28,was,1,24,27,3,23,0,-23,26,Outer Hebrides,Scotland,LOC-LOC,LOC,PROPN-PROPN,PROPN,compound-pobj,appos,NNP-NNP,NNP,10,1
0,0.0,38,was,10,1,8,7,0,29,9,-2,Stephen IV,April 1165,PER-PER,TIME-TIME,PROPN-PROPN,PROPN-NUM,compound-nsubj,appos-nummod,NNP-NNP,NNP-CD,2,1
1,7.0,13,died,2,1,5,4,0,7,1,3,Ladislaus II,14 January 1163,PER-PER,TIME-TIME-TIME,PROPN-PROPN,NUM-PROPN-NUM,compound-nsubj,nummod-pobj-nummod,NNP-NNP,CD-NNP-CD,3,1
2,10.0,30,routed,18,10,29,19,9,0,8,11,Székesfehérvár,Hungary,LOC,LOC,PROPN,PROPN,pobj,dobj,NNP,NNP,5,1
3,13.0,21,died,1,17,19,2,16,1,-16,18,Zemun,Serbia,LOC,LOC,PROPN,PROPN,appos,pobj,NNP,NNP,2,1
0,0.0,50,is,22,8,41,33,7,8,14,19,Republic of China,Taiwan,LOC-LOC-LOC,LOC,PROPN-ADP-PROPN,PROPN,pobj-prep-pobj,appos,NNP-IN-NNP,NNP,10,1
1,1.0,27,is,1,19,11,-8,18,15,-18,10,Taiwan,Republic of China,LOC,ORG-ORG-ORG,PROPN,PROPN-ADP-PROPN,pobj,pobj-prep-pobj,NNP,NNP-IN-NNP,5,1
2,8.0,19,Chinese,1,8,4,-4,7,14,-7,3,Lee Teng - hui,中華民國在臺灣,PER-PER-PER-PER,MISC,PROPN-PROPN-PUNCT-PROPN,NOUN,compound-compound-punct-poss,appos,NNP-NNP-HYPH-NNP,NN,5,1
3,10.0,19,Chinese,1,4,8,4,3,10,-3,7,中華民國是臺灣,Chen Shui - bian,MISC,PER-PER-PER-PER,PROPN,PROPN-PROPN-PUNCT-PROPN,appos,compound-compound-punct-poss,NNP,NNP-NNP-HYPH-NNP,6,1
4,10.0,19,Chinese,1,4,16,12,3,2,-3,15,中華民國是臺灣,2000,MISC,TIME,PROPN,NUM,appos,nummod,NNP,CD,6,1
0,0.0,29,is,5,1,12,11,0,16,4,7,The War of the Lions,Square Enix,MISC-MISC-MISC-MISC-MISC,ORG-ORG,DET-PROPN-ADP-DET-PROPN,PROPN-PROPN,det-nsubj-prep-det-pobj,compound-poss,DT-NNP-IN-DT-NNPS,NNP-NNP,5,1
1,0.0,29,is,5,1,16,15,0,12,4,11,The War of the Lions,Ivalice Alliance,MISC-MISC-MISC-MISC-MISC,MISC-MISC,DET-PROPN-ADP-DET-PROPN,PROPN-PROPN,det-nsubj-prep-det-pobj,nmod-nmod,DT-NNP-IN-DT-NNPS,NNP-NNP,5,1
2,0.0,29,is,5,1,16,15,0,12,4,11,The War of the Lions,Ivalice,MISC-MISC-MISC-MISC-MISC,MISC,DET-PROPN-ADP-DET-PROPN,PROPN,det-nsubj-prep-det-pobj,nmod,DT-NNP-IN-DT-NNPS,NNP,5,1
3,1.0,26,is,2,8,23,15,7,2,-6,21,Final Fantasy XII,Nintendo DS,MISC-MISC-MISC,MISC-MISC,PROPN-PROPN-PROPN,PROPN-PROPN,compound-compound-pobj,compound-pobj,NNP-NNP-NNP,NNP-NNP,8,1
4,2.0,36,has,9,1,33,32,0,2,8,24,Ivalice,Final Fantasy,MISC,MISC-MISC,PROPN,PROPN-PROPN,nsubj,compound-compound,NNP,NNP-NNP,13,1
5,6.0,50,includes,5,33,12,-21,32,37,-28,7,Cloud Strife,Final Fantasy VII,PER-PER,MISC-MISC-MISC,PROPN-PROPN,PROPN-PROPN-PROPN,compound-dobj,compound-compound-pobj,NNP-NNP,NNP-NNP-NNP,7,1
0,0.0,18,is,11,1,14,13,0,3,10,3,James Carter Walker Jr.,American,PER-PER-PER-PER,LOC,PROPN-PROPN-PROPN-PROPN,ADJ,compound-compound-compound-nsubj,amod,NNP-NNP-NNP-NNP,JJ,3,1
1,1.0,40,known,3,7,31,24,6,8,-4,28,James Evans Sr .,Good Times,PER-PER-PER-PER,MISC-MISC,PROPN-PROPN-PROPN-PROPN,PROPN-PROPN,compound-compound-subtok-ROOT,compound-appos,NNP-NNP-NNP-NNP,NNP-NNP,-1,1
2,1.0,40,known,3,31,37,6,30,2,-28,34,Good Times,1974,MISC-MISC,TIME,PROPN-PROPN,NUM,compound-appos,pobj,NNP-NNP,CD,3,1
0,0.0,32,is,2,1,8,7,0,23,1,6,Sherman Island,Sacramento County,LOC-LOC,LOC-LOC,PROPN-PROPN,PROPN-PROPN,compound-nsubj,compound-pobj,NNP-NNP,NNP-NNP,5,1
1,0.0,32,is,2,1,25,24,0,6,1,23,Sherman Island,California,LOC-LOC,LOC,PROPN-PROPN,PROPN,compound-nsubj,appos,NNP-NNP,NNP,7,1
2,0.0,32,is,2,8,25,17,7,6,-6,23,Sacramento County,California,LOC-LOC,LOC,PROPN-PROPN,PROPN,compound-pobj,appos,NNP-NNP,NNP,8,1
0,7.0,19,nominated,5,18,3,-15,17,15,-13,-2,Bhavna,Shabana Azmi,MISC,PER-PER,PROPN,PROPN-PROPN,appos,compound-nsubjpass,NNP,NNP-NNP,2,1
0,0.0,20,is,6,12,16,4,11,3,-6,10,Uttara Kannada,Karnataka,LOC-LOC,LOC,PROPN-PROPN,PROPN,compound-compound,compound,NNP-NNP,NNP,3,1
1,0.0,20,is,6,12,19,7,11,0,-6,13,Uttara Kannada,India,LOC-LOC,LOC,PROPN-PROPN,PROPN,compound-compound,pobj,NNP-NNP,NNP,6,1
0,0.0,18,is,1,1,16,15,0,1,0,15,Preakness,United States,LOC,LOC-LOC,PROPN,PROPN-PROPN,nsubj,compound-appos,NNP,NNP-NNP,3,1
1,0.0,18,is,1,8,10,2,7,7,-7,9,Wayne,Passaic County,LOC,LOC-LOC,PROPN,PROPN-PROPN,pobj,compound-pobj,NNP,NNP-NNP,1,1
2,0.0,18,is,1,8,16,8,7,1,-7,15,Wayne,United States,LOC,LOC-LOC,PROPN,PROPN-PROPN,pobj,compound-appos,NNP,NNP-NNP,2,1
3,0.0,18,is,1,10,13,3,9,4,-9,12,Passaic County,New Jersey,LOC-LOC,LOC-LOC,PROPN-PROPN,PROPN-PROPN,compound-pobj,compound-conj,NNP-NNP,NNP-NNP,1,1
4,0.0,18,is,1,10,16,6,9,1,-9,15,Passaic County,United States,LOC-LOC,LOC-LOC,PROPN-PROPN,PROPN-PROPN,compound-pobj,compound-appos,NNP-NNP,NNP-NNP,3,1
5,0.0,18,is,1,13,16,3,12,1,-12,15,New Jersey,United States,LOC-LOC,LOC-LOC,PROPN-PROPN,PROPN-PROPN,compound-conj,compound-appos,NNP-NNP,NNP-NNP,4,1
6,1.0,43,owned,24,14,20,6,13,22,10,-4,Pimlico Race Course,Maryland,LOC-LOC-LOC,LOC,PROPN-PROPN-PROPN,PROPN,compound-compound-pobj,nsubjpass,NNP-NNP-NNP,NNP,6,1
7,1.0,43,owned,24,18,20,2,17,22,6,-4,Baltimore,Maryland,LOC,LOC,PROPN,PROPN,pobj,nsubjpass,NNP,NNP,2,1
0,0.0,26,is,16,1,14,13,0,11,15,-2,Jarekus Singleton,United States,PER-PER,LOC-LOC,PROPN-PROPN,PROPN-PROPN,compound-nsubj,compound-conj,NNP-NNP,NNP-NNP,5,1
1,0.0,26,is,16,10,14,4,9,11,6,-2,Clinton,United States,LOC,LOC-LOC,PROPN,PROPN-PROPN,pobj,compound-conj,NNP,NNP-NNP,3,1
2,0.0,26,is,16,12,14,2,11,11,4,-2,Mississippi,United States,LOC,LOC-LOC,PROPN,PROPN-PROPN,conj,compound-conj,NNP,NNP-NNP,2,1
0,8.0,24,ousted,2,1,10,9,0,13,1,8,Sankara,15 October 1987,PER,TIME-TIME-TIME,PROPN,NUM-PROPN-NUM,nsubjpass,nummod-pobj-nummod,NNP,CD-NNP-CD,6,1
0,0.0,27,was,2,1,10,9,0,16,1,8,Lady Mi,Liu Bei,PER-PER,PER-PER,PROPN-PROPN,PROPN-PROPN,compound-nsubj,compound-appos,NNP-NNP,NNP-NNP,5,1
1,0.0,27,was,2,10,26,16,9,0,-8,24,Liu Bei,China,PER-PER,LOC,PROPN-PROPN,PROPN,compound-appos,pobj,NNP-NNP,NNP,5,1
2,0.0,27,was,2,22,26,4,21,0,-20,24,Three Kingdoms,China,MISC-MISC,LOC,NUM-PROPN,PROPN,compound-compound,pobj,CD-NNP,NNP,6,1
3,1.0,24,was,1,23,21,-2,22,2,-22,20,Jiangsu,Lianyungang,LOC,LOC,PROPN,PROPN,appos,attr,NNP,NNP,7,1
4,2.0,25,had,1,6,6,0,5,18,-5,5,Mi Zhu,Mi Fang,PER-PER,PER-PER,PROPN-PROPN,PROPN-PROPN,compound-appos,compound-conj,NNP-NNP,NNP-NNP,0,1
0,1.0,31,was,2,1,7,6,0,23,1,5,Rachel Boymvol,Judah - Leib Boimvol,PER-PER,PER-PER-PER-PER,PROPN-PROPN,PROPN-PUNCT-PROPN-PROPN,compound-nsubj,compound-punct-compound-pobj,NNP-NNP,NNP-HYPH-NNP-NNP,6,1
0,0.0,32,bint,1,1,21,20,0,10,0,20,A'isha bint Talhah,Talha ibn Ubayd - Allah,PER-PER-PER,PER-PER-PER-PER-PER,PROPN-NOUN-PROPN,PROPN-PROPN-PROPN-PUNCT-PROPN,amod-ROOT-appos,compound-compound-compound-punct-pobj,NNP-NN-NNP,NNP-NNP-NNP-HYPH-NNP,6,1
1,0.0,32,bint,1,1,27,26,0,4,0,26,A'isha bint Talhah,Umm Kulthum bint Abu Bakr,PER-PER-PER,PER-PER-PER-PER-PER,PROPN-NOUN-PROPN,PROPN-PROPN-NOUN-PROPN-PROPN,amod-ROOT-appos,compound-conj-compound-compound-pobj,NNP-NN-NNP,NNP-NNP-NN-NNP-NNP,6,1
2,1.0,14,was,2,1,12,11,0,1,1,10,Umm Kulthum,Abu Bakr,PER-PER,PER-PER,PROPN-PROPN,PROPN-PROPN,compound-nsubj,compound-appos,NNP-NNP,NNP-NNP,5,1
0,0.0,22,is,2,1,8,7,0,13,1,6,Fort Sumter,Charleston,LOC-LOC,LOC,PROPN-PROPN,PROPN,compound-nsubj,pobj,NNP-NNP,NNP,5,1
1,8.0,22,is,2,1,14,13,0,7,1,12,Fort Sumter National Monument,National Park Service,LOC-LOC-LOC-LOC,ORG-ORG-ORG,PROPN-PROPN-PROPN-PROPN,PROPN-PROPN-PROPN,compound-compound-compound-pobj,compound-compound-pobj,NNP-NNP-NNP-NNP,NNP-NNP-NNP,5,1
0,0.0,19,is,7,2,2,0,1,16,5,-5,Wayne State University College of Engineering,Wayne State University,ORG-ORG-ORG-ORG-ORG-ORG,ORG-ORG-ORG,PROPN-PROPN-PROPN-PROPN-ADP-PROPN,PROPN-PROPN-PROPN,compound-compound-compound-nsubj-prep-pobj,compound-compound-pobj,NNP-NNP-NNP-NNP-IN-NNP,NNP-NNP-NNP,0,1
0,7.0,30,passed,11,21,29,8,20,0,-10,18,Johnson Administration,Vietnam,ORG-ORG,LOC,PROPN-PROPN,PROPN,nmod-nmod,pobj,NNP-NNP,NNP,4,1
0,0.0,20,was,6,16,19,3,15,0,-10,13,Western Isles,Scotland,LOC-LOC,LOC,PROPN-PROPN,PROPN,compound-pobj,pobj,NNP-NNPS,NNP,7,1
0,0.0,23,"""",0,2,19,17,1,3,-2,19,Nisei,The X - Files,MISC,MISC-MISC-MISC-MISC,PROPN,DET-PROPN-PROPN-PROPN,intj,det-compound-punct-ROOT,NNP,DT-NNP-NNP-NNP,9,1
0,0.0,24,is,3,2,6,4,1,17,1,3,Heinlein Society,United States,ORG-ORG,LOC-LOC,PROPN-PROPN,PROPN-PROPN,compound-nsubj,compound-compound,NNP-NNP,NNP-NNP,3,1
1,1.0,31,founded,4,12,17,5,11,13,-8,13,Robert Heinlein,Virginia Heinlein,PER-PER,PER-PER,PROPN-PROPN,PROPN-PROPN,compound-poss,compound-appos,NNP-NNP,NNP-NNP,2,1
0,0.0,17,located,5,2,15,13,1,1,3,10,Rockwell City,United States,LOC-LOC,LOC-LOC,PROPN-PROPN,PROPN-PROPN,compound-pobj,compound-appos,NNP-NNP,NNP-NNP,6,1
1,0.0,17,located,5,13,15,2,12,1,-8,10,Iowa,United States,LOC,LOC-LOC,PROPN,PROPN-PROPN,appos,compound-appos,NNP,NNP-NNP,3,1
0,0.0,25,is,13,11,24,13,10,0,2,11,Haploblepharus kistnasamyi,Scyliorhinidae,MISC-MISC,MISC,PROPN-NOUN,PROPN,compound-appos,pobj,NNP-NN,NNP,5,1
1,2.0,20,is,2,10,14,4,9,5,-8,12,South Africa,Western Cape,LOC-LOC,LOC-LOC,PROPN-PROPN,PROPN-PROPN,compound-pobj,compound-pobj,NNP-NNP,NNP-NNP,4,1
0,3.0,37,owned,12,34,36,2,33,0,-22,24,County,Ireland,LOC,LOC,PROPN,PROPN,conj,conj,NNP,NNP,12,1
0,1.0,46,includes,21,4,12,8,3,33,17,-9,National Statuary Hall,United States Capitol,LOC-LOC-LOC,LOC-LOC-LOC,PROPN-PROPN-PROPN,PROPN-PROPN-PROPN,compound-compound-pobj,compound-compound-pobj,NNP-NNP-NNP,NNP-NNP-NNP,5,1
0,0.0,15,City,2,2,5,3,1,9,0,3,Ellicott City,Howard County,LOC-LOC,LOC-LOC,PROPN-PROPN,PROPN-PROPN,compound-ROOT,compound-pobj,NNP-NNP,NNP-NNP,2,1
1,0.0,15,City,2,2,8,6,1,6,0,6,Ellicott City,Maryland,LOC-LOC,LOC,PROPN-PROPN,PROPN,compound-ROOT,appos,NNP-NNP,NNP,1,1
2,0.0,15,City,2,2,10,8,1,4,0,8,Ellicott City,United States,LOC-LOC,LOC-LOC,PROPN-PROPN,PROPN-PROPN,compound-ROOT,compound-appos,NNP-NNP,NNP-NNP,1,1
3,0.0,15,City,2,5,8,3,4,6,-3,6,Howard County,Maryland,LOC-LOC,LOC,PROPN-PROPN,PROPN,compound-pobj,appos,NNP-NNP,NNP,3,1
4,0.0,15,City,2,5,10,5,4,4,-3,8,Howard County,United States,LOC-LOC,LOC-LOC,PROPN-PROPN,PROPN-PROPN,compound-pobj,compound-appos,NNP-NNP,NNP-NNP,3,1
5,0.0,15,City,2,8,10,2,7,4,-6,8,Maryland,United States,LOC,LOC-LOC,PROPN,PROPN-PROPN,appos,compound-appos,NNP,NNP-NNP,2,1
6,3.0,15,built,3,12,7,-5,11,7,-9,4,Alda Tyson Hopkins,James Clark,PER-PER-PER,PER-PER,PROPN-PROPN-PROPN,PROPN-PROPN,compound-compound-appos,compound-pobj,NNP-NNP-NNP,NNP-NNP,3,1
0,0.0,33,been,4,22,28,6,21,4,-18,24,Olaf Tryggvason,Norway,PER-PER,LOC,PROPN-PROPN,PROPN,compound-pobj,pobj,NNP-NNP,NNP,9,1
0,0.0,15,are,2,1,12,11,0,2,1,10,Arctic Monkeys,Sheffield,MISC-MISC,LOC,PROPN-PROPN,PROPN,compound-nsubj,pobj,NNP-NNP,NNP,5,1
1,3.0,49,began,18,8,13,5,7,35,10,-5,Favourite Worst Nightmare,23 April 2007,MISC-MISC-MISC,TIME-TIME-TIME,PROPN-PROPN-PROPN,NUM-PROPN-NUM,compound-compound-nsubj,nummod-pobj-nummod,NNP-NNP-NNP,CD-NNP-CD,8,1
0,0.0,32,was,15,1,6,5,0,25,14,-9,Shepard J. Crumpacker Jr.,"February 13 , 1917",PER-PER-PER-PER,TIME-TIME-TIME-TIME,PROPN-PROPN-PROPN-PROPN,PROPN-NUM-PUNCT-NUM,compound-compound-compound-nsubj,appos-nummod-punct-nummod,NNP-NNP-NNP-NNP,"NNP-CD-,-CD",3,1
1,2.0,19,graduated,1,1,5,4,0,13,0,4,Crumpacker,University of Michigan Law School,PER,ORG-ORG-ORG-ORG-ORG,PROPN,PROPN-ADP-PROPN-PROPN-PROPN,nsubj,nmod-prep-pobj-compound-pobj,NNP,NNP-IN-NNP-NNP-NNP,1,1
2,2.0,19,graduated,1,1,4,3,0,14,0,3,Crumpacker,Northwestern University,PER,ORG-ORG,PROPN,PROPN-PROPN,nsubj,compound-pobj,NNP,NNP-NNP,2,1
0,2.0,15,born,2,1,5,4,0,9,1,3,Kramer,Hannover,PER,LOC,PROPN,PROPN,nsubjpass,pobj,NNP,NNP,2,1
0,0.0,28,"""",0,2,22,20,1,5,-2,22,Pass It On,2003,MISC-MISC-MISC,TIME,VERB-PRON-ADP,NUM,ROOT-dobj-nsubj,nummod,VB-PRP-IN,CD,10,1
1,0.0,28,"""",0,2,25,23,1,2,-2,25,Pass It On,Magic and Medicine,MISC-MISC-MISC,MISC-MISC-MISC,VERB-PRON-ADP,PROPN-CCONJ-PROPN,ROOT-dobj-nsubj,appos-cc-conj,VB-PRP-IN,NNP-CC-NNP,12,1
2,3.0,18,is,2,12,9,-3,11,8,-10,7,You Like Me Too Much,Beatles,MISC-MISC-MISC-MISC-MISC,ORG,PRON-ADP-PRON-ADV-ADV,PROPN,nsubj-ROOT-dobj-advmod-advmod,compound,PRP-IN-PRP-RB-RB,NNPS,1,1
0,0.0,37,is,8,2,2,0,1,34,6,-6,United States Department of Justice,United States,ORG-ORG-ORG-ORG-ORG,LOC-LOC,PROPN-PROPN-PROPN-ADP-PROPN,PROPN-PROPN,compound-compound-pobj-prep-pobj,compound-compound,NNP-NNP-NNP-IN-NNP,NNP-NNP,0,1
1,3.0,36,provides,2,9,23,14,8,12,-7,21,United States,Congress,LOC-LOC,ORG,PROPN-PROPN,PROPN,compound-pobj,pobj,NNP-NNP,NNP,4,1
0,0.0,25,is,9,22,3,-19,21,21,-13,-6,Cairo,Egypt,LOC,LOC,PROPN,PROPN,pobj,appos,NNP,NNP,7,1
0,0.0,25,Klebs,2,1,5,4,0,19,1,3,Arnold C. Klebs,"March 17 , 1870",PER-PER-PER,TIME-TIME-TIME-TIME,PROPN-PROPN-PROPN,PROPN-NUM-PUNCT-NUM,compound-compound-ROOT,appos-nummod-punct-nummod,NNP-NNP-NNP,"NNP-CD-,-CD",3,1
1,0.0,25,Klebs,2,1,5,4,0,19,1,3,Arnold C. Klebs,"March 6 , 1943",PER-PER-PER,TIME-TIME-TIME-TIME,PROPN-PROPN-PROPN,PROPN-NUM-PUNCT-NUM,compound-compound-ROOT,nsubj-nummod-punct-nummod,NNP-NNP-NNP,"NNP-CD-,-CD",3,1
2,1.0,34,raised,18,7,3,-4,6,30,11,-15,Arnold Klebs,Berne,PER-PER,LOC,PROPN-PROPN,PROPN,compound-appos,pobj,NNP-NNP,NNP,4,1
3,1.0,34,raised,18,7,15,8,6,18,11,-3,Arnold Klebs,Edwin Klebs,PER-PER,PER-PER,PROPN-PROPN,PROPN-PROPN,compound-appos,compound-pobj,NNP-NNP,NNP-NNP,3,1
4,1.0,34,raised,18,3,5,2,2,28,15,-13,Berne,Switzerland,LOC,LOC,PROPN,PROPN,pobj,conj,NNP,NNP,2,1
5,2.0,23,took,1,1,8,7,0,14,0,7,Klebs,University of Basel,PER,ORG-ORG-ORG,PROPN,PROPN-ADP-PROPN,nsubj,pobj-prep-pobj,NNP,NNP-IN-NNP,3,1
6,3.0,27,worked,1,1,7,6,0,19,0,6,Klebs,Johns Hopkins University,PER,ORG-ORG-ORG,PROPN,PROPN-PROPN-PROPN,nsubj,compound-compound-pobj,NNP,NNP-NNP-NNP,3,1
7,3.0,27,worked,1,7,17,10,6,9,-6,16,Johns Hopkins University,U.S.,ORG-ORG-ORG,LOC,PROPN-PROPN-PROPN,PROPN,compound-compound-pobj,pobj,NNP-NNP-NNP,NNP,4,1
8,6.0,19,returned,4,17,9,-8,16,9,-13,5,Lake Geneva,Switzerland,LOC-LOC,LOC,PROPN-PROPN,PROPN,compound-pobj,pobj,NNP-NNP,NNP,6,1
0,0.0,17,is,1,1,15,14,0,1,0,14,WTOL,United States,ORG,LOC-LOC,PROPN,PROPN-PROPN,nsubj,compound-appos,NNP,NNP-NNP,5,1
1,0.0,17,is,1,4,15,11,3,1,-3,14,CBS,United States,ORG,LOC-LOC,PROPN,PROPN-PROPN,npadvmod,compound-appos,NNP,NNP-NNP,6,1
2,0.0,17,is,1,11,15,4,10,1,-10,14,Toledo,United States,LOC,LOC-LOC,PROPN,PROPN-PROPN,pobj,compound-appos,NNP,NNP-NNP,2,1
3,0.0,17,is,1,13,15,2,12,1,-12,14,Ohio,United States,LOC,LOC-LOC,PROPN,PROPN-PROPN,appos,compound-appos,NNP,NNP-NNP,2,1
0,4.0,37,had,11,35,4,-31,34,32,-24,-7,Punch Brothers,American,ORG-ORG,LOC,PROPN-PROPN,ADJ,compound-conj,amod,NNP-NNPS,JJ,6,1
0,5.0,23,worked,4,12,14,2,11,8,-8,10,Ico,2001,ORG,TIME,PROPN,NUM,pobj,pobj,NNP,CD,2,1
1,5.0,23,worked,4,17,22,5,16,0,-13,18,Shadow of the Colossus,2005,MISC-MISC-MISC-MISC,TIME,PROPN-ADP-DET-PROPN,NUM,conj-prep-det-pobj,pobj,NNP-IN-DT-NNP,CD,3,1
0,0.0,23,is,3,1,14,13,0,8,2,11,River of Dreams,Billy Joel,MISC-MISC-MISC,PER-PER,PROPN-ADP-PROPN,PROPN-PROPN,nsubj-prep-pobj,compound-pobj,NNP-IN-NNPS,NNP-NNP,5,1
1,4.0,16,was,3,8,14,6,7,1,-5,11,Joel,Christie Brinkley,PER,PER-PER,PROPN,PROPN-PROPN,poss,compound-appos,NNP,NNP-NNP,3,1
0,0.0,13,is,8,1,5,4,0,7,7,-3,Halldór Guðmundsson,1956,PER-PER,TIME,ADV-PROPN,NUM,compound-nsubj,npadvmod,RB-NNP,CD,2,1
1,0.0,13,is,8,1,7,6,0,5,7,-1,Halldór Guðmundsson,Reykjavík,PER-PER,LOC,ADV-PROPN,PROPN,compound-nsubj,pobj,RB-NNP,NNP,2,1
2,2.0,12,awarded,6,4,9,5,3,2,2,3,Halldór Laxness,Icelandic Literary Prize,PER-PER,MISC-MISC-MISC,PROPN-PROPN,PROPN-PROPN-PROPN,compound-pobj,compound-compound-dobj,NNP-NNP,NNP-NNP-NNP,5,1
3,4.0,33,chosen,13,1,5,4,0,27,12,-8,Halldór,Skáldalíf,PER,MISC,ADV,PROPN,poss,appos,RB,NNP,3,1
4,5.0,31,discusses,10,2,7,5,1,23,8,-3,We are all Icelanders,2009,MISC-MISC-MISC-MISC,TIME,PRON-VERB-DET-NOUN,NUM,nsubj-ccomp-advmod-attr,appos,PRP-VBP-DT-NNS,CD,2,1
0,0.0,23,is,3,1,22,21,0,0,2,19,Traralgon,Australia,LOC,LOC,PROPN,PROPN,nsubj,appos,NNP,NNP,2,1
1,0.0,23,is,3,13,17,4,12,5,-10,14,Latrobe Valley,Gippsland,LOC-LOC,LOC,PROPN-PROPN,PROPN,compound-pobj,compound,NNP-NNP,NNP,2,1
2,0.0,23,is,3,13,20,7,12,2,-10,17,Latrobe Valley,Victoria,LOC-LOC,LOC,PROPN-PROPN,PROPN,compound-pobj,pobj,NNP-NNP,NNP,5,1
3,0.0,23,is,3,13,22,9,12,0,-10,19,Latrobe Valley,Australia,LOC-LOC,LOC,PROPN-PROPN,PROPN,compound-pobj,appos,NNP-NNP,NNP,7,1
4,0.0,23,is,3,17,20,3,16,2,-14,17,Gippsland,Victoria,LOC,LOC,PROPN,PROPN,compound,pobj,NNP,NNP,3,1
5,0.0,23,is,3,17,22,5,16,0,-14,19,Gippsland,Australia,LOC,LOC,PROPN,PROPN,compound,appos,NNP,NNP,9,1
6,0.0,23,is,3,20,22,2,19,0,-17,19,Victoria,Australia,LOC,LOC,PROPN,PROPN,pobj,appos,NNP,NNP,12,1
0,1.0,28,serialised,3,23,27,4,22,0,-20,24,Nanyang Siang Pau,Singapore,MISC-MISC-MISC,LOC,PROPN-PROPN-PROPN,PROPN,compound-compound-conj,pobj,NNP-NNP-NNP,NNP,7,1
0,0.0,32,is,3,1,14,13,0,17,2,11,Liverpool Football Club,Merseyside,ORG-ORG-ORG,LOC,PROPN-PROPN-PROPN,PROPN,compound-compound-nsubj,appos,NNP-NNP-NNP,NNP,7,1
1,2.0,21,resulted,4,11,7,-4,10,13,-7,3,Goodison Park,Everton,LOC-LOC,ORG,PROPN-PROPN,PROPN,compound-pobj,nsubj,NNP-NNP,NNP,2,1
2,4.0,15,joined,1,1,4,3,0,10,0,3,Liverpool,Lancashire League,ORG,ORG-ORG,PROPN,PROPN-PROPN,nsubj,compound-dobj,NNP,NNP-NNP,1,1
0,0.0,33,was,5,2,13,11,1,19,3,8,Ministry of Home Security,1939,ORG-ORG-ORG-ORG,TIME,PROPN-ADP-PROPN-PROPN,NUM,nsubj-prep-compound-pobj,pobj,NNP-IN-NNP-NNP,CD,6,1
1,7.0,14,disbanded,9,8,12,4,7,1,1,3,Ministry,May 1945,ORG,TIME-TIME,PROPN,PROPN-NUM,nsubjpass,pobj-nummod,NNP,NNP-CD,4,1
0,0.0,22,is,9,1,12,11,0,9,8,3,Marissa Nadler,American,PER-PER,LOC,PROPN-PROPN,ADJ,compound-nsubj,amod,NNP-NNP,JJ,2,1
0,5.0,46,announced,5,30,30,0,29,15,-25,25,Another Gay Movie,Another Gay Sequel,MISC-MISC-MISC,MISC-MISC-MISC,DET-PROPN-PROPN,DET-PROPN-PROPN,det-compound-conj,det-compound-conj,DT-NNP-NNP,DT-NNP-NNP,0,1
0,0.0,38,is,16,1,22,21,0,15,15,6,The Abandonment of the Jews : America and the Holocaust 1941–1945,David S. Wyman,MISC-MISC-MISC-MISC-MISC-MISC-MISC-MISC-MISC-MISC-MISC,PER-PER-PER,DET-PROPN-ADP-DET-PROPN-PUNCT-PROPN-CCONJ-DET-PROPN-NUM,PROPN-PROPN-PROPN,det-nsubj-prep-det-pobj-punct-appos-cc-det-compound-conj,compound-compound-pobj,DT-NNP-IN-DT-NNPS-:-NNP-CC-DT-NNP-CD,NNP-NNP-NNP,5,1
1,0.0,38,is,16,22,34,12,21,3,-6,18,David S. Wyman,University of Massachusetts Amherst,PER-PER-PER,ORG-ORG-ORG-ORG,PROPN-PROPN-PROPN,PROPN-ADP-PROPN-PROPN,compound-compound-pobj,pobj-prep-compound-pobj,NNP-NNP-NNP,NNP-IN-NNP-NNP,5,1
0,0.0,38,is,22,1,19,18,0,18,21,-3,The Basilica of Saint Mary,United States,LOC-LOC-LOC-LOC-LOC,LOC-LOC,DET-PROPN-ADP-PROPN-PROPN,PROPN-PROPN,det-nsubj-prep-compound-pobj,compound-appos,DT-NNP-IN-NNP-NNP,NNP-NNP,1,1
0,0.0,48,made,38,1,4,3,0,43,37,-34,Arabella Mansfield,"May 23 , 1846",PER-PER,TIME-TIME-TIME-TIME,PROPN-PROPN,PROPN-NUM-PUNCT-NUM,compound-nsubj,appos-nummod-punct-nummod,NNP-NNP,"NNP-CD-,-CD",2,1
1,0.0,48,made,38,1,9,8,0,38,37,-29,Arabella Mansfield,"August 1 , 1911",PER-PER,TIME-TIME-TIME-TIME,PROPN-PROPN,PROPN-NUM-PUNCT-NUM,compound-nsubj,npadvmod-nummod-punct-npadvmod,NNP-NNP,"NNP-CD-,-CD",2,1
2,0.0,48,made,38,1,21,20,0,26,37,-17,Arabella Mansfield,the United States,PER-PER,LOC-LOC-LOC,PROPN-PROPN,DET-PROPN-PROPN,compound-nsubj,det-compound-pobj,NNP-NNP,DT-NNP-NNP,4,1
3,0.0,48,made,38,16,21,5,15,26,22,-17,Belle Aurelia Babb,the United States,LOC-LOC-LOC,LOC-LOC-LOC,PROPN-PROPN-PROPN,DET-PROPN-PROPN,compound-compound-appos,det-compound-pobj,NNP-NNP-NNP,DT-NNP-NNP,5,1
4,3.0,22,worked,5,5,20,15,4,1,0,15,Mansfield,DePauw University,PER,ORG-ORG,PROPN,PROPN-PROPN,nsubj,compound-conj,NNP,NNP-NNP,3,1
0,0.0,20,was,8,1,5,4,0,14,7,-3,László Zarándi,10 June 1929,PER-PER,TIME-TIME-TIME,PROPN-PROPN,NUM-PROPN-NUM,compound-nsubj,nummod-npadvmod-nummod,NNP-NNP,CD-NNP-CD,2,1
1,5.0,42,competed,1,12,14,2,11,27,-11,13,Helsinki,Finland,LOC,LOC,PROPN,PROPN,pobj,appos,NNP,NNP,4,1
2,5.0,42,competed,1,34,4,-30,33,37,-33,3,Géza Varasdi,Hungary,PER-PER,LOC,PROPN-PROPN,PROPN,compound-dobj,pobj,NNP-NNP,NNP,3,1
3,5.0,42,competed,1,34,7,-27,33,34,-33,6,Géza Varasdi,1952 Summer Olympics,PER-PER,MISC-MISC-MISC,PROPN-PROPN,NUM-PROPN-PROPN,compound-dobj,nummod-compound-pobj,NNP-NNP,CD-NNP-NNPS,5,1
4,5.0,42,competed,1,37,4,-33,36,37,-36,3,György Csányi,Hungary,PER-PER,LOC,PROPN-PROPN,PROPN,compound-conj,pobj,NNP-NNP,NNP,4,1
5,5.0,42,competed,1,37,7,-30,36,34,-36,6,György Csányi,1952 Summer Olympics,PER-PER,MISC-MISC-MISC,PROPN-PROPN,NUM-PROPN-PROPN,compound-conj,nummod-compound-pobj,NNP-NNP,CD-NNP-NNPS,6,1
6,5.0,42,competed,1,40,4,-36,39,37,-39,3,Béla Goldoványi,Hungary,PER-PER,LOC,PROPN-PROPN,PROPN,compound-conj,pobj,NNP-NNP,NNP,5,1
7,5.0,42,competed,1,40,7,-33,39,34,-39,6,Béla Goldoványi,1952 Summer Olympics,PER-PER,MISC-MISC-MISC,PROPN-PROPN,NUM-PROPN-PROPN,compound-conj,nummod-compound-pobj,NNP-NNP,CD-NNP-NNPS,7,1
0,0.0,15,is,4,10,14,4,9,0,-6,10,Greater São Paulo,Brazil,LOC-LOC-LOC,LOC,PROPN-PROPN-PROPN,PROPN,compound-compound-pobj,appos,NNP-NNP-NNP,NNP,5,1
0,2.0,24,joined,10,10,5,-5,9,18,0,-5,Lam,University of Hong Kong,PER,ORG-ORG-ORG-ORG,PROPN,PROPN-ADP-PROPN-PROPN,nsubj,pobj-prep-compound-pobj,NNP,NNP-IN-NNP-NNP,5,1
1,7.0,53,won,8,21,51,30,20,1,-13,43,Election Committee,Hong Kong,ORG-ORG,LOC-LOC,PROPN-PROPN,PROPN-PROPN,compound-pobj,compound-pobj,NNP-NNP,NNP-NNP,8,1
0,1.0,12,created,4,8,11,3,7,0,-4,7,Constitutional Act,1791,MISC-MISC,TIME,PROPN-PROPN,NUM,amod-pobj,pobj,NNP-NNP,CD,3,1
1,4.0,41,created,20,15,31,16,14,9,5,11,Legislative Assembly of Canada,1867,ORG-ORG-ORG-ORG,TIME,PROPN-PROPN-ADP-PROPN,NUM,compound-appos-prep-pobj,pobj,NNP-NNP-IN-NNP,CD,8,1
2,4.0,41,created,20,15,15,0,14,25,5,-5,Legislative Assembly of Canada,Legislative Assembly of Quebec,ORG-ORG-ORG-ORG,ORG-ORG-ORG-ORG,PROPN-PROPN-ADP-PROPN,PROPN-PROPN-ADP-PROPN,compound-appos-prep-pobj,compound-nsubjpass-prep-pobj,NNP-NNP-IN-NNP,NNP-NNP-IN-NNP,0,1
3,4.0,41,created,20,15,26,11,14,14,5,6,Legislative Assembly of Canada,Lower Canada,ORG-ORG-ORG-ORG,ORG-ORG,PROPN-PROPN-ADP-PROPN,PROPN-PROPN,compound-appos-prep-pobj,conj-pobj,NNP-NNP-IN-NNP,NNP-NNP,4,1
4,4.0,41,created,20,15,26,11,14,14,5,6,Legislative Assembly of Quebec,Lower Canada,ORG-ORG-ORG-ORG,ORG-ORG,PROPN-PROPN-ADP-PROPN,PROPN-PROPN,compound-nsubjpass-prep-pobj,conj-pobj,NNP-NNP-IN-NNP,NNP-NNP,4,1
0,2.0,42,located,23,27,31,4,26,10,-4,8,Southern Indian,Andhra Pradesh,LOC-LOC,LOC-LOC,ADJ-ADJ,PROPN-PROPN,amod-amod,compound-pobj,JJ-JJ,NNP-NNP,3,1
1,2.0,42,located,23,27,34,7,26,7,-4,11,Southern Indian,Karnataka,LOC-LOC,LOC,ADJ-ADJ,PROPN,amod-amod,conj,JJ-JJ,NNP,5,1
2,2.0,42,located,23,27,36,9,26,5,-4,13,Southern Indian,Kerala,LOC-LOC,LOC,ADJ-ADJ,PROPN,amod-amod,conj,JJ-JJ,NNP,6,1
0,0.0,14,located,4,1,11,10,0,2,3,7,Balaclava,Victoria,LOC,LOC,PROPN,PROPN,compound,pobj,NNP,NNP,7,1
1,0.0,14,located,4,1,13,12,0,0,3,9,Balaclava,Australia,LOC,LOC,PROPN,PROPN,compound,appos,NNP,NNP,3,1
2,0.0,14,located,4,8,11,3,7,2,-4,7,Sandringham,Victoria,LOC,LOC,PROPN,PROPN,compound,pobj,NNP,NNP,3,1
3,0.0,14,located,4,8,13,5,7,0,-4,9,Sandringham,Australia,LOC,LOC,PROPN,PROPN,compound,appos,NNP,NNP,3,1
4,0.0,14,located,4,11,13,2,10,0,-7,9,Victoria,Australia,LOC,LOC,PROPN,PROPN,pobj,appos,NNP,NNP,6,1
0,0.0,24,was,5,1,18,17,0,5,4,13,USS Haas ( DE-424 ),U.S. Navy,MISC-MISC-MISC-MISC-MISC,ORG-ORG,PROPN-PROPN-PUNCT-NOUN-PUNCT,PROPN-PROPN,compound-nsubj-punct-subtok-punct,compound-pobj,NNP-NNP--LRB--NN--RRB-,NNP-NNP,6,1
1,0.0,24,was,5,18,21,3,17,2,-13,16,U.S. Navy,World War II,ORG-ORG,MISC-MISC-MISC,PROPN-PROPN,PROPN-PROPN-PROPN,compound-pobj,compound-compound-pobj,NNP-NNP,NNP-NNP-NNP,5,1
2,2.0,33,named,5,10,17,7,9,15,-5,12,John William Haas,Navy Cross,PER-PER-PER,MISC-MISC,PROPN-PROPN-PROPN,PROPN-PROPN,compound-compound-pobj,compound-dobj,NNP-NNP-NNP,NNP-NNP,3,1
3,2.0,33,named,5,10,25,15,9,7,-5,20,John William Haas,4 June 1942,PER-PER-PER,TIME-TIME-TIME,PROPN-PROPN-PROPN,NUM-PROPN-NUM,compound-compound-pobj,nummod-npadvmod-nummod,NNP-NNP-NNP,CD-NNP-CD,6,1
4,2.0,33,named,5,10,30,20,9,2,-5,25,John William Haas,Battle of Midway,PER-PER-PER,MISC-MISC-MISC,PROPN-PROPN-PROPN,PROPN-ADP-PROPN,compound-compound-pobj,pobj-prep-pobj,NNP-NNP-NNP,NNP-IN-NNP,6,1
0,2.0,31,ranged,2,23,30,7,22,0,-21,28,Morea,Greece,LOC,LOC,PROPN,PROPN,nmod,pobj,NNP,NNP,6,1
1,2.0,31,ranged,2,25,30,5,24,0,-23,28,Peloponnese,Greece,LOC,LOC,PROPN,PROPN,nmod,pobj,NNP,NNP,6,1
2,3.0,48,fought,8,18,21,3,17,26,-10,13,Cretan War,1645,MISC-MISC,TIME,PROPN-PROPN,NUM,compound-pobj,nummod,NNP-NNP,CD,2,1
3,3.0,48,fought,8,18,23,5,17,24,-10,15,Cretan War,1669,MISC-MISC,TIME,PROPN-PROPN,NUM,compound-pobj,nummod,NNP-NNP,CD,5,1
4,3.0,48,fought,8,18,3,-15,17,44,-10,-5,Cretan War,Venetian,MISC-MISC,LOC,PROPN-PROPN,ADJ,compound-pobj,amod,NNP-NNP,JJ,6,1
0,0.0,14,is,2,1,12,11,0,1,1,10,Mount Gilead,United States,LOC-LOC,LOC-LOC,PROPN-PROPN,PROPN-PROPN,compound-nsubj,compound-appos,NNP-NNP,NNP-NNP,5,1
1,0.0,14,is,2,10,12,2,9,1,-8,10,Ohio,United States,LOC,LOC-LOC,PROPN,PROPN-PROPN,appos,compound-appos,NNP,NNP-NNP,2,1
0,5.0,12,died,1,4,6,2,3,5,-3,5,Hamburg,Germany,LOC,LOC,PROPN,PROPN,pobj,appos,NNP,NNP,4,1
0,0.0,20,is,3,1,18,17,0,1,2,15,Fate of Norns,Amon Amarth,MISC-MISC-MISC,ORG-ORG,PROPN-ADP-PROPN,PROPN-PROPN,nsubj-prep-pobj,compound-appos,NNP-IN-NNP,NNP-NNP,6,1
1,5.0,38,includes,2,30,32,2,29,5,-28,30,Reykjavík,Iceland,LOC,LOC,PROPN,PROPN,pobj,appos,NNP,NNP,3,1
0,0.0,59,was,4,15,29,14,14,29,-11,25,Isabella Jagiellon,John Zápolya,PER-PER,PER-PER,PROPN-PROPN,PROPN-PROPN,compound-conj,compound-pobj,NNP-NNP,NNP-NNP,7,1
1,4.0,32,ruled,10,26,30,4,25,1,-16,20,Treaty of Speyer,1570,MISC-MISC-MISC,TIME,PROPN-ADP-PROPN,NUM,pobj-prep-pobj,appos,NNP-IN-NNP,CD,2,1
0,0.0,30,is,7,17,29,12,16,0,-10,22,Norrbotten County,Sweden,LOC-LOC,LOC,PROPN-PROPN,PROPN,compound-pobj,pobj,NNP-NNP,NNP,5,1
1,0.0,30,is,7,20,29,9,19,0,-13,22,Västerbotten County,Sweden,LOC-LOC,LOC,PROPN-PROPN,PROPN,compound-appos,pobj,NNP-NNP,NNP,6,1
2,0.0,30,is,7,23,29,6,22,0,-16,22,Västernorrland County,Sweden,LOC-LOC,LOC,PROPN-PROPN,PROPN,compound-conj,pobj,NNP-NNP,NNP,7,1
3,0.0,30,is,7,26,29,3,25,0,-19,22,Jämtland County,Sweden,LOC-LOC,LOC,PROPN-PROPN,PROPN,compound-conj,pobj,NNP-NNP,NNP,8,1
4,5.0,25,started,1,11,5,-6,10,19,-10,4,Botniabanan,2010,LOC,TIME,PROPN,NUM,appos,pobj,NNP,CD,2,1
5,6.0,26,operated,2,5,9,4,4,16,-3,7,Botniatåg,SJ AB,ORG,ORG-ORG,PROPN,PROPN-PROPN,pobj,compound-pobj,NNP,NNP-NNP,4,1
0,1.0,46,written,4,2,8,6,1,37,2,4,Sanguinarium,Vivian,MISC,PER,PROPN,PROPN,nsubjpass,pobj,NNP,NNP,4,1
1,1.0,46,written,4,2,10,8,1,35,2,6,Sanguinarium,Valerie Mayhew,MISC,PER-PER,PROPN,PROPN-PROPN,nsubjpass,compound-conj,NNP,NNP-NNP,4,1
2,1.0,46,written,4,2,15,13,1,30,2,11,Sanguinarium,Kim Manners,MISC,PER-PER,PROPN,PROPN-PROPN,nsubjpass,compound-pobj,NNP,NNP-NNPS,4,1
3,3.0,34,centers,2,8,11,3,7,22,-6,9,Fox Mulder,David Duchovny,PER-PER,PER-PER,PROPN-PROPN,PROPN-PROPN,compound-appos,compound-appos,NNP-NNP,NNP-NNP,1,1
4,3.0,34,centers,2,15,18,3,14,15,-13,16,Dana Scully,Gillian Anderson,PER-PER,PER-PER,PROPN-PROPN,PROPN-PROPN,compound-appos,compound-appos,NNP-NNP,NNP-NNP,1,1
0,0.0,18,is,3,1,14,13,0,3,2,11,Super Robin Hood,November 1985,MISC-MISC-MISC,TIME-TIME,PROPN-PROPN-PROPN,PROPN-NUM,compound-compound-nsubj,pobj-nummod,NNP-NNP-NNP,NNP-CD,7,1
1,1.0,23,reworked,2,5,19,14,4,3,-3,17,Robin Hood : Legend Quest,Amiga,MISC-MISC-MISC-MISC-MISC,MISC,PROPN-PROPN-PUNCT-PROPN-PROPN,PROPN,compound-pobj-punct-compound-appos,pobj,NNP-NNP-:-NNP-NNP,NNP,6,1
2,1.0,23,reworked,2,5,21,16,4,1,-3,19,Robin Hood : Legend Quest,Atari ST,MISC-MISC-MISC-MISC-MISC,MISC-MISC,PROPN-PROPN-PUNCT-PROPN-PROPN,PROPN-PROPN,compound-pobj-punct-compound-appos,compound-conj,NNP-NNP-:-NNP-NNP,NNP-NNP,4,1
3,9.0,30,reworked,1,3,21,18,2,8,-2,20,Super Robin Hood,Quattro Adventure,MISC-MISC-MISC,MISC-MISC,PROPN-PROPN-PROPN,PROPN-PROPN,compound-compound-dobj,compound-pobj,NNP-NNP-NNP,NNP-NNP,5,1
4,9.0,30,reworked,1,21,26,5,20,3,-20,25,Quattro Adventure,Camerica,MISC-MISC,ORG,PROPN-PROPN,PROPN,compound-pobj,pobj,NNP-NNP,NNP,2,1
5,9.0,30,reworked,1,21,28,7,20,1,-20,27,Quattro Adventure,1993,MISC-MISC,TIME,PROPN-PROPN,NUM,compound-pobj,pobj,NNP-NNP,CD,4,1
0,2.0,22,preceded,5,4,21,17,3,0,1,16,RC,Rome,ORG,LOC,PROPN,PROPN,pobj,pobj,NNP,NNP,2,1
0,0.0,44,was,24,34,41,7,33,2,-10,17,SOE,World War II,ORG,MISC-MISC-MISC,PROPN,PROPN-PROPN-PROPN,compound,compound-compound-pobj,NNP,NNP-NNP-NNP,4,1
0,0.0,19,is,4,1,11,10,0,7,3,7,Elaine Marley – Threepwood,Monkey Island,PER-PER-PER-PER,MISC-MISC,PROPN-PROPN-PROPN-PROPN,PROPN-PROPN,compound-compound-compound-nsubj,compound-compound,NNP-NNP-NNP-NNP,NNP-NNP,5,1
1,3.0,48,reprise,38,22,32,10,21,15,16,-6,The Curse of Monkey Island,Escape from Monkey Island,MISC-MISC-MISC-MISC-MISC,MISC-MISC-MISC-MISC,DET-PROPN-ADP-PROPN-PROPN,PROPN-ADP-PROPN-PROPN,det-pobj-prep-compound-pobj,pobj-prep-compound-pobj,DT-NNP-IN-NNP-NNP,NNP-IN-NNP-NNP,6,1
0,0.0,22,"""",0,2,20,18,1,1,-2,20,The C Word,30 Rock,MISC-MISC-MISC,MISC-MISC,DET-NOUN-PROPN,NUM-PROPN,det-compound-nsubj,nummod-appos,DT-NN-NNP,CD-NNP,3,1
1,5.0,53,brings,8,3,6,3,2,46,5,-2,Jack Donaghy,Alec Baldwin,PER-PER,PER-PER,PROPN-PROPN,PROPN-PROPN,compound-nsubj,compound-appos,NNP-NNP,NNP-NNP,1,1
2,5.0,53,brings,8,10,10,0,9,42,-2,2,Tracy Jordan,Tracy Morgan,PER-PER,PER-PER,PROPN-PROPN,PROPN-PROPN,compound-dobj,compound-appos,NNP-NNP,NNP-NNP,0,1
0,6.0,33,returned,15,9,13,4,8,19,6,-2,Siege of Damascus,1148,MISC-MISC-MISC,TIME,PROPN-ADP-PROPN,NUM,pobj-prep-pobj,pobj,NNP-IN-NNP,CD,8,1
1,8.0,23,abdicated,5,15,3,-12,14,19,-10,-2,Clairvaux,France,LOC,LOC,PROPN,PROPN,pobj,pobj,NNP,NNP,3,1
0,1.0,13,borders,1,3,6,3,2,6,-2,5,Jefferson County,Texas,LOC-LOC,LOC,PROPN-PROPN,PROPN,compound-dobj,appos,NNP-NNP,NNP,1,1
1,1.0,13,borders,1,9,12,3,8,0,-8,11,Cameron Parish,Louisiana,LOC-LOC,LOC,PROPN-PROPN,PROPN,compound-conj,appos,NNP-NNP,NNP,3,1
0,0.0,24,was,16,1,5,4,0,18,15,-11,Thomas Christian Tychsen,8 May 1758,PER-PER-PER,TIME-TIME-TIME,PROPN-PROPN-PROPN,NUM-PROPN-NUM,compound-compound-nsubj,nummod-appos-nummod,NNP-NNP-NNP,CD-NNP-CD,3,1
1,0.0,24,was,16,1,9,8,0,14,15,-7,Thomas Christian Tychsen,Horsbüll,PER-PER-PER,LOC,PROPN-PROPN-PROPN,PROPN,compound-compound-nsubj,compound,NNP-NNP-NNP,NNP,4,1
2,0.0,24,was,16,1,11,10,0,12,15,-5,Thomas Christian Tychsen,23 October 1834,PER-PER-PER,TIME-TIME-TIME,PROPN-PROPN-PROPN,NUM-PROPN-NUM,compound-compound-nsubj,nummod-appos-nummod,NNP-NNP-NNP,CD-NNP-CD,4,1
3,0.0,24,was,16,1,15,14,0,8,15,-1,Thomas Christian Tychsen,Göttingen,PER-PER-PER,LOC,PROPN-PROPN-PROPN,PROPN,compound-compound-nsubj,appos,NNP-NNP-NNP,NNP,4,1
0,0.0,55,Wazirwola,0,54,47,-7,53,7,-54,47,Afghanistan,Paktika,LOC,LOC,PROPN,PROPN,pobj,pobj,NNP,NNP,6,1
1,0.0,55,Wazirwola,0,54,49,-5,53,5,-54,49,Afghanistan,Khost,LOC,LOC,PROPN,PROPN,pobj,conj,NNP,NNP,7,1
2,0.0,55,Wazirwola,0,54,51,-3,53,3,-54,51,Afghanistan,Paktia,LOC,LOC,PROPN,PROPN,pobj,conj,NNP,NNP,5,1
3,0.0,55,Wazirwola,0,27,39,12,26,15,-27,39,North Waziristan,Pakistan,LOC-LOC,LOC,PROPN-PROPN,PROPN,compound-pobj,pobj,NNP-NNP,NNP,5,1
4,0.0,55,Wazirwola,0,30,39,9,29,15,-30,39,South Waziristan,Pakistan,LOC-LOC,LOC,PROPN-PROPN,PROPN,compound-conj,pobj,NNP-NNP,NNP,6,1
5,0.0,55,Wazirwola,0,33,39,6,32,15,-33,39,Bannu,Pakistan,LOC,LOC,PROPN,PROPN,conj,pobj,NNP,NNP,8,1
6,0.0,55,Wazirwola,0,37,39,2,36,15,-37,39,Tank,Pakistan,LOC,LOC,PROPN,PROPN,pobj,pobj,NNP,NNP,8,1
0,3.0,34,Created,0,8,25,17,7,8,-8,25,Bin Roye,Farhat Ishtiaq,MISC-MISC,PER-PER,PROPN-PROPN,PROPN-PROPN,compound-npadvmod,compound-pobj,NNP-NNP,NNP-NNP,8,1
1,3.0,34,Created,0,8,5,-3,7,28,-8,5,Bin Roye,Momina Duraid,MISC-MISC,PER-PER,PROPN-PROPN,PROPN-PROPN,compound-npadvmod,compound-pobj,NNP-NNP,NNP-NNP,1,1
0,0.0,34,is,12,20,27,7,19,6,-8,15,Richmond,United States,LOC,LOC-LOC,PROPN,PROPN-PROPN,pobj,compound-nsubj,NNP,NNP-NNP,5,1
1,0.0,34,is,12,22,27,5,21,6,-10,15,El Cerrito,United States,LOC-LOC,LOC-LOC,PROPN-PROPN,PROPN-PROPN,compound-conj,compound-nsubj,NNP-NNP,NNP-NNP,5,1
2,0.0,34,is,12,25,27,2,24,6,-13,15,California,United States,LOC,LOC-LOC,PROPN,PROPN-PROPN,appos,compound-nsubj,NNP,NNP-NNP,3,1
0,0.0,53,is,11,22,52,30,21,0,-11,41,Francisco Javier González Longoria,Spain,PER-PER-PER-PER,LOC,PROPN-PROPN-PROPN-PROPN,PROPN,compound-compound-compound-conj,appos,NNP-NNP-NNP-NNP,NNP,6,1
1,0.0,53,is,11,34,52,18,33,0,-23,41,Chueca,Spain,LOC,LOC,PROPN,PROPN,pobj,appos,NNP,NNP,5,1
2,0.0,53,is,11,43,52,9,42,0,-32,41,Pelayo,Spain,LOC,LOC,PROPN,PROPN,conj,appos,NNP,NNP,9,1
3,1.0,29,with,1,15,21,6,14,7,-14,20,Plaza de España,Madrid,LOC-LOC-LOC,LOC,PROPN-PROPN-PROPN,PROPN,compound-compound-pobj,poss,NNP-NNP-NNP,NNP,8,1
0,0.0,40,is,12,9,1,-8,8,38,3,-11,Chambersburg,Franklin County,LOC,LOC-LOC,PROPN,PROPN-PROPN,pobj,compound-pobj,NNP,NNP-NNP,5,1
1,0.0,40,is,12,9,39,30,8,0,3,27,Chambersburg,USA,LOC,LOC,PROPN,PROPN,pobj,appos,NNP,NNP,6,1
2,0.0,40,is,12,1,37,36,0,2,11,25,Franklin County,Pennsylvania,LOC-LOC,LOC,PROPN-PROPN,PROPN,compound-pobj,appos,NNP-NNP,NNP,8,1
3,0.0,40,is,12,1,39,38,0,0,11,27,Franklin County,USA,LOC-LOC,LOC,PROPN-PROPN,PROPN,compound-pobj,appos,NNP-NNP,NNP,3,1
4,0.0,40,is,12,37,39,2,36,0,-25,27,Pennsylvania,USA,LOC,LOC,PROPN,PROPN,appos,appos,NNP,NNP,7,1
0,0.0,39,is,5,1,8,7,0,30,4,3,Killer Klowns from Outer Space,1988,MISC-MISC-MISC-MISC-MISC,TIME,PROPN-PROPN-ADP-PROPN-PROPN,NUM,compound-nsubj-prep-compound-pobj,nummod,NNP-NNP-IN-NNP-NNP,CD,5,1
1,0.0,39,is,5,1,22,21,0,16,4,17,Killer Klowns from Outer Space,Chiodo Brothers,MISC-MISC-MISC-MISC-MISC,PER-PER,PROPN-PROPN-ADP-PROPN-PROPN,PROPN-PROPN,compound-nsubj-prep-compound-pobj,compound-pobj,NNP-NNP-IN-NNP-NNP,NNP-NNPS,7,1
2,0.0,39,is,5,1,27,26,0,11,4,22,Killer Klowns from Outer Space,Grant Cramer,MISC-MISC-MISC-MISC-MISC,PER-PER,PROPN-PROPN-ADP-PROPN-PROPN,PROPN-PROPN,compound-nsubj-prep-compound-pobj,compound-dobj,NNP-NNP-IN-NNP-NNP,NNP-NNP,6,1
3,0.0,39,is,5,1,30,29,0,8,4,25,Killer Klowns from Outer Space,Suzanne Snyder,MISC-MISC-MISC-MISC-MISC,PER-PER,PROPN-PROPN-ADP-PROPN-PROPN,PROPN-PROPN,compound-nsubj-prep-compound-pobj,compound-conj,NNP-NNP-IN-NNP-NNP,NNP-NNP,7,1
4,0.0,39,is,5,1,33,32,0,5,4,28,Killer Klowns from Outer Space,John Allen Nelson,MISC-MISC-MISC-MISC-MISC,PER-PER-PER,PROPN-PROPN-ADP-PROPN-PROPN,PROPN-PROPN-PROPN,compound-nsubj-prep-compound-pobj,compound-compound-conj,NNP-NNP-IN-NNP-NNP,NNP-NNP-NNP,8,1
5,0.0,39,is,5,1,33,32,0,5,4,28,Killer Klowns from Outer Space,John Vernon,MISC-MISC-MISC-MISC-MISC,PER-PER,PROPN-PROPN-ADP-PROPN-PROPN,PROPN-PROPN,compound-nsubj-prep-compound-pobj,compound-conj,NNP-NNP-IN-NNP-NNP,NNP-NNP,8,1
0,0.0,26,is,2,1,21,20,0,4,1,19,Larisons Corners,New Jersey,LOC-LOC,LOC-LOC,NOUN-PROPN,PROPN-PROPN,compound-nsubj,compound-conj,NNS-NNPS,NNP-NNP,10,1
1,0.0,26,is,2,1,24,23,0,1,1,22,Larisons Corners,United States,LOC-LOC,LOC-LOC,NOUN-PROPN,PROPN-PROPN,compound-nsubj,compound-appos,NNS-NNPS,NNP-NNP,10,1
2,0.0,26,is,2,12,18,6,11,7,-10,16,East Amwell,Hunterdon County,LOC-LOC,LOC-LOC,PROPN-PROPN,PROPN-PROPN,compound-nmod,compound-pobj,NNP-NNP,NNP-NNP,3,1
3,0.0,26,is,2,12,24,12,11,1,-10,22,East Amwell,United States,LOC-LOC,LOC-LOC,PROPN-PROPN,PROPN-PROPN,compound-nmod,compound-appos,NNP-NNP,NNP-NNP,4,1
4,0.0,26,is,2,15,18,3,14,7,-13,16,Raritan,Hunterdon County,LOC,LOC-LOC,PROPN,PROPN-PROPN,conj,compound-pobj,NNP,NNP-NNP,2,1
5,0.0,26,is,2,15,21,6,14,4,-13,19,Raritan,New Jersey,LOC,LOC-LOC,PROPN,PROPN-PROPN,conj,compound-conj,NNP,NNP-NNP,3,1
6,0.0,26,is,2,15,24,9,14,1,-13,22,Raritan,United States,LOC,LOC-LOC,PROPN,PROPN-PROPN,conj,compound-appos,NNP,NNP-NNP,3,1
7,0.0,26,is,2,18,21,3,17,4,-16,19,Hunterdon County,New Jersey,LOC-LOC,LOC-LOC,PROPN-PROPN,PROPN-PROPN,compound-pobj,compound-conj,NNP-NNP,NNP-NNP,1,1
8,0.0,26,is,2,18,24,6,17,1,-16,22,Hunterdon County,United States,LOC-LOC,LOC-LOC,PROPN-PROPN,PROPN-PROPN,compound-pobj,compound-appos,NNP-NNP,NNP-NNP,1,1
9,0.0,26,is,2,21,24,3,20,1,-19,22,New Jersey,United States,LOC-LOC,LOC-LOC,PROPN-PROPN,PROPN-PROPN,compound-conj,compound-appos,NNP-NNP,NNP-NNP,2,1
0,0.0,42,was,15,1,18,17,0,23,14,3,Tikhon Nikolayevich Khrennikov,Russian,PER-PER-PER,LOC,PROPN-PROPN-PROPN,ADJ,compound-compound-nsubj,amod,NNP-NNP-NNP,JJ,6,1
1,4.0,15,held,1,11,14,3,10,0,-10,13,Soviet Union,1991,LOC-LOC,TIME,PROPN-PROPN,NUM,compound-pobj,pobj,NNP-NNP,CD,5,1
0,0.0,10,is,1,1,6,5,0,3,0,5,Castroverde,Lugo province,LOC,LOC-LOC,PROPN,PROPN-NOUN,nsubj,compound-pobj,NNP,NNP-NN,3,1
1,0.0,10,is,1,1,9,8,0,0,0,8,Castroverde,Spain,LOC,LOC,PROPN,PROPN,nsubj,appos,NNP,NNP,1,1
2,0.0,10,is,1,6,9,3,5,0,-5,8,Lugo province,Spain,LOC-LOC,LOC,PROPN-NOUN,PROPN,compound-pobj,appos,NNP-NN,NNP,4,1
0,2.0,36,established,1,1,34,33,0,1,0,33,Sastre,Grand Tours,PER,MISC-MISC,PROPN,PROPN-PROPN,nsubj,compound-pobj,NNP,NNP-NNPS,6,1
1,3.0,18,finished,4,4,13,9,3,4,0,9,Sastre,Grand Tours,PER,MISC-MISC,PROPN,PROPN-PROPN,nsubj,compound-pobj,NNP,NNP-NNPS,3,1
0,0.0,16,is,4,1,14,13,0,1,3,10,St Levan,United Kingdom,LOC-LOC,LOC-LOC,PROPN-PROPN,PROPN-PROPN,compound-nsubj,compound-appos,NNP-NNP,NNP-NNP,5,1
1,0.0,16,is,4,12,14,2,11,1,-8,10,England,United Kingdom,LOC,LOC-LOC,PROPN,PROPN-PROPN,conj,compound-appos,NNP,NNP-NNP,2,1
0,0.0,23,was,8,1,5,4,0,17,7,-3,Domenico Trezzini,1670,PER-PER,TIME,PROPN-PROPN,NUM,compound-nsubj,nummod,NNP-NNP,CD,2,1
1,0.0,23,was,8,1,7,6,0,15,7,-1,Domenico Trezzini,1734,PER-PER,TIME,PROPN-PROPN,NUM,compound-nsubj,nummod,NNP-NNP,CD,1,1
2,1.0,29,born,2,1,5,4,0,23,1,3,Domenico,Astano,PER,LOC,PROPN,PROPN,nsubjpass,pobj,NNP,NNP,4,1
3,1.0,29,born,2,28,7,-21,27,21,-26,5,Ticino,Landvogtei of Lugano,LOC,LOC-LOC-LOC,PROPN,PROPN-ADP-PROPN,pobj,conj-prep-pobj,NNP,NNP-IN-NNP,5,1
4,1.0,29,born,2,5,7,2,4,21,-3,5,Astano,Landvogtei of Lugano,LOC,LOC-LOC-LOC,PROPN,PROPN-ADP-PROPN,pobj,conj-prep-pobj,NNP,NNP-IN-NNP,3,1
0,0.0,56,spelled,5,53,48,-5,52,7,-48,43,Kazansky Rail Terminal,Moscow,LOC-LOC-LOC,LOC,PROPN-PROPN-PROPN,PROPN,compound-compound-pobj,conj,NNP-NNP-NNP,NNP,7,1
1,0.0,56,spelled,5,53,50,-3,52,5,-48,45,Kazansky Rail Terminal,Russia,LOC-LOC-LOC,LOC,PROPN-PROPN-PROPN,PROPN,compound-compound-pobj,appos,NNP-NNP-NNP,NNP,8,1
2,0.0,56,spelled,5,1,50,49,0,5,4,45,Novoryazanskaya Street,Russia,LOC-LOC,LOC,PROPN-PROPN,PROPN,compound-npadvmod,appos,NNP-NNP,NNP,10,1
3,0.0,56,spelled,5,45,48,3,44,7,-40,43,Krasnoselsky District,Moscow,LOC-LOC,LOC,PROPN-PROPN,PROPN,compound-pobj,conj,NNP-NNP,NNP,2,1
4,0.0,56,spelled,5,45,50,5,44,5,-40,45,Krasnoselsky District,Russia,LOC-LOC,LOC,PROPN-PROPN,PROPN,compound-pobj,appos,NNP-NNP,NNP,3,1
5,0.0,56,spelled,5,48,50,2,47,5,-43,45,Moscow,Russia,LOC,LOC,PROPN,PROPN,conj,appos,NNP,NNP,3,1
0,0.0,43,is,2,8,11,3,7,31,-6,9,Australian,South Australia,LOC,LOC-LOC,ADJ,PROPN-PROPN,amod,compound-pobj,JJ,NNP-NNP,2,1
1,0.0,43,is,2,11,21,10,10,21,-9,19,South Australia,Adelaide,LOC-LOC,LOC,PROPN-PROPN,PROPN,compound-pobj,pobj,NNP-NNP,NNP,8,1
0,1.0,18,born,3,1,6,5,0,11,2,3,Irene Scharrer,London,PER-PER,LOC,PROPN-PROPN,PROPN,compound-nsubjpass,pobj,NNP-NNP,NNP,2,1
1,1.0,18,born,3,1,11,10,0,6,2,8,Irene Scharrer,Royal Academy of Music,PER-PER,ORG-ORG-ORG-ORG,PROPN-PROPN,PROPN-PROPN-ADP-PROPN,compound-nsubjpass,compound-pobj-prep-pobj,NNP-NNP,NNP-NNP-IN-NNP,4,1
0,0.0,46,Dalziel,1,1,6,5,0,39,0,5,Henry Dalziel,18 February 1893,PER-PER,TIME-TIME-TIME,PROPN-PROPN,NUM-PROPN-NUM,compound-ROOT,nummod-appos-nummod,NNP-NNP,CD-NNP-CD,1,1
1,0.0,46,Dalziel,1,42,44,2,41,1,-41,43,British,Commonwealth,LOC,LOC,PROPN,PROPN,amod,conj,NNP,NNP,2,1
2,1.0,18,awarded,2,10,15,5,9,2,-8,13,Australian Imperial Force,First World War,ORG-ORG-ORG,MISC-MISC-MISC,PROPN-PROPN-PROPN,PROPN-PROPN-PROPN,compound-compound-pobj,compound-compound-pobj,NNP-NNP-NNP,NNP-NNP-NNP,6,1
0,0.0,16,is,10,1,5,4,0,10,9,-5,Jonatan Berg,9 May 1985,PER-PER,TIME-TIME-TIME,PROPN-PROPN,NUM-PROPN-NUM,compound-nsubj,nummod-npadvmod-nummod,NNP-NNP,CD-NNP-CD,2,1
1,0.0,16,is,10,1,9,8,0,6,9,-1,Jonatan Berg,Torsby,PER-PER,LOC,PROPN-PROPN,PROPN,compound-nsubj,pobj,NNP-NNP,NNP,1,1
2,0.0,16,is,10,1,14,13,0,1,9,4,Jonatan Berg,Swedish,PER-PER,LOC,PROPN-PROPN,ADJ,compound-nsubj,amod,NNP-NNP,JJ,2,1
3,4.0,31,was,1,1,24,23,0,6,0,23,Jonatan,GAIS,PER,ORG,PROPN,PROPN,nsubj,pobj,NNP,NNP,-1,1
0,6.0,36,included,1,9,6,-3,8,29,-8,5,Do n't Touch Me,1966,MISC-MISC-MISC-MISC,TIME,VERB-ADV-VERB-PRON,NUM,aux-neg-acl-dobj,nummod,VBP-RB-VB-PRP,CD,2,1
1,6.0,36,included,1,21,18,-3,20,17,-20,17,Almost Persuaded,1967,MISC-MISC,TIME,ADV-PROPN,NUM,advmod-oprd,nummod,RB-NNP,CD,1,1
0,1.0,42,started,1,1,6,5,0,35,0,5,Llorente,Athletic Bilbao,PER,ORG-ORG,PROPN,PROPN-PROPN,nsubj,compound-pobj,NNP,NNP-NNP,3,1
1,3.0,48,spent,23,4,10,6,3,37,19,-13,Juventus,Serie A,ORG,MISC-MISC,PROPN,PROPN-PROPN,pobj,compound-dobj,NNP,NNP-NNP,3,1
2,3.0,48,spent,23,34,40,6,33,7,-11,17,Sevilla,Premier League,ORG,MISC-MISC,PROPN,PROPN-PROPN,pobj,compound-pobj,NNP,NNP-NNP,4,1
3,3.0,48,spent,23,34,32,-2,33,15,-11,9,Sevilla,Spain,ORG,LOC,PROPN,PROPN,pobj,pobj,NNP,NNP,3,1
4,4.0,24,was,8,8,18,10,7,5,0,10,Llorente,2010 World Cup,PER,MISC-MISC-MISC,PROPN,NUM-PROPN-PROPN,nsubj,nummod-compound-dobj,NNP,CD-NNP-NNP,6,1
5,4.0,24,was,8,8,22,14,7,1,0,14,Llorente,Euro 2012,PER,MISC-MISC,PROPN,PROPN-NUM,nsubj,conj-nummod,NNP,NNP-CD,7,1
0,4.0,17,immortalized,2,9,15,6,8,1,-7,13,The Glory of Their Times,Lawrence Ritter,MISC-MISC-MISC-MISC-MISC,PER-PER,DET-NOUN-ADP-DET-PROPN,PROPN-PROPN,det-appos-prep-poss-pobj,compound-pobj,DT-NN-IN-PRP$-NNP,NNP-NNP,2,1
0,0.0,24,is,3,1,12,11,0,11,2,9,Mohamed Abu Samra,Islamic Party,PER-PER-PER,ORG-ORG,PROPN-PROPN-PROPN,PROPN-PROPN,compound-compound-nsubj,compound-pobj,NNP-NNP-NNP,NNP-NNP,6,1
0,0.0,21,Hero,1,1,12,11,0,8,0,11,Guitar Hero : Aerosmith,Neversoft,MISC-MISC-MISC-MISC,ORG,PROPN-PROPN-PUNCT-PROPN,PROPN,compound-ROOT-punct-nsubj,pobj,NNP-NNP-:-NNP,NNP,-1,1
1,0.0,21,Hero,1,1,16,15,0,4,0,15,Guitar Hero : Aerosmith,Activision,MISC-MISC-MISC-MISC,ORG,PROPN-PROPN-PUNCT-PROPN,PROPN,compound-ROOT-punct-nsubj,pobj,NNP-NNP-:-NNP,NNP,-1,1
2,1.0,46,released,2,6,6,0,5,39,-4,4,PlayStation 3,PlayStation 2,MISC-MISC,MISC-MISC,PROPN-NUM,PROPN-NUM,nmod-nummod,nmod-nummod,NNP-CD,NNP-CD,0,1
0,0.0,29,"""",0,2,19,17,1,9,-2,19,Job Fair,The Office,MISC-MISC,MISC-MISC,PROPN-PROPN,DET-PROPN,compound-nsubj,det-appos,NNP-NNP,DT-NNP,7,1
0,0.0,56,were,8,22,45,23,21,10,-14,37,Kingdom of England,United Kingdom,LOC-LOC-LOC,LOC-LOC,PROPN-ADP-PROPN,PROPN-PROPN,pobj-prep-pobj,compound-pobj,NNP-IN-NNP,NNP-NNP,8,1
1,0.0,56,were,8,27,45,18,26,10,-19,37,Wales,United Kingdom,LOC,LOC-LOC,PROPN,PROPN-PROPN,pobj,compound-pobj,NNP,NNP-NNP,5,1
0,0.0,34,is,5,2,29,27,1,4,3,24,Weymouth Township School District,New Jersey,LOC-LOC-LOC-LOC,LOC-LOC,PROPN-PROPN-PROPN-PROPN,PROPN-PROPN,compound-compound-compound-nsubj,compound-conj,NNP-NNP-NNP-NNP,NNP-NNP,8,1
1,0.0,34,is,5,2,32,30,1,1,3,27,Weymouth Township School District,United States,LOC-LOC-LOC-LOC,LOC-LOC,PROPN-PROPN-PROPN-PROPN,PROPN-PROPN,compound-compound-compound-nsubj,compound-appos,NNP-NNP-NNP-NNP,NNP-NNP,8,1
2,0.0,34,is,5,2,26,24,1,7,3,21,Weymouth Township,Atlantic County,LOC-LOC,LOC-LOC,PROPN-PROPN,PROPN-PROPN,compound-pobj,compound-pobj,NNP-NNP,NNP-NNP,7,1
3,0.0,34,is,5,2,32,30,1,1,3,27,Weymouth Township,United States,LOC-LOC,LOC-LOC,PROPN-PROPN,PROPN-PROPN,compound-pobj,compound-appos,NNP-NNP,NNP-NNP,8,1
4,0.0,34,is,5,26,29,3,25,4,-21,24,Atlantic County,New Jersey,LOC-LOC,LOC-LOC,PROPN-PROPN,PROPN-PROPN,compound-pobj,compound-conj,NNP-NNP,NNP-NNP,1,1
5,0.0,34,is,5,26,32,6,25,1,-21,27,Atlantic County,United States,LOC-LOC,LOC-LOC,PROPN-PROPN,PROPN-PROPN,compound-pobj,compound-appos,NNP-NNP,NNP-NNP,1,1
6,0.0,34,is,5,29,32,3,28,1,-24,27,New Jersey,United States,LOC-LOC,LOC-LOC,PROPN-PROPN,PROPN-PROPN,compound-conj,compound-appos,NNP-NNP,NNP-NNP,2,1
0,0.0,27,was,13,1,4,3,0,22,12,-9,Felix Gilbert,"May 21 , 1905",PER-PER,TIME-TIME-TIME-TIME,PROPN-PROPN,PROPN-NUM-PUNCT-NUM,compound-nsubj,appos-nummod-punct-nummod,NNP-NNP,"NNP-CD-,-CD",2,1
1,0.0,27,was,13,1,9,8,0,17,12,-4,Felix Gilbert,"February 14 , 1991",PER-PER,TIME-TIME-TIME-TIME,PROPN-PROPN,PROPN-NUM-PUNCT-NUM,compound-nsubj,appos-nummod-punct-nummod,NNP-NNP,"NNP-CD-,-CD",3,1
2,0.0,27,was,13,1,19,18,0,7,12,6,Felix Gilbert,American,PER-PER,LOC,PROPN-PROPN,ADJ,compound-nsubj,amod,NNP-NNP,JJ,2,1
3,2.0,19,studied,9,9,16,7,8,2,0,7,Gilbert,University of Berlin,PER,ORG-ORG-ORG,PROPN,PROPN-ADP-PROPN,nsubj,pobj-prep-pobj,NNP,NNP-IN-NNP,3,1
4,2.0,19,studied,9,12,16,4,11,2,-3,7,Friedrich Meinecke,University of Berlin,PER-PER,ORG-ORG-ORG,PROPN-PROPN,PROPN-ADP-PROPN,compound-pobj,pobj-prep-pobj,NNP-NNP,NNP-IN-NNP,5,1
0,2.0,19,separated,3,7,18,11,6,0,-4,15,Province of North Carolina,1712,LOC-LOC-LOC-LOC,TIME,PROPN-ADP-PROPN-PROPN,NUM,conj-prep-compound-pobj,pobj,NNP-IN-NNP-NNP,CD,4,1
1,3.0,45,became,7,7,16,9,6,28,0,9,Charleston,Atlantic Ocean,LOC,LOC-LOC,PROPN,PROPN-PROPN,pobj,compound-pobj,NNP,NNP-NNP,3,1
0,0.0,12,is,4,1,10,9,0,1,3,6,Jagged Little Pill Acoustic,Alanis Morissette,MISC-MISC-MISC-MISC,PER-PER,PROPN-PROPN-PROPN-PROPN,PROPN-PROPN,compound-compound-compound-nsubj,compound-pobj,NNP-NNP-NNP-NNP,NNP-NNP,6,1
1,1.0,50,is,1,15,19,4,14,30,-14,18,Jagged Little Pill,1995,MISC-MISC-MISC,TIME,PROPN-ADJ-NOUN,NUM,compound-compound-appos,appos,NNP-JJ-NN,CD,2,1
0,0.0,22,Nemesis,1,1,9,8,0,12,0,8,Zork Nemesis : The Forbidden Lands,1996,MISC-MISC-MISC-MISC-MISC-MISC,TIME,NOUN-NOUN-PUNCT-DET-PROPN-PROPN,NUM,compound-ROOT-punct-det-compound-nsubj,nummod,NN-NN-:-DT-NNP-NNP,CD,-1,1
1,0.0,22,Nemesis,1,1,16,15,0,5,0,15,Zork Nemesis : The Forbidden Lands,Zombie LLC,MISC-MISC-MISC-MISC-MISC-MISC,ORG-ORG,NOUN-NOUN-PUNCT-DET-PROPN-PROPN,PROPN-PROPN,compound-ROOT-punct-det-compound-nsubj,compound-pobj,NN-NN-:-DT-NNP-NNP,NNP-NNP,-1,1
2,0.0,22,Nemesis,1,1,21,20,0,0,0,20,Zork Nemesis : The Forbidden Lands,Activision,MISC-MISC-MISC-MISC-MISC-MISC,ORG,NOUN-NOUN-PUNCT-DET-PROPN-PROPN,PROPN,compound-ROOT-punct-det-compound-nsubj,pobj,NN-NN-:-DT-NNP-NNP,NNP,-1,1
3,1.0,23,is,1,8,21,13,7,1,-7,20,Zork,Infocom,MISC,ORG,PROPN,PROPN,compound,compound,NNP,NNP,6,1
0,0.0,56,Created,0,17,25,8,16,30,-17,25,Star Trek,William Shatner,MISC-MISC,PER-PER,PROPN-PROPN,PROPN-PROPN,compound-nsubj,compound-dobj,NNP-NNP,NNP-NNP,8,1
1,0.0,56,Created,0,17,29,12,16,26,-17,29,Star Trek,James T. Kirk,MISC-MISC,PER-PER-PER,PROPN-PROPN,PROPN-PROPN-PROPN,compound-nsubj,compound-compound-pobj,NNP-NNP,NNP-NNP-NNP,10,1
2,0.0,56,Created,0,17,33,16,16,22,-17,33,Star Trek,Leonard Nimoy,MISC-MISC,PER-PER,PROPN-PROPN,PROPN-PROPN,compound-nsubj,compound-appos,NNP-NNP,NNP-NNP,10,1
3,0.0,56,Created,0,17,37,20,16,18,-17,37,Star Trek,Spock,MISC-MISC,PER,PROPN-PROPN,PROPN,compound-nsubj,pobj,NNP-NNP,NNP,11,1
4,0.0,56,Created,0,17,40,23,16,15,-17,40,Star Trek,DeForest Kelley,MISC-MISC,PER-PER,PROPN-PROPN,PROPN-PROPN,compound-nsubj,compound-conj,NNP-NNP,NNP-NNP,9,1
5,0.0,56,Created,0,20,37,17,19,18,-20,37,The Original Series,Spock,MISC-MISC-MISC,PER,DET-PROPN-PROPN,PROPN,det-compound-appos,pobj,DT-NNP-NNP,NNP,10,1
0,0.0,21,are,6,1,3,2,0,17,5,-3,Ulver,Norwegian,ORG,MISC,PROPN,ADJ,nsubj,nsubj,NNP,JJ,2,1
1,0.0,21,are,6,1,15,14,0,5,5,9,Ulver,1993,ORG,TIME,PROPN,NUM,nsubj,pobj,NNP,CD,4,1
2,0.0,21,are,6,1,19,18,0,1,5,13,Ulver,Kristoffer Rygg,ORG,PER-PER,PROPN,PROPN-PROPN,nsubj,compound-pobj,NNP,NNP-NNP,5,1
3,3.0,21,formed,10,16,20,4,15,0,-6,10,Jester Records,1998,ORG-ORG,TIME,PROPN-PROPN,NUM,compound-appos,pobj,NNP-NNP,CD,3,1
4,3.0,21,formed,10,16,9,-7,15,11,-6,-1,Jester Records,Kristoffer Rygg,ORG-ORG,PER-PER,PROPN-PROPN,PROPN-PROPN,compound-appos,compound-nsubj,NNP-NNP,NNP-NNP,3,1
0,1.0,41,grew,14,7,9,2,6,31,7,-5,Shihad,Jon Toogood,ORG,PER-PER,PROPN,PROPN-PROPN,compound,compound-pobj,NNP,NNP-NNP,1,1
1,4.0,22,performed,5,15,20,5,14,1,-10,15,CBS Arena,New Zealand,LOC-LOC,LOC-LOC,PROPN-PROPN,PROPN-PROPN,compound-pobj,compound-appos,NNP-NNP,NNP-NNP,3,1
2,4.0,22,performed,5,11,20,9,10,1,-6,15,Christchurch,New Zealand,LOC,LOC-LOC,PROPN,PROPN-PROPN,pobj,compound-appos,NNP,NNP-NNP,2,1
0,0.0,25,is,8,1,5,4,0,19,7,-3,Nathalie Bernard,17 August 1985,PER-PER,TIME-TIME-TIME,PROPN-PROPN,NUM-PROPN-NUM,compound-nsubj,nummod-npadvmod-nummod,NNP-NNP,CD-NNP-CD,2,1
0,0.0,20,is,1,1,4,3,0,15,0,3,Exotica,1994,MISC,TIME,PROPN,NUM,nsubj,nummod,NNP,CD,2,1
1,0.0,20,is,1,1,19,18,0,0,0,18,Exotica,Toronto,MISC,LOC,PROPN,PROPN,nsubj,pobj,NNP,NNP,1,1
2,4.0,8,filmed,2,1,5,4,0,2,1,3,Exotica,Toronto,MISC,LOC,PROPN,PROPN,nsubjpass,pobj,NNP,NNP,2,1
0,4.0,26,led,7,13,16,3,12,9,-6,9,Constantinople,Latin Empire,LOC,LOC-LOC,PROPN,PROPN-PROPN,pobj,compound-pobj,NNP,NNP-NNP,1,1
1,4.0,26,led,7,13,24,11,12,1,-6,17,Constantinople,Byzantine Empire,LOC,LOC-LOC,PROPN,PROPN-PROPN,pobj,compound-dobj,NNP,NNP-NNP,6,1
0,0.0,34,was,11,1,4,3,0,29,10,-7,Petr Braiko,9 September 1919,PER-PER,TIME-TIME-TIME,PROPN-PROPN,NUM-PROPN-NUM,compound-nsubj,nummod-appos-nummod,NNP-NNP,CD-NNP-CD,1,1
1,0.0,34,was,11,1,8,7,0,25,10,-3,Petr Braiko,7 April 2018,PER-PER,TIME-TIME-TIME,PROPN-PROPN,NUM-PROPN-NUM,compound-nsubj,nummod-appos-nummod,NNP-NNP,CD-NNP-CD,1,1
2,0.0,34,was,11,1,14,13,0,19,10,3,Petr Braiko,Soviet,PER-PER,LOC,PROPN-PROPN,ADJ,compound-nsubj,amod,NNP-NNP,JJ,2,1
3,0.0,34,was,11,1,18,17,0,15,10,7,Petr Braiko,Second World War,PER-PER,MISC-MISC-MISC,PROPN-PROPN,PROPN-PROPN-PROPN,compound-nsubj,compound-compound-pobj,NNP-NNP,NNP-NNP-NNP,4,1
4,0.0,34,was,11,1,26,25,0,7,10,15,Petr Braiko,Hero of the Soviet Union,PER-PER,MISC-MISC-MISC-MISC-MISC,PROPN-PROPN,PROPN-ADP-DET-PROPN-PROPN,compound-nsubj,pobj-prep-det-compound-pobj,NNP-NNP,NNP-IN-DT-NNP-NNP,8,1
5,4.0,30,come,2,22,16,-6,21,13,-20,14,Sydir Kovpak,Soviet,PER-PER,LOC,PROPN-PROPN,ADJ,compound-pobj,amod,NNP-NNP,JJ,5,1
6,4.0,30,come,2,25,16,-9,24,13,-23,14,Semyon Rudnev,Soviet,PER-PER,LOC,PROPN-PROPN,ADJ,compound-conj,amod,NNP-NNP,JJ,6,1
7,4.0,30,come,2,28,16,-12,27,13,-26,14,Pyotr Vershigora,Soviet,PER-PER,LOC,PROPN-PROPN,ADJ,compound-conj,amod,NNP-NNP,JJ,7,1
0,0.0,36,is,8,1,20,19,0,15,7,12,Anarchy Reigns,PlatinumGames,MISC-MISC,ORG,PROPN-PROPN,PROPN,compound-nsubj,pobj,NNP-NNP,NNP,4,1
1,0.0,36,is,8,1,24,23,0,11,7,16,Anarchy Reigns,Sega,MISC-MISC,ORG,PROPN-PROPN,PROPN,compound-nsubj,pobj,NNP-NNP,NNP,4,1
2,0.0,36,is,8,1,28,27,0,7,7,20,Anarchy Reigns,Atsushi Inaba,MISC-MISC,PER-PER,PROPN-PROPN,PROPN-PROPN,compound-nsubj,compound-pobj,NNP-NNP,NNP-NNP,6,1
3,0.0,36,is,8,1,34,33,0,1,7,26,Anarchy Reigns,Masaki Yamanaka,MISC-MISC,PER-PER,PROPN-PROPN,PROPN-PROPN,compound-nsubj,compound-pobj,NNP-NNP,NNP-NNP,5,1
0,0.0,14,is,2,7,11,4,6,2,-5,9,Western Australia,Shire of Mundaring,LOC-LOC,LOC-LOC-LOC,PROPN-PROPN,PROPN-ADP-PROPN,compound-pobj,pobj-prep-pobj,NNP-NNP,NNP-IN-NNP,5,1
0,0.0,15,Endurance,0,1,13,12,0,1,-1,13,Endurance : Shackleton 's Incredible Voyage,Alfred Lansing,MISC-MISC-MISC-MISC-MISC-MISC,PER-PER,NOUN-PUNCT-PROPN-PART-PROPN-PROPN,PROPN-PROPN,ROOT-punct-poss-case-amod-nsubj,compound-pobj,NN-:-NNP-POS-NNP-NNP,NNP-NNP,6,1
1,2.0,46,recounts,2,8,27,19,7,18,-6,25,Imperial Trans - Antarctic Expedition,1914,MISC-MISC-MISC-MISC-MISC,TIME,PROPN-PROPN-PUNCT-PROPN-PROPN,NUM,compound-compound-punct-compound-pobj,pobj,NNP-NNP-HYPH-NNP-NNP,CD,5,1
2,7.0,26,led,2,10,1,-9,9,24,-8,-1,James Caird,Shackleton,MISC-MISC,PER,PROPN-PROPN,PROPN,compound-pobj,nsubj,NNP-NNP,NNP,6,1
0,0.0,25,is,8,1,5,4,0,19,7,-3,Raymond Casimir,28 October 1976,PER-PER,TIME-TIME-TIME,PROPN-PROPN,NUM-PROPN-NUM,compound-nsubj,nummod-npadvmod-nummod,NNP-NNP,CD-NNP-CD,2,1
0,7.0,82,take,37,9,18,9,8,63,28,-19,NTLDR,Microsoft,MISC,ORG,PROPN,PROPN,pobj,poss,NNP,NNP,7,1
1,7.0,82,take,37,9,20,11,8,61,28,-17,NTLDR,Windows NT,MISC,MISC-MISC,PROPN,PROPN-PROPN,pobj,nmod-npadvmod,NNP,NNP-NNP,7,1
2,7.0,82,take,37,18,20,2,17,61,19,-17,Microsoft,Windows NT,ORG,MISC-MISC,PROPN,PROPN-PROPN,poss,nmod-npadvmod,NNP,NNP-NNP,4,1
3,8.0,35,provided,22,29,12,-17,28,22,-7,-10,WINLOAD.EXE,NTLDR,MISC,MISC,INTJ,PROPN,appos,nsubjpass,UH,NNP,6,1
4,8.0,35,provided,22,2,12,10,1,22,20,-10,Windows Boot Manager,NTLDR,MISC-MISC-MISC,MISC,PROPN-PROPN-PROPN,PROPN,compound-compound-conj,nsubjpass,NNP-NNP-NNP,NNP,3,1
0,0.0,17,is,4,2,15,13,1,1,2,11,Ingeniero Ballester Dam,Argentine,LOC-LOC-LOC,LOC,PROPN-PROPN-PROPN,PROPN,compound-compound-nsubj,compound,NNP-NNP-NNP,NNP,5,1
0,1.0,30,came,1,23,25,2,22,4,-22,24,Faustus Cornelius Sulla,Sulla,PER-PER-PER,PER,PROPN-PROPN-PROPN,PROPN,compound-compound-pobj,pobj,NNP-NNP-NNP,NNP,2,1
0,2.0,32,won,1,24,22,-2,23,9,-23,21,Euphrasia Donnelly,American,PER-PER,LOC,PROPN-PROPN,ADJ,compound-dobj,amod,NNP-NNP,JJ,2,1
1,2.0,32,won,1,24,12,-12,23,19,-23,11,Euphrasia Donnelly,U.S.,PER-PER,LOC,PROPN-PROPN,PROPN,compound-dobj,compound,NNP-NNP,NNP,7,1
2,2.0,32,won,1,27,22,-5,26,9,-26,21,Gertrude Ederle,American,PER-PER,LOC,PROPN-PROPN,ADJ,compound-conj,amod,NNP-NNP,JJ,2,1
3,2.0,32,won,1,27,12,-15,26,19,-26,11,Gertrude Ederle,U.S.,PER-PER,LOC,PROPN-PROPN,PROPN,compound-conj,compound,NNP-NNP,NNP,7,1
0,0.0,17,is,11,1,14,13,0,2,10,3,Marcia Ingram Jones Smoke,American,PER-PER-PER-PER,LOC,PROPN-PROPN-PROPN-PROPN,ADJ,compound-compound-compound-nsubj,amod,NNP-NNP-NNP-NNP,JJ,5,1
1,2.0,15,native,1,9,12,3,8,2,-8,11,Jones,Michigan State University,PER,ORG-ORG-ORG,PROPN,PROPN-PROPN-PROPN,nsubj,compound-compound-pobj,NNP,NNP-NNP-NNP,3,1
0,2.0,24,debuted,2,1,5,4,0,18,1,3,Assistant,May 2016,MISC,TIME-TIME,PROPN,PROPN-NUM,nsubj,pobj-nummod,NNP,NNP-CD,4,1
0,0.0,19,is,6,1,5,4,0,13,5,-1,Richard Jasek,1964/1965,PER-PER,TIME,PROPN-PROPN,NUM,compound-nsubj,punct,NNP-NNP,CD,1,1
1,1.0,18,born,2,1,6,5,0,11,1,4,Jasek,Prague,PER,LOC,PROPN,PROPN,nsubjpass,dobj,NNP,NNP,4,1
0,0.0,27,was,13,1,8,7,0,18,12,-5,Michael Wolgemut,1434,PER-PER,TIME,PROPN-PROPN,NUM,compound-nsubj,nummod,NNP-NNP,CD,2,1
1,0.0,27,was,13,1,10,9,0,16,12,-3,Michael Wolgemut,30 November 1519,PER-PER,TIME-TIME-TIME,PROPN-PROPN,NUM-PROPN-NUM,compound-nsubj,nummod-appos-nummod,NNP-NNP,CD-NNP-CD,1,1
2,0.0,27,was,13,1,26,25,0,0,12,13,Michael Wolgemut,Nuremberg,PER-PER,LOC,PROPN-PROPN,PROPN,compound-nsubj,pobj,NNP-NNP,NNP,2,1
3,11.0,22,show,3,17,14,-3,16,7,-14,11,Belgium,Flanders,LOC,LOC,PROPN,PROPN,appos,pobj,NNP,NNP,4,1
0,0.0,32,was,10,1,9,8,0,22,9,-1,Patricia Russell,2004,PER-PER,TIME,PROPN-PROPN,NUM,compound-nsubj,nummod,NNP-NNP,CD,2,1
1,5.0,31,had,1,6,28,22,5,2,-5,27,Conrad Sebastian Robert Russell,Liberal Democrat party,PER-PER-PER-PER,ORG-ORG-ORG,PROPN-PROPN-PROPN-PROPN,PROPN-PROPN-NOUN,compound-compound-compound-appos,compound-compound-pobj,NNP-NNP-NNP-NNP,NNP-NNP-NN,11,1
0,0.0,20,is,2,1,15,14,0,4,1,13,Strand Street,Cape Town,LOC-LOC,LOC-LOC,PROPN-PROPN,PROPN-PROPN,compound-nsubj,compound-pobj,NNP-NNP,NNP-NNP,8,1
1,1.0,48,runs,1,32,23,-9,31,24,-31,22,Strand Street,Cape Town,LOC-LOC,LOC-LOC,PROPN-PROPN,PROPN-PROPN,compound-pobj,compound-compound,NNP-NNP,NNP-NNP,4,1
2,0.0,20,is,2,1,18,17,0,1,1,16,Strand Street,South Africa,LOC-LOC,LOC-LOC,PROPN-PROPN,PROPN-PROPN,compound-nsubj,compound-appos,NNP-NNP,NNP-NNP,9,1
3,0.0,20,is,2,15,18,3,14,1,-13,16,Cape Town,South Africa,LOC-LOC,LOC-LOC,PROPN-PROPN,PROPN-PROPN,compound-pobj,compound-appos,NNP-NNP,NNP-NNP,1,1
0,0.0,21,was,2,1,5,4,0,15,1,3,Romeo Void,American,ORG-ORG,LOC,PROPN-PROPN,ADJ,compound-nsubj,amod,NNP-NNP,JJ,5,1
1,0.0,21,was,2,1,13,12,0,7,1,11,Romeo Void,San Francisco,ORG-ORG,LOC-LOC,PROPN-PROPN,PROPN-PROPN,compound-nsubj,compound-pobj,NNP-NNP,NNP-NNP,4,1
2,0.0,21,was,2,1,20,19,0,0,1,18,Romeo Void,1979,ORG-ORG,TIME,PROPN-PROPN,NUM,compound-nsubj,pobj,NNP-NNP,CD,2,1
3,0.0,21,was,2,5,16,11,4,4,-3,14,American,California,LOC,LOC,ADJ,PROPN,amod,appos,JJ,NNP,4,1
4,7.0,23,resulted,14,12,21,9,11,1,2,7,Never Say Never,Columbia Records,MISC-MISC-MISC,ORG-ORG,ADV-VERB-PROPN,PROPN-PROPN,neg-aux-neg,compound-pobj,RB-VB-NNP,NNP-NNPS,5,1
0,2.0,54,was,1,34,50,16,33,3,-33,49,Republic of South Vietnam,Socialist Republic of Vietnam,LOC-LOC-LOC-LOC,LOC-LOC-LOC-LOC,PROPN-ADP-PROPN-PROPN,PROPN-PROPN-ADP-PROPN,pobj-prep-compound-pobj,compound-dobj-prep-pobj,NNP-IN-NNP-NNP,NNP-NNP-IN-NNP,9,1
0,0.0,15,is,6,1,5,4,0,9,5,-1,Richard Einhorn,1952,PER-PER,TIME,PROPN-PROPN,NUM,compound-nsubj,npadvmod,NNP-NNP,CD,1,1
1,0.0,15,is,6,1,9,8,0,5,5,3,Richard Einhorn,American,PER-PER,LOC,PROPN-PROPN,ADJ,compound-nsubj,amod,NNP-NNP,JJ,2,1
2,1.0,32,graduated,1,1,11,10,0,20,0,10,Einhorn,Columbia University,PER,ORG-ORG,ADJ,PROPN-PROPN,nsubj,compound-pobj,JJ,NNP-NNP,4,1
3,3.0,20,inspired,2,11,18,7,10,1,-9,16,The Passion of Joan of Arc,1928,MISC-MISC-MISC-MISC-MISC-MISC,TIME,DET-PROPN-ADP-PROPN-ADP-PROPN,NUM,det-appos-prep-pobj-prep-pobj,appos,DT-NNP-IN-NNP-IN-NNP,CD,4,1
4,4.0,68,composed,3,13,16,3,12,51,-10,13,Shock Waves,1977,MISC-MISC,TIME,NOUN-NOUN,NUM,compound-pobj,appos,NN-NNS,CD,1,1
5,4.0,68,composed,3,19,26,7,18,41,-16,23,Do n't Go in the House,1980,MISC-MISC-MISC-MISC-MISC-MISC,TIME,VERB-ADV-VERB-ADP-DET-PROPN,NUM,aux-neg-conj-prep-det-pobj,appos,VB-RB-VB-IN-DT-NNP,CD,2,1
6,4.0,68,composed,3,63,66,3,62,1,-60,63,Dark Tower,1989,MISC-MISC,TIME,PROPN-PROPN,NUM,compound-conj,appos,NNP-NNP,CD,1,1
0,3.0,19,is,1,9,17,8,8,1,-8,16,Eden Riegel,Sam Riegel,PER-PER,PER-PER,PROPN-PROPN,PROPN-PROPN,compound-dobj,compound-conj,NNP-NNP,NNP-NNP,2,1
0,0.0,29,is,6,17,22,5,16,6,-11,16,Mantua,Italy,LOC,LOC,PROPN,PROPN,pobj,conj,NNP,NNP,6,1
1,0.0,29,is,6,19,22,3,18,6,-13,16,Lombardy,Italy,LOC,LOC,PROPN,PROPN,conj,conj,NNP,NNP,7,1
2,1.0,29,known,3,13,17,4,12,11,-10,14,Battle of Solferino,24 June 1859,MISC-MISC-MISC,TIME-TIME-TIME,PROPN-ADP-PROPN,NUM-PROPN-NUM,pobj-prep-pobj,nummod-pobj-nummod,NNP-IN-NNP,CD-NNP-CD,8,1
3,1.0,29,known,3,13,24,11,12,4,-10,21,Battle of Solferino,Second Italian War of Independence,MISC-MISC-MISC,MISC-MISC-MISC-MISC-MISC,PROPN-ADP-PROPN,ADJ-ADJ-PROPN-ADP-PROPN,pobj-prep-pobj,amod-amod-pobj-prep-pobj,NNP-IN-NNP,JJ-JJ-NNP-IN-NNP,12,1
4,3.0,46,witnessed,6,26,45,19,25,0,-20,39,Napoléon III,France,PER-PER,LOC,PROPN-PROPN,PROPN,compound-dobj,pobj,NNP-NNP,NNP,7,1
5,6.0,53,set,8,35,47,12,34,5,-27,39,A Memory of Solferino,1862,MISC-MISC-MISC-MISC,TIME,DET-PROPN-ADP-PROPN,NUM,det-oprd-prep-pobj,pobj,DT-NNP-IN-NNP,CD,4,1
0,0.0,23,"""",0,2,19,17,1,3,-2,19,Unrequited,The X - Files,MISC,MISC-MISC-MISC-MISC,PROPN,DET-PROPN-PROPN-PROPN,acomp,det-compound-punct-ROOT,NNP,DT-NNP-NNP-NNP,8,1
1,6.0,34,centers,2,8,11,3,7,22,-6,9,Fox Mulder,David Duchovny,PER-PER,PER-PER,PROPN-PROPN,PROPN-PROPN,compound-appos,compound-appos,NNP-NNP,NNP-NNP,1,1
2,6.0,34,centers,2,15,18,3,14,15,-13,16,Dana Scully,Gillian Anderson,PER-PER,PER-PER,PROPN-PROPN,PROPN-PROPN,compound-appos,compound-appos,NNP-NNP,NNP-NNP,1,1
0,0.0,19,was,11,1,4,3,0,14,10,-7,Péter Bacsó,6 January 1928,PER-PER,TIME-TIME-TIME,PROPN-PROPN,NUM-PROPN-NUM,compound-nsubj,nummod-appos-nummod,NNP-NNP,CD-NNP-CD,1,1
1,0.0,19,was,11,1,8,7,0,10,10,-3,Péter Bacsó,11 March 2009,PER-PER,TIME-TIME-TIME,PROPN-PROPN,NUM-PROPN-NUM,compound-nsubj,nummod-npadvmod-nummod,NNP-NNP,CD-NNP-CD,2,1
2,0.0,19,was,11,1,14,13,0,4,10,3,Péter Bacsó,Hungarian,PER-PER,LOC,PROPN-PROPN,ADJ,compound-nsubj,amod,NNP-NNP,JJ,3,1
3,7.0,12,made,1,8,11,3,7,0,-7,10,Nyáron egyszerű,1963,MISC-MISC,TIME,PROPN-NOUN,NUM,compound-appos,pobj,NNP-NN,CD,3,1
4,13.0,20,was,9,18,14,-4,17,5,-9,5,Katalin Karády,Hungarian,PER-PER,LOC,PROPN-PROPN,ADJ,compound-conj,amod,NNP-NNP,JJ,1,1
0,0.0,24,is,7,1,6,5,0,17,6,-1,Joe Garagiola Jr.,1952,PER-PER-PER,TIME,PROPN-PROPN-PROPN,NUM,compound-compound-nsubj,npadvmod,NNP-NNP-NNP,CD,3,1
1,2.0,29,is,1,6,16,10,5,12,-5,15,Joe Garagiola Sr,St. Louis Cardinals,PER-PER-PER,ORG-ORG-ORG,PROPN-PROPN-PROPN,PROPN-PROPN-PROPN,compound-compound-subtok,compound-compound-nmod,NNP-NNP-NNP,NNP-NNP-NNPS,8,1
2,2.0,29,is,1,6,20,14,5,8,-5,19,Joe Garagiola Sr,Pittsburgh Pirates,PER-PER-PER,ORG-ORG,PROPN-PROPN-PROPN,PROPN-PROPN,compound-compound-subtok,conj-pobj,NNP-NNP-NNP,NNP-NNPS,8,1
0,0.0,22,was,11,1,5,4,0,16,10,-6,William H. Nobles,1816,PER-PER-PER,TIME,PROPN-PROPN-PROPN,NUM,compound-compound-nsubj,nummod,NNP-NNP-NNP,CD,2,1
1,0.0,22,was,11,1,7,6,0,14,10,-4,William H. Nobles,"December 28 , 1876",PER-PER-PER,TIME-TIME-TIME-TIME,PROPN-PROPN-PROPN,PROPN-NUM-PUNCT-NUM,compound-compound-nsubj,appos-nummod-punct-nummod,NNP-NNP-NNP,"NNP-CD-,-CD",3,1
2,1.0,10,born,2,1,5,4,0,4,1,3,Nobles,Genesee County,PER,LOC-LOC,NOUN,PROPN-PROPN,nsubjpass,compound-pobj,NNS,NNP-NNP,3,1
3,4.0,12,settled,4,4,7,3,3,4,0,3,Nobles,Saint Paul,PER,LOC-LOC,PROPN,PROPN-PROPN,nsubj,compound-pobj,NNP,NNP-NNP,2,1
4,10.0,8,died,1,1,4,3,0,3,0,3,Nobles,Saint Paul,PER,LOC-LOC,NOUN,PROPN-PROPN,nsubj,compound-pobj,NNS,NNP-NNP,2,1
5,9.0,15,served,1,1,12,11,0,2,0,11,Nobles,American Civil War,PER,MISC-MISC-MISC,NOUN,PROPN-PROPN-PROPN,nsubj,compound-compound-pobj,NNS,NNP-NNP-NNP,3,1
6,11.0,10,named,5,4,1,-3,3,8,1,-4,Minnesota,Nobles County,LOC,LOC-LOC,PROPN,PROPN-PROPN,nsubjpass,compound-nsubjpass,NNP,NNP-NNP,2,1
0,0.0,12,is,1,1,4,3,0,7,0,3,Doug,American,MISC,LOC,PROPN,ADJ,nsubj,amod,NNP,JJ,2,1
1,11.0,28,series,1,21,10,-11,20,17,-20,9,Rugrats,Nickelodeon,MISC,ORG,PROPN,PROPN,pobj,appos,NNPS,NNP,6,1
2,11.0,28,series,1,1,10,9,0,17,0,9,The Ren & Stimpy Show,Nickelodeon,MISC-MISC-MISC-MISC-MISC,ORG,DET-PROPN-CCONJ-PROPN-PROPN,PROPN,det-conj-cc-compound-conj,appos,DT-NNP-CC-NNP-NNP,NNP,2,1
0,0.0,22,is,5,13,21,8,12,0,-8,16,United States,Washington,LOC-LOC,LOC,PROPN-PROPN,PROPN,compound-pobj,pobj,NNP-NNP,NNP,4,1
1,0.0,22,is,5,18,21,3,17,0,-13,16,Cascade Range,Washington,LOC-LOC,LOC,PROPN-PROPN,PROPN,compound-pobj,pobj,NNP-NNP,NNP,3,1
0,2.0,10,born,2,5,7,2,4,2,-3,5,Toronto,Ontario,LOC,LOC,PROPN,PROPN,pobj,conj,NNP,NNP,3,1
1,2.0,10,born,2,5,9,4,4,0,-3,7,Toronto,Canada,LOC,LOC,PROPN,PROPN,pobj,appos,NNP,NNP,4,1
2,2.0,10,born,2,7,9,2,6,0,-5,7,Ontario,Canada,LOC,LOC,PROPN,PROPN,conj,appos,NNP,NNP,5,1
0,1.0,59,descended,3,33,39,6,32,19,-30,36,Johann Hinrich Gossler,Elisabeth Berenberg,PER-PER-PER,PER-PER,PROPN-PROPN-PROPN,PROPN-PROPN,compound-compound-poss,compound-pobj,NNP-NNP-NNP,NNP-NNP,4,1
1,8.0,13,named,6,2,5,3,1,7,4,-1,Gossler Islands,Antarctica,LOC-LOC,LOC,PROPN-PROPN,PROPN,compound-nsubjpass,pobj,NNP-NNP,NNP,2,1
0,0.0,38,is,4,27,37,10,26,0,-23,33,Yibin,Sichuan,LOC,LOC,PROPN,PROPN,pobj,pobj,NNP,NNP,9,1
1,0.0,38,is,4,29,37,8,28,0,-25,33,Neijiang,Sichuan,LOC,LOC,PROPN,PROPN,conj,pobj,NNP,NNP,10,1
0,0.0,20,was,15,1,4,3,0,15,14,-11,Maurice Schoemaker,Anderlecht,PER-PER,LOC,PROPN-PROPN,PROPN,compound-nsubj,appos,NNP-NNP,NNP,2,1
1,0.0,20,was,15,1,6,5,0,13,14,-9,Maurice Schoemaker,27 December 1890,PER-PER,TIME-TIME-TIME,PROPN-PROPN,NUM-PROPN-NUM,compound-nsubj,nummod-nmod-nummod,NNP-NNP,CD-NNP-CD,2,1
2,0.0,20,was,15,1,10,9,0,9,14,-5,Maurice Schoemaker,Etterbeek,PER-PER,LOC,PROPN-PROPN,PROPN,compound-nsubj,appos,NNP-NNP,NNP,3,1
3,0.0,20,was,15,1,12,11,0,7,14,-3,Maurice Schoemaker,24 August 1964,PER-PER,TIME-TIME-TIME,PROPN-PROPN,NUM-PROPN-NUM,compound-nsubj,nummod-appos-nummod,NNP-NNP,CD-NNP-CD,3,1
4,4.0,27,founded,10,12,19,7,11,7,-2,9,Les Synthétistes,Belgian,ORG-ORG,LOC,PROPN-PROPN,ADJ,compound-dobj,amod,NNP-NNPS,JJ,3,1
0,0.0,25,was,19,1,11,10,0,13,18,-8,Luciano Pigozzi,10 January 1927,PER-PER,TIME-TIME-TIME,PROPN-PROPN,NUM-PROPN-NUM,compound-nsubj,nummod-appos-nummod,NNP-NNP,CD-NNP-CD,4,1
1,0.0,25,was,19,1,15,14,0,9,18,-4,Luciano Pigozzi,14 June 2008,PER-PER,TIME-TIME-TIME,PROPN-PROPN,NUM-PROPN-NUM,compound-nsubj,nummod-npadvmod-nummod,NNP-NNP,CD-NNP-CD,4,1
2,0.0,25,was,19,8,11,3,7,13,11,-8,Alan Collins,10 January 1927,PER-PER,TIME-TIME-TIME,PROPN-PROPN,NUM-PROPN-NUM,compound-pobj,nummod-appos-nummod,NNP-NNP,CD-NNP-CD,1,1
3,0.0,25,was,19,8,15,7,7,9,11,-4,Alan Collins,14 June 2008,PER-PER,TIME-TIME-TIME,PROPN-PROPN,NUM-PROPN-NUM,compound-pobj,nummod-npadvmod-nummod,NNP-NNP,CD-NNP-CD,1,1
4,1.0,49,known,12,40,7,-33,39,41,-28,-5,Libido,Italian,MISC,LOC,PROPN,ADJ,conj,amod,NNP,JJ,14,1
5,1.0,49,known,12,47,7,-40,46,41,-35,-5,Baron Blood,Italian,MISC-MISC,LOC,PROPN-PROPN,ADJ,compound-pobj,amod,NNP-NNP,JJ,16,1
0,4.0,26,are,1,9,25,16,8,0,-8,24,Mohmand,Pakistan,LOC,LOC,PROPN,PROPN,pobj,appos,NNP,NNP,7,1
1,4.0,26,are,1,11,25,14,10,0,-10,24,Bajaur Agency,Pakistan,LOC-LOC,LOC,PROPN-PROPN,PROPN,compound-conj,appos,NNP-NNP,NNP,7,1
2,4.0,26,are,1,14,25,11,13,0,-13,24,Federally Administered Tribal Areas,Pakistan,LOC-LOC-LOC-LOC,LOC,PROPN-PROPN-PROPN-PROPN,PROPN,compound-compound-compound-conj,appos,NNP-NNP-NNP-NNPS,NNP,8,1
3,4.0,26,are,1,20,25,5,19,0,-19,24,Zhob District,Pakistan,LOC-LOC,LOC,PROPN-PROPN,PROPN,compound-pobj,appos,NNP-NNP,NNP,7,1
4,4.0,26,are,1,23,25,2,22,0,-22,24,Balochistan,Pakistan,LOC,LOC,PROPN,PROPN,conj,appos,NNP,NNP,9,1
0,0.0,28,is,8,1,17,16,0,10,7,9,The Bathers,1918,MISC-MISC,TIME,DET-PROPN,NUM,det-nsubj,pobj,DT-NNPS,CD,8,1
1,3.0,23,is,7,9,22,13,8,0,-2,15,Andrée Hessling,Jean,PER-PER,PER,PROPN-PROPN,PROPN,compound-attr,appos,NNP-NNP,NNP,2,1
2,3.0,23,is,7,18,22,4,17,0,-11,15,Renoir,Jean,PER,PER,PROPN,PROPN,poss,appos,NNP,NNP,8,1
0,1.0,60,came,1,11,45,34,10,14,-10,44,Gorillaz,Damon Albarn,ORG,PER-PER,PROPN,PROPN-PROPN,poss,compound-nsubj,NNP,NNP-NNP,13,1
1,5.0,30,performed,2,21,9,-12,20,20,-19,7,Demon Days,Gorillaz,MISC-MISC,ORG,PROPN-PROPN,PROPN,compound-conj,nmod,NNP-NNP,NNP,10,1
0,0.0,22,is,2,1,12,11,0,9,1,10,South Salem,Westchester County,LOC-LOC,LOC-LOC,PROPN-PROPN,PROPN-PROPN,compound-nsubj,compound-appos,NNP-NNP,NNP-NNP,5,1
1,0.0,22,is,2,1,17,16,0,4,1,15,South Salem,U.S.,LOC-LOC,LOC,PROPN-PROPN,PROPN,compound-nsubj,compound,NNP-NNP,NNP,3,1
2,0.0,22,is,2,8,12,4,7,9,-6,10,Town of Lewisboro,Westchester County,LOC-LOC-LOC,LOC-LOC,PROPN-ADP-PROPN,PROPN-PROPN,pobj-prep-pobj,compound-appos,NNP-IN-NNP,NNP-NNP,2,1
3,0.0,22,is,2,8,17,9,7,4,-6,15,Town of Lewisboro,U.S.,LOC-LOC-LOC,LOC,PROPN-ADP-PROPN,PROPN,pobj-prep-pobj,compound,NNP-IN-NNP,NNP,6,1
4,0.0,22,is,2,12,17,5,11,4,-10,15,Westchester County,U.S.,LOC-LOC,LOC,PROPN-PROPN,PROPN,compound-appos,compound,NNP-NNP,NNP,6,1
5,2.0,79,headliner,62,39,44,5,38,34,23,-18,Charles Sheeler,1883,PER-PER,TIME,PROPN-PROPN,NUM,compound-conj,nummod,NNP-NNP,CD,2,1
6,2.0,79,headliner,62,39,46,7,38,32,23,-16,Charles Sheeler,1965,PER-PER,TIME,PROPN-PROPN,NUM,compound-conj,nummod,NNP-NNP,CD,2,1
7,2.0,79,headliner,62,27,30,3,26,48,35,-32,Rolling Stones,Keith Richards,ORG-ORG,PER-PER,PROPN-PROPN,PROPN-PROPN,compound-compound,compound-nsubj,NNP-NNPS,NNP-NNPS,2,1
0,0.0,21,is,1,6,11,5,5,9,-5,10,Honshu,Japan,LOC,LOC,PROPN,PROPN,pobj,pobj,NNP,NNP,2,1
1,0.0,21,is,1,6,14,8,5,6,-5,13,Honshu,Sea of Japan,LOC,LOC-LOC-LOC,PROPN,PROPN-ADP-PROPN,pobj,dobj-prep-pobj,NNP,NNP-IN-NNP,4,1
2,0.0,21,is,1,6,19,13,5,1,-5,18,Honshu,Pacific Ocean,LOC,LOC-LOC,PROPN,PROPN-PROPN,pobj,compound-pobj,NNP,NNP-NNP,5,1
3,0.0,21,is,1,8,11,3,7,9,-7,10,Hokkaido,Japan,LOC,LOC,PROPN,PROPN,conj,pobj,NNP,NNP,2,1
4,0.0,21,is,1,8,14,6,7,6,-7,13,Hokkaido,Sea of Japan,LOC,LOC-LOC-LOC,PROPN,PROPN-ADP-PROPN,conj,dobj-prep-pobj,NNP,NNP-IN-NNP,4,1
5,0.0,21,is,1,8,19,11,7,1,-7,18,Hokkaido,Pacific Ocean,LOC,LOC-LOC,PROPN,PROPN-PROPN,conj,compound-pobj,NNP,NNP-NNP,5,1
6,0.0,21,is,1,11,19,8,10,1,-10,18,Japan,Pacific Ocean,LOC,LOC-LOC,PROPN,PROPN-PROPN,pobj,compound-pobj,NNP,NNP-NNP,5,1
0,0.0,21,was,8,1,5,4,0,15,7,-3,Carole Jacques,12 June 1960,PER-PER,TIME-TIME-TIME,PROPN-PROPN,NUM-PROPN-NUM,compound-nsubj,nummod-npadvmod-nummod,NNP-NNP,CD-NNP-CD,2,1
1,7.0,12,lost,3,6,10,4,5,1,-3,7,Francine Lalonde,Bloc Québécois,PER-PER,ORG-ORG,PROPN-PROPN,PROPN-PROPN,compound-pobj,compound-pobj,NNP-NNP,NNP-NNP,2,1
0,1.0,20,was,1,8,13,5,7,6,-7,12,Eurovision Song Contest 2012,Baku,MISC-MISC-MISC-MISC,LOC,PROPN-PROPN-PROPN-NUM,PROPN,compound-compound-pobj-npadvmod,pobj,NNP-NNP-NNP-CD,NNP,5,1
1,3.0,37,placed,22,34,4,-30,33,32,-12,-18,Lane moje,Joksimović,MISC-MISC,PER,PROPN-NOUN,PROPN,compound-appos,poss,NNP-NN,NNP,7,1
2,3.0,37,placed,22,11,20,9,10,16,11,-2,Eurovision Song Contest,2004,MISC-MISC-MISC,TIME,PROPN-PROPN-PROPN,NUM,compound-compound-pobj,pobj,NNP-NNP-NNP,CD,7,1
0,1.0,56,believed,25,6,12,6,5,43,19,-13,Basra,Iraq,LOC,LOC,PROPN,PROPN,pobj,pobj,NNP,NNP,2,1
0,0.0,38,is,2,1,14,13,0,23,1,12,Soccer Kid,Krisalis,MISC-MISC,ORG,PROPN-PROPN,PROPN,compound-nsubj,pobj,NNP-NNP,NNP,4,1
1,0.0,38,is,2,1,18,17,0,19,1,16,Soccer Kid,1993,MISC-MISC,TIME,PROPN-PROPN,NUM,compound-nsubj,pobj,NNP-NNP,CD,5,1
2,0.0,38,is,2,1,21,20,0,16,1,19,Soccer Kid,Commodore Amiga,MISC-MISC,MISC-MISC,PROPN-PROPN,PROPN-PROPN,compound-nsubj,compound-pobj,NNP-NNP,NNP-NNP,6,1
3,0.0,38,is,2,1,27,26,0,10,1,25,Soccer Kid,Super NES,MISC-MISC,MISC-MISC,PROPN-PROPN,PROPN-PROPN,compound-nsubj,compound-pobj,NNP-NNP,NNP-NNP,6,1
4,0.0,38,is,2,1,30,29,0,7,1,28,Soccer Kid,PC,MISC-MISC,MISC,PROPN-PROPN,NOUN,compound-nsubj,conj,NNP-NNP,NN,8,1
5,0.0,38,is,2,1,22,21,0,15,1,20,Soccer Kid,Amiga CD32,MISC-MISC,MISC-MISC,PROPN-PROPN,PROPN-PROPN,compound-nsubj,compound-conj,NNP-NNP,NNP-NNP,7,1
6,0.0,38,is,2,1,35,34,0,2,1,33,Soccer Kid,3DO Interactive Multiplayer,MISC-MISC,MISC-MISC-MISC,PROPN-PROPN,NUM-PROPN-PROPN,compound-nsubj,nummod-compound-conj,NNP-NNP,CD-NNP-NNP,10,1
0,0.0,35,are,4,2,30,28,1,4,2,26,Pleasantville Public Schools,New Jersey,LOC-LOC-LOC,LOC-LOC,PROPN-PROPN-PROPN,PROPN-PROPN,compound-compound-nsubj,compound-conj,NNP-NNP-NNPS,NNP-NNP,7,1
1,0.0,35,are,4,2,33,31,1,1,2,29,Pleasantville Public Schools,United States,LOC-LOC-LOC,LOC-LOC,PROPN-PROPN-PROPN,PROPN-PROPN,compound-compound-nsubj,compound-appos,NNP-NNP-NNPS,NNP-NNP,7,1
2,0.0,35,are,4,22,27,5,21,7,-18,23,City of Pleasantville,Atlantic County,LOC-LOC-LOC,LOC-LOC,PROPN-ADP-PROPN,PROPN-PROPN,pobj-prep-pobj,compound-pobj,NNP-IN-NNP,NNP-NNP,7,1
3,0.0,35,are,4,22,30,8,21,4,-18,26,City of Pleasantville,New Jersey,LOC-LOC-LOC,LOC-LOC,PROPN-ADP-PROPN,PROPN-PROPN,pobj-prep-pobj,compound-conj,NNP-IN-NNP,NNP-NNP,8,1
4,0.0,35,are,4,22,33,11,21,1,-18,29,City of Pleasantville,United States,LOC-LOC-LOC,LOC-LOC,PROPN-ADP-PROPN,PROPN-PROPN,pobj-prep-pobj,compound-appos,NNP-IN-NNP,NNP-NNP,8,1
5,0.0,35,are,4,27,30,3,26,4,-23,26,Atlantic County,New Jersey,LOC-LOC,LOC-LOC,PROPN-PROPN,PROPN-PROPN,compound-pobj,compound-conj,NNP-NNP,NNP-NNP,1,1
6,0.0,35,are,4,27,33,6,26,1,-23,29,Atlantic County,United States,LOC-LOC,LOC-LOC,PROPN-PROPN,PROPN-PROPN,compound-pobj,compound-appos,NNP-NNP,NNP-NNP,1,1
7,0.0,35,are,4,30,33,3,29,1,-26,29,New Jersey,United States,LOC-LOC,LOC-LOC,PROPN-PROPN,PROPN-PROPN,compound-conj,compound-appos,NNP-NNP,NNP-NNP,2,1
0,0.0,26,Campbell,1,8,15,7,7,10,-7,14,Māori language,New Zealand,MISC-MISC,LOC-LOC,PROPN-NOUN,PROPN-PROPN,compound-pobj,compound-appos,NNP-NN,NNP-NNP,7,1
1,0.0,26,Campbell,1,13,15,2,12,10,-12,14,Marlborough,New Zealand,LOC,LOC-LOC,PROPN,PROPN-PROPN,pobj,compound-appos,NNP,NNP-NNP,2,1
2,0.0,26,Campbell,1,13,24,11,12,1,-12,23,Marlborough,South Island,LOC,LOC-LOC,PROPN,PROPN-PROPN,pobj,compound-pobj,NNP,NNP-NNP,7,1
3,4.0,13,guided,5,2,12,10,1,0,3,7,Cape Campbell Lighthouse,1870,LOC-LOC-LOC,TIME,PROPN-PROPN-PROPN,NUM,compound-compound-nsubj,pobj,NNP-NNP-NNP,CD,3,1
0,0.0,23,was,14,1,5,4,0,17,13,-9,Frederick Joseph Stevenson,"December 2 , 1895",PER-PER-PER,TIME-TIME-TIME-TIME,PROPN-PROPN-PROPN,PROPN-NUM-PUNCT-NUM,compound-compound-nsubj,appos-nummod-punct-nummod,NNP-NNP-NNP,"NNP-CD-,-CD",3,1
1,0.0,23,was,14,1,10,9,0,12,13,-4,Frederick Joseph Stevenson,"January 5 , 1928",PER-PER-PER,TIME-TIME-TIME-TIME,PROPN-PROPN-PROPN,PROPN-NUM-PUNCT-NUM,compound-compound-nsubj,prep-nummod-punct-nummod,NNP-NNP-NNP,"NNP-CD-,-CD",4,1
2,0.0,23,was,14,1,17,16,0,5,13,3,Frederick Joseph Stevenson,Canadian,PER-PER-PER,LOC,PROPN-PROPN-PROPN,ADJ,compound-compound-nsubj,amod,NNP-NNP-NNP,JJ,4,1
0,3.0,23,is,8,4,15,11,3,7,4,7,Stand Up for Love,R&B,MISC-MISC-MISC-MISC,MISC,VERB-PART-ADP-NOUN,NOUN,csubj-prt-prep-pobj,attr,VB-RP-IN-NN,NN,3,1
0,1.0,19,is,1,7,12,5,6,6,-6,11,Martin,A Song of Ice and Fire,PER,MISC-MISC-MISC-MISC-MISC-MISC,PROPN,DET-NOUN-ADP-PROPN-CCONJ-PROPN,poss,compound-pobj-prep-nmod-cc-conj,NNP,DT-NN-IN-NNP-CC-NNP,2,1
1,2.0,28,is,10,10,20,10,9,7,0,10,Sansa,Eddard Stark,PER,PER-PER,PROPN,PROPN-PROPN,nsubj,compound-pobj,NNP,NNP-NNP,3,1
2,3.0,33,appeared,2,10,23,13,9,9,-8,21,A Storm of Swords,2000,MISC-MISC-MISC-MISC,TIME,DET-PROPN-ADP-PROPN,NUM,det-appos-prep-pobj,appos,DT-NNP-IN-NNP,CD,5,1
3,3.0,33,appeared,2,10,10,0,9,22,-8,8,A Storm of Swords,A Feast for Crows,MISC-MISC-MISC-MISC,MISC-MISC-MISC-MISC,DET-PROPN-ADP-PROPN,DET-PROPN-ADP-PROPN,det-appos-prep-pobj,det-conj-prep-pobj,DT-NNP-IN-NNP,DT-NNP-IN-NNP,0,1
4,3.0,33,appeared,2,10,10,0,9,22,-8,8,A Storm of Swords,A Clash of Kings,MISC-MISC-MISC-MISC,MISC-MISC-MISC-MISC,DET-PROPN-ADP-PROPN,DET-PROPN-ADP-NOUN,det-appos-prep-pobj,det-appos-prep-pobj,DT-NNP-IN-NNP,DT-NNP-IN-NNS,0,1
5,3.0,33,appeared,2,10,31,21,9,1,-8,29,A Feast for Crows,2005,MISC-MISC-MISC-MISC,TIME,DET-PROPN-ADP-PROPN,NUM,det-conj-prep-pobj,appos,DT-NNP-IN-NNP,CD,8,1
6,3.0,33,appeared,2,10,10,0,9,22,-8,8,A Feast for Crows,A Clash of Kings,MISC-MISC-MISC-MISC,MISC-MISC-MISC-MISC,DET-PROPN-ADP-PROPN,DET-PROPN-ADP-NOUN,det-conj-prep-pobj,det-appos-prep-pobj,DT-NNP-IN-NNP,DT-NNP-IN-NNS,0,1
7,4.0,36,confirmed,19,7,32,25,6,3,12,13,A Dance with Dragons,The Winds of Winter,MISC-MISC-MISC-MISC,MISC-MISC-MISC-MISC,DET-PROPN-ADP-PROPN,DET-PROPN-ADP-PROPN,det-appos-prep-pobj,det-appos-prep-pobj,DT-NNP-IN-NNPS,DT-NNPS-IN-NNP,6,1
8,5.0,20,portrayed,15,13,9,-4,12,10,2,-6,Sansa Stark,Game of Thrones,PER-PER,MISC-MISC-MISC,PROPN-PROPN,PROPN-ADP-PROPN,compound-nsubjpass,nsubjpass-prep-pobj,NNP-NNP,NNP-IN-NNP,3,1
9,5.0,20,portrayed,15,13,18,5,12,1,2,3,Sansa Stark,Sophie Turner,PER-PER,PER-PER,PROPN-PROPN,PROPN-PROPN,compound-nsubjpass,compound-pobj,NNP-NNP,NNP-NNP,3,1
10,5.0,20,portrayed,15,9,18,9,8,1,6,3,Game of Thrones,Sophie Turner,MISC-MISC-MISC,PER-PER,PROPN-ADP-PROPN,PROPN-PROPN,nsubjpass-prep-pobj,compound-pobj,NNP-IN-NNP,NNP-NNP,4,1
0,0.0,29,(;,5,13,21,8,12,7,-8,16,RSFSR,Russia,LOC,LOC,PROPN,PROPN,nmod,appos,NNP,NNP,2,1
1,0.0,29,(;,5,13,25,12,12,3,-8,20,RSFSR,Russian,LOC,LOC,PROPN,ADJ,nmod,amod,NNP,JJ,4,1
0,0.0,20,Standing,0,1,18,17,0,1,-1,18,Standing in the Light,Level 42,MISC-MISC-MISC-MISC,ORG-ORG,VERB-ADP-DET-PROPN,PROPN-NUM,ROOT-prep-det-pobj,appos-nummod,VBG-IN-DT-NNP,NNP-CD,8,1
1,8.0,32,released,3,1,31,30,0,0,2,28,The Pursuit of Accidents,Polydor,MISC-MISC-MISC-MISC,ORG,DET-PROPN-ADP-PROPN,PROPN,det-appos-prep-pobj,pobj,DT-NNP-IN-NNPS,NNP,4,1
0,0.0,38,is,4,1,22,21,0,15,3,18,The Medallion,Gordon Chan,MISC-MISC,PER-PER,DET-PROPN,PROPN-PROPN,det-nsubj,compound-appos,DT-NNP,NNP-NNP,5,1
1,0.0,38,is,4,1,27,26,0,10,3,23,The Medallion,Jackie Chan,MISC-MISC,PER-PER,DET-PROPN,PROPN-PROPN,det-nsubj,compound-dobj,DT-NNP,NNP-NNP,3,1
2,0.0,38,is,4,1,30,29,0,7,3,26,The Medallion,Lee Evans,MISC-MISC,PER-PER,DET-PROPN,PROPN-PROPN,det-nsubj,compound-conj,DT-NNP,NNP-NNP,4,1
3,0.0,38,is,4,1,33,32,0,4,3,29,The Medallion,Claire Forlani,MISC-MISC,PER-PER,DET-PROPN,PROPN-PROPN,det-nsubj,compound-conj,DT-NNP,NNP-NNP,5,1
4,0.0,38,is,4,1,36,35,0,1,3,32,The Medallion,Julian Sands,MISC-MISC,PER-PER,DET-PROPN,PROPN-PROPN,det-nsubj,compound-conj,DT-NNP,NNP-NNPS,6,1
5,1.0,28,was,1,20,20,0,19,7,-19,19,Shanghai Noon,Shanghai Knights,MISC-MISC,MISC-MISC,PROPN-PROPN,PROPN-PROPN,compound-conj,compound-appos,NNP-NNP,NNP-NNPS,0,1
0,0.0,23,was,2,1,20,19,0,2,1,18,High Park,Ontario,LOC-LOC,LOC,ADJ-PROPN,PROPN,compound-nsubj,appos,JJ-NNP,NNP,8,1
1,0.0,23,was,2,1,22,21,0,0,1,20,High Park,Canada,LOC-LOC,LOC,ADJ-PROPN,PROPN,compound-nsubj,appos,JJ-NNP,NNP,2,1
2,0.0,23,was,2,16,20,4,15,2,-14,18,City of Toronto,Ontario,LOC-LOC-LOC,LOC,PROPN-ADP-PROPN,PROPN,pobj-prep-pobj,appos,NNP-IN-NNP,NNP,3,1
3,0.0,23,was,2,16,22,6,15,0,-14,20,City of Toronto,Canada,LOC-LOC-LOC,LOC,PROPN-ADP-PROPN,PROPN,pobj-prep-pobj,appos,NNP-IN-NNP,NNP,7,1
4,0.0,23,was,2,20,22,2,19,0,-18,20,Ontario,Canada,LOC,LOC,PROPN,PROPN,appos,appos,NNP,NNP,8,1
5,5.0,44,been,8,3,6,3,2,37,5,-2,City of West Toronto Junction,Toronto,LOC-LOC-LOC-LOC-LOC,LOC,PROPN-ADP-PROPN-PROPN-PROPN,PROPN,nsubj-prep-compound-compound-pobj,pobj,NNP-IN-NNP-NNP-NNP,NNP,1,1
0,0.0,41,awarded,6,2,15,13,1,25,4,9,Dan Snyder Memorial Award,Winnipeg Jets,MISC-MISC-MISC-MISC,ORG-ORG,PROPN-PROPN-PROPN-PROPN,PROPN-PROPN,compound-compound-compound-nsubjpass,compound-pobj,NNP-NNP-NNP-NNP,NNP-NNPS,6,1
1,1.0,37,created,3,22,35,13,21,1,-19,32,Dan Snyder,September 2003,PER-PER,TIME-TIME,PROPN-PROPN,PROPN-NUM,compound-npadvmod,pobj-nummod,NNP-NNP,NNP-CD,7,1
0,0.0,31,"""",0,2,10,8,1,20,-2,10,Good Life,The Braxtons,MISC-MISC,ORG-ORG,PROPN-PROPN,DET-PROPN,compound-nsubj,det-pobj,NNP-NNP,DT-NNPS,4,1
1,0.0,31,"""",0,14,29,15,13,1,-14,29,Toni Braxton,Tamar Braxton,PER-PER,PER-PER,PROPN-PROPN,PROPN-PROPN,compound-dobj,compound-conj,NNP-NNP,NNP-NNP,6,1
2,0.0,31,"""",0,25,29,4,24,1,-25,29,Traci Braxton,Tamar Braxton,PER-PER,PER-PER,PROPN-PROPN,PROPN-PROPN,compound-conj,compound-conj,NNP-NNP,NNP-NNP,1,1
3,5.0,40,was,2,20,33,13,19,6,-18,31,L.A. Reid,LaFace Records,PER-PER,ORG-ORG,PROPN-PROPN,PROPN-PROPN,compound-pobj,compound-dobj,NNP-NNP,NNP-NNPS,1,1
0,1.0,21,graduated,1,4,8,4,3,12,-3,7,Balliol College,University of Oxford,ORG-ORG,ORG-ORG-ORG,PROPN-PROPN,PROPN-ADP-PROPN,compound-pobj,pobj-prep-pobj,NNP-NNP,NNP-IN-NNP,5,1
1,2.0,57,known,10,8,18,10,7,38,2,8,Huxley,Brave New World,PER,MISC-MISC-MISC,PROPN,PROPN-PROPN-PROPN,nsubjpass,compound-compound-appos,NNP,NNP-NNP-NNP,3,1
2,2.0,57,known,10,8,1,-7,7,55,2,-9,Huxley,The Doors of Perception,PER,MISC-MISC-MISC-MISC,PROPN,DET-PROPN-ADP-PROPN,nsubjpass,det-pobj-prep-pobj,NNP,DT-NNPS-IN-NNP,2,1
0,0.0,38,is,10,1,6,5,0,31,9,-4,Kevin Durell Edwards,"October 30 , 1965",PER-PER-PER,TIME-TIME-TIME-TIME,PROPN-PROPN-PROPN,PROPN-NUM-PUNCT-NUM,compound-compound-nsubj,npadvmod-nummod-punct-nummod,NNP-NNP-NNP,"NNP-CD-,-CD",4,1
1,0.0,38,is,10,1,14,13,0,23,9,4,Kevin Durell Edwards,American,PER-PER-PER,LOC,PROPN-PROPN-PROPN,ADJ,compound-compound-nsubj,amod,NNP-NNP-NNP,JJ,4,1
2,3.0,20,played,1,15,5,-10,14,14,-14,4,Orlando Magic,NBA,ORG-ORG,ORG,PROPN-PROPN,PROPN,compound-conj,compound,NNP-NNP,NNP,4,1
3,3.0,20,played,1,18,5,-13,17,14,-17,4,Vancouver Grizzlies,NBA,ORG-ORG,ORG,PROPN-PROPN,PROPN,compound-conj,compound,NNP-NNP,NNP,5,1
4,9.0,17,played,1,8,15,7,7,1,-7,14,Lakeland Community College,Ohio,ORG-ORG-ORG,LOC,PROPN-PROPN-PROPN,PROPN,compound-compound-conj,appos,NNP-NNP-NNP,NNP,5,1
0,0.0,16,"""",0,2,11,9,1,4,-2,11,Fall Back Down,American,MISC-MISC-MISC,LOC,VERB-ADV-PART,ADJ,csubj-compound-advmod,amod,VB-RB-RP,JJ,7,1
1,8.0,16,recorded,3,12,15,3,11,0,-9,12,Acoustic,2010,MISC,TIME,PROPN,NUM,oprd,pobj,NNP,CD,5,1
0,0.0,32,is,17,29,31,2,28,0,-12,14,Barranquilla,Colombia,LOC,LOC,PROPN,PROPN,pobj,appos,NNP,NNP,5,1
1,5.0,26,was,7,24,22,-2,23,3,-17,15,Roberto Meléndez,Colombian,PER-PER,LOC,PROPN-PROPN,ADJ,compound-appos,amod,NNP-NNP,JJ,1,1
0,0.0,11,is,4,2,7,5,1,3,2,3,Korea National Ballet,South Korean,ORG-ORG-ORG,LOC-LOC,PROPN-PROPN-PROPN,ADJ-ADJ,compound-compound-nsubj,amod-amod,NNP-NNP-NNP,JJ-JJ,4,1
1,8.0,25,was,13,10,19,9,9,5,3,6,Joo - won Kim,BENOIS de la DANSE prize,PER-PER-PER-PER,MISC-MISC-MISC-MISC-MISC,PROPN-PUNCT-VERB-PROPN,PROPN-X-X-PROPN-NOUN,compound-punct-compound-nsubj,nmod-nmod-compound-compound-pobj,NNP-HYPH-VBD-NNP,NNP-FW-FW-NNP-NN,7,1
0,0.0,15,is,10,1,7,6,0,7,9,-3,Malinda Natalia Damgaard,1 March 1981,PER-PER-PER,TIME-TIME-TIME,PROPN-PROPN-PROPN,NUM-PROPN-NUM,compound-compound-nsubj,nummod-npadvmod-nummod,NNP-NNP-NNP,CD-NNP-CD,3,1
1,5.0,37,made,2,24,27,3,23,9,-22,25,Saint Petersburg,Russia,LOC-LOC,LOC,PROPN-PROPN,PROPN,compound-pobj,appos,NNP-NNP,NNP,4,1
0,0.0,58,was,18,1,9,8,0,48,17,-9,"Albert Ogden "" Scoop "" Vorse Jr.","August 9 , 1914",PER-PER-PER-PER-PER-PER-PER,TIME-TIME-TIME-TIME,PROPN-PROPN-PUNCT-PROPN-PUNCT-PROPN-PROPN,PROPN-NUM-PUNCT-NUM,compound-nmod-punct-nmod-punct-compound-nsubj,npadvmod-nummod-punct-npadvmod,NNP-NNP-``-NNP-``-NNP-NNP,"NNP-CD-,-CD",3,1
1,0.0,58,was,18,1,14,13,0,43,17,-4,"Albert Ogden "" Scoop "" Vorse Jr.","October 27 , 1979",PER-PER-PER-PER-PER-PER-PER,TIME-TIME-TIME-TIME,PROPN-PROPN-PUNCT-PROPN-PUNCT-PROPN-PROPN,PROPN-NUM-PUNCT-NUM,compound-nmod-punct-nmod-punct-compound-nsubj,npadvmod-nummod-punct-nummod,NNP-NNP-``-NNP-``-NNP-NNP,"NNP-CD-,-CD",3,1
2,0.0,58,was,18,1,22,21,0,35,17,4,"Albert Ogden "" Scoop "" Vorse Jr.",United States Navy,PER-PER-PER-PER-PER-PER-PER,ORG-ORG-ORG,PROPN-PROPN-PUNCT-PROPN-PUNCT-PROPN-PROPN,PROPN-PROPN-PROPN,compound-nmod-punct-nmod-punct-compound-nsubj,compound-compound-compound,NNP-NNP-``-NNP-``-NNP-NNP,NNP-NNP-NNP,5,1
3,0.0,58,was,18,1,30,29,0,27,17,12,"Albert Ogden "" Scoop "" Vorse Jr.",World War II,PER-PER-PER-PER-PER-PER-PER,MISC-MISC-MISC,PROPN-PROPN-PUNCT-PROPN-PUNCT-PROPN-PROPN,PROPN-PROPN-PROPN,compound-nmod-punct-nmod-punct-compound-nsubj,compound-compound-pobj,NNP-NNP-``-NNP-``-NNP-NNP,NNP-NNP-NNP,7,1
0,0.0,20,was,12,1,5,4,0,14,11,-7,Franz Josef Niedenzu,29 November 1857,PER-PER-PER,TIME-TIME-TIME,PROPN-PROPN-PROPN,NUM-PROPN-NUM,compound-compound-nsubj,nummod-appos-nummod,NNP-NNP-NNP,CD-NNP-CD,2,1
1,0.0,20,was,12,1,9,8,0,10,11,-3,Franz Josef Niedenzu,30 September 1937,PER-PER-PER,TIME-TIME-TIME,PROPN-PROPN-PROPN,NUM-PROPN-NUM,compound-compound-nsubj,nummod-appos-nummod,NNP-NNP-NNP,CD-NNP-CD,2,1
2,0.0,20,was,12,1,19,18,0,0,11,7,Franz Josef Niedenzu,Köppernig,PER-PER-PER,LOC,PROPN-PROPN-PROPN,PROPN,compound-compound-nsubj,pobj,NNP-NNP-NNP,NNP,3,1
0,0.0,15,is,4,2,14,12,1,0,2,10,Division of Calwell,Victoria,LOC-LOC-LOC,LOC,PROPN-ADP-PROPN,PROPN,nsubj-prep-pobj,pobj,NNP-IN-NNP,NNP,3,1
1,0.0,15,is,4,7,14,7,6,0,-3,10,Australian Electoral Division,Victoria,MISC-MISC-MISC,LOC,PROPN-PROPN-PROPN,PROPN,compound-compound-attr,pobj,NNP-NNP-NNP,NNP,3,1
2,1.0,32,created,3,11,26,15,10,5,-8,23,Arthur Calwell,Australian Labor Party,PER-PER,ORG-ORG-ORG,PROPN-PROPN,PROPN-PROPN-PROPN,compound-pobj,compound-compound-pobj,NNP-NNP,NNP-NNP-NNP,5,1
3,5.0,24,is,12,14,21,7,13,2,-2,9,Maria Vamvakinou,Australian Labor Party,PER-PER,ORG-ORG-ORG,PROPN-PROPN,PROPN-PROPN-PROPN,compound-attr,compound-compound-pobj,NNP-NNP,NNP-NNP-NNP,4,1
0,1.0,34,passes,2,10,23,13,9,10,-8,21,l'Arc de Triomphe,French Republic,LOC-LOC-LOC,LOC-LOC,PROPN-ADP-PROPN,PROPN-PROPN,compound-nmod-pobj,compound-pobj,NNP-IN-NNP,NNP-NNP,9,1
1,1.0,34,passes,2,14,23,9,13,10,-12,21,Place de la Concorde,French Republic,LOC-LOC-LOC-LOC,LOC-LOC,PROPN-PROPN-X-PROPN,PROPN-PROPN,compound-compound-compound-pobj,compound-pobj,NNP-NNP-FW-NNP,NNP-NNP,5,1
0,1.0,26,portrays,1,22,25,3,21,0,-21,24,National Gallery,London,LOC-LOC,LOC,PROPN-PROPN,PROPN,compound-pobj,npadvmod,NNP-NNP,NNP,5,1
0,0.0,26,is,1,9,13,4,8,12,-8,12,Cambridge,USA,LOC,LOC,PROPN,PROPN,pobj,conj,NNP,NNP,4,1
1,0.0,26,is,1,11,13,2,10,12,-10,12,Massachusetts,USA,LOC,LOC,PROPN,PROPN,conj,conj,NNP,NNP,3,1
2,2.0,26,perform,14,7,11,4,6,14,7,-3,Face to Face,Stuart Kimball,ORG-ORG-ORG,PER-PER,NOUN-ADP-PROPN,PROPN-PROPN,pobj-prep-compound,compound-pobj,NN-IN-NNP,NNP-NNP,2,1
0,0.0,13,is,2,8,10,2,7,2,-6,8,Chelsea,London,LOC,LOC,PROPN,PROPN,pobj,conj,NNP,NNP,3,1
1,0.0,13,is,2,8,12,4,7,0,-6,10,Chelsea,England,LOC,LOC,PROPN,PROPN,pobj,appos,NNP,NNP,5,1
2,0.0,13,is,2,10,12,2,9,0,-8,10,London,England,LOC,LOC,PROPN,PROPN,conj,appos,NNP,NNP,6,1
3,6.0,11,was,2,6,9,3,5,1,-4,7,British,Margaret Thatcher,LOC,PER-PER,ADJ,PROPN-PROPN,amod,compound-appos,JJ,NNP-NNP,2,1
4,7.0,19,bought,3,6,11,5,5,7,-3,8,Margaret Thatcher,Denis Thatcher,PER-PER,PER-PER,PROPN-PROPN,PROPN-PROPN,compound-pobj,compound-appos,NNP-NNP,NNP-NNP,2,1
5,9.0,27,was,6,19,23,4,18,3,-13,17,George Devine CBE,1910,PER-PER-PER,TIME,PROPN-PROPN-PROPN,NUM,compound-compound-appos,nummod,NNP-NNP-NNP,CD,3,1
6,9.0,27,was,6,19,25,6,18,1,-13,19,George Devine CBE,1966,PER-PER-PER,TIME,PROPN-PROPN-PROPN,NUM,compound-compound-appos,nummod,NNP-NNP-NNP,CD,4,1
0,0.0,17,is,2,1,7,6,0,9,1,5,Commonwealth Park,Australia,LOC-LOC,LOC,PROPN-PROPN,PROPN,compound-nsubj,appos,NNP-NNP,NNP,4,1
1,0.0,17,is,2,5,7,2,4,9,-3,5,Canberra,Australia,LOC,LOC,PROPN,PROPN,pobj,appos,NNP,NNP,2,1
2,0.0,17,is,2,5,14,9,4,2,-3,12,Canberra,Lake Burley Griffin,LOC,LOC-LOC-LOC,PROPN,PROPN-PROPN-PROPN,pobj,compound-compound-pobj,NNP,NNP-NNP-NNP,8,1
0,0.0,39,is,26,1,4,3,0,34,25,-22,Antonín Puč,16 May 1907,PER-PER,TIME-TIME-TIME,PROPN-PROPN,NUM-PROPN-NUM,compound-nsubj,nummod-appos-nummod,NNP-NNP,CD-NNP-CD,1,1
1,0.0,39,is,26,1,8,7,0,30,25,-18,Antonín Puč,Jinonice,PER-PER,LOC,PROPN-PROPN,PROPN,compound-nsubj,compound,NNP-NNP,NNP,2,1
2,0.0,39,is,26,1,14,13,0,24,25,-12,Antonín Puč,Prague,PER-PER,LOC,PROPN-PROPN,PROPN,compound-nsubj,pobj,NNP-NNP,NNP,1,1
3,0.0,39,is,26,1,18,17,0,20,25,-8,Antonín Puč,Czech,PER-PER,LOC,PROPN-PROPN,ADJ,compound-nsubj,amod,NNP-NNP,JJ,2,1
4,3.0,11,spent,1,1,9,8,0,1,0,8,Puč,Slavia Prague,PER,ORG-ORG,PROPN,PROPN-PROPN,nsubj,compound-pobj,NNP,NNP-NNP,5,1
0,1.0,38,was,2,24,28,4,23,9,-22,26,Selma Neubacher Steele,1870,PER-PER-PER,TIME,PROPN-PROPN-PROPN,NUM,compound-compound-conj,nummod,NNP-NNP-NNP,CD,2,1
1,1.0,38,was,2,24,15,-9,23,22,-22,13,Selma Neubacher Steele,Theodore Clement Steele,PER-PER-PER,PER-PER-PER,PROPN-PROPN-PROPN,PROPN-PROPN-PROPN,compound-compound-conj,compound-compound-conj,NNP-NNP-NNP,NNP-NNP-NNP,3,1
2,1.0,38,was,2,15,19,4,14,18,-13,17,Theodore Clement Steele,1847,PER-PER-PER,TIME,PROPN-PROPN-PROPN,NUM,compound-compound-conj,nummod,NNP-NNP-NNP,CD,3,1
0,0.0,48,was,16,27,32,5,26,15,-11,16,New Orleans,United States,LOC-LOC,LOC-LOC,PROPN-PROPN,PROPN-PROPN,compound-pobj,compound-conj,NNP-NNP,NNP-NNP,2,1
1,0.0,48,was,16,30,32,2,29,15,-14,16,Louisiana,United States,LOC,LOC-LOC,PROPN,PROPN-PROPN,conj,compound-conj,NNP,NNP-NNP,2,1
0,0.0,37,Goes,1,1,28,27,0,8,0,27,Jason Goes to Hell : The Final Friday,John D. LeMay,MISC-MISC-MISC-MISC-MISC-MISC-MISC-MISC,PER-PER-PER,PROPN-VERB-ADP-PROPN-PUNCT-DET-PROPN-PROPN,PROPN-PROPN-PROPN,nsubj-ROOT-prep-pobj-punct-det-compound-nsubj,compound-compound-dobj,NNP-VBZ-IN-NNP-:-DT-NNP-NNP,NNP-NNP-NNP,4,1
1,0.0,37,Goes,1,1,32,31,0,4,0,31,Jason Goes to Hell : The Final Friday,Kari Keegan,MISC-MISC-MISC-MISC-MISC-MISC-MISC-MISC,PER-PER,PROPN-VERB-ADP-PROPN-PUNCT-DET-PROPN-PROPN,PROPN-PROPN,nsubj-ROOT-prep-pobj-punct-det-compound-nsubj,compound-conj,NNP-VBZ-IN-NNP-:-DT-NNP-NNP,NNP-NNP,4,1
2,0.0,37,Goes,1,1,35,34,0,1,0,34,Jason Goes to Hell : The Final Friday,Allison Smith,MISC-MISC-MISC-MISC-MISC-MISC-MISC-MISC,PER-PER,PROPN-VERB-ADP-PROPN-PUNCT-DET-PROPN-PROPN,PROPN-PROPN,nsubj-ROOT-prep-pobj-punct-det-compound-nsubj,compound-conj,NNP-VBZ-IN-NNP-:-DT-NNP-NNP,NNP-NNP,5,1
3,1.0,27,preceded,13,22,25,3,21,1,-9,12,Jason X,2001,MISC-MISC,TIME,PROPN-PROPN,NUM,compound-pobj,appos,NNP-NNP,CD,1,1
4,4.0,35,sold,16,8,15,7,7,19,8,-1,Part VIII : Jason Takes Manhattan,Paramount Pictures,MISC-MISC-MISC-MISC-MISC-MISC,ORG-ORG,NOUN-PROPN-PUNCT-PROPN-PROPN-PROPN,PROPN-PROPN,compound-pobj-punct-nsubj-ccomp-dobj,compound-nsubj,NN-NNP-:-NNP-NNP-NNP,NNP-NNP,6,1
0,0.0,38,is,5,2,20,18,1,17,3,15,Iglesia de Santo Tomé,Spain,LOC-LOC-LOC-LOC,LOC,PROPN-PROPN-PROPN-PROPN,PROPN,compound-compound-compound-nsubj,appos,NNP-NNP-NNP-NNP,NNP,12,1
1,0.0,38,is,5,18,20,2,17,17,-13,15,Toledo,Spain,LOC,LOC,PROPN,PROPN,pobj,appos,NNP,NNP,2,1
2,4.0,35,is,2,14,22,8,13,12,-12,20,The Burial of the Count of Orgaz,El Greco,MISC-MISC-MISC-MISC-MISC-MISC-MISC,PER-PER,DET-PROPN-ADP-DET-PROPN-ADP-PROPN,PROPN-PROPN,det-appos-prep-det-pobj-prep-pobj,compound-pobj,DT-NNP-IN-DT-NNP-IN-NNP,NNP-NNP,2,1
0,0.0,26,is,9,2,25,23,1,0,7,16,Multicultural History Society of Ontario,Canada,ORG-ORG-ORG-ORG-ORG,LOC,PROPN-PROPN-PROPN-ADP-PROPN,PROPN,compound-compound-nsubj-prep-pobj,appos,NNP-NNP-NNP-IN-NNP,NNP,3,1
1,0.0,26,is,9,23,25,2,22,0,-14,16,Toronto,Canada,LOC,LOC,PROPN,PROPN,pobj,appos,NNP,NNP,6,1
2,1.0,27,collects,10,6,3,-3,5,23,4,-7,Multicultural History Society of Ontario,1976,ORG-ORG-ORG-ORG-ORG,TIME,PROPN-PROPN-PROPN-ADP-PROPN,NUM,compound-compound-nsubj-prep-pobj,pobj,NNP-NNP-NNP-IN-NNP,CD,3,1
0,3.0,44,based,13,22,39,17,21,4,-9,26,Rose Kennedy,John F. Kennedy,PER-PER,PER-PER-PER,PROPN-PROPN,PROPN-PROPN-PROPN,compound-pobj,compound-compound-pobj,NNP-NNP,NNP-NNP-NNP,5,1
0,0.0,18,is,3,1,13,12,0,4,2,10,Webbs Creek Ferry,New South Wales,LOC-LOC-LOC,LOC-LOC-LOC,PROPN-PROPN-PROPN,PROPN-PROPN-PROPN,compound-compound-nsubj,compound-compound-pobj,NNP-NNP-NNP,NNP-NNP-NNP,8,1
1,0.0,18,is,3,1,17,16,0,0,2,14,Webbs Creek Ferry,Australia,LOC-LOC-LOC,LOC,PROPN-PROPN-PROPN,PROPN,compound-compound-nsubj,appos,NNP-NNP-NNP,NNP,3,1
2,0.0,18,is,3,10,13,3,9,4,-7,10,Hawkesbury River,New South Wales,LOC-LOC,LOC-LOC-LOC,PROPN-PROPN,PROPN-PROPN-PROPN,compound-pobj,compound-compound-pobj,NNP-NNP,NNP-NNP-NNP,3,1
3,0.0,18,is,3,10,17,7,9,0,-7,14,Hawkesbury River,Australia,LOC-LOC,LOC,PROPN-PROPN,PROPN,compound-pobj,appos,NNP-NNP,NNP,4,1
4,0.0,18,is,3,13,17,4,12,0,-10,14,New South Wales,Australia,LOC-LOC-LOC,LOC,PROPN-PROPN-PROPN,PROPN,compound-compound-pobj,appos,NNP-NNP-NNP,NNP,7,1
0,15.0,30,was,6,29,26,-3,28,3,-23,20,Toro,Sony,PER,ORG,PROPN,PROPN,dobj,poss,NNP,NNP,10,1
0,0.0,21,spans,3,2,6,4,1,14,1,3,Thomas Viaduct,Patapsco River,LOC-LOC,LOC-LOC,PROPN-PROPN,PROPN-PROPN,compound-nsubj,nmod-dobj,NNP-NNP,NNP-NNP,2,1
0,0.0,31,is,9,1,12,11,0,18,8,3,Dany Morin,Canadian,PER-PER,LOC,PROPN-PROPN,ADJ,compound-nsubj,amod,NNP-NNP,JJ,2,1
0,0.0,16,is,11,1,14,13,0,1,10,3,Georgy Fotev,Bulgarian,PER-PER,LOC,PROPN-PROPN,ADJ,compound-nsubj,amod,NNP-NNP,JJ,2,1
0,0.0,20,is,1,1,6,5,0,13,0,5,WhatDoTheyKnow,mySociety,MISC,ORG,PROPN,NOUN,nsubj,pobj,NNP,NN,4,1
0,0.0,42,is,21,1,11,10,0,30,20,-10,Movladi Saidarbievich Udugov,Germenchuk,PER-PER-PER,LOC,PROPN-PROPN-PROPN,PROPN,compound-compound-compound,pobj,NNP-NNP-NNP,NNP,4,1
1,0.0,42,is,21,1,13,12,0,28,20,-8,Movladi Saidarbievich Udugov,Shalinsky District,PER-PER-PER,LOC-LOC,PROPN-PROPN-PROPN,PROPN-PROPN,compound-compound-compound,compound-nsubj,NNP-NNP-NNP,NNP-NNP,4,1
2,0.0,42,is,21,13,16,3,12,25,8,-5,Shalinsky District,Chechnya,LOC-LOC,LOC,PROPN-PROPN,PROPN,compound-nsubj,npadvmod,NNP-NNP,NNP,4,1
3,2.0,76,is,22,20,13,-7,19,62,2,-9,Chechens,Islam,ORG,ORG,PROPN,PROPN,pobj,pobj,NNP,NNP,6,1
4,2.0,76,is,22,53,13,-40,52,62,-31,-9,Chechen,Islam,LOC,ORG,PROPN,PROPN,compound,pobj,NNP,NNP,16,1
0,1.0,17,were,2,1,16,15,0,0,1,14,Mötley Crüe,1981,ORG-ORG,TIME,PROPN-PROPN,NUM,compound-nsubj,pobj,NNP-NNP,CD,2,1
1,1.0,17,were,2,1,5,4,0,11,1,3,Mötley Crüe,American,ORG-ORG,LOC,PROPN-PROPN,ADJ,compound-nsubj,amod,NNP-NNP,JJ,4,1
2,1.0,17,were,2,11,5,-6,10,11,-9,3,Los Angeles,American,LOC-LOC,LOC,PROPN-PROPN,ADJ,compound-pobj,amod,NNP-NNP,JJ,5,1
0,9.0,54,resurfaced,23,45,3,-42,44,50,-22,-20,Donald Trump,the United States,PER-PER,LOC-LOC-LOC,PROPN-PROPN,DET-PROPN-PROPN,compound-pobj,det-compound-pobj,NNP-NNP,DT-NNP-NNP,7,1
1,9.0,54,resurfaced,23,48,3,-45,47,50,-25,-20,Bernie Sanders,the United States,PER-PER,LOC-LOC-LOC,PROPN-PROPN,DET-PROPN-PROPN,compound-conj,det-compound-pobj,NNP-NNP,DT-NNP-NNP,8,1
0,0.0,22,is,3,1,20,19,0,1,2,17,Dragon Quest X,Square Enix,MISC-MISC-MISC,ORG-ORG,PROPN-PROPN-PROPN,PROPN-PROPN,compound-compound-nsubj,compound-pobj,NNP-NNP-NNP,NNP-NNP,7,1
0,0.0,44,Hume,2,1,8,7,0,35,1,6,Allan Octavian Hume,6 June 1829,PER-PER-PER,TIME-TIME-TIME,PROPN-PROPN-PROPN,NUM-PROPN-NUM,compound-compound-ROOT,nummod-nmod-nummod,NNP-NNP-NNP,CD-NNP-CD,3,1
1,0.0,44,Hume,2,1,12,11,0,31,1,10,Allan Octavian Hume,31 July 1912,PER-PER-PER,TIME-TIME-TIME,PROPN-PROPN-PROPN,NUM-PROPN-NUM,compound-compound-ROOT,nummod-nsubj-nummod,NNP-NNP-NNP,CD-NNP-CD,3,1
2,5.0,33,rose,1,1,15,14,0,17,0,14,Hume,Joseph Hume,PER,PER-PER,PROPN,PROPN-PROPN,nsubj,compound-appos,NNP,NNP-NNP,4,1
3,11.0,14,was,1,8,12,4,7,1,-7,11,theosophical movement,Madame Blavatsky,MISC-MISC,PER-PER,ADJ-NOUN,PROPN-PROPN,amod-pobj,compound-pobj,JJ-NN,NNP-NNP,3,1
0,0.0,21,was,1,1,13,12,0,7,0,12,Auburn,United States,LOC,LOC-LOC,PROPN,PROPN-PROPN,nsubj,compound-conj,NNP,NNP-NNP,5,1
1,0.0,21,was,1,8,11,3,7,9,-7,10,Baker County,Oregon,LOC-LOC,LOC,PROPN-PROPN,PROPN,compound-pobj,conj,NNP-NNP,NNP,2,1
2,0.0,21,was,1,8,13,5,7,7,-7,12,Baker County,United States,LOC-LOC,LOC-LOC,PROPN-PROPN,PROPN-PROPN,compound-pobj,compound-conj,NNP-NNP,NNP-NNP,2,1
3,0.0,21,was,1,11,13,2,10,7,-10,12,Oregon,United States,LOC,LOC-LOC,PROPN,PROPN-PROPN,conj,compound-conj,NNP,NNP-NNP,2,1
0,4.0,51,worked,2,11,16,5,10,34,-9,14,Sandy Hook,New Jersey,PER-PER,LOC-LOC,PROPN-PROPN,PROPN-PROPN,compound-compound,compound-pobj,NNP-NNP,NNP-NNP,3,1
0,0.0,30,Kreitzberg,1,1,4,3,0,25,0,3,Peeter Kreitzberg,"December 14 , 1948",PER-PER,TIME-TIME-TIME-TIME,PROPN-PROPN,PROPN-NUM-PUNCT-NUM,compound-ROOT,appos-nummod-punct-nummod,NNP-NNP,"NNP-CD-,-CD",2,1
1,0.0,30,Kreitzberg,1,1,9,8,0,20,0,8,Peeter Kreitzberg,"November 3 , 2011",PER-PER,TIME-TIME-TIME-TIME,PROPN-PROPN,PROPN-NUM-PUNCT-NUM,compound-ROOT,nsubj-nummod-punct-nummod,NNP-NNP,"NNP-CD-,-CD",2,1
2,0.0,30,Kreitzberg,1,1,27,26,0,2,0,26,Peeter Kreitzberg,Social Democratic Party,PER-PER,ORG-ORG-ORG,PROPN-PROPN,PROPN-PROPN-PROPN,compound-ROOT,compound-compound-pobj,NNP-NNP,NNP-NNP-NNP,7,1
3,3.0,19,served,2,9,12,3,8,6,-7,10,Tallinn,Estonian,LOC,LOC,PROPN,ADJ,pobj,amod,NNP,JJ,2,1
0,0.0,19,was,13,1,4,3,0,14,12,-9,Albin Kitzinger,1 February 1912,PER-PER,TIME-TIME-TIME,PROPN-PROPN,NUM-PROPN-NUM,compound-nsubj,nummod-appos-nummod,NNP-NNP,CD-NNP-CD,1,1
1,0.0,19,was,13,1,8,7,0,10,12,-5,Albin Kitzinger,Schweinfurt,PER-PER,LOC,PROPN-PROPN,PROPN,compound-nsubj,compound,NNP-NNP,NNP,1,1
2,0.0,19,was,13,1,10,9,0,8,12,-3,Albin Kitzinger,6 August 1970,PER-PER,TIME-TIME-TIME,PROPN-PROPN,NUM-PROPN-NUM,compound-nsubj,nummod-appos-nummod,NNP-NNP,CD-NNP-CD,1,1
0,0.0,22,was,13,1,4,3,0,17,12,-9,Eugène Olivier,17 September 1881,PER-PER,TIME-TIME-TIME,PROPN-PROPN,NUM-PROPN-NUM,compound-nsubj,nummod-appos-nummod,NNP-NNP,CD-NNP-CD,1,1
1,0.0,22,was,13,1,8,7,0,13,12,-5,Eugène Olivier,Paris,PER-PER,LOC,PROPN-PROPN,PROPN,compound-nsubj,pobj,NNP-NNP,NNP,1,1
2,0.0,22,was,13,1,10,9,0,11,12,-3,Eugène Olivier,5 May 1964,PER-PER,TIME-TIME-TIME,PROPN-PROPN,NUM-PROPN-NUM,compound-nsubj,nummod-appos-nummod,NNP-NNP,CD-NNP-CD,1,1
0,0.0,23,is,4,1,18,17,0,4,3,14,Gorzów County,Lubusz Voivodeship,ORG-ORG,LOC-LOC,PROPN-PROPN,PROPN-PROPN,compound-nsubj,compound-pobj,NNP-NNP,NNP-NNP,4,1
1,0.0,23,is,4,18,22,4,17,0,-14,18,Lubusz Voivodeship,Poland,LOC-LOC,LOC,PROPN-PROPN,PROPN,compound-pobj,appos,NNP-NNP,NNP,4,1
0,0.0,15,Pitești,0,1,8,7,0,6,-1,8,Pitești,Romania,LOC,LOC,PROPN,PROPN,ROOT,pobj,NNP,NNP,3,1
0,5.0,27,killed,6,20,13,-7,19,13,-14,7,Aberdeenshire,Scottish,LOC,LOC,PROPN,ADJ,compound,amod,NNP,JJ,11,1
1,7.0,19,led,1,10,12,2,9,6,-9,11,England,Europe,LOC,LOC,PROPN,PROPN,pobj,appos,NNP,NNP,3,1
0,5.0,40,are,1,18,21,3,17,18,-17,20,Chivela Pass,México,LOC-LOC,LOC,PROPN-PROPN,PROPN,compound-pobj,pobj,NNP-NNP,NNP,3,1
0,0.0,24,is,8,21,23,2,20,0,-13,15,Tokyo,Japan,LOC,LOC,PROPN,PROPN,conj,appos,NNP,NNP,4,1
0,0.0,47,was,17,1,4,3,0,42,16,-13,Lieven Bauwens,14 June 1769,PER-PER,TIME-TIME-TIME,PROPN-PROPN,NUM-PROPN-NUM,compound-nsubj,nummod-appos-nummod,NNP-NNP,CD-NNP-CD,1,1
1,0.0,47,was,17,1,9,8,0,37,16,-8,Lieven Bauwens,Ghent,PER-PER,LOC,PROPN-PROPN,PROPN,compound-nsubj,compound,NNP-NNP,NNP,1,1
2,0.0,47,was,17,1,11,10,0,35,16,-6,Lieven Bauwens,17 March 1822,PER-PER,TIME-TIME-TIME,PROPN-PROPN,NUM-PROPN-NUM,compound-nsubj,nummod-appos-nummod,NNP-NNP,CD-NNP-CD,1,1
3,0.0,47,was,17,1,16,15,0,30,16,-1,Lieven Bauwens,Paris,PER-PER,LOC,PROPN-PROPN,PROPN,compound-nsubj,pobj,NNP-NNP,NNP,1,1
4,0.0,47,was,17,1,20,19,0,26,16,3,Lieven Bauwens,Belgian,PER-PER,LOC,PROPN-PROPN,ADJ,compound-nsubj,amod,NNP-NNP,JJ,2,1
0,0.0,37,was,14,1,10,9,0,26,13,-4,Rudolf Wolters,"January 7 , 1983",PER-PER,TIME-TIME-TIME-TIME,PROPN-PROPN,PROPN-NUM-PUNCT-NUM,compound-nsubj,appos-nummod-punct-nummod,NNP-NNP,"NNP-CD-,-CD",3,1
1,2.0,48,collapsed,8,19,25,6,18,22,-11,17,Hitler,Jewish Holocaust,PER,MISC-MISC,PROPN,ADJ-PROPN,pobj,amod-pobj,NNP,JJ-NNP,5,1
0,1.0,25,produced,2,5,22,17,4,2,-3,20,Shankar,Dark Horse,PER,MISC-MISC,PROPN,PROPN-PROPN,poss,compound-compound,NNP,NNP-NNP,10,1
1,1.0,25,produced,2,8,22,14,7,2,-6,20,George Harrison,Dark Horse,PER-PER,MISC-MISC,PROPN-PROPN,PROPN-PROPN,compound-appos,compound-compound,NNP-NNP,NNP-NNP,9,1
2,1.0,25,produced,2,18,22,4,17,2,-16,20,ex - Beatle,Dark Horse,ORG-ORG-ORG,MISC-MISC,PROPN-PROPN-PROPN,PROPN-PROPN,subtok-subtok-poss,compound-compound,NNP-NNP-NNP,NNP-NNP,3,1
3,3.0,47,refers,6,3,3,0,2,43,3,-3,Shankar Family & Friends,Shankar,MISC-MISC-MISC-MISC,PER,PROPN-PROPN-CCONJ-PROPN,PROPN,compound-nsubj-cc-conj,poss,NNP-NNP-CC-NNP,NNP,0,1
0,0.0,38,Romero,3,27,37,10,26,0,-24,34,Matamoros,Tamaulipas,LOC,LOC,PROPN,PROPN,pobj,appos,NNP,NNP,6,1
1,3.0,36,left,3,17,23,6,16,12,-14,20,Antonio Cárdenas Guillén,Mexico,PER-PER-PER,LOC,PROPN-PROPN-PROPN,PROPN,compound-compound-dobj,poss,NNP-NNP-NNP,NNP,6,1
0,0.0,16,is,3,1,2,1,0,13,2,-1,West Aceh Regency,Aceh,LOC-LOC-LOC,LOC,PROPN-PROPN-PROPN,PROPN,compound-compound-nsubj,nmod,NNP-NNP-NNP,NNP,1,1
1,0.0,16,is,3,1,15,14,0,0,2,12,West Aceh Regency,Indonesia,LOC-LOC-LOC,LOC,PROPN-PROPN-PROPN,PROPN,compound-compound-nsubj,pobj,NNP-NNP-NNP,NNP,3,1
0,0.0,19,is,14,1,5,4,0,13,13,-9,Ludmila Peterková,16 September 1967,PER-PER,TIME-TIME-TIME,PROPN-PROPN,NUM-PROPN-NUM,compound-nsubj,nummod-npadvmod-nummod,NNP-NNP,CD-NNP-CD,2,1
1,0.0,19,is,14,1,9,8,0,9,13,-5,Ludmila Peterková,Karlovy Vary,PER-PER,LOC-LOC,PROPN-PROPN,PROPN-PROPN,compound-nsubj,compound-pobj,NNP-NNP,NNP-NNP,3,1
0,0.0,39,is,20,10,12,2,9,26,10,-8,Ica,Peru,LOC,LOC,PROPN,PROPN,npadvmod,npadvmod,NNP,NNP,2,1
1,1.0,39,became,11,9,23,14,8,15,2,12,Shining Path,Abimael Guzmán,ORG-ORG,PER-PER,PROPN-PROPN,PROPN-PROPN,compound-pobj,compound-compound,NNP-NNP,NNP-NNP,6,1
2,2.0,18,captured,2,13,16,3,12,1,-11,14,Shining Path,Abimael Guzmán,ORG-ORG,PER-PER,VERB-PROPN,PROPN-PROPN,compound-compound,compound-appos,VBG-NNP,NNP-NNP,2,1
3,1.0,39,became,11,23,32,9,22,6,-12,21,Abimael Guzmán,Augusta La Torre,PER-PER,PER-PER-PER,PROPN-PROPN,PROPN-PROPN-PROPN,compound-compound,compound-compound-compound,NNP-NNP,NNP-NNP-NNP,5,1
0,0.0,23,is,3,17,19,2,16,3,-14,16,London,U.K.,LOC,LOC,PROPN,PROPN,pobj,appos,NNP,NNP,2,1
0,0.0,58,was,17,50,27,-23,49,30,-33,10,Pittsburgh Pirates,Major League Baseball,ORG-ORG,ORG-ORG-ORG,PROPN-PROPN,PROPN-PROPN-PROPN,compound-conj,compound-compound-pobj,NNP-NNPS,NNP-NNP-NNP,8,1
0,0.0,13,is,3,1,12,11,0,0,2,9,Us and Them,Godflesh,MISC-MISC-MISC,ORG,PRON-CCONJ-PRON,PROPN,nsubj-cc-conj,pobj,PRP-CC-PRP,NNP,3,1
1,2.0,34,influenced,17,14,3,-11,13,30,3,-14,Us and Them,Godflesh,MISC-MISC-MISC,ORG,PRON-CCONJ-PRON,PROPN,nsubjpass-cc-conj,poss,PRP-CC-PRP,NNP,9,1
2,3.0,32,admitted,12,3,9,6,2,22,9,-3,Us and Them,Godflesh,MISC-MISC-MISC,ORG,PRON-CCONJ-PRON,PROPN,poss-cc-poss,compound,PRP-CC-PRP,NNP,5,1
3,3.0,32,admitted,12,11,9,-2,10,22,1,-3,Justin Broadrick,Godflesh,PER-PER,ORG,PROPN-PROPN,PROPN,compound-nsubj,compound,NNP-NNP,NNP,1,1
0,0.0,29,are,2,17,26,9,16,2,-15,24,Barsoom,Edgar Rice Burroughs,LOC,PER-PER-PER,PROPN,PROPN-PROPN-PROPN,pobj,compound-compound-pobj,NNP,NNP-NNP-NNP,6,1
0,0.0,14,is,2,1,13,12,0,0,1,11,Conrad Indianapolis,Indiana,LOC-LOC,LOC,PROPN-PROPN,PROPN,compound-nsubj,appos,NNP-NNP,NNP,2,1
0,0.0,39,was,18,1,7,6,0,31,17,-11,"Branko "" Isusek "" Pleše",12 January 1915,PER-PER-PER-PER-PER,TIME-TIME-TIME,PROPN-PUNCT-PROPN-PUNCT-PROPN,NUM-PROPN-NUM,nmod-punct-nmod-punct-nsubj,nummod-npadvmod-nummod,NNP-``-NNP-''-NNP,CD-NNP-CD,3,1
1,0.0,39,was,18,1,11,10,0,27,17,-7,"Branko "" Isusek "" Pleše",Delnice,PER-PER-PER-PER-PER,LOC,PROPN-PUNCT-PROPN-PUNCT-PROPN,PROPN,nmod-punct-nmod-punct-nsubj,compound,NNP-``-NNP-''-NNP,NNP,3,1
2,0.0,39,was,18,1,13,12,0,25,17,-5,"Branko "" Isusek "" Pleše",28 March 1980,PER-PER-PER-PER-PER,TIME-TIME-TIME,PROPN-PUNCT-PROPN-PUNCT-PROPN,NUM-PROPN-NUM,nmod-punct-nmod-punct-nsubj,nummod-npadvmod-nummod,NNP-``-NNP-''-NNP,CD-NNP-CD,3,1
3,0.0,39,was,18,1,17,16,0,21,17,-1,"Branko "" Isusek "" Pleše",Zagreb,PER-PER-PER-PER-PER,LOC,PROPN-PUNCT-PROPN-PUNCT-PROPN,PROPN,nmod-punct-nmod-punct-nsubj,pobj,NNP-``-NNP-''-NNP,NNP,3,1
0,3.0,30,was,0,7,16,9,6,13,-7,16,Eurovision Song Contest 1988,Kirsten & Søren,MISC-MISC-MISC-MISC,ORG-ORG-ORG,PROPN-PROPN-PROPN-NUM,PROPN-CCONJ-PROPN,compound-compound-pobj-appos,pobj-cc-conj,NNP-NNP-NNP-CD,NNP-CC-NNP,8,1
1,4.0,30,performed,3,24,22,-2,23,7,-21,19,Afroditi Frida,Greece,ORG-ORG,LOC,PROPN-PROPN,PROPN,compound-dobj,poss,NNP-NNP,NNP,2,1
2,9.0,21,succeeded,2,9,12,3,8,8,-7,10,1989 Contest,Birthe Kjær,MISC-MISC,PER-PER,NUM-PROPN,PROPN-PROPN,nummod-pobj,compound-pobj,CD-NNP,NNP-NNP,2,1
3,9.0,21,succeeded,2,12,5,-7,11,15,-10,3,Birthe Kjær,Danish,PER-PER,LOC,PROPN-PROPN,ADJ,compound-pobj,compound,NNP-NNP,JJ,6,1
0,0.0,27,was,13,1,5,4,0,21,12,-8,Louis Alexander Slotin,1 December 1910,PER-PER-PER,TIME-TIME-TIME,PROPN-PROPN-PROPN,NUM-PROPN-NUM,compound-compound-nsubj,nummod-nmod-nummod,NNP-NNP-NNP,CD-NNP-CD,4,1
0,5.0,18,uses,1,13,6,-7,12,11,-12,5,North American Aerospace Defense Command,United States,ORG-ORG-ORG-ORG-ORG,LOC-LOC,PROPN-PROPN-PROPN-PROPN-PROPN,PROPN-PROPN,compound-compound-compound-compound-dobj,compound-pobj,NNP-NNP-NNP-NNP-NNP,NNP-NNP,5,1
1,5.0,18,uses,1,13,1,-12,12,16,-12,0,North American Aerospace Defense Command,Canada,ORG-ORG-ORG-ORG-ORG,LOC,PROPN-PROPN-PROPN-PROPN-PROPN,PROPN,compound-compound-compound-compound-dobj,nsubj,NNP-NNP-NNP-NNP-NNP,NNP,3,1
0,0.0,17,is,5,2,3,1,1,13,3,-2,Southern Maryland Blue Crabs,Maryland,ORG-ORG-ORG-ORG,LOC,PROPN-PROPN-PROPN-PROPN,PROPN,compound-compound-compound-nsubj,appos,NNP-NNP-NNP-NNP,NNP,2,1
1,0.0,17,is,5,8,3,-5,7,13,-3,-2,American,Maryland,LOC,LOC,ADJ,PROPN,amod,appos,JJ,NNP,4,1
2,3.0,30,represent,1,24,28,4,23,1,-23,27,Chesapeake Bay,Potomac River,LOC-LOC,LOC-LOC,PROPN-PROPN,PROPN-PROPN,compound-pobj,compound-conj,NNP-NNP,NNP-NNP,1,1
3,4.0,21,chose,6,11,2,-9,10,18,-5,-4,Blue Crabs,2006,ORG-ORG,TIME,PROPN-PROPN,NUM,compound-appos,pobj,NNP-NNP,CD,3,1
0,0.0,23,is,3,2,18,16,1,4,1,15,Paparazzi,The Fame,MISC,MISC-MISC,PROPN,DET-PROPN,nsubj,det-appos,NNP,DT-NNP,6,1
1,0.0,23,is,3,10,18,8,9,4,-7,15,Lady Gaga,The Fame,PER-PER,MISC-MISC,PROPN-PROPN,DET-PROPN,compound-pobj,det-appos,NNP-NNP,DT-NNP,5,1
2,0.0,23,is,3,18,21,3,17,1,-15,18,The Fame,2008,MISC-MISC,TIME,DET-PROPN,NUM,det-appos,appos,DT-NNP,CD,1,1
3,12.0,44,include,6,9,14,5,8,29,-3,8,The Monster Ball Tour,2009,MISC-MISC-MISC-MISC,TIME,DET-PROPN-PROPN-PROPN,NUM,det-compound-compound-pobj,nummod,DT-NNP-NNP-NNP,CD,3,1
4,12.0,44,include,6,9,42,33,8,1,-3,36,The Monster Ball Tour,2011,MISC-MISC-MISC-MISC,TIME,DET-PROPN-PROPN-PROPN,NUM,det-compound-compound-pobj,nummod,DT-NNP-NNP-NNP,CD,7,1
0,0.0,38,Papaconstantinou,5,21,23,2,20,14,-16,18,Brännkyrka,Sweden,LOC,LOC,PROPN,PROPN,pobj,npadvmod,NNP,NNP,2,1
0,0.0,22,was,14,1,5,4,0,16,13,-9,Ruperto Cadava Kangleón,"March 27 , 1890",PER-PER-PER,TIME-TIME-TIME-TIME,PROPN-PROPN-PROPN,PROPN-NUM-PUNCT-NUM,compound-compound-nsubj,appos-nummod-punct-nummod,NNP-NNP-NNP,"NNP-CD-,-CD",3,1
1,0.0,22,was,14,1,10,9,0,11,13,-4,Ruperto Cadava Kangleón,"February 27 , 1958",PER-PER-PER,TIME-TIME-TIME-TIME,PROPN-PROPN-PROPN,PROPN-NUM-PUNCT-NUM,compound-compound-nsubj,npadvmod-nummod-punct-nummod,NNP-NNP-NNP,"NNP-CD-,-CD",4,1
2,2.0,23,was,1,1,20,19,0,2,0,19,Kangleón,World War II,PER,MISC-MISC-MISC,PROPN,PROPN-PROPN-PROPN,nsubj,compound-compound-pobj,NNP,NNP-NNP-NNP,6,1
3,3.0,24,helped,6,14,23,9,13,0,-8,17,Leyte Landings,1944,MISC-MISC,TIME,PROPN-PROPN,NUM,compound-pobj,pobj,NNP-NNPS,CD,4,1
4,5.0,23,served,7,11,18,7,10,4,-4,11,Philippine,Manuel Roxas,LOC,PER-PER,PROPN,PROPN-PROPN,nmod,compound-pobj,NNP,NNP-NNP,2,1
0,0.0,15,is,2,1,13,12,0,1,1,11,Albert Tatlock,Coronation Street,PER-PER,MISC-MISC,PROPN-PROPN,PROPN-PROPN,compound-nsubj,compound-pobj,NNP-NNP,NNP-NNP,5,1
1,3.0,74,died,25,9,5,-4,8,68,16,-20,Albert,First World War,PER,MISC-MISC-MISC,PROPN,PROPN-PROPN-PROPN,nsubj,compound-compound-pobj,NNP,NNP-NNP-NNP,4,1
2,5.0,38,moved,15,23,36,13,22,1,-8,21,Albert,May 1984,PER,TIME-TIME,PROPN,PROPN-NUM,pobj,pobj-nummod,NNP,NNP-CD,6,1
0,1.0,17,was,1,7,16,9,6,0,-6,15,Jussi Björling,1960,PER-PER,TIME,PROPN-PROPN,NUM,compound-npadvmod,pobj,NNP-NNP,CD,2,1
0,0.0,53,were,20,6,16,10,5,36,14,-4,Evangelika,Athens,MISC,LOC,PROPN,PROPN,appos,pobj,NNP,NNP,3,1
1,0.0,53,were,20,6,18,12,5,34,14,-2,Evangelika,November 1901,MISC,TIME-TIME,PROPN,PROPN-NUM,appos,pobj-nummod,NNP,NNP-CD,5,1
0,0.0,11,is,1,1,8,7,0,2,0,7,Carindale,Queensland,LOC,LOC,PROPN,PROPN,nsubj,conj,NNP,NNP,5,1
1,0.0,11,is,1,1,10,9,0,0,0,9,Carindale,Australia,LOC,LOC,PROPN,PROPN,nsubj,appos,NNP,NNP,1,1
2,0.0,11,is,1,6,8,2,5,2,-5,7,Brisbane,Queensland,LOC,LOC,PROPN,PROPN,pobj,conj,NNP,NNP,3,1
3,0.0,11,is,1,6,10,4,5,0,-5,9,Brisbane,Australia,LOC,LOC,PROPN,PROPN,pobj,appos,NNP,NNP,5,1
4,0.0,11,is,1,8,10,2,7,0,-7,9,Queensland,Australia,LOC,LOC,PROPN,PROPN,conj,appos,NNP,NNP,6,1
0,8.0,35,described,4,20,6,-14,19,28,-16,2,Fumio Kishida,Japan,PER-PER,LOC,PROPN-PROPN,PROPN,compound-nsubj,dobj,NNP-NNP,NNP,3,1
0,0.0,23,is,6,1,5,4,0,17,5,-1,Isidore Mvouba,1954,PER-PER,TIME,PROPN-PROPN,NUM,compound-nsubj,npadvmod,NNP-NNP,CD,1,1
1,0.0,23,is,6,1,16,15,0,6,5,10,Isidore Mvouba,Congo - Brazzaville,PER-PER,LOC-LOC-LOC,PROPN-PROPN,PROPN-PUNCT-PROPN,compound-nsubj,compound-punct-pobj,NNP-NNP,NNP-HYPH-NNP,6,1
0,0.0,14,is,9,1,12,11,0,1,8,3,Lucas Hedges,American,PER-PER,LOC,PROPN-PROPN,ADJ,compound-nsubj,amod,NNP-NNP,JJ,2,1
1,2.0,32,began,1,17,20,3,16,11,-16,19,Moonrise Kingdom,2012,MISC-MISC,TIME,PROPN-PROPN,NUM,compound-appos,appos,NNP-NNP,CD,1,1
2,2.0,32,began,1,26,30,4,25,1,-25,29,Kill the Messenger,2014,MISC-MISC-MISC,TIME,PROPN-DET-PROPN,NUM,appos-det-dobj,appos,NNP-DT-NNP,CD,3,1
3,4.0,45,went,1,1,37,36,0,7,0,36,Hedges,"Three Billboards Outside Ebbing , Missouri",PER,MISC-MISC-MISC-MISC-MISC-MISC,NOUN,NUM-PROPN-PROPN-PROPN-PUNCT-PROPN,nsubj,compound-compound-compound-appos-punct-appos,NNS,"CD-NNPS-NNP-NNP-,-NNP",7,1
4,5.0,51,played,5,5,32,27,4,18,0,27,Hedges,Ben Is Back,PER,MISC-MISC-MISC,PROPN,PROPN-VERB-ADV,nsubj,nsubj-ROOT-advmod,NNP,NNP-VBZ-RB,1,1
0,0.0,16,was,2,1,5,4,0,10,1,3,Monster House,Australian,MISC-MISC,LOC,PROPN-PROPN,ADJ,compound-nsubj,amod,NNP-NNP,JJ,4,1
1,0.0,16,was,2,1,14,13,0,1,1,12,Monster House,Nine Network,MISC-MISC,ORG-ORG,PROPN-PROPN,PROPN-PROPN,compound-nsubj,compound-pobj,NNP-NNP,NNP-NNP,5,1
2,1.0,21,hosted,9,17,19,2,16,1,-8,10,Stephen,Andrew Curry,PER,PER-PER,PROPN,PROPN-PROPN,pobj,compound-conj,NNP,NNP-NNP,2,1
0,3.0,31,was,3,1,24,23,0,6,2,21,Honold,Stuttgart,PER,LOC,PROPN,PROPN,poss,compound,NNP,NNP,6,1
1,12.0,9,died,1,1,4,3,0,4,0,3,Honold,Stuttgart,PER,LOC,PROPN,PROPN,nsubj,pobj,NNP,NNP,1,1
0,0.0,24,is,8,1,5,4,0,18,7,-3,Umberto Smaila,26 June 1950,PER-PER,TIME-TIME-TIME,PROPN-PROPN,NUM-PROPN-NUM,compound-nsubj,nummod-npadvmod-nummod,NNP-NNP,CD-NNP-CD,2,1
1,0.0,24,is,8,1,11,10,0,12,7,3,Umberto Smaila,Italian,PER-PER,LOC,PROPN-PROPN,ADJ,compound-nsubj,amod,NNP-NNP,JJ,2,1
2,5.0,52,ragazzo,23,15,20,5,14,31,8,-3,Beast with a Gun,1977,MISC-MISC-MISC-MISC,TIME,PROPN-ADP-DET-PROPN,NUM,pobj-prep-det-pobj,appos,NNP-IN-DT-NNP,CD,2,1
3,5.0,52,ragazzo,23,23,29,6,22,22,0,6,Il ragazzo del pony express,1986,MISC-MISC-MISC-MISC-MISC,TIME,PROPN-VERB-NOUN-NOUN-NOUN,NUM,nsubj-ROOT-compound-compound-dobj,npadvmod,NNP-VBZ-NN-NN-NN,CD,2,1
4,5.0,52,ragazzo,23,32,37,5,31,14,-9,14,Sweets from a Stranger,1987,MISC-MISC-MISC-MISC,TIME,PROPN-ADP-DET-PROPN,NUM,dobj-prep-det-pobj,appos,NNPS-IN-DT-NNP,CD,2,1
5,5.0,52,ragazzo,23,40,44,4,39,7,-17,21,Delitti e profumi,1988,MISC-MISC-MISC,TIME,PROPN-NOUN-NOUN,NUM,compound-compound-conj,appos,NNP-NN-NN,CD,2,1
6,5.0,52,ragazzo,23,47,50,3,46,1,-24,27,Chicken Park,1994,MISC-MISC,TIME,PROPN-PROPN,NUM,compound-conj,appos,NNP-NNP,CD,1,1
0,0.0,25,is,8,1,11,10,0,13,7,3,Green Street,2005,MISC-MISC,TIME,PROPN-PROPN,NUM,compound-nsubj,nummod,NNP-NNP,CD,4,1
1,0.0,25,is,8,1,23,22,0,1,7,15,Green Street Hooligans,United Kingdom,MISC-MISC-MISC,LOC-LOC,PROPN-PROPN-PROPN,PROPN-PROPN,compound-compound-conj,compound-pobj,NNP-NNP-NNPS,NNP-NNP,4,1
0,0.0,18,is,5,14,16,2,13,1,-9,11,Seoul,South Korea,LOC,LOC-LOC,PROPN,PROPN-PROPN,pobj,compound-appos,NNP,NNP-NNP,2,1
0,0.0,57,is,21,1,5,4,0,51,20,-16,Brian Wecht,"April 22 , 1975",PER-PER,TIME-TIME-TIME-TIME,PROPN-PROPN,PROPN-NUM-PUNCT-NUM,compound-nsubj,npadvmod-nummod-punct-nummod,NNP-NNP,"NNP-CD-,-CD",3,1
1,1.0,50,known,3,28,48,20,27,1,-25,45,Starbomb,Dan Avidan,ORG,PER-PER,PROPN,PROPN-PROPN,appos,compound-pobj,NNP,NNP-NNP,4,1
0,0.0,25,is,2,1,5,4,0,19,1,3,Amy Grant,American,PER-PER,LOC,PROPN-PROPN,ADJ,compound-nsubj,amod,NNP-NNP,JJ,3,1
1,5.0,48,included,37,28,30,2,27,17,9,-7,Unguarded,Heart in Motion,MISC,MISC-MISC-MISC,VERB,PROPN-ADP-PROPN,appos,conj-prep-pobj,VBN,NNP-IN-NNP,3,1
0,0.0,31,is,7,1,28,27,0,2,6,21,Insomniac 's Guide to a Lonely Heart,44th Floor Records,MISC-MISC-MISC-MISC-MISC-MISC-MISC,ORG-ORG-ORG,PROPN-PART-PROPN-ADP-DET-PROPN-PROPN,NOUN-PROPN-PROPN,poss-case-nsubj-prep-det-amod-pobj,amod-compound-pobj,NNP-POS-NNP-IN-DT-NNP-NNP,NN-NNP-NNPS,8,1
1,0.0,31,is,7,16,28,12,15,2,-9,21,Ben Bledsoe,44th Floor Records,PER-PER,ORG-ORG-ORG,PROPN-PROPN,NOUN-PROPN-PROPN,compound-pobj,amod-compound-pobj,NNP-NNP,NN-NNP-NNPS,6,1
0,0.0,10,is,3,1,6,5,0,3,2,3,Paul H. Crane,American,PER-PER-PER,LOC,PROPN-PROPN-PROPN,ADJ,compound-compound-nsubj,amod,NNP-NNP-NNP,JJ,3,1
0,0.0,12,is,4,1,10,9,0,1,3,6,Sino Group,Hong Kong,ORG-ORG,LOC-LOC,ADJ-PROPN,PROPN-PROPN,amod-nsubj,compound-pobj,JJ-NNP,NNP-NNP,4,1
0,0.0,21,is,3,1,12,11,0,8,2,9,Night Over Water,Ken Follett,MISC-MISC-MISC,PER-PER,PROPN-PROPN-PROPN,PROPN-PROPN,nsubj-prep-pobj,compound-pobj,NNP-NNP-NNP,NNP-NNP,6,1
1,0.0,21,is,3,1,17,16,0,3,2,14,Night Over Water,William Morrow,MISC-MISC-MISC,ORG-ORG,PROPN-PROPN-PROPN,PROPN-PROPN,nsubj-prep-pobj,compound-pobj,NNP-NNP-NNP,NNP-NNP,7,1
2,0.0,21,is,3,1,20,19,0,0,2,17,Night Over Water,1991,MISC-MISC-MISC,TIME,PROPN-PROPN-PROPN,NUM,nsubj-prep-pobj,pobj,NNP-NNP-NNP,CD,3,1
3,5.0,52,was,1,7,24,17,6,27,-6,23,Atlantic Ocean,Ireland,LOC-LOC,LOC,PROPN-PROPN,PROPN,compound-dobj,conj,NNP-NNP,NNP,7,1
4,5.0,52,was,1,7,37,30,6,14,-6,36,Atlantic Ocean,Canada,LOC-LOC,LOC,PROPN-PROPN,PROPN,compound-dobj,appos,NNP-NNP,NNP,2,1
5,5.0,52,was,1,19,24,5,18,27,-18,23,Shannon Estuary,Ireland,LOC-LOC,LOC,PROPN-PROPN,PROPN,compound-pobj,conj,NNP-NNP,NNP,6,1
6,5.0,52,was,1,22,24,2,21,27,-21,23,Foynes,Ireland,LOC,LOC,PROPN,PROPN,pobj,conj,NNP,NNP,3,1
7,5.0,52,was,1,26,37,11,25,14,-25,36,Bay of Exploits,Canada,LOC-LOC-LOC,LOC,PROPN-ADP-PROPN,PROPN,conj-prep-pobj,appos,NNP-IN-NNP,NNP,8,1
8,5.0,52,was,1,30,37,7,29,14,-29,36,Botwood,Canada,LOC,LOC,PROPN,PROPN,pobj,appos,NNP,NNP,10,1
9,5.0,52,was,1,32,37,5,31,14,-31,36,Newfoundland,Canada,LOC,LOC,PROPN,PROPN,conj,appos,NNP,NNP,11,1
10,5.0,52,was,1,34,37,3,33,14,-33,36,Shediac Bay,Canada,LOC-LOC,LOC,PROPN-PROPN,PROPN,compound-conj,appos,NNP-NNP,NNP,11,1
0,10.0,15,published,3,12,14,2,11,0,-9,11,Västerås,Sweden,LOC,LOC,PROPN,PROPN,pobj,npadvmod,NNP,NNP,7,1
0,2.0,23,appeared,2,17,21,4,16,1,-15,19,Breaking Glass,Hazel O'Connor,MISC-MISC,PER-PER,PROPN-PROPN,PROPN-PROPN,compound-appos,compound-pobj,NNP-NNP,NNP-NNP,5,1
1,3.0,8,born,2,1,5,4,0,2,1,3,Tibbs,Northwood,PER,LOC,PROPN,PROPN,nsubjpass,pobj,NNP,NNP,4,1
2,3.0,8,born,2,5,7,2,4,0,-3,5,Northwood,London,LOC,LOC,PROPN,PROPN,pobj,appos,NNP,NNP,4,1
3,4.0,31,was,1,28,6,-22,27,24,-27,5,Ant Rap,Adam and the Ants,MISC-MISC,ORG-ORG-ORG-ORG,PROPN-PROPN,PROPN-CCONJ-DET-PROPN,compound-dobj,pobj-cc-det-conj,NNP-NNP,NNP-CC-DT-NNPS,6,1
0,0.0,15,is,2,1,7,6,0,7,1,5,Obliteration Pie,Robyn Hitchcock,MISC-MISC,PER-PER,PROPN-PROPN,PROPN-PROPN,compound-nsubj,compound-pobj,NNP-NNP,NNP-NNP,4,1
1,0.0,15,is,2,1,14,13,0,0,1,12,Obliteration Pie,2005,MISC-MISC,TIME,PROPN-PROPN,NUM,compound-nsubj,pobj,NNP-NNP,CD,2,1
2,2.0,32,includes,2,13,8,-5,12,23,-11,6,Funkytown,Lipps Inc.,MISC,ORG-ORG,PROPN,PROPN-PROPN,pobj,compound-compound,NNP,NNP-NNP,3,1
3,3.0,60,is,1,22,30,8,21,29,-21,29,I Often Dream Of Trains,The Man With The Lightbulb Head,MISC-MISC-MISC-MISC-MISC,MISC-MISC-MISC-MISC-MISC-MISC,PRON-ADV-PROPN-ADP-NOUN,DET-NOUN-ADP-DET-PROPN-PROPN,compound-compound-pobj-prep-pobj,det-conj-prep-det-compound-pobj,PRP-RB-NNP-IN-NNS,DT-NN-IN-DT-NNP-NNP,2,1
4,3.0,60,is,1,22,5,-17,21,54,-21,4,I Often Dream Of Trains,Hitchcock,MISC-MISC-MISC-MISC-MISC,PER,PRON-ADV-PROPN-ADP-NOUN,PROPN,compound-compound-pobj-prep-pobj,compound,PRP-RB-NNP-IN-NNS,NNP,5,1
0,0.0,39,is,3,1,36,35,0,2,2,33,Pymatuning State Park,the United States,LOC-LOC-LOC,LOC-LOC-LOC,VERB-PROPN-PROPN,DET-PROPN-PROPN,compound-compound-nsubj,det-compound-pobj,VBG-NNP-NNP,DT-NNP-NNP,6,1
1,0.0,39,is,3,11,30,19,10,8,-8,27,Conneaut,Crawford County,LOC,LOC-LOC,PROPN,PROPN-PROPN,pobj,compound-conj,NNP,NNP-NNP,8,1
2,0.0,39,is,3,13,30,17,12,8,-10,27,North Shenango,Crawford County,LOC-LOC,LOC-LOC,PROPN-PROPN,PROPN-PROPN,compound-conj,compound-conj,NNP-NNP,NNP-NNP,6,1
3,0.0,39,is,3,16,30,14,15,8,-13,27,Pine,Crawford County,LOC,LOC-LOC,PROPN,PROPN-PROPN,conj,compound-conj,NNP,NNP-NNP,6,1
4,0.0,39,is,3,18,30,12,17,8,-15,27,Sadsbury,Crawford County,LOC,LOC-LOC,PROPN,PROPN-PROPN,conj,compound-conj,NNP,NNP-NNP,5,1
5,0.0,39,is,3,20,30,10,19,8,-17,27,South Shenango,Crawford County,LOC-LOC,LOC-LOC,PROPN-PROPN,PROPN-PROPN,compound-conj,compound-conj,NNP-NNP,NNP-NNP,3,1
6,0.0,39,is,3,23,30,7,22,8,-20,27,West Fallowfield,Crawford County,LOC-LOC,LOC-LOC,PROPN-PROPN,PROPN-PROPN,compound-conj,compound-conj,NNP-NNP,NNP-NNP,2,1
0,1.0,26,was,1,19,25,6,18,0,-18,24,Edward I,England,PER-PER,LOC,PROPN-PROPN,PROPN,compound-pobj,pobj,NNP-NNP,NNP,6,1
1,1.0,26,was,1,19,25,6,18,0,-18,24,Edward II,England,PER-PER,LOC,PROPN-PROPN,PROPN,compound-conj,pobj,NNP-NNP,NNP,6,1
2,5.0,35,used,1,15,18,3,14,16,-14,17,Philip IV,France,PER-PER,LOC,PROPN-PROPN,PROPN,compound-conj,pobj,NNP-NNP,NNP,6,1
0,2.0,102,distributed,44,47,49,2,46,52,-3,5,Disney,Touchstone Pictures,ORG,ORG-ORG,PROPN,PROPN-PROPN,poss,compound-pobj,NNP,NNP-NNPS,2,1
0,0.0,20,is,2,1,19,18,0,0,1,17,La Bufadora,Mexico,LOC-LOC,LOC,PROPN-PROPN,PROPN,compound-nsubj,appos,NNP-NNP,NNP,2,1
1,7.0,18,See,0,4,17,13,3,0,-4,17,La Bufadora,Mexico,LOC-LOC,LOC,PROPN-PROPN,PROPN,compound-npadvmod,compound,NNP-NNP,NNP,3,1
2,0.0,20,is,2,12,17,5,11,2,-10,15,Punta Banda Peninsula,California,LOC-LOC-LOC,LOC,PROPN-PROPN-PROPN,PROPN,compound-compound-pobj,pobj,NNP-NNP-NNP,NNP,3,1
3,0.0,20,is,2,12,19,7,11,0,-10,17,Punta Banda Peninsula,Mexico,LOC-LOC-LOC,LOC,PROPN-PROPN-PROPN,PROPN,compound-compound-pobj,appos,NNP-NNP-NNP,NNP,6,1
4,0.0,20,is,2,16,19,3,15,0,-14,17,Baja,Mexico,LOC,LOC,PROPN,PROPN,compound,appos,NNP,NNP,6,1
5,7.0,18,See,0,17,13,-4,16,4,-17,13,Mexico,Baja California Sur,LOC,LOC-LOC-LOC,PROPN,PROPN-PROPN-PROPN,compound,compound-compound-conj,NNP,NNP-NNP-NNP,3,1
6,8.0,15,See,0,15,11,-4,14,3,-15,11,Mexico,Baja California Sur,LOC,LOC-LOC-LOC,PROPN,PROPN-PROPN-PROPN,npadvmod,compound-compound-conj,NNP,NNP-NNP-NNP,-1,1
0,0.0,20,located,4,1,18,17,0,1,3,14,Mayland Community College,Spruce Pine,ORG-ORG-ORG,LOC-LOC,PROPN-PROPN-PROPN,PROPN-PROPN,compound-compound-nsubjpass,compound-pobj,NNP-NNP-NNP,NNP-NNP,6,1
1,4.0,40,chartered,5,1,12,11,0,27,4,7,Mayland Community College,February 1970,ORG-ORG-ORG,TIME-TIME,PROPN-PROPN-PROPN,PROPN-NUM,compound-compound-nsubjpass,pobj-nummod,NNP-NNP-NNP,NNP-CD,5,1
0,0.0,18,(;,2,1,13,12,0,4,1,11,Rena Dor,Greek,PER-PER,LOC,PROPN-PROPN,ADJ,compound-nsubj,amod,NNP-NNP,JJ,3,1
0,0.0,20,Theatre,2,2,19,17,1,0,0,17,Aarhus,Denmark,LOC,LOC,PROPN,PROPN,pobj,pobj,NNP,NNP,2,1
1,3.0,26,designed,4,10,13,3,9,12,-6,9,Hack Kampmann,1856,PER-PER,TIME,PROPN-PROPN,NUM,compound-appos,nummod,NNP-NNP,CD,2,1
2,3.0,26,designed,4,10,15,5,9,10,-6,11,Hack Kampmann,1920,PER-PER,TIME,PROPN-PROPN,NUM,compound-appos,nummod,NNP-NNP,CD,1,1
3,4.0,17,stood,7,6,14,8,5,2,1,7,Aarhus Theatre,15 September 1900,LOC-LOC,TIME-TIME-TIME,PROPN-PROPN,NUM-PROPN-NUM,compound-nsubj,nummod-pobj-nummod,NNP-NNP,CD-NNP-CD,4,1
0,0.0,44,"""",0,2,19,17,1,24,-2,19,Good Times,1967,MISC-MISC,TIME,PROPN-PROPN,NUM,compound-nsubj,nummod,NNP-NNP,CD,7,1
1,0.0,44,"""",0,2,21,19,1,22,-2,21,Good Times,Winds of Change,MISC-MISC,MISC-MISC-MISC,PROPN-PROPN,PROPN-ADP-PROPN,compound-nsubj,appos-prep-pobj,NNP-NNP,NNP-IN-NNP,7,1
2,0.0,44,"""",0,21,10,-11,20,33,-21,10,Winds of Change,Eric Burdon,MISC-MISC-MISC,PER-PER,PROPN-ADP-PROPN,PROPN-PROPN,appos-prep-pobj,compound-pobj,NNP-IN-NNP,NNP-NNP,6,1
3,6.0,28,side,3,21,26,5,20,1,-18,23,Stranger in the House,1967,MISC-MISC-MISC-MISC,TIME,PROPN-ADP-DET-PROPN,NUM,appos-prep-det-pobj,appos,NNP-IN-DT-NNP,CD,4,1
4,8.0,24,released,4,19,22,3,18,1,-15,18,Die Katze,Götz George,PER-PER,PER-PER,PROPN-PROPN,PROPN-PROPN,compound-appos,compound-dobj,NNP-NNP,NNP-NNP,3,1
5,11.0,27,featured,3,11,19,8,10,7,-8,16,The Official Live Bootleg # 2,2000,MISC-MISC-MISC-MISC-MISC-MISC,TIME,DET-ADJ-PROPN-PROPN-SYM-NUM,NUM,det-amod-compound-compound-nmod-nummod,appos,DT-JJ-NNP-NNP-$-CD,CD,6,1
0,0.0,17,is,8,1,5,4,0,11,7,-3,Declan Bennett,20 March 1981,PER-PER,TIME-TIME-TIME,PROPN-PROPN,NUM-PROPN-NUM,compound-nsubj,nummod-npadvmod-nummod,NNP-NNP,CD-NNP-CD,2,1
1,2.0,54,was,4,45,39,-6,44,14,-41,35,Broadway,UK,LOC,LOC,PROPN,PROPN,pobj,compound,NNP,NNP,3,1
2,2.0,54,was,4,50,39,-11,49,14,-46,35,Phoenix Theatre,UK,LOC-LOC,LOC,PROPN-PROPN,PROPN,compound-pobj,compound,NNP-NNP,NNP,4,1
3,2.0,54,was,4,25,39,14,24,14,-21,35,London,UK,LOC,LOC,PROPN,PROPN,pobj,compound,NNP,NNP,11,1
4,3.0,45,joined,5,7,23,16,6,21,-2,18,EastEnders,June Brown,LOC,PER-PER,PROPN,PROPN-PROPN,dobj,compound-appos,NNP,NNP-NNP,6,1
5,4.0,25,took,5,11,11,0,10,13,-6,6,Jesus,Jesus Christ Superstar,PER,MISC-MISC-MISC,PROPN,PROPN-PROPN-PROPN,pobj,compound-compound-pobj,NNP,NNP-NNP-NNP,0,1
0,0.0,22,is,1,14,15,1,13,6,-13,14,Downtown Seattle Transit Tunnel,Seattle,LOC-LOC-LOC-LOC,LOC,PROPN-PROPN-PROPN-PROPN,PROPN,compound-compound-compound-pobj,pobj,NNP-NNP-NNP-NNP,NNP,2,1
1,2.0,31,served,2,6,11,5,5,19,-4,9,Central Link,Sound Transit,LOC-LOC,ORG-ORG,PROPN-PROPN,PROPN-PROPN,compound-pobj,compound-poss,NNP-NNP,NNP-NNP,4,1
0,0.0,41,is,7,1,6,5,0,34,6,-1,Harvey Phillip Pratt,1941,PER-PER-PER,TIME,PROPN-PROPN-PROPN,NUM,compound-compound-nsubj,npadvmod,NNP-NNP-NNP,CD,3,1
1,4.0,31,teamed,6,17,20,3,16,10,-11,14,Hoopa Reservation,California,LOC-LOC,LOC,PROPN-PROPN,PROPN,compound-pobj,pobj,NNP-NNP,NNP,3,1
0,0.0,33,fought,19,15,31,16,14,1,4,12,Operation Sunshine,World War I.,MISC-MISC,MISC-MISC-MISC,PROPN-PROPN,PROPN-PROPN-PROPN,compound-appos,compound-compound-pobj,NNP-NNP,NNP-NNP-NNP,8,1
1,0.0,33,fought,19,5,29,24,4,3,14,10,Dernancourt,France,LOC,LOC,PROPN,PROPN,pobj,pobj,NNP,NNP,3,1
0,0.0,27,is,3,2,6,4,1,20,1,3,Rocket Post,2004,MISC-MISC,TIME,PROPN-PROPN,NUM,compound-nsubj,nummod,NNP-NNP,CD,3,1
1,0.0,27,is,3,2,12,10,1,14,1,9,Rocket Post,Stephen Whittaker,MISC-MISC,PER-PER,PROPN-PROPN,PROPN-PROPN,compound-nsubj,compound-pobj,NNP-NNP,NNP-NNP,5,1
2,0.0,27,is,3,2,16,14,1,10,1,13,Rocket Post,Ulrich Thomsen,MISC-MISC,PER-PER,PROPN-PROPN,PROPN-PROPN,compound-nsubj,compound-dobj,NNP-NNP,NNP-NNP,5,1
3,0.0,27,is,3,2,19,17,1,7,1,16,Rocket Post,Shauna Macdonald,MISC-MISC,PER-PER,PROPN-PROPN,PROPN-PROPN,compound-nsubj,compound-conj,NNP-NNP,NNP-NNP,6,1
4,0.0,27,is,3,2,22,20,1,4,1,19,Rocket Post,Kevin McKidd,MISC-MISC,PER-PER,PROPN-PROPN,PROPN-PROPN,compound-nsubj,compound-conj,NNP-NNP,NNP-NNP,7,1
5,0.0,27,is,3,2,25,23,1,1,1,22,Rocket Post,Patrick Malahide,MISC-MISC,PER-PER,PROPN-PROPN,PROPN-PROPN,compound-nsubj,compound-conj,NNP-NNP,NNP-NNP,8,1
6,6.0,26,formed,6,18,12,-6,17,13,-12,6,Rocket Post,2001,MISC-MISC,TIME,PROPN-PROPN,NUM,compound-oprd,nummod,NNP-NNP,CD,5,1
0,0.0,20,Hubbard,1,1,4,3,0,15,0,3,Lucien Hubbard,"December 22 , 1888",PER-PER,TIME-TIME-TIME-TIME,PROPN-PROPN,PROPN-NUM-PUNCT-NUM,compound-ROOT,appos-nummod-punct-npadvmod,NNP-NNP,"NNP-CD-,-CD",2,1
1,0.0,20,Hubbard,1,1,4,3,0,15,0,3,Lucien Hubbard,"December 31 , 1971",PER-PER,TIME-TIME-TIME-TIME,PROPN-PROPN,PROPN-NUM-PUNCT-NUM,compound-ROOT,nsubj-nummod-punct-nummod,NNP-NNP,"NNP-CD-,-CD",2,1
0,0.0,24,was,4,1,14,13,0,9,3,10,John J. Pershing College,1966,ORG-ORG-ORG-ORG,TIME,PROPN-PROPN-PROPN-PROPN,NUM,compound-compound-compound-nsubj,pobj,NNP-NNP-NNP-NNP,CD,6,1
1,0.0,24,was,4,1,20,19,0,3,3,16,John J. Pershing College,Nebraska,ORG-ORG-ORG-ORG,LOC,PROPN-PROPN-PROPN-PROPN,PROPN,compound-compound-compound-nsubj,conj,NNP-NNP-NNP-NNP,NNP,8,1
2,0.0,24,was,4,1,22,21,0,1,3,18,John J. Pershing College,United States,ORG-ORG-ORG-ORG,LOC-LOC,PROPN-PROPN-PROPN-PROPN,PROPN-PROPN,compound-compound-compound-nsubj,compound-appos,NNP-NNP-NNP-NNP,NNP-NNP,7,1
3,0.0,24,was,4,18,22,4,17,1,-14,18,Beatrice,United States,LOC,LOC-LOC,PROPN,PROPN-PROPN,pobj,compound-appos,NNP,NNP-NNP,2,1
4,0.0,24,was,4,20,22,2,19,1,-16,18,Nebraska,United States,LOC,LOC-LOC,PROPN,PROPN-PROPN,conj,compound-appos,NNP,NNP-NNP,3,1
5,1.0,25,was,1,19,24,5,18,0,-18,23,Parsons College,Iowa,ORG-ORG,LOC,PROPN-PROPN,PROPN,compound-pobj,appos,NNPS-NNP,NNP,9,1
0,0.0,18,is,8,1,5,4,0,12,7,-3,Walter Kohl,16 July 1963,PER-PER,TIME-TIME-TIME,PROPN-PROPN,NUM-PROPN-NUM,compound-nsubj,nummod-npadvmod-nummod,NNP-NNP,CD-NNP-CD,2,1
1,1.0,26,is,1,14,17,3,13,8,-13,16,Helmut Kohl,Hannelore Kohl,PER-PER,PER-PER,PROPN-PROPN,PROPN-PROPN,compound-pobj,compound-conj,NNP-NNP,NNP-NNP,1,1
2,1.0,26,is,1,14,24,10,13,1,-13,23,Helmut Kohl,Peter Kohl,PER-PER,PER-PER,PROPN-PROPN,PROPN-PROPN,compound-pobj,compound-pobj,NNP-NNP,NNP-NNP,7,1
3,1.0,26,is,1,17,24,7,16,1,-16,23,Hannelore Kohl,Peter Kohl,PER-PER,PER-PER,PROPN-PROPN,PROPN-PROPN,compound-conj,compound-pobj,NNP-NNP,NNP-NNP,8,1
4,9.0,12,obtained,4,9,11,2,8,0,-5,7,INSEAD,France,ORG,LOC,PROPN,PROPN,pobj,pobj,NNP,NNP,2,1
0,0.0,19,was,14,1,5,4,0,13,13,-9,Gaynelle Griffin Jones,"November 20 , 1948",PER-PER-PER,TIME-TIME-TIME-TIME,PROPN-PROPN-PROPN,PROPN-NUM-PUNCT-NUM,compound-compound-nsubj,appos-nummod-punct-nummod,NNP-NNP-NNP,"NNP-CD-,-CD",3,1
1,0.0,19,was,14,1,10,9,0,8,13,-4,Gaynelle Griffin Jones,"March 1 , 2013",PER-PER-PER,TIME-TIME-TIME-TIME,PROPN-PROPN-PROPN,PROPN-NUM-PUNCT-NUM,compound-compound-nsubj,npadvmod-nummod-punct-nummod,NNP-NNP-NNP,"NNP-CD-,-CD",3,1
2,1.0,25,received,7,7,3,-4,6,21,0,-4,Jones,Dallas,PER,LOC,PROPN,PROPN,nsubj,pobj,NNP,NNP,4,1
3,1.0,25,received,7,7,14,7,6,10,0,7,Jones,Emerson College,PER,ORG-ORG,PROPN,PROPN-PROPN,nsubj,compound-pobj,NNP,NNP-NNP,2,1
4,1.0,25,received,7,7,21,14,6,3,0,14,Jones,Boston College Law School,PER,ORG-ORG-ORG-ORG,PROPN,PROPN-PROPN-PROPN-PROPN,nsubj,compound-compound-compound-pobj,NNP,NNP-NNP-NNP-NNP,7,1
5,2.0,19,appointed,6,10,18,8,9,0,-4,12,United States,Texas,LOC-LOC,LOC,PROPN-PROPN,PROPN,compound-compound,pobj,NNP-NNP,NNP,4,1
6,2.0,19,appointed,6,10,5,-5,9,13,-4,-1,United States,Bill Clinton,LOC-LOC,PER-PER,PROPN-PROPN,PROPN-PROPN,compound-compound,compound-nsubj,NNP-NNP,NNP-NNP,4,1
0,0.0,20,is,2,9,18,9,8,1,-7,16,SiN,Ritual Entertainment,MISC,ORG-ORG,PROPN,PROPN-PROPN,nmod,compound-pobj,NNP,NNP-NNP,4,1
1,3.0,20,is,1,1,14,13,0,5,0,13,Elexis,ADV Films,PER,ORG-ORG,PROPN,PROPN-PROPN,nsubj,compound-pobj,NNP,NNP-NNPS,4,1
0,6.0,45,was,12,25,32,7,24,12,-13,20,East Asian,Japan,LOC-LOC,LOC,ADJ-ADJ,PROPN,amod-amod,conj,JJ-JJ,NNP,3,1
0,0.0,16,is,10,1,13,12,0,2,9,3,Robert Charles Gallo,American,PER-PER-PER,LOC,PROPN-PROPN-PROPN,ADJ,compound-compound-compound,amod,NNP-NNP-NNP,JJ,5,1
0,0.0,52,is,7,20,22,2,19,29,-13,15,Hillsdale,Bergen County,LOC,LOC-LOC,PROPN,PROPN-PROPN,pobj,compound-pobj,NNP,NNP-NNP,1,1
1,0.0,52,is,7,20,28,8,19,23,-13,21,Hillsdale,United States,LOC,LOC-LOC,PROPN,PROPN-PROPN,pobj,compound-conj,NNP,NNP-NNP,3,1
2,0.0,52,is,7,22,25,3,21,26,-15,18,Bergen County,New Jersey,LOC-LOC,LOC-LOC,PROPN-PROPN,PROPN-PROPN,compound-pobj,compound-conj,NNP-NNP,NNP-NNP,1,1
3,0.0,52,is,7,22,28,6,21,23,-15,21,Bergen County,United States,LOC-LOC,LOC-LOC,PROPN-PROPN,PROPN-PROPN,compound-pobj,compound-conj,NNP-NNP,NNP-NNP,2,1
4,0.0,52,is,7,25,28,3,24,23,-18,21,New Jersey,United States,LOC-LOC,LOC-LOC,PROPN-PROPN,PROPN-PROPN,compound-conj,compound-conj,NNP-NNP,NNP-NNP,1,1
0,0.0,20,is,1,1,8,7,0,11,0,7,Sonnet,The Verve,MISC,ORG-ORG,NOUN,DET-PROPN,nsubj,det-pobj,NN,DT-NNP,1,1
1,0.0,20,is,1,1,18,17,0,1,0,17,Sonnet,Urban Hymns,MISC,MISC-MISC,NOUN,PROPN-PROPN,nsubj,compound-appos,NN,NNP-NNP,4,1
0,0.0,31,is,5,2,17,15,1,13,3,12,Brazoria National Wildlife Refuge,USA,LOC-LOC-LOC-LOC,LOC,PROPN-PROPN-PROPN-PROPN,PROPN,compound-compound-compound-nsubj,appos,NNP-NNP-NNP-NNP,NNP,8,1
1,6.0,31,refuges,3,12,7,-5,11,23,-9,4,San Bernard,Texas,LOC-LOC,LOC,PROPN-PROPN,PROPN,compound-conj,compound,NNP-NNP,NNP,2,1
2,6.0,31,refuges,3,15,7,-8,14,23,-12,4,Big Boggy,Texas,LOC-LOC,LOC,PROPN-PROPN,PROPN,compound-compound,compound,NNP-NNP,NNP,3,1
0,0.0,17,was,2,1,10,9,0,6,1,8,FBOP Corporation,Oak Park,ORG-ORG,LOC-LOC,PROPN-PROPN,PROPN-PROPN,compound-nsubj,compound-pobj,NNP-NNP,NNP-NNP,5,1
1,0.0,17,was,2,10,15,5,9,1,-8,13,Oak Park,United States,LOC-LOC,LOC-LOC,PROPN-PROPN,PROPN-PROPN,compound-pobj,compound-conj,NNP-NNP,NNP-NNP,1,1
2,0.0,17,was,2,13,15,2,12,1,-11,13,Illinois,United States,LOC,LOC-LOC,PROPN,PROPN-PROPN,conj,compound-conj,NNP,NNP-NNP,3,1
0,0.0,27,was,11,1,4,3,0,22,10,-7,Ugochuku Ehiogu,3 November 1972,PER-PER,TIME-TIME-TIME,PROPN-PROPN,NUM-PROPN-NUM,amod-compound,nummod-npadvmod-nummod,NNP-NNP,CD-NNP-CD,2,1
1,8.0,18,died,1,1,13,12,0,4,0,12,Ehiogu,Tottenham Hotspur,PER,ORG-ORG,PROPN,PROPN-PROPN,nsubj,compound-poss,NNP,NNP-NNP,6,1
0,3.0,14,Meyer,1,1,8,7,0,5,0,7,Joseph Meyer,1941,PER-PER,TIME,PROPN-PROPN,NUM,compound-ROOT,nummod,NNP-NNP,CD,2,1
1,3.0,14,Meyer,1,1,10,9,0,3,0,9,Joseph Meyer,2012,PER-PER,TIME,PROPN-PROPN,NUM,compound-ROOT,nummod,NNP-NNP,CD,1,1
2,4.0,15,Meyer,2,1,6,5,0,8,1,4,Joseph A. Meyer,1895,PER-PER-PER,TIME,PROPN-NOUN-PROPN,NUM,compound-compound-ROOT,nummod,NNP-NN-NNP,CD,3,1
3,4.0,15,Meyer,2,1,8,7,0,6,1,6,Joseph A. Meyer,1970,PER-PER-PER,TIME,PROPN-NOUN-PROPN,NUM,compound-compound-ROOT,nummod,NNP-NN-NNP,CD,3,1
4,5.0,11,Meyer,2,1,5,4,0,5,1,3,Joseph E. Meyer,1878,PER-PER-PER,TIME,PROPN-PROPN-PROPN,NUM,compound-compound-ROOT,nummod,NNP-NNP-NNP,CD,3,1
5,5.0,11,Meyer,2,1,7,6,0,3,1,5,Joseph E. Meyer,1950,PER-PER-PER,TIME,PROPN-PROPN-PROPN,NUM,compound-compound-ROOT,nummod,NNP-NNP-NNP,CD,2,1
6,6.0,15,Meyer,1,1,8,7,0,6,0,7,Joey Meyer,1949,PER-PER,TIME,PROPN-PROPN,NUM,compound-ROOT,npadvmod,NNP-NNP,CD,2,1
0,0.0,50,was,14,1,5,4,0,44,13,-9,Thomas E. Corcoran,"October 12 , 1839",PER-PER-PER,TIME-TIME-TIME-TIME,PROPN-PROPN-PROPN,PROPN-NUM-PUNCT-NUM,compound-compound-nsubj,appos-nummod-punct-nummod,NNP-NNP-NNP,"NNP-CD-,-CD",3,1
1,0.0,50,was,14,1,10,9,0,39,13,-4,Thomas E. Corcoran,"March 12 , 1904",PER-PER-PER,TIME-TIME-TIME-TIME,PROPN-PROPN-PROPN,PROPN-NUM-PUNCT-NUM,compound-compound-nsubj,appos-nummod-punct-nummod,NNP-NNP-NNP,"NNP-CD-,-CD",3,1
2,0.0,50,was,14,1,17,16,0,32,13,3,Thomas E. Corcoran,Union Navy,PER-PER-PER,ORG-ORG,PROPN-PROPN-PROPN,PROPN-PROPN,compound-compound-nsubj,compound-compound,NNP-NNP-NNP,NNP-NNP,4,1
3,0.0,50,was,14,1,21,20,0,28,13,7,Thomas E. Corcoran,the United States,PER-PER-PER,LOC-LOC-LOC,PROPN-PROPN-PROPN,DET-PROPN-PROPN,compound-compound-nsubj,det-compound-compound,NNP-NNP-NNP,DT-NNP-NNP,6,1
4,0.0,50,was,14,17,21,4,16,28,-3,7,Union Navy,the American Civil War,ORG-ORG,MISC-MISC-MISC-MISC,PROPN-PROPN,DET-PROPN-PROPN-PROPN,compound-compound,det-compound-compound-pobj,NNP-NNP,DT-NNP-NNP-NNP,4,1
5,0.0,50,was,14,21,21,0,20,28,-7,7,the American Civil War,the United States,MISC-MISC-MISC-MISC,LOC-LOC-LOC,DET-PROPN-PROPN-PROPN,DET-PROPN-PROPN,det-compound-compound-pobj,det-compound-compound,DT-NNP-NNP-NNP,DT-NNP-NNP,0,1
0,0.0,22,is,4,1,11,10,0,10,3,7,Donaldson Air Force Base,United States Air Force,LOC-LOC-LOC-LOC,ORG-ORG-ORG-ORG,PROPN-PROPN-PROPN-PROPN,PROPN-PROPN-PROPN-PROPN,compound-compound-compound-nsubj,compound-compound-compound-pobj,NNP-NNP-NNP-NNP,NNP-NNP-NNP-NNP,7,1
1,0.0,22,is,4,1,20,19,0,1,3,16,Donaldson Air Force Base,South Carolina,LOC-LOC-LOC-LOC,LOC-LOC,PROPN-PROPN-PROPN-PROPN,PROPN-PROPN,compound-compound-compound-nsubj,compound-appos,NNP-NNP-NNP-NNP,NNP-NNP,9,1
2,3.0,27,used,2,17,24,7,16,2,-15,22,B-25 Mitchell,World War II,MISC-MISC,MISC-MISC-MISC,PROPN-PROPN,PROPN-PROPN-PROPN,nmod-nmod,compound-compound-pobj,NNP-NNP,NNP-NNP-NNP,4,1
0,0.0,20,was,13,1,4,3,0,15,12,-9,Daniel Ellison,"February 14 , 1886",PER-PER,TIME-TIME-TIME-TIME,PROPN-PROPN,PROPN-NUM-PUNCT-NUM,compound-nsubj,appos-nummod-punct-nummod,NNP-NNP,"NNP-CD-,-CD",2,1
1,0.0,20,was,13,1,9,8,0,10,12,-4,Daniel Ellison,"August 20 , 1960",PER-PER,TIME-TIME-TIME-TIME,PROPN-PROPN,PROPN-NUM-PUNCT-NUM,compound-nsubj,appos-nummod-punct-nummod,NNP-NNP,"NNP-CD-,-CD",2,1
2,0.0,20,was,13,1,16,15,0,3,12,3,Daniel Ellison,U.S.,PER-PER,LOC,PROPN-PROPN,PROPN,compound-nsubj,compound,NNP-NNP,NNP,2,1
3,0.0,20,was,13,16,19,3,15,0,-3,6,U.S.,Maryland,LOC,LOC,PROPN,PROPN,compound,pobj,NNP,NNP,2,1
4,1.0,19,brought,7,6,3,-3,5,15,1,-4,Ellison,Russian Empire,PER,LOC-LOC,PROPN,PROPN-PROPN,nsubjpass,compound-pobj,NNP,NNP-NNP,4,1
0,0.0,26,is,1,1,22,21,0,3,0,21,Tautira,Tahiti,LOC,LOC,PROPN,PROPN,nsubj,pobj,NNP,NNP,8,1
1,0.0,26,is,1,4,25,21,3,0,-3,24,Polynesian,Pacific,LOC,LOC,ADJ,PROPN,amod,pobj,JJ,NNP,3,1
2,0.0,26,is,1,22,25,3,21,0,-21,24,Tahiti,Pacific,LOC,LOC,PROPN,PROPN,pobj,pobj,NNP,NNP,9,1
0,1.0,18,located,2,5,16,11,4,1,-3,14,Capitol Hill,Washington,LOC-LOC,LOC,PROPN-PROPN,PROPN,compound-pobj,pobj,NNP-NNP,NNP,9,1
1,1.0,18,located,2,13,16,3,12,1,-11,14,National Mall,Washington,LOC-LOC,LOC,PROPN-PROPN,PROPN,compound-pobj,pobj,NNP-NNP,NNP,3,1
0,0.0,17,is,10,1,13,12,0,3,9,3,Michael Morris Rosbash,American,PER-PER-PER,LOC,PROPN-PROPN-PROPN,ADJ,compound-compound-nsubj,amod,NNP-NNP-NNP,JJ,3,1
1,1.0,16,is,1,1,6,5,0,9,0,5,Rosbash,Brandeis University,PER,ORG-ORG,PROPN,PROPN-PROPN,nsubj,compound-pobj,NNP,NNP-NNP,3,1
2,1.0,16,is,1,1,12,11,0,3,0,11,Rosbash,Howard Hughes Medical Institute,PER,ORG-ORG-ORG-ORG,PROPN,PROPN-PROPN-PROPN-PROPN,nsubj,compound-compound-compound-pobj,NNP,NNP-NNP-NNP-NNP,4,1
3,4.0,12,elected,2,1,6,5,0,5,1,4,Rosbash,National Academy of Sciences,PER,ORG-ORG-ORG-ORG,PROPN,PROPN-PROPN-ADP-PROPN,nsubjpass,compound-pobj-prep-pobj,NNP,NNP-NNP-IN-NNPS,3,1
4,5.0,34,awarded,12,3,16,13,2,17,9,4,Michael W. Young,Nobel Prize in Physiology or Medicine,PER-PER-PER,MISC-MISC-MISC-MISC-MISC-MISC,PROPN-PROPN-PROPN,PROPN-PROPN-ADP-PROPN-CCONJ-PROPN,compound-compound-pobj,compound-dobj-prep-pobj-cc-conj,NNP-NNP-NNP,NNP-NNP-IN-NNP-CC-NNP,5,1
5,5.0,34,awarded,12,7,16,9,6,17,5,4,Jeffrey C. Hall,Nobel Prize in Physiology or Medicine,PER-PER-PER,MISC-MISC-MISC-MISC-MISC-MISC,PROPN-PROPN-PROPN,PROPN-PROPN-ADP-PROPN-CCONJ-PROPN,compound-compound-conj,compound-dobj-prep-pobj-cc-conj,NNP-NNP-NNP,NNP-NNP-IN-NNP-CC-NNP,6,1
0,0.0,15,is,3,1,6,5,0,8,2,3,The Immortal Alamo,American,MISC-MISC-MISC,LOC,DET-PROPN-PROPN,ADJ,det-compound-nsubj,amod,DT-NNP-NNP,JJ,4,1
1,0.0,15,is,3,1,11,10,0,3,2,8,The Immortal Alamo,"May 25 , 1911",MISC-MISC-MISC,TIME-TIME-TIME-TIME,DET-PROPN-PROPN,PROPN-NUM-PUNCT-NUM,det-compound-nsubj,pobj-nummod-punct-nummod,DT-NNP-NNP,"NNP-CD-,-CD",7,1
2,1.0,19,is,3,1,14,13,0,4,2,11,The Immortal Alamo,1836 Battle of the Alamo,MISC-MISC-MISC,MISC-MISC-MISC-MISC-MISC,DET-PROPN-PROPN,NUM-PROPN-ADP-DET-PROPN,det-compound-nsubj,nummod-dobj-prep-det-pobj,DT-NNP-NNP,CD-NNP-IN-DT-NNP,7,1
0,0.0,32,is,9,14,24,10,13,7,-5,15,Catskill Mountains,Greene County,LOC-LOC,LOC-LOC,PROPN-PROPN,PROPN-PROPN,compound-pobj,compound-pobj,NNP-NNPS,NNP-NNP,5,1
1,0.0,32,is,9,14,30,16,13,1,-5,21,Catskill Mountains,United States,LOC-LOC,LOC-LOC,PROPN-PROPN,PROPN-PROPN,compound-pobj,compound-appos,NNP-NNPS,NNP-NNP,1,1
2,0.0,32,is,9,20,24,4,19,7,-11,15,Town of Hunter,Greene County,LOC-LOC-LOC,LOC-LOC,PROPN-ADP-PROPN,PROPN-PROPN,pobj-prep-pobj,compound-pobj,NNP-IN-NNP,NNP-NNP,3,1
3,0.0,32,is,9,20,30,10,19,1,-11,21,Town of Hunter,United States,LOC-LOC-LOC,LOC-LOC,PROPN-ADP-PROPN,PROPN-PROPN,pobj-prep-pobj,compound-appos,NNP-IN-NNP,NNP-NNP,5,1
4,0.0,32,is,9,24,27,3,23,4,-15,18,Greene County,New York,LOC-LOC,LOC-LOC,PROPN-PROPN,PROPN-PROPN,compound-pobj,compound-conj,NNP-NNP,NNP-NNP,3,1
5,0.0,32,is,9,24,30,6,23,1,-15,21,Greene County,United States,LOC-LOC,LOC-LOC,PROPN-PROPN,PROPN-PROPN,compound-pobj,compound-appos,NNP-NNP,NNP-NNP,6,1
6,0.0,32,is,9,27,30,3,26,1,-18,21,New York,United States,LOC-LOC,LOC-LOC,PROPN-PROPN,PROPN-PROPN,compound-conj,compound-appos,NNP-NNP,NNP-NNP,5,1
0,6.0,33,include,14,7,23,16,6,9,7,9,American,Pennsylvania,LOC,LOC,ADJ,PROPN,conj,conj,JJ,NNP,9,1
1,6.0,33,include,14,17,12,-5,16,20,-3,-2,Philadelphia,the United States,LOC,LOC-LOC-LOC,PROPN,DET-PROPN-PROPN,pobj,det-compound-pobj,NNP,DT-NNP-NNP,7,1
2,6.0,33,include,14,23,12,-11,22,20,-9,-2,Pennsylvania,the United States,LOC,LOC-LOC-LOC,PROPN,DET-PROPN-PROPN,conj,det-compound-pobj,NNP,DT-NNP-NNP,10,1
3,6.0,33,include,14,30,12,-18,29,20,-16,-2,New York City,the United States,LOC-LOC-LOC,LOC-LOC-LOC,PROPN-PROPN-PROPN,DET-PROPN-PROPN,compound-compound-pobj,det-compound-pobj,NNP-NNP-NNP,DT-NNP-NNP,13,1
0,0.0,23,was,12,1,5,4,0,17,11,-7,Devdas Mohandas Gandhi,22 May 1900,PER-PER-PER,TIME-TIME-TIME,PROPN-PROPN-PROPN,NUM-PROPN-NUM,compound-compound-nsubj,nummod-nmod-nummod,NNP-NNP-NNP,CD-NNP-CD,2,1
1,0.0,23,was,12,1,9,8,0,13,11,-3,Devdas Mohandas Gandhi,3 August 1957,PER-PER-PER,TIME-TIME-TIME,PROPN-PROPN-PROPN,NUM-PROPN-NUM,compound-compound-nsubj,nummod-appos-nummod,NNP-NNP-NNP,CD-NNP-CD,2,1
2,0.0,23,was,12,1,2,1,0,20,11,-10,Devdas Mohandas Gandhi,Mohandas Karamchand Gandhi,PER-PER-PER,PER-PER-PER,PROPN-PROPN-PROPN,PROPN-PROPN-PROPN,compound-compound-nsubj,compound-compound-pobj,NNP-NNP-NNP,NNP-NNP-NNP,1,1
3,4.0,24,fell,1,6,11,5,5,12,-5,10,Lakshmi,C. Rajagopalachari,PER,PER-PER,PROPN,PROPN-PROPN,pobj,compound-pobj,NNP,NNP-NNP,4,1
4,7.0,29,had,3,8,11,3,7,17,-5,8,Rajmohan Gandhi,Gopalkrishna Gandhi,PER-PER,PER-PER,PROPN-PROPN,PROPN-PROPN,compound-appos,compound-conj,NNP-NNP,NNP-NNP,1,1
5,7.0,29,had,3,8,14,6,7,14,-5,11,Rajmohan Gandhi,Ramchandra Gandhi,PER-PER,PER-PER,PROPN-PROPN,PROPN-PROPN,compound-appos,compound-conj,NNP-NNP,NNP-NNP,2,1
6,7.0,29,had,3,11,14,3,10,14,-8,11,Gopalkrishna Gandhi,Ramchandra Gandhi,PER-PER,PER-PER,PROPN-PROPN,PROPN-PROPN,compound-conj,compound-conj,NNP-NNP,NNP-NNP,1,1
7,7.0,29,had,3,17,22,5,16,6,-14,19,Tara Gandhi Bhattacharjee,24 April 1934,PER-PER-PER,TIME-TIME-TIME,PROPN-PROPN-PROPN,NUM-PROPN-NUM,compound-compound-conj,nummod-npadvmod-nummod,NNP-NNP-NNP,CD-NNP-CD,7,1
0,0.0,31,composed,22,6,18,12,5,12,16,-4,Gambia,West African,LOC,LOC-LOC,PROPN,ADJ-ADJ,pobj,amod-amod,NNP,JJ-JJ,6,1
1,0.0,31,composed,22,8,18,10,7,12,14,-4,Sierra Leone,West African,LOC-LOC,LOC-LOC,PROPN-PROPN,ADJ-ADJ,compound-conj,amod-amod,NNP-NNP,JJ-JJ,6,1
2,1.0,22,province,2,9,17,8,8,4,-7,15,Sierra Leone,Freetown,LOC-LOC,LOC,PROPN-PROPN,PROPN,compound-dobj,appos,NNP-NNP,NNP,3,1
3,4.0,27,has,2,19,26,7,18,0,-17,24,Sierra Leone,Freetown,LOC-LOC,LOC,PROPN-PROPN,PROPN,compound-conj,pobj,NNP-NNP,NNP,5,1
4,2.0,23,diocese,2,22,15,-7,21,7,-20,13,Banjul,Gambia,LOC,LOC,PROPN,PROPN,appos,pobj,NNP,NNP,2,1
5,7.0,42,is,2,35,40,5,34,1,-33,38,Liberia,Monrovia,LOC,LOC,PROPN,PROPN,pobj,appos,NNP,NNP,2,1
0,2.0,32,grew,1,11,25,14,10,6,-10,24,Grand Canal,China,LOC-LOC,LOC,PROPN-PROPN,PROPN,compound-pobj,pobj,NNP-NNP,NNP,6,1
0,0.0,25,is,1,1,10,9,0,14,0,9,Alton,Madison County,LOC,LOC-LOC,PROPN,PROPN-PROPN,nsubj,compound-pobj,NNP,NNP-NNP,5,1
1,0.0,25,is,1,7,13,6,6,11,-6,12,Mississippi River,Illinois,LOC-LOC,LOC,PROPN-PROPN,PROPN,compound-pobj,conj,NNP-NNP,NNP,4,1
2,0.0,25,is,1,10,13,3,9,11,-9,12,Madison County,Illinois,LOC-LOC,LOC,PROPN-PROPN,PROPN,compound-pobj,conj,NNP-NNP,NNP,2,1
3,0.0,25,is,1,13,15,2,12,9,-12,14,Illinois,United States,LOC,LOC-LOC,PROPN,PROPN-PROPN,conj,compound-conj,NNP,NNP-NNP,2,1
4,0.0,25,is,1,15,24,9,14,0,-14,23,United States,Missouri,LOC-LOC,LOC,PROPN-PROPN,PROPN,compound-conj,appos,NNP-NNP,NNP,8,1
0,0.0,18,is,4,1,17,16,0,0,3,13,Hercules & Love Affair,2004,MISC-MISC-MISC-MISC,TIME,PROPN-CCONJ-PROPN-PROPN,NUM,nsubj-cc-compound-conj,pobj,NNP-CC-NNP-NNP,CD,3,1
1,2.0,40,founded,19,11,13,2,10,26,8,-6,Ghent,Belgium,LOC,LOC,PROPN,PROPN,pobj,conj,NNP,NNP,3,1
2,3.0,42,went,15,27,30,3,26,11,-12,15,Blue Songs,2011,MISC-MISC,TIME,PROPN-NOUN,NUM,compound-conj,appos,NNP-NNS,CD,1,1
3,3.0,42,went,15,27,33,6,26,8,-12,18,Blue Songs,The Feast of the Broken Heart,MISC-MISC,MISC-MISC-MISC-MISC-MISC-MISC,PROPN-NOUN,DET-PROPN-ADP-DET-PROPN-PROPN,compound-conj,det-conj-prep-det-compound-pobj,NNP-NNS,DT-NNP-IN-DT-NNP-NNP,2,1
4,3.0,42,went,15,33,40,7,32,1,-18,25,The Feast of the Broken Heart,2014,MISC-MISC-MISC-MISC-MISC-MISC,TIME,DET-PROPN-ADP-DET-PROPN-PROPN,NUM,det-conj-prep-det-compound-pobj,appos,DT-NNP-IN-DT-NNP-NNP,CD,1,1
5,4.0,13,released,5,4,11,7,3,1,1,6,Omnion,Atlantic Records,MISC,ORG-ORG,PROPN,PROPN-PROPN,nsubjpass,compound-pobj,NNP,NNP-NNPS,3,1
0,0.0,14,is,1,1,9,8,0,4,0,8,Gloppen,Sogn og Fjordane,LOC,LOC-LOC-LOC,PROPN,PROPN-ADP-PROPN,nsubj,pobj-prep-conj,NNP,NNP-IN-NNP,2,1
1,0.0,14,is,1,9,13,4,8,0,-8,12,Sogn og Fjordane,Norway,LOC-LOC-LOC,LOC,PROPN-ADP-PROPN,PROPN,pobj-prep-conj,appos,NNP-IN-NNP,NNP,3,1
0,0.0,22,was,14,1,5,4,0,16,13,-9,William Earl Barber,"November 30 , 1919",PER-PER-PER,TIME-TIME-TIME-TIME,PROPN-PROPN-PROPN,PROPN-NUM-PUNCT-NUM,compound-compound-nsubj,appos-nummod-punct-nummod,NNP-NNP-NNP,"NNP-CD-,-CD",3,1
1,0.0,22,was,14,1,10,9,0,11,13,-4,William Earl Barber,"April 19 , 2002",PER-PER-PER,TIME-TIME-TIME-TIME,PROPN-PROPN-PROPN,PROPN-NUM-PUNCT-NUM,compound-compound-nsubj,appos-nummod-punct-nummod,NNP-NNP-NNP,"NNP-CD-,-CD",4,1
2,1.0,30,fought,1,22,28,6,21,1,-21,27,Battle of Chosin Reservoir,Korean War,MISC-MISC-MISC-MISC,MISC-MISC,PROPN-ADP-PROPN-PROPN,PROPN-PROPN,pobj-prep-compound-pobj,compound-pobj,NNP-IN-NNP-NNP,NNP-NNP,5,1
0,5.0,19,was,2,1,16,15,0,2,1,14,Carisbrooke Castle,Isle of Wight,LOC-LOC,LOC-LOC-LOC,PROPN-PROPN,PROPN-ADP-PROPN,compound-nsubj,pobj-prep-pobj,NNP-NNP,NNP-IN-NNP,7,1
0,0.0,37,is,3,1,8,7,0,28,2,5,Kaesong,North Hwanghae Province,LOC,LOC-LOC-LOC,PROPN,PROPN-PROPN-PROPN,nsubj,compound-compound-pobj,NNP,NNP-NNP-NNP,5,1
1,0.0,37,is,3,1,31,30,0,5,2,28,Kaesong,Taebong,LOC,ORG,PROPN,PROPN,nsubj,compound,NNP,NNP,10,1
2,0.0,37,is,3,8,8,0,7,28,-5,5,North Hwanghae Province,North Korea,LOC-LOC-LOC,LOC-LOC,PROPN-PROPN-PROPN,PROPN-PROPN,compound-compound-pobj,compound-pobj,NNP-NNP-NNP,NNP-NNP,0,1
3,3.0,11,functions,2,1,6,5,0,4,1,4,Kaesong,DPRK,LOC,ORG,PROPN,PROPN,nsubj,poss,NNP,NNP,5,1
0,0.0,17,is,4,1,3,2,0,13,3,-1,Ardhanaari,2012,MISC,TIME,PROPN,NUM,nsubj,appos,NNP,CD,2,1
1,0.0,17,is,4,1,7,6,0,9,3,3,Ardhanaari,Malayalam,MISC,MISC,PROPN,PROPN,nsubj,compound,NNP,NNP,3,1
0,0.0,16,is,4,2,15,13,1,0,2,11,New Pass Range,Nevada,LOC-LOC-LOC,LOC,PROPN-PROPN-PROPN,PROPN,compound-compound-nsubj,pobj,NNP-NNP-NNP,NNP,3,1
1,0.0,16,is,4,10,15,5,9,0,-6,11,Lander,Nevada,LOC,LOC,PROPN,PROPN,nmod,pobj,NNP,NNP,5,1
2,0.0,16,is,4,12,15,3,11,0,-8,11,Churchill,Nevada,LOC,LOC,PROPN,PROPN,conj,pobj,NNP,NNP,4,1
0,0.0,24,Museum,2,20,23,3,19,0,-18,21,Abu Dhabi,UAE,LOC-LOC,LOC,PROPN-PROPN,PROPN,compound-pobj,appos,NNP-NNP,NNP,4,1
1,1.0,22,designed,2,21,10,-11,20,11,-19,8,UAE,Zayed bin Sultan Al Nahyan,LOC,PER-PER-PER-PER-PER,PROPN,PROPN-PROPN-PROPN-PROPN-PROPN,pobj,compound-compound-compound-compound-pobj,NNP,NNP-NNP-NNP-NNP-NNP,6,1
0,0.0,19,is,4,2,18,16,1,0,2,14,Niagara Regional Council,Canada,ORG-ORG-ORG,LOC,PROPN-PROPN-PROPN,PROPN,compound-compound-nsubj,appos,NNP-NNP-NNP,NNP,3,1
1,0.0,19,is,4,3,16,13,2,2,1,12,Regional Municipality of Niagara,Ontario,ORG-ORG-ORG-ORG,LOC,PROPN-PROPN-ADP-PROPN,PROPN,compound-pobj-prep-pobj,pobj,NNP-NNP-IN-NNP,NNP,5,1
2,0.0,19,is,4,3,18,15,2,0,1,14,Regional Municipality of Niagara,Canada,ORG-ORG-ORG-ORG,LOC,PROPN-PROPN-ADP-PROPN,PROPN,compound-pobj-prep-pobj,appos,NNP-NNP-IN-NNP,NNP,2,1
3,0.0,19,is,4,16,18,2,15,0,-12,14,Ontario,Canada,LOC,LOC,PROPN,PROPN,pobj,appos,NNP,NNP,5,1
4,1.0,11,meets,1,10,8,-2,9,2,-9,7,Ontario,Thorold,LOC,LOC,PROPN,PROPN,appos,pobj,NNP,NNP,6,1
0,0.0,46,was,12,1,5,4,0,40,11,-7,S. Ali Raza,9 January 1925,PER-PER-PER,TIME-TIME-TIME,PROPN-PROPN-PROPN,NUM-PROPN-NUM,compound-compound-nsubj,nummod-appos-nummod,NNP-NNP-NNP,CD-NNP-CD,2,1
1,0.0,46,was,12,1,15,14,0,30,11,3,S. Ali Raza,Indian,PER-PER-PER,LOC,PROPN-PROPN-PROPN,ADJ,compound-compound-nsubj,amod,NNP-NNP-NNP,JJ,4,1
0,0.0,19,is,7,13,15,2,12,3,-6,8,Cornwall,England,LOC,LOC,PROPN,PROPN,pobj,conj,NNP,NNP,2,1
1,0.0,19,is,7,13,17,4,12,1,-6,10,Cornwall,United Kingdom,LOC,LOC-LOC,PROPN,PROPN-PROPN,pobj,compound-appos,NNP,NNP-NNP,2,1
2,0.0,19,is,7,15,17,2,14,1,-8,10,England,United Kingdom,LOC,LOC-LOC,PROPN,PROPN-PROPN,conj,compound-appos,NNP,NNP-NNP,2,1
0,0.0,13,is,3,1,6,5,0,6,2,3,The Piano Lesson,1987,MISC-MISC-MISC,TIME,DET-PROPN-PROPN,NUM,det-compound-nsubj,nummod,DT-NNP-NNP,CD,3,1
1,1.0,12,is,1,7,9,2,6,2,-6,8,Wilson,The Pittsburgh Cycle,PER,MISC-MISC-MISC,PROPN,DET-PROPN-PROPN,poss,det-compound-pobj,NNP,DT-NNP-NNP,3,1
2,7.0,46,follows,15,13,4,-9,12,41,2,-11,The Piano Lesson,Pittsburgh,MISC-MISC-MISC,LOC,DET-PROPN-PROPN,PROPN,det-compound-nsubj,dobj,DT-NNP-NNP,NNP,4,1
0,0.0,26,is,3,1,23,22,0,2,2,20,The Original High,Warner Bros. Records,MISC-MISC-MISC,ORG-ORG-ORG,DET-PROPN-PROPN,PROPN-PROPN-PROPN,det-amod-nsubj,compound-compound-pobj,DT-NNP-NNP,NNP-NNPS-NNPS,7,1
1,0.0,26,is,3,12,23,11,11,2,-9,20,Adam Lambert,Warner Bros. Records,PER-PER,ORG-ORG-ORG,PROPN-PROPN,PROPN-PROPN-PROPN,compound-pobj,compound-compound-pobj,NNP-NNP,NNP-NNPS-NNPS,6,1
2,1.0,38,are,3,26,33,7,25,4,-23,30,Whataya Want from Me,If I Had You,MISC-MISC-MISC-MISC,MISC-MISC-MISC-MISC,PROPN-VERB-ADP-PRON,ADP-PRON-VERB-PRON,compound-relcl-prep-pobj,mark-nsubj-conj-dobj,NNP-VBP-IN-PRP,IN-PRP-VBD-PRP,10,1
3,2.0,16,marks,2,4,14,10,3,1,-2,12,Lambert,RCA Records,PER,ORG-ORG,PROPN,PROPN-PROPN,poss,compound-appos,NNP,NNP-NNPS,4,1
0,0.0,18,is,8,1,5,4,0,12,7,-3,Detlef Schrempf,21 January 1963,PER-PER,TIME-TIME-TIME,PROPN-PROPN,NUM-PROPN-NUM,compound-nsubj,nummod-npadvmod-nummod,NNP-NNP,CD-NNP-CD,2,1
1,3.0,26,played,1,1,14,13,0,11,0,13,Schrempf,Indiana Pacers,PER,ORG-ORG,PROPN,PROPN-PROPN,nsubj,compound-pobj,NNP,NNP-NNPS,4,1
2,3.0,26,played,1,1,23,22,0,2,0,22,Schrempf,Portland Trail Blazers,PER,ORG-ORG-ORG,PROPN,PROPN-PROPN-PROPN,nsubj,compound-compound-conj,NNP,NNP-NNP-NNPS,7,1
3,3.0,26,played,1,14,5,-9,13,20,-13,4,Indiana Pacers,NBA,ORG-ORG,ORG,PROPN-PROPN,PROPN,compound-pobj,pobj,NNP-NNPS,NNP,5,1
4,3.0,26,played,1,23,5,-18,22,20,-22,4,Portland Trail Blazers,NBA,ORG-ORG-ORG,ORG,PROPN-PROPN-PROPN,PROPN,compound-compound-conj,pobj,NNP-NNP-NNPS,NNP,8,1
5,4.0,12,reached,4,11,7,-4,10,4,-7,3,SuperSonics,NBA Finals,ORG,MISC-MISC,PROPN,PROPN-PROPN,pobj,compound-dobj,NNP,NNP-NNPS,2,1
0,0.0,20,is,8,1,18,17,0,1,7,10,Willits,United States,LOC,LOC-LOC,NOUN,PROPN-PROPN,nsubj,compound-appos,NNS,NNP-NNP,6,1
1,0.0,20,is,8,13,16,3,12,3,-5,8,Mendocino County,California,LOC-LOC,LOC,PROPN-PROPN,PROPN,compound-pobj,appos,NNP-NNP,NNP,1,1
2,0.0,20,is,8,13,18,5,12,1,-5,10,Mendocino County,United States,LOC-LOC,LOC-LOC,PROPN-PROPN,PROPN-PROPN,compound-pobj,compound-appos,NNP-NNP,NNP-NNP,1,1
3,0.0,20,is,8,16,18,2,15,1,-8,10,California,United States,LOC,LOC-LOC,PROPN,PROPN-PROPN,appos,compound-appos,NNP,NNP-NNP,2,1
0,0.0,21,were,3,2,19,17,1,1,1,16,Carolina Thunderbirds,United States,ORG-ORG,LOC-LOC,PROPN-PROPN,PROPN-PROPN,compound-nsubj,compound-pobj,NNP-NNPS,NNP-NNP,7,1
1,0.0,21,were,3,16,19,3,15,1,-13,16,North Carolina,United States,LOC-LOC,LOC-LOC,PROPN-PROPN,PROPN-PROPN,compound-conj,compound-pobj,NNP-NNP,NNP-NNP,1,1
0,0.0,30,University,1,27,29,2,26,0,-26,28,Bangkok,Thailand,LOC,LOC,PROPN,PROPN,pobj,appos,NNP,NNP,5,1
0,2.0,23,been,2,1,8,7,0,14,1,6,Rzeszów,Subcarpathian Voivodeship,LOC,LOC-LOC,PROPN,ADJ-PROPN,nsubj,compound-pobj,NNP,JJ-NNP,4,1
1,2.0,23,been,2,1,8,7,0,14,1,6,Rzeszów County,Subcarpathian Voivodeship,LOC-LOC,LOC-LOC,PROPN-PROPN,ADJ-PROPN,compound-pobj,compound-pobj,NNP-NNP,JJ-NNP,4,1
2,3.0,21,begins,4,4,7,3,3,13,0,3,Rzeszów,1354,LOC,TIME,PROPN,NUM,pobj,pobj,NNP,CD,3,1
3,7.0,28,annexed,8,7,12,5,6,15,1,4,Rzeszów,Austrian Empire,LOC,LOC-LOC,PROPN,PROPN-PROPN,nsubjpass,compound-pobj,NNP,NNP-NNP,3,1
0,0.0,40,is,1,1,11,10,0,28,0,10,Chariot,PlayStation 4,MISC,MISC-MISC,PROPN,PROPN-NUM,nsubj,pobj-nummod,NNP,NNP-CD,4,1
1,0.0,40,is,1,1,11,10,0,28,0,10,Chariot,PlayStation 3,MISC,MISC-MISC,PROPN,PROPN-NUM,nsubj,appos-nummod,NNP,NNP-CD,4,1
2,0.0,40,is,1,1,20,19,0,19,0,19,Chariot,Wii U,MISC,MISC-MISC,PROPN,PROPN-PRON,nsubj,compound-conj,NNP,NNP-PRP,3,1
3,0.0,40,is,1,1,23,22,0,16,0,22,Chariot,Microsoft Windows,MISC,MISC-MISC,PROPN,PROPN-PROPN,nsubj,compound-conj,NNP,NNP-NNP,4,1
4,0.0,40,is,1,1,29,28,0,10,0,28,Chariot,Frima Studio,MISC,ORG-ORG,PROPN,PROPN-PROPN,nsubj,compound-pobj,NNP,NNP-NNP,4,1
5,1.0,29,released,3,27,14,-13,26,14,-24,11,Gold program,Xbox One,MISC-MISC,MISC-MISC,ADJ-NOUN,PROPN-PROPN,compound-pobj,compound-pobj,JJ-NN,NNP-NNP,9,1
6,2.0,25,released,8,5,12,7,4,12,3,4,Super Chariot,Nintendo Switch,MISC-MISC,MISC-MISC,PROPN-PROPN,PROPN-PROPN,compound-oprd,compound-pobj,NNP-NNP,NNP-NNP,5,1
0,1.0,37,developed,7,11,17,6,10,19,-4,10,Scotland,United Kingdom,LOC,LOC-LOC,PROPN,PROPN-PROPN,pobj,compound-pobj,NNP,NNP-NNP,3,1
1,5.0,61,read,19,39,42,3,38,18,-20,23,Human Rights Act,1998,MISC-MISC-MISC,TIME,PROPN-PROPN-PROPN,NUM,compound-compound-pobj,nummod,NNP-NNPS-NNP,CD,5,1
0,1.0,71,contains,18,31,34,3,30,36,-13,16,Carnival,Masquerade,MISC,MISC,PROPN,PROPN,appos,conj,NNP,NNP,3,1
1,3.0,17,be,5,3,12,9,2,4,2,7,Greatest Hits,Columbia Records,MISC-MISC,ORG-ORG,PROPN-PROPN,PROPN-PROPN,compound-nsubj,compound-pobj,NNP-NNPS,NNP-NNPS,4,1
2,5.0,28,serviced,15,12,26,14,11,1,3,11,Ghetto Religion,September 2003,MISC-MISC,TIME-TIME,PROPN-PROPN,PROPN-NUM,compound-nsubjpass,pobj-nummod,NNP-NNP,NNP-CD,6,1
3,6.0,29,is,14,4,12,8,3,16,10,-2,Pussycat,Tom Jones,MISC,PER-PER,PROPN,PROPN-PROPN,nsubj,compound-pobj,NNP,NNP-NNP,4,1
0,0.0,27,was,12,1,5,4,0,21,11,-7,Edward Tangye Lean,23 February 1911,PER-PER-PER,TIME-TIME-TIME,PROPN-PROPN-PROPN,NUM-PROPN-NUM,compound-compound-nsubj,nummod-nmod-nummod,NNP-NNP-NNP,CD-NNP-CD,2,1
1,0.0,27,was,12,1,9,8,0,17,11,-3,Edward Tangye Lean,28 October 1974,PER-PER-PER,TIME-TIME-TIME,PROPN-PROPN-PROPN,NUM-PROPN-NUM,compound-compound-nsubj,nummod-appos-nummod,NNP-NNP-NNP,CD-NNP-CD,3,1
2,0.0,27,was,12,1,15,14,0,11,11,3,Edward Tangye Lean,British,PER-PER-PER,LOC,PROPN-PROPN-PROPN,ADJ,compound-compound-nsubj,amod,NNP-NNP-NNP,JJ,3,1
3,1.0,36,was,3,1,5,4,0,30,2,2,Lean,Francis William le Blount Lean,PER,PER-PER-PER-PER-PER,PROPN,PROPN-PROPN-X-PROPN-PROPN,poss,compound-compound-compound-compound-nsubj,NNP,NNP-NNP-FW-NNP-NNP,5,1
4,1.0,36,was,3,1,14,13,0,21,2,11,Lean,Helena Annie ( née Tangye ) Lean,PER,PER-PER-PER-PER-PER-PER-PER,PROPN,PROPN-PROPN-PUNCT-ADJ-PROPN-PUNCT-PROPN,poss,compound-attr-punct-compound-appos-punct-ROOT,NNP,NNP-NNP--LRB--JJ-NNP--RRB--NNP,5,1
5,3.0,17,was,8,7,13,6,6,3,1,5,Tangye Lean,"University College , Oxford",PER-PER,ORG-ORG-ORG-ORG,PROPN-PROPN,PROPN-PROPN-PUNCT-PROPN,compound-nsubj,compound-pobj-punct-appos,NNP-NNP,"NNP-NNP-,-NNP",4,1
0,6.0,28,starred,2,9,22,13,8,5,-7,20,Riding In Tandem,Philippines,MISC-MISC-MISC,LOC,PROPN-ADP-PROPN,PROPN,pobj-prep-pobj,pobj,NNP-IN-NNP,NNP,5,1
0,0.0,37,is,3,1,14,13,0,22,2,11,Doctors to Be,BBC Two,MISC-MISC-MISC,ORG-ORG,NOUN-PART-VERB,PROPN-NUM,nsubj-aux-relcl,compound-pobj,NNS-TO-VB,NNP-CD,8,1
1,0.0,37,is,3,14,14,0,13,22,-11,11,BBC Two,BBC Television,ORG-ORG,ORG-ORG,PROPN-NUM,PROPN-PROPN,compound-pobj,compound-pobj,NNP-CD,NNP-NNP,0,1
2,4.0,37,selected,2,11,13,2,10,23,-9,11,London,England,LOC,LOC,PROPN,PROPN,conj,appos,NNP,NNP,4,1
0,0.0,26,is,3,1,11,10,0,14,2,8,Men at Arms,Terry Pratchett,MISC-MISC-MISC,PER-PER,NOUN-ADP-PROPN,PROPN-PROPN,nsubj-prep-pobj,compound-pobj,NNS-IN-NNP,NNP-NNP,5,1
1,0.0,26,is,3,1,25,24,0,0,2,22,Men at Arms,1993,MISC-MISC-MISC,TIME,NOUN-ADP-PROPN,NUM,nsubj-prep-pobj,pobj,NNS-IN-NNP,CD,3,1
0,0.0,26,was,14,1,7,6,0,18,13,-7,Jean Piaget,9 August 1896,PER-PER,TIME-TIME-TIME,PROPN-PROPN,NUM-PROPN-NUM,compound-nsubj,nummod-appos-nummod,NNP-NNP,CD-NNP-CD,2,1
1,0.0,26,was,14,1,17,16,0,8,13,3,Jean Piaget,Swiss,PER-PER,LOC,PROPN-PROPN,ADJ,compound-nsubj,amod,NNP-NNP,JJ,2,1
2,6.0,31,created,1,1,10,9,0,20,0,9,Piaget,Geneva,PER,LOC,PROPN,PROPN,nsubj,pobj,NNP,NNP,1,1
0,0.0,13,is,1,1,11,10,0,1,0,10,Liberty,United States,LOC,LOC-LOC,PROPN,PROPN-PROPN,nsubj,compound-appos,NNP,NNP-NNP,5,1
1,0.0,13,is,1,6,9,3,5,3,-5,8,Allegheny County,Pennsylvania,LOC-LOC,LOC,PROPN-PROPN,PROPN,compound-pobj,appos,NNP-NNP,NNP,2,1
2,0.0,13,is,1,6,11,5,5,1,-5,10,Allegheny County,United States,LOC-LOC,LOC-LOC,PROPN-PROPN,PROPN-PROPN,compound-pobj,compound-appos,NNP-NNP,NNP-NNP,2,1
3,0.0,13,is,1,9,11,2,8,1,-8,10,Pennsylvania,United States,LOC,LOC-LOC,PROPN,PROPN-PROPN,appos,compound-appos,NNP,NNP-NNP,2,1
0,5.0,17,is,2,2,7,5,1,9,0,5,UPM,TIME,ORG,ORG,PROPN,PROPN,nsubj,compound,NNP,NNP,3,1
0,12.0,22,vote,12,11,4,-7,10,17,1,-8,Lithuania,European Union,LOC,ORG-ORG,PROPN,PROPN-PROPN,pobj,compound-compound,NNP,NNP-NNP,5,1
1,12.0,22,vote,12,4,16,12,3,5,8,4,European Union,Lithuanian,ORG-ORG,LOC,PROPN-PROPN,ADJ,compound-compound,amod,NNP-NNP,JJ,6,1
0,0.0,36,began,4,2,12,10,1,23,2,8,Looting of Battleford,1885,MISC-MISC-MISC,TIME,NOUN-ADP-PROPN,NUM,nsubj-prep-pobj,npadvmod,NN-IN-NNP,CD,3,1
1,0.0,36,began,4,4,27,23,3,8,0,23,Battleford,Saskatchewan,LOC,LOC,PROPN,PROPN,pobj,appos,NNP,NNP,3,1
0,1.0,16,started,1,15,8,-7,14,7,-14,7,Gits,Steve Moriarty,ORG,PER-PER,NOUN,PROPN-PROPN,pobj,compound-dobj,NNS,NNP-NNP,3,1
1,5.0,27,formed,1,22,26,4,21,0,-21,25,Sick ' Em,1992,MISC-MISC-MISC,TIME,PROPN-PUNCT-PROPN,NUM,compound-punct-appos,pobj,NNP-''-NNP,CD,5,1
0,0.0,14,is,4,2,12,10,1,1,2,8,Order of Myths,Margaret Brown,MISC-MISC-MISC,PER-PER,NOUN-ADP-PROPN,PROPN-PROPN,nsubj-prep-pobj,compound-pobj,NN-IN-NNP,NNP-NNP,6,1
1,1.0,19,focuses,1,9,4,-5,8,14,-8,3,Mobile,the United States,LOC,LOC-LOC-LOC,PROPN,DET-PROPN-PROPN,pobj,det-compound-pobj,NNP,DT-NNP-NNP,5,1
2,1.0,19,focuses,1,11,4,-7,10,14,-10,3,Alabama,the United States,LOC,LOC-LOC-LOC,PROPN,DET-PROPN-PROPN,appos,det-compound-pobj,NNP,DT-NNP-NNP,3,1
3,6.0,30,had,1,18,22,4,17,7,-17,21,Independent Lens,PBS,MISC-MISC,ORG,PROPN-PROPN,PROPN,compound-pobj,compound,NNP-NNP,NNP,1,1
0,0.0,20,Lentin,1,1,4,3,0,15,0,3,Louis Lentin,11 December 1933,PER-PER,TIME-TIME-TIME,PROPN-PROPN,NUM-PROPN-NUM,compound-ROOT,nummod-appos-nummod,NNP-NNP,CD-NNP-CD,2,1
1,6.0,7,was,1,1,6,5,0,0,0,5,Lentin,Aosdána,PER,ORG,PROPN,PROPN,nsubj,pobj,NNP,NNP,1,1
0,0.0,22,"""",0,2,7,5,1,14,-2,7,Honey Chile,1967,MISC-MISC,TIME,PROPN-PROPN,NUM,compound-nsubj,nummod,NNP-NNP,CD,2,1
1,0.0,22,"""",0,2,20,18,1,1,-2,20,Honey Chile,Gordy,MISC-MISC,ORG,PROPN-PROPN,PROPN,compound-nsubj,compound,NNP-NNP,NNP,8,1
0,1.0,25,gained,11,21,23,2,20,1,-10,12,U.S.,Donald Trump,LOC,PER-PER,PROPN,PROPN-PROPN,compound,compound-pobj,NNP,NNP-NNP,1,1
0,0.0,27,is,14,1,5,4,0,21,13,-9,Jacques Poulin,23 September 1937,PER-PER,TIME-TIME-TIME,PROPN-PROPN,NUM-PROPN-NUM,compound-nsubj,nummod-npadvmod-nummod,NNP-NNP,CD-NNP-CD,2,1
1,1.0,28,started,14,1,8,7,0,19,13,-6,Poulin,Université Laval,PER,ORG-ORG,PROPN,PROPN-PROPN,nsubj,compound-pobj,NNP,NNP-NNP,2,1
2,2.0,25,was,14,10,12,2,9,12,4,-2,Jimmy,1969,MISC,TIME,PROPN,NUM,appos,appos,NNP,CD,2,1
3,5.0,35,selected,5,12,17,5,11,17,-7,12,CBC,Canada,ORG,LOC,PROPN,PROPN,poss,pobj,NNP,NNP,4,1
4,5.0,35,selected,5,25,17,-8,24,17,-20,12,Roch Carrier,Canada,PER-PER,LOC,PROPN-PROPN,PROPN,compound-pobj,pobj,NNP-NNP,NNP,3,1
0,6.0,18,taken,2,1,9,8,0,8,1,7,Invensys,Schneider Electric,ORG,ORG-ORG,PROPN,PROPN-PROPN,nsubjpass,compound-pobj,NNP,NNP-NNP,3,1
0,0.0,24,is,5,2,8,6,1,15,3,3,Bust of Victor Hugo,1883,MISC-MISC-MISC-MISC,TIME,PROPN-ADP-PROPN-PROPN,NUM,nsubj-prep-compound-pobj,nummod,NNP-IN-NNP-NNP,CD,4,1
1,0.0,24,is,5,2,16,14,1,7,3,11,Bust of Victor Hugo,Auguste Rodin,MISC-MISC-MISC-MISC,PER-PER,PROPN-ADP-PROPN-PROPN,PROPN-PROPN,nsubj-prep-compound-pobj,compound-appos,NNP-IN-NNP-NNP,NNP-NNP,6,1
2,1.0,11,is,1,6,9,3,5,1,-5,8,Museo Soumaya,Mexico City,LOC-LOC,LOC-LOC,PROPN-PROPN,PROPN-PROPN,compound-pobj,compound-pobj,NNP-NNP,NNP-NNP,2,1
0,0.0,13,were,2,1,10,9,0,2,1,8,Bolt Thrower,Coventry,ORG-ORG,LOC,PROPN-PROPN,PROPN,compound-nsubj,pobj,NNP-NNP,NNP,5,1
1,1.0,15,formed,1,11,14,3,10,0,-10,13,Vinyl Solution,1988,ORG-ORG,TIME,PROPN-PROPN,NUM,compound-pobj,pobj,NNP-NNP,CD,4,1
0,0.0,21,(;,3,1,5,4,0,15,2,2,John Harvey Tolan,"January 15 , 1877",PER-PER-PER,TIME-TIME-TIME-TIME,PROPN-PROPN-PROPN,PROPN-NUM-PUNCT-NUM,compound-compound-compound,npadvmod-nummod-punct-nummod,NNP-NNP-NNP,"NNP-CD-,-CD",4,1
1,0.0,21,(;,3,1,17,16,0,3,2,14,John Harvey Tolan,U.S.,PER-PER-PER,LOC,PROPN-PROPN-PROPN,PROPN,compound-compound-compound,compound,NNP-NNP-NNP,NNP,4,1
2,0.0,21,(;,3,17,20,3,16,0,-14,17,U.S.,California,LOC,LOC,PROPN,PROPN,compound,pobj,NNP,NNP,3,1
3,6.0,29,elected,2,1,6,5,0,22,1,4,Tolan,Democrat,PER,ORG,PROPN,PROPN,nsubjpass,pobj,NNP,NNP,2,1
4,9.0,12,interred,2,5,11,6,4,0,-3,9,Holy Sepulchre Cemetery,California,LOC-LOC-LOC,LOC,PROPN-PROPN-PROPN,PROPN,compound-compound-pobj,appos,NNP-NNP-NNP,NNP,4,1
0,0.0,41,was,26,1,29,28,0,11,25,3,Luis Jorge Fontana,Argentine,PER-PER-PER,LOC,PROPN-PROPN-PROPN,ADJ,compound-compound-nsubj,amod,NNP-NNP-NNP,JJ,5,1
1,5.0,24,fought,18,5,22,17,4,1,13,4,Fontana,Paraguayan War,PER,MISC-MISC,PROPN,PROPN-PROPN,nsubj,compound-pobj,NNP,NNP-NNP,3,1
0,0.0,14,was,9,1,6,5,0,7,8,-3,Mary Catherine Crawford,12 April 1947,PER-PER-PER,TIME-TIME-TIME,PROPN-PROPN-PROPN,NUM-PROPN-NUM,compound-compound-nsubj,nummod-npadvmod-nummod,NNP-NNP-NNP,CD-NNP-CD,3,1
1,1.0,19,educated,8,3,5,2,2,13,5,-3,Toowoomba,Queensland,LOC,LOC,PROPN,PROPN,pobj,npadvmod,NNP,NNP,2,1
0,0.0,19,born,5,11,16,5,10,2,-6,11,Dangjin,South Korean,LOC,LOC-LOC,PROPN,ADJ-ADJ,pobj,amod-amod,NNP,JJ-JJ,-1,1
0,0.0,17,born,4,1,6,5,0,10,3,2,Olga Barabanschikova,2 November 1979,PER-PER,TIME-TIME-TIME,PROPN-PROPN,NUM-PROPN-NUM,compound-compound,nummod-npadvmod-nummod,NNP-NNP,CD-NNP-CD,3,1
1,4.0,6,born,2,1,5,4,0,0,1,3,Barabanschikova,Minsk,PER,LOC,PROPN,PROPN,nsubjpass,pobj,NNP,NNP,2,1
0,0.0,20,is,2,7,9,2,6,10,-5,7,Tuzla,Bosnia and Herzegovina,LOC,LOC-LOC-LOC,PROPN,PROPN-CCONJ-PROPN,pobj,conj-cc-conj,NNP,NNP-CC-NNP,3,1
0,0.0,19,is,10,8,12,4,7,6,2,2,Sydney,Australia,LOC,LOC,PROPN,PROPN,pobj,poss,NNP,NNP,9,1
1,0.0,19,is,10,10,12,2,9,6,0,2,Perth,Australia,LOC,LOC,PROPN,PROPN,conj,poss,NNP,NNP,3,1
2,2.0,19,established,7,10,13,3,9,5,-3,6,Cottesloe Beach,Western Australia,LOC-LOC,LOC-LOC,PROPN-PROPN,PROPN-PROPN,compound-pobj,compound-pobj,NNP-NNP,NNP-NNP,2,1
3,3.0,22,announced,4,7,9,2,6,12,-3,5,Aarhus,Denmark,LOC,LOC,PROPN,PROPN,nsubj,pobj,NNP,NNP,3,1
0,0.0,34,found,17,14,23,9,13,10,3,6,Kingdom of León,Alfonso VII,LOC-LOC-LOC,PER-PER,PROPN-ADP-PROPN,PROPN-PROPN,pobj-prep-pobj,compound-pobj,NNP-IN-NNP,NNP-NNP,12,1
0,0.0,15,is,3,2,14,12,1,0,1,11,Ask,Smiths,MISC,ORG,VERB,PROPN,csubj,appos,VB,NNP,3,1
1,6.0,25,continued,3,2,6,4,1,18,1,3,Ask,Smiths,MISC,ORG,VERB,PROPN,csubj,poss,VB,NNP,5,1
2,10.0,31,found,3,27,29,2,26,1,-24,26,Rank,1988,MISC,TIME,PROPN,NUM,appos,appos,NNP,CD,2,1
0,0.0,35,is,5,2,30,28,1,4,3,25,Upper Township School District,New Jersey,LOC-LOC-LOC-LOC,LOC-LOC,PROPN-PROPN-PROPN-PROPN,PROPN-PROPN,compound-compound-compound-nsubj,compound-conj,NNP-NNP-NNP-NNP,NNP-NNP,6,1
1,0.0,35,is,5,2,33,31,1,1,3,28,Upper Township School District,United States,LOC-LOC-LOC-LOC,LOC-LOC,PROPN-PROPN-PROPN-PROPN,PROPN-PROPN,compound-compound-compound-nsubj,compound-appos,NNP-NNP-NNP-NNP,NNP-NNP,6,1
2,0.0,35,is,5,2,26,24,1,8,3,21,Upper Township,Cape May County,LOC-LOC,LOC-LOC-LOC,PROPN-PROPN,PROPN-PROPN-PROPN,compound-pobj,compound-compound-pobj,NNP-NNP,NNP-NNP-NNP,6,1
3,0.0,35,is,5,2,33,31,1,1,3,28,Upper Township,United States,LOC-LOC,LOC-LOC,PROPN-PROPN,PROPN-PROPN,compound-pobj,compound-appos,NNP-NNP,NNP-NNP,6,1
4,0.0,35,is,5,26,30,4,25,4,-21,25,Cape May County,New Jersey,LOC-LOC-LOC,LOC-LOC,PROPN-PROPN-PROPN,PROPN-PROPN,compound-compound-pobj,compound-conj,NNP-NNP-NNP,NNP-NNP,2,1
5,0.0,35,is,5,26,33,7,25,1,-21,28,Cape May County,United States,LOC-LOC-LOC,LOC-LOC,PROPN-PROPN-PROPN,PROPN-PROPN,compound-compound-pobj,compound-appos,NNP-NNP-NNP,NNP-NNP,2,1
6,0.0,35,is,5,30,33,3,29,1,-25,28,New Jersey,United States,LOC-LOC,LOC-LOC,PROPN-PROPN,PROPN-PROPN,compound-conj,compound-appos,NNP-NNP,NNP-NNP,2,1
0,0.0,25,"""",0,2,23,21,1,1,-2,23,The People,Finding Forever,MISC-MISC,MISC-MISC,DET-NOUN,PROPN-PROPN,det-nsubj,compound-pobj,DT-NNS,NNP-NNP,4,1
1,8.0,16,received,2,7,13,6,6,2,-5,11,Best Rap Solo Performance,50th Grammy Awards,MISC-MISC-MISC-MISC,MISC-MISC-MISC,PROPN-PROPN-PROPN-PROPN,ADJ-PROPN-PROPN,compound-compound-compound-pobj,amod-compound-pobj,NNP-NNP-NNP-NNP,JJ-NNP-NNPS,7,1
0,6.0,24,is,9,18,23,5,17,0,-9,14,Acholi,Uganda,LOC,LOC,PROPN,PROPN,amod,pobj,NNP,NNP,7,1
0,0.0,18,is,6,9,17,8,8,0,-3,11,GAA,Ireland,ORG,LOC,PROPN,PROPN,compound,appos,NNP,NNP,2,1
1,0.0,18,is,6,12,14,2,11,3,-6,8,Birr,County Offaly,LOC,LOC-LOC,PROPN,PROPN-PROPN,pobj,compound-conj,NNP,NNP-NNP,2,1
2,0.0,18,is,6,12,17,5,11,0,-6,11,Birr,Ireland,LOC,LOC,PROPN,PROPN,pobj,appos,NNP,NNP,5,1
3,0.0,18,is,6,14,17,3,13,0,-8,11,County Offaly,Ireland,LOC-LOC,LOC,PROPN-PROPN,PROPN,compound-conj,appos,NNP-NNP,NNP,5,1
4,3.0,32,was,12,6,9,3,5,22,6,-3,O'Connor Park,Tullamore,LOC-LOC,LOC,PROPN-PROPN,PROPN,compound-pobj,pobj,NNP-NNP,NNP,6,1
5,7.0,34,located,6,25,27,2,24,6,-19,21,Thurles,Tipperary,ORG,LOC,PROPN,PROPN,pobj,dobj,NNP,NNP,2,1
0,0.0,27,was,14,1,5,4,0,21,13,-9,Raymond Clinton Cole,"August 21 , 1870",PER-PER-PER,TIME-TIME-TIME-TIME,PROPN-PROPN-PROPN,PROPN-NUM-PUNCT-NUM,compound-compound-nsubj,appos-nummod-punct-appos,NNP-NNP-NNP,"NNP-CD-,-CD",3,1
1,0.0,27,was,14,1,17,16,0,9,13,3,Raymond Clinton Cole,U.S.,PER-PER-PER,LOC,PROPN-PROPN-PROPN,PROPN,compound-compound-nsubj,compound,NNP-NNP-NNP,NNP,3,1
2,0.0,27,was,14,17,20,3,16,6,-3,6,U.S.,Ohio,LOC,LOC,PROPN,PROPN,compound,pobj,NNP,NNP,1,1
3,1.0,23,attended,11,11,3,-8,10,19,0,-8,Cole,Biglick Township,PER,LOC-LOC,PROPN,PROPN-PROPN,nsubj,compound-pobj,NNP,NNP-NNP,3,1
4,1.0,23,attended,11,11,7,-4,10,15,0,-4,Cole,Findlay College,PER,ORG-ORG,PROPN,PROPN-PROPN,nsubj,compound-conj,NNP,NNP-NNP,4,1
5,7.0,33,elected,2,1,6,5,0,26,1,4,Cole,Republican,PER,ORG,PROPN,PROPN,nsubjpass,pobj,NNP,NNP,2,1
0,0.0,32,is,2,1,26,25,0,5,1,24,Beautiful Surrender,Bethel Music,MISC-MISC,ORG-ORG,ADJ-PROPN,PROPN-PROPN,amod-nsubj,compound-pobj,JJ-NNP,NNP-NNP,3,1
1,2.0,34,was,18,17,26,9,16,7,1,8,Beautiful Surrender,Bethel Music,MISC-MISC,ORG-ORG,PROPN-PROPN,PROPN-PROPN,compound-nsubj,compound-pobj,NNP-NNP,NNP-NNP,8,1
2,0.0,32,is,2,1,29,28,0,2,1,27,Beautiful Surrender,Provident Label Group,MISC-MISC,ORG-ORG-ORG,ADJ-PROPN,PROPN-PROPN-PROPN,amod-nsubj,compound-compound-pobj,JJ-NNP,NNP-NNP-NNP,5,1
0,0.0,31,is,2,1,8,7,0,22,1,6,Gales Creek,Washington County,LOC-LOC,LOC-LOC,PROPN-PROPN,PROPN-PROPN,compound-nsubj,compound-pobj,NNP-NNP,NNP-NNP,4,1
1,0.0,31,is,2,1,11,10,0,19,1,9,Gales Creek,Oregon,LOC-LOC,LOC,PROPN-PROPN,PROPN,compound-nsubj,conj,NNP-NNP,NNP,6,1
2,0.0,31,is,2,1,13,12,0,17,1,11,Gales Creek,United States,LOC-LOC,LOC-LOC,PROPN-PROPN,PROPN-PROPN,compound-nsubj,compound-conj,NNP-NNP,NNP-NNP,6,1
3,0.0,31,is,2,8,11,3,7,19,-6,9,Washington County,Oregon,LOC-LOC,LOC,PROPN-PROPN,PROPN,compound-pobj,conj,NNP-NNP,NNP,2,1
4,0.0,31,is,2,8,13,5,7,17,-6,11,Washington County,United States,LOC-LOC,LOC-LOC,PROPN-PROPN,PROPN-PROPN,compound-pobj,compound-conj,NNP-NNP,NNP-NNP,2,1
5,0.0,31,is,2,11,13,2,10,17,-9,11,Oregon,United States,LOC,LOC-LOC,PROPN,PROPN-PROPN,conj,compound-conj,NNP,NNP-NNP,2,1
0,0.0,38,was,8,1,5,4,0,32,7,-3,Amayak Zakharovich Kobulov,1906,PER-PER-PER,TIME,PROPN-PROPN-PROPN,NUM,compound-compound-nsubj,npadvmod,NNP-NNP-NNP,CD,5,1
1,2.0,68,recruited,9,54,3,-51,53,64,-45,-6,Adolf Hitler,Berlin,PER-PER,LOC,PROPN-PROPN,PROPN,compound-nsubj,pobj,NNP-NNP,NNP,11,1
0,0.0,28,is,3,1,23,22,0,4,2,20,New Creek Mountain,U.S.,LOC-LOC-LOC,LOC,PROPN-PROPN-PROPN,PROPN,compound-compound-nsubj,compound,NNP-NNP-NNP,NNP,5,1
1,0.0,28,is,3,1,26,25,0,1,2,23,New Creek Mountain,West Virginia,LOC-LOC-LOC,LOC-LOC,PROPN-PROPN-PROPN,PROPN-PROPN,compound-compound-nsubj,compound-pobj,NNP-NNP-NNP,NNP-NNP,7,1
2,0.0,28,is,3,10,23,13,9,4,-7,20,Ridge - and - Valley Appalachians,U.S.,LOC-LOC-LOC-LOC-LOC-LOC,LOC,PROPN-PUNCT-CCONJ-PUNCT-PROPN-PROPN,PROPN,nmod-punct-cc-punct-conj-pobj,compound,NNP-HYPH-CC-HYPH-NNP-NNPS,NNP,6,1
3,0.0,28,is,3,17,23,6,16,4,-14,20,Grant,U.S.,LOC,LOC,PROPN,PROPN,nmod,compound,NNP,NNP,8,1
4,0.0,28,is,3,17,26,9,16,1,-14,23,Grant,West Virginia,LOC,LOC-LOC,PROPN,PROPN-PROPN,nmod,compound-pobj,NNP,NNP-NNP,10,1
5,0.0,28,is,3,19,23,4,18,4,-16,20,Mineral,U.S.,LOC,LOC,PROPN,PROPN,conj,compound,NNP,NNP,6,1
6,0.0,28,is,3,19,26,7,18,1,-16,23,Mineral,West Virginia,LOC,LOC-LOC,PROPN,PROPN-PROPN,conj,compound-pobj,NNP,NNP-NNP,8,1
7,0.0,28,is,3,23,26,3,22,1,-20,23,U.S.,West Virginia,LOC,LOC-LOC,PROPN,PROPN-PROPN,compound,compound-pobj,NNP,NNP-NNP,2,1
0,0.0,55,taken,19,1,55,54,0,-1,18,36,Hillary Clinton,U.S.,PER-PER,LOC,PROPN-PROPN,PROPN,compound-nsubj,pobj,NNP-NNP,NNP,-1,1
1,0.0,55,taken,19,1,31,30,0,23,18,12,Hillary Clinton,Arkansas,PER-PER,LOC,PROPN-PROPN,PROPN,compound-nsubj,pobj,NNP-NNP,NNP,5,1
2,0.0,55,taken,19,55,31,-24,54,23,-36,12,U.S.,Arkansas,LOC,LOC,PROPN,PROPN,pobj,pobj,NNP,NNP,-1,1
3,1.0,25,Senator,0,3,15,12,2,9,-3,15,New York,United States,LOC-LOC,LOC-LOC,PROPN-PROPN,PROPN-PROPN,compound-pobj,compound-nmod,NNP-NNP,NNP-NNP,6,1
4,5.0,31,lost,1,9,17,8,8,13,-8,16,US,Donald Trump,LOC,PER-PER,PROPN,PROPN-PROPN,nmod,compound-dobj,NNP,NNP-NNP,5,1
0,0.0,20,is,1,16,18,2,15,1,-15,17,Maryland,United States,LOC,LOC-LOC,PROPN,PROPN-PROPN,conj,compound-appos,NNP,NNP-NNP,2,1
0,3.0,27,released,4,13,9,-4,12,17,-9,5,Dye My Hair,Karma,MISC-MISC-MISC,MISC,PROPN-DET-PROPN,PROPN,compound-poss-conj,appos,NNP-PRP$-NNP,NNP,7,1
0,0.0,26,is,2,9,24,15,8,1,-7,22,Columbia River Gorge,United States,LOC-LOC-LOC,LOC-LOC,PROPN-PROPN-PROPN,PROPN-PROPN,compound-compound-pobj,compound-conj,NNP-NNP-NNP,NNP-NNP,9,1
1,0.0,26,is,2,15,24,9,14,1,-13,22,Troutdale,United States,LOC,LOC-LOC,PROPN,PROPN-PROPN,pobj,compound-conj,NNP,NNP-NNP,7,1
2,0.0,26,is,2,18,24,6,17,1,-16,22,Corbett,United States,LOC,LOC-LOC,PROPN,PROPN-PROPN,pobj,compound-conj,NNP,NNP-NNP,4,1
3,0.0,26,is,2,20,22,2,19,3,-18,20,Dodson,Oregon,LOC,LOC,PROPN,PROPN,conj,conj,NNP,NNP,3,1
4,0.0,26,is,2,20,24,4,19,1,-18,22,Dodson,United States,LOC,LOC-LOC,PROPN,PROPN-PROPN,conj,compound-conj,NNP,NNP-NNP,3,1
5,0.0,26,is,2,22,24,2,21,1,-20,22,Oregon,United States,LOC,LOC-LOC,PROPN,PROPN-PROPN,conj,compound-conj,NNP,NNP-NNP,2,1
0,1.0,47,includes,2,15,27,12,14,19,-13,25,Drakensberg,Lesotho,LOC,LOC,PROPN,PROPN,compound,pobj,NNP,NNP,3,1
1,1.0,47,includes,2,32,38,6,31,8,-30,36,Emlembe,Swaziland,LOC,LOC,PROPN,PROPN,conj,pobj,NNP,NNP,3,1
2,5.0,14,are,5,3,13,10,2,0,2,8,Du Toits Peak,Africa,LOC-LOC-LOC,LOC,PROPN-PROPN-PROPN,PROPN,compound-compound-conj,pobj,NNP-NNP-NNP,NNP,4,1
0,0.0,20,Delaistre,3,1,7,6,0,12,2,4,François - Nicolas Delaistre,9 March 1746,PER-PER-PER-PER,TIME-TIME-TIME,PROPN-PUNCT-PROPN-PROPN,NUM-PROPN-NUM,compound-punct-compound-ROOT,nummod-appos-nummod,NNP-HYPH-NNP-NNP,CD-NNP-CD,4,1
1,0.0,20,Delaistre,3,1,11,10,0,8,2,8,François - Nicolas Delaistre,23 April 1832,PER-PER-PER-PER,TIME-TIME-TIME,PROPN-PUNCT-PROPN-PROPN,NUM-PROPN-NUM,compound-punct-compound-ROOT,nummod-nmod-nummod,NNP-HYPH-NNP-NNP,CD-NNP-CD,4,1
2,0.0,20,Delaistre,3,1,18,17,0,1,2,15,François - Nicolas Delaistre,French,PER-PER-PER-PER,LOC,PROPN-PUNCT-PROPN-PROPN,ADJ,compound-punct-compound-ROOT,amod,NNP-HYPH-NNP-NNP,JJ,4,1
3,2.0,38,studied,10,1,4,3,0,33,9,-6,Delaistre,Prix de Rome,PER,MISC-MISC-MISC,PROPN,PROPN-PROPN-PROPN,nsubj,compound-compound-dobj,NNP,NNP-NNP-NNP,2,1
4,2.0,38,studied,10,1,16,15,0,21,9,6,Delaistre,École royale des élèves protégés,PER,ORG-ORG-ORG-ORG-ORG,PROPN,PROPN-NOUN-NOUN-VERB-NOUN,nsubj,compound-pobj-nsubj-ROOT-amod,NNP,NNP-NN-NN-VBZ-NN,4,1
0,0.0,33,is,4,2,28,26,1,4,2,24,Dover School District,New Jersey,LOC-LOC-LOC,LOC-LOC,PROPN-PROPN-PROPN,PROPN-PROPN,compound-compound-nsubj,compound-conj,NNP-NNP-NNP,NNP-NNP,11,1
1,0.0,33,is,4,2,31,29,1,1,2,27,Dover School District,United States,LOC-LOC-LOC,LOC-LOC,PROPN-PROPN-PROPN,PROPN-PROPN,compound-compound-nsubj,compound-appos,NNP-NNP-NNP,NNP-NNP,9,1
2,0.0,33,is,4,2,25,23,1,7,2,21,Dover,Morris County,LOC,LOC-LOC,PROPN,PROPN-PROPN,pobj,compound-pobj,NNP,NNP-NNP,10,1
3,0.0,33,is,4,2,31,29,1,1,2,27,Dover,United States,LOC,LOC-LOC,PROPN,PROPN-PROPN,pobj,compound-appos,NNP,NNP-NNP,9,1
4,0.0,33,is,4,25,28,3,24,4,-21,24,Morris County,New Jersey,LOC-LOC,LOC-LOC,PROPN-PROPN,PROPN-PROPN,compound-pobj,compound-conj,NNP-NNP,NNP-NNP,1,1
5,0.0,33,is,4,25,31,6,24,1,-21,27,Morris County,United States,LOC-LOC,LOC-LOC,PROPN-PROPN,PROPN-PROPN,compound-pobj,compound-appos,NNP-NNP,NNP-NNP,3,1
6,0.0,33,is,4,28,31,3,27,1,-24,27,New Jersey,United States,LOC-LOC,LOC-LOC,PROPN-PROPN,PROPN-PROPN,compound-conj,compound-appos,NNP-NNP,NNP-NNP,4,1
0,0.0,46,was,14,1,5,4,0,40,13,-9,J. Barry Stout,"November 7 , 1936",PER-PER-PER,TIME-TIME-TIME-TIME,PROPN-PROPN-PROPN,PROPN-NUM-PUNCT-NUM,compound-compound-nsubj,npadvmod-nummod-punct-nummod,NNP-NNP-NNP,"NNP-CD-,-CD",3,1
1,0.0,46,was,14,1,17,16,0,28,13,3,J. Barry Stout,Democratic,PER-PER-PER,ORG,PROPN-PROPN-PROPN,ADJ,compound-compound-nsubj,amod,NNP-NNP-NNP,JJ,3,1
0,0.0,25,said,10,21,24,3,20,0,-11,14,Champagne,France,LOC,LOC,PROPN,PROPN,compound,pobj,NNP,NNP,5,1
0,0.0,28,is,1,1,14,13,0,13,0,13,Enclave,Starbreeze Studios,MISC,ORG-ORG,PROPN,PROPN-PROPN,nsubj,compound-pobj,NNP,NNP-NNP,3,1
1,0.0,28,is,1,1,20,19,0,7,0,19,Enclave,Windows,MISC,MISC,PROPN,PROPN,nsubj,pobj,NNP,NNP,5,1
2,0.0,28,is,1,1,22,21,0,5,0,21,Enclave,Xbox,MISC,MISC,PROPN,PROPN,nsubj,conj,NNP,NNP,3,1
3,0.0,28,is,1,19,20,1,18,7,-18,19,Microsoft,Windows,ORG,MISC,PROPN,PROPN,compound,pobj,NNP,NNP,1,1
0,0.0,28,is,4,1,15,14,0,12,3,11,Corcovado Volcano,Yelcho River,LOC-LOC,LOC-LOC,PROPN-PROPN,PROPN-PROPN,compound-nsubj,compound-pobj,NNP-NNP,NNP-NNP,9,1
1,0.0,28,is,4,1,23,22,0,4,3,19,Corcovado Volcano,Los Lagos Region,LOC-LOC,LOC-LOC-LOC,PROPN-PROPN,PROPN-PROPN-PROPN,compound-nsubj,compound-compound-conj,NNP-NNP,NNP-NNP-NNP,4,1
2,0.0,28,is,4,1,27,26,0,0,3,23,Corcovado Volcano,Chile,LOC-LOC,LOC,PROPN-PROPN,PROPN,compound-nsubj,appos,NNP-NNP,NNP,2,1
3,0.0,28,is,4,15,27,12,14,0,-11,23,Yelcho River,Chile,LOC-LOC,LOC,PROPN-PROPN,PROPN,compound-pobj,appos,NNP-NNP,NNP,9,1
4,0.0,28,is,4,20,23,3,19,4,-16,19,Palena Province,Los Lagos Region,LOC-LOC,LOC-LOC-LOC,PROPN-PROPN,PROPN-PROPN-PROPN,compound-pobj,compound-compound-conj,NNP-NNP,NNP-NNP-NNP,4,1
5,0.0,28,is,4,20,27,7,19,0,-16,23,Palena Province,Chile,LOC-LOC,LOC,PROPN-PROPN,PROPN,compound-pobj,appos,NNP-NNP,NNP,4,1
6,0.0,28,is,4,23,27,4,22,0,-19,23,Los Lagos Region,Chile,LOC-LOC-LOC,LOC,PROPN-PROPN-PROPN,PROPN,compound-compound-conj,appos,NNP-NNP-NNP,NNP,4,1
0,2.0,76,consists,2,23,28,5,22,47,-21,26,Illinois,US,LOC,LOC,PROPN,PROPN,pobj,pobj,NNP,NNP,4,1
0,0.0,24,is,10,1,7,6,0,16,9,-3,Seyed Mohammad Sadegh Kharazi,2 March 1963,PER-PER-PER-PER,TIME-TIME-TIME,PROPN-PROPN-PROPN-PROPN,NUM-PROPN-NUM,amod-compound-compound-compound,nummod-npadvmod-nummod,NNP-NNP-NNP-NNP,CD-NNP-CD,4,1
1,7.0,35,is,1,19,10,-9,18,24,-18,9,Tehran University,Iranian,ORG-ORG,LOC,PROPN-PROPN,ADJ,compound-pobj,amod,NNP-NNP,JJ,3,1
2,7.0,35,is,1,23,10,-13,22,24,-22,9,Cultural Heritage Organization of Iran,Iranian,ORG-ORG-ORG-ORG-ORG,LOC,PROPN-PROPN-PROPN-ADP-PROPN,ADJ,compound-compound-appos-prep-pobj,amod,NNP-NNP-NNP-IN-NNP,JJ,5,1
3,7.0,35,is,1,31,10,-21,30,24,-30,9,National Library of Iran,Iranian,ORG-ORG-ORG-ORG,LOC,PROPN-PROPN-ADP-PROPN,ADJ,compound-conj-prep-pobj,amod,NNP-NNP-IN-NNP,JJ,5,1
0,6.0,23,formed,6,10,22,12,9,0,-4,16,The Vanishing of Ethan Carter,2014,MISC-MISC-MISC-MISC-MISC,TIME,DET-PROPN-ADP-PROPN-PROPN,NUM,det-ROOT-prep-compound-pobj,pobj,DT-NNP-IN-NNP-NNP,CD,3,1
0,0.0,24,is,1,1,8,7,0,15,0,7,Ormstown,Canada,LOC,LOC,PROPN,PROPN,nsubj,appos,NNP,NNP,4,1
1,0.0,24,is,1,6,8,2,5,15,-5,7,Quebec,Canada,LOC,LOC,PROPN,PROPN,pobj,appos,NNP,NNP,2,1
2,1.0,21,is,1,14,19,5,13,1,-13,18,New York State,United States,LOC-LOC-LOC,LOC-LOC,PROPN-PROPN-PROPN,PROPN-PROPN,compound-compound-pobj,compound-pobj,NNP-NNP-NNP,NNP-NNP,5,1
0,0.0,19,is,11,1,10,9,0,8,10,-1,Claude Abadie,Paris,PER-PER,LOC,PROPN-PROPN,PROPN,compound-nsubj,appos,NNP-NNP,NNP,2,1
1,0.0,19,is,11,1,14,13,0,4,10,3,Claude Abadie,French,PER-PER,LOC,PROPN-PROPN,ADJ,compound-nsubj,amod,NNP-NNP,JJ,3,1
0,0.0,34,is,5,2,29,27,1,4,3,24,Runnemede Public School District,New Jersey,LOC-LOC-LOC-LOC,LOC-LOC,PROPN-PROPN-PROPN-PROPN,PROPN-PROPN,compound-compound-compound-nsubj,compound-conj,NNP-NNP-NNP-NNP,NNP-NNP,8,1
1,0.0,34,is,5,2,32,30,1,1,3,27,Runnemede Public School District,United States,LOC-LOC-LOC-LOC,LOC-LOC,PROPN-PROPN-PROPN-PROPN,PROPN-PROPN,compound-compound-compound-nsubj,compound-appos,NNP-NNP-NNP-NNP,NNP-NNP,8,1
2,0.0,34,is,5,2,26,24,1,7,3,21,Runnemede,Camden County,LOC,LOC-LOC,PROPN,PROPN-PROPN,pobj,compound-pobj,NNP,NNP-NNP,7,1
3,0.0,34,is,5,2,32,30,1,1,3,27,Runnemede,United States,LOC,LOC-LOC,PROPN,PROPN-PROPN,pobj,compound-appos,NNP,NNP-NNP,8,1
4,0.0,34,is,5,26,29,3,25,4,-21,24,Camden County,New Jersey,LOC-LOC,LOC-LOC,PROPN-PROPN,PROPN-PROPN,compound-pobj,compound-conj,NNP-NNP,NNP-NNP,1,1
5,0.0,34,is,5,26,32,6,25,1,-21,27,Camden County,United States,LOC-LOC,LOC-LOC,PROPN-PROPN,PROPN-PROPN,compound-pobj,compound-appos,NNP-NNP,NNP-NNP,1,1
6,0.0,34,is,5,29,32,3,28,1,-24,27,New Jersey,United States,LOC-LOC,LOC-LOC,PROPN-PROPN,PROPN-PROPN,compound-conj,compound-appos,NNP-NNP,NNP-NNP,2,1
0,0.0,14,was,8,1,5,4,0,8,7,-3,Harry Gordon Lawrence,1901,PER-PER-PER,TIME,PROPN-PROPN-PROPN,NUM,compound-compound-nsubj,nummod,NNP-NNP-NNP,CD,2,1
1,0.0,14,was,8,1,7,6,0,6,7,-1,Harry Gordon Lawrence,1973,PER-PER-PER,TIME,PROPN-PROPN-PROPN,NUM,compound-compound-nsubj,appos,NNP-NNP-NNP,CD,2,1
2,0.0,14,was,8,1,11,10,0,2,7,3,Harry Gordon Lawrence,South African,PER-PER-PER,LOC-LOC,PROPN-PROPN-PROPN,ADJ-ADJ,compound-compound-nsubj,amod-amod,NNP-NNP-NNP,JJ-JJ,4,1
3,3.0,21,served,1,1,14,13,0,6,0,13,Lawrence,National Party,PER,ORG-ORG,PROPN,PROPN-PROPN,nsubj,compound-nsubj,NNP,NNP-NNP,3,1
4,9.0,30,return,3,14,11,-3,13,18,-11,8,Jan Steytler,Party,PER-PER,ORG,PROPN-PROPN,PROPN,compound-nsubj,compound,NNP-NNP,NNP,4,1
0,0.0,29,is,1,1,18,17,0,10,0,17,KBOI,Idaho,ORG,LOC,PROPN,PROPN,nsubj,appos,NNP,NNP,2,1
1,3.0,17,is,1,1,3,2,0,13,0,2,KBOI,Idaho,ORG,LOC,PROPN,PROPN,nsubj,poss,NNP,NNP,3,1
0,0.0,27,was,12,1,5,4,0,21,11,-7,Mogens Ludolf Fog,9 June 1904,PER-PER-PER,TIME-TIME-TIME,PROPN-PROPN-PROPN,NUM-PROPN-NUM,compound-compound-nsubj,nummod-appos-nummod,NNP-NNP-NNP,CD-NNP-CD,2,1
1,0.0,27,was,12,1,9,8,0,17,11,-3,Mogens Ludolf Fog,16 July 1990,PER-PER-PER,TIME-TIME-TIME,PROPN-PROPN-PROPN,NUM-PROPN-NUM,compound-compound-nsubj,nummod-appos-nummod,NNP-NNP-NNP,CD-NNP-CD,4,1
0,0.0,25,was,11,21,24,3,20,0,-10,13,Ambert,France,LOC,LOC,PROPN,PROPN,pobj,appos,NNP,NNP,3,1
1,11.0,21,died,1,1,4,3,0,16,0,3,Chabrier,Paris,PER,LOC,PROPN,PROPN,nsubj,pobj,NNP,NNP,1,1
0,0.0,45,spelled,6,1,11,10,0,33,5,5,Pari Khan Khanum,1548,PER-PER-PER,TIME,PROPN-PROPN-PROPN,NUM,compound-compound-nsubj,nummod,NNP-NNP-NNP,CD,5,1
1,0.0,45,spelled,6,1,29,28,0,15,5,23,Pari Khan Khanum,Tahmasp I,PER-PER-PER,PER-PER,PROPN-PROPN-PROPN,NOUN-PROPN,compound-compound-nsubj,ROOT-ROOT,NNP-NNP-NNP,NN-NNP,-1,1
2,0.0,45,spelled,6,8,11,3,7,33,-2,5,Parikhan Khanum,1548,PER-PER,TIME,PROPN-PROPN,NUM,compound-dobj,nummod,NNP-NNP,CD,2,1
3,0.0,45,spelled,6,8,29,21,7,15,-2,23,Parikhan Khanum,Tahmasp I,PER-PER,PER-PER,PROPN-PROPN,NOUN-PROPN,compound-dobj,ROOT-ROOT,NNP-NNP,NN-NNP,-1,1
4,1.0,30,was,11,9,19,10,8,10,2,8,Pari Khan Khanum,Islamic,PER-PER-PER,ORG,PROPN-PROPN-PROPN,ADJ,compound-compound-appos,amod,NNP-NNP-NNP,JJ,6,1
5,2.0,25,played,1,13,19,6,12,5,-12,18,Ismail II,1577,PER-PER,TIME,PROPN-PROPN,NUM,compound-appos,nummod,NNP-NNP,CD,8,1
6,3.0,45,lessened,8,22,28,6,21,16,-14,20,Mohammad Khodabanda,1587,PER-PER,TIME,PROPN-PROPN,NUM,compound-appos,nummod,NNP-NNP,CD,2,1
0,1.0,36,was,13,5,9,4,4,26,8,-4,Elli L. Friedmann,Samorin,PER-PER-PER,LOC,PROPN-PROPN-PROPN,PROPN,compound-compound-pobj,pobj,NNP-NNP-NNP,NNP,2,1
1,1.0,36,was,13,9,11,2,8,24,4,-2,Samorin,Czechoslovakia,LOC,LOC,PROPN,PROPN,pobj,conj,NNP,NNP,5,1
0,0.0,20,is,2,1,12,11,0,7,1,10,Bolgatty Palace,India,LOC-LOC,LOC,PROPN-PROPN,PROPN,compound-nsubj,pobj,NNP-NNP,NNP,4,1
1,0.0,20,is,2,1,19,18,0,0,1,17,Bolgatty Palace,Kerala,LOC-LOC,LOC,PROPN-PROPN,PROPN,compound-nsubj,appos,NNP-NNP,NNP,2,1
2,0.0,20,is,2,12,19,7,11,0,-10,17,India,Kerala,LOC,LOC,PROPN,PROPN,pobj,appos,NNP,NNP,4,1
0,0.0,31,is,3,2,10,8,1,20,1,7,Pilot,American,MISC,LOC,PROPN,ADJ,nsubj,amod,NNP,JJ,6,1
1,0.0,31,is,3,2,20,18,1,10,1,17,Pilot,USA,MISC,LOC,PROPN,PROPN,nsubj,compound,NNP,NNP,8,1
2,0.0,31,is,3,2,24,22,1,6,1,21,Pilot,United States,MISC,LOC-LOC,PROPN,PROPN-PROPN,nsubj,compound-pobj,NNP,NNP-NNP,10,1
3,3.0,18,promoted,7,1,4,3,0,13,6,-3,Harvey Specter,Gabriel Macht,PER-PER,PER-PER,PROPN-PROPN,PROPN-PROPN,compound-nsubjpass,compound-appos,NNP-NNP,NNP-NNP,1,1
0,0.0,31,distilled,6,1,1,0,0,29,5,-5,George Washington ’s Rye Whiskey,George Washington,LOC-LOC-LOC-LOC-LOC,PER-PER,PROPN-PROPN-PROPN-PROPN-PROPN,PROPN-PROPN,compound-compound-compound-compound-nsubjpass,compound-compound,NNP-NNP-NNP-NNP-NNP,NNP-NNP,0,1
0,0.0,33,is,4,1,11,10,0,21,3,7,Albania Defiant,Swedish,MISC-MISC,LOC,PROPN-PROPN,ADJ,compound-nsubj,amod,NNP-NNP,JJ,4,1
1,0.0,33,is,4,1,22,21,0,10,3,18,Albania Defiant,1970,MISC-MISC,TIME,PROPN-PROPN,NUM,compound-nsubj,pobj,NNP-NNP,CD,3,1
0,0.0,18,is,13,1,5,4,0,12,12,-8,Erasmus Hendjala,31 December 1947,PER-PER,TIME-TIME-TIME,PROPN-PROPN,NUM-PROPN-NUM,compound-nsubj,nummod-npadvmod-nummod,NNP-NNP,CD-NNP-CD,2,1
1,0.0,18,is,13,1,9,8,0,8,12,-4,Erasmus Hendjala,Omundudu,PER-PER,LOC,PROPN-PROPN,PROPN,compound-nsubj,pobj,NNP-NNP,NNP,4,1
2,0.0,18,is,13,1,16,15,0,1,12,3,Erasmus Hendjala,Namibian,PER-PER,LOC,PROPN-PROPN,ADJ,compound-nsubj,amod,NNP-NNP,JJ,2,1
3,0.0,18,is,13,9,16,7,8,1,4,3,Omundudu,Namibian,LOC,LOC,PROPN,ADJ,pobj,amod,NNP,JJ,6,1
4,0.0,18,is,13,11,16,5,10,1,2,3,Ohangwena Region,Namibian,LOC-LOC,LOC,PROPN-PROPN,ADJ,compound-appos,amod,NNP-NNP,JJ,6,1
5,1.0,38,represented,1,14,16,2,13,21,-13,15,Windhoek,Khomas Region,LOC,LOC-LOC,PROPN,PROPN-PROPN,appos,compound-appos,NNP,NNP-NNP,2,1
0,0.0,13,is,1,1,6,5,0,6,0,5,Sanford,York County,LOC,LOC-LOC,PROPN,PROPN-PROPN,nsubj,compound-pobj,NNP,NNP-NNP,3,1
1,0.0,13,is,1,1,11,10,0,1,0,10,Sanford,United States,LOC,LOC-LOC,PROPN,PROPN-PROPN,nsubj,compound-appos,NNP,NNP-NNP,4,1
2,0.0,13,is,1,6,9,3,5,3,-5,8,York County,Maine,LOC-LOC,LOC,PROPN-PROPN,PROPN,compound-pobj,conj,NNP-NNP,NNP,1,1
3,0.0,13,is,1,6,11,5,5,1,-5,10,York County,United States,LOC-LOC,LOC-LOC,PROPN-PROPN,PROPN-PROPN,compound-pobj,compound-appos,NNP-NNP,NNP-NNP,1,1
4,0.0,13,is,1,9,11,2,8,1,-8,10,Maine,United States,LOC,LOC-LOC,PROPN,PROPN-PROPN,conj,compound-appos,NNP,NNP-NNP,2,1
5,4.0,17,is,1,11,13,2,10,3,-10,12,Biddeford,Maine,LOC,LOC,PROPN,PROPN,pobj,nmod,NNP,NNP,3,1
0,1.0,20,grow,1,17,19,2,16,0,-16,18,Queensland,Australia,LOC,LOC,PROPN,PROPN,pobj,appos,NNP,NNP,6,1
0,0.0,18,is,2,1,14,13,0,3,1,12,Lake County,U.S.,LOC-LOC,LOC,PROPN-PROPN,PROPN,compound-nsubj,compound,NNP-NNP,NNP,6,1
1,0.0,18,is,2,1,17,16,0,0,1,15,Lake County,Oregon,LOC-LOC,LOC,PROPN-PROPN,PROPN,compound-nsubj,pobj,NNP-NNP,NNP,2,1
2,0.0,18,is,2,14,17,3,13,0,-12,15,U.S.,Oregon,LOC,LOC,PROPN,PROPN,compound,pobj,NNP,NNP,6,1
0,0.0,49,took,3,2,8,6,1,40,1,5,Café Wars,Algerian War,MISC-MISC,MISC-MISC,PROPN-PROPN,PROPN-PROPN,compound-nsubj,compound-pobj,NNP-NNPS,NNP-NNP,3,1
1,7.0,22,end,5,19,8,-11,18,13,-14,3,Charles de Gaulle,Algeria,PER-PER-PER,LOC,PROPN-ADP-PROPN,PROPN,compound-compound-pobj,nsubjpass,NNP-IN-NNP,NNP,6,1
0,0.0,35,is,10,18,20,2,17,14,-8,10,Busan,South Korea,LOC,LOC-LOC,PROPN,PROPN-PROPN,pobj,compound-appos,NNP,NNP-NNP,2,1
1,3.0,55,Editor,0,47,16,-31,46,38,-47,16,Gangnam Style,Psy,MISC-MISC,PER,PROPN-PROPN,PROPN,nmod-nmod,poss,NNP-NNP,NNP,12,1
0,0.0,24,is,8,1,5,4,0,18,7,-3,Petre Grosu,27 November 1955,PER-PER,TIME-TIME-TIME,PROPN-PROPN,NUM-PROPN-NUM,compound-nsubj,nummod-npadvmod-nummod,NNP-NNP,CD-NNP-CD,2,1
1,0.0,24,is,8,1,11,10,0,12,7,3,Petre Grosu,Romanian,PER-PER,LOC,PROPN-PROPN,ADJ,compound-nsubj,amod,NNP-NNP,JJ,3,1
0,0.0,31,created,5,9,21,12,8,9,-4,16,American Civil War,United States,MISC-MISC-MISC,LOC-LOC,PROPN-PROPN-PROPN,PROPN-PROPN,compound-compound-pobj,compound-compound,NNP-NNP-NNP,NNP-NNP,9,1
1,2.0,20,presented,3,13,19,6,12,0,-10,16,United States,Congress,LOC-LOC,ORG,PROPN-PROPN,PROPN,compound-pobj,pobj,NNP-NNP,NNP,7,1
2,5.0,21,Levy,0,14,18,4,13,2,-14,18,Battle of Glendale,June 30 1862,MISC-MISC-MISC,TIME-TIME-TIME,PROPN-ADP-PROPN,PROPN-NUM-NUM,pobj-prep-pobj,pobj-nummod-nummod,NNP-IN-NNP,NNP-CD-CD,8,1
3,7.0,24,were,3,5,21,16,4,2,-2,18,Henry Heller,American Civil War,PER-PER,MISC-MISC-MISC,PROPN-PROPN,PROPN-PROPN-PROPN,compound-attr,compound-compound-pobj,NNP-NNP,NNP-NNP-NNP,4,1
4,7.0,24,were,3,8,21,13,7,2,-5,18,David Orbansky,American Civil War,PER-PER,MISC-MISC-MISC,PROPN-PROPN,PROPN-PROPN-PROPN,compound-conj,compound-compound-pobj,NNP-NNP,NNP-NNP-NNP,5,1
5,8.0,21,was,2,17,20,3,16,0,-15,18,Fort Riviere,Haiti,LOC-LOC,LOC,PROPN-PROPN,PROPN,compound-pobj,appos,NNP-NNP,NNP,6,1
0,0.0,34,is,16,24,31,7,23,2,-8,15,Microsoft,Trident,ORG,MISC,PROPN,PROPN,pobj,compound,NNP,NNP,7,1
1,1.0,13,loaded,3,8,8,0,7,4,-5,5,Windows Phone,Windows CE,MISC-MISC,MISC-MISC,PROPN-PROPN,PROPN-PROPN,compound-pobj,compound-conj,NNP-NNP,NNP-NNP,0,1
2,3.0,28,based,21,12,12,0,11,15,9,-9,Windows Phone 7,Windows Mobile,MISC-MISC-MISC,MISC-MISC,PROPN-PROPN-NUM,PROPN-PROPN,compound-pobj-nummod,compound-conj,NNP-NNP-CD,NNP-NNP,0,1
0,0.0,34,was,27,14,16,2,13,17,13,-11,Vienna,Austria,LOC,LOC,PROPN,PROPN,pobj,compound,NNP,NNP,4,1
1,0.0,34,was,27,14,30,16,13,3,13,3,Vienna,Austrian,LOC,LOC,PROPN,ADJ,pobj,amod,NNP,JJ,6,1
2,1.0,18,was,1,1,8,7,0,9,0,7,Rebner,Vienna Conservatory,PER,ORG-ORG,PROPN,PROPN-PROPN,nsubj,compound-pobj,NNP,NNP-NNP,3,1
3,5.0,31,died,11,3,8,5,2,22,8,-3,Edward Wolfgang Rebner,1910,PER-PER-PER,TIME,PROPN-PROPN-PROPN,NUM,compound-compound-appos,npadvmod,NNP-NNP-NNP,CD,4,1
0,0.0,27,is,2,23,26,3,22,0,-21,24,Cape Croker,Ontario,LOC-LOC,LOC,PROPN-PROPN,PROPN,compound-pobj,appos,NNP-NNP,NNP,8,1
1,1.0,20,has,1,14,17,3,13,2,-13,16,York University,Toronto,ORG-ORG,LOC,PROPN-PROPN,PROPN,compound-pobj,pobj,NNP-NNP,NNP,1,1
2,2.0,51,is,4,16,22,6,15,28,-12,18,University of Regina,Saskatchewan,ORG-ORG-ORG,LOC,PROPN-ADP-PROPN,PROPN,pobj-prep-pobj,appos,NNP-IN-NNP,NNP,4,1
3,3.0,19,working,3,14,10,-4,13,8,-11,7,Regina,MacKenzie Art Gallery,LOC,LOC-LOC-LOC,PROPN,PROPN-PROPN-PROPN,pobj,compound-compound-pobj,NNP,NNP-NNP-NNP,4,1
0,1.0,36,defined,11,10,18,8,9,17,1,7,HQMC,United States Code,ORG,MISC-MISC-MISC,PROPN,PROPN-PROPN-PROPN,pobj,compound-compound-pobj,NNP,NNP-NNP-NNP,6,1
0,0.0,17,is,12,1,4,3,0,12,11,-8,Nathan Coenen,Perth,PER-PER,LOC,PROPN-PROPN,PROPN,compound-nsubj,appos,NNP-NNP,NNP,2,1
1,0.0,17,is,12,1,9,8,0,7,11,-3,Nathan Coenen,10 September 1992,PER-PER,TIME-TIME-TIME,PROPN-PROPN,NUM-PROPN-NUM,compound-nsubj,nummod-appos-nummod,NNP-NNP,CD-NNP-CD,2,1
0,0.0,31,is,2,1,5,4,0,25,1,3,Batkid Begins,2015,MISC-MISC,TIME,PROPN-PROPN,NUM,compound-nsubj,nummod,NNP-NNP,CD,3,1
1,0.0,31,is,2,1,23,22,0,7,1,21,Batkid Begins,Kurt Kuenne,MISC-MISC,PER-PER,PROPN-PROPN,PROPN-PROPN,compound-nsubj,compound-pobj,NNP-NNP,NNP-NNP,4,1
2,0.0,31,is,2,1,29,28,0,1,1,27,Batkid Begins,Dana Nachman,MISC-MISC,PER-PER,PROPN-PROPN,PROPN-PROPN,compound-nsubj,compound-pobj,NNP-NNP,NNP-NNP,4,1
3,3.0,59,rallied,16,23,20,-3,22,38,-7,4,California,San Francisco,LOC,LOC-LOC,PROPN,PROPN-PROPN,appos,compound-dobj,NNP,NNP-NNP,2,1
0,0.0,15,is,3,1,10,9,0,4,2,7,Catacol,Isle of Arran,LOC,LOC-LOC-LOC,PROPN,PROPN-ADP-PROPN,nsubj,pobj-prep-pobj,NNP,NNP-IN-NNP,5,1
1,0.0,15,is,3,10,14,4,9,0,-7,11,Isle of Arran,Scotland,LOC-LOC-LOC,LOC,PROPN-ADP-PROPN,PROPN,pobj-prep-pobj,appos,NNP-IN-NNP,NNP,5,1
0,0.0,30,is,5,1,1,0,0,28,4,-4,Hawarden Airport,Hawarden,LOC-LOC,LOC,PROPN-PROPN,PROPN,compound-nsubj,pobj,NNP-NNP,NNP,0,1
1,0.0,30,is,5,1,14,13,0,15,4,9,Hawarden Airport,Wales,LOC-LOC,LOC,PROPN-PROPN,PROPN,compound-nsubj,appos,NNP-NNP,NNP,3,1
2,0.0,30,is,5,1,12,11,0,17,4,7,Hawarden,Flintshire,LOC,LOC,PROPN,PROPN,pobj,pobj,NNP,NNP,7,1
3,0.0,30,is,5,12,14,2,11,15,-7,9,Flintshire,Wales,LOC,LOC,PROPN,PROPN,pobj,appos,NNP,NNP,6,1
0,0.0,21,is,4,2,18,16,1,2,2,14,Toronto Coach Terminal,Ontario,LOC-LOC-LOC,LOC,PROPN-PROPN-PROPN,PROPN,compound-compound-nsubj,conj,NNP-NNP-NNP,NNP,7,1
1,0.0,21,is,4,2,20,18,1,0,2,16,Toronto Coach Terminal,Canada,LOC-LOC-LOC,LOC,PROPN-PROPN-PROPN,PROPN,compound-compound-nsubj,appos,NNP-NNP-NNP,NNP,3,1
2,0.0,21,is,4,2,18,16,1,2,2,14,Toronto,Ontario,LOC,LOC,PROPN,PROPN,pobj,conj,NNP,NNP,7,1
3,0.0,21,is,4,2,20,18,1,0,2,16,Toronto,Canada,LOC,LOC,PROPN,PROPN,pobj,appos,NNP,NNP,3,1
4,0.0,21,is,4,18,20,2,17,0,-14,16,Ontario,Canada,LOC,LOC,PROPN,PROPN,conj,appos,NNP,NNP,6,1
0,0.0,18,is,1,1,15,14,0,2,0,14,Vembannur,Kerala,LOC,LOC,PROPN,PROPN,nsubj,pobj,NNP,NNP,9,1
1,0.0,18,is,1,1,17,16,0,0,0,16,Vembannur,India,LOC,LOC,PROPN,PROPN,nsubj,appos,NNP,NNP,1,1
2,0.0,18,is,1,8,17,9,7,0,-7,16,Nedumangad taluk,India,LOC-LOC,LOC,PROPN-NOUN,PROPN,compound-pobj,appos,NNP-NN,NNP,5,1
3,0.0,18,is,1,12,15,3,11,2,-11,14,Thiruvananthapuram District,Kerala,LOC-LOC,LOC,PROPN-PROPN,PROPN,compound-pobj,pobj,NNP-NNP,NNP,3,1
4,0.0,18,is,1,12,17,5,11,0,-11,16,Thiruvananthapuram District,India,LOC-LOC,LOC,PROPN-PROPN,PROPN,compound-pobj,appos,NNP-NNP,NNP,7,1
5,0.0,18,is,1,15,17,2,14,0,-14,16,Kerala,India,LOC,LOC,PROPN,PROPN,pobj,appos,NNP,NNP,10,1
0,0.0,26,was,12,1,5,4,0,20,11,-7,Viacheslav Aleksandrovich Malyshev,3 December 1902,PER-PER-PER,TIME-TIME-TIME,PROPN-PROPN-PROPN,NUM-PROPN-NUM,compound-compound-nsubj,nummod-appos-nummod,NNP-NNP-NNP,CD-NNP-CD,2,1
1,0.0,26,was,12,1,9,8,0,16,11,-3,Viacheslav Aleksandrovich Malyshev,20 February 1957,PER-PER-PER,TIME-TIME-TIME,PROPN-PROPN-PROPN,NUM-PROPN-NUM,compound-compound-nsubj,nummod-appos-nummod,NNP-NNP-NNP,CD-NNP-CD,2,1
2,0.0,26,was,12,1,19,18,0,6,11,7,Viacheslav Aleksandrovich Malyshev,Soviet,PER-PER-PER,LOC,PROPN-PROPN-PROPN,ADJ,compound-compound-nsubj,amod,NNP-NNP-NNP,JJ,7,1
3,5.0,68,led,1,29,49,20,28,18,-28,48,Nikolai Kuznetsov,Red Fleet,PER-PER,ORG-ORG,PROPN-PROPN,PROPN-PROPN,compound-dobj,compound-dobj,NNP-NNP,NNP-NNP,7,1
0,3.0,30,established,3,13,27,14,12,2,-10,24,Daniel Waggoner,William Thomas Waggoner,PER-PER,PER-PER-PER,PROPN-PROPN,PROPN-PROPN-PROPN,compound-pobj,compound-compound-attr,NNP-NNP,NNP-NNP-NNP,7,1
1,4.0,24,acquired,2,5,12,7,4,11,-3,10,Stan Kroenke,Ann Walton,PER-PER,PER-PER,PROPN-PROPN,PROPN-PROPN,compound-pobj,compound-pobj,NNP-NNP,NNP-NNP,4,1
0,0.0,26,lies,3,2,21,19,1,4,1,18,Karangahake Gorge,New Zealand,LOC-LOC,LOC-LOC,PROPN-PROPN,PROPN-PROPN,compound-nsubj,compound-poss,NNP-NNP,NNP-NNP,9,1
1,0.0,26,lies,3,7,21,14,6,4,-4,18,Coromandel,New Zealand,LOC,LOC-LOC,PROPN,PROPN-PROPN,nmod,compound-poss,NNP,NNP-NNP,11,1
2,0.0,26,lies,3,9,21,12,8,4,-6,18,Kaimai,New Zealand,LOC,LOC-LOC,PROPN,PROPN-PROPN,conj,compound-poss,NNP,NNP-NNP,7,1
3,0.0,26,lies,3,7,21,14,6,4,-4,18,Coromandel Peninsula,New Zealand,LOC-LOC,LOC-LOC,PROPN-PROPN,PROPN-PROPN,compound-pobj,compound-poss,NNP-NNP,NNP-NNP,11,1
4,0.0,26,lies,3,7,24,17,6,1,-4,21,Coromandel Peninsula,North Island,LOC-LOC,LOC-LOC,PROPN-PROPN,PROPN-PROPN,compound-pobj,compound-pobj,NNP-NNP,NNP-NNP,10,1
0,0.0,24,is,10,15,18,3,14,5,-5,8,Chile,Santiago Province,LOC,LOC-LOC,PROPN,PROPN-PROPN,pobj,compound-pobj,NNP,NNP-NNP,2,1
1,0.0,24,is,10,15,18,3,14,5,-5,8,Chile,Santiago Metropolitan Region,LOC,LOC-LOC-LOC,PROPN,PROPN-PROPN-PROPN,pobj,compound-compound-appos,NNP,NNP-NNP-NNP,2,1
2,0.0,24,is,10,18,18,0,17,5,-8,8,Santiago Province,Santiago Metropolitan Region,LOC-LOC,LOC-LOC-LOC,PROPN-PROPN,PROPN-PROPN-PROPN,compound-pobj,compound-compound-appos,NNP-NNP,NNP-NNP-NNP,0,1
0,2.0,38,occupied,3,5,21,16,4,16,-2,18,North America,United States of America,LOC-LOC,LOC-LOC-LOC-LOC,PROPN-PROPN,PROPN-PROPN-ADP-PROPN,compound-dobj,compound-pobj-prep-pobj,NNP-NNP,NNP-NNP-IN-NNP,8,1
1,2.0,38,occupied,3,5,26,21,4,11,-2,23,North America,Canada,LOC-LOC,LOC,PROPN-PROPN,PROPN,compound-dobj,conj,NNP-NNP,NNP,5,1
2,9.0,20,is,5,2,5,3,1,14,3,0,Lindenmeier Site,Colorado,LOC-LOC,LOC,PROPN-PROPN,PROPN,compound-nsubj,pobj,NNP-NNP,NNP,1,1
0,1.0,26,were,4,1,16,15,0,9,3,12,Lone Horn,Touch the Clouds,PER-PER,PER-PER-PER,PROPN-PROPN,VERB-DET-PROPN,compound-poss,conj-det-dobj,NNP-NNP,VB-DT-NNPS,5,1
1,2.0,47,was,40,8,13,5,7,33,32,-27,Treaty of Fort Laramie,1868,MISC-MISC-MISC-MISC,TIME,PROPN-ADP-PROPN-PROPN,NUM,pobj-prep-compound-pobj,pobj,NNP-IN-NNP-NNP,CD,6,1
2,2.0,47,was,40,33,37,4,32,9,7,-3,Old Chief Smoke,1774,PER-PER-PER,TIME,PROPN-PROPN-NOUN,NUM,compound-compound-nsubj,nummod,NNP-NNP-NN,CD,3,1
3,2.0,47,was,40,33,39,6,32,7,7,-1,Old Chief Smoke,1864,PER-PER-PER,TIME,PROPN-PROPN-NOUN,NUM,compound-compound-nsubj,nummod,NNP-NNP-NN,CD,2,1
4,3.0,12,died,2,1,5,4,0,6,1,3,Lone Horn,Bear Butte,PER-PER,LOC-LOC,PROPN-PROPN,PROPN-PROPN,compound-nsubj,compound-pobj,NNP-NNP,NNP-NNP,3,1
5,3.0,12,died,2,1,8,7,0,3,1,6,Lone Horn,1877,PER-PER,TIME,PROPN-PROPN,NUM,compound-nsubj,pobj,NNP-NNP,CD,2,1
6,4.0,32,became,11,27,31,4,26,0,-16,20,Wounded Knee Massacre,1890,MISC-MISC-MISC,TIME,VERB-PROPN-PROPN,NUM,compound-compound-pobj,pobj,VBN-NNP-NNP,CD,7,1
0,0.0,41,is,4,1,33,32,0,7,3,29,Mount Inderbitzen,Sentinel Range,LOC-LOC,LOC-LOC,PROPN-PROPN,PROPN-PROPN,compound-nsubj,compound-pobj,NNP-NNP,NNP-NNP,5,1
1,0.0,41,is,4,1,40,39,0,0,3,36,Mount Inderbitzen,Antarctica,LOC-LOC,LOC,PROPN-PROPN,PROPN,compound-nsubj,pobj,NNP-NNP,NNP,2,1
2,0.0,41,is,4,1,33,32,0,7,3,29,Mount Craddock,Sentinel Range,LOC-LOC,LOC-LOC,PROPN-PROPN,PROPN-PROPN,compound-pobj,compound-pobj,NNP-NNP,NNP-NNP,5,1
3,0.0,41,is,4,1,40,39,0,0,3,36,Mount Craddock,Antarctica,LOC-LOC,LOC,PROPN-PROPN,PROPN,compound-pobj,pobj,NNP-NNP,NNP,2,1
4,0.0,41,is,4,1,33,32,0,7,3,29,Mount Milton,Sentinel Range,LOC-LOC,LOC-LOC,PROPN-PROPN,PROPN-PROPN,compound-pobj,compound-pobj,NNP-NNP,NNP-NNP,5,1
5,0.0,41,is,4,1,40,39,0,0,3,36,Mount Milton,Antarctica,LOC-LOC,LOC,PROPN-PROPN,PROPN,compound-pobj,pobj,NNP-NNP,NNP,2,1
6,0.0,41,is,4,25,33,8,24,7,-21,29,Owen Ridge,Sentinel Range,LOC-LOC,LOC-LOC,PROPN-PROPN,PROPN-PROPN,compound-pobj,compound-pobj,NNP-NNP,NNP-NNP,10,1
7,0.0,41,is,4,25,40,15,24,0,-21,36,Owen Ridge,Antarctica,LOC-LOC,LOC,PROPN-PROPN,PROPN,compound-pobj,pobj,NNP-NNP,NNP,9,1
8,0.0,41,is,4,33,37,4,32,3,-29,33,Sentinel Range,Ellsworth Mountains,LOC-LOC,LOC-LOC,PROPN-PROPN,PROPN-PROPN,compound-pobj,compound-pobj,NNP-NNP,NNP-NNPS,2,1
9,0.0,41,is,4,33,40,7,32,0,-29,36,Sentinel Range,Antarctica,LOC-LOC,LOC,PROPN-PROPN,PROPN,compound-pobj,pobj,NNP-NNP,NNP,5,1
10,0.0,41,is,4,37,40,3,36,0,-33,36,Ellsworth Mountains,Antarctica,LOC-LOC,LOC,PROPN-PROPN,PROPN,compound-pobj,pobj,NNP-NNPS,NNP,7,1
11,5.0,36,was,5,5,31,26,4,4,0,26,Inderbitzen,U.S.,PER,LOC,PROPN,PROPN,nsubj,nmod,NNP,NNP,5,1
12,5.0,36,was,5,19,31,12,18,4,-14,26,United States Antarctic Program,U.S.,MISC-MISC-MISC-MISC,LOC,PROPN-PROPN-PROPN-PROPN,PROPN,compound-compound-compound-pobj,nmod,NNP-NNP-NNP-NNP,NNP,13,1
0,0.0,19,is,1,1,18,17,0,0,0,17,Wabaningo,Michigan,LOC,LOC,PROPN,PROPN,nsubj,pobj,NNP,NNP,1,1
1,0.0,19,is,1,8,11,3,7,7,-7,10,Fruitland Township,Muskegon County,LOC-LOC,LOC-LOC,PROPN-PROPN,PROPN-PROPN,compound-pobj,compound-appos,NNP-NNP,NNP-NNP,1,1
2,0.0,19,is,1,8,15,7,7,3,-7,14,Fruitland Township,U.S.,LOC-LOC,LOC,PROPN-PROPN,PROPN,compound-pobj,compound,NNP-NNP,NNP,3,1
3,0.0,19,is,1,11,15,4,10,3,-10,14,Muskegon County,U.S.,LOC-LOC,LOC,PROPN-PROPN,PROPN,compound-appos,compound,NNP-NNP,NNP,2,1
4,0.0,19,is,1,11,18,7,10,0,-10,17,Muskegon County,Michigan,LOC-LOC,LOC,PROPN-PROPN,PROPN,compound-appos,pobj,NNP-NNP,NNP,5,1
5,0.0,19,is,1,15,18,3,14,0,-14,17,U.S.,Michigan,LOC,LOC,PROPN,PROPN,compound,pobj,NNP,NNP,7,1
0,0.0,23,Petit,1,1,4,3,0,18,0,3,Pierre Petit,8 December 1594,PER-PER,TIME-TIME-TIME,PROPN-PROPN,NUM-PROPN-NUM,compound-ROOT,nummod-appos-nummod,NNP-NNP,CD-NNP-CD,1,1
1,1.0,6,born,2,1,5,4,0,0,1,3,Petit,Montluçon,PER,LOC,PROPN,PROPN,nsubjpass,pobj,NNP,NNP,2,1
2,6.0,24,served,2,11,11,0,10,12,-9,9,Louis XIII,Louis XIV,PER-PER,PER-PER,PROPN-PROPN,PROPN-PROPN,compound-pobj,compound-conj,NNP-NNP,NNP-NNP,0,1
0,0.0,50,is,10,4,28,24,3,21,6,18,Lake Superior,US,LOC-LOC,LOC,PROPN-PROPN,PROPN,compound-nsubj,compound,NNP-NNP,NNP,2,1
1,0.0,50,is,10,28,39,11,27,10,-18,29,US,North America,LOC,LOC-LOC,PROPN,PROPN-PROPN,compound,compound-pobj,NNP,NNP-NNP,4,1
0,0.0,24,(;,1,14,16,2,13,7,-13,15,Fuzhou,Fujian,LOC,LOC,PROPN,PROPN,pobj,compound,NNP,NNP,2,1
1,1.0,30,located,3,18,27,9,17,2,-15,24,Fuzhou,East China Sea,LOC,LOC-LOC-LOC,PROPN,PROPN-PROPN-PROPN,poss,compound-compound-pobj,NNP,NNP-NNP-NNP,6,1
2,1.0,30,located,3,14,27,13,13,2,-11,24,Min River,East China Sea,LOC-LOC,LOC-LOC-LOC,PROPN-PROPN,PROPN-PROPN-PROPN,compound-pobj,compound-compound-pobj,NNP-NNP,NNP-NNP-NNP,8,1
0,0.0,17,is,8,1,5,4,0,11,7,-3,Norman Boyd,16 October 1961,PER-PER,TIME-TIME-TIME,PROPN-PROPN,NUM-PROPN-NUM,compound-nsubj,nummod-npadvmod-nummod,NNP-NNP,CD-NNP-CD,2,1
1,1.0,19,born,2,1,5,4,0,13,1,3,Boyd,Belfast,PER,LOC,PROPN,PROPN,nsubjpass,pobj,NNP,NNP,2,1
2,1.0,19,born,2,1,12,11,0,6,1,10,Boyd,Newtownabbey Technical College,PER,ORG-ORG-ORG,PROPN,PROPN-PROPN-PROPN,nsubjpass,compound-compound-conj,NNP,NNP-NNP-NNP,5,1
3,4.0,51,acted,1,45,49,4,44,1,-44,48,Democratic Unionist Party,William McCrea,ORG-ORG-ORG,PER-PER,PROPN-PROPN-PROPN,PROPN-PROPN,compound-compound-compound,compound-dobj,NNP-NNP-NNP,NNP-NNP,3,1
0,0.0,29,is,6,1,24,23,0,4,5,18,Wrangler : Anatomy of an Icon,Jeffrey Schwarz,MISC-MISC-MISC-MISC-MISC-MISC,PER-PER,NOUN-PUNCT-PROPN-ADP-DET-PROPN,PROPN-PROPN,dep-punct-nsubj-prep-det-pobj,compound-pobj,NN-:-NNP-IN-DT-NNP,NNP-NNP,9,1
0,0.0,24,is,10,1,7,6,0,16,9,-3,Nallari Kiran Kumar Reddy,13 September 1960,PER-PER-PER-PER,TIME-TIME-TIME,PROPN-PROPN-PROPN-PROPN,NUM-PROPN-NUM,compound-compound-compound-nsubj,nummod-npadvmod-nummod,NNP-NNP-NNP-NNP,CD-NNP-CD,3,1
1,0.0,24,is,10,1,13,12,0,10,9,3,Nallari Kiran Kumar Reddy,Indian,PER-PER-PER-PER,LOC,PROPN-PROPN-PROPN-PROPN,ADJ,compound-compound-compound-nsubj,amod,NNP-NNP-NNP-NNP,JJ,3,1
2,0.0,24,is,10,13,22,9,12,1,-3,12,Indian,Andhra Pradesh,LOC,LOC-LOC,ADJ,PROPN-PROPN,amod,compound-pobj,JJ,NNP-NNP,5,1
0,0.0,28,Got,2,1,19,18,0,8,1,17,You 've Got to Walk It Like You Talk It or You 'll Lose That Beat,1971,MISC-MISC-MISC-MISC-MISC-MISC-MISC-MISC-MISC-MISC-MISC-MISC-MISC-MISC-MISC-MISC,TIME,PRON-VERB-VERB-PART-VERB-PRON-ADP-PRON-VERB-PRON-CCONJ-PRON-VERB-VERB-DET-PROPN,NUM,nsubj-aux-ROOT-aux-xcomp-dobj-ROOT-pobj-compound-ROOT-cc-conj-aux-ROOT-det-nsubj,nummod,PRP-VBP-VBN-TO-VB-PRP-IN-PRP-VBP-PRP-CC-PRP-MD-VB-DT-NNP,CD,4,1
1,0.0,28,Got,2,1,26,25,0,1,1,24,You 've Got to Walk It Like You Talk It or You 'll Lose That Beat,Peter Locke,MISC-MISC-MISC-MISC-MISC-MISC-MISC-MISC-MISC-MISC-MISC-MISC-MISC-MISC-MISC-MISC,PER-PER,PRON-VERB-VERB-PART-VERB-PRON-ADP-PRON-VERB-PRON-CCONJ-PRON-VERB-VERB-DET-PROPN,PROPN-PROPN,nsubj-aux-ROOT-aux-xcomp-dobj-ROOT-pobj-compound-ROOT-cc-conj-aux-ROOT-det-nsubj,compound-pobj,PRP-VBP-VBN-TO-VB-PRP-IN-PRP-VBP-PRP-CC-PRP-MD-VB-DT-NNP,NNP-NNP,7,1
2,2.0,29,includes,2,11,27,16,10,1,-9,25,Donald Fagen,Steely Dan,PER-PER,ORG-ORG,PROPN-PROPN,PROPN-PROPN,compound-pobj,compound-appos,NNP-NNP,NNP-NNP,3,1
0,1.0,17,was,4,11,15,4,10,1,-7,11,Freaks and Geeks,1999–2000,MISC-MISC-MISC,TIME,PROPN-CCONJ-PROPN,NUM,appos-cc-conj,npadvmod,NNP-CC-NNPS,CD,4,1
1,2.0,37,received,1,10,13,3,9,23,-9,12,Mean Girls,2004,MISC-MISC,TIME,PROPN-NOUN,NUM,compound-ROOT,appos,NNP-NNS,CD,1,1
2,2.0,37,received,1,16,18,2,15,18,-15,17,Cloverfield,2008,MISC,TIME,PROPN,NUM,conj,appos,NNP,CD,2,1
3,3.0,30,starred,3,9,11,2,8,18,-6,8,Related,2005,MISC,TIME,PROPN,NUM,dobj,nummod,NNP,CD,3,1
4,3.0,30,starred,3,23,26,3,22,3,-20,23,Party Down,2009,MISC-MISC,TIME,PROPN-PROPN,NUM,compound-conj,nummod,NNP-NNP,CD,1,1
5,5.0,51,include,4,47,49,2,46,1,-43,45,Extinction,2018,MISC,TIME,PROPN,NUM,conj,npadvmod,NNP,CD,2,1
0,0.0,35,is,8,28,34,6,27,0,-20,26,Osmothèque,Versailles,ORG,LOC,PROPN,PROPN,pobj,pobj,NNP,NNP,8,1
1,1.0,12,born,2,9,11,2,8,0,-7,9,Brittany,France,LOC,LOC,PROPN,PROPN,pobj,appos,NNP,NNP,4,1
0,0.0,28,was,3,1,9,8,0,18,2,6,Island Number Ten,Mississippi River,LOC-LOC-LOC,LOC-LOC,PROPN-PROPN-NUM,PROPN-PROPN,compound-nsubj-nummod,compound-pobj,NNP-NNP-CD,NNP-NNP,4,1
1,0.0,28,was,3,1,14,13,0,13,2,11,Island Number Ten,Tennessee,LOC-LOC-LOC,LOC,PROPN-PROPN-NUM,PROPN,compound-nsubj-nummod,conj,NNP-NNP-CD,NNP,8,1
2,0.0,28,was,3,9,14,5,8,13,-6,11,Mississippi River,Tennessee,LOC-LOC,LOC,PROPN-PROPN,PROPN,compound-pobj,conj,NNP-NNP,NNP,4,1
3,1.0,41,began,8,39,34,-5,38,6,-31,26,Illinois,Ohio River,LOC,LOC-LOC,PROPN,PROPN-PROPN,appos,compound-pobj,NNP,NNP-NNP,10,1
4,1.0,41,began,8,20,34,14,19,6,-12,26,Lower Mississippi River,Ohio River,LOC-LOC-LOC,LOC-LOC,PROPN-PROPN-PROPN,PROPN-PROPN,compound-compound-pobj,compound-pobj,NNP-NNP-NNP,NNP-NNP,12,1
0,0.0,22,Make,0,1,12,11,0,9,-1,12,Make You Happy,Divinyls,MISC-MISC-MISC,ORG,VERB-PRON-ADJ,PROPN,ROOT-nsubj-nsubj,pobj,VB-PRP-JJ,NNP,4,1
1,1.0,41,consists,1,14,20,6,13,20,-13,19,Boys in Town,Science Fiction,MISC-MISC-MISC,MISC-MISC,PROPN-ADP-PROPN,PROPN-NOUN,appos-prep-pobj,compound-appos,NNPS-IN-NNP,NNP-NN,9,1
2,3.0,30,is,9,5,20,15,4,9,4,11,Love in Motion,Divinyls,MISC-MISC-MISC,ORG,NOUN-ADP-PROPN,PROPN,conj-prep-pobj,poss,NN-IN-NNP,NNP,9,1
3,3.0,30,is,9,22,20,-2,21,9,-13,11,Christina Amphlett,Divinyls,PER-PER,ORG,PROPN-PROPN,PROPN,compound-nsubj,poss,NNP-NNP,NNP,2,1
0,0.0,32,is,2,1,1,0,0,30,1,-1,Thurrock Independents,Thurrock,ORG-ORG,LOC,PROPN-PROPN,PROPN,compound-nsubj,pobj,NNP-NNPS,NNP,0,1
1,0.0,32,is,2,1,12,11,0,19,1,10,Thurrock,Essex,LOC,LOC,PROPN,PROPN,pobj,appos,NNP,NNP,4,1
0,5.0,30,comes,5,14,29,15,13,0,-9,24,Roots Radicals,Rancid,MISC-MISC,ORG,PROPN-PROPN,PROPN,compound-appos,pobj,NNP-NNPS,NNP,-1,1
1,6.0,18,is,5,7,4,-3,6,13,-2,-1,Tim Armstrong,Hellcat Records,PER-PER,ORG-ORG,PROPN-PROPN,PROPN-PROPN,compound-attr,compound-pobj,NNP-NNP,NNP-NNPS,4,1
2,6.0,18,is,5,7,17,10,6,0,-2,12,Tim Armstrong,Rancid,PER-PER,ORG,PROPN-PROPN,PROPN,compound-attr,pobj,NNP-NNP,NNP,2,1
0,0.0,21,is,2,1,11,10,0,9,1,9,Crimson Skies,Zipper Interactive,MISC-MISC,ORG-ORG,PROPN-PROPN,PROPN-PROPN,compound-nsubj,compound-pobj,NNP-NNPS,NNP-NNP,5,1
1,0.0,21,is,2,1,16,15,0,4,1,14,Crimson Skies,2000,MISC-MISC,TIME,PROPN-PROPN,NUM,compound-nsubj,pobj,NNP-NNPS,CD,5,1
2,0.0,21,is,2,1,18,17,0,2,1,16,Crimson Skies,Microsoft Game Studios,MISC-MISC,ORG-ORG-ORG,PROPN-PROPN,PROPN-PROPN-PROPN,compound-nsubj,compound-compound-pobj,NNP-NNPS,NNP-NNP-NNP,7,1
3,3.0,41,set,3,10,39,29,9,1,-7,36,the United States,North America,LOC-LOC-LOC,LOC-LOC,DET-PROPN-PROPN,PROPN-PROPN,det-compound-nsubj,compound-pobj,DT-NNP-NNP,NNP-NNP,8,1
0,0.0,41,was,9,1,4,3,0,36,8,-5,Anicia Juliana,Constantinople,PER-PER,LOC,PROPN-PROPN,PROPN,compound-nsubj,appos,NNP-NNP,NNP,2,1
1,0.0,41,was,9,1,23,22,0,17,8,14,Anicia Juliana,Olybrius,PER-PER,PER,PROPN-PROPN,PROPN,compound-nsubj,pobj,NNP-NNP,NNP,6,1
2,0.0,41,was,9,1,30,29,0,10,8,21,Anicia Juliana,Placidia,PER-PER,PER,PROPN-PROPN,PROPN,compound-nsubj,pobj,NNP-NNP,NNP,6,1
3,0.0,41,was,9,39,30,-9,38,10,-30,21,Licinia Eudoxia,Placidia,PER-PER,PER,PROPN-PROPN,PROPN,compound-conj,pobj,NNP-NNP,NNP,4,1
4,0.0,41,was,9,39,36,-3,38,4,-30,27,Licinia Eudoxia,Valentinian III,PER-PER,PER-PER,PROPN-PROPN,PROPN-PROPN,compound-conj,compound-pobj,NNP-NNP,NNP-NNP,1,1
5,0.0,41,was,9,23,30,7,22,10,-14,21,Olybrius,Placidia,PER,PER,PROPN,PROPN,pobj,pobj,NNP,NNP,8,1
6,0.0,41,was,9,30,36,6,29,4,-21,27,Placidia,Valentinian III,PER,PER-PER,PROPN,PROPN-PROPN,pobj,compound-pobj,NNP,NNP-NNP,3,1
0,0.0,15,is,2,1,13,12,0,1,1,11,Pinkerton Academy,United States,ORG-ORG,LOC-LOC,PROPN-PROPN,PROPN-PROPN,compound-nsubj,compound-appos,NNP-NNP,NNP-NNP,6,1
1,0.0,15,is,2,8,13,5,7,1,-6,11,Derry,United States,LOC,LOC-LOC,PROPN,PROPN-PROPN,pobj,compound-appos,NNP,NNP-NNP,3,1
2,0.0,15,is,2,10,13,3,9,1,-8,11,New Hampshire,United States,LOC-LOC,LOC-LOC,PROPN-PROPN,PROPN-PROPN,compound-conj,compound-appos,NNP-NNP,NNP-NNP,1,1
0,1.0,78,merged,30,43,2,-41,42,75,-13,-28,UniCredit Banca,1 July 2002,ORG-ORG,TIME-TIME-TIME,PROPN-PROPN,NUM-PROPN-NUM,compound-pobj,nummod-pobj-nummod,NNP-NNP,CD-NNP-CD,6,1
1,1.0,78,merged,30,43,6,-37,42,71,-13,-24,UniCredit Banca,Rolo Banca,ORG-ORG,ORG-ORG,PROPN-PROPN,PROPN-PROPN,compound-pobj,compound-nsubjpass,NNP-NNP,NNP-NNP,5,1
2,1.0,78,merged,30,43,7,-36,42,70,-13,-23,UniCredit Banca,Banca CRT,ORG-ORG,ORG-ORG,PROPN-PROPN,PROPN-PROPN,compound-pobj,compound-conj,NNP-NNP,NNP-NNP,6,1
3,1.0,78,merged,30,43,6,-37,42,71,-13,-24,UniCredit,Rolo Banca,ORG,ORG-ORG,PROPN,PROPN-PROPN,pobj,compound-nsubjpass,NNP,NNP-NNP,5,1
4,1.0,78,merged,30,43,7,-36,42,70,-13,-23,UniCredit,Banca CRT,ORG,ORG-ORG,PROPN,PROPN-PROPN,pobj,compound-conj,NNP,NNP-NNP,6,1
5,2.0,27,gained,16,4,13,9,3,13,12,-3,Capitalia Group,2007,ORG-ORG,TIME,PROPN-PROPN,NUM,compound-dobj,pobj,NNP-NNP,CD,3,1
6,5.0,24,absorbed,6,4,2,-2,3,21,2,-4,UniCredit Banca,2010,ORG-ORG,TIME,PROPN-PROPN,NUM,compound-nsubjpass,pobj,NNP-NNP,CD,2,1
7,5.0,24,absorbed,6,4,4,0,3,19,2,-2,UniCredit Banca,UniCredit S.p . A.,ORG-ORG,ORG-ORG-ORG-ORG,PROPN-PROPN,PROPN-PROPN-PUNCT-PROPN,compound-nsubjpass,nmod-nmod-punct-appos,NNP-NNP,NNP-NNP-.-NNP,0,1
0,5.0,25,featured,13,20,24,4,19,0,-7,11,Apple,iPod,ORG,MISC,PROPN,PROPN,poss,conj,NNP,NNP,7,1
1,10.0,10,released,1,7,9,2,6,0,-6,8,Futurinô,2009,MISC,TIME,PROPN,NUM,appos,pobj,NNP,CD,2,1
0,0.0,28,was,12,1,5,4,0,22,11,-7,Garlin Murl Conner,2 June 1919,PER-PER-PER,TIME-TIME-TIME,PROPN-PROPN-PROPN,NUM-PROPN-NUM,compound-compound-nsubj,nummod-appos-nummod,NNP-NNP-NNP,CD-NNP-CD,2,1
1,0.0,28,was,12,1,9,8,0,18,11,-3,Garlin Murl Conner,5 November 1998,PER-PER-PER,TIME-TIME-TIME,PROPN-PROPN-PROPN,NUM-PROPN-NUM,compound-compound-nsubj,nummod-npadvmod-nummod,NNP-NNP-NNP,CD-NNP-CD,2,1
2,0.0,28,was,12,1,15,14,0,12,11,3,Garlin Murl Conner,United States Army,PER-PER-PER,ORG-ORG-ORG,PROPN-PROPN-PROPN,PROPN-PROPN-PROPN,compound-compound-nsubj,compound-nmod-nmod,NNP-NNP-NNP,NNP-NNP-NNP,5,1
3,0.0,28,was,12,1,25,24,0,2,11,13,Garlin Murl Conner,Second World War,PER-PER-PER,MISC-MISC-MISC,PROPN-PROPN-PROPN,PROPN-PROPN-PROPN,compound-compound-nsubj,compound-compound-pobj,NNP-NNP-NNP,NNP-NNP-NNP,7,1
4,3.0,29,took,25,12,17,5,11,11,13,-8,Medal of Honor,United States,MISC-MISC-MISC,LOC-LOC,PROPN-ADP-PROPN,PROPN-PROPN,pobj-prep-pobj,compound-compound,NNP-IN-NNP,NNP-NNP,7,1
0,0.0,62,born,5,53,61,8,52,0,-48,56,Kiss from a Rose,1994,MISC-MISC-MISC-MISC,TIME,VERB-ADP-DET-PROPN,NUM,attr-prep-det-pobj,pobj,VB-IN-DT-NNP,CD,6,1
1,2.0,42,received,5,30,33,3,29,8,-25,28,Killer,1990,MISC,TIME,PROPN,NUM,pobj,appos,NNP,CD,2,1
2,2.0,42,received,5,30,37,7,29,4,-25,32,Killer,Crazy,MISC,MISC,PROPN,PROPN,pobj,conj,NNP,NNP,3,1
0,0.0,21,is,9,1,6,5,0,14,8,-3,Peter Iwers,15 May 1975,PER-PER,TIME-TIME-TIME,PROPN-PROPN,NUM-PROPN-NUM,compound-nsubj,nummod-pobj-nummod,NNP-NNP,CD-NNP-CD,3,1
1,1.0,29,played,1,28,4,-24,27,24,-27,3,Whoracle,In Flames,MISC,ORG-ORG,PROPN,ADP-PROPN,pobj,compound-pobj,NNP,IN-NNP,3,1
2,1.0,29,played,1,4,21,17,3,7,-3,20,In Flames,Johan Larsson,ORG-ORG,PER-PER,ADP-PROPN,PROPN-PROPN,compound-pobj,compound-dobj,IN-NNP,NNP-NNP,4,1
3,2.0,21,was,1,9,15,6,8,5,-8,14,Cyhra,Jesper Strömblad,ORG,PER-PER,PROPN,PROPN-PROPN,appos,compound-pobj,NNP,NNP-NNP,1,1
4,3.0,28,influenced,6,9,11,2,8,16,-3,5,Toto,Mike Porcaro,ORG,PER-PER,PROPN,PROPN-PROPN,compound,compound-pobj,NNP,NNP-NNP,1,1
5,3.0,28,influenced,6,17,20,3,16,7,-11,14,Geddy Lee,Rush,PER-PER,ORG,PROPN-PROPN,PROPN,compound-conj,pobj,NNP-NNP,NNP,3,1
0,0.0,54,were,7,25,27,2,24,26,-18,20,Aristippus,Cyrene,PER,LOC,PROPN,PROPN,pobj,pobj,NNP,NNP,6,1
1,1.0,13,called,4,12,7,-5,11,5,-8,3,Aristippus,Cyrene,PER,LOC,PROPN,PROPN,pobj,pobj,NNP,NNP,4,1
0,0.0,19,is,1,14,18,4,13,0,-13,17,Karnataka,India,LOC,LOC,PROPN,PROPN,compound,pobj,NNP,NNP,6,1
1,14.0,24,ranked,9,23,17,-6,22,6,-14,8,Karnataka,India,LOC,LOC,PROPN,PROPN,pobj,pobj,NNP,NNP,2,1
0,0.0,22,was,12,1,5,4,0,16,11,-7,Adolph Albrecht Erlenmeyer,11 July 1822,PER-PER-PER,TIME-TIME-TIME,PROPN-PROPN-PROPN,NUM-PROPN-NUM,compound-compound-nsubj,nummod-nmod-nummod,NNP-NNP-NNP,CD-NNP-CD,2,1
1,0.0,22,was,12,1,9,8,0,12,11,-3,Adolph Albrecht Erlenmeyer,9 August 1877,PER-PER-PER,TIME-TIME-TIME,PROPN-PROPN-PROPN,NUM-PROPN-NUM,compound-compound-nsubj,nummod-appos-nummod,NNP-NNP-NNP,CD-NNP-CD,2,1
2,0.0,22,was,12,1,15,14,0,6,11,3,Adolph Albrecht Erlenmeyer,German,PER-PER-PER,LOC,PROPN-PROPN-PROPN,ADJ,compound-compound-nsubj,amod,NNP-NNP-NNP,JJ,3,1
3,0.0,22,was,12,1,21,20,0,0,11,9,Adolph Albrecht Erlenmeyer,Wiesbaden,PER-PER-PER,LOC,PROPN-PROPN-PROPN,PROPN,compound-compound-nsubj,pobj,NNP-NNP-NNP,NNP,3,1
4,2.0,50,studied,6,36,41,5,35,8,-30,35,Carl Wigand Maximilian Jacobi,1777,PER-PER-PER-PER,TIME,PROPN-PROPN-PROPN-PROPN,NUM,compound-compound-compound-dobj,nummod,NNP-NNP-NNP-NNP,CD,3,1
5,2.0,50,studied,6,36,43,7,35,6,-30,37,Carl Wigand Maximilian Jacobi,1858,PER-PER-PER-PER,TIME,PROPN-PROPN-PROPN-PROPN,NUM,compound-compound-compound-dobj,appos,NNP-NNP-NNP-NNP,CD,2,1
6,7.0,21,remembered,13,5,9,4,4,11,8,-4,Friedrich Albrecht Erlenmeyer,1849,PER-PER-PER,TIME,PROPN-PROPN-PROPN,NUM,compound-compound-appos,nummod,NNP-NNP-NNP,CD,3,1
7,7.0,21,remembered,13,5,11,6,4,9,8,-2,Friedrich Albrecht Erlenmeyer,1926,PER-PER-PER,TIME,PROPN-PROPN-PROPN,NUM,compound-compound-appos,nummod,NNP-NNP-NNP,CD,3,1
0,0.0,23,is,3,1,9,8,0,13,2,6,Back for Good,Modern Talking,MISC-MISC-MISC,ORG-ORG,ADV-ADP-PROPN,PROPN-PROPN,advmod-prep-pobj,compound-pobj,RB-IN-NNP,NNP-NNP,5,1
1,0.0,23,is,3,1,13,12,0,9,2,10,Back for Good,30 March 1998,MISC-MISC-MISC,TIME-TIME-TIME,ADV-ADP-PROPN,NUM-PROPN-NUM,advmod-prep-pobj,nummod-pobj-nummod,RB-IN-NNP,CD-NNP-CD,6,1
0,0.0,40,was,19,1,12,11,0,27,18,-7,Peter Sydney Ernest Lawford,7 September 1923,PER-PER-PER-PER,TIME-TIME-TIME,PROPN-PROPN-PROPN-PROPN,NUM-PROPN-NUM,compound-compound-compound-nsubj,nummod-npadvmod-nummod,NNP-NNP-NNP-NNP,CD-NNP-CD,2,1
1,0.0,40,was,19,1,16,15,0,23,18,-3,Peter Sydney Ernest Lawford,24 December 1984,PER-PER-PER-PER,TIME-TIME-TIME,PROPN-PROPN-PROPN-PROPN,NUM-PROPN-NUM,compound-compound-compound-nsubj,nummod-appos-nummod,NNP-NNP-NNP-NNP,CD-NNP-CD,3,1
2,1.0,33,was,1,20,27,7,19,5,-19,26,John F. Kennedy,Robert F. Kennedy,PER-PER-PER,PER-PER-PER,PROPN-PROPN-PROPN,PROPN-PROPN-PROPN,compound-compound-pobj,compound-compound-appos,NNP-NNP-NNP,NNP-NNP-NNP,6,1
3,1.0,33,was,1,20,31,11,19,1,-19,30,John F. Kennedy,Edward Kennedy,PER-PER-PER,PER-PER,PROPN-PROPN-PROPN,PROPN-PROPN,compound-compound-pobj,compound-conj,NNP-NNP-NNP,NNP-NNP,6,1
4,1.0,33,was,1,27,31,4,26,1,-26,30,Robert F. Kennedy,Edward Kennedy,PER-PER-PER,PER-PER,PROPN-PROPN-PROPN,PROPN-PROPN,compound-compound-appos,compound-conj,NNP-NNP-NNP,NNP-NNP,2,1
0,0.0,13,is,8,1,5,4,0,7,7,-3,Kate Fleetwood,24 September 1972,PER-PER,TIME-TIME-TIME,PROPN-PROPN,NUM-PROPN-NUM,compound-nsubj,nummod-npadvmod-nummod,NNP-NNP,CD-NNP-CD,2,1
1,1.0,29,nominated,2,12,13,1,11,15,-10,11,Lady Macbeth,Macbeth,PER-PER,MISC,PROPN-PROPN,PROPN,compound-pobj,pobj,NNP-NNP,NNP,1,1
2,4.0,17,raised,2,1,15,14,0,1,1,13,Fleetwood,Exeter University,PER,ORG-ORG,PROPN,PROPN-PROPN,nsubjpass,compound-pobj,NNP,NNP-NNP,5,1
0,0.0,23,is,10,17,19,2,16,3,-7,9,Eutaw,Alabama,LOC,LOC,PROPN,PROPN,pobj,appos,NNP,NNP,2,1
1,0.0,23,is,10,17,21,4,16,1,-7,11,Eutaw,United States,LOC,LOC-LOC,PROPN,PROPN-PROPN,pobj,compound-appos,NNP,NNP-NNP,2,1
2,0.0,23,is,10,19,21,2,18,1,-9,11,Alabama,United States,LOC,LOC-LOC,PROPN,PROPN-PROPN,appos,compound-appos,NNP,NNP-NNP,2,1
0,0.0,33,pronounced,3,1,15,14,0,17,2,12,Lech Majewski,30 August 1953,PER-PER,TIME-TIME-TIME,PROPN-PROPN,NUM-PROPN-NUM,compound-nsubj,nummod-npadvmod-nummod,NNP-NNP,CD-NNP-CD,2,1
1,1.0,17,studied,7,7,3,-4,6,13,0,-4,Majewski,Katowice,PER,LOC,PROPN,PROPN,nsubj,pobj,NNP,NNP,4,1
2,1.0,17,studied,7,7,11,4,6,5,0,4,Majewski,Academy of Fine Arts,PER,ORG-ORG-ORG-ORG,PROPN,PROPN-ADP-PROPN-PROPN,nsubj,pobj-prep-compound-pobj,NNP,NNP-IN-NNP-NNPS,3,1
3,2.0,28,studied,6,10,14,4,9,13,-4,8,National Film School,Łódź,ORG-ORG-ORG,LOC,PROPN-PROPN-PROPN,PROPN,compound-compound-pobj,pobj,NNP-NNP-NNP,NNP,4,1
4,8.0,20,hosted,12,5,10,5,4,9,7,-2,Museum of Modern Art,New York City,LOC-LOC-LOC-LOC,LOC-LOC-LOC,PROPN-ADP-PROPN-PROPN,PROPN-PROPN-PROPN,nsubj-prep-compound-pobj,compound-compound-pobj,NNP-IN-NNP-NNP,NNP-NNP-NNP,4,1
0,1.0,24,published,3,16,20,4,15,3,-13,17,Fawcett Crest,Ballantine Books,ORG-ORG,ORG-ORG,PROPN-PROPN,PROPN-PROPN,compound-compound,compound-pobj,NNP-NNP,NNP-NNPS,3,1
1,6.0,31,rated,11,28,16,-12,27,14,-17,5,Black Widowers,Asimov,MISC-MISC,PER,PROPN-PROPN,ADJ,compound-compound,amod,NNP-NNP,JJ,7,1
2,12.0,22,is,10,17,15,-2,16,6,-7,5,Azazel,Asimov,MISC,PER,PROPN,PROPN,compound,poss,NNP,NNP,2,1
0,1.0,9,Licensed,0,5,7,2,4,1,-5,7,Colorado,United States,LOC,LOC-LOC,PROPN,PROPN-PROPN,conj,compound-appos,NNP,NNP-NNP,2,1
1,4.0,28,signed,3,1,7,6,0,20,2,4,Krystal 93,May 1988,ORG-ORG,TIME-TIME,PROPN-NUM,PROPN-NUM,nsubj-nummod,pobj-nummod,NNP-CD,NNP-CD,5,1
0,1.0,36,convicted,2,32,29,-3,31,6,-30,27,Japan,Gunma,LOC,LOC,PROPN,PROPN,npadvmod,compound,NNP,NNP,8,1
1,5.0,19,died,5,5,11,6,4,7,0,6,Nagata,5 February 2011,PER,TIME-TIME-TIME,PROPN,NUM-PROPN-NUM,nsubj,nummod-pobj-nummod,NNP,CD-NNP-CD,2,1
0,1.0,44,exhibit,1,5,9,4,4,34,-4,8,Carriageworks,Australia,LOC,LOC,PROPN,PROPN,pobj,appos,NNP,NNP,4,1
1,1.0,44,exhibit,1,7,9,2,6,34,-6,8,Sydney,Australia,LOC,LOC,PROPN,PROPN,pobj,appos,NNP,NNP,6,1
0,0.0,15,is,2,1,13,12,0,1,1,11,Jungle Rules,French Montana,MISC-MISC,PER-PER,PROPN-PROPN,PROPN-PROPN,compound-nsubj,compound-pobj,NNP-NNPS,NNP-NNP,4,1
1,2.0,21,succeeds,2,6,8,2,5,12,-4,6,MC4,2016,MISC,TIME,PROPN,NUM,dobj,appos,NNP,CD,2,1
0,0.0,29,is,8,1,5,4,0,23,7,-3,Jacques Lanxade,8 September 1934,PER-PER,TIME-TIME-TIME,PROPN-PROPN,NUM-PROPN-NUM,compound-nsubj,nummod-npadvmod-nummod,NNP-NNP,CD-NNP-CD,2,1
1,2.0,15,was,1,9,14,5,8,0,-8,13,Rwandan Genocide,1994,MISC-MISC,TIME,PROPN-PROPN,NUM,compound-nsubj,pobj,NNP-NNP,CD,3,1
0,0.0,13,is,2,1,10,9,0,2,1,8,Sugarplum Fairy,Borlänge,ORG-ORG,LOC,PROPN-PROPN,PROPN,compound-nsubj,pobj,NNP-NNP,NNP,5,1
1,0.0,13,is,2,10,12,2,9,0,-8,10,Borlänge,Sweden,LOC,LOC,PROPN,PROPN,pobj,appos,NNP,NNP,5,1
2,1.0,43,took,2,11,22,11,10,20,-9,20,Beatles,John Lennon,ORG,PER-PER,PROPN,PROPN-PROPN,poss,compound-nsubj,NNPS,NNP-NNP,4,1
3,2.0,15,founded,3,1,13,12,0,1,2,10,Sugarplum Fairy,Kristian Gidlund,ORG-ORG,PER-PER,PROPN-PROPN,PROPN-PROPN,compound-nsubjpass,compound-conj,NNP-NNP,NNP-NNP,3,1
0,0.0,24,is,4,2,22,20,1,1,2,18,Children of Violence,Doris Lessing,MISC-MISC-MISC,PER-PER,PROPN-ADP-PROPN,PROPN-PROPN,nsubj-prep-pobj,compound-pobj,NNPS-IN-NNP,NNP-NNP,9,1
1,1.0,37,Quest,1,23,25,2,22,11,-22,24,Landlocked,1965,MISC,TIME,PROPN,NUM,conj,appos,NNP,CD,2,1
2,1.0,37,Quest,1,29,35,6,28,1,-28,34,The Four - Gated City,1969,MISC-MISC-MISC-MISC-MISC,TIME,DET-PROPN-PUNCT-VERB-PROPN,NUM,det-compound-punct-compound-conj,appos,DT-NNP-HYPH-VBN-NNP,CD,3,1
3,1.0,37,Quest,1,1,4,3,0,32,0,3,Martha Quest,1952,MISC-MISC,TIME,PROPN-PROPN,NUM,compound-ROOT,appos,NNP-NNP,CD,1,1
4,1.0,37,Quest,1,7,11,4,6,25,-6,10,A Proper Marriage,1954,MISC-MISC-MISC,TIME,DET-PROPN-NOUN,NUM,det-compound-appos,appos,DT-NNP-NN,CD,2,1
5,1.0,37,Quest,1,7,7,0,6,29,-6,6,A Proper Marriage,A Ripple from the Storm,MISC-MISC-MISC,MISC-MISC-MISC-MISC-MISC,DET-PROPN-NOUN,DET-PROPN-ADP-DET-PROPN,det-compound-appos,det-ROOT-prep-det-pobj,DT-NNP-NN,DT-NNP-IN-DT-NNP,0,1
0,0.0,26,is,4,1,15,14,0,10,3,11,Tokyo Mirage Sessions ♯FE,Atlus,MISC-MISC-MISC-MISC,ORG,PROPN-PROPN-PROPN-PUNCT,PROPN,compound-compound-nsubj-punct,pobj,NNP-NNP-NNPS-'',NNP,6,1
1,0.0,26,is,4,1,19,18,0,6,3,15,Tokyo Mirage Sessions ♯FE,Nintendo,MISC-MISC-MISC-MISC,ORG,PROPN-PROPN-PROPN-PUNCT,PROPN,compound-compound-nsubj-punct,pobj,NNP-NNP-NNPS-'',NNP,7,1
2,0.0,26,is,4,1,22,21,0,3,3,18,Tokyo Mirage Sessions ♯FE,Wii U,MISC-MISC-MISC-MISC,MISC-MISC,PROPN-PROPN-PROPN-PUNCT,PROPN-NOUN,compound-compound-nsubj-punct,compound-compound,NNP-NNP-NNPS-'',NNP-NN,9,1
3,3.0,46,Taking,0,16,7,-9,15,38,-16,7,Shibuya,Tokyo,LOC,LOC,PROPN,PROPN,pobj,pobj,NNPS,NNP,6,1
4,6.0,25,proposed,4,9,7,-2,8,17,-5,3,Kaori Ando,Nintendo,PER-PER,ORG,PROPN-PROPN,PROPN,compound-pobj,compound,NNP-NNP,NNP,1,1
5,9.0,14,was,3,12,9,-3,11,4,-9,6,Avex Group,Japanese,ORG-ORG,LOC,PROPN-PROPN,ADJ,compound-pobj,amod,NNP-NNP,JJ,2,1
0,0.0,37,is,10,1,18,17,0,18,9,8,England 's Happiness in the Crowning of William and Mary,1689,MISC-MISC-MISC-MISC-MISC-MISC-MISC-MISC-MISC-MISC,TIME,PROPN-PART-NOUN-ADP-DET-PROPN-ADP-PROPN-CCONJ-PROPN,NUM,poss-case-nsubj-prep-det-pobj-prep-pobj-cc-conj,pobj,NNP-POS-NN-IN-DT-NNP-IN-NNP-CC-NNP,CD,4,1
0,0.0,18,is,4,1,14,13,0,3,3,10,Little Bay de Noc,U.S.,LOC-LOC-LOC-LOC,LOC,PROPN-PROPN-X-PROPN,PROPN,amod-compound-compound-nsubj,compound,NNP-NNP-FW-NNP,NNP,7,1
1,0.0,18,is,4,1,17,16,0,0,3,13,Little Bay de Noc,Michigan,LOC-LOC-LOC-LOC,LOC,PROPN-PROPN-X-PROPN,PROPN,amod-compound-compound-nsubj,pobj,NNP-NNP-FW-NNP,NNP,3,1
2,0.0,18,is,4,10,14,4,9,3,-6,10,Upper Peninsula,U.S.,LOC-LOC,LOC,PROPN-PROPN,PROPN,compound-pobj,compound,NNP-NNP,NNP,2,1
3,0.0,18,is,4,10,17,7,9,0,-6,13,Upper Peninsula,Michigan,LOC-LOC,LOC,PROPN-PROPN,PROPN,compound-pobj,pobj,NNP-NNP,NNP,4,1
4,0.0,18,is,4,14,17,3,13,0,-10,13,U.S.,Michigan,LOC,LOC,PROPN,PROPN,compound,pobj,NNP,NNP,6,1
0,0.0,16,is,9,1,6,5,0,9,8,-3,John Olav Egeland,2 November 1951,PER-PER-PER,TIME-TIME-TIME,PROPN-PROPN-PROPN,NUM-PROPN-NUM,compound-compound-nsubj,nummod-npadvmod-nummod,NNP-NNP-NNP,CD-NNP-CD,3,1
1,0.0,16,is,9,1,12,11,0,3,8,3,John Olav Egeland,Norwegian,PER-PER-PER,LOC,PROPN-PROPN-PROPN,ADJ,compound-compound-nsubj,amod,NNP-NNP-NNP,JJ,3,1
2,1.0,19,born,2,11,16,5,10,2,-9,14,Erik Egeland,John Oscar Egeland,PER-PER,PER-PER-PER,PROPN-PROPN,PROPN-PROPN-PROPN,compound-pobj,compound-compound-pobj,NNP-NNP,NNP-NNP-NNP,6,1
0,0.0,29,was,8,2,26,24,1,2,6,18,bombing of Stuttgart in World War II,Allies,MISC-MISC-MISC-MISC-MISC-MISC-MISC,ORG,NOUN-ADP-PROPN-ADP-PROPN-PROPN-PROPN,PROPN,nsubj-prep-pobj-prep-compound-compound-pobj,pobj,NN-IN-NNP-IN-NNP-NNP-NNP,NNPS,12,1
1,2.0,56,attacked,4,34,55,21,33,0,-30,51,Daimler,Germany,ORG,LOC,PROPN,PROPN,nmod,pobj,NNP,NNP,6,1
2,2.0,56,attacked,4,36,55,19,35,0,-32,51,Porsche,Germany,ORG,LOC,PROPN,PROPN,conj,pobj,NNP,NNP,7,1
0,0.0,37,are,3,2,33,31,1,3,1,30,Buchan Caves,Australian,LOC-LOC,LOC,PROPN-PROPN,ADJ,compound-nsubj,amod,NNP-NNPS,JJ,10,1
1,0.0,37,are,3,2,36,34,1,0,1,33,Buchan Caves,Victoria,LOC-LOC,LOC,PROPN-PROPN,PROPN,compound-nsubj,pobj,NNP-NNPS,NNP,2,1
2,0.0,37,are,3,13,33,20,12,3,-10,30,Royal Cave,Australian,LOC-LOC,LOC,PROPN-PROPN,ADJ,compound-dobj,amod,NNP-NNP,JJ,4,1
3,0.0,37,are,3,17,33,16,16,3,-14,30,Fairy Cave,Australian,LOC-LOC,LOC,PROPN-PROPN,ADJ,compound-conj,amod,NNP-NNP,JJ,5,1
4,0.0,37,are,3,17,36,19,16,0,-14,33,Fairy Cave,Victoria,LOC-LOC,LOC,PROPN-PROPN,PROPN,compound-conj,pobj,NNP-NNP,NNP,7,1
5,0.0,37,are,3,28,33,5,27,3,-25,30,East Gippsland,Australian,LOC-LOC,LOC,PROPN-PROPN,ADJ,compound-compound,amod,NNP-NNP,JJ,3,1
6,0.0,37,are,3,28,36,8,27,0,-25,33,East Gippsland,Victoria,LOC-LOC,LOC,PROPN-PROPN,PROPN,compound-compound,pobj,NNP-NNP,NNP,9,1
7,0.0,37,are,3,33,36,3,32,0,-30,33,Australian,Victoria,LOC,LOC,ADJ,PROPN,amod,pobj,JJ,NNP,10,1
0,1.0,22,governed,2,14,18,4,13,3,-12,16,Loftus Versfeld Stadium,Pretoria,LOC-LOC-LOC,LOC,PROPN-PROPN-PROPN,PROPN,compound-compound-pobj,pobj,NNP-NNP-NNP,NNP,2,1
0,0.0,21,"""",0,2,13,11,1,7,-2,13,The Ripper,Judas Priest,MISC-MISC,ORG-ORG,DET-PROPN,PROPN-PROPN,det-nsubj,compound-pobj,DT-NNP,NNP-NNP,5,1
0,0.0,15,was,10,1,4,3,0,10,9,-6,Richard Collins,1947,PER-PER,TIME,PROPN-PROPN,NUM,compound-nsubj,nummod,NNP-NNP,CD,1,1
1,0.0,15,was,10,1,6,5,0,8,9,-4,Richard Collins,"April 15 , 2013",PER-PER,TIME-TIME-TIME-TIME,PROPN-PROPN,PROPN-NUM-PUNCT-NUM,compound-nsubj,appos-nummod-punct-nummod,NNP-NNP,"NNP-CD-,-CD",2,1
2,0.0,15,was,10,1,13,12,0,1,9,3,Richard Collins,Canadian,PER-PER,LOC,PROPN-PROPN,ADJ,compound-nsubj,amod,NNP-NNP,JJ,2,1
3,4.0,31,born,2,1,5,4,0,25,1,3,Collins,St. John 's,PER,LOC-LOC-LOC,NOUN,PROPN-PROPN-PART,nsubjpass,compound-pobj-case,NNS,NNP-NNP-POS,4,1
4,4.0,31,born,2,5,16,11,4,14,-3,14,St. John 's,Canada,LOC-LOC-LOC,LOC,PROPN-PROPN-PART,PROPN,compound-pobj-case,npadvmod,NNP-NNP-POS,NNP,3,1
0,0.0,35,was,13,1,4,3,0,30,12,-9,Robert Smalls,"April 5 , 1839",PER-PER,TIME-TIME-TIME-TIME,PROPN-PROPN,PROPN-NUM-PUNCT-NUM,compound-nsubj,appos-nummod-punct-nummod,NNP-NNP,"NNP-CD-,-CD",2,1
1,0.0,35,was,13,1,9,8,0,25,12,-4,Robert Smalls,"February 23 , 1915",PER-PER,TIME-TIME-TIME-TIME,PROPN-PROPN,PROPN-NUM-PUNCT-NUM,compound-nsubj,appos-nummod-punct-nummod,NNP-NNP,"NNP-CD-,-CD",2,1
2,0.0,35,was,13,1,17,16,0,17,12,4,Robert Smalls,African American,PER-PER,LOC-LOC,PROPN-PROPN,PROPN-PROPN,compound-nsubj,compound-attr,NNP-NNP,NNP-NNP,2,1
3,1.0,49,freed,1,28,47,19,27,1,-27,46,Charleston,U.S.,LOC,LOC,PROPN,PROPN,compound,compound,NNP,NNP,7,1
4,2.0,23,convince,5,8,22,14,7,0,-3,17,Abraham Lincoln,Navy,PER-PER,ORG,PROPN-PROPN,PROPN,compound-dobj,conj,NNP-NNP,NNP,3,1
5,3.0,9,born,2,1,5,4,0,3,1,3,Smalls,Beaufort,PER,LOC,PROPN,PROPN,nsubjpass,pobj,NNP,NNP,4,1
6,5.0,23,authored,1,7,11,4,6,11,-6,10,South Carolina,the United States,LOC-LOC,LOC-LOC-LOC,PROPN-PROPN,DET-PROPN-PROPN,compound-pobj,det-compound-pobj,NNP-NNP,DT-NNP-NNP,5,1
0,0.0,13,is,2,1,7,6,0,5,1,5,Old Glory,the United States,MISC-MISC,LOC-LOC-LOC,PROPN-PROPN,DET-PROPN-PROPN,compound-nsubj,det-compound-pobj,NNP-NNP,DT-NNP-NNP,4,1
1,4.0,35,claimed,5,22,30,8,21,4,-17,25,Smithsonian Institution,National Museum of American History,ORG-ORG,LOC-LOC-LOC-LOC-LOC,PROPN-PROPN,PROPN-PROPN-ADP-PROPN-PROPN,compound-pobj,compound-pobj-prep-compound-pobj,NNP-NNP,NNP-NNP-IN-NNP-NNP,3,1
0,0.0,40,is,14,1,10,9,0,29,13,-4,"William Paul "" Bill "" Cole III","May 16 , 1956",PER-PER-PER-PER-PER-PER-PER,TIME-TIME-TIME-TIME,PROPN-PROPN-PUNCT-PROPN-PUNCT-PROPN-PROPN,PROPN-NUM-PUNCT-NUM,nmod-nsubj-punct-compound-punct-compound-appos,npadvmod-nummod-punct-nummod,NNP-NNP-``-NNP-''-NNP-NNP,"NNP-CD-,-CD",4,1
0,0.0,39,spelled,3,17,37,20,16,1,-14,34,Tihamah,Saudi Arabia,LOC,LOC-LOC,PROPN,PROPN-PROPN,compound,compound-pobj,NNP,NNP-NNP,7,1
1,0.0,39,spelled,3,21,27,6,20,11,-18,24,Hejaz,Red Sea,LOC,LOC-LOC,PROPN,PROPN-PROPN,pobj,compound-pobj,NNPS,NNP-NNP,3,1
2,1.0,44,is,1,36,7,-29,35,36,-35,6,Saudi Arabia,Makkah Province,LOC-LOC,LOC-LOC,PROPN-PROPN,PROPN-PROPN,compound-pobj,compound-pobj,NNP-NNP,NNP-NNP,10,1
3,1.0,44,is,1,36,43,7,35,0,-35,42,Saudi Arabia,Riyadh,LOC-LOC,LOC,PROPN-PROPN,PROPN,compound-pobj,appos,NNP-NNP,NNP,8,1
4,5.0,25,ranked,3,10,8,-2,9,16,-7,5,Mid - East,Africa,LOC-LOC-LOC,LOC,PROPN-PUNCT-PROPN,PROPN,compound-punct-compound,nmod,NNP-HYPH-NNP,NNP,4,1
0,0.0,18,is,5,14,16,2,13,1,-9,11,Medina,Saudi Arabia,LOC,LOC-LOC,PROPN,PROPN-PROPN,pobj,compound-appos,NNP,NNP-NNP,2,1
0,4.0,51,achieved,1,1,11,10,0,39,0,10,Nesbit,Harry Kendall Thaw,PER,PER-PER-PER,PROPN,PROPN-PROPN-PROPN,nsubj,compound-compound-relcl,NNP,NNP-NNP-NNP,4,1
1,4.0,51,achieved,1,18,32,14,17,18,-17,31,Stanford White,"June 25 , 1906",PER-PER,TIME-TIME-TIME-TIME,PROPN-PROPN,PROPN-NUM-PUNCT-NUM,compound-dobj,pobj-nummod-punct-nummod,NNP-NNP,"NNP-CD-,-CD",6,1
0,0.0,25,was,14,22,24,2,21,0,-8,10,Kerala,India,LOC,LOC,PROPN,PROPN,pobj,appos,NNP,NNP,5,1
1,8.0,23,',0,2,22,20,1,0,-2,22,Kozhikodan Smaraka Samiti,Malayalam,MISC-MISC-MISC,MISC,PROPN-PROPN-PROPN,PROPN,compound-compound-nsubj,pobj,NNP-NNP-NNP,NNP,3,1
2,8.0,23,',0,2,22,20,1,0,-2,22,Kozhikodan Puraskaram,Malayalam,MISC-MISC,MISC,PROPN-PROPN,PROPN,compound-dobj,pobj,NNP-NNP,NNP,3,1
0,0.0,28,is,6,1,24,23,0,3,5,18,Ploschad Muzhestva,Saint Petersburg,LOC-LOC,LOC-LOC,PROPN-PROPN,PROPN-PROPN,compound-nsubj,compound-pobj,NNP-NNP,NNP-NNP,7,1
1,0.0,28,is,6,1,27,26,0,0,5,21,Ploschad Muzhestva,Russia,LOC-LOC,LOC,PROPN-PROPN,PROPN,compound-nsubj,appos,NNP-NNP,NNP,2,1
2,0.0,28,is,6,24,27,3,23,0,-18,21,Saint Petersburg,Russia,LOC-LOC,LOC,PROPN-PROPN,PROPN,compound-pobj,appos,NNP-NNP,NNP,7,1
0,0.0,16,located,4,1,13,12,0,2,3,9,Yorkdale Bus Terminal,Ontario,LOC-LOC-LOC,LOC,PROPN-PROPN-PROPN,PROPN,compound-compound-nsubjpass,conj,NNP-NNP-NNP,NNP,7,1
1,0.0,16,located,4,1,15,14,0,0,3,11,Yorkdale Bus Terminal,Canada,LOC-LOC-LOC,LOC,PROPN-PROPN-PROPN,PROPN,compound-compound-nsubjpass,appos,NNP-NNP-NNP,NNP,3,1
2,0.0,16,located,4,7,15,8,6,0,-3,11,1 Yorkdale Road,Canada,LOC-LOC-LOC,LOC,NUM-PROPN-PROPN,PROPN,nummod-compound-pobj,appos,CD-NNP-NNP,NNP,4,1
3,0.0,16,located,4,11,13,2,10,2,-7,9,Toronto,Ontario,LOC,LOC,PROPN,PROPN,npadvmod,conj,NNP,NNP,3,1
4,0.0,16,located,4,11,15,4,10,0,-7,11,Toronto,Canada,LOC,LOC,PROPN,PROPN,npadvmod,appos,NNP,NNP,5,1
5,0.0,16,located,4,13,15,2,12,0,-9,11,Ontario,Canada,LOC,LOC,PROPN,PROPN,conj,appos,NNP,NNP,6,1
0,0.0,21,built,13,2,8,6,1,12,11,-5,Belknap Stone House,New York,LOC-LOC-LOC,LOC-LOC,PROPN-PROPN-PROPN,PROPN-PROPN,compound-compound-nsubjpass,compound-conj,NNP-NNP-NNP,NNP-NNP,2,1
1,0.0,21,built,13,2,11,9,1,9,11,-2,Belknap Stone House,USA,LOC-LOC-LOC,LOC,PROPN-PROPN-PROPN,PROPN,compound-compound-nsubjpass,appos,NNP-NNP-NNP,NNP,3,1
2,0.0,21,built,13,6,8,2,5,12,7,-5,Newburgh,New York,LOC,LOC-LOC,PROPN,PROPN-PROPN,pobj,compound-conj,NNP,NNP-NNP,2,1
3,0.0,21,built,13,6,11,5,5,9,7,-2,Newburgh,USA,LOC,LOC,PROPN,PROPN,pobj,appos,NNP,NNP,3,1
4,0.0,21,built,13,8,11,3,7,9,5,-2,New York,USA,LOC-LOC,LOC,PROPN-PROPN,PROPN,compound-conj,appos,NNP-NNP,NNP,3,1
0,0.0,18,is,1,10,10,0,9,7,-9,9,Demerara,Demerara - Mahaica,LOC,LOC-LOC-LOC,PROPN,PROPN-PUNCT-PROPN,pobj,compound-punct-compound,NNP,NNP-HYPH-NNP,0,1
0,0.0,17,was,12,1,5,4,0,11,11,-7,Vagn Walfrid Ekman,3 May 1874,PER-PER-PER,TIME-TIME-TIME,PROPN-PROPN-PROPN,NUM-PROPN-NUM,compound-compound-nsubj,nummod-nmod-nummod,NNP-NNP-NNP,CD-NNP-CD,3,1
1,0.0,17,was,12,1,9,8,0,7,11,-3,Vagn Walfrid Ekman,9 March 1954,PER-PER-PER,TIME-TIME-TIME,PROPN-PROPN-PROPN,NUM-PROPN-NUM,compound-compound-nsubj,nummod-npadvmod-nummod,NNP-NNP-NNP,CD-NNP-CD,2,1
2,0.0,17,was,12,1,15,14,0,1,11,3,Vagn Walfrid Ekman,Swedish,PER-PER-PER,LOC,PROPN-PROPN-PROPN,ADJ,compound-compound-nsubj,amod,NNP-NNP-NNP,JJ,3,1
3,7.0,27,singer,4,24,26,2,23,0,-20,22,Stockaryd,Sweden,LOC,LOC,PROPN,PROPN,pobj,appos,NNP,NNP,5,1
0,0.0,12,is,1,1,7,6,0,4,0,6,Blokland,Dutch,LOC,LOC,PROPN,ADJ,nsubj,amod,NNP,JJ,3,1
1,0.0,12,is,1,7,10,3,6,1,-6,9,Dutch,South Holland,LOC,LOC-LOC,ADJ,PROPN-PROPN,amod,compound-pobj,JJ,NNP-NNP,2,1
2,3.0,53,is,43,18,25,7,17,27,25,-18,De Ronde Venen,Utrecht,LOC-LOC-LOC,LOC,PROPN-PROPN-PROPN,PROPN,compound-compound-pobj,pobj,NNP-NNP-NNP,NNP,6,1
0,0.0,19,is,2,1,18,17,0,0,1,16,Slow Life,2004,MISC-MISC,TIME,ADJ-NOUN,NUM,compound-nsubj,pobj,JJ-NN,CD,2,1
1,7.0,36,appeared,3,13,7,-6,12,28,-10,4,Slow Life,2004,MISC-MISC,TIME,ADJ-NOUN,NUM,compound-dobj,nummod,JJ-NN,CD,3,1
2,2.0,30,appeared,6,4,10,6,3,19,2,4,Slow Life,2003,MISC-MISC,TIME,ADJ-NOUN,NUM,compound-nsubj,nummod,JJ-NN,CD,5,1
3,7.0,36,appeared,3,9,7,-2,8,28,-6,4,9 Songs,2004,MISC-MISC,TIME,NUM-NOUN,NUM,nummod-appos,nummod,CD-NNS,CD,1,1
0,0.0,32,is,12,1,5,4,0,26,11,-7,Sixto Paz Wells,Lima,PER-PER-PER,LOC,PROPN-PROPN-PROPN,PROPN,compound-compound-nsubj,nmod,NNP-NNP-NNP,NNP,3,1
1,0.0,32,is,12,1,9,8,0,22,11,-3,Sixto Paz Wells,December 12 1955,PER-PER-PER,TIME-TIME-TIME,PROPN-PROPN-PROPN,PROPN-NUM-NUM,compound-compound-nsubj,npadvmod-nummod-nummod,NNP-NNP-NNP,NNP-CD-CD,4,1
2,0.0,32,is,12,5,7,2,4,24,7,-5,Lima,Peru,LOC,LOC,PROPN,PROPN,nmod,appos,NNP,NNP,2,1
3,1.0,41,stands,19,8,11,3,7,29,11,-8,Rahma Mission,Spain,MISC-MISC,LOC,PROPN-PROPN,PROPN,compound-pobj,pobj,NNP-NNP,NNP,3,1
0,0.0,15,Make,0,1,7,6,0,7,-1,7,Make Way for Tomorrow,1937,MISC-MISC-MISC-MISC,TIME,VERB-NOUN-ADP-NOUN,NUM,ROOT-dobj-prep-pobj,nummod,VB-NN-IN-NN,CD,3,1
1,0.0,15,Make,0,1,8,7,0,6,-1,8,Make Way for Tomorrow,American,MISC-MISC-MISC-MISC,LOC,VERB-NOUN-ADP-NOUN,ADJ,ROOT-dobj-prep-pobj,amod,VB-NN-IN-NN,JJ,3,1
2,0.0,15,Make,0,1,13,12,0,1,-1,13,Make Way for Tomorrow,Leo McCarey,MISC-MISC-MISC-MISC,PER-PER,VERB-NOUN-ADP-NOUN,PROPN-PROPN,ROOT-dobj-prep-pobj,compound-pobj,VB-NN-IN-NN,NNP-NNP,5,1
0,1.0,74,made,1,45,48,3,44,25,-44,47,Picture Bride,1994,MISC-MISC,TIME,PROPN-PROPN,NUM,compound-conj,appos,NNP-NNP,CD,1,1
1,1.0,74,made,1,51,54,3,50,19,-50,53,Four Rooms,1995,MISC-MISC,TIME,PROPN-NOUN,NUM,compound-conj,npadvmod,NNP-NNS,CD,1,1
2,1.0,74,made,1,57,60,3,56,13,-56,59,Robot Stories,2003,MISC-MISC,TIME,PROPN-PROPN,NUM,compound-conj,appos,NNP-NNPS,CD,1,1
3,1.0,74,made,1,11,68,57,10,5,-10,67,The Day After Tomorrow,2004,MISC-MISC-MISC-MISC,TIME,DET-PROPN-ADP-PROPN,NUM,det-ROOT-prep-pobj,pobj,DT-NNP-IN-NNP,CD,8,1
4,1.0,74,made,1,11,17,6,10,56,-10,16,The Karate Kid Part II,1986,MISC-MISC-MISC-MISC-MISC,TIME,DET-PROPN-PROPN-PROPN-PROPN,NUM,det-compound-compound-compound-pobj,appos,DT-NNP-NNP-NNP-NNP,CD,3,1
5,1.0,74,made,1,29,34,5,28,39,-28,33,Come See the Paradise,1990,MISC-MISC-MISC-MISC,TIME,VERB-VERB-DET-PROPN,NUM,aux-ROOT-det-dobj,appos,VB-VB-DT-NNP,CD,2,1
6,1.0,74,made,1,11,42,31,10,31,-10,41,The Joy Luck Club,1993,MISC-MISC-MISC-MISC,TIME,DET-PROPN-PROPN-PROPN,NUM,det-compound-compound-conj,appos,DT-NNP-NNP-NNP,CD,8,1
7,3.0,27,starred,1,8,11,3,7,15,-7,10,Berlin Station,2016,MISC-MISC,TIME,PROPN-PROPN,NUM,compound-appos,appos,NNP-NNP,CD,1,1
0,0.0,20,River,0,1,13,12,0,6,-1,13,River Out of Eden : A Darwinian View of Life,1995,MISC-MISC-MISC-MISC-MISC-MISC-MISC-MISC-MISC-MISC,TIME,PROPN-ADP-ADP-PROPN-PUNCT-DET-ADJ-NOUN-ADP-PROPN,NUM,ROOT-prt-prep-pobj-punct-det-amod-nsubj-prep-pobj,nummod,NNP-IN-IN-NNP-:-DT-JJ-NN-IN-NNP,CD,4,1
1,0.0,20,River,0,1,18,17,0,1,-1,18,River Out of Eden : A Darwinian View of Life,Richard Dawkins,MISC-MISC-MISC-MISC-MISC-MISC-MISC-MISC-MISC-MISC,PER-PER,PROPN-ADP-ADP-PROPN-PUNCT-DET-ADJ-NOUN-ADP-PROPN,PROPN-PROPN,ROOT-prt-prep-pobj-punct-det-amod-nsubj-prep-pobj,compound-pobj,NNP-IN-IN-NNP-:-DT-JJ-NN-IN-NNP,NNP-NNP,5,1
2,3.0,11,illustrated,2,8,5,-3,7,5,-6,3,Dawkins,Lalla Ward,PER,PER-PER,PROPN,PROPN-PROPN,poss,compound-pobj,NNP,NNP-NNP,3,1
0,1.0,34,disembarked,14,3,6,3,2,27,11,-8,Bergamo,Italy,LOC,LOC,PROPN,PROPN,pobj,pobj,NNP,NNP,2,1
0,1.0,28,was,1,11,25,14,10,2,-10,24,French Consulate,First French Empire,LOC-LOC,LOC-LOC-LOC,PROPN-PROPN,PROPN-PROPN-PROPN,amod-pobj,amod-compound-conj,NNP-NNP,NNP-NNP-NNP,11,1
1,3.0,22,became,0,17,20,3,16,1,-17,20,National Assembly,June 1789,ORG-ORG,TIME-TIME,PROPN-PROPN,PROPN-NUM,compound-pobj,pobj-nummod,NNP-NNP,NNP-CD,5,1
0,0.0,34,is,5,1,8,7,0,25,4,3,The Turn of the Screw,1898,MISC-MISC-MISC-MISC-MISC,TIME,DET-PROPN-ADP-DET-PROPN,NUM,det-nsubj-prep-det-pobj,nummod,DT-NNP-IN-DT-NNP,CD,3,1
1,0.0,34,is,5,1,12,11,0,21,4,7,The Turn of the Screw,Henry James,MISC-MISC-MISC-MISC-MISC,PER-PER,DET-PROPN-ADP-DET-PROPN,PROPN-PROPN,det-nsubj-prep-det-pobj,compound-pobj,DT-NNP-IN-DT-NNP,NNP-NNP,4,1
2,1.0,24,appeared,4,7,15,8,6,8,-3,11,The Two Magics,Macmillan,MISC-MISC-MISC,ORG,DET-PROPN-PROPN,PROPN,det-compound-pobj,pobj,DT-NNP-NNPS,NNP,6,1
3,1.0,24,appeared,4,15,17,2,14,6,-11,13,Macmillan,New York City,ORG,LOC-LOC-LOC,PROPN,PROPN-PROPN-PROPN,pobj,compound-compound-pobj,NNP,NNP-NNP-NNP,2,1
0,0.0,26,is,2,14,24,10,13,1,-12,22,Doors,Elektra Records,ORG,ORG-ORG,PROPN,PROPN-PROPN,appos,compound-pobj,NNPS,NNP-NNPS,4,1
1,5.0,32,"""",0,2,12,10,1,19,-2,12,Love Her Madly,March 1971,MISC-MISC-MISC,TIME-TIME,VERB-DET-PROPN,PROPN-NUM,nsubjpass-poss-dobj,pobj-nummod,VB-PRP$-NNP,NNP-CD,5,1
0,0.0,24,is,3,1,6,5,0,17,2,3,Battir,Palestinian,LOC,LOC,PROPN,ADJ,nsubj,amod,NNP,JJ,2,1
1,1.0,26,inhabited,2,25,8,-17,24,17,-23,6,Muslim,Islamic,ORG,ORG,PROPN,ADJ,pobj,conj,NNP,JJ,4,1
0,9.0,54,are,23,13,21,8,12,32,10,-2,Yazawin Thit,Hmannan Yazawin,MISC-MISC,MISC-MISC,PROPN-PROPN,PROPN-PROPN,compound-pobj,compound-compound,NNP-NNP,NNP-NNP,2,1
0,0.0,23,is,4,1,3,2,0,19,3,-1,Jordan,Ontario,LOC,LOC,PROPN,PROPN,nsubj,appos,NNP,NNP,3,1
1,0.0,23,is,4,15,21,6,14,1,-11,17,Town of Lincoln,Niagara Region,LOC-LOC-LOC,LOC-LOC,PROPN-ADP-PROPN,PROPN-PROPN,pobj-prep-pobj,compound-pobj,NNP-IN-NNP,NNP-NNP,8,1
0,0.0,32,was,11,1,4,3,0,27,10,-7,Babik Reinhardt,8 June 1944,PER-PER,TIME-TIME-TIME,PROPN-PROPN,NUM-PROPN-NUM,compound-nsubj,nummod-appos-nummod,NNP-NNP,CD-NNP-CD,1,1
1,0.0,32,was,11,1,8,7,0,23,10,-3,Babik Reinhardt,13 November 2001,PER-PER,TIME-TIME-TIME,PROPN-PROPN,NUM-PROPN-NUM,compound-nsubj,nummod-appos-nummod,NNP-NNP,CD-NNP-CD,1,1
2,1.0,35,was,18,9,5,-4,8,29,9,-13,Django,Lousson,PER,PER,PROPN,PROPN,poss,appos,NNP,NNP,5,1
3,2.0,6,born,2,1,5,4,0,0,1,3,Reinhardt,Paris,PER,LOC,NOUN,PROPN,nsubjpass,pobj,NNS,NNP,2,1
4,7.0,19,died,4,16,18,2,15,0,-12,14,Cannes,France,LOC,LOC,PROPN,PROPN,pobj,appos,NNPS,NNP,8,1
5,8.0,34,appeared,1,6,11,5,5,22,-5,10,Generation Django,2009,MISC-MISC,TIME,PROPN-PROPN,NUM,compound-appos,npadvmod,NNP-NNP,CD,2,1
0,0.0,31,is,10,1,5,4,0,25,9,-5,Thomas Acda,Amsterdam,PER-PER,LOC,PROPN-PROPN,PROPN,compound-nsubj,appos,NNP-NNP,NNP,2,1
1,0.0,31,is,10,1,7,6,0,23,9,-3,Thomas Acda,6 March 1967,PER-PER,TIME-TIME-TIME,PROPN-PROPN,NUM-PROPN-NUM,compound-nsubj,nummod-appos-nummod,NNP-NNP,CD-NNP-CD,2,1
2,15.0,28,decided,12,12,8,-4,11,19,0,-4,VARA,Netherlands,ORG,LOC,PROPN,PROPN,nsubj,pobj,NNP,NNP,1,1
3,15.0,28,decided,12,27,8,-19,26,19,-15,-4,Willem,Netherlands,PER,LOC,PROPN,PROPN,pobj,pobj,NNP,NNP,2,1
0,0.0,21,Knowles,2,1,5,4,0,15,1,3,John Cunningham Knowles,"October 15 , 1894",PER-PER-PER,TIME-TIME-TIME-TIME,PROPN-PROPN-PROPN,PROPN-NUM-PUNCT-NUM,compound-compound-ROOT,appos-nummod-punct-nummod,NNP-NNP-NNP,"NNP-CD-,-CD",3,1
1,0.0,21,Knowles,2,1,10,9,0,10,1,8,John Cunningham Knowles,"August 31 , 1977",PER-PER-PER,TIME-TIME-TIME-TIME,PROPN-PROPN-PROPN,PROPN-NUM-PUNCT-NUM,compound-compound-ROOT,nsubj-nummod-punct-nummod,NNP-NNP-NNP,"NNP-CD-,-CD",3,1
2,2.0,32,born,2,13,16,3,12,15,-11,14,Robert Knowles,Mary Elizabeth Cunningham,PER-PER,PER-PER-PER,PROPN-PROPN,PROPN-PROPN-PROPN,compound-pobj,compound-compound-conj,NNP-NNP,NNP-NNP-NNP,2,1
3,7.0,12,served,2,6,9,3,5,2,-4,7,Canadian Army,World War II,ORG-ORG,MISC-MISC-MISC,PROPN-PROPN,PROPN-PROPN-PROPN,compound-pobj,compound-compound-pobj,NNP-NNP,NNP-NNP-NNP,5,1
0,0.0,15,is,1,8,11,3,7,3,-7,10,Anderson County,Kentucky,LOC-LOC,LOC,PROPN-PROPN,PROPN,compound-pobj,conj,NNP-NNP,NNP,1,1
1,0.0,15,is,1,8,13,5,7,1,-7,12,Anderson County,United States,LOC-LOC,LOC-LOC,PROPN-PROPN,PROPN-PROPN,compound-pobj,compound-appos,NNP-NNP,NNP-NNP,1,1
2,0.0,15,is,1,11,13,2,10,1,-10,12,Kentucky,United States,LOC,LOC-LOC,PROPN,PROPN-PROPN,conj,compound-appos,NNP,NNP-NNP,2,1
0,0.0,25,"""",0,2,23,21,1,1,-2,23,Someday,1990,MISC,TIME,ADV,NUM,advmod,appos,RB,CD,5,1
1,3.0,36,began,9,9,6,-3,8,29,0,-3,Carey,Columbia Records,PER,ORG-ORG,PROPN,PROPN-PROPN,nsubj,compound-pobj,NNP,NNP-NNPS,5,1
2,7.0,48,"""",0,27,30,3,26,17,-27,30,Greatest Hits,2001,MISC-MISC,TIME,PROPN-PROPN,NUM,compound-conj,appos,NNP-NNP,CD,1,1
3,7.0,48,"""",0,27,33,6,26,14,-27,33,Greatest Hits,The Essential Mariah Carey,MISC-MISC,MISC-MISC-MISC-MISC,PROPN-PROPN,DET-PROPN-PROPN-PROPN,compound-conj,det-compound-compound-conj,NNP-NNP,DT-NNP-NNP-NNP,2,1
4,7.0,48,"""",0,27,10,-17,26,37,-27,10,Greatest Hits,Carey,MISC-MISC,PER,PROPN-PROPN,PROPN,compound-conj,poss,NNP-NNP,NNP,7,1
5,7.0,48,"""",0,33,38,5,32,9,-33,38,The Essential Mariah Carey,2011,MISC-MISC-MISC-MISC,TIME,DET-PROPN-PROPN-PROPN,NUM,det-compound-compound-conj,appos,DT-NNP-NNP-NNP,CD,2,1
6,7.0,48,"""",0,33,20,-13,32,27,-33,20,The Essential Mariah Carey,# 1 to Infinity,MISC-MISC-MISC-MISC,MISC-MISC-MISC-MISC,DET-PROPN-PROPN-PROPN,SYM-NUM-ADP-PROPN,det-compound-compound-conj,nmod-conj-prep-pobj,DT-NNP-NNP-NNP,$-CD-IN-NNP,3,1
7,7.0,48,"""",0,33,10,-23,32,37,-33,10,The Essential Mariah Carey,Carey,MISC-MISC-MISC-MISC,PER,DET-PROPN-PROPN-PROPN,PROPN,det-compound-compound-conj,poss,DT-NNP-NNP-NNP,NNP,9,1
8,7.0,48,"""",0,20,10,-10,19,37,-20,10,# 1 to Infinity,Carey,MISC-MISC-MISC-MISC,PER,SYM-NUM-ADP-PROPN,PROPN,nmod-conj-prep-pobj,poss,$-CD-IN-NNP,NNP,6,1
0,0.0,29,is,2,1,28,27,0,0,1,26,Château d'Autet,France,LOC-LOC,LOC,PROPN-PROPN,PROPN,compound-nsubj,conj,NNP-NNP,NNP,2,1
1,0.0,29,is,2,9,28,19,8,0,-7,26,Luberon,France,LOC,LOC,PROPN,PROPN,compound,conj,NNP,NNP,5,1
2,0.0,29,is,2,15,18,3,14,10,-13,16,Viens,Vaucluse,LOC,LOC,PROPN,PROPN,pobj,compound,NNPS,NNP,1,1
3,0.0,29,is,2,15,28,13,14,0,-13,26,Viens,France,LOC,LOC,PROPN,PROPN,pobj,conj,NNPS,NNP,8,1
4,0.0,29,is,2,18,28,10,17,0,-16,26,Vaucluse,France,LOC,LOC,PROPN,PROPN,compound,conj,NNP,NNP,9,1
0,1.0,22,released,2,11,20,9,10,1,-9,18,Ipecac Recordings,Mike Patton,ORG-ORG,PER-PER,PROPN-PROPN,PROPN-PROPN,compound-pobj,compound-pobj,NNP-NNPS,NNP-NNP,4,1
0,1.0,15,incorporated,3,6,8,2,5,6,-3,5,Massachusetts,US,LOC,LOC,PROPN,PROPN,pobj,appos,NNP,NNP,2,1
0,0.0,18,is,13,1,10,9,0,7,12,-3,Pierre Marsan,Montreal,PER-PER,LOC,PROPN-PROPN,PROPN,compound-nsubj,pobj,NNP-NNP,NNP,4,1
1,2.0,33,went,1,1,5,4,0,27,0,4,Marsan,Université du Québec à Montréal,PER,ORG-ORG-ORG-ORG-ORG,PROPN,PROPN-PROPN-PROPN-X-PROPN,nsubj,nmod-nmod-pobj-det-appos,NNP,NNP-NNP-NNP-XX-NNP,3,1
2,2.0,33,went,1,1,5,4,0,27,0,4,Marsan,Université de Montréal,PER,ORG-ORG-ORG,PROPN,PROPN-PROPN-PROPN,nsubj,compound-compound-pobj,NNP,NNP-NNP-NNP,3,1
0,0.0,19,was,10,1,4,3,0,14,9,-6,Giacomo Albé,"July 18 , 1829",PER-PER,TIME-TIME-TIME-TIME,PROPN-PROPN,PROPN-NUM-PUNCT-NUM,compound-nsubj,appos-nummod-punct-nummod,NNP-NNP,"NNP-CD-,-CD",2,1
1,3.0,17,painted,6,9,11,2,8,5,-3,5,Havana,Cuba,LOC,LOC,PROPN,PROPN,pobj,dobj,NNP,NNP,4,1
0,0.0,23,is,2,14,17,3,13,5,-12,15,Lake Ohrid,Macedonia,LOC-LOC,LOC,PROPN-PROPN,PROPN,compound-pobj,pobj,NNP-NNP,NNP,3,1
0,0.0,28,is,13,24,27,3,23,0,-11,14,Rockdale County,Georgia,LOC-LOC,LOC,PROPN-PROPN,PROPN,compound-pobj,appos,NNP-NNP,NNP,5,1
1,3.0,8,is,1,1,6,5,0,1,0,5,Hadley,Dartmouth College,PER,ORG-ORG,PROPN,PROPN-PROPN,nsubj,compound-pobj,NNP,NNP-NNP,3,1
0,5.0,20,understood,18,8,15,7,7,4,10,-3,Achala,Argentina,LOC,LOC,PROPN,PROPN,nmod,pobj,NNP,NNP,7,1
1,5.0,20,understood,18,10,15,5,9,4,8,-3,Cerro Aspero,Argentina,LOC-LOC,LOC,PROPN-PROPN,PROPN,compound-conj,pobj,NNP-NNP,NNP,5,1
0,14.0,22,performed,4,18,21,3,17,0,-14,17,Auditorium Theatre,Chicago,LOC-LOC,LOC,PROPN-PROPN,PROPN,compound-pobj,pobj,NNP-NNP,NNP,3,1
0,0.0,27,is,3,1,6,5,0,20,2,3,Bedtime for Bonzo,1951,MISC-MISC-MISC,TIME,PROPN-ADP-PROPN,NUM,nsubj-prep-pobj,nummod,NNP-IN-NNP,CD,4,1
1,0.0,27,is,3,1,7,6,0,19,2,4,Bedtime for Bonzo,American,MISC-MISC-MISC,LOC,PROPN-ADP-PROPN,ADJ,nsubj-prep-pobj,amod,NNP-IN-NNP,JJ,4,1
2,0.0,27,is,3,1,12,11,0,14,2,9,Bedtime for Bonzo,Fred de Cordova,MISC-MISC-MISC,PER-PER-PER,PROPN-ADP-PROPN,PROPN-PROPN-PROPN,nsubj-prep-pobj,compound-compound-pobj,NNP-IN-NNP,NNP-NNP-NNP,7,1
3,0.0,27,is,3,1,20,19,0,6,2,17,Bedtime for Bonzo,Diana Lynn,MISC-MISC-MISC,PER-PER,PROPN-ADP-PROPN,PROPN-PROPN,nsubj-prep-pobj,compound-conj,NNP-IN-NNP,NNP-NNP,5,1
4,0.0,27,is,3,1,24,23,0,2,2,21,Bedtime for Bonzo,Peggy,MISC-MISC-MISC,PER,PROPN-ADP-PROPN,PROPN,nsubj-prep-pobj,conj,NNP-IN-NNP,NNP,7,1
5,6.0,32,hired,19,13,1,-12,12,30,6,-18,Bedtime for Bonzo,Peggy,MISC-MISC-MISC,PER,PROPN-ADP-PROPN,PROPN,pobj-prep-pobj,nsubj,NNP-IN-NNP,NNP,3,1
6,5.0,25,released,3,6,11,5,5,13,-3,8,Bonzo Goes to College,1952,MISC-MISC-MISC-MISC,TIME,PROPN-VERB-ADP-PROPN,NUM,compound-oprd-prep-pobj,appos,NNP-VBZ-IN-NNP,CD,3,1
0,1.0,32,involved,3,16,20,4,15,11,-13,17,Denver Broncos,NFL,ORG-ORG,ORG,PROPN-PROPN,PROPN,compound-conj,pobj,NNP-NNPS,NNP,1,1
1,3.0,79,posted,26,1,23,22,0,55,25,-3,Fatafehi,Snow College,PER,ORG-ORG,PROPN,PROPN-PROPN,nsubj,compound-pobj,NNP,NNP-NNP,5,1
2,4.0,34,was,1,1,13,12,0,20,0,12,Fatafehi,Snow College,PER,ORG-ORG,PROPN,PROPN-PROPN,nsubj,compound-pobj,NNP,NNP-NNP,4,1
0,0.0,23,is,18,14,16,2,13,6,4,-2,Wrexham,United Kingdom,LOC,LOC-LOC,PROPN,PROPN-PROPN,pobj,compound-appos,NNP,NNP-NNP,2,1
1,3.0,15,is,4,10,14,4,9,0,-6,10,University of Siena,Italy,ORG-ORG-ORG,LOC,PROPN-ADP-PROPN,PROPN,pobj-prep-pobj,appos,NNP-IN-NNP,NNP,5,1
0,0.0,38,is,18,28,11,-17,27,26,-10,-7,Donald Trump,the United States,PER-PER,LOC-LOC-LOC,PROPN-PROPN,DET-PROPN-PROPN,compound-pobj,det-compound-pobj,NNP-NNP,DT-NNP-NNP,10,1
0,0.0,29,House,2,1,5,4,0,23,1,3,Edward Mandell House,"July 26 , 1858",PER-PER-PER,TIME-TIME-TIME-TIME,PROPN-PROPN-PROPN,PROPN-NUM-PUNCT-NUM,compound-compound-ROOT,appos-nummod-punct-nummod,NNP-NNP-NNP,"NNP-CD-,-CD",3,1
1,0.0,29,House,2,1,10,9,0,18,1,8,Edward Mandell House,"March 28 , 1938",PER-PER-PER,TIME-TIME-TIME-TIME,PROPN-PROPN-PROPN,PROPN-NUM-PUNCT-NUM,compound-compound-ROOT,nsubj-nummod-punct-nummod,NNP-NNP-NNP,"NNP-CD-,-CD",4,1
2,0.0,29,House,2,1,17,16,0,11,1,15,Edward Mandell House,American,PER-PER-PER,LOC,PROPN-PROPN-PROPN,ADJ,compound-compound-ROOT,amod,NNP-NNP-NNP,JJ,3,1
3,3.0,47,hold,10,31,35,4,30,11,-21,25,World War I,1914,MISC-MISC-MISC,TIME,PROPN-PROPN-PROPN,NUM,compound-pobj-ROOT,nummod,NNP-NNP-NNP,CD,2,1
0,2.0,29,played,1,4,10,6,3,18,-3,9,Boys on the Docks,Do or Die,MISC-MISC-MISC-MISC,MISC-MISC-MISC,PROPN-ADP-DET-PROPN,VERB-CCONJ-VERB,pobj-prep-det-compound,conj-cc-conj,NNPS-IN-DT-NNP,VB-CC-VB,3,1
1,2.0,29,played,1,10,14,4,9,14,-9,13,Do or Die,The Gang 's All Here,MISC-MISC-MISC,MISC-MISC-MISC-MISC-MISC,VERB-CCONJ-VERB,DET-PROPN-PART-ADV-ADV,conj-cc-conj,det-poss-case-appos-advmod,VB-CC-VB,DT-NNP-POS-RB-RB,4,1
0,0.0,21,is,5,3,20,17,2,0,2,15,Kannada,India,MISC,LOC,PROPN,PROPN,compound,appos,NNP,NNP,3,1
1,0.0,21,is,5,11,20,9,10,0,-6,15,Kumta,India,LOC,LOC,PROPN,PROPN,compound,appos,NNP,NNP,4,1
0,0.0,30,is,10,1,6,5,0,23,9,-4,Hugo Néstor Conte,"April 14 , 1963",PER-PER-PER,TIME-TIME-TIME-TIME,PROPN-PROPN-PROPN,PROPN-NUM-PUNCT-NUM,compound-compound-nsubj,npadvmod-nummod-punct-nummod,NNP-NNP-NNP,"NNP-CD-,-CD",4,1
1,0.0,30,is,10,1,28,27,0,1,9,18,Hugo Néstor Conte,Summer Olympics,PER-PER-PER,MISC-MISC,PROPN-PROPN-PROPN,PROPN-PROPN,compound-compound-nsubj,compound-pobj,NNP-NNP-NNP,NNP-NNPS,6,1
2,3.0,38,was,15,15,9,-6,14,28,0,-6,Conte,1984 Summer Olympics,PER,MISC-MISC-MISC,PROPN,NUM-PROPN-PROPN,pobj,nummod-compound-pobj,NNP,CD-NNP-NNPS,5,1
3,3.0,38,was,15,34,36,2,33,1,-19,21,Seoul,South Korea,LOC,LOC-LOC,PROPN,PROPN-PROPN,pobj,compound-appos,NNP,NNP-NNP,2,1
4,3.0,38,was,15,9,13,4,8,24,6,-2,1984 Summer Olympics,Los Angeles,MISC-MISC-MISC,LOC-LOC,NUM-PROPN-PROPN,PROPN-PROPN,nummod-compound-pobj,compound-compound,CD-NNP-NNPS,NNP-NNP,4,1
0,16.0,29,moved,7,20,14,-6,19,14,-13,7,Kyoto,Yōgen - in,LOC,LOC-LOC-LOC,PROPN,PROPN-PUNCT-PROPN,pobj,compound-punct-appos,NNP,NNP-HYPH-NNP,4,1
0,0.0,32,Olza,3,1,11,10,0,20,2,8,Iñaki Ochoa de Olza,Pamplona,PER-PER-PER-PER,LOC,PROPN-PROPN-X-PROPN,PROPN,compound-compound-nmod-ROOT,pobj,NNP-NNP-FW-NNP,NNP,3,1
1,0.0,32,Olza,3,1,26,25,0,5,2,23,Iñaki Ochoa de Olza,Spanish,PER-PER-PER-PER,LOC,PROPN-PROPN-X-PROPN,ADJ,compound-compound-nmod-ROOT,amod,NNP-NNP-FW-NNP,JJ,3,1
2,0.0,32,Olza,3,20,22,2,19,9,-17,19,Annapurna,Nepal,LOC,LOC,PROPN,PROPN,pobj,appos,NNP,NNP,4,1
0,0.0,29,was,11,1,10,9,0,18,10,-1,Mohamed Qanyare Afrah,1941,PER-PER-PER,TIME,PROPN-PROPN-PROPN,NUM,compound-compound-nsubj,nummod,NNP-NNP-NNP,CD,3,1
0,0.0,34,was,14,1,5,4,0,28,13,-9,George Harrison Shull,"April 15 , 1874",PER-PER-PER,TIME-TIME-TIME-TIME,PROPN-PROPN-PROPN,PROPN-NUM-PUNCT-NUM,compound-compound-nsubj,appos-nummod-punct-nummod,NNP-NNP-NNP,"NNP-CD-,-CD",3,1
1,0.0,34,was,14,1,10,9,0,23,13,-4,George Harrison Shull,"September 28 , 1954",PER-PER-PER,TIME-TIME-TIME-TIME,PROPN-PROPN-PROPN,PROPN-NUM-PUNCT-NUM,compound-compound-nsubj,appos-nummod-punct-nummod,NNP-NNP-NNP,"NNP-CD-,-CD",3,1
2,0.0,34,was,14,1,18,17,0,15,13,4,George Harrison Shull,American,PER-PER-PER,LOC,PROPN-PROPN-PROPN,ADJ,compound-compound-nsubj,amod,NNP-NNP-NNP,JJ,4,1
3,1.0,81,born,2,58,67,9,57,13,-56,65,Station for Experimental Evolution,N. Y.,ORG-ORG-ORG-ORG,LOC-LOC,PROPN-ADP-PROPN-PROPN,PROPN-PROPN,pobj-prep-compound-pobj,compound-conj,NNP-IN-NNP-NNP,NNP-NNP,5,1
4,1.0,81,born,2,63,67,4,62,13,-61,65,Cold Spring Harbor,N. Y.,ORG-ORG-ORG,LOC-LOC,PROPN-PROPN-PROPN,PROPN-PROPN,compound-compound-appos,compound-conj,NNP-NNP-NNP,NNP-NNP,2,1
5,1.0,81,born,2,8,11,3,7,69,-6,9,Clark County,Ohio,LOC-LOC,LOC,PROPN-PROPN,PROPN,compound-pobj,appos,NNP-NNP,NNP,6,1
6,8.0,22,awarded,8,7,11,4,6,10,1,3,Shull,Public Welfare Medal,PER,MISC-MISC-MISC,PROPN,PROPN-PROPN-PROPN,nsubjpass,compound-compound-dobj,NNP,NNP-NNP-NNP,3,1
7,11.0,32,called,2,10,13,3,9,18,-8,11,Harrison Shull,1923–2003,PER-PER,TIME,PROPN-PROPN,NUM,compound-appos,appos,NNP-NNP,CD,5,1
0,0.0,23,was,13,1,6,5,0,16,12,-7,Alfred John Kennett Todd,13 April 1890,PER-PER-PER-PER,TIME-TIME-TIME,PROPN-PROPN-PROPN-PROPN,NUM-PROPN-NUM,compound-compound-compound-nsubj,nummod-nmod-nummod,NNP-NNP-NNP-NNP,CD-NNP-CD,2,1
1,0.0,23,was,13,1,10,9,0,12,12,-3,Alfred John Kennett Todd,27 August 1970,PER-PER-PER-PER,TIME-TIME-TIME,PROPN-PROPN-PROPN-PROPN,NUM-PROPN-NUM,compound-compound-compound-nsubj,nummod-appos-nummod,NNP-NNP-NNP-NNP,CD-NNP-CD,2,1
2,0.0,23,was,13,1,21,20,0,1,12,8,Alfred John Kennett Todd,United Kingdom,PER-PER-PER-PER,LOC-LOC,PROPN-PROPN-PROPN-PROPN,PROPN-PROPN,compound-compound-compound-nsubj,compound-pobj,NNP-NNP-NNP-NNP,NNP-NNP,5,1
3,0.0,23,was,13,16,21,5,15,1,-3,8,Conservative Party,United Kingdom,ORG-ORG,LOC-LOC,PROPN-PROPN,PROPN-PROPN,compound-compound,compound-pobj,NNP-NNP,NNP-NNP,3,1
4,6.0,19,is,4,3,7,4,2,11,1,3,Mark Todd,Labour Party,PER-PER,ORG-ORG,PROPN-PROPN,PROPN-PROPN,compound-appos,compound-compound,NNP-NNP,NNP-NNP,4,1
0,1.0,22,finished,19,10,14,4,9,7,9,-5,Godby,Åland,LOC,LOC,PROPN,PROPN,pobj,conj,NNP,NNP,7,1
1,1.0,22,finished,19,10,16,6,9,5,9,-3,Godby,Finland,LOC,LOC,PROPN,PROPN,pobj,appos,NNP,NNP,6,1
2,1.0,22,finished,19,12,16,4,11,5,7,-3,Mariehamn,Finland,LOC,LOC,PROPN,PROPN,conj,appos,NNP,NNP,2,1
3,1.0,22,finished,19,14,16,2,13,5,5,-3,Åland,Finland,LOC,LOC,PROPN,PROPN,conj,appos,NNP,NNP,3,1
4,3.0,23,finished,15,10,12,2,9,10,5,-3,Riga,Latvia,LOC,LOC,PROPN,PROPN,pobj,appos,NNP,NNP,6,1
5,6.0,23,finished,15,10,12,2,9,10,5,-3,Frederikshavn,Denmark,LOC,LOC,PROPN,PROPN,pobj,appos,NNP,NNP,3,1
6,7.0,21,finished,18,12,14,2,11,6,6,-4,Ostrava,Czech Republic,LOC,LOC-LOC,PROPN,PROPN-PROPN,conj,compound-nsubj,NNP,NNP-NNP,3,1
0,0.0,24,is,10,1,5,4,0,18,9,-5,Datawind,Montreal,ORG,LOC,PROPN,PROPN,nsubj,pobj,NNP,NNP,5,1
1,7.0,14,has,1,1,5,4,0,8,0,4,Datawind,Montreal,ORG,LOC,PROPN,PROPN,nsubj,pobj,NNP,NNP,4,1
2,0.0,24,is,10,5,7,2,4,16,5,-3,Montreal,Quebec,LOC,LOC,PROPN,PROPN,pobj,conj,NNP,NNP,3,1
3,0.0,24,is,10,5,9,4,4,14,5,-1,Montreal,Canada,LOC,LOC,PROPN,PROPN,pobj,appos,NNP,NNP,6,1
4,0.0,24,is,10,7,9,2,6,14,3,-1,Quebec,Canada,LOC,LOC,PROPN,PROPN,conj,appos,NNP,NNP,7,1
0,0.0,20,was,4,1,15,14,0,4,3,11,Operation Mobile,2011,MISC-MISC,TIME,PROPN-PROPN,NUM,compound-nsubj,nummod,NNP-NNP,CD,6,1
1,9.0,18,continued,3,8,2,-6,7,15,-5,-1,Operation Mobile,Canadian,MISC-MISC,LOC,PROPN-PROPN,ADJ,compound-pobj,amod,NNP-NNP,JJ,4,1
2,9.0,18,continued,3,8,15,7,7,2,-5,12,Operation Mobile,1 November 2011,MISC-MISC,TIME-TIME-TIME,PROPN-PROPN,NUM-PROPN-NUM,compound-pobj,nummod-pobj-nummod,NNP-NNP,CD-NNP-CD,3,1
0,0.0,37,is,2,1,20,19,0,16,1,18,Beaver River,Stillwater Reservoir,LOC-LOC,LOC-LOC,PROPN-PROPN,PROPN-PROPN,compound-nsubj,compound-pobj,NNP-NNP,NNP-NNP,5,1
1,6.0,18,named,3,7,16,9,6,1,-4,13,Beaver River,Stillwater Reservoir,LOC-LOC,LOC-LOC,PROPN-PROPN,PROPN-PROPN,compound-pobj,compound-dobj,NNP-NNP,NNP-NNP,3,1
2,0.0,37,is,2,1,35,34,0,1,1,33,Beaver River,United States,LOC-LOC,LOC-LOC,PROPN-PROPN,PROPN-PROPN,compound-nsubj,compound-appos,NNP-NNP,NNP-NNP,7,1
3,0.0,37,is,2,20,35,15,19,1,-18,33,Stillwater Reservoir,United States,LOC-LOC,LOC-LOC,PROPN-PROPN,PROPN-PROPN,compound-pobj,compound-appos,NNP-NNP,NNP-NNP,8,1
4,0.0,37,is,2,27,29,2,26,7,-25,27,Webb,Herkimer County,LOC,LOC-LOC,PROPN,PROPN-PROPN,pobj,compound-pobj,NNP,NNP-NNP,1,1
5,0.0,37,is,2,27,35,8,26,1,-25,33,Webb,United States,LOC,LOC-LOC,PROPN,PROPN-PROPN,pobj,compound-appos,NNP,NNP-NNP,2,1
6,0.0,37,is,2,29,35,6,28,1,-27,33,Herkimer County,United States,LOC-LOC,LOC-LOC,PROPN-PROPN,PROPN-PROPN,compound-pobj,compound-appos,NNP-NNP,NNP-NNP,1,1
7,0.0,37,is,2,32,35,3,31,1,-30,33,New York,United States,LOC-LOC,LOC-LOC,PROPN-PROPN,PROPN-PROPN,compound-conj,compound-appos,NNP-NNP,NNP-NNP,2,1
8,7.0,21,is,3,2,12,10,1,8,1,9,Beaver River,Black River,LOC-LOC,LOC-LOC,PROPN-PROPN,PROPN-PROPN,compound-nsubj,compound-pobj,NNP-NNP,NNP-NNP,4,1
9,7.0,21,is,3,2,18,16,1,2,1,15,Beaver River,Lake Ontario,LOC-LOC,LOC-LOC,PROPN-PROPN,PROPN-PROPN,compound-nsubj,compound-pobj,NNP-NNP,NNP-NNP,5,1
0,2.0,39,was,2,33,11,-22,32,27,-31,9,Moscow Does not Believe in Tears,Soviet Union,MISC-MISC-MISC-MISC-MISC-MISC,LOC-LOC,PROPN-VERB-ADV-VERB-ADP-PROPN,PROPN-PROPN,nsubj-aux-neg-advcl-prep-pobj,compound-pobj,NNP-VBZ-RB-VB-IN-NNP,NNP-NNP,8,1
1,2.0,39,was,2,33,11,-22,32,27,-31,9,Moscow Does not Believe in Tears,Soviet,MISC-MISC-MISC-MISC-MISC-MISC,LOC,PROPN-VERB-ADV-VERB-ADP-PROPN,ADJ,nsubj-aux-neg-advcl-prep-pobj,amod,NNP-VBZ-RB-VB-IN-NNP,JJ,8,1
2,8.0,20,received,5,12,16,4,11,3,-7,11,Natalya Negoda,Nika Awards,PER-PER,MISC-MISC,PROPN-PROPN,PROPN-PROPN,compound-pobj,compound-pobj,NNP-NNP,NNP-NNPS,4,1
0,0.0,20,was,14,1,5,4,0,14,13,-9,Gilbert Heron Miller,"July 3 , 1884",PER-PER-PER,TIME-TIME-TIME-TIME,PROPN-PROPN-PROPN,PROPN-NUM-PUNCT-NUM,compound-compound-nsubj,npadvmod-nummod-punct-nummod,NNP-NNP-NNP,"NNP-CD-,-CD",3,1
1,0.0,20,was,14,1,10,9,0,9,13,-4,Gilbert Heron Miller,"January 2 , 1969",PER-PER-PER,TIME-TIME-TIME-TIME,PROPN-PROPN-PROPN,PROPN-NUM-PUNCT-NUM,compound-compound-nsubj,appos-nummod-punct-nummod,NNP-NNP-NNP,"NNP-CD-,-CD",4,1
2,0.0,20,was,14,1,17,16,0,2,13,3,Gilbert Heron Miller,American,PER-PER-PER,LOC,PROPN-PROPN-PROPN,ADJ,compound-compound-nsubj,amod,NNP-NNP-NNP,JJ,4,1
3,1.0,32,was,7,17,20,3,16,11,-10,13,Henry Miller,1859,PER-PER,TIME,PROPN-PROPN,NUM,compound-pobj,nummod,NNP-NNP,CD,2,1
4,1.0,32,was,7,17,22,5,16,9,-10,15,Henry Miller,1926,PER-PER,TIME,PROPN-PROPN,NUM,compound-pobj,nummod,NNP-NNP,CD,4,1
5,1.0,32,was,7,17,25,8,16,6,-10,18,Henry Miller,Bijou Heron,PER-PER,PER-PER,PROPN-PROPN,PROPN-PROPN,compound-pobj,compound-conj,NNP-NNP,NNP-NNP,4,1
6,5.0,25,won,6,5,9,4,4,15,1,3,Gilbert Miller,Tony Award for Best Play,PER-PER,MISC-MISC-MISC-MISC-MISC,PROPN-PROPN,PROPN-PROPN-ADP-ADJ-PROPN,compound-nsubj,compound-dobj-prep-compound-pobj,NNP-NNP,NNP-NNP-IN-JJS-NNP,2,1
7,7.0,19,died,2,1,5,4,0,13,1,3,Gilbert Miller,1969,PER-PER,TIME,PROPN-PROPN,NUM,compound-nsubj,pobj,NNP-NNP,CD,2,1
8,7.0,19,died,2,11,15,4,10,3,-9,13,Woodlawn Cemetery,Bronx,LOC-LOC,LOC,PROPN-PROPN,PROPN,compound-pobj,pobj,NNP-NNP,NNP,1,1
9,7.0,19,died,2,15,17,2,14,1,-13,15,Bronx,New York,LOC,LOC-LOC,PROPN,PROPN-PROPN,pobj,compound-appos,NNP,NNP-NNP,2,1
0,1.0,19,purports,1,11,15,4,10,3,-10,14,Lavrentiy Beria,Soviet,PER-PER,LOC,PROPN-PROPN,ADJ,compound-pobj,amod,NNP-NNP,JJ,2,1
1,5.0,27,are,8,24,3,-21,23,23,-16,-5,L Ron Hubbard Jr.,L. Ron Hubbard,PER-PER-PER-PER,PER-PER-PER,PROPN-PROPN-PROPN-PROPN,PROPN-PROPN-PROPN,compound-compound-compound-appos,compound-compound-nsubj,NNP-NNP-NNP-NNP,NNP-NNP-NNP,8,1
0,6.0,41,northwards,13,3,36,33,2,4,10,23,yellow - faced honeyeaters,New South Wales,MISC-MISC-MISC-MISC,LOC-LOC-LOC,ADV-PUNCT-ADJ-NOUN,PROPN-PROPN-PROPN,advmod-punct-amod-nsubj,compound-compound-pobj,RB-HYPH-JJ-NNS,NNP-NNP-NNP,9,1
1,6.0,41,northwards,13,3,25,22,2,15,10,12,yellow - faced honeyeaters,Queensland,MISC-MISC-MISC-MISC,LOC,ADV-PUNCT-ADJ-NOUN,PROPN,advmod-punct-amod-nsubj,pobj,RB-HYPH-JJ-NNS,NNP,5,1
0,1.0,21,is,1,7,18,11,6,2,-6,17,the United States,Texas,LOC-LOC-LOC,LOC,DET-PROPN-PROPN,PROPN,det-compound-pobj,pobj,DT-NNP-NNP,NNP,2,1
1,1.0,21,is,1,7,20,13,6,0,-6,19,the United States,Virginia,LOC-LOC-LOC,LOC,DET-PROPN-PROPN,PROPN,det-compound-pobj,pobj,DT-NNP-NNP,NNP,5,1
0,1.0,23,imprisoned,10,2,4,2,1,18,8,-6,Japan,World War II,LOC,MISC-MISC-MISC,PROPN,PROPN-PROPN-PROPN,poss,compound-compound-compound,NNP,NNP-NNP-NNP,4,1
0,2.0,50,viewed,3,49,16,-33,48,33,-46,13,Wei,Zhang Chonghua,PER,PER-PER,PROPN,PROPN-PROPN,pobj,compound-poss,NNP,NNP-NNP,6,1
1,2.0,50,viewed,3,49,16,-33,48,33,-46,13,Wei,Zhang Tianxi,PER,PER-PER,PROPN,PROPN-PROPN,pobj,compound-appos,NNP,NNP-NNP,6,1
2,2.0,50,viewed,3,16,16,0,15,33,-13,13,Zhang Yaoling,Zhang Chonghua,PER-PER,PER-PER,PROPN-PROPN,PROPN-PROPN,compound-appos,compound-poss,NNP-NNP,NNP-NNP,0,1
3,2.0,50,viewed,3,16,16,0,15,33,-13,13,Zhang Chonghua,Zhang Tianxi,PER-PER,PER-PER,PROPN-PROPN,PROPN-PROPN,compound-poss,compound-appos,NNP-NNP,NNP-NNP,0,1
0,4.0,23,is,1,3,15,12,2,7,-2,14,Cornell,Audioslave,PER,ORG,PROPN,PROPN,poss,dobj,NNP,NNP,5,1
0,1.0,32,born,2,8,11,3,7,20,-6,9,Allegheny County,Pennsylvania,LOC-LOC,LOC,PROPN-PROPN,PROPN,compound-pobj,appos,NNP-NNP,NNP,3,1
0,0.0,18,is,1,1,11,10,0,6,0,10,Petersfield,East Hampshire,LOC,LOC-LOC,PROPN,PROPN-PROPN,nsubj,compound-compound,NNP,NNP-NNP,4,1
1,0.0,18,is,1,11,12,1,10,5,-10,11,East Hampshire,Hampshire,LOC-LOC,LOC,PROPN-PROPN,PROPN,compound-compound,pobj,NNP-NNP,NNP,1,1
2,5.0,13,twinned,2,1,10,9,0,2,1,8,Petersfield,Warendorf,LOC,LOC,PROPN,PROPN,nsubjpass,conj,NNP,NNP,3,1
3,5.0,13,twinned,2,5,7,2,4,5,-3,5,Barentin,France,LOC,LOC,PROPN,PROPN,pobj,pobj,NNP,NNP,2,1
4,5.0,13,twinned,2,10,12,2,9,0,-8,10,Warendorf,Germany,LOC,LOC,PROPN,PROPN,conj,pobj,NNP,NNP,3,1
0,0.0,17,was,4,2,15,13,1,1,2,11,sponging - house,United Kingdom,LOC-LOC-LOC,LOC-LOC,NOUN-PUNCT-NOUN,PROPN-PROPN,compound-punct-nsubj,compound-pobj,NN-HYPH-NN,NNP-NNP,9,1
1,5.0,15,set,2,10,14,4,9,0,-8,12,The Three Clerks,1857,MISC-MISC-MISC,TIME,DET-PROPN-PROPN,NUM,det-compound-ROOT,pobj,DT-NNP-NNPS,CD,3,1
0,1.0,20,is,9,19,16,-3,18,3,-10,7,Chongqing,Yuzhong District,LOC,LOC-LOC,PROPN,PROPN-PROPN,pobj,compound-pobj,NNP,NNP-NNP,4,1
1,2.0,25,park,1,15,21,6,14,3,-14,20,KMT,Republic of China,ORG,LOC-LOC-LOC,PROPN,PROPN-ADP-PROPN,compound,nmod-prep-pobj,NNP,NNP-IN-NNP,4,1
0,0.0,19,is,12,1,5,4,0,13,11,-7,Synnøve Svabø,22 September 1968,PER-PER,TIME-TIME-TIME,PROPN-PROPN,NUM-PROPN-NUM,compound-nsubj,nummod-npadvmod-nummod,NNP-NNP,CD-NNP-CD,2,1
1,0.0,19,is,12,1,9,8,0,9,11,-3,Synnøve Svabø,Sunnmøre,PER-PER,LOC,PROPN-PROPN,PROPN,compound-nsubj,pobj,NNP-NNP,NNP,4,1
2,0.0,19,is,12,1,11,10,0,7,11,-1,Synnøve Svabø,Norway,PER-PER,LOC,PROPN-PROPN,PROPN,compound-nsubj,appos,NNP-NNP,NNP,1,1
3,0.0,19,is,12,1,15,14,0,3,11,3,Synnøve Svabø,Norwegian,PER-PER,LOC,PROPN-PROPN,ADJ,compound-nsubj,amod,NNP-NNP,JJ,4,1
4,0.0,19,is,12,9,11,2,8,7,3,-1,Sunnmøre,Norway,LOC,LOC,PROPN,PROPN,pobj,appos,NNP,NNP,5,1
5,0.0,19,is,12,9,15,6,8,3,3,3,Sunnmøre,Norwegian,LOC,LOC,PROPN,ADJ,pobj,amod,NNP,JJ,8,1
6,1.0,20,known,3,20,11,-9,19,8,-17,8,Norway,Thorbjørn Jagland,LOC,PER-PER,PROPN,PROPN-PROPN,pobj,compound-pobj,NNP,NNP-NNP,-1,1
0,0.0,17,is,6,1,9,8,0,7,5,3,Makvala Kasrashvili,Georgian,PER-PER,LOC,PROPN-PROPN,ADJ,compound-nsubj,amod,NNP-NNP,JJ,4,1
1,1.0,31,graduated,23,18,20,2,17,10,5,-3,Kutaisi,Georgian SSR,LOC,LOC-LOC,PROPN,PROPN-PROPN,pobj,compound-npadvmod,NNP,NNP-NNP,2,1
2,2.0,14,been,5,10,13,3,9,0,-5,8,Bolshoi Theatre,Moscow,LOC-LOC,LOC,PROPN-PROPN,PROPN,compound-pobj,appos,NNP-NNP,NNP,4,1
3,3.0,30,performed,19,7,10,3,6,19,12,-9,Metropolitan Opera,New York City,LOC-LOC,LOC-LOC-LOC,PROPN-PROPN,PROPN-PROPN-PROPN,compound-pobj,compound-compound-appos,NNP-NNP,NNP-NNP-NNP,2,1
0,0.0,37,is,2,9,31,22,8,5,-7,29,the United States,Alaska,LOC-LOC-LOC,LOC,DET-PROPN-PROPN,PROPN,det-compound-conj,appos,DT-NNP-NNP,NNP,8,1
0,0.0,47,is,10,1,5,4,0,41,9,-5,Károly Güttler,15 June 1968,PER-PER,TIME-TIME-TIME,PROPN-PROPN,NUM-PROPN-NUM,compound-nsubj,nummod-npadvmod-nummod,NNP-NNP,CD-NNP-CD,2,1
1,0.0,47,is,10,1,9,8,0,37,9,-1,Károly Güttler,Budapest,PER-PER,LOC,PROPN-PROPN,PROPN,compound-nsubj,pobj,NNP-NNP,NNP,1,1
2,0.0,47,is,10,1,16,15,0,30,9,6,Károly Güttler,Hungary,PER-PER,LOC,PROPN-PROPN,PROPN,compound-nsubj,pobj,NNP-NNP,NNP,5,1
3,0.0,47,is,10,1,31,30,0,15,9,21,Károly Güttler,1988 Summer Olympics,PER-PER,MISC-MISC-MISC,PROPN-PROPN,NUM-PROPN-PROPN,compound-nsubj,nummod-compound-pobj,NNP-NNP,CD-NNP-NNPS,9,1
4,0.0,47,is,10,1,40,39,0,6,9,30,Károly Güttler,2000 Summer Olympics,PER-PER,MISC-MISC-MISC,PROPN-PROPN,NUM-PROPN-PROPN,compound-nsubj,nummod-compound-pobj,NNP-NNP,CD-NNP-NNPS,10,1
5,0.0,47,is,10,31,35,4,30,11,-21,25,1988 Summer Olympics,Seoul,MISC-MISC-MISC,LOC,NUM-PROPN-PROPN,PROPN,nummod-compound-pobj,pobj,CD-NNP-NNPS,NNP,4,1
6,0.0,47,is,10,40,44,4,39,2,-30,34,2000 Summer Olympics,Sydney,MISC-MISC-MISC,LOC,NUM-PROPN-PROPN,PROPN,nummod-compound-pobj,pobj,CD-NNP-NNPS,NNP,4,1
7,2.0,34,enjoyed,1,30,32,2,29,1,-29,31,Sheffield,United Kingdom,LOC,LOC-LOC,PROPN,PROPN-PROPN,pobj,compound-appos,NNP,NNP-NNP,2,1
0,0.0,18,is,12,1,5,4,0,12,11,-7,Chris Leck,21 May 1986,PER-PER,TIME-TIME-TIME,PROPN-PROPN,NUM-PROPN-NUM,compound-nsubj,nummod-npadvmod-nummod,NNP-NNP,CD-NNP-CD,2,1
1,0.0,18,is,12,1,9,8,0,8,11,-3,Chris Leck,Manchester,PER-PER,LOC,PROPN-PROPN,PROPN,compound-nsubj,pobj,NNP-NNP,NNP,4,1
2,0.0,18,is,12,9,11,2,8,6,3,-1,Manchester,England,LOC,LOC,PROPN,PROPN,pobj,appos,NNP,NNP,5,1
0,0.0,40,fought,5,2,8,6,1,31,3,3,Second Boer War,11 October 1899,MISC-MISC-MISC,TIME-TIME-TIME,PROPN-PROPN-PROPN,NUM-PROPN-NUM,compound-compound-nsubjpass,nummod-pobj-nummod,NNP-NNP-NNP,CD-NNP-CD,4,1
1,0.0,40,fought,5,2,12,10,1,27,3,7,Second Boer War,31 May 1902,MISC-MISC-MISC,TIME-TIME-TIME,PROPN-PROPN-PROPN,NUM-PROPN-NUM,compound-compound-nsubjpass,nummod-pobj-nummod,NNP-NNP-NNP,CD-NNP-CD,4,1
2,0.0,40,fought,5,2,18,16,1,21,3,13,Second Boer War,British Empire,MISC-MISC-MISC,LOC-LOC,PROPN-PROPN-PROPN,PROPN-PROPN,compound-compound-nsubjpass,compound-pobj,NNP-NNP-NNP,NNP-NNP,4,1
3,0.0,40,fought,5,2,28,26,1,11,3,23,Second Boer War,Orange Free State,MISC-MISC-MISC,LOC-LOC-LOC,PROPN-PROPN-PROPN,PROPN-PROPN-PROPN,compound-compound-nsubjpass,compound-compound-pobj,NNP-NNP-NNP,NNP-NNP-NNP,8,1
4,0.0,40,fought,5,2,33,31,1,6,3,28,Second Boer War,South African Republic,MISC-MISC-MISC,LOC-LOC-LOC,PROPN-PROPN-PROPN,PROPN-PROPN-PROPN,compound-compound-nsubjpass,compound-compound-conj,NNP-NNP-NNP,NNP-NNP-NNP,9,1
5,0.0,40,fought,5,2,37,35,1,2,3,32,Second Boer War,Transvaal Republic,MISC-MISC-MISC,LOC-LOC,PROPN-PROPN-PROPN,PROPN-PROPN,compound-compound-nsubjpass,compound-appos,NNP-NNP-NNP,NNP-NNP,9,1
0,4.0,48,bookended,3,31,29,-2,30,18,-28,26,A Tribute to Blackwell,1987,MISC-MISC-MISC-MISC,TIME,DET-PROPN-ADP-PROPN,NUM,compound-conj-prep-pobj,poss,DT-NNP-IN-NNP,CD,2,1
0,0.0,20,is,2,1,5,4,0,14,1,3,Trees Lounge,1996,MISC-MISC,TIME,PROPN-PROPN,NUM,compound-nsubj,nummod,NNP-NNP,CD,4,1
1,0.0,20,is,2,1,14,13,0,5,1,12,Trees Lounge,Steve Buscemi,MISC-MISC,PER-PER,PROPN-PROPN,PROPN-PROPN,compound-nsubj,compound-pobj,NNP-NNP,NNP-NNP,5,1
2,2.0,65,cited,19,38,34,-4,37,30,-19,15,Pine Barrens,Buscemi,MISC-MISC,PER,PROPN-PROPN,PROPN,compound-dobj,dobj,NNP-NNP,NNP,2,1
3,2.0,65,cited,19,38,1,-37,37,63,-19,-18,Pine Barrens,The Sopranos,MISC-MISC,MISC-MISC,PROPN-PROPN,DET-PROPN,compound-dobj,det-compound,NNP-NNP,DT-NNP,9,1
4,2.0,65,cited,19,53,1,-52,52,63,-34,-18,Tony Soprano,The Sopranos,PER-PER,MISC-MISC,PROPN-PROPN,DET-PROPN,compound-poss,det-compound,NNP-NNP,DT-NNP,11,1
5,2.0,65,cited,19,53,28,-25,52,36,-34,9,Tony Soprano,David Chase,PER-PER,PER-PER,PROPN-PROPN,PROPN-PROPN,compound-poss,compound-pobj,NNP-NNP,NNP-NNP,5,1
6,2.0,65,cited,19,53,34,-19,52,30,-34,15,Tony Blundetto,Buscemi,PER-PER,PER,PROPN-PROPN,PROPN,compound-pobj,dobj,NNP-NNP,NNP,6,1
7,2.0,65,cited,19,53,1,-52,52,63,-34,-18,Tony Blundetto,The Sopranos,PER-PER,MISC-MISC,PROPN-PROPN,DET-PROPN,compound-pobj,det-compound,NNP-NNP,DT-NNP,11,1
8,2.0,65,cited,19,1,28,27,0,36,18,9,The Sopranos,David Chase,MISC-MISC,PER-PER,DET-PROPN,PROPN-PROPN,det-compound,compound-pobj,DT-NNP,NNP-NNP,6,1
0,3.0,17,renamed,2,1,1,0,0,15,1,-1,BAE Systems Southeast Shipyards,BAE Systems Inc.,ORG-ORG-ORG-ORG,ORG-ORG-ORG,PROPN-PROPN-PROPN-PROPN,PROPN-PROPN-PROPN,compound-compound-compound-appos,compound-subtok-pobj,NNP-NNP-NNP-NNPS,NNP-NNPS-NNP,0,1
0,1.0,37,graduated,9,9,3,-6,8,33,0,-6,Murphy,Platteville,PER,LOC,PROPN,PROPN,nsubj,pobj,NNP,NNP,3,1
1,1.0,37,graduated,9,9,13,4,8,23,0,4,Murphy,State Normal School,PER,ORG-ORG-ORG,PROPN,PROPN-PROPN-PROPN,nsubj,compound-compound-pobj,NNP,NNP-NNP-NNP,3,1
2,1.0,37,graduated,9,9,19,10,8,17,0,10,Murphy,University of Michigan Law School,PER,ORG-ORG-ORG-ORG-ORG,PROPN,PROPN-ADP-PROPN-PROPN-PROPN,nsubj,nmod-prep-pobj-compound-pobj,NNP,NNP-IN-NNP-NNP-NNP,4,1
3,2.0,21,practiced,1,13,16,3,12,4,-12,15,Grant County,Wisconsin,LOC-LOC,LOC,PROPN-PROPN,PROPN,compound-pobj,appos,NNP-NNP,NNP,5,1
0,0.0,22,is,10,1,13,12,0,8,9,3,Vincent Di Fate,American,PER-PER-PER,LOC,PROPN-PROPN-PROPN,ADJ,compound-compound-nsubj,amod,NNP-NNP-NNP,JJ,3,1
1,2.0,10,born,3,1,6,5,0,3,2,3,Di Fate,Yonkers,PER-PER,LOC,PROPN-PROPN,PROPN,compound-nsubjpass,pobj,NNP-NNP,NNP,4,1
0,4.0,28,known,6,13,4,-9,12,23,-7,-2,Colombia,South America,LOC,LOC-LOC,PROPN,PROPN-PROPN,pobj,compound-pobj,NNP,NNP-NNP,8,1
1,4.0,28,known,6,15,4,-11,14,23,-9,-2,Venezuela,South America,LOC,LOC-LOC,PROPN,PROPN-PROPN,conj,compound-pobj,NNP,NNP-NNP,4,1
2,4.0,28,known,6,21,4,-17,20,23,-15,-2,Aruba,South America,LOC,LOC-LOC,PROPN,PROPN-PROPN,pobj,compound-pobj,NNP,NNP-NNP,8,1
3,4.0,28,known,6,23,4,-19,22,23,-17,-2,Curaçao,South America,LOC,LOC-LOC,PROPN,PROPN-PROPN,conj,compound-pobj,NNP,NNP-NNP,9,1
4,4.0,28,known,6,27,4,-23,26,23,-21,-2,Trinidad,South America,LOC,LOC-LOC,PROPN,PROPN-PROPN,conj,compound-pobj,NNP,NNP-NNP,4,1
0,0.0,35,was,12,1,5,4,0,29,11,-7,Joel Mandelstam FRS,13 November 1919,PER-PER-PER,TIME-TIME-TIME,PROPN-PROPN-PROPN,NUM-PROPN-NUM,compound-compound-nsubj,nummod-appos-nummod,NNP-NNP-NNP,CD-NNP-CD,2,1
1,0.0,35,was,12,1,9,8,0,25,11,-3,Joel Mandelstam FRS,20 December 2008,PER-PER-PER,TIME-TIME-TIME,PROPN-PROPN-PROPN,NUM-PROPN-NUM,compound-compound-nsubj,nummod-appos-nummod,NNP-NNP-NNP,CD-NNP-CD,2,1
2,0.0,35,was,12,1,15,14,0,19,11,3,Joel Mandelstam FRS,British,PER-PER-PER,LOC,PROPN-PROPN-PROPN,ADJ,compound-compound-nsubj,amod,NNP-NNP-NNP,JJ,3,1
0,6.0,22,is,2,1,10,9,0,11,1,8,Pierre Cossette,Grammy Trustees Award,PER-PER,MISC-MISC-MISC,PROPN-PROPN,PROPN-PROPN-PROPN,compound-nsubj,compound-compound-dobj,NNP-NNP,NNP-NNPS-NNP,5,1
0,1.0,11,founded,3,8,10,2,7,0,-5,7,Sollentuna,Sweden,LOC,LOC,PROPN,PROPN,pobj,appos,NNP,NNP,4,1
0,0.0,23,Maclay,2,1,5,4,0,17,1,3,William Brown Maclay,"March 20 , 1812",PER-PER-PER,TIME-TIME-TIME-TIME,PROPN-PROPN-PROPN,PROPN-NUM-PUNCT-NUM,compound-compound-ROOT,appos-nummod-punct-nummod,NNP-NNP-NNP,"NNP-CD-,-CD",3,1
1,0.0,23,Maclay,2,1,10,9,0,12,1,8,William Brown Maclay,"February 19 , 1882",PER-PER-PER,TIME-TIME-TIME-TIME,PROPN-PROPN-PROPN,PROPN-NUM-PUNCT-NUM,compound-compound-ROOT,nsubj-nummod-punct-nummod,NNP-NNP-NNP,"NNP-CD-,-CD",4,1
0,0.0,34,is,5,2,29,27,1,4,3,24,Mendham Township Public Schools,New Jersey,ORG-ORG-ORG-ORG,LOC-LOC,PROPN-PROPN-PROPN-PROPN,PROPN-PROPN,compound-compound-compound-nsubj,compound-conj,NNP-NNP-NNP-NNPS,NNP-NNP,5,1
1,0.0,34,is,5,2,32,30,1,1,3,27,Mendham Township Public Schools,United States,ORG-ORG-ORG-ORG,LOC-LOC,PROPN-PROPN-PROPN-PROPN,PROPN-PROPN,compound-compound-compound-nsubj,compound-appos,NNP-NNP-NNP-NNPS,NNP-NNP,5,1
2,0.0,34,is,5,2,26,24,1,7,3,21,Mendham Township,Morris County,LOC-LOC,LOC-LOC,PROPN-PROPN,PROPN-PROPN,compound-pobj,compound-pobj,NNP-NNP,NNP-NNP,4,1
3,0.0,34,is,5,2,32,30,1,1,3,27,Mendham Township,United States,LOC-LOC,LOC-LOC,PROPN-PROPN,PROPN-PROPN,compound-pobj,compound-appos,NNP-NNP,NNP-NNP,5,1
4,0.0,34,is,5,26,29,3,25,4,-21,24,Morris County,New Jersey,LOC-LOC,LOC-LOC,PROPN-PROPN,PROPN-PROPN,compound-pobj,compound-conj,NNP-NNP,NNP-NNP,1,1
5,0.0,34,is,5,26,32,6,25,1,-21,27,Morris County,United States,LOC-LOC,LOC-LOC,PROPN-PROPN,PROPN-PROPN,compound-pobj,compound-appos,NNP-NNP,NNP-NNP,1,1
6,0.0,34,is,5,29,32,3,28,1,-24,27,New Jersey,United States,LOC-LOC,LOC-LOC,PROPN-PROPN,PROPN-PROPN,compound-conj,compound-appos,NNP-NNP,NNP-NNP,2,1
0,0.0,21,was,11,1,4,3,0,16,10,-7,Andrew White,27 July 1930,PER-PER,TIME-TIME-TIME,PROPN-PROPN,NUM-PROPN-NUM,compound-nsubj,nummod-nmod-nummod,NNP-NNP,CD-NNP-CD,1,1
1,0.0,21,was,11,1,8,7,0,12,10,-3,Andrew White,9 November 2015,PER-PER,TIME-TIME-TIME,PROPN-PROPN,NUM-PROPN-NUM,compound-nsubj,nummod-appos-nummod,NNP-NNP,CD-NNP-CD,1,1
2,2.0,29,featured,2,26,23,-3,25,5,-24,21,Please Please Me,British,MISC-MISC-MISC,LOC,INTJ-INTJ-PRON,ADJ,intj-agent-dobj,amod,UH-UH-PRP,JJ,8,1
0,1.0,26,operates,13,3,8,5,2,17,10,-5,Reliance Industries,Navi Mumbai,ORG-ORG,LOC-LOC,PROPN-PROPN,PROPN-PROPN,compound-pobj,compound-pobj,NNP-NNPS,NNP-NNP,5,1
1,1.0,26,operates,13,8,11,3,7,14,5,-2,Navi Mumbai,Maharashtra,LOC-LOC,LOC,PROPN-PROPN,PROPN,compound-pobj,appos,NNP-NNP,NNP,5,1
2,4.0,32,launched,13,11,17,6,10,14,2,4,Gigafiber,Reliance Industries Limited,MISC,ORG-ORG-ORG,PROPN,PROPN-PROPN-PROPN,oprd,compound-compound-poss,NNP,NNP-NNPS-NNP,6,1
3,4.0,32,launched,13,22,17,-5,21,14,-9,4,Mukesh Ambani,Reliance Industries Limited,PER-PER,ORG-ORG-ORG,PROPN-PROPN,PROPN-PROPN-PROPN,compound-appos,compound-compound-poss,NNP-NNP,NNP-NNPS-NNP,3,1
4,4.0,32,launched,13,29,17,-12,28,14,-16,4,Annual General Meeting,Reliance Industries Limited,MISC-MISC-MISC,ORG-ORG-ORG,PROPN-PROPN-PROPN,PROPN-PROPN-PROPN,compound-compound-pobj,compound-compound-poss,NNP-NNP-NNP,NNP-NNPS-NNP,8,1
0,0.0,31,was,15,1,7,6,0,23,14,-8,Mario Arturo Acosta Chaparro Escápite,19 January 1942,PER-PER-PER-PER-PER,TIME-TIME-TIME,PROPN-PROPN-PROPN-PROPN-PROPN,NUM-PROPN-NUM,compound-compound-compound-compound-nsubj,nummod-appos-nummod,NNP-NNP-NNP-NNP-NNP,CD-NNP-CD,3,1
1,0.0,31,was,15,1,12,11,0,18,14,-3,Mario Arturo Acosta Chaparro Escápite,20 April 2012,PER-PER-PER-PER-PER,TIME-TIME-TIME,PROPN-PROPN-PROPN-PROPN-PROPN,NUM-PROPN-NUM,compound-compound-compound-compound-nsubj,nummod-appos-nummod,NNP-NNP-NNP-NNP-NNP,CD-NNP-CD,4,1
2,0.0,31,was,15,1,18,17,0,12,14,3,Mario Arturo Acosta Chaparro Escápite,Mexican Army,PER-PER-PER-PER-PER,ORG-ORG,PROPN-PROPN-PROPN-PROPN-PROPN,PROPN-PROPN,compound-compound-compound-compound-nsubj,compound-compound,NNP-NNP-NNP-NNP-NNP,NNP-NNP,5,1
3,0.0,31,was,15,1,29,28,0,1,14,14,Mario Arturo Acosta Chaparro Escápite,Mexico City,PER-PER-PER-PER-PER,LOC-LOC,PROPN-PROPN-PROPN-PROPN-PROPN,PROPN-PROPN,compound-compound-compound-compound-nsubj,compound-pobj,NNP-NNP-NNP-NNP-NNP,NNP-NNP,9,1
0,2.0,29,had,1,6,17,11,5,11,-5,16,Pierre Renoir,Auguste Renoir,PER-PER,PER-PER,PROPN-PROPN,PROPN-PROPN,compound-pobj,compound-appos,NNP-NNP,NNP-NNP,9,1
0,0.0,34,is,4,1,9,8,0,24,3,5,The New Chinese Empire,Ross Terrill,MISC-MISC-MISC-MISC,PER-PER,DET-PROPN-PROPN-PROPN,PROPN-PROPN,det-compound-compound-nsubj,compound-pobj,DT-NNP-NNP-NNP,NNP-NNP,5,1
1,0.0,34,is,4,1,15,14,0,18,3,11,The New Chinese Empire,Basic Books,MISC-MISC-MISC-MISC,ORG-ORG,DET-PROPN-PROPN-PROPN,PROPN-PROPN,det-compound-compound-nsubj,compound-pobj,DT-NNP-NNP-NNP,NNP-NNPS,8,1
2,0.0,34,is,4,1,18,17,0,15,3,14,The New Chinese Empire,2003,MISC-MISC-MISC-MISC,TIME,DET-PROPN-PROPN-PROPN,NUM,det-compound-compound-nsubj,pobj,DT-NNP-NNP-NNP,CD,7,1
3,4.0,37,draws,9,1,4,3,0,32,8,-5,Terrill,Harvard,PER,ORG,PROPN,PROPN,nsubj,compound,NNP,NNP,2,1
0,0.0,23,is,3,1,13,12,0,9,2,10,Goresbridge,County Kilkenny,LOC,LOC-LOC,PROPN,PROPN-PROPN,nsubj,compound-pobj,NNP,NNP-NNP,7,1
1,1.0,35,named,2,1,24,23,0,10,1,22,Goresbridge,County Kilkenny,LOC,LOC-LOC,PROPN,PROPN-PROPN,nsubjpass,compound-pobj,NNP,NNP-NNP,12,1
2,0.0,23,is,3,13,20,7,12,2,-10,17,County Kilkenny,Leinster,LOC-LOC,LOC,PROPN-PROPN,PROPN,compound-pobj,pobj,NNP-NNP,NNP,10,1
3,0.0,23,is,3,13,22,9,12,0,-10,19,County Kilkenny,Ireland,LOC-LOC,LOC,PROPN-PROPN,PROPN,compound-pobj,appos,NNP-NNP,NNP,7,1
4,0.0,23,is,3,20,22,2,19,0,-17,19,Leinster,Ireland,LOC,LOC,PROPN,PROPN,pobj,appos,NNP,NNP,7,1
5,5.0,12,occurred,6,3,10,7,2,1,3,4,Battle of Goresbridge,June 1798,MISC-MISC-MISC,TIME-TIME,PROPN-ADP-PROPN,PROPN-NUM,nsubj-prep-pobj,pobj-nummod,NNP-IN-NNP,NNP-CD,5,1
0,0.0,21,was,13,1,6,5,0,14,12,-7,Manol Manolov,4 August 1925,PER-PER,TIME-TIME-TIME,PROPN-PROPN,NUM-PROPN-NUM,compound-nsubj,nummod-nmod-nummod,NNP-NNP,CD-NNP-CD,1,1
1,0.0,21,was,13,1,10,9,0,10,12,-3,Manol Manolov,16 December 2008,PER-PER,TIME-TIME-TIME,PROPN-PROPN,NUM-PROPN-NUM,compound-nsubj,nummod-npadvmod-nummod,NNP-NNP,CD-NNP-CD,2,1
2,2.0,22,featured,1,1,19,18,0,2,0,18,Manolov,1956 Summer Olympics,PER,MISC-MISC-MISC,PROPN,NUM-PROPN-PROPN,nsubj,nummod-compound-pobj,NNP,CD-NNP-NNPS,4,1
0,0.0,40,is,26,35,37,2,34,2,-9,11,Ahmedabad,Gujarat,LOC,LOC,PROPN,PROPN,pobj,conj,NNP,NNP,3,1
1,0.0,40,is,26,35,39,4,34,0,-9,13,Ahmedabad,India,LOC,LOC,PROPN,PROPN,pobj,appos,NNP,NNP,7,1
2,0.0,40,is,26,37,39,2,36,0,-11,13,Gujarat,India,LOC,LOC,PROPN,PROPN,conj,appos,NNP,NNP,8,1
0,0.0,43,was,21,1,5,4,0,37,20,-16,Michael H. Robinson,1929,PER-PER-PER,TIME,PROPN-PROPN-PROPN,NUM,compound-compound-nsubj,appos,NNP-NNP-NNP,CD,2,1
1,0.0,43,was,21,1,7,6,0,35,20,-14,Michael H. Robinson,Preston,PER-PER-PER,LOC,PROPN-PROPN-PROPN,PROPN,compound-compound-nsubj,npadvmod,NNP-NNP-NNP,NNP,3,1
2,0.0,43,was,21,1,9,8,0,33,20,-12,Michael H. Robinson,Lancashire,PER-PER-PER,LOC,PROPN-PROPN-PROPN,PROPN,compound-compound-nsubj,conj,NNP-NNP-NNP,NNP,4,1
3,0.0,43,was,21,1,13,12,0,29,20,-8,Michael H. Robinson,"March 22 , 2008",PER-PER-PER,TIME-TIME-TIME-TIME,PROPN-PROPN-PROPN,PROPN-NUM-PUNCT-NUM,compound-compound-nsubj,conj-nummod-punct-conj,NNP-NNP-NNP,"NNP-CD-,-CD",3,1
4,0.0,43,was,21,1,18,17,0,24,20,-3,Michael H. Robinson,Alexandria,PER-PER-PER,LOC,PROPN-PROPN-PROPN,PROPN,compound-compound-nsubj,conj,NNP-NNP-NNP,NNP,4,1
0,0.0,15,is,7,1,10,9,0,4,6,3,Ayatollah of Rock ' n ' Rolla,2014,MISC-MISC-MISC-MISC-MISC-MISC-MISC,TIME,PROPN-ADP-PROPN-CCONJ-CCONJ-PUNCT-PROPN,NUM,nmod-prep-pobj-subtok-subtok-punct-nsubj,nummod,NNP-IN-NNP-CC-CC-``-NNP,CD,3,1
0,0.0,25,born,3,1,5,4,0,19,2,2,Matthias Sammer,5 September 1967,PER-PER,TIME-TIME-TIME,PROPN-PROPN,NUM-PROPN-NUM,compound-compound,nummod-npadvmod-nummod,NNP-NNP,CD-NNP-CD,3,1
1,2.0,45,won,8,8,2,-6,7,42,0,-6,Sammer,Borussia Dortmund,PER,ORG-ORG,PROPN,PROPN-PROPN,nsubj,compound-pobj,NNP,NNP-NNP,2,1
2,5.0,14,won,8,2,7,5,1,6,6,-1,Sammer,Borussia Dortmund,PER,ORG-ORG,PROPN,PROPN-PROPN,pobj,compound-nsubj,NNP,NNP-NNP,4,1
3,3.0,34,won,7,7,10,3,6,23,0,3,Sammer,UEFA Euro 1996,PER,MISC-MISC-MISC,PROPN,PROPN-PROPN-NUM,nsubj,compound-dobj-nummod,NNP,NNP-NNP-CD,1,1
4,3.0,34,won,7,7,29,22,6,4,0,22,Sammer,Ballon d'Or,PER,MISC-MISC,PROPN,PROPN-NOUN,nsubj,dobj-ROOT,NNP,NNP-NNS,2,1
0,1.0,13,designed,2,1,10,9,0,2,1,8,Kaibōkan,Imperial Japanese Navy,MISC,ORG-ORG-ORG,PROPN,PROPN-PROPN-PROPN,nsubjpass,amod-amod-pobj,NNP,NNP-NNP-NNP,6,1
1,2.0,33,identified,6,2,20,18,1,12,4,14,Royal Navy,the United States,ORG-ORG,LOC-LOC-LOC,PROPN-PROPN,DET-PROPN-PROPN,compound-nmod,det-compound-nsubj,NNP-NNP,DT-NNP-NNP,6,1
0,0.0,21,is,15,1,7,6,0,13,14,-8,Ayeta Anne Wangusa,Kampala,PER-PER-PER,LOC,PROPN-PROPN-PROPN,PROPN,compound-compound-nsubj,pobj,NNP-NNP-NNP,NNP,5,1
1,0.0,21,is,15,1,12,11,0,8,14,-3,Ayeta Anne Wangusa,9 September 1971,PER-PER-PER,TIME-TIME-TIME,PROPN-PROPN-PROPN,NUM-PROPN-NUM,compound-compound-nsubj,nummod-pobj-nummod,NNP-NNP-NNP,CD-NNP-CD,4,1
2,0.0,21,is,15,7,9,2,6,11,8,-6,Kampala,Uganda,LOC,LOC,PROPN,PROPN,pobj,appos,NNP,NNP,5,1
3,1.0,34,achieved,17,27,32,5,26,1,-10,15,Memoirs of a Mother,1998,MISC-MISC-MISC-MISC,TIME,PROPN-ADP-DET-PROPN,NUM,pobj-prep-det-pobj,appos,NNPS-IN-DT-NNP,CD,4,1
0,1.0,16,play,5,9,15,6,8,0,-4,10,Veikkausliiga,Finland,MISC,LOC,PROPN,PROPN,pobj,pobj,NNP,NNP,4,1
1,3.0,26,merged,9,3,25,22,2,0,6,16,Ilves - Kissat,Mestaruussarja,ORG-ORG-ORG,LOC,PROPN-PUNCT-PROPN,PROPN,compound-punct-poss,pobj,NNP-HYPH-NNP,NNP,6,1
2,8.0,14,recovered,3,1,9,8,0,4,2,6,Ilves,Ykkönen,ORG,ORG,NOUN,PROPN,nsubj,pobj,NNS,NNP,3,1
0,0.0,43,is,16,1,29,28,0,13,15,13,Neba'a Faour,Bekaa Valley,LOC-LOC,LOC-LOC,CCONJ-ADJ,PROPN-PROPN,compound-dep,compound-pobj,CC-JJ,NNP-NNP,5,1
1,0.0,43,is,16,1,32,31,0,10,15,16,Neba'a Faour,Lebanon,LOC-LOC,LOC,CCONJ-ADJ,PROPN,compound-dep,nsubj,CC-JJ,NNP,3,1
2,0.0,43,is,16,4,29,25,3,13,12,13,Tell Neba'a Faour,Bekaa Valley,LOC-LOC-LOC,LOC-LOC,VERB-PROPN-PROPN,PROPN-PROPN,csubj-compound-dobj,compound-pobj,VB-NNP-NNP,NNP-NNP,5,1
3,0.0,43,is,16,4,32,28,3,10,12,16,Tell Neba'a Faour,Lebanon,LOC-LOC-LOC,LOC,VERB-PROPN-PROPN,PROPN,csubj-compound-dobj,nsubj,VB-NNP-NNP,NNP,3,1
4,0.0,43,is,16,8,29,21,7,13,8,13,Mashna'et el Faour,Bekaa Valley,LOC-LOC-LOC,LOC-LOC,PROPN-PROPN-PROPN,PROPN-PROPN,compound-compound-appos,compound-pobj,NNP-NNP-NNP,NNP-NNP,7,1
5,0.0,43,is,16,8,32,24,7,10,8,16,Mashna'et el Faour,Lebanon,LOC-LOC-LOC,LOC,PROPN-PROPN-PROPN,PROPN,compound-compound-appos,nsubj,NNP-NNP-NNP,NNP,5,1
6,0.0,43,is,16,12,29,17,11,13,4,13,Neba Faour,Bekaa Valley,LOC-LOC,LOC-LOC,PROPN-PROPN,PROPN-PROPN,compound-conj,compound-pobj,NNP-NNP,NNP-NNP,7,1
7,0.0,43,is,16,12,32,20,11,10,4,16,Neba Faour,Lebanon,LOC-LOC,LOC,PROPN-PROPN,PROPN,compound-conj,nsubj,NNP-NNP,NNP,5,1
8,0.0,43,is,16,15,29,14,14,13,1,13,Nebaa Faour,Bekaa Valley,LOC-LOC,LOC-LOC,PROPN-PROPN,PROPN-PROPN,compound-conj,compound-pobj,NNP-NNP,NNP-NNP,8,1
9,0.0,43,is,16,15,32,17,14,10,1,16,Nebaa Faour,Lebanon,LOC-LOC,LOC,PROPN-PROPN,PROPN,compound-conj,nsubj,NNP-NNP,NNP,6,1
10,0.0,43,is,16,29,32,3,28,10,-13,16,Bekaa Valley,Lebanon,LOC-LOC,LOC,PROPN-PROPN,PROPN,compound-pobj,nsubj,NNP-NNP,NNP,4,1
0,0.0,20,was,14,1,5,4,0,14,13,-9,William Quintillis Dallmeyer,"October 23 , 1829",PER-PER-PER,TIME-TIME-TIME-TIME,PROPN-PROPN-PROPN,PROPN-NUM-PUNCT-NUM,compound-compound-nsubj,appos-nummod-punct-nummod,NNP-NNP-NNP,"NNP-CD-,-CD",3,1
1,0.0,20,was,14,1,10,9,0,9,13,-4,William Quintillis Dallmeyer,"March 15 , 1908",PER-PER-PER,TIME-TIME-TIME-TIME,PROPN-PROPN-PROPN,PROPN-NUM-PUNCT-NUM,compound-compound-nsubj,npadvmod-nummod-punct-nummod,NNP-NNP-NNP,"NNP-CD-,-CD",3,1
2,1.0,10,born,4,1,7,6,0,2,3,3,William Quintillis Dallmeyer,Hanover,PER-PER-PER,LOC,PROPN-PROPN-PROPN,PROPN,compound-compound-nsubjpass,pobj,NNP-NNP-NNP,NNP,5,1
3,1.0,10,born,4,7,9,2,6,0,-3,5,Hanover,Germany,LOC,LOC,PROPN,PROPN,pobj,appos,NNP,NNP,4,1
4,2.0,37,emigrated,1,24,27,3,23,9,-23,26,St. Louis,Missouri,LOC-LOC,LOC,PROPN-PROPN,PROPN,compound-pobj,appos,NNP-NNP,NNP,1,1
5,3.0,35,moved,4,7,10,3,6,24,-3,6,Gasconade County,Missouri,LOC-LOC,LOC,PROPN-PROPN,PROPN,compound-pobj,appos,NNP-NNP,NNP,1,1
0,1.0,25,concentrated,6,14,24,10,13,0,-8,18,Chandel District,Manipur,LOC-LOC,LOC,PROPN-PROPN,PROPN,compound-conj,pobj,NNP-NNP,NNP,5,1
1,2.0,14,is,1,10,13,3,9,0,-9,12,Chin State,Myanmar,LOC-LOC,LOC,PROPN-PROPN,PROPN,compound-pobj,pobj,NNP-NNP,NNP,4,1
2,4.0,36,scattered,5,11,18,7,10,17,-6,13,Gangte,India,LOC,LOC,PROPN,PROPN,conj,pobj,NNP,NNP,3,1
3,4.0,36,scattered,5,13,18,5,12,17,-8,13,Paite,India,LOC,LOC,PROPN,PROPN,conj,pobj,NNP,NNP,4,1
4,4.0,36,scattered,5,15,18,3,14,17,-10,13,Thadou,India,LOC,LOC,PROPN,PROPN,conj,pobj,NNP,NNP,4,1
0,0.0,19,is,4,1,17,16,0,1,3,13,Rice People,Rithy Panh,MISC-MISC,PER-PER,NOUN-NOUN,PROPN-PROPN,compound-nsubj,compound-pobj,NN-NNS,NNP-NNP,3,1
1,2.0,33,filmed,2,9,6,-3,8,26,-7,4,Kamreang,Cambodian,LOC,LOC,PROPN,ADJ,pobj,amod,NNP,JJ,3,1
2,2.0,33,filmed,2,13,20,7,12,12,-11,18,Kien Svay,Kandal Province,LOC-LOC,LOC-LOC,PROPN-PROPN,PROPN-PROPN,compound-pobj,compound-pobj,NNP-NNP,NNP-NNP,3,1
3,2.0,33,filmed,2,13,6,-7,12,26,-11,4,Kien Svay,Cambodian,LOC-LOC,LOC,PROPN-PROPN,ADJ,compound-pobj,amod,NNP-NNP,JJ,4,1
4,2.0,33,filmed,2,20,6,-14,19,26,-18,4,Kandal Province,Cambodian,LOC-LOC,LOC,PROPN-PROPN,ADJ,compound-pobj,amod,NNP-NNP,JJ,7,1
5,2.0,33,filmed,2,23,31,8,22,1,-21,29,Phnom Penh,Mekong River,LOC-LOC,LOC-LOC,PROPN-PROPN,PROPN-PROPN,compound-pobj,compound-pobj,NNP-NNP,NNP-NNP,11,1
6,2.0,33,filmed,2,23,6,-17,22,26,-21,4,Phnom Penh,Cambodian,LOC-LOC,LOC,PROPN-PROPN,ADJ,compound-pobj,amod,NNP-NNP,JJ,9,1
7,4.0,41,film,1,20,37,17,19,3,-19,36,Academy Awards,Best Foreign Language Film,MISC-MISC,MISC-MISC-MISC-MISC,PROPN-PROPN,ADJ-PROPN-PROPN-PROPN,compound-pobj,amod-compound-compound-pobj,NNP-NNPS,JJS-NNP-NNP-NNP,11,1
0,0.0,35,is,4,2,30,28,1,4,2,26,Carlstadt Public Schools,New Jersey,ORG-ORG-ORG,LOC-LOC,PROPN-PROPN-PROPN,PROPN-PROPN,compound-compound-nsubj,compound-appos,NNP-NNP-NNPS,NNP-NNP,11,1
1,0.0,35,is,4,2,33,31,1,1,2,29,Carlstadt Public Schools,United States,ORG-ORG-ORG,LOC-LOC,PROPN-PROPN-PROPN,PROPN-PROPN,compound-compound-nsubj,compound-appos,NNP-NNP-NNPS,NNP-NNP,9,1
2,0.0,35,is,4,2,27,25,1,7,2,23,Carlstadt,Bergen County,LOC,LOC-LOC,PROPN,PROPN-PROPN,pobj,compound-pobj,NNP,NNP-NNP,10,1
3,0.0,35,is,4,2,33,31,1,1,2,29,Carlstadt,United States,LOC,LOC-LOC,PROPN,PROPN-PROPN,pobj,compound-appos,NNP,NNP-NNP,9,1
4,0.0,35,is,4,27,30,3,26,4,-23,26,Bergen County,New Jersey,LOC-LOC,LOC-LOC,PROPN-PROPN,PROPN-PROPN,compound-pobj,compound-appos,NNP-NNP,NNP-NNP,1,1
5,0.0,35,is,4,27,33,6,26,1,-23,29,Bergen County,United States,LOC-LOC,LOC-LOC,PROPN-PROPN,PROPN-PROPN,compound-pobj,compound-appos,NNP-NNP,NNP-NNP,3,1
6,0.0,35,is,4,30,33,3,29,1,-26,29,New Jersey,United States,LOC-LOC,LOC-LOC,PROPN-PROPN,PROPN-PROPN,compound-appos,compound-appos,NNP-NNP,NNP-NNP,4,1
0,0.0,23,Auto,2,1,16,15,0,6,1,14,Grand Theft Auto : Vice City,Rockstar North,MISC-MISC-MISC-MISC-MISC-MISC,ORG-ORG,PROPN-PROPN-PROPN-PUNCT-PROPN-PROPN,PROPN-PROPN,compound-compound-ROOT-punct-compound-nsubj,compound-pobj,NNP-NNP-NNP-:-NNP-NNP,NNP-NNP,6,1
1,0.0,23,Auto,2,1,16,15,0,6,1,14,Grand Theft Auto : Vice City,Rockstar Games,MISC-MISC-MISC-MISC-MISC-MISC,ORG-ORG,PROPN-PROPN-PROPN-PUNCT-PROPN-PROPN,PROPN-PROPN,compound-compound-ROOT-punct-compound-nsubj,compound-pobj,NNP-NNP-NNP-:-NNP-NNP,NNP-NNPS,6,1
2,1.0,29,released,2,18,19,1,17,9,-16,17,Microsoft,Windows,ORG,MISC,PROPN,PROPN,compound,pobj,NNP,NNP,3,1
3,4.0,22,follows,13,5,15,10,4,6,8,2,Vice City,Tommy Vercetti,MISC-MISC,PER-PER,PROPN-PROPN,PROPN-PROPN,compound-pobj,compound-dobj,NNP-NNP,NNP-NNP,4,1
0,0.0,33,known,10,20,24,4,19,8,-10,14,Tavagnacco,Province of Udine,LOC,LOC-LOC-LOC,PROPN,PROPN-ADP-PROPN,pobj,nmod-prep-pobj,NNP,NNP-IN-NNP,5,1
1,0.0,33,known,10,24,28,4,23,4,-14,18,Province of Udine,Friuli – Venezia Giulia,LOC-LOC-LOC,LOC-LOC-LOC-LOC,PROPN-ADP-PROPN,PROPN-PUNCT-PROPN-PROPN,nmod-prep-pobj,compound-compound-compound-compound,NNP-IN-NNP,NNP-HYPH-NNP-NNP,6,1
2,4.0,30,was,8,18,29,11,17,0,-10,21,Vienna,Austria,LOC,LOC,PROPN,PROPN,npadvmod,pobj,NNP,NNP,6,1
3,5.0,37,had,2,7,9,2,6,27,-5,7,Italy,Veneto,LOC,LOC,PROPN,PROPN,pobj,appos,NNP,NNP,4,1
4,5.0,37,had,2,7,14,7,6,22,-5,12,Italy,Lombardy,LOC,LOC,PROPN,PROPN,pobj,appos,NNP,NNP,5,1
0,0.0,33,is,9,1,23,22,0,9,8,14,Luke Schenn,Anaheim Ducks,PER-PER,ORG-ORG,PROPN-PROPN,PROPN-PROPN,compound-nsubj,compound-pobj,NNP-NNP,NNP-NNPS,5,1
1,10.0,11,plays,4,4,8,4,3,2,0,4,Brayden,St. Louis Blues,PER,ORG-ORG-ORG,PROPN,PROPN-PROPN-PROPN,appos,compound-compound-pobj,NNP,NNP-NNP-NNPS,3,1
0,7.0,24,recorded,3,22,14,-8,21,9,-19,11,Laughing Stock,Polydor,MISC-MISC,ORG,PROPN-PROPN,PROPN,compound-pobj,pobj,NNP-NNP,NNP,4,1
1,7.0,24,recorded,3,18,14,-4,17,9,-15,11,Talk Talk,Polydor,ORG-ORG,ORG,PROPN-PROPN,PROPN,compound-poss,pobj,NNP-NNP,NNP,5,1
2,10.0,15,released,9,11,6,-5,10,8,-2,-3,Mark Hollis,Ba Da Bing Records,PER-PER,ORG-ORG-ORG-ORG,PROPN-PROPN,PROPN-PROPN-PROPN-PROPN,compound-dobj,compound-compound-compound-nsubj,NNP-NNP,NNP-NNP-NNP-NNPS,4,1
0,0.0,12,is,6,1,5,4,0,6,5,-1,Martti Aiha,1952,PER-PER,TIME,PROPN-PROPN,NUM,compound-nsubj,npadvmod,NNP-NNP,CD,1,1
1,0.0,12,is,6,1,11,10,0,0,5,5,Martti Aiha,Finland,PER-PER,LOC,PROPN-PROPN,PROPN,compound-nsubj,pobj,NNP-NNP,NNP,2,1
2,9.0,10,received,1,1,5,4,0,4,0,4,Aiha,Prince Eugen Medal,PER,MISC-MISC-MISC,PROPN,PROPN-PROPN-PROPN,nsubj,compound-compound-dobj,NNP,NNP-NNP-NNP,2,1
0,0.0,27,was,14,1,5,4,0,21,13,-9,Alfred M. Wood,"April 19 , 1825",PER-PER-PER,TIME-TIME-TIME-TIME,PROPN-PROPN-PROPN,PROPN-NUM-PUNCT-NUM,compound-compound-nsubj,appos-nummod-punct-nummod,NNP-NNP-NNP,"NNP-CD-,-CD",3,1
1,0.0,27,was,14,1,10,9,0,16,13,-4,Alfred M. Wood,"July 28 , 1895",PER-PER-PER,TIME-TIME-TIME-TIME,PROPN-PROPN-PROPN,PROPN-NUM-PUNCT-NUM,compound-compound-nsubj,appos-nummod-punct-nummod,NNP-NNP-NNP,"NNP-CD-,-CD",3,1
2,0.0,27,was,14,1,20,19,0,6,13,6,Alfred M. Wood,Union Army,PER-PER-PER,ORG-ORG,PROPN-PROPN-PROPN,PROPN-PROPN,compound-compound-nsubj,compound-pobj,NNP-NNP-NNP,NNP-NNP,5,1
3,0.0,27,was,14,1,24,23,0,2,13,10,Alfred M. Wood,American Civil War,PER-PER-PER,MISC-MISC-MISC,PROPN-PROPN-PROPN,PROPN-PROPN-PROPN,compound-compound-nsubj,compound-compound-pobj,NNP-NNP-NNP,NNP-NNP-NNP,6,1
4,0.0,27,was,14,20,24,4,19,2,-6,10,Union Army,American Civil War,ORG-ORG,MISC-MISC-MISC,PROPN-PROPN,PROPN-PROPN-PROPN,compound-pobj,compound-compound-pobj,NNP-NNP,NNP-NNP-NNP,5,1
5,2.0,30,enlisted,7,21,23,2,20,6,-14,16,Brooklyn,New York,LOC,LOC-LOC,PROPN,PROPN-PROPN,pobj,compound-appos,NNP,NNP-NNP,2,1
0,8.0,21,are,14,12,18,6,11,2,2,4,UK,England,LOC,LOC,PROPN,PROPN,pobj,pobj,NNP,NNP,5,1
1,8.0,21,are,14,12,20,8,11,0,2,6,UK,Wales,LOC,LOC,PROPN,PROPN,pobj,conj,NNP,NNP,2,1
0,0.0,19,is,2,1,5,4,0,13,1,3,Jurie Els,South African,PER-PER,LOC-LOC,PROPN-PROPN,ADJ-ADJ,compound-nsubj,amod-amod,NNP-NNP,JJ-JJ,3,1
1,2.0,20,was,6,16,18,2,15,1,-10,12,Johannesburg,South Africa,LOC,LOC-LOC,PROPN,PROPN-PROPN,conj,compound-appos,NNP,NNP-NNP,2,1
0,0.0,21,Story,2,1,5,4,0,15,1,3,John Douglas Story,7 August 1869,PER-PER-PER,TIME-TIME-TIME,PROPN-PROPN-PROPN,NUM-PROPN-NUM,compound-compound-ROOT,nummod-appos-nummod,NNP-NNP-NNP,CD-NNP-CD,2,1
1,0.0,21,Story,2,1,13,12,0,7,1,11,John Douglas Story,2 February 1966,PER-PER-PER,TIME-TIME-TIME,PROPN-PROPN-PROPN,NUM-PROPN-NUM,compound-compound-ROOT,nummod-appos-nummod,NNP-NNP-NNP,CD-NNP-CD,2,1
2,0.0,21,Story,2,9,11,2,8,9,-7,9,Edinburgh,Scotland,LOC,LOC,PROPN,PROPN,pobj,compound,NNP,NNP,4,1
3,1.0,34,migrated,8,11,13,2,10,20,-3,5,Brisbane,Queensland,LOC,LOC,PROPN,PROPN,pobj,conj,NNP,NNP,3,1
4,1.0,34,migrated,8,15,13,-2,14,20,-7,5,Australia,Queensland,LOC,LOC,PROPN,PROPN,appos,conj,NNP,NNP,5,1
5,2.0,28,was,1,5,21,16,4,6,-4,20,Queensland Public Service,Department of Education,ORG-ORG-ORG,ORG-ORG-ORG,PROPN-PROPN-PROPN,PROPN-ADP-PROPN,compound-compound-dobj,pobj-prep-pobj,NNP-NNP-NNP,NNP-IN-NNP,7,1
6,2.0,28,was,1,5,5,0,4,22,-4,4,Queensland Public Service,Queensland,ORG-ORG-ORG,LOC,PROPN-PROPN-PROPN,PROPN,compound-compound-dobj,nmod,NNP-NNP-NNP,NNP,0,1
7,2.0,28,was,1,21,5,-16,20,22,-20,4,Department of Education,Queensland,ORG-ORG-ORG,LOC,PROPN-ADP-PROPN,PROPN,pobj-prep-pobj,nmod,NNP-IN-NNP,NNP,7,1
0,0.0,20,is,4,1,18,17,0,1,3,14,Wanna Be a Star,September 1981,MISC-MISC-MISC-MISC,TIME-TIME,PROPN-VERB-DET-PROPN,PROPN-NUM,nsubj-csubj-det-attr,pobj-nummod,NNP-VB-DT-NNP,NNP-CD,6,1
1,4.0,35,single,4,8,26,18,7,8,-4,22,I Believe,Chilliwack,MISC-MISC,ORG,PRON-VERB,PROPN,nsubj-ccomp,dobj,PRP-VBP,NNP,4,1
2,6.0,28,is,7,5,12,7,4,15,2,5,Sign Here,Chilliwack,MISC-MISC,ORG,NOUN-ADV,PROPN,appos-advmod,poss,NN-RB,NNP,8,1
3,7.0,21,was,1,17,13,-4,16,7,-16,12,Toronto,Canada,LOC,LOC,PROPN,PROPN,npadvmod,pobj,NNP,NNP,4,1
0,5.0,27,was,4,23,26,3,22,0,-19,22,Soviet Union,1991,LOC-LOC,TIME,PROPN-PROPN,NUM,compound-pobj,pobj,NNP-NNP,CD,6,1
0,0.0,24,was,11,1,4,3,0,19,10,-7,Hans Engen,22 August 1912,PER-PER,TIME-TIME-TIME,PROPN-PROPN,NUM-PROPN-NUM,compound-nsubj,nummod-nmod-nummod,NNP-NNP,CD-NNP-CD,1,1
1,0.0,24,was,11,1,8,7,0,15,10,-3,Hans Engen,6 April 1966,PER-PER,TIME-TIME-TIME,PROPN-PROPN,NUM-PROPN-NUM,compound-nsubj,nummod-npadvmod-nummod,NNP-NNP,CD-NNP-CD,2,1
2,0.0,24,was,11,1,22,21,0,1,10,11,Hans Engen,Labour Party,PER-PER,ORG-ORG,PROPN-PROPN,PROPN-PROPN,compound-nsubj,compound-pobj,NNP-NNP,NNP-NNP,4,1
0,9.0,41,assumed,13,7,30,23,6,10,6,17,Alexandre Pétion,Republic of Haiti,PER-PER,LOC-LOC-LOC,PROPN-PROPN,PROPN-ADP-PROPN,compound-conj,dobj-prep-pobj,NNP-NNP,NNP-IN-NNP,11,1
1,9.0,41,assumed,13,10,30,20,9,10,3,17,Henri Christophe,Republic of Haiti,PER-PER,LOC-LOC-LOC,PROPN-PROPN,PROPN-ADP-PROPN,compound-conj,dobj-prep-pobj,NNP-NNP,NNP-IN-NNP,12,1
2,9.0,41,assumed,13,8,30,22,7,10,5,17,Pétion,Republic of Haiti,PER,LOC-LOC-LOC,PROPN,PROPN-ADP-PROPN,pobj,dobj-prep-pobj,NNP,NNP-IN-NNP,12,1
3,10.0,29,established,16,13,19,6,12,9,3,3,Faustin Soulouque,Empire in Haiti,PER-PER,ORG-ORG-ORG,PROPN-PROPN,PROPN-ADP-PROPN,compound-nsubj,dobj-prep-pobj,NNP-NNP,NNP-IN-NNP,4,1
0,1.0,70,finished,10,52,31,-21,51,38,-42,21,Angela Knösel,East Germans,PER-PER,LOC-LOC,PROPN-PROPN,PROPN-PROPN,compound-conj,compound-nsubjpass,NNP-NNP,NNP-NNPS,7,1
1,1.0,70,finished,10,52,3,-49,51,66,-42,-7,Angela Knösel,1968 Winter Olympics,PER-PER,MISC-MISC-MISC,PROPN-PROPN,NUM-PROPN-PROPN,compound-conj,nummod-compound-pobj,NNP-NNP,CD-NNPS-NNPS,6,1
2,1.0,70,finished,10,52,31,-21,51,38,-42,21,Angela Knösel,East German,PER-PER,LOC-LOC,PROPN-PROPN,ADJ-ADJ,compound-conj,amod-amod,NNP-NNP,JJ-JJ,7,1
3,1.0,70,finished,10,3,7,4,2,62,7,-3,1968 Winter Olympics,Grenoble,MISC-MISC-MISC,LOC,NUM-PROPN-PROPN,PROPN,nummod-compound-pobj,pobj,CD-NNPS-NNPS,NNP,4,1
4,2.0,28,won,2,1,14,13,0,13,1,12,Schmuck,FIL World Luge Championships,PER,MISC-MISC-MISC-MISC,PROPN,PROPN-PROPN-PROPN-NOUN,nsubj,compound-compound-compound-pobj,NNP,NNP-NNP-NNP-NNS,4,1
0,0.0,15,is,2,1,13,12,0,1,1,11,Duets II,Frank Sinatra,MISC-MISC,PER-PER,NOUN-PROPN,PROPN-PROPN,compound-nsubj,compound-pobj,NNS-NNP,NNP-NNP,4,1
1,6.0,23,won,4,9,9,0,8,13,-5,5,Grammy Award for Best Traditional Pop Vocal Performance,Grammy Award,MISC-MISC-MISC-MISC-MISC-MISC-MISC-MISC,MISC-MISC,PROPN-PROPN-ADP-PROPN-PROPN-PROPN-PROPN-PROPN,PROPN-PROPN,compound-dobj-prep-compound-compound-compound-compound-pobj,compound-appos,NNP-NNP-IN-NNP-NNP-NNP-NNP-NNP,NNP-NNP,0,1
0,0.0,52,referred,5,2,47,45,1,4,3,42,Catskill Mountains,U.S.,LOC-LOC,LOC,PROPN-PROPN,PROPN,compound-pobj,compound,NNP-NNPS,NNP,7,1
1,0.0,52,referred,5,41,47,6,40,4,-36,42,Greene,U.S.,LOC,LOC,PROPN,PROPN,nmod,compound,NNP,NNP,7,1
2,0.0,52,referred,5,43,47,4,42,4,-38,42,Ulster,U.S.,LOC,LOC,PROPN,PROPN,conj,compound,NNP,NNP,6,1
0,0.0,48,moved,5,2,2,0,1,45,3,-3,Manchester City Football Club,Manchester,ORG-ORG-ORG-ORG,LOC,PROPN-PROPN-PROPN-PROPN,PROPN,compound-compound-compound-nsubj,pobj,NNP-NNP-NNP-NNP,NNP,0,1
1,0.0,48,moved,5,2,15,13,1,32,3,10,Manchester,England,LOC,LOC,PROPN,PROPN,pobj,appos,NNP,NNP,3,1
0,3.0,28,fled,12,25,9,-16,24,18,-13,-3,University of Cambridge,1209,ORG-ORG-ORG,TIME,PROPN-ADP-PROPN,NUM,attr-prep-pobj,pobj,NNP-IN-NNP,CD,5,1
1,3.0,28,fled,12,25,18,-7,24,9,-13,6,University of Cambridge,Cambridge,ORG-ORG-ORG,LOC,PROPN-ADP-PROPN,PROPN,attr-prep-pobj,pobj,NNP-IN-NNP,NNP,4,1
0,0.0,25,is,5,1,12,11,0,12,4,7,Saturday Nights & Sunday Mornings,Counting Crows,MISC-MISC-MISC-MISC-MISC,ORG-ORG,PROPN-PROPN-CCONJ-PROPN-PROPN,PROPN-PROPN,compound-nsubj-cc-compound-conj,compound-pobj,NNP-NNP-CC-NNP-NNPS,NNP-NNP,3,1
1,0.0,25,is,5,1,18,17,0,6,4,13,Saturday Nights & Sunday Mornings,United States,MISC-MISC-MISC-MISC-MISC,LOC-LOC,PROPN-PROPN-CCONJ-PROPN-PROPN,PROPN-PROPN,compound-nsubj-cc-compound-conj,compound-pobj,NNP-NNP-CC-NNP-NNPS,NNP-NNP,6,1
2,0.0,25,is,5,12,18,6,11,6,-7,13,Counting Crows,United States,ORG-ORG,LOC-LOC,PROPN-PROPN,PROPN-PROPN,compound-pobj,compound-pobj,NNP-NNP,NNP-NNP,3,1
0,0.0,78,was,19,33,36,3,32,41,-14,17,Natchitoches Parish,Louisiana,LOC-LOC,LOC,PROPN-PROPN,PROPN,compound-pobj,appos,NNP-NNP,NNP,1,1
1,3.0,37,interred,24,3,6,3,2,30,21,-18,Samuel Friedman,1848,PER-PER,TIME,PROPN-PROPN,NUM,compound-pobj,npadvmod,NNP-NNP,CD,3,1
0,0.0,32,is,22,29,31,2,28,0,-7,9,Bratislava,Slovakia,LOC,LOC,PROPN,PROPN,pobj,appos,NNP,NNP,6,1
0,0.0,10,is,1,1,7,6,0,2,0,6,Helgelandsmoen,Buskerud,LOC,LOC,PROPN,PROPN,nsubj,pobj,NNP,NNP,5,1
1,0.0,10,is,1,1,9,8,0,0,0,8,Helgelandsmoen,Norway,LOC,LOC,PROPN,PROPN,nsubj,appos,NNP,NNP,1,1
2,0.0,10,is,1,7,9,2,6,0,-6,8,Buskerud,Norway,LOC,LOC,PROPN,PROPN,pobj,appos,NNP,NNP,6,1
3,1.0,13,situated,2,10,12,2,9,0,-8,10,Norderhov,Ringerike,LOC,LOC,PROPN,PROPN,pobj,pobj,NNP,NNP,6,1
0,0.0,15,is,5,2,11,9,1,3,3,6,Comox Valley Regional District,British Columbia,LOC-LOC-LOC-LOC,LOC-LOC,PROPN-PROPN-PROPN-PROPN,PROPN-PROPN,compound-compound-compound-nsubj,compound-pobj,NNP-NNP-NNP-NNP,NNP-NNP,5,1
1,0.0,15,is,5,2,14,12,1,0,3,9,Comox Valley Regional District,Canada,LOC-LOC-LOC-LOC,LOC,PROPN-PROPN-PROPN-PROPN,PROPN,compound-compound-compound-nsubj,appos,NNP-NNP-NNP-NNP,NNP,3,1
2,0.0,15,is,5,11,14,3,10,0,-6,9,British Columbia,Canada,LOC-LOC,LOC,PROPN-PROPN,PROPN,compound-pobj,appos,NNP-NNP,NNP,4,1
0,0.0,28,was,10,1,5,4,0,22,9,-5,Padma Bahadur Khatri,19 July 1915,PER-PER-PER,TIME-TIME-TIME,PROPN-PROPN-PROPN,NUM-PROPN-NUM,compound-compound-nsubj,nummod-appos-npadvmod,NNP-NNP-NNP,CD-NNP-CD,2,1
1,0.0,28,was,10,1,9,8,0,18,9,-1,Padma Bahadur Khatri,1985,PER-PER-PER,TIME,PROPN-PROPN-PROPN,NUM,compound-compound-nsubj,prep,NNP-NNP-NNP,CD,2,1
0,0.0,22,is,3,3,18,15,2,3,0,15,Berlin,Germany,LOC,LOC,PROPN,PROPN,pobj,conj,NNP,NNP,2,1
1,1.0,16,released,4,7,12,5,6,3,-3,8,Live in Berlin,1981,MISC-MISC-MISC,TIME,ADJ-ADP-PROPN,NUM,pobj-prep-pobj,nummod,JJ-IN-NNP,CD,5,1
2,1.0,16,released,4,7,16,9,6,-1,-3,12,Live in Berlin,Blurt,MISC-MISC-MISC,ORG,ADJ-ADP-PROPN,PROPN,pobj-prep-pobj,pobj,JJ-IN-NNP,NNP,-1,1
3,2.0,19,Live,2,12,18,6,11,0,-10,16,Pink Floyd,Roger Waters,ORG-ORG,PER-PER,PROPN-PROPN,PROPN-PROPN,compound-poss,compound-pobj,NNP-NNP,NNP-NNP,5,1
4,2.0,19,Live,2,1,18,17,0,0,1,16,The Wall,Roger Waters,MISC-MISC,PER-PER,DET-PROPN,PROPN-PROPN,det-pobj,compound-pobj,DT-NNP,NNP-NNP,4,1
5,3.0,10,Berlin,2,1,10,9,0,-1,1,8,Live aus Berlin,Rammstein,MISC-MISC-MISC,MISC,VERB-VERB-PROPN,PROPN,amod-compound-ROOT,pobj,VB-VB-NNP,NNP,-1,1
6,5.0,13,Live,2,1,11,10,0,1,1,9,Acoustic Trio Live in Berlin,Willy DeVille,MISC-MISC-MISC-MISC-MISC,PER-PER,PROPN-PROPN-VERB-ADP-PROPN,PROPN-PROPN,amod-compound-ROOT-prep-pobj,compound-pobj,NNP-NNP-VBP-IN-NNP,NNP-NNP,4,1
7,8.0,21,Live,3,1,19,18,0,1,2,16,La Ultima / Live in Berlin,Böhse Onkelz,MISC-MISC-MISC-MISC-MISC-MISC,ORG-ORG,PROPN-PROPN-SYM-VERB-ADP-PROPN,PROPN-PROPN,compound-nmod-punct-ROOT-prep-pobj,compound-pobj,NNP-NNP-SYM-VB-IN-NNP,NNP-NNP,4,1
8,10.0,21,Live,2,1,1,0,0,19,1,-1,Depeche Mode Live in Berlin,Depeche Mode,MISC-MISC-MISC-MISC-MISC,ORG-ORG,PROPN-PROPN-VERB-ADP-PROPN,PROPN-PROPN,compound-nsubj-ROOT-prep-pobj,compound-pobj,NNP-NNP-VBP-IN-NNP,NNP-NNP,0,1
0,0.0,12,is,4,1,11,10,0,0,3,7,Pro Patria,Estonia,ORG-ORG,LOC,PROPN-PROPN,PROPN,compound-nsubj,pobj,NNP-NNP,NNP,2,1
0,2.0,46,found,12,18,22,4,17,23,-6,10,Russia,Republic of Kalmykia,LOC,LOC-LOC-LOC,PROPN,PROPN-ADP-PROPN,pobj,pobj-prep-pobj,NNP,NNP-IN-NNP,4,1
1,2.0,46,found,12,18,26,8,17,19,-6,14,Russia,Astrakhan Oblast,LOC,LOC-LOC,PROPN,PROPN-PROPN,pobj,compound-conj,NNP,NNP-NNP,6,1
0,0.0,19,were,2,1,11,10,0,7,1,9,The Warmers,"Washington , D.C.",ORG-ORG,LOC-LOC-LOC,DET-PROPN,PROPN-PUNCT-PROPN,det-nsubj,pobj-punct-appos,DT-NNPS,"NNP-,-NNP",6,1
1,0.0,19,were,2,1,16,15,0,2,1,14,The Warmers,1994,ORG-ORG,TIME,DET-PROPN,NUM,det-nsubj,pobj,DT-NNPS,CD,5,1
2,1.0,42,trio,1,31,41,10,30,0,-30,40,The Warmers,Dischord,ORG-ORG,ORG,DET-PROPN,PROPN,det-nsubj,appos,DT-NNPS,NNP,-1,1
3,1.0,42,trio,1,5,7,2,4,34,-4,6,Faith,Alec MacKaye,ORG,PER-PER,PROPN,PROPN-PROPN,compound,compound-dobj,NNP,NNP-NNP,1,1
4,1.0,42,trio,1,7,41,34,6,0,-6,40,Alec MacKaye,Dischord,PER-PER,ORG,PROPN-PROPN,PROPN,compound-dobj,appos,NNP-NNP,NNP,-1,1
5,1.0,42,trio,1,25,41,16,24,0,-24,40,Amy Farina,Dischord,PER-PER,ORG,PROPN-PROPN,PROPN,compound-conj,appos,NNP-NNP,NNP,-1,1
6,8.0,18,go,2,7,1,-6,6,16,-5,-1,The Evens,Farina,ORG-ORG,PER,DET-PROPN,PROPN,det-dobj,nsubj,DT-NNPS,NNP,3,1
7,8.0,18,go,2,16,10,-6,15,7,-14,8,Ian MacKaye,Alec,PER-PER,PER,PROPN-PROPN,PROPN,compound-appos,poss,NNP-NNP,NNP,4,1
0,0.0,79,is,8,1,5,4,0,73,7,-3,Susan McCann,2 February 1949,PER-PER,TIME-TIME-TIME,PROPN-PROPN,NUM-PROPN-NUM,compound-nsubj,nummod-npadvmod-nummod,NNP-NNP,CD-NNP-CD,2,1
1,0.0,79,is,8,75,73,-2,74,5,-67,65,George H. W. Bush,US,PER-PER-PER-PER,LOC,PROPN-PROPN-PROPN-PROPN,PROPN,compound-compound-compound-pobj,compound,NNP-NNP-NNP-NNP,NNP,2,1
0,0.0,26,was,11,1,5,4,0,20,10,-6,Girolamo Parabosco,1524,PER-PER,TIME,PROPN-PROPN,NUM,compound-nsubj,nummod,NNP-NNP,CD,1,1
1,0.0,26,was,11,1,14,13,0,11,10,3,Girolamo Parabosco,Italian,PER-PER,LOC,PROPN-PROPN,ADJ,compound-nsubj,amod,NNP-NNP,JJ,2,1
2,6.0,45,wrote,1,25,27,2,24,17,-24,26,Boccaccio,Decameron,PER,MISC,PROPN,PROPN,poss,pobj,NNP,NNP,7,1
0,0.0,31,"""",0,2,14,12,1,16,-2,14,Savoy Truffle,Beatles,MISC-MISC,ORG,PROPN-PROPN,PROPN,compound-nsubj,appos,NNP-NNP,NNPS,4,1
1,4.0,24,recorded,2,5,2,-3,4,21,-3,0,Savoy Truffle,Beatles,MISC-MISC,ORG,PROPN-PROPN,PROPN,compound-dobj,nsubj,NNP-NNP,NNPS,1,1
2,3.0,50,is,29,26,23,-3,25,26,3,-6,Badge,Cream,MISC,ORG,PROPN,PROPN,pobj,poss,NNP,NNP,5,1
3,4.0,24,recorded,2,17,2,-15,16,21,-15,0,five - month,Beatles,TIME-TIME-TIME,ORG,NUM-PUNCT-NOUN,PROPN,nummod-punct-compound,nsubj,CD-HYPH-NN,NNPS,6,1
0,0.0,24,is,13,1,6,5,0,17,12,-7,Barry Alexander Brown,2 November 1960,PER-PER-PER,TIME-TIME-TIME,PROPN-PROPN-PROPN,NUM-PROPN-NUM,compound-compound-nsubj,nummod-npadvmod-nummod,NNP-NNP-NNP,CD-NNP-CD,3,1
1,0.0,24,is,13,1,10,9,0,13,12,-3,Barry Alexander Brown,Warrington,PER-PER-PER,LOC,PROPN-PROPN-PROPN,PROPN,compound-compound-nsubj,pobj,NNP-NNP-NNP,NNP,6,1
2,1.0,65,known,8,41,45,4,40,19,-33,37,He Got Game,1998,MISC-MISC-MISC,TIME,PRON-VERB-PROPN,NUM,nsubj-conj-dobj,npadvmod,PRP-VBD-NNP,CD,2,1
3,1.0,65,known,8,48,51,3,47,13,-40,43,25th Hour,2002,MISC-MISC,TIME,ADJ-PROPN,NUM,compound-npadvmod,appos,JJ-NNP,CD,1,1
4,1.0,65,known,8,54,57,3,53,7,-46,49,Inside Man,2006,MISC-MISC,TIME,PROPN-PROPN,NUM,conj-pobj,appos,NNP-NNP,CD,1,1
5,1.0,65,known,8,61,63,2,60,1,-53,55,BlacKkKlansman,2018,MISC,TIME,PROPN,NUM,conj,appos,NNP,CD,2,1
6,1.0,65,known,8,27,32,5,26,32,-19,24,Do the Right Thing,1989,MISC-MISC-MISC-MISC,TIME,VERB-DET-PROPN-NOUN,NUM,pcomp-det-compound-dobj,appos,VB-DT-NNP-NN,CD,2,1
7,2.0,44,directed,8,13,18,5,12,25,-5,10,The War at Home,1979,MISC-MISC-MISC-MISC,TIME,DET-PROPN-ADP-PROPN,NUM,det-appos-prep-pobj,appos,DT-NNP-IN-NNP,CD,3,1
8,3.0,48,include,7,15,18,3,14,29,-8,11,Amazing Journey,1993,MISC-MISC,TIME,ADJ-NOUN,NUM,compound-conj,appos,JJ-NN,CD,1,1
9,3.0,48,include,7,35,46,11,34,1,-28,39,Winning Girls Through Psychic Mind Control,Bronson Pinchot,MISC-MISC-MISC-MISC-MISC-MISC,PER-PER,VERB-NOUN-ADP-PROPN-PROPN-PROPN,PROPN-PROPN,compound-appos-prep-compound-compound-pobj,compound-dobj,VBG-NNS-IN-NNP-NNP-NNP,NNP-NNP,3,1
0,0.0,21,is,2,1,5,4,0,15,1,3,Dwight Tillery,American,PER-PER,LOC,PROPN-PROPN,ADJ,compound-nsubj,amod,NNP-NNP,JJ,2,1
1,0.0,21,is,2,5,20,15,4,0,-3,18,American,Ohio,LOC,LOC,ADJ,PROPN,amod,appos,JJ,NNP,2,1
2,1.0,38,grew,1,1,13,12,0,24,0,12,Tillery,University of Cincinnati,PER,ORG-ORG-ORG,PROPN,PROPN-ADP-PROPN,nsubj,dobj-prep-pobj,NNP,NNP-IN-NNP,3,1
0,0.0,15,is,1,1,7,6,0,7,0,6,Candler,Buncombe County,LOC,LOC-LOC,PROPN,PROPN-PROPN,nsubj,compound-pobj,NNP,NNP-NNP,3,1
0,0.0,22,is,2,1,9,8,0,12,1,7,Street Survivors,Southern rock,MISC-MISC,MISC-MISC,PROPN-PROPN,ADJ-NOUN,compound-nsubj,amod-compound,NNP-NNPS,JJ-NN,5,1
0,4.0,33,performed,5,17,8,-9,16,24,-12,3,Back to Broadway,Barbra Streisand,MISC-MISC-MISC,PER-PER,ADV-ADP-PROPN,PROPN-PROPN,advmod-prep-pobj,compound-pobj,RB-IN-NNP,NNP-NNP,5,1
1,4.0,33,performed,5,17,8,-9,16,24,-12,3,Back to Brooklyn,Barbra Streisand,MISC-MISC-MISC,PER-PER,ADV-ADP-PROPN,PROPN-PROPN,conj-prep-pobj,compound-pobj,RB-IN-NNP,NNP-NNP,5,1
0,0.0,30,weekdays,28,1,15,14,0,14,27,-13,The Big Story,2000,MISC-MISC-MISC,TIME,DET-PROPN-PROPN,NUM,det-compound-nsubj,pobj,DT-NNP-NNP,CD,5,1
1,0.0,30,weekdays,28,1,18,17,0,11,27,-10,The Big Story,Fox News Channel,MISC-MISC-MISC,MISC-MISC-MISC,DET-PROPN-PROPN,PROPN-PROPN-PROPN,det-compound-nsubj,compound-compound-pobj,DT-NNP-NNP,NNP-NNP-NNP,7,1
0,1.0,24,known,4,11,15,4,10,8,-7,11,Brenda Meeks,Scary Movie,PER-PER,MISC-MISC,PROPN-PROPN,PROPN-PROPN,compound-pobj,compound-compound,NNP-NNPS,NNP-NNP,3,1
1,1.0,24,known,4,11,20,9,10,3,-7,16,Brenda Meeks,2000,PER-PER,TIME,PROPN-PROPN,NUM,compound-pobj,nummod,NNP-NNPS,CD,3,1
2,1.0,24,known,4,15,20,5,14,3,-11,16,Scary Movie,2000,MISC-MISC,TIME,PROPN-PROPN,NUM,compound-compound,nummod,NNP-NNP,CD,2,1
3,4.0,74,Think,37,6,10,4,5,63,31,-27,The Best Man,1999,MISC-MISC-MISC,TIME,DET-ADJ-PROPN,NUM,det-amod-dobj,appos,DT-JJS-NNP,CD,2,1
4,4.0,74,Think,37,6,20,14,5,53,31,-17,The Best Man Holiday,2013,MISC-MISC-MISC-MISC,TIME,DET-ADJ-PROPN-PROPN,NUM,det-amod-compound-appos,appos,DT-JJS-NNP-NNP,CD,4,1
5,4.0,74,Think,37,23,27,4,22,46,14,-10,Love & Basketball,2000,MISC-MISC-MISC,TIME,PROPN-CCONJ-PROPN,NUM,appos-cc-conj,appos,NNP-CC-NNP,CD,2,1
6,4.0,74,Think,37,30,35,5,29,38,7,-2,Malibu 's Most Wanted,2003,MISC-MISC-MISC-MISC,TIME,PROPN-PART-ADV-ADJ,NUM,poss-case-compound-appos,appos,NNP-POS-RBS-JJ,CD,3,1
7,4.0,74,Think,37,38,43,5,37,30,-1,6,Think Like a Man,2012,MISC-MISC-MISC-MISC,TIME,VERB-ADP-DET-NOUN,NUM,ROOT-prep-det-pobj,appos,VB-IN-DT-NN,CD,2,1
8,4.0,74,Think,37,64,66,2,63,7,-27,29,Vacation,2015,MISC,TIME,PROPN,NUM,appos,appos,NNP,CD,2,1
9,4.0,74,Think,37,69,72,3,68,1,-32,35,Girls Trip,2017,MISC-MISC,TIME,NOUN-PROPN,NUM,compound-conj,appos,NNS-NNP,CD,1,1
0,0.0,30,is,4,1,18,17,0,11,3,14,Głubczyce County,Opole Voivodeship,LOC-LOC,LOC-LOC,PROPN-PROPN,PROPN-PROPN,compound-nsubj,compound-pobj,NNP-NNP,NNP-NNP,4,1
1,0.0,30,is,4,1,24,23,0,5,3,20,Głubczyce County,Poland,LOC-LOC,LOC,PROPN-PROPN,PROPN,compound-nsubj,appos,NNP-NNP,NNP,3,1
2,0.0,30,is,4,18,24,6,17,5,-14,20,Opole Voivodeship,Poland,LOC-LOC,LOC,PROPN-PROPN,PROPN,compound-pobj,appos,NNP-NNP,NNP,3,1
0,1.0,45,is,1,7,22,15,6,22,-6,21,Los Angeles,Mississippi River,LOC-LOC,LOC-LOC,PROPN-PROPN,PROPN-PROPN,compound-pobj,compound-pobj,NNP-NNP,NNP-NNP,6,1
1,1.0,45,is,1,22,27,5,21,17,-21,26,Mississippi River,New York City,LOC-LOC,LOC-LOC-LOC,PROPN-PROPN,PROPN-PROPN-PROPN,compound-pobj,compound-compound-pobj,NNP-NNP,NNP-NNP-NNP,6,1
0,1.0,32,began,1,11,14,3,10,17,-10,13,Nya tider,1999,MISC-MISC,TIME,PROPN-NOUN,NUM,compound-ROOT,nummod,NNP-NN,CD,2,1
1,1.0,32,began,1,27,30,3,26,1,-26,29,Drowning Ghost,2004,MISC-MISC,TIME,PROPN-PROPN,NUM,compound-appos,appos,NNP-NNP,CD,1,1
2,2.0,42,came,1,18,21,3,17,20,-17,20,White Queen,2013,MISC-MISC,TIME,PROPN-PROPN,NUM,compound-ROOT,appos,NNP-NNP,CD,1,1
3,2.0,42,came,1,18,14,-4,17,27,-17,13,White Queen,British,MISC-MISC,LOC,PROPN-PROPN,ADJ,compound-ROOT,amod,NNP-NNP,JJ,6,1
4,3.0,38,starred,3,8,16,8,7,21,-5,13,Ilsa Faust,2015,PER-PER,TIME,PROPN-PROPN,NUM,compound-pobj,appos,NNP-NNP,CD,1,1
5,3.0,38,starred,3,33,36,3,32,1,-30,33,Greatest Showman,2017,MISC-MISC,TIME,PROPN-PROPN,NUM,compound-pobj,appos,NNP-NNP,CD,1,1
6,4.0,27,played,3,12,25,13,11,1,-9,22,Florence Foster Jenkins,2016,MISC-MISC-MISC,TIME,PROPN-PROPN-PROPN,NUM,compound-compound-pobj,appos,NNP-NNP-NNP,CD,6,1
7,4.0,27,played,3,18,25,7,17,1,-15,22,The Girl on the Train,2016,MISC-MISC-MISC-MISC-MISC,TIME,DET-PROPN-ADP-DET-NOUN,NUM,det-appos-prep-det-pobj,appos,DT-NNP-IN-DT-NN,CD,5,1
0,4.0,21,ported,2,1,5,4,0,15,1,3,Centipede,Atari 2600,MISC,MISC-MISC,PROPN,PROPN-NUM,nsubjpass,pobj-nummod,NNP,NNP-CD,5,1
1,4.0,21,ported,2,1,5,4,0,15,1,3,Centipede,Atari 5200,MISC,MISC-MISC,PROPN,PROPN-NUM,nsubjpass,appos-nummod,NNP,NNP-CD,5,1
2,4.0,21,ported,2,1,5,4,0,15,1,3,Centipede,Atari 7800,MISC,MISC-MISC,PROPN,PROPN-NUM,nsubjpass,appos-nummod,NNP,NNP-CD,5,1
3,4.0,21,ported,2,1,5,4,0,15,1,3,Centipede,Atari 8-bit,MISC,MISC-MISC,PROPN,PROPN-NUM,nsubjpass,nmod-nummod,NNP,NNP-CD,5,1
0,0.0,29,is,2,1,12,11,0,16,1,10,Bretton Woods,New Hampshire,LOC-LOC,LOC-LOC,PROPN-PROPN,PROPN-PROPN,compound-nsubj,compound-conj,NNP-NNP,NNP-NNP,7,1
1,0.0,29,is,2,1,15,14,0,13,1,13,Bretton Woods,United States,LOC-LOC,LOC-LOC,PROPN-PROPN,PROPN-PROPN,compound-nsubj,compound-conj,NNP-NNP,NNP-NNP,8,1
2,0.0,29,is,2,10,15,5,9,13,-8,13,Carroll,United States,LOC,LOC-LOC,PROPN,PROPN-PROPN,pobj,compound-conj,NNP,NNP-NNP,3,1
3,0.0,29,is,2,12,15,3,11,13,-10,13,New Hampshire,United States,LOC-LOC,LOC-LOC,PROPN-PROPN,PROPN-PROPN,compound-conj,compound-conj,NNP-NNP,NNP-NNP,1,1
4,1.0,40,includes,22,17,21,4,16,18,5,-1,Mount Washington,Presidential Range,LOC-LOC,LOC-LOC,PROPN-PROPN,PROPN-PROPN,compound-pobj,compound-conj,NNP-NNP,NNP-NNP,1,1
5,2.0,43,was,2,34,42,8,33,0,-32,40,World Bank,1945,ORG-ORG,TIME,PROPN-PROPN,NUM,compound-pobj,pobj,NNP-NNP,CD,8,1
6,5.0,44,granted,5,11,18,7,10,25,-6,13,Bretton Hall,West Bretton,LOC-LOC,LOC-LOC,PROPN-PROPN,PROPN-PROPN,compound-pobj,compound-pobj,NNP-NNP,NNP-NNP,5,1
0,0.0,46,"""",0,2,11,9,1,34,-2,11,La Bicicleta,Colombian,MISC-MISC,LOC,PROPN-PROPN,ADJ,compound-ROOT,amod,NNP-NNP,JJ,4,1
1,13.0,24,was,16,6,14,8,5,9,10,-2,La Bicicleta,Colombian,MISC-MISC,LOC,PROPN-PROPN,ADJ,compound-pobj,amod,NNP-NNP,JJ,6,1
2,0.0,46,"""",0,2,13,11,1,32,-2,13,La Bicicleta,Carlos Vives,MISC-MISC,PER-PER,PROPN-PROPN,PROPN-PROPN,compound-ROOT,compound-appos,NNP-NNP,NNP-NNPS,5,1
3,0.0,46,"""",0,2,14,12,1,31,-2,14,La Bicicleta,Vives,MISC-MISC,PER,PROPN-PROPN,PROPN,compound-ROOT,poss,NNP-NNP,NNPS,6,1
4,0.0,46,"""",0,2,41,39,1,4,-2,41,La Bicicleta,El Dorado,MISC-MISC,MISC-MISC,PROPN-PROPN,PROPN-PROPN,compound-ROOT,compound-appos,NNP-NNP,NNP-NNP,7,1
5,10.0,38,clip,1,30,22,-8,29,15,-29,21,Barranquilla,Colombia,LOC,LOC,PROPN,PROPN,conj,pobj,NNP,NNP,3,1
6,10.0,38,clip,1,27,22,-5,26,15,-26,21,Santa Marta,Colombia,LOC-LOC,LOC,PROPN-PROPN,PROPN,compound-appos,pobj,NNP-NNP,NNP,4,1
0,4.0,22,interviewed,15,18,21,3,17,0,-3,6,Fox News,Paris,ORG-ORG,LOC,PROPN-PROPN,PROPN,compound-pobj,pobj,NNP-NNP,NNP,3,1
0,0.0,41,born,5,1,12,11,0,28,4,7,Aleksandr Solomonovich Khakhanov,"January 3 , 1864",PER-PER-PER,TIME-TIME-TIME-TIME,PROPN-PROPN-PROPN,PROPN-NUM-PUNCT-NUM,compound-compound-nsubj,nmod-nummod-punct-nummod,NNP-NNP-NNP,"NNP-CD-,-CD",3,1
1,0.0,41,born,5,1,17,16,0,23,4,12,Aleksandr Solomonovich Khakhanov,"May 25 , 1912",PER-PER-PER,TIME-TIME-TIME-TIME,PROPN-PROPN-PROPN,VERB-NUM-PUNCT-NUM,compound-compound-nsubj,nsubj-nummod-punct-nummod,NNP-NNP-NNP,"MD-CD-,-CD",4,1
0,5.0,64,Stop,0,27,15,-12,26,48,-27,15,Ritt Bjerregaard,Danish,PER-PER,LOC,PROPN-PROPN,ADJ,compound-conj,amod,NNP-NNP,JJ,4,1
1,5.0,64,Stop,0,30,15,-15,29,48,-30,15,Connie Hedegaard,Danish,PER-PER,LOC,PROPN-PROPN,ADJ,compound-conj,amod,NNP-NNP,JJ,5,1
2,5.0,64,Stop,0,33,15,-18,32,48,-33,15,Bertel Haarder,Danish,PER-PER,LOC,PROPN-PROPN,ADJ,compound-conj,amod,NNP-NNP,JJ,6,1
3,5.0,64,Stop,0,36,15,-21,35,48,-36,15,Frank Jensen,Danish,PER-PER,LOC,PROPN-PROPN,ADJ,compound-conj,amod,NNP-NNP,JJ,7,1
4,5.0,64,Stop,0,39,15,-24,38,48,-39,15,Dan Jørgensen,Danish,PER-PER,LOC,PROPN-PROPN,ADJ,compound-conj,amod,NNP-NNP,JJ,8,1
5,5.0,64,Stop,0,42,15,-27,41,48,-42,15,Karen Ellemann,Danish,PER-PER,LOC,PROPN-PROPN,ADJ,compound-conj,amod,NNP-NNP,JJ,9,1
6,5.0,64,Stop,0,45,15,-30,44,48,-45,15,Henrik Høegh,Danish,PER-PER,LOC,PROPN-PROPN,ADJ,compound-conj,amod,NNP-NNP,JJ,10,1
7,5.0,64,Stop,0,48,15,-33,47,48,-48,15,Kirsten Brosbøl,Danish,PER-PER,LOC,PROPN-PROPN,ADJ,compound-conj,amod,NNP-NNP,JJ,11,1
0,0.0,41,is,12,1,10,9,0,30,11,-2,Tomasz Lis,Zielona Góra,PER-PER,LOC-LOC,PROPN-PROPN,PROPN-PROPN,compound-nsubj,compound-pobj,NNP-NNP,NNP-NNP,3,1
1,0.0,41,is,12,1,15,14,0,25,11,3,Tomasz Lis,Polish,PER-PER,LOC,PROPN-PROPN,ADJ,compound-nsubj,amod,NNP-NNP,JJ,2,1
0,0.0,18,is,4,1,12,11,0,5,3,8,Al Majma'ah,Ar Riyad Province,LOC-LOC,LOC-LOC-LOC,PROPN-PROPN,PROPN-PROPN-PROPN,compound-nsubj,compound-compound-pobj,NNP-NNP,NNP-NNP-NNP,6,1
1,0.0,18,is,4,1,16,15,0,1,3,12,Al Majma'ah,Saudi Arabia,LOC-LOC,LOC-LOC,PROPN-PROPN,PROPN-PROPN,compound-nsubj,compound-appos,NNP-NNP,NNP-NNP,6,1
2,0.0,18,is,4,12,16,4,11,1,-8,12,Ar Riyad Province,Saudi Arabia,LOC-LOC-LOC,LOC-LOC,PROPN-PROPN-PROPN,PROPN-PROPN,compound-compound-pobj,compound-appos,NNP-NNP-NNP,NNP-NNP,2,1
0,0.0,20,is,1,1,11,10,0,8,0,10,Militia,Maurizio Boccacci,ORG,PER-PER,PROPN,PROPN-PROPN,nsubj,compound-pobj,NNP,NNP-NNP,4,1
1,4.0,20,arrested,6,19,18,-1,18,1,-13,12,Carabinieri,Italian,ORG,LOC,PROPN,ADJ,pobj,amod,NNP,JJ,5,1
2,5.0,43,made,3,12,12,0,11,30,-9,9,Rome,Rome,LOC,LOC,PROPN,PROPN,poss,pobj,NNP,NNP,0,1
3,5.0,43,made,3,17,12,-5,16,30,-14,9,Gianni Alemanno,Rome,PER-PER,LOC,PROPN-PROPN,PROPN,compound-appos,pobj,NNP-NNP,NNP,5,1
4,5.0,43,made,3,24,30,6,23,12,-21,27,Gianfranco Fini,Chamber of Deputies,PER-PER,ORG-ORG-ORG,PROPN-PROPN,PROPN-ADP-PROPN,compound-appos,pobj-prep-pobj,NNP-NNP,NNP-IN-NNPS,6,1
0,0.0,29,is,10,1,21,20,0,7,9,11,Jason E. Chaffetz,U.S.,PER-PER-PER,LOC,PROPN-PROPN-PROPN,PROPN,compound-compound-compound,compound,NNP-NNP-NNP,NNP,7,1
0,0.0,41,was,13,1,10,9,0,30,12,-3,Rebecca Mann Pennell,1821,PER-PER-PER,TIME,PROPN-PROPN-PROPN,NUM,compound-compound-nsubj,npadvmod,NNP-NNP-NNP,CD,5,1
1,0.0,41,was,13,1,10,9,0,30,12,-3,Rebecca Mann Dean,1821,PER-PER-PER,TIME,PROPN-PROPN-PROPN,NUM,compound-compound-appos,npadvmod,NNP-NNP-NNP,CD,5,1
2,1.0,34,was,1,10,16,6,9,17,-9,15,Antioch College,Ohio,ORG-ORG,LOC,PROPN-PROPN,PROPN,compound-pobj,appos,NNP-NNP,NNP,5,1
0,0.0,23,was,12,1,5,4,0,17,11,-7,Johan Peter Falk,26 November 1732,PER-PER-PER,TIME-TIME-TIME,PROPN-PROPN-PROPN,NUM-PROPN-NUM,compound-compound-nsubj,nummod-appos-nummod,NNP-NNP-NNP,CD-NNP-CD,2,1
1,0.0,23,was,12,1,9,8,0,13,11,-3,Johan Peter Falk,31 March 1774,PER-PER-PER,TIME-TIME-TIME,PROPN-PROPN-PROPN,NUM-PROPN-NUM,compound-compound-nsubj,nummod-appos-nummod,NNP-NNP-NNP,CD-NNP-CD,2,1
2,0.0,23,was,12,1,15,14,0,7,11,3,Johan Peter Falk,Swedish,PER-PER-PER,LOC,PROPN-PROPN-PROPN,ADJ,compound-compound-nsubj,amod,NNP-NNP-NNP,JJ,3,1
3,2.0,8,born,2,1,5,4,0,2,1,3,Falk,Broddetorp,PER,LOC,PROPN,PROPN,nsubjpass,pobj,NNP,NNP,4,1
4,4.0,24,travelled,1,1,4,3,0,19,0,3,Falk,St Petersburg,PER,LOC-LOC,PROPN,PROPN-PROPN,nsubj,compound-pobj,NNP,NNP-NNP,2,1
5,4.0,24,travelled,1,4,11,7,3,12,-3,10,St Petersburg,Russian,LOC-LOC,LOC,PROPN-PROPN,ADJ,compound-pobj,amod,NNP-NNP,JJ,5,1
6,5.0,8,took,1,1,7,6,0,0,0,6,Falk,Kazan,PER,LOC,PROPN,PROPN,nsubj,pobj,NNP,NNP,1,1
0,0.0,31,is,12,1,22,21,0,8,11,10,James Manuel Costa,Democrat,PER-PER-PER,ORG,PROPN-PROPN-PROPN,PROPN,compound-compound-nsubj,pobj,NNP-NNP-NNP,NNP,6,1
0,0.0,36,was,20,1,6,5,0,29,19,-14,Kina Konova,Sevlievo,PER-PER,LOC,PROPN-PROPN,PROPN,compound-nsubj,appos,NNP-NNP,NNP,2,1
1,0.0,36,was,20,1,8,7,0,27,19,-12,Kina Konova,September 1872-,PER-PER,TIME-TIME,PROPN-PROPN,PROPN-PROPN,compound-nsubj,compound-compound,NNP-NNP,NNP-NNP,3,1
2,0.0,36,was,20,1,10,9,0,25,19,-10,Kina Konova,Sofia,PER-PER,LOC,PROPN-PROPN,PROPN,compound-nsubj,conj,NNP-NNP,NNP,2,1
3,0.0,36,was,20,1,12,11,0,23,19,-8,Kina Konova,2 May 1952,PER-PER,TIME-TIME-TIME,PROPN-PROPN,NUM-VERB-NUM,compound-nsubj,nummod-appos-nummod,NNP-NNP,CD-MD-CD,2,1
4,0.0,36,was,20,1,23,22,0,12,19,3,Kina Konova,Bulgarian,PER-PER,LOC,PROPN-PROPN,ADJ,compound-nsubj,amod,NNP-NNP,JJ,3,1
5,0.0,36,was,20,6,23,17,5,12,14,3,Sevlievo,Bulgarian,LOC,LOC,PROPN,ADJ,appos,amod,NNP,JJ,5,1
0,0.0,39,is,2,1,10,9,0,28,1,8,Sheng Long,Street Fighter,MISC-MISC,MISC-MISC,PROPN-PROPN,PROPN-PROPN,compound-nsubj,compound-compound,NNP-NNP,NNP-NNP,6,1
1,1.0,37,described,26,16,23,7,15,13,10,-3,Sheng Long,Street Fighter II,PER-PER,MISC-MISC-MISC,PROPN-PROPN,PROPN-PROPN-PROPN,compound-oprd,compound-compound-appos,NNP-NNP,NNP-NNP-NNP,4,1
2,5.0,33,influenced,2,8,15,7,7,17,-6,13,Akuma,Street Fighter,PER,MISC-MISC,PROPN,PROPN-PROPN,pobj,compound-compound,NNP,NNP-NNP,8,1
0,0.0,28,is,8,11,18,7,10,9,-3,10,American,California,LOC,LOC,ADJ,PROPN,amod,appos,JJ,NNP,1,1
1,0.0,28,is,8,15,18,3,14,9,-7,10,Foothill Ranch,California,LOC-LOC,LOC,PROPN-PROPN,PROPN,compound-pobj,appos,NNP-NNP,NNP,4,1
0,2.0,13,published,3,6,11,5,5,1,-3,8,"Ah , Sweet Dancer",1970,MISC-MISC-MISC-MISC,TIME,INTJ-PUNCT-PROPN-PROPN,NUM,pobj-punct-compound-npadvmod,npadvmod,"UH-,-NNP-NNP",CD,6,1
1,6.0,35,was,1,23,33,10,22,1,-22,32,Raymond Lovell,Simone Lovell,PER-PER,PER-PER,PROPN-PROPN,PROPN-PROPN,compound-pobj,compound-appos,NNP-NNP,NNP-NNP,3,1
0,0.0,27,is,1,1,4,3,0,22,0,3,Deadlight,2012,MISC,TIME,NOUN,NUM,nsubj,nummod,NN,CD,2,1
1,0.0,27,is,1,1,14,13,0,12,0,13,Deadlight,Tequila Works,MISC,ORG-ORG,NOUN,PROPN-PROPN,nsubj,compound-pobj,NN,NNP-NNP,4,1
2,0.0,27,is,1,1,19,18,0,7,0,18,Deadlight,Microsoft Studios,MISC,ORG-ORG,NOUN,PROPN-PROPN,nsubj,compound-pobj,NN,NNP-NNP,5,1
3,0.0,27,is,1,1,19,18,0,7,0,18,Deadlight,Microsoft Windows,MISC,MISC-MISC,NOUN,PROPN-PROPN,nsubj,compound-conj,NN,NNP-NNP,5,1
0,0.0,25,was,2,1,10,9,0,14,1,8,Parramatta Stadium,New South Wales,LOC-LOC,LOC-LOC-LOC,PROPN-PROPN,PROPN-PROPN-PROPN,compound-nsubj,compound-compound-conj,NNP-NNP,NNP-NNP-NNP,6,1
1,2.0,49,was,2,21,46,25,20,2,-19,44,Parramatta Stadium,New South Wales,LOC-LOC,LOC-LOC-LOC,PROPN-PROPN,PROPN-PROPN-PROPN,compound-nsubjpass,compound-compound-pobj,NNP-NNP,NNP-NNP-NNP,10,1
2,0.0,25,was,2,1,14,13,0,10,1,12,Parramatta Stadium,Australia,LOC-LOC,LOC,PROPN-PROPN,PROPN,compound-nsubj,conj,NNP-NNP,NNP,3,1
3,0.0,25,was,2,1,10,9,0,14,1,8,Parramatta,New South Wales,LOC,LOC-LOC-LOC,PROPN,PROPN-PROPN-PROPN,pobj,compound-compound-conj,NNP,NNP-NNP-NNP,6,1
4,0.0,25,was,2,1,14,13,0,10,1,12,Parramatta,Australia,LOC,LOC,PROPN,PROPN,pobj,conj,NNP,NNP,3,1
5,0.0,25,was,2,1,20,19,0,4,1,18,Parramatta,Sydney,LOC,LOC,PROPN,PROPN,pobj,poss,NNP,NNP,7,1
6,0.0,25,was,2,10,14,4,9,10,-8,12,New South Wales,Australia,LOC-LOC-LOC,LOC,PROPN-PROPN-PROPN,PROPN,compound-compound-conj,conj,NNP-NNP-NNP,NNP,5,1
7,1.0,43,was,2,26,30,4,25,12,-24,28,Parramatta Eels,National Rugby League,ORG-ORG,ORG-ORG-ORG,PROPN-PROPN,PROPN-PROPN-PROPN,compound-attr,compound-compound-pobj,NNP-NNPS,NNP-NNP-NNP,3,1
8,4.0,35,performed,2,7,11,4,6,23,-5,9,Bad World Tour,20–21 November 1987,MISC-MISC-MISC,TIME-TIME-TIME,ADJ-PROPN-PROPN,NUM-PROPN-NUM,compound-compound-pobj,nummod-pobj-nummod,JJ-NNP-NNP,CD-NNP-CD,5,1
0,0.0,20,is,1,1,18,17,0,1,0,17,Winfield,United States,LOC,LOC-LOC,PROPN,PROPN-PROPN,nsubj,compound-conj,NNP,NNP-NNP,7,1
1,0.0,20,is,1,8,13,5,7,6,-7,12,Milton,DuPage County,LOC,LOC-LOC,PROPN,PROPN-PROPN,pobj,compound-appos,NNP,NNP-NNP,2,1
2,0.0,20,is,1,8,16,8,7,3,-7,15,Milton,Illinois,LOC,LOC,PROPN,PROPN,pobj,conj,NNP,NNP,4,1
3,0.0,20,is,1,8,18,10,7,1,-7,17,Milton,United States,LOC,LOC-LOC,PROPN,PROPN-PROPN,pobj,compound-conj,NNP,NNP-NNP,4,1
4,0.0,20,is,1,1,13,12,0,6,0,12,Winfield Townships,DuPage County,LOC-LOC,LOC-LOC,PROPN-PROPN,PROPN-PROPN,compound-conj,compound-appos,NNP-NNP,NNP-NNP,5,1
5,0.0,20,is,1,1,16,15,0,3,0,15,Winfield Townships,Illinois,LOC-LOC,LOC,PROPN-PROPN,PROPN,compound-conj,conj,NNP-NNP,NNP,7,1
6,0.0,20,is,1,1,18,17,0,1,0,17,Winfield Townships,United States,LOC-LOC,LOC-LOC,PROPN-PROPN,PROPN-PROPN,compound-conj,compound-conj,NNP-NNP,NNP-NNP,7,1
7,0.0,20,is,1,13,16,3,12,3,-12,15,DuPage County,Illinois,LOC-LOC,LOC,PROPN-PROPN,PROPN,compound-appos,conj,NNP-NNP,NNP,2,1
8,0.0,20,is,1,13,18,5,12,1,-12,17,DuPage County,United States,LOC-LOC,LOC-LOC,PROPN-PROPN,PROPN-PROPN,compound-appos,compound-conj,NNP-NNP,NNP-NNP,2,1
9,0.0,20,is,1,16,18,2,15,1,-15,17,Illinois,United States,LOC,LOC-LOC,PROPN,PROPN-PROPN,conj,compound-conj,NNP,NNP-NNP,2,1
0,5.0,27,reported,9,7,26,19,6,0,2,17,Sichuan,China,LOC,LOC,PROPN,PROPN,pobj,pobj,NNP,NNP,6,1
1,5.0,27,reported,9,9,26,17,8,0,0,17,Xinjiang,China,LOC,LOC,PROPN,PROPN,conj,pobj,NNP,NNP,2,1
0,0.0,38,is,8,1,5,4,0,32,7,-3,Rhoda Grant,26 June 1963,PER-PER,TIME-TIME-TIME,PROPN-PROPN,NUM-PROPN-NUM,compound-nsubj,nummod-npadvmod-nummod,NNP-NNP,CD-NNP-CD,2,1
1,2.0,33,fought,5,26,30,4,25,2,-21,25,Eleanor Scott,Scottish Green Party,PER-PER,ORG-ORG-ORG,PROPN-PROPN,PROPN-PROPN-PROPN,compound-pobj,compound-compound-pobj,NNP-NNP,NNP-NNP-NNP,3,1
0,0.0,34,is,2,12,15,3,11,18,-10,13,U.S.,Michigan,LOC,LOC,PROPN,PROPN,compound,pobj,NNP,NNP,7,1
1,0.0,34,is,2,15,19,4,14,14,-13,17,Michigan,Lake Michigan,LOC,LOC-LOC,PROPN,PROPN-PROPN,pobj,compound-pobj,NNP,NNP-NNP,3,1
2,6.0,41,formed,6,36,39,3,35,1,-30,33,Ganges Township,Allegan County,LOC-LOC,LOC-LOC,PROPN-PROPN,PROPN-PROPN,compound-pobj,compound-pobj,NNP-NNP,NNP-NNP,2,1
0,0.0,24,is,2,1,15,14,0,8,1,13,Greatest Hits,Aerosmith,MISC-MISC,ORG,PROPN-PROPN,PROPN,compound-nsubj,pobj,NNP-NNP,NNP,3,1
1,0.0,24,is,2,1,19,18,0,4,1,17,Greatest Hits,Columbia Records,MISC-MISC,ORG-ORG,PROPN-PROPN,PROPN-PROPN,compound-nsubj,compound-pobj,NNP-NNP,NNP-NNPS,5,1
2,0.0,24,is,2,1,22,21,0,1,1,20,Greatest Hits,October 1980,MISC-MISC,TIME-TIME,PROPN-PROPN,PROPN-NUM,compound-nsubj,pobj-nummod,NNP-NNP,NNP-CD,6,1
3,0.0,24,is,2,15,19,4,14,4,-13,17,Aerosmith,Columbia Records,ORG,ORG-ORG,PROPN,PROPN-PROPN,pobj,compound-pobj,NNP,NNP-NNPS,4,1
0,0.0,16,is,3,2,12,10,1,3,1,9,Tikchik River,U.S.,LOC-LOC,LOC,PROPN-PROPN,PROPN,compound-nsubj,compound,NNP-NNP,NNP,3,1
1,0.0,16,is,3,2,15,13,1,0,1,12,Tikchik River,Alaska,LOC-LOC,LOC,PROPN-PROPN,PROPN,compound-nsubj,pobj,NNP-NNP,NNP,2,1
2,0.0,16,is,3,12,15,3,11,0,-9,12,U.S.,Alaska,LOC,LOC,PROPN,PROPN,compound,pobj,NNP,NNP,3,1
3,2.0,27,empties,2,1,6,5,0,20,1,4,Tikchik Lake,Nuyakuk River,LOC-LOC,LOC-LOC,PROPN-PROPN,PROPN-PROPN,compound-compound,compound-pobj,NNP-NNP,NNP-NNP,3,1
4,2.0,27,empties,2,6,13,7,5,13,-4,11,Nuyakuk River,Nushagak River,LOC-LOC,LOC-LOC,PROPN-PROPN,PROPN-PROPN,compound-pobj,compound-pobj,NNP-NNP,NNP-NNP,5,1
5,2.0,27,empties,2,6,13,7,5,13,-4,11,Nuyakuk River,Nushagak Bay,LOC-LOC,LOC-LOC,PROPN-PROPN,PROPN-PROPN,compound-pobj,compound-pobj,NNP-NNP,NNP-NNP,5,1
6,2.0,27,empties,2,6,25,19,5,1,-4,23,Nuyakuk River,Bristol Bay,LOC-LOC,LOC-LOC,PROPN-PROPN,PROPN-PROPN,compound-pobj,compound-pobj,NNP-NNP,NNP-NNP,9,1
7,2.0,27,empties,2,13,13,0,12,13,-11,11,Nushagak River,Nushagak Bay,LOC-LOC,LOC-LOC,PROPN-PROPN,PROPN-PROPN,compound-pobj,compound-pobj,NNP-NNP,NNP-NNP,0,1
8,2.0,27,empties,2,13,25,12,12,1,-11,23,Nushagak River,Bristol Bay,LOC-LOC,LOC-LOC,PROPN-PROPN,PROPN-PROPN,compound-pobj,compound-pobj,NNP-NNP,NNP-NNP,8,1
9,2.0,27,empties,2,13,25,12,12,1,-11,23,Nushagak Bay,Bristol Bay,LOC-LOC,LOC-LOC,PROPN-PROPN,PROPN-PROPN,compound-pobj,compound-pobj,NNP-NNP,NNP-NNP,8,1
0,0.0,19,is,3,1,18,17,0,0,2,15,Envigado,Antioquia,LOC,LOC,PROPN,PROPN,nsubj,pobj,NNP,NNP,3,1
1,0.0,19,is,3,9,11,2,8,7,-6,8,Medellin,Colombia,LOC,LOC,PROPN,PROPN,pobj,ROOT,NNP,NNP,5,1
2,0.0,19,is,3,9,18,9,8,0,-6,15,Medellin,Antioquia,LOC,LOC,PROPN,PROPN,pobj,pobj,NNP,NNP,6,1
3,0.0,19,is,3,11,18,7,10,0,-8,15,Colombia,Antioquia,LOC,LOC,PROPN,PROPN,ROOT,pobj,NNP,NNP,5,1
4,3.0,41,is,23,35,39,4,34,1,-12,16,Pablo Escobar,Medellin cartel,PER-PER,ORG-ORG,PROPN-PROPN,PROPN-NOUN,compound-pobj,compound-conj,NNP-NNP,NNP-NN,1,1
5,6.0,32,is,1,1,21,20,0,10,0,20,Envigado Futbol Club,Colombia,ORG-ORG-ORG,LOC,PROPN-PROPN-PROPN,PROPN,compound-compound-appos,pobj,NNP-NNP-NNP,NNP,3,1
0,1.0,15,born,2,5,11,6,4,3,-3,9,Khujand,Sughd Province,LOC,LOC-LOC,PROPN,PROPN-PROPN,pobj,compound-pobj,NNP,NNP-NNP,4,1
1,1.0,15,born,2,5,14,9,4,0,-3,12,Khujand,Tajikistan,LOC,LOC,PROPN,PROPN,pobj,pobj,NNP,NNP,2,1
2,1.0,15,born,2,11,14,3,10,0,-9,12,Sughd Province,Tajikistan,LOC-LOC,LOC,PROPN-PROPN,PROPN,compound-pobj,pobj,NNP-NNP,NNP,4,1
3,5.0,20,trace,13,9,3,-6,8,16,4,-10,Sadegh Hedayat,Persian,PER-PER,LOC,PROPN-PROPN,ADJ,compound-conj,amod,NNP-NNP,JJ,1,1
0,0.0,41,refers,15,32,37,5,31,3,-17,22,Mao Zedong,1976,PER-PER,TIME,PROPN-PROPN,NUM,compound-poss,pobj,NNP-NNP,CD,4,1
0,0.0,37,is,12,1,9,8,0,27,11,-3,Ranil Wickremesinghe,24 March 1949,PER-PER,TIME-TIME-TIME,PROPN-PROPN,NUM-PROPN-NUM,compound-nsubj,nummod-npadvmod-nummod,NNP-NNP,CD-NNP-CD,2,1
0,0.0,24,was,7,1,4,3,0,19,6,-3,Vladimir Mayakovsky,1893,PER-PER,TIME,PROPN-PROPN,NUM,compound-nsubj,nummod,NNP-NNP,CD,1,1
1,0.0,24,was,7,1,6,5,0,17,6,-1,Vladimir Mayakovsky,1930,PER-PER,TIME,PROPN-PROPN,NUM,compound-nsubj,nummod,NNP-NNP,CD,1,1
2,2.0,14,Mayakovsky,0,8,10,2,7,3,-8,10,Baghdati,Georgia,LOC,LOC,PROPN,PROPN,pobj,conj,NNP,NNP,3,1
3,4.0,14,Mayakovskoye,0,11,14,3,10,-1,-11,14,Kaliningrad,Russia,LOC,LOC,PROPN,PROPN,compound,appos,NNP,NNP,-1,1
0,0.0,22,was,12,2,7,5,1,14,10,-5,Edgar Gaston Furtado Abraham,1880,PER-PER-PER-PER,TIME,PROPN-PROPN-PROPN-PROPN,NUM,compound-compound-compound-nsubj,nummod,NNP-NNP-NNP-NNP,CD,2,1
1,3.0,36,returned,12,6,10,4,5,25,6,-2,First World War,1914,MISC-MISC-MISC,TIME,PROPN-PROPN-PROPN,NUM,compound-compound-pobj,pobj,NNP-NNP-NNP,CD,6,1
0,0.0,13,is,3,1,11,10,0,1,2,8,Sofie & Cecilia,Katherine Ashenburg,MISC-MISC-MISC,PER-PER,PROPN-CCONJ-PROPN,PROPN-PROPN,nsubj-cc-conj,compound-pobj,NNP-CC-NNP,NNP-NNP,5,1
1,4.0,32,based,10,30,23,-7,29,8,-20,13,Anders Zorn,Emma Lamm,PER-PER,PER-PER,PROPN-PROPN,PROPN-PROPN,compound-pobj,compound-conj,NNP-NNP,NNP-NNP,4,1
0,0.0,39,is,6,2,13,11,1,25,4,7,South Point Local School District,the U.S. state,LOC-LOC-LOC-LOC-LOC,LOC-LOC-LOC,PROPN-PROPN-PROPN-PROPN-PROPN,DET-PROPN-NOUN,compound-compound-compound-compound-nsubj,det-compound-pobj,NNP-NNP-NNP-NNP-NNP,DT-NNP-NN,5,1
1,0.0,39,is,6,2,26,24,1,12,4,20,South Point,Lawrence County,LOC-LOC,LOC-LOC,PROPN-PROPN,PROPN-PROPN,compound-pobj,compound-pobj,NNP-NNP,NNP-NNP,12,1
2,0.0,39,is,6,26,13,-13,25,25,-20,7,Lawrence County,the U.S. state,LOC-LOC,LOC-LOC-LOC,PROPN-PROPN,DET-PROPN-NOUN,compound-pobj,det-compound-pobj,NNP-NNP,DT-NNP-NN,7,1
0,0.0,23,"""",0,2,20,18,1,2,-2,20,Swiss Lady,Pepe Lienhard Band,MISC-MISC,ORG-ORG-ORG,PROPN-PROPN,PROPN-PROPN-PROPN,compound-nsubj,compound-compound-pobj,NNP-NNP,NNP-NNP-NNP,5,1
1,0.0,23,"""",0,11,20,9,10,2,-11,20,Eurovision Song Contest,Pepe Lienhard Band,MISC-MISC-MISC,ORG-ORG-ORG,PROPN-PROPN-PROPN,PROPN-PROPN-PROPN,compound-compound-pobj,compound-compound-pobj,NNP-NNP-NNP,NNP-NNP-NNP,8,1
0,0.0,23,is,1,16,22,6,15,0,-15,21,Shibuya,Japan,LOC,LOC,PROPN,PROPN,compound,appos,NNPS,NNP,5,1
0,0.0,41,was,9,7,17,10,6,23,2,8,American Civil War,Union,MISC-MISC-MISC,ORG,PROPN-PROPN-PROPN,PROPN,compound-compound-pobj,compound,NNP-NNP-NNP,NNP,7,1
1,1.0,32,caused,20,4,23,19,3,8,16,3,Union,Lincoln,ORG,PER,PROPN,PROPN,compound,nsubj,NNP,NNP,5,1
0,2.0,16,spent,1,7,15,8,6,0,-6,14,Mediterranean,Adriatic,LOC,LOC,PROPN,PROPN,pobj,pobj,NNP,NNP,2,1
0,2.0,23,moved,10,5,21,16,4,1,5,11,East Coast of Canada,British Columbia,LOC-LOC-LOC-LOC,LOC-LOC,PROPN-PROPN-ADP-PROPN,PROPN-PROPN,compound-pobj-prep-pobj,compound-pobj,NNP-NNP-IN-NNP,NNP-NNP,9,1
1,2.0,23,moved,10,14,21,7,13,1,-4,11,Vancouver Island,British Columbia,LOC-LOC,LOC-LOC,PROPN-PROPN,PROPN-PROPN,compound-pobj,compound-pobj,NNP-NNP,NNP-NNP,3,1
2,6.0,25,exhibited,5,2,24,22,1,0,3,19,North America,Canada,LOC-LOC,LOC,PROPN-PROPN,PROPN,compound-pobj,pobj,NNP-NNP,NNP,3,1
3,7.0,10,lives,2,5,7,2,4,2,-3,5,Calgary,Alberta,LOC,LOC,PROPN,PROPN,pobj,npadvmod,NNP,NNP,3,1
4,7.0,10,lives,2,5,9,4,4,0,-3,7,Calgary,Canada,LOC,LOC,PROPN,PROPN,pobj,appos,NNP,NNP,4,1
5,7.0,10,lives,2,7,9,2,6,0,-5,7,Alberta,Canada,LOC,LOC,PROPN,PROPN,npadvmod,appos,NNP,NNP,5,1
0,0.0,25,"""",0,2,15,13,1,9,-2,15,My Ever Changing Moods,Style Council,MISC-MISC-MISC-MISC,ORG-ORG,DET-ADV-VERB-NOUN,PROPN-PROPN,poss-advmod-compound-nsubj,compound-ROOT,PRP$-RB-VBG-NNS,NNP-NNP,7,1
1,4.0,17,29,0,4,16,12,3,0,-4,16,Billboard Hot 100,US,MISC-MISC-MISC,LOC,PROPN-PROPN-NUM,PROPN,compound-pobj-nummod,pobj,NNP-NNP-CD,NNP,1,1
2,5.0,23,remains,2,1,4,3,0,18,1,2,The Jam,Weller,ORG-ORG,PER,DET-PROPN,PROPN,det-pobj,poss,DT-NNP,NNP,4,1
0,0.0,22,was,9,18,21,3,17,0,-9,12,Amhara Region,Ethiopia,LOC-LOC,LOC,PROPN-PROPN,PROPN,compound-pobj,pobj,NNP-NNP,NNP,6,1
0,0.0,21,"""",0,2,13,11,1,7,-2,13,Sitting at the Wheel,The Moody Blues,MISC-MISC-MISC-MISC,ORG-ORG-ORG,VERB-ADP-DET-PROPN,DET-PROPN-PROPN,csubj-prep-det-pobj,det-compound-pobj,VBG-IN-DT-NNP,DT-NNP-NNPS,5,1
1,2.0,29,released,11,6,26,20,5,2,5,15,Sitting at the Wheel,Blue World,MISC-MISC-MISC-MISC,MISC-MISC,VERB-ADP-DET-PROPN,PROPN-PROPN,nsubjpass-prep-det-pobj,compound-pobj,VBG-IN-DT-NNP,NNP-NNP,4,1
2,2.0,29,released,11,21,26,5,20,2,-10,15,The Present,Blue World,MISC-MISC,MISC-MISC,DET-PROPN,PROPN-PROPN,det-pobj,compound-pobj,DT-NNP,NNP-NNP,6,1
0,0.0,21,is,3,1,9,8,0,11,2,6,Jukkasjärvi,Kiruna Municipality,LOC,LOC-LOC,PROPN,PROPN-PROPN,nsubj,compound-pobj,NNP,NNP-NNP,5,1
1,0.0,21,is,3,1,15,14,0,5,2,12,Jukkasjärvi,Sweden,LOC,LOC,PROPN,PROPN,nsubj,appos,NNP,NNP,4,1
2,0.0,21,is,3,9,12,3,8,8,-6,9,Kiruna Municipality,Norrbotten County,LOC-LOC,LOC-LOC,PROPN-PROPN,PROPN-PROPN,compound-pobj,compound-conj,NNP-NNP,NNP-NNP,1,1
3,0.0,21,is,3,9,15,6,8,5,-6,12,Kiruna Municipality,Sweden,LOC-LOC,LOC,PROPN-PROPN,PROPN,compound-pobj,appos,NNP-NNP,NNP,3,1
4,0.0,21,is,3,12,15,3,11,5,-9,12,Norrbotten County,Sweden,LOC-LOC,LOC,PROPN-PROPN,PROPN,compound-conj,appos,NNP-NNP,NNP,4,1
0,0.0,61,is,4,7,35,28,6,25,-3,31,Vietnam,Saigon,LOC,LOC,PROPN,PROPN,pobj,pobj,NNP,NNP,-1,1
1,0.0,61,is,4,7,39,32,6,21,-3,35,Vietnam,Dong Nai,LOC,LOC-LOC,PROPN,PROPN-PROPN,pobj,compound-compound,NNP,NNP-NNP,-1,1
2,0.0,61,is,4,7,58,51,6,2,-3,54,Vietnam,Đồng Nai,LOC,LOC-LOC,PROPN,PROPN-PROPN,pobj,compound-compound,NNP,NNP-NNP,-1,1
3,0.0,61,is,4,55,58,3,54,2,-51,54,Biên Hòa,Đồng Nai,LOC-LOC,LOC-LOC,PROPN-PROPN,PROPN-PROPN,compound-pobj,compound-compound,NNP-NNP,NNP-NNP,5,1
0,0.0,29,was,15,2,8,6,1,20,13,-7,Gurbachan Singh Salaria,29 November 1935,PER-PER-PER,TIME-TIME-TIME,PROPN-PROPN-PROPN,NUM-PROPN-NUM,compound-compound-nsubj,nummod-appos-nummod,NNP-NNP-NNP,CD-NNP-CD,2,1
1,0.0,29,was,15,2,12,10,1,16,13,-3,Gurbachan Singh Salaria,5 December 1961,PER-PER-PER,TIME-TIME-TIME,PROPN-PROPN-PROPN,NUM-PROPN-NUM,compound-compound-nsubj,nummod-npadvmod-nummod,NNP-NNP-NNP,CD-NNP-CD,2,1
2,0.0,29,was,15,2,18,16,1,10,13,3,Gurbachan Singh Salaria,Indian Army,PER-PER-PER,ORG-ORG,PROPN-PROPN-PROPN,ADJ-PROPN,compound-compound-nsubj,amod-compound,NNP-NNP-NNP,JJ-NNP,4,1
0,0.0,27,Bourque,2,1,5,4,0,21,1,3,John Samuel Bourque,"September 8 , 1894",PER-PER-PER,TIME-TIME-TIME-TIME,PROPN-PROPN-PROPN,PROPN-NUM-PUNCT-NUM,compound-compound-ROOT,appos-nummod-punct-nummod,NNP-NNP-NNP,"NNP-CD-,-CD",3,1
1,0.0,27,Bourque,2,1,10,9,0,16,1,8,John Samuel Bourque,"March 5 , 1974",PER-PER-PER,TIME-TIME-TIME-TIME,PROPN-PROPN-PROPN,PROPN-NUM-PUNCT-NUM,compound-compound-ROOT,nsubj-nummod-punct-nummod,NNP-NNP-NNP,"NNP-CD-,-CD",4,1
2,2.0,52,Born,0,7,45,38,6,6,-7,45,Bourque,World War I,PER,MISC-MISC-MISC,PROPN,PROPN-PROPN-PROPN,appos,compound-compound-pobj,NNP,NNP-NNP-NNP,7,1
0,6.0,23,was,16,12,14,2,11,8,4,-2,Mumbai,Maharashtra,LOC,LOC,PROPN,PROPN,pobj,appos,NNP,NNP,7,1
1,7.0,17,founded,3,1,6,5,0,10,2,3,Zee Network,Subhash Chandra,ORG-ORG,PER-PER,PROPN-PROPN,PROPN-PROPN,compound-nsubjpass,compound-pobj,NNP-NNP,NNP-NNP,3,1
2,7.0,17,founded,3,1,14,13,0,2,2,11,Zee Network,1 October 1992,ORG-ORG,TIME-TIME-TIME,PROPN-PROPN,NUM-PROPN-NUM,compound-nsubjpass,nummod-pobj-nummod,NNP-NNP,CD-NNP-CD,4,1
0,0.0,44,is,7,14,35,21,13,8,-7,28,North America,Canada,LOC-LOC,LOC,PROPN-PROPN,PROPN,compound-pobj,appos,NNP-NNP,NNP,6,1
1,0.0,44,is,7,25,41,16,24,2,-18,34,Mississippi River,Gulf of Mexico,LOC-LOC,LOC-LOC-LOC,PROPN-PROPN,PROPN-ADP-PROPN,compound-compound,pobj-prep-pobj,NNP-NNP,NNP-IN-NNP,8,1
2,0.0,44,is,7,33,35,2,32,8,-26,28,Ontario,Canada,LOC,LOC,PROPN,PROPN,pobj,appos,NNP,NNP,5,1
0,0.0,31,was,15,1,6,5,0,24,14,-9,Mary Elizabeth Anania Edwards,"July 3 , 1949",PER-PER-PER-PER,TIME-TIME-TIME-TIME,PROPN-PROPN-PROPN-PROPN,PROPN-NUM-PUNCT-NUM,compound-compound-compound-nsubj,npadvmod-nummod-punct-nummod,NNP-NNP-NNP-NNP,"NNP-CD-,-CD",3,1
1,0.0,31,was,15,1,18,17,0,12,14,3,Mary Elizabeth Anania Edwards,American,PER-PER-PER-PER,LOC,PROPN-PROPN-PROPN-PROPN,ADJ,compound-compound-compound-nsubj,amod,NNP-NNP-NNP-NNP,JJ,3,1
2,2.0,16,Senator,0,9,3,-6,8,12,-9,3,United States,North Carolina,LOC-LOC,LOC-LOC,PROPN-PROPN,PROPN-PROPN,nmod-nmod,compound-pobj,NNP-NNP,NNP-NNP,5,1
0,1.0,13,Chambers,1,1,8,7,0,4,0,7,Paul Chambers,1982,PER-PER,TIME,PROPN-PROPN,NUM,compound-ROOT,npadvmod,NNP-NNP,CD,2,1
1,2.0,16,Coleman,1,1,5,4,0,10,0,4,Norris Coleman,1961,PER-PER,TIME,PROPN-PROPN,NUM,compound-ROOT,npadvmod,NNP-NNP,CD,1,1
2,3.0,11,Ferris,1,1,4,3,0,6,0,3,Sarge Ferris,1928,PER-PER,TIME,PROPN-PROPN,NUM,compound-ROOT,npadvmod,NNP-NNP,CD,3,1
3,5.0,15,McCrimmon,1,1,4,3,0,10,0,3,Brad McCrimmon,1959,PER-PER,TIME,PROPN-PROPN,NUM,compound-ROOT,npadvmod,NNP-NNP,CD,3,1
4,6.0,10,Moody,1,1,4,3,0,5,0,3,Orville Moody,1933,PER-PER,TIME,PROPN-PROPN,NUM,compound-ROOT,npadvmod,NNP-NNP,CD,3,1
5,7.0,15,Rangel,1,1,5,4,0,9,0,4,Charles Rangel,1930,PER-PER,TIME,PROPN-PROPN,NUM,compound-ROOT,npadvmod,NNP-NNP,CD,2,1
6,7.0,15,Rangel,1,1,13,12,0,1,0,12,Charles Rangel,Korean War,PER-PER,MISC-MISC,PROPN-PROPN,ADJ-PROPN,compound-ROOT,compound-compound,NNP-NNP,JJ-NNP,3,1
7,8.0,12,Sargent,1,1,5,4,0,6,0,4,Mitchell Sargent,1979,PER-PER,TIME,PROPN-PROPN,NUM,compound-ROOT,npadvmod,NNP-NNP,CD,1,1
8,10.0,14,Schumacher,1,1,9,8,0,4,0,8,Tony Schumacher,1969,PER-PER,TIME,PROPN-PROPN,NUM,compound-ROOT,npadvmod,NNP-NNP,CD,2,1
0,0.0,21,was,7,1,4,3,0,16,6,-3,Ernie Copland,15 April 1927,PER-PER,TIME-TIME-TIME,PROPN-PROPN,NUM-PROPN-NUM,compound-nsubj,nummod-appos-nummod,NNP-NNP,CD-NNP-CD,1,1
1,0.0,21,was,7,1,15,14,0,5,6,8,Ernie Copland,Arbroath,PER-PER,ORG,PROPN-PROPN,PROPN,compound-nsubj,pobj,NNP-NNP,NNP,6,1
2,0.0,21,was,7,1,17,16,0,3,6,10,Ernie Copland,Dundee,PER-PER,ORG,PROPN-PROPN,PROPN,compound-nsubj,conj,NNP-NNP,NNP,7,1
3,0.0,21,was,7,1,19,18,0,1,6,12,Ernie Copland,Raith Rovers,PER-PER,ORG-ORG,PROPN-PROPN,PROPN-PROPN,compound-nsubj,compound-conj,NNP-NNP,NNP-NNPS,7,1
4,1.0,28,selected,2,5,7,2,4,20,-3,5,Scotland,1954 FIFA World Cup,LOC,MISC-MISC-MISC-MISC,PROPN,NUM-PROPN-PROPN-PROPN,poss,nummod-compound-compound-compound,NNP,CD-NNP-NNP-NNP,4,1
5,4.0,41,chosen,2,26,28,2,25,12,-24,26,Stuttgart,Germany,LOC,LOC,PROPN,PROPN,conj,appos,NNP,NNP,3,1
6,4.0,41,chosen,2,32,34,2,31,6,-30,32,Madrid,Spain,LOC,LOC,PROPN,PROPN,conj,appos,NNP,NNP,2,1
0,0.0,22,is,5,1,12,11,0,9,4,7,Classics selected by Brian Wilson,The Beach Boys,MISC-MISC-MISC-MISC-MISC,ORG-ORG-ORG,NOUN-VERB-ADP-PROPN-PROPN,DET-PROPN-PROPN,nsubj-acl-agent-compound-pobj,det-compound-pobj,NNS-VBN-IN-NNP-NNP,DT-NNP-NNPS,6,1
1,0.0,22,is,5,1,18,17,0,3,4,13,Classics selected by Brian Wilson,Capitol Records,MISC-MISC-MISC-MISC-MISC,ORG-ORG,NOUN-VERB-ADP-PROPN-PROPN,PROPN-PROPN,nsubj-acl-agent-compound-pobj,compound-pobj,NNS-VBN-IN-NNP-NNP,NNP-NNPS,5,1
2,0.0,22,is,5,12,18,6,11,3,-7,13,The Beach Boys,Capitol Records,ORG-ORG-ORG,ORG-ORG,DET-PROPN-PROPN,PROPN-PROPN,det-compound-pobj,compound-pobj,DT-NNP-NNPS,NNP-NNPS,7,1
0,0.0,19,was,13,1,6,5,0,12,12,-7,Pentti Tapio Akseli Linnosvuo,17 March 1933,PER-PER-PER-PER,TIME-TIME-TIME,PROPN-PROPN-PROPN-PROPN,NUM-PROPN-NUM,compound-compound-compound-nsubj,nummod-nmod-nummod,NNP-NNP-NNP-NNP,CD-NNP-CD,2,1
1,0.0,19,was,13,1,10,9,0,8,12,-3,Pentti Tapio Akseli Linnosvuo,13 July 2010,PER-PER-PER-PER,TIME-TIME-TIME,PROPN-PROPN-PROPN-PROPN,NUM-PROPN-NUM,compound-compound-compound-nsubj,nummod-appos-nummod,NNP-NNP-NNP-NNP,CD-NNP-CD,3,1
2,3.0,28,born,2,1,5,4,0,22,1,3,Linnosvuo,Vaasa,PER,LOC,PROPN,PROPN,nsubjpass,pobj,NNP,NNP,2,1
3,8.0,17,employed,7,10,14,4,9,2,-3,7,S Group,Finnish,ORG-ORG,LOC,PROPN-PROPN,ADJ,compound-pobj,amod,NNP-NNP,JJ,2,1
0,0.0,21,is,8,1,5,4,0,15,7,-3,Stephen Nicol,11 December 1961,PER-PER,TIME-TIME-TIME,PROPN-PROPN,NUM-PROPN-NUM,compound-nsubj,nummod-npadvmod-nummod,NNP-NNP,CD-NNP-CD,2,1
1,4.0,28,played,2,1,11,10,0,16,1,9,Nicol,Notts County,PER,ORG-ORG,PROPN,PROPN-PROPN,nsubj,compound-pobj,NNP,NNP-NNP,5,1
2,4.0,28,played,2,1,14,13,0,13,1,12,Nicol,Sheffield Wednesday,PER,ORG-ORG,PROPN,PROPN-PROPN,nsubj,compound-conj,NNP,NNP-NNP,4,1
3,4.0,28,played,2,1,17,16,0,10,1,15,Nicol,Doncaster Rovers,PER,ORG-ORG,PROPN,PROPN-PROPN,nsubj,compound-conj,NNP,NNP-NNPS,5,1
4,5.0,26,was,1,8,20,12,7,5,-7,19,New England Revolution,MLS,ORG-ORG-ORG,ORG,PROPN-PROPN-PROPN,PROPN,compound-compound-pobj,pobj,NNP-NNP-NNP,NNP,8,1
0,0.0,33,built,13,11,17,6,10,15,2,4,Saint Petersburg,Imperial Russia,LOC-LOC,LOC-LOC,PROPN-PROPN,PROPN-PROPN,compound-pobj,compound-poss,NNP-NNP,NNP-NNP,8,1
0,0.0,48,was,5,2,38,36,1,9,3,33,Tallinn Offensive,Eastern Front of World War II,MISC-MISC,LOC-LOC-LOC-LOC-LOC-LOC,PROPN-PROPN,PROPN-PROPN-ADP-PROPN-PROPN-PROPN,compound-nsubj,compound-pobj-prep-compound-compound-pobj,NNP-NNP,NNP-NNP-IN-NNP-NNP-NNP,4,1
1,0.0,48,was,5,2,45,43,1,2,3,40,Tallinn Offensive,17–26 September 1944,MISC-MISC,TIME-TIME-TIME,PROPN-PROPN,ADJ-PROPN-NUM,compound-nsubj,nummod-pobj-nummod,NNP-NNP,JJ-NNP-CD,3,1
0,0.0,34,"""",0,30,32,2,29,1,-30,32,Schizophonic,1999,MISC,TIME,PROPN,NUM,pobj,npadvmod,NNP,CD,2,1
1,2.0,21,"""",0,2,15,13,1,5,-2,15,Mi Chico Latino,16 August 1999,MISC-MISC-MISC,TIME-TIME-TIME,PROPN-PROPN-PROPN,NUM-PROPN-NUM,compound-compound-nsubjpass,nummod-pobj-nummod,NNP-NNP-NNP,CD-NNP-CD,4,1
2,2.0,21,"""",0,2,20,18,1,0,-2,20,Mi Chico Latino,EMI,MISC-MISC-MISC,ORG,PROPN-PROPN-PROPN,PROPN,compound-compound-nsubjpass,pobj,NNP-NNP-NNP,NNP,3,1
0,0.0,29,McDougall,1,1,4,3,0,24,0,3,Robert McDougall,16 April 1813,PER-PER,TIME-TIME-TIME,PROPN-PROPN,NUM-PROPN-NUM,compound-ROOT,nummod-appos-nummod,NNP-NNP,CD-NNP-CD,1,1
1,1.0,28,was,9,5,7,2,4,20,4,-2,Perthshire,Scotland,LOC,LOC,PROPN,PROPN,conj,conj,NNP,NNP,4,1
2,7.0,14,died,1,6,9,3,5,4,-5,8,Moonee Ponds,Victoria,LOC-LOC,LOC,PROPN-PROPN,PROPN,compound-conj,npadvmod,NNP-NNPS,NNP,2,1
0,0.0,25,Kirkland,2,1,5,4,0,19,1,3,John Thornton Kirkland,"August 17 , 1770",PER-PER-PER,TIME-TIME-TIME-TIME,PROPN-PROPN-PROPN,PROPN-NUM-PUNCT-NUM,compound-compound-ROOT,appos-nummod-punct-nummod,NNP-NNP-NNP,"NNP-CD-,-CD",3,1
1,0.0,25,Kirkland,2,1,10,9,0,14,1,8,John Thornton Kirkland,"April 26 , 1840",PER-PER-PER,TIME-TIME-TIME-TIME,PROPN-PROPN-PROPN,PROPN-NUM-PUNCT-NUM,compound-compound-ROOT,nsubj-nummod-punct-nummod,NNP-NNP-NNP,"NNP-CD-,-CD",3,1
2,9.0,13,was,1,1,8,7,0,4,0,7,Kirkland,American Antiquarian Society,PER,ORG-ORG-ORG,PROPN,PROPN-PROPN-PROPN,nsubj,compound-compound-pobj,NNP,NNP-NNP-NNP,4,1
0,11.0,44,chosen,4,17,43,26,16,0,-13,39,Greatest Hits,Björk,MISC-MISC,PER,PROPN-PROPN,PROPN,compound-appos,pobj,NNP-NNP,NNP,5,1
0,0.0,25,"""",0,2,11,9,1,13,-2,11,The Invisible Man,British,MISC-MISC-MISC,LOC,DET-ADJ-PROPN,ADJ,det-compound-nsubj,amod,DT-JJ-NNP,JJ,7,1
1,2.0,17,released,10,6,16,10,5,0,4,6,The Miracle,1989,MISC-MISC,TIME,DET-PROPN,NUM,det-appos,pobj,DT-NNP,CD,3,1
0,2.0,26,born,2,21,25,4,20,0,-19,23,Giovanni Battista Viola,Rome,PER-PER-PER,LOC,PROPN-PROPN-PROPN,PROPN,compound-compound-pobj,pobj,NNP-NNP-NNP,NNP,5,1
0,0.0,16,is,1,1,4,3,0,11,0,3,Paddington,London Underground,LOC,ORG-ORG,PROPN,PROPN-PROPN,nsubj,compound-compound,NNP,NNP-NNP,2,1
1,0.0,16,is,1,4,10,6,3,5,-3,9,London Underground,Circle and Hammersmith & City,ORG-ORG,ORG-ORG-ORG-ORG-ORG,PROPN-PROPN,PROPN-CCONJ-PROPN-CCONJ-PROPN,compound-compound,nmod-cc-conj-cc-conj,NNP-NNP,NNP-CC-NNP-CC-NNP,5,1
0,0.0,45,was,11,1,4,3,0,40,10,-7,Gerd Tellenbach,17 September 1903,PER-PER,TIME-TIME-TIME,PROPN-PROPN,NUM-PROPN-NUM,compound-nsubj,nummod-appos-nummod,NNP-NNP,CD-NNP-CD,1,1
1,0.0,45,was,11,1,8,7,0,36,10,-3,Gerd Tellenbach,12 June 1999,PER-PER,TIME-TIME-TIME,PROPN-PROPN,NUM-PROPN-NUM,compound-nsubj,nummod-appos-nummod,NNP-NNP,CD-NNP-CD,1,1
0,0.0,24,is,8,14,17,3,13,6,-6,9,Svalbard,Norway,LOC,LOC,PROPN,PROPN,compound,pobj,NNP,NNP,4,1
1,6.0,14,is,11,13,11,-2,12,2,-2,0,Freemansundet,Edgeøya,LOC,LOC,PROPN,PROPN,attr,pobj,NNP,NNP,1,1
0,4.0,25,was,2,9,9,0,8,15,-7,7,John I de Balliol,John Balliol,PER-PER-PER-PER,PER-PER,PROPN-PROPN-ADP-PROPN,PROPN-PROPN,nmod-nmod-compound-pobj,compound-pobj,NNP-NNP-IN-NNP,NNP-NNP,0,1
1,4.0,25,was,2,9,21,12,8,3,-7,19,John Balliol,1292,PER-PER,TIME,PROPN-PROPN,NUM,compound-pobj,nummod,NNP-NNP,CD,6,1
0,0.0,24,is,9,1,6,5,0,17,8,-3,Raiphi Vincent Gomez,16 October 1985,PER-PER-PER,TIME-TIME-TIME,PROPN-PROPN-PROPN,NUM-PROPN-NUM,compound-compound-nsubj,nummod-npadvmod-nummod,NNP-NNP-NNP,CD-NNP-CD,3,1
1,2.0,15,selected,2,5,12,7,4,2,-3,10,Rajasthan Royals,Indian Premier League,ORG-ORG,ORG-ORG-ORG,PROPN-PROPN,PROPN-PROPN-PROPN,compound-pobj,compound-compound-pobj,NNP-NNPS,NNP-NNP-NNP,7,1
0,0.0,16,is,2,1,1,0,0,14,1,-1,Marella Explorer,Marella Cruises,MISC-MISC,ORG-ORG,PROPN-PROPN,PROPN-PROPN,compound-nsubj,compound-pobj,NNP-NNP,NNP-NNP,0,1
1,2.0,34,laid,2,7,11,4,6,22,-5,9,Meyer Werft shipyard,Papenburg,LOC-LOC-LOC,LOC,PROPN-PROPN-NOUN,PROPN,compound-compound-pobj,pobj,NNP-NNP-NN,NNP,4,1
2,2.0,34,laid,2,7,13,6,6,20,-5,11,Meyer Werft shipyard,Germany,LOC-LOC-LOC,LOC,PROPN-PROPN-NOUN,PROPN,compound-compound-pobj,appos,NNP-NNP-NN,NNP,4,1
3,2.0,34,laid,2,11,13,2,10,20,-9,11,Papenburg,Germany,LOC,LOC,PROPN,PROPN,pobj,appos,NNP,NNP,6,1
4,5.0,49,transferred,6,22,26,4,21,22,-16,20,Celebrity Cruises,Royal Caribbean Cruises Ltd.,ORG-ORG,ORG-ORG-ORG-ORG,PROPN-PROPN,ADJ-PROPN-PROPN-PROPN,compound-poss,compound-compound-subtok-subtok,NNP-NNPS,JJ-NNP-NNPS-NNP,10,1
0,1.0,27,centered,13,2,8,6,1,18,11,-5,Antarctic,Earth,LOC,LOC,ADJ,PROPN,amod,poss,JJ,NNP,5,1
0,0.0,13,is,7,1,6,5,0,6,6,-1,María Alicia Lemme,1954,PER-PER-PER,TIME,PROPN-PROPN-PROPN,NUM,compound-compound-nsubj,npadvmod,NNP-NNP-NNP,CD,2,1
1,6.0,24,stepped,1,23,8,-15,22,15,-22,7,Adolfo,Alberto Rodríguez Saá,PER,PER-PER-PER,PROPN,PROPN-PROPN-PROPN,appos,compound-compound-nsubj,NNP,NNP-NNP-NNP,5,1
0,0.0,33,was,22,30,32,2,29,0,-8,10,Milan,Italy,LOC,LOC,PROPN,PROPN,pobj,appos,NNP,NNP,5,1
0,0.0,26,is,10,1,7,6,0,18,9,-3,Wesley Alexander Nevada Thomas,23 January 1987,PER-PER-PER-PER,TIME-TIME-TIME,PROPN-PROPN-PROPN-PROPN,NUM-PROPN-NUM,compound-compound-compound-nsubj,nummod-npadvmod-nummod,NNP-NNP-NNP-NNP,CD-NNP-CD,4,1
1,0.0,26,is,10,1,24,23,0,1,9,14,Wesley Alexander Nevada Thomas,Grimsby Town,PER-PER-PER-PER,ORG-ORG,PROPN-PROPN-PROPN-PROPN,PROPN-PROPN,compound-compound-compound-nsubj,compound-pobj,NNP-NNP-NNP-NNP,NNP-NNP,9,1
0,0.0,30,is,11,9,27,18,8,2,2,16,Amras,Fëanor,PER,PER,PROPN,PROPN,appos,pobj,NNP,NNP,7,1
1,0.0,30,is,11,21,27,6,20,2,-10,16,Amrod,Fëanor,PER,PER,PROPN,PROPN,pobj,pobj,NNP,NNP,4,1
0,4.0,25,announced,9,14,17,3,13,7,-5,8,Michelle Bachelet,PS,PER-PER,ORG,PROPN-PROPN,PROPN,nmod-nmod,dobj,NNP-NNP,NNP,2,1
1,4.0,25,announced,9,14,24,10,13,0,-5,15,Michelle Bachelet,Concertacion,PER-PER,ORG,PROPN-PROPN,PROPN,nmod-nmod,pobj,NNP-NNP,NNP,3,1
0,0.0,33,Tiempo,2,1,5,4,0,27,1,3,Edith L. Tiempo,"April 22 , 1919",PER-PER-PER,TIME-TIME-TIME-TIME,PROPN-PROPN-PROPN,PROPN-NUM-PUNCT-NUM,compound-compound-ROOT,appos-nummod-punct-nummod,NNP-NNP-NNP,"NNP-CD-,-CD",3,1
1,0.0,33,Tiempo,2,1,10,9,0,22,1,8,Edith L. Tiempo,"August 21 , 2011",PER-PER-PER,TIME-TIME-TIME-TIME,PROPN-PROPN-PROPN,PROPN-NUM-PUNCT-NUM,compound-compound-ROOT,nsubj-nummod-punct-nummod,NNP-NNP-NNP,"NNP-CD-,-CD",3,1
2,1.0,17,born,2,1,5,4,0,11,1,3,Tiempo,Quezon City,PER,LOC-LOC,PROPN,PROPN-PROPN,nsubjpass,compound-pobj,NNP,NNP-NNP,3,1
0,1.0,51,did,1,1,8,7,0,42,0,7,Maarek,École Nationale des Ponts et Chaussées,PER,ORG-ORG-ORG-ORG-ORG-ORG,PROPN,PROPN-PROPN-PROPN-PROPN-PROPN-PROPN,nsubj,nmod-nmod-compound-compound-compound-pobj,NNP,NNP-NNP-NNP-NNP-NNP-NNP,5,1
1,1.0,51,did,1,1,23,22,0,27,0,22,Maarek,Pierre and Marie Curie University,PER,ORG-ORG-ORG-ORG-ORG,PROPN,PROPN-CCONJ-PROPN-PROPN-PROPN,nsubj,pobj-cc-compound-compound-conj,NNP,NNP-CC-NNP-NNP-NNP,4,1
2,1.0,51,did,1,1,35,34,0,15,0,34,Maarek,Technion – Israel Institute of Technology,PER,ORG-ORG-ORG-ORG-ORG-ORG,PROPN,PROPN-PUNCT-PROPN-PROPN-ADP-PROPN,nsubj,compound-pobj-compound-ROOT-prep-pobj,NNP,NNP-:-NNP-NNP-IN-NNP,5,1
3,3.0,29,founded,4,7,14,7,6,14,-3,10,Google Haifa Engineering Center,Israel,ORG-ORG-ORG-ORG,LOC,PROPN-PROPN-PROPN-PROPN,PROPN,compound-compound-compound-dobj,appos,NNP-NNP-NNP-NNP,NNP,2,1
4,3.0,29,founded,4,8,14,6,7,14,-4,10,Haifa,Israel,LOC,LOC,PROPN,PROPN,pobj,appos,NNP,NNP,2,1
0,0.0,28,is,3,1,18,17,0,9,2,15,Midway High School,USA,LOC-LOC-LOC,LOC,PROPN-PROPN-PROPN,PROPN,compound-compound-nsubj,appos,NNP-NNP-NNP,NNP,5,1
1,0.0,28,is,3,14,18,4,13,9,-11,15,Waco,USA,LOC,LOC,PROPN,PROPN,pobj,appos,NNP,NNP,6,1
2,0.0,28,is,3,16,18,2,15,9,-13,15,Texas,USA,LOC,LOC,PROPN,PROPN,appos,appos,NNP,NNP,7,1
0,4.0,10,shot,4,7,9,2,6,0,-3,5,Berlin,Germany,LOC,LOC,PROPN,PROPN,pobj,appos,NNP,NNP,4,1
1,11.0,39,named,16,15,3,-12,14,35,1,-13,The Edge,U2,PER-PER,ORG,DET-PROPN,PROPN,det-nsubj,pobj,DT-NNP,NNP,2,1
0,2.0,16,mark,4,6,15,9,5,0,-2,11,Zohra Sehgal,2014,PER-PER,TIME,PROPN-PROPN,NUM,compound-dobj,pobj,NNP-NNP,CD,2,1
1,3.0,32,marks,2,12,17,5,11,14,-10,15,Ranbir Kapoor,Rishi Kapoor,PER-PER,PER-PER,PROPN-PROPN,PROPN-PROPN,compound-conj,compound-appos,NNP-NNP,NNP-NNP,2,1
2,3.0,32,marks,2,12,20,8,11,11,-10,18,Ranbir Kapoor,Neetu Singh,PER-PER,PER-PER,PROPN-PROPN,PROPN-PROPN,compound-conj,compound-conj,NNP-NNP,NNP-NNP,3,1
3,3.0,32,marks,2,17,20,3,16,11,-15,18,Rishi Kapoor,Neetu Singh,PER-PER,PER-PER,PROPN-PROPN,PROPN-PROPN,compound-appos,compound-conj,NNP-NNP,NNP-NNP,1,1
4,3.0,32,marks,2,24,30,6,23,1,-22,28,Sonam Kapoor,Anil Kapoor,PER-PER,PER-PER,PROPN-PROPN,PROPN-PROPN,compound-conj,compound-pobj,NNP-NNP,NNP-NNP,2,1
0,0.0,32,is,15,12,14,2,11,17,3,-1,Augsburg,Germany,LOC,LOC,PROPN,PROPN,pobj,appos,NNP,NNP,7,1
0,0.0,38,is,4,1,12,11,0,25,3,8,The Saint in Europe,Leslie Charteris,MISC-MISC-MISC-MISC,PER-PER,DET-PROPN-ADP-PROPN,PROPN-PROPN,det-nsubj-prep-pobj,compound-pobj,DT-NNP-IN-NNP,NNP-NNP,4,1
1,0.0,38,is,4,1,18,17,0,19,3,14,The Saint in Europe,1953,MISC-MISC-MISC-MISC,TIME,DET-PROPN-ADP-PROPN,NUM,det-nsubj-prep-pobj,pobj,DT-NNP-IN-NNP,CD,3,1
2,0.0,38,is,4,1,1,0,0,36,3,-3,The Saint in Europe,The Crime Club,MISC-MISC-MISC-MISC,ORG-ORG-ORG,DET-PROPN-ADP-PROPN,DET-PROPN-PROPN,det-nsubj-prep-pobj,det-compound-pobj,DT-NNP-IN-NNP,DT-NNP-NNP,0,1
3,0.0,38,is,4,1,31,30,0,6,3,27,The Saint in Europe,Hodder and Stoughton,MISC-MISC-MISC-MISC,ORG-ORG-ORG,DET-PROPN-ADP-PROPN,PROPN-CCONJ-PROPN,det-nsubj-prep-pobj,pobj-cc-conj,DT-NNP-IN-NNP,NNP-CC-NNP,5,1
4,0.0,38,is,4,31,25,-6,30,12,-27,21,Hodder and Stoughton,United Kingdom,ORG-ORG-ORG,LOC-LOC,PROPN-CCONJ-PROPN,PROPN-PROPN,pobj-cc-conj,compound-pobj,NNP-CC-NNP,NNP-NNP,7,1
0,0.0,17,is,5,1,11,10,0,5,4,6,Slivo Pole,Bulgaria,LOC-LOC,LOC,PROPN-PROPN,PROPN,compound-nsubj,pobj,NNP-NNP,NNP,3,1
1,5.0,28,settled,2,9,12,3,8,15,-7,10,Crimean War,1853,MISC-MISC,TIME,PROPN-PROPN,NUM,compound-pobj,nummod,NNP-NNP,CD,2,1
2,5.0,28,settled,2,9,14,5,8,13,-7,12,Crimean War,1856,MISC-MISC,TIME,PROPN-PROPN,NUM,compound-pobj,nummod,NNP-NNP,CD,1,1
0,0.0,23,is,2,1,10,9,0,12,1,8,Girls Trip,Regina Hall,MISC-MISC,PER-PER,NOUN-PROPN,PROPN-PROPN,compound-nsubj,compound-dobj,NNS-NNP,NNP-NNP,4,1
1,0.0,23,is,2,1,13,12,0,9,1,11,Girls Trip,Queen Latifah,MISC-MISC,PER-PER,NOUN-PROPN,PROPN-PROPN,compound-nsubj,compound-conj,NNS-NNP,NNP-NNP,5,1
2,0.0,23,is,2,1,20,19,0,2,1,18,Girls Trip,Jada Pinkett Smith,MISC-MISC,PER-PER-PER,NOUN-PROPN,PROPN-PROPN-PROPN,compound-nsubj,compound-compound-conj,NNS-NNP,NNP-NNP-NNP,3,1
3,3.0,34,premiered,2,1,27,26,0,6,1,25,Girls Trip,Universal Pictures,MISC-MISC,ORG-ORG,NOUN-PROPN,PROPN-PROPN,compound-nsubj,compound-pobj,NNS-NNP,NNP-NNP,4,1
4,3.0,34,premiered,2,6,11,5,5,22,-4,9,American Black Film Festival,Miami,MISC-MISC-MISC-MISC,LOC,PROPN-PROPN-PROPN-PROPN,PROPN,compound-compound-compound-pobj,pobj,NNP-NNP-NNP-NNP,NNP,4,1
5,3.0,34,premiered,2,6,5,-1,5,28,-4,3,American Black Film Festival,the United States,MISC-MISC-MISC-MISC,LOC-LOC-LOC,PROPN-PROPN-PROPN-PROPN,DET-PROPN-PROPN,compound-compound-compound-pobj,det-compound-pobj,NNP-NNP-NNP-NNP,DT-NNP-NNP,2,1
6,3.0,34,premiered,2,11,5,-6,10,28,-9,3,Miami,the United States,LOC,LOC-LOC-LOC,PROPN,DET-PROPN-PROPN,pobj,det-compound-pobj,NNP,DT-NNP-NNP,4,1
0,0.0,34,is,8,1,5,4,0,28,7,-3,Paul Ardenne,4 October 1956,PER-PER,TIME-TIME-TIME,PROPN-PROPN,NUM-PROPN-NUM,compound-nsubj,nummod-npadvmod-nummod,NNP-NNP,CD-NNP-CD,2,1
1,0.0,34,is,8,1,15,14,0,18,7,7,Paul Ardenne,University of Amiens,PER-PER,ORG-ORG-ORG,PROPN-PROPN,PROPN-ADP-PROPN,compound-nsubj,pobj-prep-pobj,NNP-NNP,NNP-IN-NNP,5,1
2,2.0,48,encountered,4,18,25,7,17,22,-14,21,Catherine Millet,Art Press,PER-PER,ORG-ORG,PROPN-PROPN,PROPN-PROPN,compound-conj,compound-pobj,NNP-NNP,NNP-NNP,3,1
0,0.0,22,is,2,12,20,8,11,1,-10,18,Cream,Polydor Records,ORG,ORG-ORG,PROPN,PROPN-PROPN,pobj,compound-pobj,NNP,NNP-NNPS,4,1
1,1.0,16,contains,1,12,15,3,11,0,-11,14,BBC,London,ORG,LOC,PROPN,PROPN,compound,pobj,NNP,NNP,6,1
2,4.0,37,included,4,25,20,-5,24,16,-21,16,I Feel Free – Ultimate Cream,Cream,MISC-MISC-MISC-MISC-MISC-MISC,ORG,PRON-VERB-ADJ-PUNCT-PROPN-PROPN,PROPN,nsubj-ROOT-compound-compound-compound-dobj,poss,PRP-VBP-JJ-HYPH-NNP-NNP,NNP,9,1
0,0.0,19,is,3,10,14,4,9,4,-7,11,West Bank,Israel,LOC-LOC,LOC,PROPN-PROPN,PROPN,compound-pobj,poss,NNP-NNP,NNP,7,1
1,1.0,26,located,2,20,15,-5,19,10,-18,13,Israeli,Dead Sea,LOC,LOC-LOC,ADJ,PROPN-PROPN,amod,compound-pobj,JJ,NNP-NNP,9,1
0,0.0,11,was,3,2,6,4,1,4,1,3,Palace Rebellion,1949,MISC-MISC,TIME,PROPN-PROPN,NUM,compound-nsubj,nummod,NNP-NNP,CD,3,1
0,0.0,33,is,6,12,22,10,11,10,-6,16,Philippines,Luzon Island,LOC,LOC-LOC,PROPN,PROPN-PROPN,pobj,compound-pobj,NNPS,NNP-NNP,5,1
1,4.0,36,covered,9,2,24,22,1,11,7,15,La Provincia de Cagayan,Quirino,LOC-LOC-LOC-LOC,LOC,PROPN-PROPN-PROPN-PROPN,PROPN,compound-compound-compound-oprd,conj,NNP-NNP-NNP-NNP,NNP,10,1
2,4.0,36,covered,9,5,24,19,4,11,4,15,Cagayan Valley,Quirino,LOC-LOC,LOC,PROPN-PROPN,PROPN,compound-dobj,conj,NNP-NNP,NNP,8,1
3,4.0,36,covered,9,5,26,21,4,9,4,17,Cagayan Valley,Nueva Vizcaya,LOC-LOC,LOC-LOC,PROPN-PROPN,PROPN-PROPN,compound-dobj,compound-conj,NNP-NNP,NNP-NNP,8,1
4,4.0,36,covered,9,5,29,24,4,6,4,20,Cagayan Valley,Batanes,LOC-LOC,LOC,PROPN-PROPN,PROPN,compound-dobj,conj,NNP-NNP,NNPS,10,1
5,4.0,36,covered,9,5,22,17,4,13,4,13,Cagayan Valley,Isabela,LOC-LOC,LOC,PROPN-PROPN,PROPN,compound-dobj,pobj,NNP-NNP,NNP,7,1
0,0.0,20,was,13,1,4,3,0,15,12,-9,Raymond Hackett,"July 15 , 1902",PER-PER,TIME-TIME-TIME-TIME,PROPN-PROPN,PROPN-NUM-PUNCT-NUM,compound-nsubj,appos-nummod-punct-nummod,NNP-NNP,"NNP-CD-,-CD",2,1
1,0.0,20,was,13,1,4,3,0,15,12,-9,Raymond Hackett,"July 7 , 1958",PER-PER,TIME-TIME-TIME-TIME,PROPN-PROPN,PROPN-NUM-PUNCT-NUM,compound-nsubj,appos-nummod-punct-nummod,NNP-NNP,"NNP-CD-,-CD",2,1
2,8.0,35,called,5,24,30,6,23,4,-19,25,The Country Flapper,Dorothy Gish,MISC-MISC-MISC,PER-PER,DET-PROPN-PROPN,PROPN-PROPN,det-nsubj-appos,compound-dobj,DT-NNP-NNP,NNP-NNP,9,1
3,8.0,35,called,5,24,33,9,23,1,-19,28,The Country Flapper,Glenn Hunter,MISC-MISC-MISC,PER-PER,DET-PROPN-PROPN,PROPN-PROPN,det-nsubj-appos,compound-conj,DT-NNP-NNP,NNP-NNP,7,1
4,9.0,18,Had,0,8,11,3,7,6,-8,11,The Cradle Snatchers,1925,MISC-MISC-MISC,TIME,DET-PROPN-PROPN,NUM,det-compound-pobj,appos,DT-NNP-NNPS,CD,4,1
0,3.0,23,adopted,13,7,10,3,6,12,6,-3,Emperor Hirohito,Princess Kazuko,PER-PER,PER-PER,PROPN-PROPN,PROPN-PROPN,compound-pobj,compound-appos,NNP-NNP,NNP-NNP,1,1
0,0.0,72,was,18,61,67,6,60,4,-43,49,The Blue Dahlia,Raymond Chandler,MISC-MISC-MISC,PER-PER,DET-PROPN-PROPN,PROPN-PROPN,det-compound-pobj,compound-pobj,DT-NNP-NNP,NNP-NNP,7,1
1,1.0,35,known,4,17,21,4,16,13,-13,17,The Paper Chase,1973,MISC-MISC-MISC,TIME,DET-PROPN-PROPN,NUM,det-compound-ROOT,appos,DT-NNP-NNP,CD,2,1
0,0.0,32,is,4,1,31,30,0,0,3,27,Remi Lake,Canada,LOC-LOC,LOC,PROPN-PROPN,PROPN,compound-nsubj,appos,NNP-NNP,NNP,2,1
1,0.0,32,is,4,16,31,15,15,0,-12,27,Gurney Township,Canada,LOC-LOC,LOC,PROPN-PROPN,PROPN,compound-conj,appos,NNP-NNP,NNP,5,1
2,0.0,32,is,4,20,21,1,19,10,-16,17,North Cochrane District,Cochrane District,LOC-LOC-LOC,LOC-LOC,PROPN-PROPN-PROPN,PROPN-PROPN,compound-compound-pobj,compound-appos,NNP-NNP-NNP,NNP-NNP,1,1
3,0.0,32,is,4,21,28,7,20,3,-17,24,Cochrane District,Northeastern Ontario,LOC-LOC,LOC-LOC,PROPN-PROPN,PROPN-PROPN,compound-appos,compound-pobj,NNP-NNP,NNP-NNP,6,1
4,0.0,32,is,4,21,31,10,20,0,-17,27,Cochrane District,Canada,LOC-LOC,LOC,PROPN-PROPN,PROPN,compound-appos,appos,NNP-NNP,NNP,7,1
5,0.0,32,is,4,28,31,3,27,0,-24,27,Northeastern Ontario,Canada,LOC-LOC,LOC,PROPN-PROPN,PROPN,compound-pobj,appos,NNP-NNP,NNP,5,1
0,2.0,33,shows,1,3,6,3,2,26,-2,5,Louis IX of France,France,PER-PER-PER-PER,LOC,PROPN-PROPN-ADP-PROPN,PROPN,compound-nsubj-prep-pobj,pobj,NNP-NNP-IN-NNP,NNP,2,1
0,6.0,28,was,6,12,19,7,11,8,-6,13,Cold War,Soviet Empire,MISC-MISC,LOC-LOC,PROPN-PROPN,PROPN-PROPN,compound-pobj,compound-pobj,NNP-NNP,NNP-NNP,5,1
0,0.0,15,is,3,1,12,11,0,2,2,9,On Your Mark,Chage & Aska,MISC-MISC-MISC,ORG-ORG-ORG,ADP-DET-PROPN,PROPN-CCONJ-PROPN,prep-poss-pobj,appos-cc-conj,IN-PRP$-NNP,NNP-CC-NNP,7,1
0,2.0,24,attended,7,7,10,3,6,13,0,3,Stough,University of Colorado,PER,ORG-ORG-ORG,PROPN,PROPN-ADP-PROPN,nsubj,dobj-prep-pobj,NNP,NNP-IN-NNP,2,1
1,3.0,37,worked,9,33,5,-28,32,31,-24,-4,The Book of Mormon,Trey Parker,MISC-MISC-MISC-MISC,PER-PER,DET-PROPN-ADP-PROPN,PROPN-PROPN,det-conj-prep-pobj,compound-pobj,DT-NNP-IN-NNP,NNP-NNP,-1,1
2,3.0,37,worked,9,23,5,-18,22,31,-14,-4,South Park,Trey Parker,MISC-MISC,PER-PER,PROPN-PROPN,PROPN-PROPN,compound-pobj,compound-pobj,NNP-NNP,NNP-NNP,7,1
3,3.0,37,worked,9,23,14,-9,22,22,-14,5,South Park,Matt Stone,MISC-MISC,PER-PER,PROPN-PROPN,PROPN-PROPN,compound-pobj,compound-conj,NNP-NNP,NNP-NNP,7,1
4,5.0,14,was,1,9,12,3,8,1,-8,11,Butters Stotch,South Park,PER-PER,MISC-MISC,PROPN-PROPN,PROPN-PROPN,compound-pobj,compound-pobj,NNP-NNP,NNP-NNP,2,1
0,0.0,27,is,5,13,13,0,12,13,-8,8,Virginia Beach,Virginia,LOC-LOC,LOC,PROPN-PROPN,PROPN,compound-pobj,appos,NNP-NNP,NNP,0,1
0,0.0,31,Griffith,2,1,5,4,0,25,1,3,John Keller Griffith,"October 16 , 1882",PER-PER-PER,TIME-TIME-TIME-TIME,PROPN-PROPN-PROPN,PROPN-NUM-PUNCT-NUM,compound-compound-ROOT,appos-nummod-punct-nummod,NNP-NNP-NNP,"NNP-CD-,-CD",3,1
1,0.0,31,Griffith,2,1,10,9,0,20,1,8,John Keller Griffith,"September 25 , 1942",PER-PER-PER,TIME-TIME-TIME-TIME,PROPN-PROPN-PROPN,PROPN-NUM-PUNCT-NUM,compound-compound-ROOT,nsubj-nummod-punct-nummod,NNP-NNP-NNP,"NNP-CD-,-CD",3,1
2,1.0,28,earned,6,23,26,3,22,1,-17,20,Tulane University,New Orleans,ORG-ORG,LOC-LOC,PROPN-PROPN,PROPN-PROPN,compound-pobj,compound-pobj,NNP-NNP,NNP-NNP,2,1
3,4.0,33,elected,5,4,9,5,3,23,1,4,Griffith,Democrat,PER,ORG,PROPN,PROPN,nsubjpass,pobj,NNP,NNP,2,1
0,0.0,31,Lie,2,1,5,4,0,25,1,3,Haakon Steen Lie,22 September 1905,PER-PER-PER,TIME-TIME-TIME,PROPN-PROPN-PROPN,NUM-PROPN-NUM,compound-compound-ROOT,nummod-appos-nummod,NNP-NNP-NNP,CD-NNP-CD,2,1
1,0.0,31,Lie,2,1,9,8,0,21,1,7,Haakon Steen Lie,25 May 2009,PER-PER-PER,TIME-TIME-TIME,PROPN-PROPN-PROPN,NUM-PROPN-NUM,compound-compound-ROOT,nummod-nsubj-nummod,NNP-NNP-NNP,CD-NNP-CD,3,1
2,0.0,31,Lie,2,1,15,14,0,15,1,13,Haakon Steen Lie,Norwegian,PER-PER-PER,LOC,PROPN-PROPN-PROPN,ADJ,compound-compound-ROOT,amod,NNP-NNP-NNP,JJ,3,1
0,0.0,28,Bosbyshell,2,1,5,4,0,22,1,3,Oliver Christian Bosbyshell,"January 3 , 1839",PER-PER-PER,TIME-TIME-TIME-TIME,PROPN-PROPN-PROPN,PROPN-NUM-PUNCT-NUM,compound-compound-ROOT,appos-nummod-punct-nummod,NNP-NNP-NNP,"NNP-CD-,-CD",3,1
1,1.0,47,claimed,2,17,35,18,16,11,-15,33,Civil War,Confederate,MISC-MISC,ORG,PROPN-PROPN,PROPN,compound-pobj,compound,NNP-NNP,NNP,14,1
2,3.0,18,were,2,14,17,3,13,0,-12,15,Schuylkill County,Pennsylvania,LOC-LOC,LOC,PROPN-PROPN,PROPN,compound-pobj,appos,NNP-NNP,NNP,3,1
3,8.0,40,involved,18,6,22,16,5,17,12,4,Bosbyshell,Republican,PER,ORG,PROPN,ADJ,nsubj,amod,NNP,JJ,3,1
0,0.0,34,Bigger,1,1,9,8,0,24,0,8,Samuel Bigger,"September 9 , 1846",PER-PER,TIME-TIME-TIME-TIME,PROPN-PROPN,PROPN-NUM-PUNCT-NUM,compound-ROOT,nsubj-nummod-punct-nummod,NNP-NNP,"NNP-CD-,-CD",3,1
1,0.0,34,Bigger,1,1,20,19,0,13,0,19,Samuel Bigger,U.S.,PER-PER,LOC,PROPN-PROPN,PROPN,compound-ROOT,compound,NNP-NNP,NNP,4,1
2,0.0,34,Bigger,1,20,23,3,19,10,-19,22,U.S.,Indiana,LOC,LOC,PROPN,PROPN,compound,pobj,NNP,NNP,3,1
0,0.0,25,Sanford,3,1,6,5,0,18,2,3,John W. A. Sanford,"August 28 , 1798",PER-PER-PER-PER,TIME-TIME-TIME-TIME,PROPN-PROPN-PROPN-PROPN,PROPN-NUM-PUNCT-NUM,compound-compound-compound-ROOT,appos-nummod-punct-nummod,NNP-NNP-NNP-NNP,"NNP-CD-,-CD",3,1
1,0.0,25,Sanford,3,1,18,17,0,6,2,15,John W. A. Sanford,United States,PER-PER-PER-PER,LOC-LOC,PROPN-PROPN-PROPN-PROPN,PROPN-PROPN,compound-compound-compound-ROOT,compound-compound,NNP-NNP-NNP-NNP,NNP-NNP,4,1
2,0.0,25,Sanford,3,18,24,6,17,0,-15,21,United States,Georgia,LOC-LOC,LOC,PROPN-PROPN,PROPN,compound-compound,pobj,NNP-NNP,NNP,3,1
0,0.0,13,is,1,1,11,10,0,1,0,10,Monson,United States,LOC,LOC-LOC,PROPN,PROPN-PROPN,nsubj,compound-conj,NNP,NNP-NNP,4,1
1,0.0,13,is,1,6,9,3,5,3,-5,8,Piscataquis County,Maine,LOC-LOC,LOC,PROPN-PROPN,PROPN,compound-pobj,conj,NNP-NNP,NNP,1,1
2,0.0,13,is,1,6,11,5,5,1,-5,10,Piscataquis County,United States,LOC-LOC,LOC-LOC,PROPN-PROPN,PROPN-PROPN,compound-pobj,compound-conj,NNP-NNP,NNP-NNP,1,1
3,0.0,13,is,1,9,11,2,8,1,-8,10,Maine,United States,LOC,LOC-LOC,PROPN,PROPN-PROPN,conj,compound-conj,NNP,NNP-NNP,2,1
0,0.0,15,is,1,1,13,12,0,1,0,12,Hiram,United States,LOC,LOC-LOC,PROPN,PROPN-PROPN,nsubj,compound-appos,NNP,NNP-NNP,5,1
1,0.0,15,is,1,8,11,3,7,3,-7,10,Wayne County,Missouri,LOC-LOC,LOC,PROPN-PROPN,PROPN,compound-pobj,conj,NNP-NNP,NNP,2,1
2,0.0,15,is,1,8,13,5,7,1,-7,12,Wayne County,United States,LOC-LOC,LOC-LOC,PROPN-PROPN,PROPN-PROPN,compound-pobj,compound-appos,NNP-NNP,NNP-NNP,2,1
3,0.0,15,is,1,11,13,2,10,1,-10,12,Missouri,United States,LOC,LOC-LOC,PROPN,PROPN-PROPN,conj,compound-appos,NNP,NNP-NNP,2,1
0,0.0,24,was,14,1,5,4,0,18,13,-9,Bradley B. Meeker,"March 13 , 1813",PER-PER-PER,TIME-TIME-TIME-TIME,PROPN-PROPN-PROPN,PROPN-NUM-PUNCT-NUM,compound-compound-nsubj,appos-nummod-punct-nummod,NNP-NNP-NNP,"NNP-CD-,-CD",3,1
1,0.0,24,was,14,1,10,9,0,13,13,-4,Bradley B. Meeker,"February 20 , 1873",PER-PER-PER,TIME-TIME-TIME-TIME,PROPN-PROPN-PROPN,PROPN-NUM-PUNCT-NUM,compound-compound-nsubj,appos-nummod-punct-nummod,NNP-NNP-NNP,"NNP-CD-,-CD",4,1
2,0.0,24,was,14,1,17,16,0,6,13,3,Bradley B. Meeker,American,PER-PER-PER,LOC,PROPN-PROPN-PROPN,ADJ,compound-compound-nsubj,amod,NNP-NNP-NNP,JJ,3,1
3,1.0,15,went,7,7,10,3,6,4,0,3,Meeker,Weston Academy,PER,ORG-ORG,PROPN,PROPN-PROPN,nsubj,compound-pobj,NNP,NNP-NNP,2,1
4,1.0,15,went,7,7,13,6,6,1,0,6,Meeker,Yale University,PER,ORG-ORG,PROPN,PROPN-PROPN,nsubj,compound-conj,NNP,NNP-NNP,3,1
5,8.0,9,named,5,1,4,3,0,4,4,-1,Meeker County,Minnesota,LOC-LOC,LOC,PROPN-PROPN,PROPN,compound-nsubjpass,appos,NNP-NNP,NNP,2,1
0,0.0,13,is,8,1,5,4,0,7,7,-3,Miranda Otto,16 December 1967,PER-PER,TIME-TIME-TIME,PROPN-PROPN,NUM-PROPN-NUM,compound-nsubj,nummod-npadvmod-nummod,NNP-NNP,CD-NNP-CD,2,1
1,1.0,20,is,1,1,18,17,0,1,0,17,Otto,Gracie Otto,PER,PER-PER,PROPN,PROPN-PROPN,nsubj,compound-pobj,NNP,NNP-NNP,5,1
0,0.0,23,was,14,1,5,4,0,17,13,-9,William Edward Dodd,"October 21 , 1869",PER-PER-PER,TIME-TIME-TIME-TIME,PROPN-PROPN-PROPN,PROPN-NUM-PUNCT-NUM,compound-compound-nsubj,appos-nummod-punct-nummod,NNP-NNP-NNP,"NNP-CD-,-CD",3,1
1,0.0,23,was,14,1,10,9,0,12,13,-4,William Edward Dodd,"February 9 , 1940",PER-PER-PER,TIME-TIME-TIME-TIME,PROPN-PROPN-PROPN,PROPN-NUM-PUNCT-NUM,compound-compound-nsubj,appos-nummod-punct-nummod,NNP-NNP-NNP,"NNP-CD-,-CD",3,1
2,1.0,22,served,5,3,8,5,2,13,2,3,Democrat,the United States,ORG,LOC-LOC-LOC,PROPN,DET-PROPN-PROPN,advcl,det-compound-compound,NNP,DT-NNP-NNP,5,1
0,0.0,20,was,15,1,6,5,0,13,14,-9,Otto Friedrich Karl Deiters,"November 15 , 1834",PER-PER-PER-PER,TIME-TIME-TIME-TIME,PROPN-PROPN-PROPN-PROPN,PROPN-NUM-PUNCT-NUM,compound-compound-compound-nsubj,npadvmod-nummod-punct-nummod,NNP-NNP-NNP-NNP,"NNP-CD-,-CD",4,1
1,0.0,20,was,15,1,11,10,0,8,14,-4,Otto Friedrich Karl Deiters,"December 5 , 1863",PER-PER-PER-PER,TIME-TIME-TIME-TIME,PROPN-PROPN-PROPN-PROPN,PROPN-NUM-PUNCT-NUM,compound-compound-compound-nsubj,appos-nummod-punct-nummod,NNP-NNP-NNP-NNP,"NNP-CD-,-CD",5,1
2,0.0,20,was,15,1,18,17,0,1,14,3,Otto Friedrich Karl Deiters,German,PER-PER-PER-PER,LOC,PROPN-PROPN-PROPN-PROPN,ADJ,compound-compound-compound-nsubj,amod,NNP-NNP-NNP-NNP,JJ,4,1
0,0.0,32,is,24,1,5,4,0,26,23,-19,Elspeth Attwooll,1 February 1943,PER-PER,TIME-TIME-TIME,PROPN-PROPN,NUM-PROPN-NUM,compound-nsubj,nummod-npadvmod-nummod,NNP-NNP,CD-NNP-CD,2,1
1,0.0,32,is,24,1,9,8,0,22,23,-15,Elspeth Attwooll,Chislehurst,PER-PER,LOC,PROPN-PROPN,PROPN,compound-nsubj,pobj,NNP-NNP,NNP,2,1
2,0.0,32,is,24,9,23,14,8,8,15,-1,Chislehurst,Bromley,LOC,LOC,PROPN,PROPN,pobj,pobj,NNP,NNP,3,1
3,9.0,22,succeeded,2,11,9,-2,10,12,-9,7,George Lyon,Scotland,PER-PER,LOC,PROPN-PROPN,PROPN,compound-pobj,pobj,NNP-NNP,NNP,1,1
0,0.0,10,is,3,1,6,5,0,3,2,3,Gautham K Sharma,Indian,PER-PER-PER,LOC,PROPN-PROPN-PROPN,ADJ,compound-compound-nsubj,amod,NNP-NNP-NNP,JJ,3,1
1,5.0,35,made,1,13,17,4,12,17,-12,16,Bhindi Baazaar Inc.,2011,ORG-ORG-ORG,TIME,PROPN-PROPN-PROPN,NUM,compound-compound-pobj,npadvmod,NNP-NNP-NNP,CD,8,1
2,5.0,35,made,1,13,20,7,12,14,-12,19,Bhindi Baazaar Inc.,Kay Kay Menon,ORG-ORG-ORG,PER-PER-PER,PROPN-PROPN-PROPN,PROPN-PROPN-PROPN,compound-compound-pobj,compound-compound-pobj,NNP-NNP-NNP,NNP-NNP-NNP,10,1
3,5.0,35,made,1,13,24,11,12,10,-12,23,Bhindi Baazaar Inc.,Piyush Mishra,ORG-ORG-ORG,PER-PER,PROPN-PROPN-PROPN,PROPN-PROPN,compound-compound-pobj,compound-conj,NNP-NNP-NNP,NNP-NNP,10,1
4,5.0,35,made,1,13,27,14,12,7,-12,26,Bhindi Baazaar Inc.,Pavan Malhotra,ORG-ORG-ORG,PER-PER,PROPN-PROPN-PROPN,PROPN-PROPN,compound-compound-pobj,compound-conj,NNP-NNP-NNP,NNP-NNP,11,1
0,0.0,17,was,12,1,5,4,0,11,11,-7,William Channing A'Beckett,1 January 1846,PER-PER-PER,TIME-TIME-TIME,PROPN-PROPN-PROPN,NUM-PROPN-NUM,compound-compound-nsubj,nummod-appos-nummod,NNP-NNP-NNP,CD-NNP-CD,2,1
1,2.0,21,sent,2,16,12,-4,15,8,-14,10,New South Wales,Australia,LOC-LOC-LOC,LOC,PROPN-PROPN-PROPN,PROPN,compound-compound-pobj,pobj,NNP-NNP-NNP,NNP,4,1
2,6.0,7,died,1,1,4,3,0,2,0,3,A'Beckett,Wellington,PER,LOC,PROPN,PROPN,nsubj,pobj,NNP,NNP,1,1
0,0.0,32,is,2,1,7,6,0,24,1,5,Panic Spring,Lawrence Durrell,MISC-MISC,PER-PER,PROPN-PROPN,PROPN-PROPN,compound-nsubj,compound-pobj,NNP-NNP,NNP-NNP,4,1
1,0.0,32,is,2,1,12,11,0,19,1,10,Panic Spring,1937,MISC-MISC,TIME,PROPN-PROPN,NUM,compound-nsubj,pobj,NNP-NNP,CD,6,1
2,0.0,32,is,2,1,14,13,0,17,1,12,Panic Spring,Faber and Faber,MISC-MISC,ORG-ORG-ORG,PROPN-PROPN,PROPN-CCONJ-PROPN,compound-nsubj,pobj-cc-conj,NNP-NNP,NNP-CC-NNP,8,1
3,0.0,32,is,2,14,18,4,13,13,-12,16,Faber and Faber,Britain,ORG-ORG-ORG,LOC,PROPN-CCONJ-PROPN,PROPN,pobj-cc-conj,pobj,NNP-CC-NNP,NNP,4,1
4,1.0,24,set,2,18,14,-4,17,9,-16,12,Patras,Ionian Sea,LOC,LOC-LOC,PROPN,PROPN-PROPN,pobj,compound-pobj,NNP,NNP-NNP,8,1
5,1.0,24,set,2,20,14,-6,19,9,-18,12,Kephalonia,Ionian Sea,LOC,LOC-LOC,PROPN,PROPN-PROPN,conj,compound-pobj,NNP,NNP-NNP,9,1
6,1.0,24,set,2,23,14,-9,22,9,-21,12,Ithaca,Ionian Sea,LOC,LOC-LOC,PROPN,PROPN-PROPN,conj,compound-pobj,NNP,NNP-NNP,5,1
0,5.0,31,seen,2,1,9,8,0,21,1,7,EasyJet,1995,ORG,TIME,PROPN,NUM,nsubj,pobj,NNP,CD,2,1
0,1.0,38,born,2,25,22,-3,24,15,-23,20,Soviet Union,Voronezh Oblast,LOC-LOC,LOC-LOC,PROPN-PROPN,PROPN-PROPN,compound-conj,compound-appos,NNP-NNP,NNP-NNP,2,1
0,4.0,64,are,3,15,45,30,14,18,-12,42,Windows NT,DEC Alpha,MISC-MISC,MISC-MISC,PROPN-PROPN,PROPN-PROPN,compound-compound,compound-appos,NNP-NNP,NNP-NNP,6,1
1,4.0,64,are,3,15,48,33,14,15,-12,45,Windows NT,PowerPC,MISC-MISC,MISC,PROPN-PROPN,PROPN,compound-compound,conj,NNP-NNP,NNP,10,1
2,4.0,64,are,3,15,50,35,14,13,-12,47,Windows NT,Mips,MISC-MISC,MISC,PROPN-PROPN,PROPN,compound-compound,npadvmod,NNP-NNP,NNP,10,1
3,4.0,64,are,3,15,10,-5,14,53,-12,7,Windows NT,Microsoft,MISC-MISC,ORG,PROPN-PROPN,PROPN,compound-compound,nsubj,NNP-NNP,NNP,4,1
4,4.0,64,are,3,31,10,-21,30,53,-28,7,Hardware Abstraction,Microsoft,MISC-MISC,ORG,PROPN-PROPN,PROPN,compound-compound,nsubj,NNP-NNP,NNP,6,1
5,4.0,64,are,3,45,10,-35,44,53,-42,7,DEC Alpha,Microsoft,MISC-MISC,ORG,PROPN-PROPN,PROPN,compound-appos,nsubj,NNP-NNP,NNP,6,1
6,4.0,64,are,3,48,10,-38,47,53,-45,7,PowerPC,Microsoft,MISC,ORG,PROPN,PROPN,conj,nsubj,NNP,NNP,6,1
7,4.0,64,are,3,50,10,-40,49,53,-47,7,Mips,Microsoft,MISC,ORG,PROPN,PROPN,npadvmod,nsubj,NNP,NNP,6,1
0,0.0,17,is,7,2,13,11,1,3,5,6,Elbe Lateral Canal,Lower Saxony,LOC-LOC-LOC,LOC-LOC,PROPN-PROPN-PROPN,PROPN-PROPN,compound-compound-compound,compound-pobj,NNP-NNP-NNP,NNP-NNP,-1,1
1,0.0,17,is,7,2,16,14,1,0,5,9,Elbe Lateral Canal,Germany,LOC-LOC-LOC,LOC,PROPN-PROPN-PROPN,PROPN,compound-compound-compound,appos,NNP-NNP-NNP,NNP,-1,1
2,0.0,17,is,7,13,16,3,12,0,-6,9,Lower Saxony,Germany,LOC-LOC,LOC,PROPN-PROPN,PROPN,compound-pobj,appos,NNP-NNP,NNP,4,1
0,4.0,41,based,6,2,37,35,1,3,4,31,Los Angeles Hindu Society,U.S.,ORG-ORG-ORG-ORG,LOC,PROPN-PROPN-PROPN-PROPN,PROPN,compound-compound-compound-nsubjpass,compound,NNP-NNP-NNP-NNP,NNP,12,1
1,4.0,41,based,6,10,37,27,9,3,-4,31,Pasadena Hindu Temple,U.S.,LOC-LOC-LOC,LOC,PROPN-PROPN-PROPN,PROPN,compound-compound-pobj,compound,NNP-NNP-NNP,NNP,9,1
2,4.0,41,based,6,40,37,-3,39,3,-34,31,California,U.S.,LOC,LOC,PROPN,PROPN,pobj,compound,NNP,NNP,11,1
0,0.0,72,is,1,1,10,9,0,61,0,9,Procidis,Albert Barillé,ORG,PER-PER,PROPN,PROPN-PROPN,nsubj,compound-pobj,NNP,NNP-NNP,4,1
1,0.0,72,is,1,66,69,3,65,2,-65,68,Planet Earth,2008,MISC-MISC,TIME,PROPN-PROPN,NUM,compound-conj,appos,NNP-NNP,CD,1,1
0,1.0,15,is,1,12,14,2,11,0,-11,13,Zeus,Hera,PER,PER,PROPN,PROPN,pobj,conj,NNP,NNP,8,1
1,5.0,19,tells,7,3,7,4,2,11,4,0,Iliad,Zeus,MISC,PER,PROPN,PROPN,pobj,appos,NNP,NNP,1,1
2,10.0,25,is,1,9,20,11,8,4,-8,19,Aphrodite,Hephaestus,PER,PER,PROPN,PROPN,pobj,pobj,NNP,NNP,6,1
0,0.0,13,is,3,1,6,5,0,6,2,3,Christopher Wayne Heatherly,American,PER-PER-PER,LOC,PROPN-PROPN-PROPN,ADJ,compound-compound-nsubj,amod,NNP-NNP-NNP,JJ,4,1
0,0.0,16,Fagan,1,1,4,3,0,11,0,3,Charles Fagan,1 October 1881,PER-PER,TIME-TIME-TIME,PROPN-PROPN,NUM-PROPN-NUM,compound-ROOT,nummod-appos-nummod,NNP-NNP,CD-NNP-CD,1,1
1,0.0,16,Fagan,1,1,8,7,0,7,0,7,Charles Fagan,8 May 1974,PER-PER,TIME-TIME-TIME,PROPN-PROPN,NUM-PROPN-NUM,compound-ROOT,nummod-nsubj-nummod,NNP-NNP,CD-NNP-CD,2,1
0,6.0,12,led,6,4,2,-2,3,9,2,-4,Lala Lajpat Rai,Indian,PER-PER-PER,LOC,PROPN-PROPN-PROPN,ADJ,compound-compound-nsubj,amod,NNP-NNP-NNP,JJ,2,1
0,0.0,20,is,4,1,13,12,0,6,3,9,Doctor in the House,Ralph Thomas,MISC-MISC-MISC-MISC,PER-PER,NOUN-ADP-DET-PROPN,PROPN-PROPN,nsubj-prep-det-pobj,compound-pobj,NN-IN-DT-NNP,NNP-NNP,6,1
1,0.0,20,is,4,1,18,17,0,1,3,14,Doctor in the House,Betty Box,MISC-MISC-MISC-MISC,PER-PER,NOUN-ADP-DET-PROPN,PROPN-PROPN,nsubj-prep-det-pobj,compound-pobj,NN-IN-DT-NNP,NNP-NNP,7,1
0,2.0,35,translated,1,4,14,10,3,20,-3,13,Story of My Experiments with Truth,Mahatma Gandhi,MISC-MISC-MISC-MISC-MISC-MISC,PER-PER,PROPN-ADP-DET-NOUN-ADP-PROPN,PROPN-PROPN,dobj-prep-poss-pobj-prep-pobj,compound-pobj,NNP-IN-PRP$-NNS-IN-NNP,NNP-NNP,4,1
0,0.0,31,is,2,1,11,10,0,19,1,9,Union Peak,Cascade Range,LOC-LOC,LOC-LOC,PROPN-PROPN,PROPN-PROPN,compound-nsubj,compound-pobj,NNP-NNP,NNP-NNP,4,1
1,0.0,31,is,2,1,15,14,0,15,1,13,Union Peak,Oregon,LOC-LOC,LOC,PROPN-PROPN,PROPN,compound-nsubj,pobj,NNP-NNP,NNP,3,1
2,0.0,31,is,2,11,15,4,10,15,-9,13,Cascade Range,Oregon,LOC-LOC,LOC,PROPN-PROPN,PROPN,compound-pobj,pobj,NNP-NNP,NNP,3,1
0,0.0,25,is,6,1,9,8,0,15,5,3,Night of the Pencils,1986,MISC-MISC-MISC-MISC,TIME,NOUN-ADP-DET-PROPN,NUM,nsubj-prep-det-pobj,nummod,NN-IN-DT-NNPS,CD,4,1
1,0.0,25,is,6,1,16,15,0,8,5,10,Night of the Pencils,Héctor Olivera,MISC-MISC-MISC-MISC,PER-PER,NOUN-ADP-DET-PROPN,PROPN-PROPN,nsubj-prep-det-pobj,compound-pobj,NN-IN-DT-NNPS,NNP-NNP,6,1
2,3.0,69,tells,27,21,21,0,20,47,6,-6,La noche de los lápices,La Plata,MISC-MISC-MISC-MISC-MISC,LOC-LOC,PROPN-NOUN-X-X-NOUN,PROPN-PROPN,compound-nmod-nmod-compound-appos,compound-pobj,NNP-NN-FW-FW-NNS,NNP-NNP,0,1
3,3.0,69,tells,27,21,56,35,20,12,6,29,La Plata,Argentina,LOC-LOC,LOC,PROPN-PROPN,PROPN,compound-pobj,poss,NNP-NNP,NNP,17,1
0,0.0,21,is,2,1,8,7,0,12,1,6,Cocalico Creek,Conestoga River,LOC-LOC,LOC-LOC,PROPN-PROPN,PROPN-PROPN,compound-nsubj,compound-pobj,NNP-NNP,NNP-NNP,4,1
1,0.0,21,is,2,1,16,15,0,4,1,14,Cocalico Creek,Pennsylvania,LOC-LOC,LOC,PROPN-PROPN,PROPN,compound-nsubj,pobj,NNP-NNP,NNP,3,1
2,0.0,21,is,2,1,7,6,0,13,1,5,Cocalico Creek,the United States,LOC-LOC,LOC-LOC-LOC,PROPN-PROPN,DET-PROPN-PROPN,compound-nsubj,det-compound-pobj,NNP-NNP,DT-NNP-NNP,5,1
3,0.0,21,is,2,8,16,8,7,4,-6,14,Conestoga River,Pennsylvania,LOC-LOC,LOC,PROPN-PROPN,PROPN,compound-pobj,pobj,NNP-NNP,NNP,3,1
4,0.0,21,is,2,8,7,-1,7,13,-6,5,Conestoga River,the United States,LOC-LOC,LOC-LOC-LOC,PROPN-PROPN,DET-PROPN-PROPN,compound-pobj,det-compound-pobj,NNP-NNP,DT-NNP-NNP,1,1
5,0.0,21,is,2,13,16,3,12,4,-11,14,Lancaster,Pennsylvania,LOC,LOC,PROPN,PROPN,conj,pobj,NNP,NNP,6,1
6,0.0,21,is,2,13,7,-6,12,13,-11,5,Lancaster,the United States,LOC,LOC-LOC-LOC,PROPN,DET-PROPN-PROPN,conj,det-compound-pobj,NNP,DT-NNP-NNP,4,1
7,0.0,21,is,2,16,7,-9,15,13,-14,5,Pennsylvania,the United States,LOC,LOC-LOC-LOC,PROPN,DET-PROPN-PROPN,pobj,det-compound-pobj,NNP,DT-NNP-NNP,4,1
0,0.0,26,was,11,1,4,3,0,21,10,-7,Joseph Charlier,20 June 1816,PER-PER,TIME-TIME-TIME,PROPN-PROPN,NUM-PROPN-NUM,compound-nsubj,nummod-appos-nummod,NNP-NNP,CD-NNP-CD,1,1
1,0.0,26,was,11,1,8,7,0,17,10,-3,Joseph Charlier,6 December 1896,PER-PER,TIME-TIME-TIME,PROPN-PROPN,NUM-PROPN-NUM,compound-nsubj,nummod-appos-nummod,NNP-NNP,CD-NNP-CD,1,1
2,0.0,26,was,11,1,14,13,0,11,10,3,Joseph Charlier,Belgian,PER-PER,LOC,PROPN-PROPN,ADJ,compound-nsubj,amod,NNP-NNP,JJ,4,1
3,1.0,36,was,1,22,29,7,21,6,-21,28,state bonus,Dennis Milner,MISC-MISC,PER-PER,NOUN-NOUN,PROPN-PROPN,nmod-nmod,compound-pobj,NN-NN,NNP-NNP,4,1
4,1.0,36,was,1,29,32,3,28,3,-28,31,Dennis Milner,1892–1956,PER-PER,TIME,PROPN-PROPN,NUM,compound-pobj,appos,NNP-NNP,CD,5,1
0,0.0,19,is,3,12,14,2,11,4,-9,11,Dungannon,County Tyrone,LOC,LOC-LOC,PROPN,PROPN-PROPN,pobj,compound-conj,NNP,NNP-NNP,2,1
1,0.0,19,is,3,14,17,3,13,1,-11,14,County Tyrone,Northern Ireland,LOC-LOC,LOC-LOC,PROPN-PROPN,PROPN-PROPN,compound-conj,compound-appos,NNP-NNP,NNP-NNP,1,1
2,4.0,49,has,1,21,25,4,20,23,-20,24,Portora Royal School,Enniskillen,ORG-ORG-ORG,LOC,PROPN-PROPN-PROPN,PROPN,compound-compound-conj,pobj,NNP-NNP-NNP,NNP,4,1
3,4.0,49,has,1,25,17,-8,24,31,-24,16,Enniskillen,County Fermanagh,LOC,LOC-LOC,PROPN,PROPN-PROPN,pobj,compound-conj,NNP,NNP-NNP,4,1
4,4.0,49,has,1,45,17,-28,44,31,-44,16,Raphoe,County Donegal,LOC,LOC-LOC,PROPN,PROPN-PROPN,pobj,compound-appos,NNP,NNP-NNP,7,1
0,8.0,14,are,5,8,13,5,7,0,-3,8,China,Asia,LOC,LOC,PROPN,PROPN,pobj,pobj,NNP,NNP,4,1
0,3.0,35,indicated,4,1,3,2,0,31,3,-1,SpaceX,Elon Musk,ORG,PER-PER,PROPN,PROPN-PROPN,compound,compound-nsubj,NNP,NNP-NNP,1,1
1,5.0,55,was,19,13,32,19,12,22,6,13,Boca Chica Beach,US,LOC-LOC-LOC,LOC,PROPN-PROPN-PROPN,PROPN,compound-compound-pobj,compound,NNP-NNP-NNP,NNP,11,1
0,0.0,34,is,11,27,33,6,26,0,-16,22,Tlaxcala,Mexico,LOC,LOC,PROPN,PROPN,nmod,pobj,NNP,NNP,6,1
1,2.0,41,makes,2,9,23,14,8,17,-7,21,Tlaxcala,Mexico,LOC,LOC,PROPN,PROPN,pobj,pobj,NNP,NNP,8,1
2,0.0,34,is,11,29,33,4,28,0,-18,22,Puebla,Mexico,LOC,LOC,PROPN,PROPN,conj,pobj,NNP,NNP,5,1
3,2.0,41,makes,2,16,23,7,15,17,-14,21,Puebla,Mexico,LOC,LOC,PROPN,PROPN,pobj,pobj,NNP,NNP,5,1
4,2.0,41,makes,2,16,30,14,15,10,-14,28,Puebla,North America,LOC,LOC-LOC,PROPN,PROPN-PROPN,pobj,compound-pobj,NNP,NNP-NNP,7,1
5,2.0,41,makes,2,23,30,7,22,10,-21,28,Mexico,North America,LOC,LOC-LOC,PROPN,PROPN-PROPN,pobj,compound-pobj,NNP,NNP-NNP,4,1
6,3.0,21,varies,5,20,12,-8,19,8,-15,7,Puebla,Villa Vicente Guerrero,LOC,LOC-LOC-LOC,PROPN,PROPN-PROPN-PROPN,pobj,compound-compound-pobj,NNP,NNP-NNP-NNP,4,1
0,0.0,20,is,2,11,11,0,10,8,-9,9,Mozilla Corporation,Mozilla,ORG-ORG,ORG,PROPN-PROPN,PROPN,compound-pobj,pobj,NNP-NNP,NNP,0,1
1,3.0,14,employed,3,1,6,5,0,7,2,3,Turner,Netscape,PER,ORG,PROPN,PROPN,nsubjpass,pobj,NNP,NNP,2,1
0,0.0,27,was,11,7,5,-2,6,21,4,-6,New Orleans,Louisiana,LOC-LOC,LOC,PROPN-PROPN,PROPN,compound-pobj,conj,NNP-NNP,NNP,1,1
1,0.0,27,was,11,7,25,18,6,1,4,14,New Orleans,United States,LOC-LOC,LOC-LOC,PROPN-PROPN,PROPN-PROPN,compound-pobj,compound-appos,NNP-NNP,NNP-NNP,10,1
2,0.0,27,was,11,5,25,20,4,1,6,14,Louisiana,United States,LOC,LOC-LOC,PROPN,PROPN-PROPN,conj,compound-appos,NNP,NNP-NNP,9,1
0,0.0,34,Healey,2,1,5,4,0,28,1,3,Dorothy Ray Healey,"September 22 , 1914",PER-PER-PER,TIME-TIME-TIME-TIME,PROPN-PROPN-PROPN,PROPN-NUM-PUNCT-NUM,compound-compound-ROOT,appos-nummod-punct-npadvmod,NNP-NNP-NNP,"NNP-CD-,-CD",3,1
1,0.0,34,Healey,2,1,10,9,0,23,1,8,Dorothy Ray Healey,"August 6 , 2006",PER-PER-PER,TIME-TIME-TIME-TIME,PROPN-PROPN-PROPN,PROPN-NUM-PUNCT-NUM,compound-compound-ROOT,nsubj-nummod-punct-nummod,NNP-NNP-NNP,"NNP-CD-,-CD",3,1
2,3.0,51,opponent,1,25,34,9,24,16,-24,33,Healey,New American Movement,PER,ORG-ORG-ORG,PROPN,PROPN-PROPN-PROPN,nsubj,compound-compound-dobj,NNP,NNP-NNP-NNP,4,1
3,3.0,51,opponent,1,25,45,20,24,5,-24,44,Healey,Democratic Socialists of America,PER,ORG-ORG-ORG-ORG,PROPN,ADJ-PROPN-ADP-PROPN,nsubj,compound-pobj-prep-pobj,NNP,JJ-NNPS-IN-NNP,8,1
4,3.0,51,opponent,1,5,10,5,4,40,-4,9,Soviet invasion of Czechoslovakia,1968,MISC-MISC-MISC-MISC,TIME,ADJ-NOUN-ADP-PROPN,NUM,amod-pobj-prep-pobj,pobj,JJ-NN-IN-NNP,CD,4,1
0,0.0,21,is,1,1,6,5,0,14,0,5,Dormont,Allegheny County,LOC,LOC-LOC,PROPN,PROPN-PROPN,nsubj,compound-pobj,NNP,NNP-NNP,3,1
1,0.0,21,is,1,9,11,2,8,9,-8,10,Pennsylvania,United States,LOC,LOC-LOC,PROPN,PROPN-PROPN,appos,compound-conj,NNP,NNP-NNP,2,1
0,0.0,25,was,12,1,5,4,0,19,11,-7,Odilon Marc Lannelongue,4 December 1840,PER-PER-PER,TIME-TIME-TIME,PROPN-PROPN-PROPN,NUM-PROPN-NUM,compound-compound-nsubj,nummod-appos-nummod,NNP-NNP-NNP,CD-NNP-CD,2,1
1,0.0,25,was,12,1,9,8,0,15,11,-3,Odilon Marc Lannelongue,22 December 1911,PER-PER-PER,TIME-TIME-TIME,PROPN-PROPN-PROPN,NUM-PROPN-NUM,compound-compound-nsubj,nummod-npadvmod-nummod,NNP-NNP-NNP,CD-NNP-CD,2,1
0,0.0,16,represents,7,2,15,13,1,0,5,8,Old Dominion University,Virginia,ORG-ORG-ORG,LOC,PROPN-PROPN-PROPN,PROPN,compound-compound-dobj,appos,NNP-NNP-NNP,NNP,4,1
1,2.0,27,contributed,7,2,10,8,1,16,5,3,ODU Monarchs,the United States,ORG-ORG,LOC-LOC-LOC,PROPN-PROPN,DET-PROPN-PROPN,compound-compound,det-compound-pobj,NNP-NNP,DT-NNP-NNP,6,1
0,0.0,28,was,13,1,4,3,0,23,12,-9,Lucien Gaillard,1861,PER-PER,TIME,PROPN-PROPN,NUM,compound-nsubj,nummod,NNP-NNP,CD,2,1
1,0.0,28,was,13,1,6,5,0,21,12,-7,Lucien Gaillard,1942,PER-PER,TIME,PROPN-PROPN,NUM,compound-nsubj,nummod,NNP-NNP,CD,1,1
2,0.0,28,was,13,1,10,9,0,17,12,-3,Lucien Gaillard,Paris,PER-PER,LOC,PROPN-PROPN,PROPN,compound-nsubj,pobj,NNP-NNP,NNP,4,1
3,0.0,28,was,13,1,12,11,0,15,12,-1,Lucien Gaillard,France,PER-PER,LOC,PROPN-PROPN,PROPN,compound-nsubj,appos,NNP-NNP,NNP,1,1
4,0.0,28,was,13,1,16,15,0,11,12,3,Lucien Gaillard,French,PER-PER,LOC,PROPN-PROPN,ADJ,compound-nsubj,amod,NNP-NNP,JJ,2,1
5,0.0,28,was,13,10,12,2,9,15,3,-1,Paris,France,LOC,LOC,PROPN,PROPN,pobj,appos,NNP,NNP,5,1
6,0.0,28,was,13,10,16,6,9,11,3,3,Paris,French,LOC,LOC,PROPN,ADJ,pobj,amod,NNP,JJ,6,1
0,0.0,37,is,9,1,6,5,0,30,8,-3,Ilkka Heikki Herlin,25 January 1959,PER-PER-PER,TIME-TIME-TIME,PROPN-PROPN-PROPN,NUM-PROPN-NUM,compound-compound-nsubj,nummod-npadvmod-nummod,NNP-NNP-NNP,CD-NNP-CD,3,1
1,0.0,37,is,9,1,12,11,0,24,8,3,Ilkka Heikki Herlin,Finnish,PER-PER-PER,LOC,PROPN-PROPN-PROPN,ADJ,compound-compound-nsubj,amod,NNP-NNP-NNP,JJ,3,1
2,1.0,37,died,4,3,7,4,2,29,1,3,Pekka Herlin,2003,PER-PER,TIME,PROPN-PROPN,NUM,compound-appos,pobj,NNP-NNP,CD,3,1
3,1.0,37,died,4,3,35,32,2,1,1,31,Pekka Herlin,Antti Herlin,PER-PER,PER-PER,PROPN-PROPN,PROPN-PROPN,compound-appos,compound-appos,NNP-NNP,NNP-NNP,8,1
4,6.0,15,is,1,12,14,2,11,0,-11,13,Helsinki,Finland,LOC,LOC,PROPN,PROPN,pobj,appos,NNP,NNP,6,1
0,0.0,25,was,18,1,6,5,0,18,17,-12,Joseph Arnaud Charles Gaillardot,20 September 1814,PER-PER-PER-PER,TIME-TIME-TIME,PROPN-PROPN-PROPN-PROPN,NUM-PROPN-NUM,compound-compound-compound-nsubj,nummod-appos-nummod,NNP-NNP-NNP-NNP,CD-NNP-CD,2,1
1,0.0,25,was,18,1,11,10,0,13,17,-7,Joseph Arnaud Charles Gaillardot,Lunéville,PER-PER-PER-PER,LOC,PROPN-PROPN-PROPN-PROPN,PROPN,compound-compound-compound-nsubj,compound,NNP-NNP-NNP-NNP,NNP,2,1
2,0.0,25,was,18,1,13,12,0,11,17,-5,Joseph Arnaud Charles Gaillardot,August 1883,PER-PER-PER-PER,TIME-TIME,PROPN-PROPN-PROPN-PROPN,PROPN-NUM,compound-compound-compound-nsubj,pobj-nummod,NNP-NNP-NNP-NNP,NNP-CD,3,1
3,0.0,25,was,18,1,17,16,0,7,17,-1,Joseph Arnaud Charles Gaillardot,Bhamdoun,PER-PER-PER-PER,LOC,PROPN-PROPN-PROPN-PROPN,PROPN,compound-compound-compound-nsubj,pobj,NNP-NNP-NNP-NNP,NNP,2,1
0,0.0,28,is,1,1,20,19,0,7,0,19,Middletown,Ohio,LOC,LOC,PROPN,PROPN,nsubj,pobj,NNP,NNP,2,1
1,4.0,45,was,2,44,32,-12,43,12,-42,30,Middletown,Ohio,LOC,LOC,PROPN,PROPN,pobj,appos,NNP,NNP,5,1
2,0.0,28,is,1,7,17,10,6,10,-6,16,Butler,U.S.,LOC,LOC,PROPN,PROPN,nmod,compound,NNP,NNP,8,1
3,0.0,28,is,1,7,20,13,6,7,-6,19,Butler,Ohio,LOC,LOC,PROPN,PROPN,nmod,pobj,NNP,NNP,6,1
4,0.0,28,is,1,9,17,8,8,10,-8,16,Warren,U.S.,LOC,LOC,PROPN,PROPN,conj,compound,NNP,NNP,6,1
5,0.0,28,is,1,9,20,11,8,7,-8,19,Warren,Ohio,LOC,LOC,PROPN,PROPN,conj,pobj,NNP,NNP,4,1
6,0.0,28,is,1,17,20,3,16,7,-16,19,U.S.,Ohio,LOC,LOC,PROPN,PROPN,compound,pobj,NNP,NNP,6,1
0,0.0,14,is,9,1,6,5,0,7,8,-3,Pierre Emile Cartier,10 June 1932,PER-PER-PER,TIME-TIME-TIME,PROPN-PROPN-PROPN,NUM-PROPN-NUM,compound-compound-nsubj,nummod-npadvmod-nummod,NNP-NNP-NNP,CD-NNP-CD,3,1
1,0.0,14,is,9,1,12,11,0,1,8,3,Pierre Emile Cartier,French,PER-PER-PER,LOC,PROPN-PROPN-PROPN,ADJ,compound-compound-nsubj,amod,NNP-NNP-NNP,JJ,3,1
2,2.0,16,studied,1,5,9,4,4,6,-4,8,École Normale Supérieure,Paris,ORG-ORG-ORG,LOC,PROPN-PROPN-PROPN,PROPN,compound-compound-pobj,pobj,NNP-NNP-NNP,NNP,4,1
0,2.0,25,made,1,11,14,3,10,10,-10,13,Dehraadun Diary,2013,MISC-MISC,TIME,PROPN-PROPN,NUM,compound-appos,appos,NNP-NNP,CD,1,1
1,3.0,25,made,1,15,22,7,14,2,-14,21,Thalaivaa,A. L. Vijay,MISC,PER-PER-PER,PROPN,PROPN-PROPN-PROPN,appos,compound-compound-pobj,NNP,NNP-NNP-NNP,9,1
2,3.0,25,made,1,15,17,2,14,7,-14,16,Thalaivaa,2013,MISC,TIME,PROPN,NUM,appos,npadvmod,NNP,CD,2,1
3,3.0,25,made,1,15,7,-8,14,17,-14,6,Thalaivaa,Tamil,MISC,MISC,PROPN,PROPN,appos,compound,NNP,NNP,4,1
4,7.0,20,done,2,7,19,12,6,0,-5,17,Peruchazhi,Mohanlal,MISC,PER,PROPN,PROPN,dobj,pobj,NNP,NNP,3,1
0,0.0,36,is,13,24,27,3,23,8,-11,14,U.S.,Missouri,LOC,LOC,PROPN,PROPN,compound,poss,NNP,NNP,4,1
1,3.0,9,is,1,1,7,6,0,1,0,6,Wagner,Republican Party,PER,ORG-ORG,NOUN,PROPN-PROPN,nsubj,compound-pobj,NN,NNP-NNP,3,1
2,5.0,36,was,7,7,12,5,6,23,0,5,Wagner,Missouri Republican Party,PER,ORG-ORG-ORG,PROPN,PROPN-PROPN-PROPN,nsubj,compound-compound-pobj,NNP,NNP-NNP-NNP,4,1
0,0.0,12,is,2,1,1,0,0,10,1,-1,Yale College,Yale University,ORG-ORG,ORG-ORG,PROPN-PROPN,PROPN-PROPN,compound-nsubj,compound-pobj,NNP-NNP,NNP-NNP,0,1
1,2.0,38,known,18,16,16,0,15,21,2,-2,Yale College,Yale University,ORG-ORG,ORG-ORG,PROPN-PROPN,PROPN-PROPN,compound-pobj,compound-oprd,NNP-NNP,NNP-NNP,0,1
0,3.0,23,is,5,2,17,15,1,5,3,12,Calgary – Edmonton Corridor,Canada,LOC-LOC-LOC-LOC,LOC,PROPN-PUNCT-PROPN-PROPN,PROPN,compound-compound-compound-nsubj,poss,NNP-HYPH-NNP-NNP,NNP,7,1
0,0.0,23,is,14,1,6,5,0,16,13,-8,James Joseph Webster,14 June 1925,PER-PER-PER,TIME-TIME-TIME,PROPN-PROPN-PROPN,NUM-PROPN-NUM,compound-compound-nsubj,nummod-npadvmod-nummod,NNP-NNP-NNP,CD-NNP-CD,3,1
1,0.0,23,is,14,1,10,9,0,12,13,-4,James Joseph Webster,Flinders Island,PER-PER-PER,LOC-LOC,PROPN-PROPN-PROPN,PROPN-PROPN,compound-compound-nsubj,compound-pobj,NNP-NNP-NNP,NNP-NNP,4,1
2,0.0,23,is,14,10,13,3,9,9,4,-1,Flinders Island,Tasmania,LOC-LOC,LOC,PROPN-PROPN,PROPN,compound-pobj,npadvmod,NNP-NNP,NNP,1,1
3,3.0,30,appointed,2,1,12,11,0,17,1,10,Webster,Country Party,PER,ORG-ORG,PROPN,PROPN-PROPN,nsubjpass,compound-pobj,NNP,NNP-NNP,5,1
0,1.0,24,was,1,8,22,14,7,1,-7,21,Maria Theresa,Marie Antoinette,PER-PER,PER-PER,PROPN-PROPN,PROPN-PROPN,compound-pobj,compound-pobj,NNP-NNP,NNP-NNP,5,1
0,4.0,34,known,3,9,14,5,8,19,-6,11,Chris Griffin,Family Guy,PER-PER,MISC-MISC,PROPN-PROPN,PROPN-PROPN,compound-pobj,compound-pobj,NNP-NNP,NNP-NNP,2,1
0,0.0,20,is,2,1,16,15,0,3,1,14,Kamehameha Highway,U.S.,LOC-LOC,LOC,PROPN-PROPN,PROPN,compound-nsubj,compound,NNP-NNP,NNP,7,1
1,0.0,20,is,2,1,19,18,0,0,1,17,Kamehameha Highway,Hawaii,LOC-LOC,LOC,PROPN-PROPN,PROPN,compound-nsubj,pobj,NNP-NNP,NNP,2,1
2,0.0,20,is,2,13,16,3,12,3,-11,14,O‘ahu,U.S.,LOC,LOC,ADV,PROPN,dobj,compound,WRB,NNP,1,1
3,0.0,20,is,2,13,19,6,12,0,-11,17,O‘ahu,Hawaii,LOC,LOC,ADV,PROPN,dobj,pobj,WRB,NNP,6,1
4,0.0,20,is,2,16,19,3,15,0,-14,17,U.S.,Hawaii,LOC,LOC,PROPN,PROPN,compound,pobj,NNP,NNP,7,1
0,0.0,33,Mediaș,7,24,31,7,23,1,-17,24,Romania,Eastern Europe,LOC,LOC-LOC,PROPN,PROPN-PROPN,pobj,compound-pobj,NNP,NNP-NNP,6,1
1,5.0,50,structured,2,47,49,2,46,0,-45,47,Bratislava,Slovakia,LOC,LOC,PROPN,PROPN,pobj,appos,NNP,NNP,9,1
0,5.0,29,listed,4,21,27,6,20,1,-17,23,Kelley Earnhardt Elledge,Kerry Earnhardt,PER-PER-PER,PER-PER,PROPN-PROPN-PROPN,PROPN-PROPN,compound-compound-appos,compound-appos,NNP-NNP-NNP,NNP-NNP,3,1
0,1.0,20,lost,11,7,9,2,6,10,4,-2,China,Macao,LOC,LOC,PROPN,PROPN,pobj,pobj,NNP,NNP,3,1
1,4.0,29,is,1,1,8,7,0,20,0,7,Lee,Democratic Progressive Party,PER,ORG-ORG-ORG,PROPN,PROPN-PROPN-PROPN,nsubj,compound-compound-pobj,NNP,NNP-NNP-NNP,4,1
0,0.0,17,is,12,1,5,4,0,11,11,-7,Paweł Szymański,28 March 1954,PER-PER,TIME-TIME-TIME,PROPN-PROPN,NUM-PROPN-NUM,compound-nsubj,nummod-npadvmod-nummod,NNP-NNP,CD-NNP-CD,2,1
1,0.0,17,is,12,1,9,8,0,7,11,-3,Paweł Szymański,Warsaw,PER-PER,LOC,PROPN-PROPN,PROPN,compound-nsubj,pobj,NNP-NNP,NNP,4,1
2,1.0,20,studied,14,14,8,-6,13,11,0,-6,Szymański,Fryderyk Chopin University of Music,PER,ORG-ORG-ORG-ORG-ORG,PROPN,PROPN-PROPN-PROPN-ADP-PROPN,nsubj,compound-compound-dobj-prep-pobj,NNP,NNP-NNP-NNP-IN-NNP,5,1
0,0.0,33,is,4,2,28,26,1,4,2,24,Bellmawr School District,New Jersey,LOC-LOC-LOC,LOC-LOC,PROPN-PROPN-PROPN,PROPN-PROPN,compound-compound-nsubj,compound-conj,NNP-NNP-NNP,NNP-NNP,7,1
1,0.0,33,is,4,2,31,29,1,1,2,27,Bellmawr School District,United States,LOC-LOC-LOC,LOC-LOC,PROPN-PROPN-PROPN,PROPN-PROPN,compound-compound-nsubj,compound-appos,NNP-NNP-NNP,NNP-NNP,7,1
2,0.0,33,is,4,2,25,23,1,7,2,21,Bellmawr,Camden County,LOC,LOC-LOC,PROPN,PROPN-PROPN,pobj,compound-pobj,NNP,NNP-NNP,6,1
3,0.0,33,is,4,2,31,29,1,1,2,27,Bellmawr,United States,LOC,LOC-LOC,PROPN,PROPN-PROPN,pobj,compound-appos,NNP,NNP-NNP,7,1
4,0.0,33,is,4,25,28,3,24,4,-21,24,Camden County,New Jersey,LOC-LOC,LOC-LOC,PROPN-PROPN,PROPN-PROPN,compound-pobj,compound-conj,NNP-NNP,NNP-NNP,1,1
5,0.0,33,is,4,25,31,6,24,1,-21,27,Camden County,United States,LOC-LOC,LOC-LOC,PROPN-PROPN,PROPN-PROPN,compound-pobj,compound-appos,NNP-NNP,NNP-NNP,1,1
6,0.0,33,is,4,28,31,3,27,1,-24,27,New Jersey,United States,LOC-LOC,LOC-LOC,PROPN-PROPN,PROPN-PROPN,compound-conj,compound-appos,NNP-NNP,NNP-NNP,2,1
0,0.0,17,was,12,1,5,4,0,11,11,-7,Aung Zan Wai,19 November 1893,PER-PER-PER,TIME-TIME-TIME,PROPN-PROPN-PROPN,NUM-PROPN-NUM,compound-compound-nsubj,nummod-npadvmod-nummod,NNP-NNP-NNP,CD-NNP-CD,2,1
1,2.0,51,were,25,35,50,15,34,0,-10,25,Panglong Conference,1947,ORG-ORG,TIME,PROPN-PROPN,NUM,compound-pobj,pobj,NNP-NNP,CD,4,1
2,2.0,51,were,25,35,39,4,34,11,-10,14,Panglong Conference,Burma,ORG-ORG,LOC,PROPN-PROPN,PROPN,compound-pobj,nmod,NNP-NNP,NNP,7,1
0,5.0,20,was,2,1,9,8,0,10,1,7,Pitch Black,PolyGram Filmed Entertainment,MISC-MISC,ORG-ORG-ORG,PROPN-PROPN,PROPN-PROPN-PROPN,compound-nsubj,compound-compound-pobj,NNP-NNP,NNP-NNP-NNP,5,1
1,8.0,30,released,9,4,12,8,3,17,5,3,The Chronicles of Riddick,2004,MISC-MISC-MISC-MISC,TIME,DET-PROPN-ADP-PROPN,NUM,det-appos-prep-pobj,pobj,DT-NNPS-IN-NNP,CD,3,1
2,8.0,30,released,9,4,24,20,3,5,5,15,The Chronicles of Riddick,Twohy,MISC-MISC-MISC-MISC,PER,DET-PROPN-ADP-PROPN,PROPN,det-appos-prep-pobj,conj,DT-NNPS-IN-NNP,NNP,8,1
3,8.0,30,released,9,4,17,13,3,12,5,8,The Chronicles of Riddick,Diesel,MISC-MISC-MISC-MISC,PER,DET-PROPN-ADP-PROPN,PROPN,det-appos-prep-pobj,nsubj,DT-NNPS-IN-NNP,NNP,5,1
4,9.0,20,released,9,7,12,5,6,7,2,3,Riddick,2013,MISC,TIME,PROPN,NUM,oprd,pobj,NNP,CD,2,1
0,0.0,10,is,2,1,9,8,0,0,1,7,Pycnarmon alboflavalis,Crambidae,MISC-MISC,MISC,PROPN-VERB,PROPN,compound-nsubj,pobj,NNP-VBZ,NNP,2,1
1,2.0,18,found,2,5,7,2,4,10,-3,5,India,Darjeeling,LOC,LOC,PROPN,PROPN,pobj,appos,NNP,NNP,2,1
2,2.0,18,found,2,5,9,4,4,8,-3,7,India,Sikkim,LOC,LOC,PROPN,PROPN,pobj,conj,NNP,NNP,3,1
3,2.0,18,found,2,5,11,6,4,6,-3,9,India,Andamans,LOC,LOC,PROPN,PROPN,pobj,conj,NNP,NNPS,4,1
4,2.0,18,found,2,5,13,8,4,4,-3,11,India,Arunachal Pradesh,LOC,LOC-LOC,PROPN,PROPN-PROPN,pobj,compound-conj,NNP,NNP-NNP,4,1
0,0.0,15,is,3,11,13,2,10,1,-8,10,Antigonish,Nova Scotia,LOC,LOC-LOC,PROPN,PROPN-PROPN,amod,compound-pobj,NNP,NNP-NNP,2,1
1,3.0,11,Mine,3,1,1,0,0,9,2,-2,Stellarton Surface Coal Mine,Stellarton,LOC-LOC-LOC-LOC,LOC,PROPN-PROPN-PROPN-PROPN,PROPN,compound-compound-compound-ROOT,pobj,NNP-NNP-NNP-NNP,NNP,0,1
2,4.0,13,Mine,4,1,12,11,0,0,3,8,Point Aconi Surface Coal Mine,Nova Scotia,LOC-LOC-LOC-LOC-LOC,LOC-LOC,NOUN-PROPN-PROPN-PROPN-PROPN,PROPN-PROPN,compound-compound-compound-compound-ROOT,compound-npadvmod,NN-NNP-NNP-NNP-NNP,NNP-NNP,4,1
3,4.0,13,Mine,4,1,12,11,0,0,3,8,Point Aconi,Nova Scotia,LOC-LOC,LOC-LOC,PROPN-PROPN,PROPN-PROPN,compound-pobj,compound-npadvmod,NNP-NNP,NNP-NNP,4,1
0,0.0,20,is,2,2,12,10,1,7,0,10,Curoca,Angola,LOC,LOC,PROPN,PROPN,nsubj,appos,NNP,NNP,4,1
1,0.0,20,is,2,8,12,4,7,7,-6,10,Namibe Province,Angola,LOC-LOC,LOC,PROPN-PROPN,PROPN,compound-pobj,appos,NNP-NNP,NNP,7,1
0,0.0,23,formed,7,2,18,16,1,4,5,11,parks and gardens in Bratislava,Slovakia,LOC-LOC-LOC-LOC-LOC,LOC,NOUN-CCONJ-NOUN-ADP-PROPN,PROPN,nsubj-cc-conj-prep-pobj,pobj,NNS-CC-NNS-IN-NNP,NNP,3,1
0,2.0,66,include,3,58,64,6,57,1,-55,61,The Cowboy Rides Away,George Strait,MISC-MISC-MISC-MISC,PER-PER,DET-NOUN-VERB-ADV,PROPN-PROPN,det-compound-ROOT-advmod,compound-pobj,DT-NN-VBZ-RB,NNP-NNP,3,1
0,0.0,22,was,8,1,5,4,0,16,7,-3,Carlo Giuseppe Ratti,1737,PER-PER-PER,TIME,PROPN-PROPN-PROPN,NUM,compound-compound-nsubj,nummod,NNP-NNP-NNP,CD,2,1
1,0.0,22,was,8,1,7,6,0,14,7,-1,Carlo Giuseppe Ratti,1795,PER-PER-PER,TIME,PROPN-PROPN-PROPN,NUM,compound-compound-nsubj,appos,NNP-NNP-NNP,CD,2,1
0,1.0,20,is,8,8,14,6,7,5,0,6,Zuckerman,University of California,PER,ORG-ORG-ORG,PROPN,PROPN-ADP-PROPN,nsubj,pobj-prep-pobj,NNP,NNP-IN-NNP,4,1
0,0.0,14,was,2,2,10,8,1,3,0,8,Bidet,France,MISC,LOC,PROPN,PROPN,nsubj,pobj,NNP,NNP,2,1
0,0.0,25,is,5,2,17,15,1,7,3,12,Test for Echo,Rush,MISC-MISC-MISC,ORG,NOUN-ADP-PROPN,PROPN,nsubj-prep-pobj,poss,NN-IN-NNP,NNP,7,1
1,0.0,25,is,5,2,24,22,1,0,3,19,Test for Echo,1996,MISC-MISC-MISC,TIME,NOUN-ADP-PROPN,NUM,nsubj-prep-pobj,pobj,NN-IN-NNP,CD,3,1
2,4.0,45,was,1,22,27,5,21,17,-21,26,Stick It Out,Counterparts,MISC-MISC-MISC,MISC,PROPN-PRON-PART,PROPN,compound-pobj-advmod,pobj,NNP-PRP-RP,NNPS,6,1
3,4.0,45,was,1,39,42,3,38,2,-38,41,Dreamline,Roll the Bones,MISC,MISC-MISC-MISC,PROPN,PROPN-DET-PROPN,conj,pobj-det-appos,NNP,NNP-DT-NNPS,8,1
0,0.0,21,is,7,1,19,18,0,1,6,12,La Conexión,Nina Sky,MISC-MISC,ORG-ORG,PROPN-PROPN,PROPN-PROPN,compound-nsubj,compound-pobj,NNP-NNP,NNP-NNP,5,1
1,7.0,30,failed,2,1,21,20,0,8,1,19,La Conexión,Nina Sky,MISC-MISC,PER-PER,PROPN-PROPN,PROPN-PROPN,compound-nsubj,compound-dobj,NNP-NNP,NNP-NNP,-1,1
0,3.0,45,destroyed,4,12,16,4,11,28,-8,12,Sack of Constantinople,1204,MISC-MISC-MISC,TIME,PROPN-ADP-PROPN,NUM,pobj-prep-pobj,pobj,NNP-IN-NNP,CD,4,1
1,3.0,45,destroyed,4,12,21,9,11,23,-8,17,Sack of Constantinople,Fourth Crusade,MISC-MISC-MISC,MISC-MISC,PROPN-ADP-PROPN,PROPN-PROPN,pobj-prep-pobj,compound-pobj,NNP-IN-NNP,NNP-NNP,6,1
0,0.0,40,was,18,1,12,11,0,27,17,-6,Laura Margaret Attrux,Duck Lake,PER-PER-PER,LOC-LOC,PROPN-PROPN-PROPN,PROPN-PROPN,compound-compound-nsubj,compound-pobj,NNP-NNP-NNP,NNP-NNP,3,1
1,0.0,40,was,18,1,17,16,0,22,17,-1,Laura Margaret Attrux,Canada,PER-PER-PER,LOC,PROPN-PROPN-PROPN,PROPN,compound-compound-nsubj,appos,NNP-NNP-NNP,NNP,3,1
2,0.0,40,was,18,1,32,31,0,7,17,14,Laura Margaret Attrux,University of Alberta,PER-PER-PER,ORG-ORG-ORG,PROPN-PROPN-PROPN,PROPN-ADP-PROPN,compound-compound-nsubj,pobj-prep-pobj,NNP-NNP-NNP,NNP-IN-NNP,7,1
3,0.0,40,was,18,12,17,5,11,22,6,-1,Duck Lake,Canada,LOC-LOC,LOC,PROPN-PROPN,PROPN,compound-pobj,appos,NNP-NNP,NNP,4,1
4,0.0,40,was,18,15,17,2,14,22,3,-1,Saskatchewan,Canada,LOC,LOC,PROPN,PROPN,conj,appos,NNP,NNP,6,1
0,7.0,33,is,5,7,11,4,6,21,-2,6,Edi Rama,Socialist Party,PER-PER,ORG-ORG,PROPN-PROPN,PROPN-PROPN,compound-attr,compound-pobj,NNP-NNP,NNP-NNP,2,1
0,1.0,64,mounted,24,23,40,17,22,23,1,16,Sorensen,European Championships,PER,MISC-MISC,PROPN,PROPN-PROPN,nsubj,compound-pobj,NNP,NNP-NNPS,7,1
1,3.0,49,Sorensen,0,1,30,29,0,18,-1,30,Sorensen,UCI World Championships,PER,MISC-MISC-MISC,PROPN,PROPN-PROPN-PROPN,ROOT,compound-compound-pobj,NNP,NNP-NNP-NNPS,7,1
2,3.0,49,Sorensen,0,14,18,4,13,30,-14,18,2008 Summer Olympics,Beijing,MISC-MISC-MISC,LOC,NUM-PROPN-PROPN,PROPN,nummod-compound-pobj,pobj,CD-NNP-NNPS,NNP,7,1
3,3.0,49,Sorensen,0,30,48,18,29,0,-30,48,UCI World Championships,Canada,MISC-MISC-MISC,LOC,PROPN-PROPN-PROPN,PROPN,compound-compound-pobj,appos,NNP-NNP-NNPS,NNP,7,1
4,3.0,49,Sorensen,0,45,48,3,44,0,-45,48,British Columbia,Canada,LOC-LOC,LOC,PROPN-PROPN,PROPN,compound-appos,appos,NNP-NNP,NNP,11,1
0,0.0,22,was,11,1,4,3,0,17,10,-7,Giacomo Bulgarelli,24 October 1940,PER-PER,TIME-TIME-TIME,PROPN-PROPN,NUM-PROPN-NUM,compound-nsubj,nummod-appos-nummod,NNP-NNP,CD-NNP-CD,1,1
1,0.0,22,was,11,1,8,7,0,13,10,-3,Giacomo Bulgarelli,12 February 2009,PER-PER,TIME-TIME-TIME,PROPN-PROPN,NUM-PROPN-NUM,compound-nsubj,nummod-appos-nummod,NNP-NNP,CD-NNP-CD,2,1
2,1.0,67,is,39,11,59,48,10,7,28,20,Bulgarelli,Bolognese,PER,LOC,PROPN,ADJ,nsubj,amod,NNP,JJ,5,1
3,2.0,32,had,5,14,11,-3,13,20,-9,6,Hartford Bicentennials,America,ORG-ORG,LOC,PROPN-PROPN,PROPN,compound-pobj,pobj,NNP-NNPS,NNP,1,1
0,0.0,21,is,8,1,5,4,0,15,7,-3,Christiane Mercelis,5 October 1931,PER-PER,TIME-TIME-TIME,PROPN-PROPN,NUM-PROPN-NUM,compound-nsubj,nummod-npadvmod-nummod,NNP-NNP,CD-NNP-CD,2,1
1,4.0,33,played,1,1,7,6,0,25,0,6,Mercelis,Federation Cup,PER,MISC-MISC,PROPN,PROPN-PROPN,nsubj,compound-pobj,NNP,NNP-NNP,2,1
0,0.0,26,is,3,2,16,14,1,9,1,13,Moneytalks,Bruce Fairbairn,MISC,PER-PER,PROPN,PROPN-PROPN,nsubj,compound-pobj,NNP,NNP-NNP,7,1
0,0.0,34,O'Nan,2,1,10,9,0,23,1,8,Michael Ernest O'Nan,Fort Knox,PER-PER-PER,LOC-LOC,PROPN-PROPN-PROPN,PROPN-PROPN,compound-compound-ROOT,compound-npadvmod,NNP-NNP-NNP,NNP-NNP,2,1
1,0.0,34,O'Nan,2,1,15,14,0,18,1,13,Michael Ernest O'Nan,"July 31 , 2017",PER-PER-PER,TIME-TIME-TIME-TIME,PROPN-PROPN-PROPN,PROPN-NUM-PUNCT-NUM,compound-compound-ROOT,nsubj-nummod-punct-nummod,NNP-NNP-NNP,"NNP-CD-,-CD",3,1
2,0.0,34,O'Nan,2,1,27,26,0,6,1,25,Michael Ernest O'Nan,American,PER-PER-PER,LOC,PROPN-PROPN-PROPN,ADJ,compound-compound-ROOT,amod,NNP-NNP-NNP,JJ,3,1
3,0.0,34,O'Nan,2,10,13,3,9,20,-8,11,Fort Knox,Kentucky,LOC-LOC,LOC,PROPN-PROPN,PROPN,compound-npadvmod,compound,NNP-NNP,NNP,2,1
4,0.0,34,O'Nan,2,10,27,17,9,6,-8,25,Fort Knox,American,LOC-LOC,LOC,PROPN-PROPN,ADJ,compound-npadvmod,amod,NNP-NNP,JJ,3,1
5,0.0,34,O'Nan,2,20,27,7,19,6,-18,25,Princeton,American,LOC,LOC,PROPN,ADJ,appos,amod,NNP,JJ,4,1
0,0.0,23,is,4,1,8,7,0,14,3,4,Tera Mera Ki Rishta,Indian,MISC-MISC-MISC-MISC,LOC,PROPN-PROPN-PROPN-PROPN,PROPN,compound-compound-compound-nsubj,amod,NNP-NNP-NNP-NNP,NNP,6,1
1,0.0,23,is,4,1,16,15,0,6,3,12,Tera Mera Ki Rishta,Navaniat Singh,MISC-MISC-MISC-MISC,PER-PER,PROPN-PROPN-PROPN-PROPN,PROPN-PROPN,compound-compound-compound-nsubj,compound-pobj,NNP-NNP-NNP-NNP,NNP-NNP,7,1
2,0.0,23,is,4,1,21,20,0,1,3,17,Tera Mera Ki Rishta,Mukesh Sharma,MISC-MISC-MISC-MISC,PER-PER,PROPN-PROPN-PROPN-PROPN,PROPN-PROPN,compound-compound-compound-nsubj,compound-pobj,NNP-NNP-NNP-NNP,NNP-NNP,8,1
0,3.0,22,appear,2,9,14,5,8,7,-7,12,Angoulême International Comics Festival,France,MISC-MISC-MISC-MISC,LOC,PROPN-PROPN-PROPN-PROPN,PROPN,compound-compound-compound-pobj,pobj,NNP-NNP-NNP-NNP,NNP,3,1
1,5.0,34,participated,27,8,14,6,7,19,19,-13,Anke Feuchtenberger,Germany,PER-PER,LOC,PROPN-PROPN,PROPN,compound-pobj,appos,NNP-NNP,NNP,2,1
2,5.0,34,participated,27,11,14,3,10,19,16,-13,Henning Wagenbreth,Germany,PER-PER,LOC,PROPN-PROPN,PROPN,compound-conj,appos,NNP-NNP,NNP,1,1
3,5.0,34,participated,27,23,26,3,22,7,4,-1,David Polonsky,Israel,PER-PER,LOC,PROPN-PROPN,PROPN,compound-conj,appos,NNP-NNP,NNP,1,1
0,0.0,16,is,7,1,6,5,0,9,6,-1,Laura Alicia Brown,1970,PER-PER-PER,TIME,PROPN-PROPN-PROPN,NUM,compound-compound-nsubj,npadvmod,NNP-NNP-NNP,CD,3,1
1,0.0,16,is,7,1,11,10,0,4,6,4,Laura Alicia Brown,American,PER-PER-PER,LOC,PROPN-PROPN-PROPN,ADJ,compound-compound-nsubj,amod,NNP-NNP-NNP,JJ,4,1
2,3.0,44,received,1,1,9,8,0,34,0,8,Brown,University of Florida,PER,ORG-ORG-ORG,PROPN,PROPN-ADP-PROPN,nsubj,dobj-prep-pobj,NNP,NNP-IN-NNP,3,1
0,0.0,13,is,1,1,12,11,0,0,0,11,Trandumskogen,Norway,LOC,LOC,PROPN,PROPN,nsubj,appos,NNP,NNP,1,1
1,0.0,13,is,1,7,9,2,6,3,-6,8,Ullensaker,Akershus county,LOC,LOC-LOC,PROPN,PROPN-NOUN,pobj,compound-conj,NNP,NNP-NN,2,1
2,0.0,13,is,1,7,12,5,6,0,-6,11,Ullensaker,Norway,LOC,LOC,PROPN,PROPN,pobj,appos,NNP,NNP,6,1
0,0.0,19,is,2,1,12,11,0,6,1,10,Ladies Night,Atomic Kitten,MISC-MISC,ORG-ORG,PROPN-PROPN,PROPN-PROPN,compound-nsubj,compound-pobj,NNP-NNP,NNP-NNP,4,1
1,0.0,19,is,2,1,16,15,0,2,1,14,Ladies Night,10 November 2003,MISC-MISC,TIME-TIME-TIME,PROPN-PROPN,NUM-PROPN-NUM,compound-nsubj,nummod-pobj-nummod,NNP-NNP,CD-NNP-CD,5,1
2,2.0,46,released,11,7,14,7,6,31,4,3,Someone like Me,29 March 2004,MISC-MISC-MISC,TIME-TIME-TIME,NOUN-ADP-PRON,NUM-PROPN-NUM,nsubjpass-prep-pobj,nummod-pobj-nummod,NN-IN-PRP,CD-NNP-CD,4,1
3,3.0,55,featured,6,49,53,4,48,1,-43,47,Feels So Good,2002,MISC-MISC-MISC,TIME,VERB-ADV-ADJ,NUM,ROOT-advmod-ROOT,npadvmod,VBZ-RB-JJ,CD,2,1
0,6.0,35,nominated,3,18,18,0,17,16,-15,15,Best R&B ; Song,Best Female R&B,MISC-MISC-MISC-MISC,MISC-MISC-MISC,ADJ-NOUN-PUNCT-PROPN,PROPN-PROPN-NOUN,amod-dobj-punct-appos,compound-compound-conj,JJS-NN-:-NNP,NNP-NNP-NN,0,1
0,0.0,34,was,4,1,7,6,0,26,3,3,Dixon of Dock Green,BBC,MISC-MISC-MISC-MISC,ORG,PROPN-ADP-PROPN-PROPN,PROPN,nsubj-prep-compound-pobj,compound,NNP-IN-NNP-NNP,NNP,4,1
1,0.0,34,was,4,1,15,14,0,18,3,11,Dixon of Dock Green,London,MISC-MISC-MISC-MISC,LOC,PROPN-ADP-PROPN-PROPN,PROPN,nsubj-prep-compound-pobj,compound,NNP-IN-NNP-NNP,NNP,6,1
0,0.0,17,is,5,2,14,12,1,2,3,9,Wild Wadi Water Park,United Arab Emirates,LOC-LOC-LOC-LOC,LOC-LOC-LOC,PROPN-PROPN-PROPN-PROPN,PROPN-PROPN-PROPN,compound-compound-compound-nsubj,compound-compound-appos,NNP-NNP-NNP-NNP,NNP-NNP-NNPS,5,1
1,0.0,17,is,5,12,14,2,11,2,-7,9,Dubai,United Arab Emirates,LOC,LOC-LOC-LOC,PROPN,PROPN-PROPN-PROPN,pobj,compound-compound-appos,NNP,NNP-NNP-NNPS,3,1
2,1.0,34,operated,23,6,6,0,5,27,17,-17,Jumeirah Beach Hotel,Jumeirah International,LOC-LOC-LOC,ORG-ORG,PROPN-PROPN-PROPN,PROPN-PROPN,compound-compound-conj,compound-pobj,NNP-NNP-NNP,NNP-NNP,0,1
0,0.0,33,"""",0,2,21,19,1,11,-2,21,Father 's Day,Doctor Who,MISC-MISC-MISC,MISC-MISC,PROPN-PART-NOUN,PROPN-PRON,poss-case-nsubj,compound-nsubj,NNP-POS-NN,NNP-WP,-1,1
1,0.0,33,"""",0,21,27,6,20,5,-21,27,Doctor Who,14 May 2005,MISC-MISC,TIME-TIME-TIME,PROPN-PRON,NUM-PROPN-NUM,compound-nsubj,nummod-pobj-nummod,NNP-WP,CD-NNP-CD,3,1
2,2.0,39,agrees,13,31,33,2,30,5,-18,20,Pete,Shaun Dingwall,PER,PER-PER,PROPN,PROPN-PROPN,appos,compound-appos,NNP,NNP-NNP,1,1
3,2.0,39,agrees,13,33,38,5,32,0,-20,25,Shaun Dingwall,1987,PER-PER,TIME,PROPN-PROPN,NUM,compound-appos,pobj,NNP-NNP,CD,8,1
4,2.0,39,agrees,13,9,11,2,8,27,4,-2,Doctor,Christopher Eccleston,PER,PER-PER,PROPN,PROPN-PROPN,nsubj,compound-appos,NNP,NNP-NNP,1,1
0,0.0,14,was,7,1,4,3,0,9,6,-3,Otto Corbach,1877,PER-PER,TIME,PROPN-PROPN,NUM,compound-nsubj,npadvmod,NNP-NNP,CD,3,1
1,1.0,24,born,2,1,5,4,0,18,1,3,Corbach,Herscheid,PER,LOC,NOUN,PROPN,nsubjpass,pobj,NN,NNP,2,1
0,0.0,27,is,1,1,12,11,0,14,0,11,Aussois,Savoie,LOC,LOC,PROPN,PROPN,nsubj,compound,NNP,NNP,2,1
1,0.0,27,is,1,1,26,25,0,0,0,25,Aussois,France,LOC,LOC,PROPN,PROPN,nsubj,pobj,NNP,NNP,1,1
2,0.0,27,is,1,7,26,19,6,0,-6,25,Vanoise,France,LOC,LOC,PROPN,PROPN,compound,pobj,NNP,NNP,4,1
3,0.0,27,is,1,12,26,14,11,0,-11,25,Savoie,France,LOC,LOC,PROPN,PROPN,compound,pobj,NNP,NNP,3,1
0,1.0,23,opened,1,17,20,3,16,2,-16,19,Heilongjiang province,Harbin,LOC-LOC,LOC,PROPN-NOUN,PROPN,compound-pobj,conj,NNP-NN,NNP,2,1
1,1.0,23,opened,1,17,22,5,16,0,-16,21,Heilongjiang province,Qiqihar,LOC-LOC,LOC,PROPN-NOUN,PROPN,compound-pobj,conj,NNP-NN,NNP,5,1
0,0.0,21,is,9,1,6,5,0,14,8,-3,Frederik Van Lierde,25 May 1979,PER-PER-PER,TIME-TIME-TIME,PROPN-PROPN-PROPN,NUM-PROPN-NUM,compound-compound-nsubj,nummod-npadvmod-nummod,NNP-NNP-NNP,CD-NNP-CD,3,1
1,6.0,20,attacked,8,15,18,3,14,1,-7,10,Port Elizabeth,South Africa,LOC-LOC,LOC-LOC,PROPN-PROPN,PROPN-PROPN,compound-pobj,compound-appos,NNP-NNP,NNP-NNP,1,1
0,0.0,22,is,4,2,12,10,1,9,2,8,Royal Victorian Order,the United Kingdom,MISC-MISC-MISC,LOC-LOC-LOC,ADJ-PROPN-NOUN,DET-PROPN-PROPN,compound-compound-nsubj,det-compound-pobj,JJ-NNP-NN,DT-NNP-NNP,8,1
0,0.0,23,is,1,19,22,3,18,0,-18,21,Andalusia,Spain,LOC,LOC,PROPN,PROPN,pobj,pobj,NNP,NNP,6,1
0,3.0,41,is,1,10,13,3,9,27,-9,12,Cannibal Holocaust,1980,MISC-MISC,TIME,PROPN-PROPN,NUM,compound-pobj,appos,NNP-NNP,CD,1,1
0,0.0,18,was,11,1,5,4,0,12,10,-6,Stephen Burpee Appleby,1836,PER-PER-PER,TIME,PROPN-PROPN-PROPN,NUM,compound-compound-nsubj,nummod,NNP-NNP-NNP,CD,2,1
1,0.0,18,was,11,1,14,13,0,3,10,3,Stephen Burpee Appleby,Canadian,PER-PER-PER,LOC,PROPN-PROPN-PROPN,ADJ,compound-compound-nsubj,amod,NNP-NNP-NNP,JJ,3,1
2,1.0,9,born,2,1,5,4,0,3,1,3,Appleby,Florenceville,PER,LOC,PROPN,PROPN,nsubjpass,pobj,NNP,NNP,4,1
0,0.0,40,is,3,1,38,37,0,1,2,35,Plattsburgh International Airport,United States,LOC-LOC-LOC,LOC-LOC,PROPN-PROPN-PROPN,PROPN-PROPN,compound-compound-nsubj,compound-appos,NNP-NNP-NNP,NNP-NNP,11,1
1,0.0,40,is,3,1,32,31,0,7,2,29,Plattsburgh,Clinton County,LOC,LOC-LOC,PROPN,PROPN-PROPN,pobj,compound-pobj,NNP,NNP-NNP,10,1
2,0.0,40,is,3,1,38,37,0,1,2,35,Plattsburgh,United States,LOC,LOC-LOC,PROPN,PROPN-PROPN,pobj,compound-appos,NNP,NNP-NNP,11,1
3,0.0,40,is,3,32,38,6,31,1,-29,35,Clinton County,United States,LOC-LOC,LOC-LOC,PROPN-PROPN,PROPN-PROPN,compound-pobj,compound-appos,NNP-NNP,NNP-NNP,1,1
4,0.0,40,is,3,35,38,3,34,1,-32,35,New York,United States,LOC-LOC,LOC-LOC,PROPN-PROPN,PROPN-PROPN,compound-conj,compound-appos,NNP-NNP,NNP-NNP,2,1
0,0.0,16,is,11,1,4,3,0,11,10,-7,Mario Amilivia,9 November 1957,PER-PER,TIME-TIME-TIME,PROPN-PROPN,NUM-PROPN-NUM,compound-nsubj,nummod-appos-nummod,NNP-NNP,CD-NNP-CD,1,1
1,0.0,16,is,11,1,8,7,0,7,10,-3,Mario Amilivia,León,PER-PER,LOC,PROPN-PROPN,PROPN,compound-nsubj,pobj,NNP-NNP,NNP,3,1
0,1.0,24,return,12,2,5,3,1,18,10,-7,Sechskies,Kim Jae Duc,ORG,PER-PER-PER,PROPN,PROPN-PROPN-PROPN,compound,compound-compound-appos,NNPS,NNP-NNP-NNP,2,1
1,1.0,24,return,12,2,9,7,1,14,10,-3,Sechskies,Jang Su Won,ORG,PER-PER-PER,PROPN,PROPN-PROPN-PROPN,compound,compound-compound-conj,NNPS,NNP-NNP-NNP,3,1
2,5.0,50,sold,19,46,43,-3,45,6,-27,24,Kang Sunghun,Sechs Kies,PER-PER,ORG-ORG,PROPN-PROPN,PROPN-PROPN,compound-pobj,compound-compound,NNP-NNP,NNP-NNP,2,1
0,0.0,32,is,19,2,30,28,1,1,17,11,Domus Sanctae Marthae,Vatican City,LOC-LOC-LOC,LOC-LOC,PROPN-PROPN-PROPN,PROPN-PROPN,compound-compound-nsubj,compound-pobj,NNP-NNP-NNP,NNP-NNP,8,1
1,0.0,32,is,19,16,30,14,15,1,3,11,Casa Santa Marta,Vatican City,LOC-LOC-LOC,LOC-LOC,PROPN-PROPN-PROPN,PROPN-PROPN,compound-compound-pobj,compound-pobj,NNP-NNP-NNP,NNP-NNP,10,1
2,1.0,34,named,15,31,18,-13,30,15,-16,3,Lazarus of Bethany,Saint Martha,PER-PER-PER,PER-PER,PROPN-ADP-PROPN,PROPN-PROPN,conj-prep-pobj,compound-pobj,NNP-IN-NNP,NNP-NNP,6,1
0,0.0,28,is,13,2,26,24,1,1,11,13,Loudoun County,Virginia,LOC-LOC,LOC,PROPN-PROPN,PROPN,compound-pobj,compound,NNP-NNP,NNP,7,1
1,1.0,31,operate,2,12,12,0,11,18,-10,10,Washington Metro,"Washington , D.C",LOC-LOC,LOC-LOC-LOC,PROPN-PROPN,PROPN-PUNCT-PROPN,compound-compound,conj-punct-appos,NNP-NNP,"NNP-,-NNP",0,1
0,0.0,26,is,4,1,18,17,0,7,3,14,Śrem County,Greater Poland Voivodeship,LOC-LOC,LOC-LOC-LOC,PROPN-PROPN,PROPN-PROPN-PROPN,compound-nsubj,compound-compound-pobj,NNP-NNP,NNP-NNP-NNP,5,1
1,0.0,26,is,4,1,19,18,0,6,3,15,Śrem County,Poland,LOC-LOC,LOC,PROPN-PROPN,PROPN,compound-nsubj,appos,NNP-NNP,NNP,4,1
2,0.0,26,is,4,18,19,1,17,6,-14,15,Greater Poland Voivodeship,Poland,LOC-LOC-LOC,LOC,PROPN-PROPN-PROPN,PROPN,compound-compound-pobj,appos,NNP-NNP-NNP,NNP,1,1
0,0.0,28,is,8,1,5,4,0,22,7,-3,Ashley Mote,25 January 1936,PER-PER,TIME-TIME-TIME,PROPN-PROPN,NUM-PROPN-NUM,compound-nsubj,nummod-npadvmod-nummod,NNP-NNP,CD-NNP-CD,2,1
0,0.0,39,is,19,2,13,11,1,25,17,-6,Second River,New Jersey,LOC-LOC,LOC-LOC,PROPN-PROPN,PROPN-PROPN,compound-nsubj,compound-pobj,NNP-NNP,NNP-NNP,5,1
1,0.0,39,is,19,2,17,15,1,21,17,-2,Second River,United States,LOC-LOC,LOC-LOC,PROPN-PROPN,PROPN-PROPN,compound-nsubj,compound-pobj,NNP-NNP,NNP-NNP,5,1
2,0.0,39,is,19,6,13,7,5,25,13,-6,Watsessing River,New Jersey,LOC-LOC,LOC-LOC,PROPN-PROPN,PROPN-PROPN,compound-conj,compound-pobj,NNP-NNP,NNP-NNP,6,1
3,0.0,39,is,19,6,17,11,5,21,13,-2,Watsessing River,United States,LOC-LOC,LOC-LOC,PROPN-PROPN,PROPN-PROPN,compound-conj,compound-pobj,NNP-NNP,NNP-NNP,6,1
4,0.0,39,is,19,13,17,4,12,21,6,-2,New Jersey,United States,LOC-LOC,LOC-LOC,PROPN-PROPN,PROPN-PROPN,compound-pobj,compound-pobj,NNP-NNP,NNP-NNP,4,1
0,0.0,53,Agoncillo,1,1,4,3,0,48,0,3,Felipe Agoncillo,"May 26 , 1859",PER-PER,TIME-TIME-TIME-TIME,PROPN-PROPN,PROPN-NUM-PUNCT-NUM,compound-ROOT,npadvmod-nummod-punct-npadvmod,NNP-NNP,"NNP-CD-,-CD",2,1
1,0.0,53,Agoncillo,1,1,9,8,0,43,0,8,Felipe Agoncillo,"September 29 , 1941",PER-PER,TIME-TIME-TIME-TIME,PROPN-PROPN,PROPN-NUM-PUNCT-NUM,compound-ROOT,nsubj-nummod-punct-nummod,NNP-NNP,"NNP-CD-,-CD",3,1
2,0.0,53,Agoncillo,1,28,32,4,27,20,-27,31,Treaty of Paris,1898,MISC-MISC-MISC,TIME,PROPN-ADP-PROPN,NUM,pobj-prep-pobj,appos,NNP-IN-NNP,CD,2,1
0,0.0,37,Bacaloglu,1,1,4,3,0,32,0,3,Emanoil Bacaloglu,11 April 1830,PER-PER,TIME-TIME-TIME,PROPN-PROPN,NUM-PROPN-NUM,compound-ROOT,nummod-npadvmod-nummod,NNP-NNP,CD-NNP-CD,2,1
1,0.0,37,Bacaloglu,1,1,8,7,0,28,0,7,Emanoil Bacaloglu,30 August 1891,PER-PER,TIME-TIME-TIME,PROPN-PROPN,NUM-PROPN-NUM,compound-ROOT,nummod-appos-nummod,NNP-NNP,CD-NNP-CD,2,1
0,0.0,31,is,4,1,29,28,0,1,3,25,Dylan & the Dead,Columbia Records,MISC-MISC-MISC-MISC,ORG-ORG,PROPN-CCONJ-DET-PROPN,PROPN-PROPN,nsubj-cc-det-conj,compound-pobj,NNP-CC-DT-NNP,NNP-NNPS,6,1
1,4.0,42,documented,13,20,6,-14,19,35,-7,-7,View from the Vault IV,Grateful Dead,MISC-MISC-MISC-MISC-MISC,ORG-ORG,PROPN-ADP-DET-PROPN-PROPN,PROPN-PROPN,conj-prep-det-compound-pobj,compound-poss,NNP-IN-DT-NNP-NNP,NNP-NNP,9,1
2,4.0,42,documented,13,38,6,-32,37,35,-25,-7,Postcards of the Hanging,Grateful Dead,MISC-MISC-MISC-MISC,ORG-ORG,PROPN-ADP-DET-PROPN,PROPN-PROPN,appos-prep-det-pobj,compound-poss,NNPS-IN-DT-NNP,NNP-NNP,10,1
0,0.0,20,is,11,1,5,4,0,14,10,-6,Miroslaw Balka,1958,PER-PER,TIME,PROPN-PROPN,NUM,compound-nsubj,npadvmod,NNP-NNP,CD,2,1
1,0.0,20,is,11,1,7,6,0,12,10,-4,Miroslaw Balka,Warsaw,PER-PER,LOC,PROPN-PROPN,PROPN,compound-nsubj,appos,NNP-NNP,NNP,3,1
2,0.0,20,is,11,7,15,8,6,4,4,4,Warsaw,Polish,LOC,LOC,PROPN,ADJ,appos,amod,NNP,JJ,6,1
3,0.0,20,is,11,9,15,6,8,4,2,4,Poland,Polish,LOC,LOC,PROPN,ADJ,appos,amod,NNP,JJ,5,1
0,12.0,25,remixed,6,13,11,-2,12,13,-7,5,Dave Mustaine,Megadeth,PER-PER,ORG,PROPN-PROPN,PROPN,compound-pobj,compound,NNP-NNP,NNP,1,1
0,0.0,35,are,5,2,30,28,1,4,3,25,Millburn Township Public Schools,New Jersey,ORG-ORG-ORG-ORG,LOC-LOC,PROPN-PROPN-PROPN-PROPN,PROPN-PROPN,compound-compound-compound-nsubj,compound-conj,NNP-NNP-NNP-NNPS,NNP-NNP,7,1
1,0.0,35,are,5,2,33,31,1,1,3,28,Millburn Township Public Schools,United States,ORG-ORG-ORG-ORG,LOC-LOC,PROPN-PROPN-PROPN-PROPN,PROPN-PROPN,compound-compound-compound-nsubj,compound-appos,NNP-NNP-NNP-NNPS,NNP-NNP,7,1
2,0.0,35,are,5,2,27,25,1,7,3,22,Millburn,Essex County,LOC,LOC-LOC,PROPN,PROPN-PROPN,pobj,compound-pobj,NNP,NNP-NNP,6,1
3,0.0,35,are,5,2,33,31,1,1,3,28,Millburn,United States,LOC,LOC-LOC,PROPN,PROPN-PROPN,pobj,compound-appos,NNP,NNP-NNP,7,1
4,0.0,35,are,5,27,30,3,26,4,-22,25,Essex County,New Jersey,LOC-LOC,LOC-LOC,PROPN-PROPN,PROPN-PROPN,compound-pobj,compound-conj,NNP-NNP,NNP-NNP,1,1
5,0.0,35,are,5,27,33,6,26,1,-22,28,Essex County,United States,LOC-LOC,LOC-LOC,PROPN-PROPN,PROPN-PROPN,compound-pobj,compound-appos,NNP-NNP,NNP-NNP,1,1
6,0.0,35,are,5,30,33,3,29,1,-25,28,New Jersey,United States,LOC-LOC,LOC-LOC,PROPN-PROPN,PROPN-PROPN,compound-conj,compound-appos,NNP-NNP,NNP-NNP,2,1
0,2.0,32,occurs,3,6,17,11,5,14,-3,14,the United States,Washington DC,LOC-LOC-LOC,LOC-LOC,DET-PROPN-PROPN,PROPN-PROPN,det-compound-pobj,compound-pobj,DT-NNP-NNP,NNP-NNP,6,1
1,3.0,30,been,8,15,29,14,14,0,-7,21,Holyrood,Edinburgh,LOC,LOC,PROPN,PROPN,compound,pobj,NNP,NNP,4,1
2,3.0,30,been,8,29,5,-24,28,24,-21,-3,Edinburgh,Scotland,LOC,LOC,PROPN,PROPN,pobj,pobj,NNP,NNP,2,1
3,7.0,29,indicated,8,4,7,3,3,21,4,-1,Conservative Party,Michael Howard,ORG-ORG,PER-PER,PROPN-PROPN,PROPN-PROPN,compound-compound,compound-nsubj,NNP-NNP,NNP-NNP,2,1
0,0.0,20,is,7,15,19,4,14,0,-8,12,State of Penang,Malaysia,LOC-LOC-LOC,LOC,PROPN-ADP-PROPN,PROPN,pobj-prep-pobj,appos,NNP-IN-NNP,NNP,5,1
0,0.0,18,is,3,1,17,16,0,0,2,14,Mount Carmel Cemetery,Illinois,LOC-LOC-LOC,LOC,PROPN-PROPN-PROPN,PROPN,compound-compound-nsubj,appos,NNP-NNP-NNP,NNP,3,1
0,0.0,43,was,11,1,4,3,0,38,10,-7,John Udell,22 June 1795,PER-PER,TIME-TIME-TIME,PROPN-PROPN,NUM-PROPN-NUM,compound-nsubj,nummod-appos-nummod,NNP-NNP,CD-NNP-CD,2,1
1,0.0,43,was,11,1,8,7,0,34,10,-3,John Udell,30 June 1874,PER-PER,TIME-TIME-TIME,PROPN-PROPN,NUM-PROPN-NUM,compound-nsubj,nummod-npadvmod-nummod,NNP-NNP,CD-NNP-CD,1,1
2,0.0,43,was,11,1,14,13,0,28,10,3,John Udell,American,PER-PER,LOC,PROPN-PROPN,ADJ,compound-nsubj,amod,NNP-NNP,JJ,2,1
3,0.0,43,was,11,1,36,35,0,6,10,25,John Udell,the United States,PER-PER,LOC-LOC-LOC,PROPN-PROPN,DET-PROPN-PROPN,compound-nsubj,det-compound-pobj,NNP-NNP,DT-NNP-NNP,9,1
4,0.0,43,was,11,37,36,-1,36,6,-26,25,Great Plains,the United States,LOC-LOC,LOC-LOC-LOC,PROPN-PROPN,DET-PROPN-PROPN,compound-pobj,det-compound-pobj,NNP-NNPS,DT-NNP-NNP,1,1
5,2.0,22,remained,9,15,8,-7,14,13,-6,-1,Solano County,California,LOC-LOC,LOC,PROPN-PROPN,PROPN,compound-pobj,pobj,NNP-NNP,NNP,4,1
6,2.0,22,remained,9,20,8,-12,19,13,-11,-1,Sonoma County,California,LOC-LOC,LOC,PROPN-PROPN,PROPN,compound-pobj,pobj,NNP-NNP,NNP,4,1
0,1.0,21,is,1,5,12,7,4,8,-4,11,North America,Canada,LOC-LOC,LOC,PROPN-PROPN,PROPN,compound-pobj,pobj,NNP-NNP,NNP,4,1
1,1.0,21,is,1,5,14,9,4,6,-4,13,North America,the United States,LOC-LOC,LOC-LOC-LOC,PROPN-PROPN,DET-PROPN-PROPN,compound-pobj,det-compound-pobj,NNP-NNP,DT-NNP-NNP,5,1
0,0.0,42,is,12,15,21,6,14,20,-3,9,Islamist Salafi,Syrian Civil War,ORG-ORG,MISC-MISC-MISC,PROPN-PROPN,ADJ-PROPN-PROPN,compound-compound,amod-compound-pobj,NNP-NNP,JJ-NNP-NNP,5,1
1,3.0,24,named,3,6,13,7,5,10,-3,10,Imam Bukhari,Islamic,PER-PER,ORG,PROPN-PROPN,ADJ,compound-pobj,amod,NNP-NNP,JJ,1,1
2,3.0,24,named,3,18,23,5,17,0,-15,20,Bukhara,Uzbekistan,LOC,LOC,PROPN,PROPN,pobj,pobj,NNP,NNP,6,1
0,0.0,21,is,4,10,20,10,9,0,-6,16,Winnipeg,Canada,LOC,LOC,PROPN,PROPN,pobj,pobj,NNP,NNP,5,1
1,0.0,21,is,4,12,20,8,11,0,-8,16,Manitoba,Canada,LOC,LOC,PROPN,PROPN,conj,pobj,NNP,NNP,6,1
0,0.0,64,Paskačić,1,47,55,8,46,8,-46,54,Mrnjavčević,1395,PER,TIME,PROPN,NUM,poss,npadvmod,NNP,CD,2,1
1,0.0,64,Paskačić,1,25,30,5,24,33,-24,29,Dušan the Mighty,1331,PER-PER-PER,TIME,PROPN-DET-PROPN,NUM,pobj-det-appos,npadvmod,NNP-DT-NNP,CD,3,1
2,2.0,53,had,1,1,6,5,0,46,0,5,Paskač,Vlatko Paskačić,PER,PER-PER,PROPN,PROPN-PROPN,nsubj,compound-appos,NNP,NNP-NNP,2,1
0,0.0,25,was,13,1,4,3,0,20,12,-9,Leo Friedlander,"July 6 , 1888",PER-PER,TIME-TIME-TIME-TIME,PROPN-PROPN,PROPN-NUM-PUNCT-NUM,compound-nsubj,npadvmod-nummod-punct-nummod,NNP-NNP,"NNP-CD-,-CD",2,1
1,0.0,25,was,13,1,9,8,0,15,12,-4,Leo Friedlander,"October 24 , 1966",PER-PER,TIME-TIME-TIME-TIME,PROPN-PROPN,PROPN-NUM-PUNCT-NUM,compound-nsubj,appos-nummod-punct-nummod,NNP-NNP,"NNP-CD-,-CD",3,1
2,1.0,29,studied,1,1,5,4,0,23,0,4,Friedlander,Art Students League,PER,ORG-ORG-ORG,ADJ,PROPN-PROPN-PROPN,nsubj,compound-compound-pobj,JJR,NNP-NNPS-NNP,3,1
3,1.0,29,studied,1,5,9,4,4,19,-4,8,Art Students League,New York City,ORG-ORG-ORG,LOC-LOC-LOC,PROPN-PROPN-PROPN,PROPN-PROPN-PROPN,compound-compound-pobj,compound-compound-pobj,NNP-NNPS-NNP,NNP-NNP-NNP,4,1
4,5.0,11,was,1,1,5,4,0,5,0,4,Friedlander,Rhoda Lichter,PER,PER-PER,PROPN,PROPN-PROPN,nsubj,compound-pobj,NNP,NNP-NNP,3,1
0,0.0,20,is,3,1,18,17,0,1,2,15,Zombie Army Trilogy,Rebellion Developments,MISC-MISC-MISC,ORG-ORG,PROPN-PROPN-PROPN,PROPN-PROPN,compound-compound-nsubj,compound-pobj,NNP-NNP-NNP,NNP-NNPS,7,1
1,1.0,28,is,1,20,21,1,19,6,-19,20,Microsoft,Windows,ORG,MISC,PROPN,PROPN,compound,pobj,NNP,NNP,1,1
2,2.0,62,is,5,30,18,-12,29,43,-25,13,Adolf Hitler,World War II,PER-PER,MISC-MISC-MISC,PROPN-PROPN,PROPN-PROPN-PROPN,compound-nsubj,compound-compound-pobj,NNP-NNP,NNP-NNP-NNP,8,1
0,0.0,26,is,3,1,14,13,0,11,2,11,Brome - Missisquoi,Quebec,LOC-LOC-LOC,LOC,PROPN-PUNCT-PROPN,PROPN,compound-punct-nsubj,pobj,NNP-HYPH-NNP,NNP,8,1
1,0.0,26,is,3,1,16,15,0,9,2,13,Brome - Missisquoi,Canada,LOC-LOC-LOC,LOC,PROPN-PUNCT-PROPN,PROPN,compound-punct-nsubj,appos,NNP-HYPH-NNP,NNP,5,1
2,0.0,26,is,3,11,14,3,10,11,-8,11,Montérégie,Quebec,LOC,LOC,PROPN,PROPN,compound,pobj,NNP,NNP,3,1
3,0.0,26,is,3,11,16,5,10,9,-8,13,Montérégie,Canada,LOC,LOC,PROPN,PROPN,compound,appos,NNP,NNP,4,1
4,0.0,26,is,3,14,16,2,13,9,-11,13,Quebec,Canada,LOC,LOC,PROPN,PROPN,pobj,appos,NNP,NNP,7,1
0,0.0,22,is,1,7,11,4,6,10,-6,10,South Coast,New South Wales,LOC-LOC,LOC-LOC-LOC,PROPN-PROPN,PROPN-PROPN-PROPN,compound-compound,compound-compound-pobj,NNP-NNP,NNP-NNP-NNP,4,1
1,0.0,22,is,1,7,15,8,6,6,-6,14,South Coast,Australia,LOC-LOC,LOC,PROPN-PROPN,PROPN,compound-compound,appos,NNP-NNP,NNP,4,1
2,0.0,22,is,1,11,15,4,10,6,-10,14,New South Wales,Australia,LOC-LOC-LOC,LOC,PROPN-PROPN-PROPN,PROPN,compound-compound-pobj,appos,NNP-NNP-NNP,NNP,6,1
3,0.0,22,is,1,11,19,8,10,2,-10,18,New South Wales,City of Shoalhaven,LOC-LOC-LOC,LOC-LOC-LOC,PROPN-PROPN-PROPN,PROPN-ADP-PROPN,compound-compound-pobj,pobj-prep-pobj,NNP-NNP-NNP,NNP-IN-NNP,8,1
0,0.0,13,is,4,2,10,8,1,2,2,6,Grom - Bach,Hesse,LOC-LOC-LOC,LOC,PROPN-PUNCT-PROPN,PROPN,compound-punct-nsubj,pobj,NNP-HYPH-NNP,NNP,6,1
1,0.0,13,is,4,2,12,10,1,0,2,8,Grom - Bach,Germany,LOC-LOC-LOC,LOC,PROPN-PUNCT-PROPN,PROPN,compound-punct-nsubj,appos,NNP-HYPH-NNP,NNP,3,1
2,0.0,13,is,4,10,12,2,9,0,-6,8,Hesse,Germany,LOC,LOC,PROPN,PROPN,pobj,appos,NNP,NNP,5,1
0,0.0,18,is,5,2,14,12,1,3,3,9,Pink Line,Montreal Metro,MISC-MISC,MISC-MISC,PROPN-NOUN,PROPN-PROPN,compound-nsubj,compound-pobj,NNP-NN,NNP-NNP,4,1
1,0.0,18,is,5,2,17,15,1,0,3,12,Pink Line,Canada,MISC-MISC,LOC,PROPN-NOUN,PROPN,compound-nsubj,pobj,NNP-NN,NNP,2,1
2,0.0,18,is,5,14,17,3,13,0,-9,12,Montreal Metro,Canada,MISC-MISC,LOC,PROPN-PROPN,PROPN,compound-pobj,pobj,NNP-NNP,NNP,4,1
3,1.0,46,was,18,31,39,8,30,6,-13,21,Valérie Plante,Projet Montréal,PER-PER,ORG-ORG,PROPN-PROPN,PROPN-PROPN,compound-pobj,compound-appos,NNP-NNP,NNP-NNP,4,1
0,0.0,15,is,10,1,5,4,0,9,9,-5,Kristian Gullichsen,29 September 1932,PER-PER,TIME-TIME-TIME,PROPN-PROPN,NUM-PROPN-NUM,amod-nsubj,nummod-npadvmod-nummod,NNP-NNP,CD-NNP-CD,2,1
1,0.0,15,is,10,1,9,8,0,5,9,-1,Kristian Gullichsen,Helsinki,PER-PER,LOC,PROPN-PROPN,PROPN,amod-nsubj,appos,NNP-NNP,NNP,1,1
2,2.0,18,are,2,8,11,3,7,6,-6,9,Lilli Alanen,Johan Gullichsen,PER-PER,PER-PER,PROPN-PROPN,PROPN-PROPN,compound-appos,compound-conj,NNP-NNP,NNP-NNP,1,1
3,3.0,23,has,2,1,17,16,0,5,1,15,Kristian Gullichsen,Alvar Gullichsen,PER-PER,PER-PER,PROPN-PROPN,PROPN-PROPN,amod-nsubj,compound-appos,NNP-NNP,NNP-NNP,4,1
4,3.0,23,has,2,17,21,4,16,1,-15,19,Alvar Gullichsen,1961,PER-PER,TIME,PROPN-PROPN,NUM,compound-appos,npadvmod,NNP-NNP,CD,3,1
0,0.0,47,was,11,1,4,3,0,42,10,-7,Mehdi Bazargan,1 September 1907,PER-PER,TIME-TIME-TIME,PROPN-PROPN,NUM-PROPN-NUM,compound-compound,nummod-npadvmod-nummod,NNP-NNP,CD-NNP-CD,2,1
1,0.0,47,was,11,1,8,7,0,38,10,-3,Mehdi Bazargan,20 January 1995,PER-PER,TIME-TIME-TIME,PROPN-PROPN,NUM-PROPN-NUM,compound-compound,nummod-appos-nummod,NNP-NNP,CD-NNP-CD,-1,1
0,0.0,11,are,1,7,10,3,6,0,-6,9,U.S.,Washington,LOC,LOC,PROPN,PROPN,compound,pobj,NNP,NNP,4,1
0,0.0,28,is,8,1,5,4,0,22,7,-3,Curt Smith,24 June 1961,PER-PER,TIME-TIME-TIME,PROPN-PROPN,NUM-PROPN-NUM,compound-nsubj,nummod-npadvmod-nummod,NNP-NNP,CD-NNP-CD,2,1
1,3.0,26,pursued,11,21,25,4,20,0,-10,14,Soul on Board,1993,MISC-MISC-MISC,TIME,PROPN-ADP-PROPN,NUM,appos-prep-pobj,pobj,NNP-IN-NNP,CD,3,1
0,0.0,20,Honeymoon,1,1,19,18,0,0,0,18,Gypsy Honeymoon : The Best of Kim Carnes,1993,MISC-MISC-MISC-MISC-MISC-MISC-MISC-MISC,TIME,PROPN-PROPN-PUNCT-DET-ADJ-ADP-PROPN-PROPN,NUM,compound-ROOT-punct-det-nsubj-prep-compound-pobj,pobj,NNP-NNP-:-DT-JJS-IN-NNP-NNP,CD,2,1
0,0.0,14,is,3,1,12,11,0,1,2,9,Sarah Lawrence College,United States,ORG-ORG-ORG,LOC-LOC,PROPN-PROPN-PROPN,PROPN-PROPN,compound-compound-nsubj,compound-pobj,NNP-NNP-NNP,NNP-NNP,5,1
1,1.0,21,located,2,6,9,3,5,11,-4,7,Westchester County,New York,LOC-LOC,LOC-LOC,PROPN-PROPN,PROPN-PROPN,compound-pobj,compound-appos,NNP-NNP,NNP-NNP,1,1
2,1.0,21,located,2,9,20,11,8,0,-7,18,New York,Manhattan,LOC-LOC,LOC,PROPN-PROPN,PROPN,compound-appos,pobj,NNP-NNP,NNP,4,1
0,0.0,15,is,1,9,11,2,8,3,-8,10,Cornwall,England,LOC,LOC,PROPN,PROPN,pobj,conj,NNP,NNP,3,1
1,0.0,15,is,1,9,13,4,8,1,-8,12,Cornwall,United Kingdom,LOC,LOC-LOC,PROPN,PROPN-PROPN,pobj,compound-appos,NNP,NNP-NNP,3,1
2,0.0,15,is,1,11,13,2,10,1,-10,12,England,United Kingdom,LOC,LOC-LOC,PROPN,PROPN-PROPN,conj,compound-appos,NNP,NNP-NNP,2,1
3,2.0,28,has,1,19,26,7,18,1,-18,25,Caradon Hill,Bodmin Moor,LOC-LOC,LOC-LOC,PROPN-PROPN,PROPN-PROPN,compound-conj,compound-pobj,NNP-NNP,NNP-NNP,10,1
0,0.0,22,died,14,1,9,8,0,12,13,-5,Maier Zipser,Balassagyarmat,PER-PER,LOC,PROPN-PROPN,PROPN,compound-nsubj,pobj,NNP-NNP,NNP,4,1
1,0.0,22,died,14,1,11,10,0,10,13,-3,Maier Zipser,14 August 1815,PER-PER,TIME-TIME-TIME,PROPN-PROPN,NUM-PROPN-NUM,compound-nsubj,nummod-appos-nummod,NNP-NNP,CD-NNP-CD,4,1
2,0.0,22,died,14,1,19,18,0,2,13,5,Maier Zipser,10 December 1869,PER-PER,TIME-TIME-TIME,PROPN-PROPN,NUM-PROPN-NUM,compound-nsubj,nummod-appos-nummod,NNP-NNP,CD-NNP-CD,2,1
0,0.0,16,is,2,1,5,4,0,10,1,3,The Used,American,ORG-ORG,LOC,DET-PROPN,ADJ,det-nsubj,amod,DT-NNP,JJ,3,1
1,0.0,16,is,2,1,10,9,0,5,1,8,The Used,Orem,ORG-ORG,LOC,DET-PROPN,PROPN,det-nsubj,pobj,DT-NNP,NNP,6,1
2,0.0,16,is,2,1,15,14,0,0,1,13,The Used,2001,ORG-ORG,TIME,DET-PROPN,NUM,det-nsubj,pobj,DT-NNP,CD,2,1
3,0.0,16,is,2,5,12,7,4,3,-3,10,American,Utah,LOC,LOC,ADJ,PROPN,amod,appos,JJ,NNP,3,1
4,3.0,30,followed,1,9,15,6,8,14,-8,14,In Love and Death,September 2004,MISC-MISC-MISC-MISC,TIME-TIME,ADP-PROPN-CCONJ-PROPN,PROPN-NUM,prep-pobj-cc-conj,pobj-nummod,IN-NNP-CC-NNP,NNP-CD,7,1
5,3.0,30,followed,1,9,22,13,8,7,-8,21,In Love and Death,Lies for the Liars,MISC-MISC-MISC-MISC,MISC-MISC-MISC-MISC,ADP-PROPN-CCONJ-PROPN,PROPN-ADP-DET-PROPN,prep-pobj-cc-conj,npadvmod-prep-det-pobj,IN-NNP-CC-NNP,NNPS-IN-DT-NNPS,7,1
6,4.0,22,released,17,1,20,19,0,1,16,3,Shallow Believer,February 2008,MISC-MISC,TIME-TIME,PROPN-PROPN,PROPN-NUM,compound-nsubjpass,pobj-nummod,NNP-NNP,NNP-CD,4,1
7,6.0,19,released,8,6,17,11,5,1,2,9,Vulnerable,Hopeless Records,MISC,ORG-ORG,PROPN,PROPN-PROPN,oprd,compound-appos,NNP,NNP-NNPS,5,1
8,8.0,12,album,2,5,10,5,4,1,-3,8,Imaginary Enemy,April 2014,MISC-MISC,TIME-TIME,PROPN-PROPN,PROPN-NUM,compound-appos,pobj-nummod,NNP-NNP,NNP-CD,5,1
0,0.0,15,is,1,1,13,12,0,1,0,12,Pattukkottai,Tamil Nadu,LOC,LOC-LOC,PROPN,PROPN-PROPN,nsubj,compound-pobj,NNP,NNP-NNP,5,1
1,0.0,15,is,1,6,10,4,5,4,-5,9,Thanjavur,Indian,LOC,LOC,PROPN,ADJ,compound,amod,NNP,JJ,4,1
2,0.0,15,is,1,6,13,7,5,1,-5,12,Thanjavur,Tamil Nadu,LOC,LOC-LOC,PROPN,PROPN-PROPN,compound,compound-pobj,NNP,NNP-NNP,6,1
3,0.0,15,is,1,10,13,3,9,1,-9,12,Indian,Tamil Nadu,LOC,LOC-LOC,ADJ,PROPN-PROPN,amod,compound-pobj,JJ,NNP-NNP,2,1
4,8.0,32,are,3,18,31,13,17,0,-15,28,Tiruchirapalli Airport,Tiruchirappalli,LOC-LOC,LOC,PROPN-PROPN,PROPN,compound-attr,pobj,NNP-NNP,NNP,2,1
0,0.0,23,Koláček,1,1,4,3,0,18,0,3,František Koláček,9 October 1851,PER-PER,TIME-TIME-TIME,PROPN-PROPN,NUM-PROPN-NUM,compound-ROOT,nummod-appos-nummod,NNP-NNP,CD-NNP-CD,1,1
1,0.0,23,Koláček,1,1,8,7,0,14,0,7,František Koláček,Slavkov u Brna,PER-PER,LOC-LOC-LOC,PROPN-PROPN,PROPN-PROPN-PROPN,compound-ROOT,compound-compound-appos,NNP-NNP,NNP-NNP-NNP,2,1
2,0.0,23,Koláček,1,1,14,13,0,8,0,13,František Koláček,8 December 1913,PER-PER,TIME-TIME-TIME,PROPN-PROPN,NUM-PROPN-NUM,compound-ROOT,nummod-nsubj-nummod,NNP-NNP,CD-NNP-CD,1,1
3,0.0,23,Koláček,1,1,18,17,0,4,0,17,František Koláček,Prague,PER-PER,LOC,PROPN-PROPN,PROPN,compound-ROOT,appos,NNP-NNP,NNP,2,1
4,2.0,20,obtained,14,3,6,3,2,13,11,-8,Charles University,Prague,ORG-ORG,LOC,PROPN-PROPN,PROPN,compound-pobj,pobj,NNP-NNP,NNP,3,1
0,0.0,40,was,20,2,34,32,1,5,18,14,Kaohsiung,Taiwan,LOC,LOC,PROPN,PROPN,pobj,appos,NNP,NNP,2,1
0,0.0,30,called,4,18,26,8,17,3,-14,22,Wells Gray Provincial Park,British Columbia,LOC-LOC-LOC-LOC,LOC-LOC,PROPN-PROPN-PROPN-PROPN,PROPN-PROPN,compound-compound-compound-pobj,compound-pobj,NNP-NNP-NNP-NNP,NNP-NNP,5,1
1,0.0,30,called,4,18,29,11,17,0,-14,25,Wells Gray Provincial Park,Canada,LOC-LOC-LOC-LOC,LOC,PROPN-PROPN-PROPN-PROPN,PROPN,compound-compound-compound-pobj,appos,NNP-NNP-NNP-NNP,NNP,5,1
2,0.0,30,called,4,26,29,3,25,0,-22,25,British Columbia,Canada,LOC-LOC,LOC,PROPN-PROPN,PROPN,compound-pobj,appos,NNP-NNP,NNP,4,1
3,2.0,22,is,7,6,16,10,5,5,1,9,Kostal Cone,Wells Gray - Clearwater volcanic field,LOC-LOC,LOC-LOC-LOC-LOC-LOC-LOC,PROPN-PROPN,PROPN-PROPN-PUNCT-PROPN-ADJ-NOUN,compound-nsubj,nmod-compound-punct-nmod-amod-pobj,NNP-NNP,NNP-NNP-HYPH-NNP-JJ-NN,8,1
4,6.0,37,revealed,5,13,23,10,12,13,-8,18,Kostal Cone,Wells Gray - Clearwater volcanic field,LOC-LOC,LOC-LOC-LOC-LOC-LOC-LOC,PROPN-PROPN,PROPN-PROPN-PUNCT-PROPN-ADJ-NOUN,compound-pobj,nmod-nmod-punct-nmod-amod-pobj,NNP-NNP,NNP-NNP-HYPH-NNP-JJ-NN,9,1
5,10.0,49,include,25,39,13,-26,38,35,-14,-12,Kostal Cone,Wells Gray - Clearwater volcanic field,LOC-LOC,LOC-LOC-LOC-LOC-LOC-LOC,PROPN-PROPN,PROPN-PROPN-PUNCT-PROPN-ADJ-NOUN,compound-pobj,nmod-nmod-punct-nmod-amod-pobj,NNP-NNP,NNP-NNP-HYPH-NNP-JJ-NN,13,1
0,0.0,35,was,10,1,4,3,0,30,9,-6,Jan Hambourg,27 August 1882,PER-PER,TIME-TIME-TIME,PROPN-PROPN,NUM-PROPN-NUM,compound-nsubj,nummod-nmod-nummod,NNP-NNP,CD-NNP-CD,1,1
1,0.0,35,was,10,1,7,6,0,27,9,-3,Jan Hambourg,–29 September 1947,PER-PER,TIME-TIME-TIME,PROPN-PROPN,PROPN-PROPN-NUM,compound-nsubj,appos-npadvmod-nummod,NNP-NNP,NNP-NNP-CD,2,1
2,1.0,20,born,3,1,6,5,0,13,2,3,Jan Hambourg,Voronezh,PER-PER,LOC,PROPN-PROPN,PROPN,compound-nsubjpass,pobj,NNP-NNP,NNP,4,1
3,1.0,20,born,3,1,17,16,0,2,2,14,Jan Hambourg,Mark Hambourg,PER-PER,PER-PER,PROPN-PROPN,PROPN-PROPN,compound-nsubjpass,compound-appos,NNP-NNP,NNP-NNP,7,1
4,1.0,20,born,3,6,8,2,5,11,-3,5,Voronezh,Russia,LOC,LOC,PROPN,PROPN,pobj,appos,NNP,NNP,3,1
5,6.0,7,died,1,4,6,2,3,0,-3,5,Tours,France,LOC,LOC,PROPN,PROPN,pobj,appos,NNP,NNP,4,1
0,0.0,27,is,9,1,6,5,0,20,8,-3,Gazmend Pula,Pristina,PER-PER,LOC,PROPN-PROPN,PROPN,compound-nsubj,pobj,NNP-NNP,NNP,4,1
0,0.0,12,is,3,2,11,9,1,0,1,8,Assam Rifles,India,ORG-ORG,LOC,PROPN-PROPN,PROPN,compound-nsubj,pobj,NNP-NNPS,NNP,2,1
1,2.0,48,undergone,6,4,19,15,3,28,2,13,Assam Frontier Police,1883,ORG-ORG-ORG,TIME,PROPN-PROPN-NOUN,NUM,compound-compound-dobj,appos,NNP-NNP-NNS,CD,4,1
2,3.0,50,served,15,27,34,7,26,15,-12,19,World War I,Europe,MISC-MISC-MISC,LOC,PROPN-PROPN-PRON,PROPN,compound-compound-pobj,pobj,NNP-NNP-PRP,NNP,5,1
3,3.0,50,served,15,27,37,10,26,12,-12,22,World War I,Middle East,MISC-MISC-MISC,LOC-LOC,PROPN-PROPN-PRON,PROPN-PROPN,compound-compound-pobj,compound-conj,NNP-NNP-PRP,NNP-NNP,5,1
0,0.0,18,was,13,1,10,9,0,7,12,-3,Ottaviano de ' Medici,28 May 1546,PER-PER-PER-PER,TIME-TIME-TIME,PROPN-PROPN-PUNCT-PROPN,NUM-PROPN-NUM,compound-subtok-punct-nsubj,nummod-appos-nummod,NNP-NNP-``-NNP,CD-NNP-CD,3,1
1,0.0,18,was,13,1,16,15,0,1,12,3,Ottaviano de ' Medici,Italian,PER-PER-PER-PER,LOC,PROPN-PROPN-PUNCT-PROPN,ADJ,compound-subtok-punct-nsubj,amod,NNP-NNP-``-NNP,JJ,4,1
2,7.0,22,founded,4,21,8,-13,20,13,-17,4,Naples,Italian,LOC,LOC,PROPN,ADJ,pobj,amod,NNP,JJ,2,1
0,2.0,22,classify,2,21,12,-9,20,9,-19,10,Myopsina,Teuthida,MISC,MISC,PROPN,PROPN,pobj,appos,NNP,NNP,4,1
0,0.0,20,is,3,1,12,11,0,7,2,9,The Skin Mechanic,Gary Numan,MISC-MISC-MISC,PER-PER,DET-NOUN-PROPN,PROPN-PROPN,det-compound-nsubj,compound-pobj,DT-NN-NNP,NNP-NNP,6,1
1,0.0,20,is,3,1,18,17,0,1,2,15,The Skin Mechanic,IRS Records,MISC-MISC-MISC,ORG-ORG,DET-NOUN-PROPN,PROPN-PROPN,det-compound-nsubj,compound-pobj,DT-NN-NNP,NNP-NNPS,8,1
2,0.0,20,is,3,12,18,6,11,1,-9,15,Gary Numan,IRS Records,PER-PER,ORG-ORG,PROPN-PROPN,PROPN-PROPN,compound-pobj,compound-pobj,NNP-NNP,NNP-NNPS,6,1
0,1.0,32,located,2,5,30,25,4,1,-3,28,North Cascades National Park,United States,LOC-LOC-LOC-LOC,LOC-LOC,PROPN-PROPN-PROPN-PROPN,PROPN-PROPN,compound-compound-compound-pobj,compound-appos,NNP-NNP-NNP-NNP,NNP-NNP,4,1
1,1.0,32,located,2,10,28,18,9,3,-8,26,Lake Chelan National Recreation Area,Washington,LOC-LOC-LOC-LOC-LOC,LOC,PROPN-PROPN-PROPN-PROPN-PROPN,PROPN,compound-compound-compound-compound-conj,pobj,NNP-NNP-NNP-NNP-NNP,NNP,3,1
2,1.0,32,located,2,10,30,20,9,1,-8,28,Lake Chelan National Recreation Area,United States,LOC-LOC-LOC-LOC-LOC,LOC-LOC,PROPN-PROPN-PROPN-PROPN-PROPN,PROPN-PROPN,compound-compound-compound-compound-conj,compound-appos,NNP-NNP-NNP-NNP-NNP,NNP-NNP,3,1
3,1.0,32,located,2,17,28,11,16,3,-15,26,Ross Lake National Recreation Area,Washington,LOC-LOC-LOC-LOC-LOC,LOC,PROPN-PROPN-PROPN-PROPN-PROPN,PROPN,compound-compound-compound-compound-conj,pobj,NNP-NNP-NNP-NNP-NNP,NNP,2,1
4,1.0,32,located,2,17,30,13,16,1,-15,28,Ross Lake National Recreation Area,United States,LOC-LOC-LOC-LOC-LOC,LOC-LOC,PROPN-PROPN-PROPN-PROPN-PROPN,PROPN-PROPN,compound-compound-compound-compound-conj,compound-appos,NNP-NNP-NNP-NNP-NNP,NNP-NNP,2,1
5,1.0,32,located,2,5,28,23,4,3,-3,26,North Cascade Range,Washington,LOC-LOC-LOC,LOC,PROPN-PROPN-PROPN,PROPN,compound-compound-pobj,pobj,NNP-NNP-NNP,NNP,4,1
6,1.0,32,located,2,5,30,25,4,1,-3,28,North Cascade Range,United States,LOC-LOC-LOC,LOC-LOC,PROPN-PROPN-PROPN,PROPN-PROPN,compound-compound-pobj,compound-appos,NNP-NNP-NNP,NNP-NNP,4,1
7,1.0,32,located,2,28,30,2,27,1,-26,28,Washington,United States,LOC,LOC-LOC,PROPN,PROPN-PROPN,pobj,compound-appos,NNP,NNP-NNP,2,1
0,0.0,47,is,6,1,34,33,0,12,5,28,Northern Burlington County Regional High School,United States,ORG-ORG-ORG-ORG-ORG-ORG,LOC-LOC,PROPN-PROPN-PROPN-PROPN-PROPN-PROPN,PROPN-PROPN,compound-compound-compound-compound-compound-nsubj,compound-conj,NNP-NNP-NNP-NNP-NNP-NNP,NNP-NNP,10,1
1,0.0,47,is,6,2,31,29,1,15,4,25,Burlington County,New Jersey,LOC-LOC,LOC-LOC,PROPN-PROPN,PROPN-PROPN,compound-pobj,compound-conj,NNP-NNP,NNP-NNP,9,1
2,0.0,47,is,6,2,34,32,1,12,4,28,Burlington County,United States,LOC-LOC,LOC-LOC,PROPN-PROPN,PROPN-PROPN,compound-pobj,compound-conj,NNP-NNP,NNP-NNP,9,1
3,0.0,47,is,6,31,34,3,30,12,-25,28,New Jersey,United States,LOC-LOC,LOC-LOC,PROPN-PROPN,PROPN-PROPN,compound-conj,compound-conj,NNP-NNP,NNP-NNP,2,1
4,2.0,26,located,17,21,24,3,20,1,-4,7,Columbus,Mansfield Township,LOC,LOC-LOC,PROPN,PROPN-PROPN,compound,compound-pobj,NNP,NNP-NNP,2,1
0,0.0,36,is,13,8,34,26,7,1,5,21,A Dictionary of the Bible,William Smith,MISC-MISC-MISC-MISC-MISC,PER-PER,DET-PROPN-ADP-DET-PROPN,PROPN-PROPN,det-oprd-prep-det-pobj,compound-appos,DT-NNP-IN-DT-NNP,NNP-NNP,10,1
0,0.0,16,is,2,1,12,11,0,3,1,10,Taneli Jarva,Oulu,PER-PER,LOC,PROPN-PROPN,PROPN,compound-nsubj,pobj,NNP-NNP,NNP,7,1
1,0.0,16,is,2,1,14,13,0,1,1,12,Taneli Jarva,Northern Finland,PER-PER,LOC-LOC,PROPN-PROPN,PROPN-PROPN,compound-nsubj,compound-appos,NNP-NNP,NNP-NNP,7,1
2,0.0,16,is,2,12,14,2,11,1,-10,12,Oulu,Northern Finland,LOC,LOC-LOC,PROPN,PROPN-PROPN,pobj,compound-appos,NNP,NNP-NNP,2,1
3,4.0,34,joined,16,6,12,6,5,21,10,-4,Sentenced,2005,ORG,TIME,PROPN,NUM,poss,pobj,NNP,CD,3,1
0,0.0,33,"""",0,2,22,20,1,10,-2,22,The Pool of the Black One,Conan the Cimmerian,MISC-MISC-MISC-MISC-MISC-MISC,PER-PER-PER,DET-PROPN-ADP-DET-PROPN-PROPN,PROPN-DET-PROPN,det-nsubj-prep-det-compound-pobj,npadvmod-det-appos,DT-NNP-IN-DT-NNP-NNP,NNP-DT-NNP,9,1
1,0.0,33,"""",0,2,30,28,1,2,-2,30,The Pool of the Black One,Robert E. Howard,MISC-MISC-MISC-MISC-MISC-MISC,PER-PER-PER,DET-PROPN-ADP-DET-PROPN-PROPN,PROPN-PROPN-PROPN,det-nsubj-prep-det-compound-pobj,compound-compound-pobj,DT-NNP-IN-DT-NNP-NNP,NNP-NNP-NNP,10,1
2,0.0,33,"""",0,22,30,8,21,2,-22,30,Conan the Cimmerian,Robert E. Howard,PER-PER-PER,PER-PER-PER,PROPN-DET-PROPN,PROPN-PROPN-PROPN,npadvmod-det-appos,compound-compound-pobj,NNP-DT-NNP,NNP-NNP-NNP,7,1
3,1.0,37,set,2,9,14,5,8,22,-7,12,Hyborian Age,Conan,TIME-TIME,PER,PROPN-PROPN,PROPN,compound-pobj,nsubj,NNP-NNP,NNP,4,1
4,2.0,37,republished,12,20,32,12,19,4,-8,20,Conan the Adventurer,Lancer Books,MISC-MISC-MISC,ORG-ORG,PROPN-DET-PROPN,PROPN-PROPN,conj-det-appos,compound-ROOT,NNP-DT-NNP,NNP-NNP,7,1
5,2.0,37,republished,12,20,35,15,19,1,-8,23,Conan the Adventurer,1966,MISC-MISC-MISC,TIME,PROPN-DET-PROPN,NUM,conj-det-appos,appos,NNP-DT-NNP,CD,8,1
6,2.0,37,republished,12,17,22,5,16,14,-5,10,The Sword of Conan,Gnome Press,MISC-MISC-MISC-MISC,ORG-ORG,DET-PROPN-ADP-PROPN,PROPN-PROPN,det-appos-prep-pobj,compound-appos,DT-NNP-IN-NNP,NNP-NNP,1,1
7,3.0,32,published,5,27,30,3,26,1,-22,25,Del Rey,2003,ORG-ORG,TIME,PROPN-PROPN,NUM,compound-conj,npadvmod,NNP-NNP,CD,1,1
0,0.0,43,is,17,1,25,24,0,17,16,8,Corrientes Province,Argentina,LOC-LOC,LOC,PROPN-PROPN,PROPN,compound-pobj,appos,NNP-NNP,NNP,4,1
0,1.0,29,released,3,15,26,11,14,2,-12,23,Breakfast in America,A&M,MISC-MISC-MISC,ORG,PROPN-ADP-PROPN,PROPN,appos-prep-pobj,pobj,NNP-IN-NNP,NNP,8,1
1,7.0,42,"""",0,13,9,-4,12,32,-13,9,Roger Hodgson,Supertramp,PER-PER,ORG,PROPN-PROPN,PROPN,compound-poss,compound,NNP-NNP,NNP,3,1
2,7.0,42,"""",0,18,9,-9,17,32,-18,9,Classics Live,Supertramp,MISC-MISC,ORG,PROPN-VERB,PROPN,compound-appos,compound,NNP-VBP,NNP,3,1
0,0.0,25,is,13,1,7,6,0,17,12,-6,Alfredo Toro Hardy,Caracas,PER-PER-PER,LOC,PROPN-PROPN-PROPN,PROPN,compound-compound-nsubj,pobj,NNP-NNP-NNP,NNP,2,1
1,0.0,25,is,13,1,9,8,0,15,12,-4,Alfredo Toro Hardy,"May 22 , 1950",PER-PER-PER,TIME-TIME-TIME-TIME,PROPN-PROPN-PROPN,PROPN-NUM-PUNCT-NUM,compound-compound-nsubj,pobj-nummod-punct-nummod,NNP-NNP-NNP,"NNP-CD-,-CD",4,1
0,1.0,28,was,3,17,13,-4,16,14,-14,10,Nashville,Cumberland River,LOC,LOC-LOC,PROPN,PROPN-PROPN,pobj,compound-pobj,NNP,NNP-NNP,5,1
0,1.0,51,played,3,36,6,-30,35,44,-33,3,Super Rugby,Australia,ORG-ORG,LOC,PROPN-PROPN,PROPN,compound-conj,pobj,NNP-NNP,NNP,3,1
1,1.0,51,played,3,36,29,-7,35,21,-33,26,Super Rugby,Rugby League,ORG-ORG,ORG-ORG,PROPN-PROPN,PROPN-PROPN,compound-conj,compound-appos,NNP-NNP,NNP-NNP,1,1
2,1.0,51,played,3,45,6,-39,44,44,-42,3,A - League,Australia,ORG-ORG-ORG,LOC,PROPN-PUNCT-PROPN,PROPN,compound-punct-nmod,pobj,NNP-HYPH-NNP,NNP,6,1
0,0.0,54,is,28,20,38,18,19,15,8,10,Zanda County,Ngari Prefecture,LOC-LOC,LOC-LOC,PROPN-PROPN,PROPN-PROPN,compound-pobj,compound-appos,NNP-NNP,NNP-NNP,8,1
1,0.0,54,is,28,20,45,25,19,8,8,17,Zanda County,Tibet Autonomous Region,LOC-LOC,LOC-LOC-LOC,PROPN-PROPN,PROPN-PROPN-PROPN,compound-pobj,compound-compound-pobj,NNP-NNP,NNP-NNP-NNP,10,1
2,0.0,54,is,28,38,45,7,37,8,-10,17,Ngari Prefecture,Tibet Autonomous Region,LOC-LOC,LOC-LOC-LOC,PROPN-PROPN,PROPN-PROPN-PROPN,compound-appos,compound-compound-pobj,NNP-NNP,NNP-NNP-NNP,8,1
0,0.0,34,are,4,2,26,24,1,7,2,22,Lodi,Bergen County,LOC,LOC-LOC,PROPN,PROPN-PROPN,pobj,compound-pobj,NNP,NNP-NNP,6,1
1,0.0,34,are,4,2,32,30,1,1,2,28,Lodi,United States,LOC,LOC-LOC,PROPN,PROPN-PROPN,pobj,compound-appos,NNP,NNP-NNP,7,1
2,0.0,34,are,4,26,29,3,25,4,-22,25,Bergen County,New Jersey,LOC-LOC,LOC-LOC,PROPN-PROPN,PROPN-PROPN,compound-pobj,compound-conj,NNP-NNP,NNP-NNP,1,1
3,0.0,34,are,4,26,32,6,25,1,-22,28,Bergen County,United States,LOC-LOC,LOC-LOC,PROPN-PROPN,PROPN-PROPN,compound-pobj,compound-appos,NNP-NNP,NNP-NNP,1,1
4,0.0,34,are,4,29,32,3,28,1,-25,28,New Jersey,United States,LOC-LOC,LOC-LOC,PROPN-PROPN,PROPN-PROPN,compound-conj,compound-appos,NNP-NNP,NNP-NNP,2,1
0,0.0,18,Alemany,1,1,10,9,0,7,0,9,Arnau Alemany,Barcelona,PER-PER,LOC,PROPN-PROPN,PROPN,compound-ROOT,npadvmod,NNP-NNP,NNP,-1,1
1,0.0,18,Alemany,1,1,12,11,0,5,0,11,Arnau Alemany,1948,PER-PER,TIME,PROPN-PROPN,NUM,compound-ROOT,appos,NNP-NNP,CD,-1,1
0,0.0,41,was,14,1,6,5,0,34,13,-8,Charlotte Brontë,21 April 1816,PER-PER,TIME-TIME-TIME,PROPN-PROPN,NUM-PROPN-NUM,compound-nsubj,nummod-nmod-nummod,NNP-NNP,CD-NNP-CD,1,1
1,0.0,41,was,14,1,11,10,0,29,13,-3,Charlotte Brontë,31 March 1855,PER-PER,TIME-TIME-TIME,PROPN-PROPN,NUM-PROPN-NUM,compound-nsubj,nummod-appos-nummod,NNP-NNP,CD-NNP-CD,2,1
2,2.0,24,left,1,13,11,-2,12,12,-12,10,Anne,Emily,PER,PER,PROPN,PROPN,conj,appos,NNP,NNP,3,1
3,5.0,20,published,16,14,19,5,13,0,2,3,Jane Eyre,1847,MISC-MISC,TIME,PROPN-PROPN,NUM,compound-nsubjpass,pobj,NNP-NNP,CD,3,1
0,0.0,27,is,1,12,16,4,11,10,-11,15,WB Television Network,the United States,ORG-ORG-ORG,LOC-LOC-LOC,PROPN-PROPN-PROPN,DET-PROPN-PROPN,compound-compound-pobj,det-compound-pobj,NNP-NNP-NNP,DT-NNP-NNP,4,1
1,4.0,32,was,13,26,30,4,25,1,-13,17,Warner Bros.,Time Warner,ORG-ORG,ORG-ORG,PROPN-PROPN,PROPN-PROPN,compound-compound,compound-pobj,NNP-NNPS,NNP-NNP,3,1
0,0.0,16,was,11,1,4,3,0,11,10,-7,Frank Stone,22 August 1800,PER-PER,TIME-TIME-TIME,PROPN-PROPN,NUM-PROPN-NUM,compound-nsubj,nummod-appos-nummod,NNP-NNP,CD-NNP-CD,1,1
1,0.0,16,was,11,1,8,7,0,7,10,-3,Frank Stone,18 November 1859,PER-PER,TIME-TIME-TIME,PROPN-PROPN,NUM-PROPN-NUM,compound-nsubj,nummod-appos-nummod,NNP-NNP,CD-NNP-CD,1,1
0,0.0,12,is,1,1,10,9,0,1,0,9,Ghostwritten,David Mitchell,MISC,PER-PER,PROPN,PROPN-PROPN,nsubj,compound-pobj,NNP,NNP-NNP,4,1
1,4.0,28,continue,6,14,16,2,13,11,-8,10,number9dream,Cloud Atlas,MISC,MISC-MISC,PROPN,PROPN-PROPN,appos,compound-conj,NNP,NNP-NNP,2,1
2,4.0,28,continue,6,14,9,-5,13,18,-8,3,number9dream,Mitchell,MISC,PER,PROPN,PROPN,appos,poss,NNP,NNP,4,1
3,4.0,28,continue,6,16,9,-7,15,18,-10,3,Cloud Atlas,Mitchell,MISC-MISC,PER,PROPN-PROPN,PROPN,compound-conj,poss,NNP-NNP,NNP,4,1
4,4.0,28,continue,6,25,9,-16,24,18,-19,3,The Bone Clocks,Mitchell,MISC-MISC-MISC,PER,DET-PROPN-PROPN,PROPN,det-compound-pobj,poss,DT-NNP-NNPS,NNP,8,1
5,7.0,45,are,1,32,35,3,31,9,-31,34,Wild Swans,Jung Chang,MISC-MISC,PER-PER,PROPN-PROPN,PROPN-PROPN,compound-attr,compound-pobj,NNP-NNPS,NNP-NNP,2,1
6,7.0,45,are,1,38,43,5,37,1,-37,42,The Music of Chance,Paul Auster,MISC-MISC-MISC-MISC,PER-PER,DET-PROPN-ADP-PROPN,PROPN-PROPN,det-conj-prep-pobj,compound-pobj,DT-NNP-IN-NNP,NNP-NNP,2,1
0,0.0,34,is,6,1,5,4,0,28,5,-1,Christa Cowrie,1949,PER-PER,TIME,PROPN-PROPN,NUM,compound-nsubj,npadvmod,NNP-NNP,CD,1,1
0,1.0,35,left,24,34,32,-2,33,2,-10,8,Serbia,Vojvodina,LOC,LOC,PROPN,PROPN,appos,pobj,NNP,NNP,5,1
1,5.0,36,redrawn,16,28,33,5,27,2,-12,17,Zenica,Bosnia and Herzegovina,LOC,LOC-LOC-LOC,PROPN,PROPN-CCONJ-PROPN,compound,pobj-cc-conj,NNP,NNP-CC-NNP,4,1
0,2.0,48,invited,22,47,45,-2,46,2,-25,23,Captured,Journey,MISC,ORG,VERB,PROPN,acl,compound,VBN,NNP,5,1
1,2.0,48,invited,22,16,19,3,15,28,6,-3,Jonathan Cain,The Babys,PER-PER,ORG-ORG,PROPN-PROPN,DET-PROPN,compound-pobj,det-pobj,NNP-NNP,DT-NNP,4,1
2,5.0,38,wrote,4,22,25,3,21,12,-18,21,Jon Anderson,Yes,PER-PER,ORG,PROPN-PROPN,INTJ,compound-pobj,pobj,NNP-NNP,UH,1,1
3,5.0,38,wrote,4,32,35,3,31,2,-28,31,Mike Pinder,The Moody Blues,PER-PER,ORG-ORG-ORG,PROPN-PROPN,DET-PROPN-PROPN,compound-dobj,det-compound-pobj,NNP-NNP,DT-NNP-NNPS,3,1
0,1.0,34,son,1,5,8,3,4,25,-4,7,James Goldsmith,Lady Annabel Goldsmith,PER-PER,PER-PER-PER,PROPN-PROPN,PROPN-PROPN-PROPN,compound-pobj,compound-compound-conj,NNP-NNP,NNP-NNP-NNP,4,1
0,0.0,42,was,20,1,9,8,0,32,19,-11,Thomas Wolff,New York City,PER-PER,LOC-LOC-LOC,PROPN-PROPN,PROPN-PROPN-PROPN,compound-nsubj,compound-compound-compound,NNP-NNP,NNP-NNP-NNP,2,1
1,0.0,42,was,20,1,18,17,0,23,19,-2,Thomas Wolff,Kern County,PER-PER,LOC-LOC,PROPN-PROPN,PROPN-PROPN,compound-nsubj,compound-appos,NNP-NNP,NNP-NNP,2,1
0,0.0,30,was,12,26,29,3,25,0,-14,17,Sikhottabong District,Vientiane,LOC-LOC,LOC,PROPN-PROPN,PROPN,compound-conj,appos,NNP-NNP,NNP,5,1
0,1.0,18,runs,1,5,17,12,4,0,-4,16,Saigon River,Vietnam,LOC-LOC,LOC,PROPN-PROPN,PROPN,compound-pobj,pobj,NNP-NNP,NNP,3,1
1,1.0,18,runs,1,8,17,9,7,0,-7,16,Ho Chi Minh City,Vietnam,LOC-LOC-LOC-LOC,LOC,PROPN-PROPN-PROPN-PROPN,PROPN,compound-compound-compound-pobj,pobj,NNP-NNP-NNP-NNP,NNP,7,1
0,0.0,14,is,4,1,12,11,0,1,3,8,Rest Inside the Flames,36 Crazyfists,MISC-MISC-MISC-MISC,ORG-ORG,VERB-ADP-DET-PROPN,NUM-NOUN,nsubj-prep-det-pobj,nummod-appos,VB-IN-DT-NNP,CD-NNS,5,1
1,4.0,46,features,2,7,10,3,6,35,-5,8,Killswitch Engage,Howard Jones,ORG-ORG,PER-PER,PROPN-PROPN,PROPN-PROPN,compound-compound,compound-pobj,NNP-NNP,NNP-NNP,2,1
0,3.0,31,remained,28,6,14,8,5,16,22,-14,Ducal Prussia,Lutheranism,ORG-ORG,ORG,PROPN-PROPN,PROPN,amod-pobj,dobj,NNP-NNP,NNP,5,1
0,0.0,28,was,8,1,5,4,0,22,7,-3,Alexander I Aldea,1397,PER-PER-PER,TIME,PROPN-PRON-PROPN,NUM,compound-compound-nsubj,nummod,NNP-PRP-NNP,CD,2,1
1,0.0,28,was,8,1,25,24,0,2,7,17,Alexander I Aldea,Mircea the Elder,PER-PER-PER,PER-PER-PER,PROPN-PRON-PROPN,PROPN-DET-NOUN,compound-compound-nsubj,pobj-det-appos,NNP-PRP-NNP,NNP-DT-NN,9,1
2,6.0,28,assumed,11,9,27,18,8,0,2,16,Vlad II Dracul,1447,PER-PER-PER,TIME,PROPN-PROPN-PROPN,NUM,compound-compound-nsubj,pobj,NNP-NNP-NNP,CD,3,1
3,7.0,26,was,2,1,7,6,0,18,1,5,Alexander I,Vlad II Dracul,PER-PER,PER-PER-PER,PROPN-PRON,PROPN-PROPN-PROPN,compound-nsubj,compound-compound-pobj,NNP-PRP,NNP-NNP-NNP,4,1
4,7.0,26,was,2,7,7,0,6,18,-5,5,Vlad II Dracul,Vlad Tepes,PER-PER-PER,PER-PER,PROPN-PROPN-PROPN,PROPN-PROPN,compound-compound-pobj,compound-pobj,NNP-NNP-NNP,NNP-NNP,0,1
0,0.0,27,is,13,1,10,9,0,16,12,-3,Pacino Horne,Ypsilanti,PER-PER,LOC,PROPN-PROPN,PROPN,compound-nsubj,pobj,NNP-NNP,NNP,4,1
1,1.0,18,was,3,9,15,6,8,2,-6,12,Hamilton Tiger - Cats,Canadian Football League,ORG-ORG-ORG-ORG,ORG-ORG-ORG,PROPN-PROPN-PUNCT-NOUN,PROPN-PROPN-PROPN,compound-compound-punct-pobj,compound-compound-pobj,NNP-NNP-HYPH-NNS,NNP-NNP-NNP,4,1
0,0.0,32,is,16,2,31,29,1,0,14,15,Hoogerwerf,Phasianidae,LOC,MISC,PROPN,PROPN,poss,pobj,NNP,NNP,4,1
1,5.0,24,endemic,2,22,2,-20,21,21,-20,0,Aceh province,Indonesian,LOC-LOC,LOC,PROPN-NOUN,ADJ,compound-pobj,amod,NNP-NN,JJ,7,1
2,6.0,21,discovered,11,19,17,-2,18,3,-8,6,North Sumatra,Medan,LOC-LOC,LOC,PROPN-PROPN,PROPN,compound-appos,pobj,NNP-NNP,NNP,2,1
0,0.0,25,was,11,1,4,3,0,20,10,-7,Rudolf Kaltenbach,12 May 1842,PER-PER,TIME-TIME-TIME,PROPN-PROPN,NUM-PROPN-NUM,compound-nsubj,nummod-nmod-nummod,NNP-NNP,CD-NNP-CD,1,1
1,0.0,25,was,11,1,8,7,0,16,10,-3,Rudolf Kaltenbach,21 November 1893,PER-PER,TIME-TIME-TIME,PROPN-PROPN,NUM-PROPN-NUM,compound-nsubj,nummod-npadvmod-nummod,NNP-NNP,CD-NNP-CD,2,1
2,1.0,32,earned,3,18,22,4,17,9,-15,19,Johann von Dumreicher,1815,PER-PER-PER,TIME,PROPN-PROPN-PROPN,NUM,compound-compound-pobj,npadvmod,NNP-NNP-NNP,CD,4,1
3,3.0,25,became,3,16,21,5,15,3,-13,18,Robert Michaelis von Olshausen,1835,PER-PER-PER-PER,TIME,PROPN-PROPN-PROPN-PROPN,NUM,compound-compound-compound-dobj,appos,NNP-NNP-NNP-NNP,CD,4,1
0,0.0,29,Am,1,1,7,6,0,21,0,6,I Am a Camera,1955,MISC-MISC-MISC-MISC,TIME,PRON-VERB-DET-PROPN,NUM,nsubj-ROOT-det-attr,nummod,PRP-VBP-DT-NNP,CD,3,1
1,0.0,29,Am,1,1,26,25,0,2,0,25,I Am a Camera,John Van Druten,MISC-MISC-MISC-MISC,PER-PER-PER,PRON-VERB-DET-PROPN,PROPN-PROPN-PROPN,nsubj-ROOT-det-attr,compound-compound-pobj,PRP-VBP-DT-NNP,NNP-NNP-NNP,11,1
2,0.0,29,Am,1,16,19,3,15,9,-15,18,Berlin Stories,Christopher Isherwood,MISC-MISC,PER-PER,PROPN-PROPN,PROPN-PROPN,compound-pobj,compound-pobj,NNP-NNPS,NNP-NNP,2,1
3,2.0,35,Am,13,13,10,-3,12,24,0,-3,I Am a Camera,John Collier,MISC-MISC-MISC-MISC,PER-PER,PRON-VERB-DET-PROPN,PROPN-PROPN,nsubj-ROOT-det-compound,compound-pobj,PRP-VBP-DT-NNP,NNP-NNP,5,1
4,2.0,35,Am,13,13,18,5,12,16,0,5,I Am a Camera,Laurence Harvey,MISC-MISC-MISC-MISC,PER-PER,PRON-VERB-DET-PROPN,PROPN-PROPN,nsubj-ROOT-det-compound,compound-appos,PRP-VBP-DT-NNP,NNP-NNP,1,1
5,2.0,35,Am,13,13,23,10,12,11,0,10,I Am a Camera,Julie Harris,MISC-MISC-MISC-MISC,PER-PER,PRON-VERB-DET-PROPN,PROPN-PROPN,nsubj-ROOT-det-compound,compound-conj,PRP-VBP-DT-NNP,NNP-NNP,4,1
0,0.0,25,is,3,19,23,4,18,1,-16,20,No Fixed Address,2014,MISC-MISC-MISC,TIME,DET-PROPN-PROPN,NUM,det-compound-appos,appos,DT-NNP-NNP,CD,2,1
0,1.0,42,team,1,6,10,4,5,31,-5,9,Bartlesville,USA,LOC,LOC,PROPN,PROPN,pobj,appos,NNP,NNP,5,1
1,1.0,42,team,1,8,10,2,7,31,-7,9,Oklahoma,USA,LOC,LOC,PROPN,PROPN,conj,appos,NNP,NNP,6,1
0,0.0,14,is,3,2,13,11,1,0,1,10,Magic Whip,Blur,MISC-MISC,ORG,PROPN-PROPN,PROPN,compound-nsubj,pobj,NNP-NNP,NNP,2,1
1,2.0,27,is,1,10,13,3,9,13,-9,12,Think Tank,2003,MISC-MISC,TIME,PROPN-PROPN,NUM,compound-pobj,appos,NNP-NNP,CD,1,1
2,6.0,43,is,3,32,42,10,31,0,-29,39,EMI,2012,ORG,TIME,PROPN,NUM,pobj,pobj,NNP,CD,7,1
0,0.0,8,is,2,1,5,4,0,2,1,3,Stu Loeser,Democratic,PER-PER,ORG,PROPN-PROPN,ADJ,compound-nsubj,amod,NNP-NNP,JJ,3,1
0,1.0,62,was,5,43,40,-3,42,21,-38,35,Charles XII,Sweden,PER-PER,LOC,PROPN-PROPN,PROPN,compound-dobj,pobj,NNP-NNP,NNP,2,1
1,4.0,48,remained,7,3,29,26,2,18,4,22,French Revolution,Paris,MISC-MISC,LOC,PROPN-PROPN,PROPN,compound-nsubj,pobj,NNP-NNP,NNP,8,1
0,0.0,17,is,3,10,16,6,9,0,-7,13,Eltham,Greenwich,LOC,LOC,PROPN,PROPN,pobj,pobj,NNP,NNP,3,1
1,3.0,24,married,1,1,3,2,0,20,0,2,William,Margaret More,PER,PER-PER,PROPN,PROPN-ADV,nsubj,compound-dobj,NNP,NNP-RBR,1,1
2,3.0,24,married,1,3,23,20,2,0,-2,22,Margaret More,England,PER-PER,LOC,PROPN-ADV,PROPN,compound-dobj,pobj,NNP-RBR,NNP,2,1
0,0.0,25,is,2,1,24,23,0,0,1,22,Moreton Island,Australia,LOC-LOC,LOC,PROPN-PROPN,PROPN,compound-nsubj,appos,NNP-NNP,NNP,2,1
1,0.0,25,is,2,1,20,19,0,4,1,18,Moreton Bay,South East Queensland,LOC-LOC,LOC-LOC-LOC,PROPN-PROPN,PROPN-PROPN-PROPN,compound-pobj,compound-compound-pobj,NNP-NNP,NNP-NNP-NNP,6,1
2,0.0,25,is,2,1,24,23,0,0,1,22,Moreton Bay,Australia,LOC-LOC,LOC,PROPN-PROPN,PROPN,compound-pobj,appos,NNP-NNP,NNP,2,1
3,0.0,25,is,2,20,24,4,19,0,-18,22,South East Queensland,Australia,LOC-LOC-LOC,LOC,PROPN-PROPN-PROPN,PROPN,compound-compound-pobj,appos,NNP-NNP-NNP,NNP,6,1
4,1.0,68,constructed,22,30,34,4,29,33,-8,12,Cape Moreton Light,1857,LOC-LOC-LOC,TIME,PROPN-PROPN-PROPN,NUM,compound-compound-pobj,pobj,NNP-NNP-NNP,CD,4,1
5,1.0,68,constructed,22,30,40,10,29,27,-8,18,Cape Moreton Light,Queensland,LOC-LOC-LOC,LOC,PROPN-PROPN-PROPN,PROPN,compound-compound-pobj,pobj,NNP-NNP-NNP,NNP,4,1
0,6.0,23,living,7,10,12,2,9,10,-3,5,Ankara,Turkey,LOC,LOC,PROPN,PROPN,pobj,appos,NNP,NNP,4,1
0,0.0,24,are,4,2,21,19,1,2,2,17,Bavarian Crown Jewels,1806,MISC-MISC-MISC,TIME,PROPN-PROPN-PROPN,NUM,amod-compound-nsubj,pobj,NNP-NNP-NNP,CD,6,1
1,0.0,24,are,4,14,21,7,13,2,-10,17,Kingdom of Bavaria,1806,LOC-LOC-LOC,TIME,PROPN-ADP-PROPN,NUM,pobj-prep-pobj,pobj,NNP-IN-NNP,CD,9,1
2,0.0,24,are,4,14,23,9,13,0,-10,19,Kingdom of Bavaria,1918,LOC-LOC-LOC,TIME,PROPN-ADP-PROPN,NUM,pobj-prep-pobj,pobj,NNP-IN-NNP,CD,8,1
3,1.0,35,upgraded,23,27,30,3,26,4,-4,7,German,Bavaria,LOC,LOC,ADJ,PROPN,amod,pobj,JJ,NNP,2,1
4,12.0,27,abolished,13,11,21,10,10,5,2,8,German,Bavaria,LOC,LOC,ADJ,PROPN,amod,nsubj,JJ,NNP,3,1
0,0.0,16,was,11,1,4,3,0,11,10,-7,Friedrich Trendelenburg,24 May 1844,PER-PER,TIME-TIME-TIME,PROPN-PROPN,NUM-PROPN-NUM,compound-nsubj,nummod-nmod-nummod,NNP-NNP,CD-NNP-CD,1,1
1,2.0,19,born,2,1,5,4,0,13,1,3,Trendelenburg,Berlin,PER,LOC,PROPN,PROPN,nsubjpass,pobj,NNP,NNP,2,1
2,2.0,19,born,2,1,11,10,0,7,1,9,Trendelenburg,University of Glasgow,PER,ORG-ORG-ORG,PROPN,PROPN-ADP-PROPN,nsubjpass,pobj-prep-pobj,NNP,NNP-IN-NNP,5,1
3,2.0,19,born,2,1,11,10,0,7,1,9,Trendelenburg,University of Edinburgh,PER,ORG-ORG-ORG,PROPN,PROPN-ADP-PROPN,nsubjpass,conj-prep-pobj,NNP,NNP-IN-NNP,5,1
4,7.0,9,founded,1,4,8,4,3,0,-3,7,German Surgical Society,1872,ORG-ORG-ORG,TIME,PROPN-PROPN-PROPN,NUM,amod-compound-dobj,pobj,NNP-NNP-NNP,CD,3,1
0,0.0,27,is,8,1,20,19,0,6,7,12,Gurdwara Darbar Sahib Kartarpur,Pakistan,LOC-LOC-LOC-LOC,LOC,PROPN-PROPN-PROPN-PROPN,PROPN,compound-compound-compound-nsubj,conj,NNP-NNP-NNP-NNP,NNP,4,1
1,0.0,27,is,8,6,20,14,5,6,2,12,Punjabi,Pakistan,MISC,LOC,PROPN,PROPN,appos,conj,NNP,NNP,4,1
2,0.0,27,is,8,4,15,11,3,11,4,7,Kartarpur,Narowal District,LOC,LOC-LOC,PROPN,PROPN-PROPN,pobj,compound-conj,NNP,NNP-NNP,7,1
3,0.0,27,is,8,4,20,16,3,6,4,12,Kartarpur,Pakistan,LOC,LOC,PROPN,PROPN,pobj,conj,NNP,NNP,5,1
4,0.0,27,is,8,15,18,3,14,8,-7,10,Narowal District,Punjab,LOC-LOC,LOC,PROPN-PROPN,PROPN,compound-conj,conj,NNP-NNP,NNP,2,1
5,0.0,27,is,8,15,20,5,14,6,-7,12,Narowal District,Pakistan,LOC-LOC,LOC,PROPN-PROPN,PROPN,compound-conj,conj,NNP-NNP,NNP,4,1
6,0.0,27,is,8,18,20,2,17,6,-10,12,Punjab,Pakistan,LOC,LOC,PROPN,PROPN,conj,conj,NNP,NNP,6,1
7,1.0,21,built,2,9,15,6,8,5,-7,13,Guru Nanak,Sikh,PER-PER,ORG,PROPN-PROPN,PROPN,compound-nsubj,compound,NNP-NNP,NNP,3,1
0,0.0,43,is,23,20,29,9,19,13,3,6,Mount Artxanda,Biscay,LOC-LOC,LOC,PROPN-PROPN,PROPN,compound-pobj,pobj,NNP-NNP,NNP,10,1
1,0.0,43,is,23,20,34,14,19,8,3,11,Mount Artxanda,Spain,LOC-LOC,LOC,PROPN-PROPN,PROPN,compound-pobj,appos,NNP-NNP,NNP,10,1
2,0.0,43,is,23,29,31,2,28,11,-6,8,Biscay,Basque Country,LOC,LOC-LOC,PROPN,PROPN-PROPN,pobj,compound-appos,NNP,NNP-NNP,1,1
3,0.0,43,is,23,29,34,5,28,8,-6,11,Biscay,Spain,LOC,LOC,PROPN,PROPN,pobj,appos,NNP,NNP,2,1
4,0.0,43,is,23,29,40,11,28,2,-6,17,Biscay,Bilbao,LOC,LOC,PROPN,PROPN,pobj,pobj,NNP,NNP,6,1
5,0.0,43,is,23,31,34,3,30,8,-8,11,Basque Country,Spain,LOC-LOC,LOC,PROPN-PROPN,PROPN,compound-appos,appos,NNP-NNP,NNP,1,1
6,3.0,17,is,7,9,14,5,8,2,-2,7,Begoña Gómez Martín,Spanish,PER-PER-PER,LOC,PROPN-PROPN-PROPN,ADJ,compound-compound-attr,amod,NNP-NNP-NNP,JJ,3,1
0,0.0,21,is,5,12,19,7,11,1,-7,14,Shiva,Amish Tripathi,PER,PER-PER,PROPN,PROPN-PROPN,compound,compound-appos,NNP,NNP-NNP,3,1
0,0.0,46,Cup,4,2,31,29,1,14,2,27,Santiago,Cape Verde,LOC,LOC-LOC,PROPN,PROPN-PROPN,pobj,compound-npadvmod,NNP,NNP-NNP,6,1
1,0.0,46,Cup,4,31,39,8,30,6,-27,35,Cape Verde,Ribeira Grande de Santiago,LOC-LOC,LOC-LOC-LOC-LOC,PROPN-PROPN,PROPN-PROPN-ADP-PROPN,compound-npadvmod,compound-nmod-nmod-conj,NNP-NNP,NNP-NNP-IN-NNP,6,1
2,0.0,46,Cup,4,31,44,13,30,1,-27,40,Cape Verde,São Domingos,LOC-LOC,LOC-LOC,PROPN-PROPN,PROPN-PROPN,compound-npadvmod,compound-conj,NNP-NNP,NNP-NNP,6,1
0,0.0,16,was,1,1,7,6,0,8,0,6,Anselperga,Desiderius,PER,PER,PROPN,PROPN,nsubj,pobj,NNP,NNP,2,1
1,0.0,16,was,1,1,15,14,0,0,0,14,Anselperga,Ansa,PER,PER,PROPN,PROPN,nsubj,conj,NNP,NNP,1,1
2,0.0,16,was,1,7,15,8,6,0,-6,14,Desiderius,Ansa,PER,PER,PROPN,PROPN,pobj,conj,NNP,NNP,3,1
0,0.0,84,"""",0,2,2,0,1,81,-2,2,The Walls Fell Down,The Marbles,MISC-MISC-MISC-MISC,ORG-ORG,DET-NOUN-VERB-PART,DET-PROPN,det-nsubj-compound-nsubj,det-appos,DT-NNS-VBD-RP,DT-NNP,0,1
1,0.0,84,"""",0,2,28,26,1,55,-2,28,The Walls Fell Down,March 1969,MISC-MISC-MISC-MISC,TIME-TIME,DET-NOUN-VERB-PART,PROPN-NUM,det-nsubj-compound-nsubj,pobj-nummod,DT-NNS-VBD-RP,NNP-CD,6,1
2,0.0,84,"""",0,2,38,36,1,45,-2,38,The Walls Fell Down,Barry Gibb,MISC-MISC-MISC-MISC,PER-PER,DET-NOUN-VERB-PART,PROPN-PROPN,det-nsubj-compound-nsubj,compound-pobj,DT-NNS-VBD-RP,NNP-NNP,7,1
3,0.0,84,"""",0,2,41,39,1,42,-2,41,The Walls Fell Down,Robin Gibb,MISC-MISC-MISC-MISC,PER-PER,DET-NOUN-VERB-PART,PROPN-PROPN,det-nsubj-compound-nsubj,compound-conj,DT-NNS-VBD-RP,NNP-NNP,8,1
4,0.0,84,"""",0,2,57,55,1,26,-2,57,The Walls Fell Down,Robert Stigwood,MISC-MISC-MISC-MISC,PER-PER,DET-NOUN-VERB-PART,PROPN-PROPN,det-nsubj-compound-nsubj,compound-pobj,DT-NNS-VBD-RP,NNP-NNP,7,1
5,0.0,84,"""",0,70,2,-68,69,81,-70,2,Only One Woman,The Marbles,MISC-MISC-MISC,ORG-ORG,ADV-NUM-NOUN,DET-PROPN,advmod-nummod-pobj,det-appos,RB-CD-NN,DT-NNP,8,1
6,0.0,84,"""",0,2,22,20,1,61,-2,22,The Marbles,Graham Bonnet,ORG-ORG,PER-PER,DET-PROPN,PROPN-PROPN,det-appos,compound-pobj,DT-NNP,NNP-NNP,6,1
0,0.0,38,is,2,20,29,9,19,8,-18,27,Rome,Roman Republic,MISC,LOC-LOC,PROPN,PROPN-PROPN,appos,compound-pobj,NNP,NNP-NNP,6,1
1,0.0,38,is,2,20,29,9,19,8,-18,27,Rome,Roman Empire,MISC,LOC-LOC,PROPN,PROPN-PROPN,appos,compound-pobj,NNP,NNP-NNP,6,1
2,0.0,38,is,2,29,29,0,28,8,-27,27,Roman Republic,Roman Empire,LOC-LOC,LOC-LOC,PROPN-PROPN,PROPN-PROPN,compound-pobj,compound-pobj,NNP-NNP,NNP-NNP,0,1
3,1.0,31,introduced,15,13,7,-6,12,23,2,-8,Lucius Vorenus,Kevin McKidd,PER-PER,PER-PER,PROPN-PROPN,PROPN-PROPN,compound-nsubjpass,compound-pobj,NNP-NNP,NNP-NNP,4,1
4,3.0,28,is,5,21,24,3,20,3,-16,19,Julius Caesar,Commentarii de Bello Gallico,PER-PER,MISC-MISC-MISC-MISC,PROPN-PROPN,PROPN-PROPN-PROPN-PROPN,compound-poss,compound-compound-compound-pobj,NNP-NNP,NNP-NNP-NNP-NNP,2,1
0,0.0,33,is,2,1,25,24,0,7,1,23,Hawkes Heights,Antarctica,LOC-LOC,LOC,PROPN-PROPN,PROPN,compound-nsubj,conj,NNP-NNP,NNP,3,1
1,0.0,33,is,2,17,22,5,16,10,-15,20,Coulman Island,Ross Sea,LOC-LOC,LOC-LOC,PROPN-PROPN,PROPN-PROPN,compound-pobj,compound-pobj,NNP-NNP,NNP-NNP,4,1
2,0.0,33,is,2,17,25,8,16,7,-15,23,Coulman Island,Antarctica,LOC-LOC,LOC,PROPN-PROPN,PROPN,compound-pobj,conj,NNP-NNP,NNP,4,1
3,0.0,33,is,2,22,25,3,21,7,-20,23,Ross Sea,Antarctica,LOC-LOC,LOC,PROPN-PROPN,PROPN,compound-pobj,conj,NNP-NNP,NNP,4,1
4,1.0,62,named,3,21,25,4,20,36,-18,22,William M. Hawkes,U.S. Navy,PER-PER-PER,ORG-ORG,PROPN-PROPN-PROPN,PROPN-PROPN,compound-compound-pobj,compound-appos,NNP-NNP-NNP,NNP-NNP,2,1
0,4.0,15,Pandora,0,6,8,2,5,6,-6,8,Deucalion,Pyrrha,PER,PER,PROPN,PROPN,pobj,conj,NNP,NNP,3,1
1,7.0,13,were,4,6,8,2,5,4,-2,4,Procris,Creusa,PER,PER,PROPN,PROPN,attr,conj,NNP,NNP,3,1
2,7.0,13,were,4,6,10,4,5,2,-2,6,Procris,Oreithyia,PER,PER,PROPN,PROPN,attr,conj,NNP,NNP,4,1
3,7.0,13,were,4,8,10,2,7,2,-4,6,Creusa,Oreithyia,PER,PER,PROPN,PROPN,conj,conj,NNP,NNP,3,1
4,7.0,13,were,4,10,12,2,9,0,-6,8,Oreithyia,Chthonia,PER,PER,PROPN,PROPN,conj,conj,NNP,NNP,5,1
0,3.0,84,explained,1,6,30,24,5,53,-5,29,Baltimore,American,LOC,LOC,PROPN,ADJ,pobj,amod,NNP,JJ,7,1
0,0.0,42,is,5,1,8,7,0,33,4,3,The Unusual Youth,2005,MISC-MISC-MISC,TIME,DET-PROPN-PROPN,NUM,det-compound-nsubj,nummod,DT-NNP-NNP,CD,5,1
1,3.0,26,turned,19,1,11,10,0,14,18,-8,The Unusual Youth,Dennis Law,MISC-MISC-MISC,PER-PER,DET-PROPN-PROPN,PROPN-PROPN,det-compound-nsubj,compound-pobj,DT-NNP-NNP,NNP-NNP,7,1
0,0.0,37,is,6,2,12,10,1,24,4,6,Christian Church of Southern Sumatra,Indonesia,LOC-LOC-LOC-LOC-LOC,LOC,PROPN-PROPN-ADP-PROPN-PROPN,PROPN,compound-nsubj-prep-compound-pobj,pobj,NNP-NNP-IN-NNP-NNP,NNP,2,1
1,0.0,37,is,6,12,6,-6,11,30,-6,0,Indonesia,Sumatra,LOC,LOC,PROPN,PROPN,pobj,pobj,NNP,NNP,1,1
2,0.0,37,is,6,12,30,18,11,6,-6,24,Indonesia,Jambi,LOC,LOC,PROPN,PROPN,pobj,conj,NNP,NNP,10,1
3,0.0,37,is,6,12,32,20,11,4,-6,26,Indonesia,South Sumatra,LOC,LOC-LOC,PROPN,PROPN-PROPN,pobj,compound-conj,NNP,NNP-NNP,10,1
4,0.0,37,is,6,12,36,24,11,0,-6,30,Indonesia,Bengkulu,LOC,LOC,PROPN,PROPN,pobj,conj,NNP,NNP,2,1
0,6.0,9,formed,7,4,2,-2,3,6,3,-5,Greater London Council,1965,ORG-ORG-ORG,TIME,PROPN-PROPN-PROPN,NUM,compound-compound-nsubjpass,pobj,NNP-NNP-NNP,CD,2,1
1,7.0,22,absorbed,2,21,1,-20,20,20,-19,-1,Middlesex,Greater London,LOC,LOC-LOC,PROPN,PROPN-PROPN,pobj,compound-nsubj,NNP,NNP-NNP,2,1
2,8.0,38,transferred,30,28,37,9,27,0,2,7,Spelthorne,Surrey,LOC,LOC,PROPN,PROPN,pobj,pobj,NNP,NNP,2,1
0,0.0,27,is,3,1,23,22,0,3,2,20,Carrick,County Tipperary,LOC,LOC-LOC,PROPN,PROPN-PROPN,pobj,compound-pobj,NNP,NNP-NNP,12,1
1,0.0,27,is,3,1,26,25,0,0,2,23,Carrick,Ireland,LOC,LOC,PROPN,PROPN,pobj,pobj,NNP,NNP,3,1
2,0.0,27,is,3,23,26,3,22,0,-20,23,County Tipperary,Ireland,LOC-LOC,LOC,PROPN-PROPN,PROPN,compound-pobj,pobj,NNP-NNP,NNP,11,1
3,1.0,30,is,1,16,22,6,15,7,-15,21,St. Molleran,County Waterford,LOC-LOC,LOC-LOC,PROPN-PROPN,PROPN-PROPN,compound-nsubj,compound-pobj,NNP-NNP,NNP-NNP,5,1
0,3.0,25,took,8,22,24,2,21,0,-14,16,Denver,Colorado,LOC,LOC,PROPN,PROPN,pobj,appos,NNP,NNP,9,1
0,1.0,40,was,1,10,38,28,9,1,-9,37,Easybeats,Harry Vanda,ORG,PER-PER,PROPN,PROPN-PROPN,appos,compound-appos,NNPS,NNP-NNP,7,1
1,3.0,52,was,1,12,20,8,11,31,-11,19,Easybeats,Harry Vanda,ORG,PER-PER,PROPN,PROPN-PROPN,appos,compound-pobj,NNPS,NNP-NNP,4,1
2,1.0,40,was,1,28,38,10,27,1,-27,37,Vanda & Young,Harry Vanda,ORG-ORG-ORG,PER-PER,PROPN-CCONJ-PROPN,PROPN-PROPN,appos-cc-conj,compound-appos,NNP-CC-NNP,NNP-NNP,7,1
3,3.0,52,was,1,33,20,-13,32,31,-32,19,Love Is in the Air,Harry Vanda,MISC-MISC-MISC-MISC-MISC,PER-PER,NOUN-VERB-ADP-DET-PROPN,PROPN-PROPN,nsubj-conj-prep-det-pobj,compound-pobj,NN-VBZ-IN-DT-NNP,NNP-NNP,4,1
4,4.0,30,were,3,26,28,2,25,1,-23,25,Malcolm,Angus Young,PER,PER-PER,PROPN,PROPN-PROPN,appos,compound-conj,NNP,NNP-NNP,2,1
0,0.0,16,is,3,13,15,2,12,0,-10,12,Milwaukee,Wisconsin,LOC,LOC,PROPN,PROPN,pobj,appos,NNP,NNP,7,1
1,5.0,32,was,7,19,22,3,18,9,-12,15,Milwaukee,Wisconsin,LOC,LOC,PROPN,PROPN,pobj,conj,NNP,NNP,8,1
0,3.0,36,was,2,24,28,4,23,7,-22,26,Supersonic,Shakermaker,MISC,MISC,PROPN,NOUN,appos,appos,NNP,NN,9,1
1,3.0,36,was,2,28,33,5,27,2,-26,31,Shakermaker,Live Forever,MISC,MISC-MISC,NOUN,ADJ-PROPN,appos,compound-conj,NN,JJ-NNP,3,1
0,0.0,39,was,22,1,4,3,0,34,21,-18,André Obey,8 May 1892,PER-PER,TIME-TIME-TIME,PROPN-PROPN,NUM-PROPN-NUM,compound-nsubj,nummod-appos-nummod,NNP-NNP,CD-NNP-CD,2,1
1,0.0,39,was,22,1,8,7,0,30,21,-14,André Obey,Douai,PER-PER,LOC,PROPN-PROPN,PROPN,compound-nsubj,pobj,NNP-NNP,NNP,4,1
2,0.0,39,was,22,1,10,9,0,28,21,-12,André Obey,France,PER-PER,LOC,PROPN-PROPN,PROPN,compound-nsubj,compound,NNP-NNP,NNP,4,1
3,0.0,39,was,22,1,12,11,0,26,21,-10,André Obey,11 April 1975,PER-PER,TIME-TIME-TIME,PROPN-PROPN,NUM-PROPN-NUM,compound-nsubj,nummod-npadvmod-nummod,NNP-NNP,CD-NNP-CD,4,1
4,0.0,39,was,22,1,16,15,0,22,21,-6,André Obey,Montsoreau,PER-PER,LOC,PROPN-PROPN,PROPN,compound-nsubj,pobj,NNP-NNP,NNP,5,1
5,0.0,39,was,22,1,26,25,0,12,21,4,André Obey,French,PER-PER,LOC,PROPN-PROPN,ADJ,compound-nsubj,amod,NNP-NNP,JJ,3,1
6,0.0,39,was,22,8,10,2,7,28,14,-12,Douai,France,LOC,LOC,PROPN,PROPN,pobj,compound,NNP,NNP,2,1
0,0.0,19,is,13,1,7,6,0,11,12,-6,Tapash Baisya,25 December 1982,PER-PER,TIME-TIME-TIME,PROPN-PROPN,NUM-PROPN-NUM,compound-nsubj,nummod-npadvmod-nummod,NNP-NNP,CD-NNP-CD,2,1
1,0.0,19,is,13,1,12,11,0,6,12,-1,Tapash Baisya,Sylhet,PER-PER,LOC,PROPN-PROPN,PROPN,compound-nsubj,pobj,NNP-NNP,NNP,2,1
0,0.0,26,is,4,13,17,4,12,8,-9,13,Cornwall,UK,LOC,LOC,PROPN,PROPN,pobj,conj,NNP,NNP,2,1
1,0.0,26,is,4,15,17,2,14,8,-11,13,England,UK,LOC,LOC,PROPN,PROPN,conj,conj,NNP,NNP,3,1
0,0.0,50,DeBlanc,2,1,5,4,0,44,1,3,Jefferson Joseph DeBlanc,"February 15 , 1921",PER-PER-PER,TIME-TIME-TIME-TIME,PROPN-PROPN-PROPN,PROPN-NUM-PUNCT-NUM,compound-compound-ROOT,appos-nummod-punct-nummod,NNP-NNP-NNP,"NNP-CD-,-CD",3,1
1,0.0,50,DeBlanc,2,1,10,9,0,39,1,8,Jefferson Joseph DeBlanc,"November 22 , 2007",PER-PER-PER,TIME-TIME-TIME-TIME,PROPN-PROPN-PROPN,PROPN-NUM-PUNCT-NUM,compound-compound-ROOT,nsubj-nummod-punct-npadvmod,NNP-NNP-NNP,"NNP-CD-,-CD",3,1
2,0.0,50,DeBlanc,2,1,20,19,0,29,1,18,Jefferson Joseph DeBlanc,World War II,PER-PER-PER,MISC-MISC-MISC,PROPN-PROPN-PROPN,PROPN-PROPN-PROPN,compound-compound-ROOT,compound-compound-compound,NNP-NNP-NNP,NNP-NNP-NNP,5,1
3,0.0,50,DeBlanc,2,1,23,22,0,26,1,21,Jefferson Joseph DeBlanc,Marine Corps,PER-PER-PER,ORG-ORG,PROPN-PROPN-PROPN,PROPN-PROPN,compound-compound-ROOT,compound-compound,NNP-NNP-NNP,NNP-NNP,4,1
0,0.0,31,was,14,1,5,4,0,25,13,-9,R Adams Cowley,"July 25 , 1917",PER-PER-PER,TIME-TIME-TIME-TIME,PROPN-PROPN-PROPN,PROPN-NUM-PUNCT-NUM,compound-compound-nsubj,npadvmod-nummod-punct-nummod,NNP-NNP-NNP,"NNP-CD-,-CD",3,1
1,0.0,31,was,14,1,10,9,0,20,13,-4,R Adams Cowley,"October 27 , 1991",PER-PER-PER,TIME-TIME-TIME-TIME,PROPN-PROPN-PROPN,PROPN-NUM-PUNCT-NUM,compound-compound-nsubj,appos-nummod-punct-nummod,NNP-NNP-NNP,"NNP-CD-,-CD",3,1
2,0.0,31,was,14,1,17,16,0,13,13,3,R Adams Cowley,American,PER-PER-PER,LOC,PROPN-PROPN-PROPN,ADJ,compound-compound-nsubj,amod,NNP-NNP-NNP,JJ,3,1
0,0.0,27,is,1,12,16,4,11,10,-11,15,Jo Daviess County,Illinois,LOC-LOC-LOC,LOC,PROPN-PROPN-PROPN,PROPN,compound-compound-pobj,appos,NNP-NNP-NNP,NNP,4,1
1,3.0,20,was,6,6,8,2,5,11,0,2,Galena,the United States,LOC,LOC-LOC-LOC,PROPN,DET-PROPN-PROPN,nsubj,det-compound-pobj,NNP,DT-NNP-NNP,1,1
2,5.0,19,emerged,2,15,18,3,14,0,-13,16,St. Louis,Missouri,LOC-LOC,LOC,PROPN-PROPN,PROPN,compound-pobj,appos,NNP-NNP,NNP,4,1
0,3.0,33,took,9,27,30,3,26,2,-18,21,Dead Kennedys,East Bay Ray,ORG-ORG,PER-PER-PER,PROPN-PROPN,PROPN-PROPN-PROPN,compound-compound,compound-compound-pobj,NNP-NNP,NNP-NNP-NNP,3,1
1,6.0,20,is,3,3,8,5,2,11,0,5,Biafra,the United States,PER,LOC-LOC-LOC,PROPN,DET-PROPN-PROPN,nsubj,det-compound-pobj,NNP,DT-NNP-NNP,4,1
2,6.0,20,is,3,9,8,-1,8,11,-6,5,Green Party,the United States,ORG-ORG,LOC-LOC-LOC,PROPN-PROPN,DET-PROPN-PROPN,compound-pobj,det-compound-pobj,NNP-NNP,DT-NNP-NNP,1,1
0,0.0,15,"""",0,2,13,11,1,1,-2,13,Lego House,Ed Sheeran,MISC-MISC,PER-PER,PROPN-PROPN,PROPN-PROPN,compound-nsubj,compound-pobj,NNP-NNP,NNP-NNP,4,1
0,0.0,31,was,12,1,5,4,0,25,11,-7,Heinrich Rudolf Hildebrand,13 March 1824,PER-PER-PER,TIME-TIME-TIME,PROPN-PROPN-PROPN,NUM-PROPN-NUM,compound-compound-nsubj,nummod-appos-nummod,NNP-NNP-NNP,CD-NNP-CD,2,1
1,0.0,31,was,12,1,9,8,0,21,11,-3,Heinrich Rudolf Hildebrand,28 October 1894,PER-PER-PER,TIME-TIME-TIME,PROPN-PROPN-PROPN,NUM-PROPN-NUM,compound-compound-nsubj,nummod-npadvmod-nummod,NNP-NNP-NNP,CD-NNP-CD,3,1
2,2.0,16,born,3,1,6,5,0,9,2,3,Rudolf Hildebrand,Leipzig,PER-PER,LOC,PROPN-PROPN,PROPN,compound-nsubjpass,pobj,NNP-NNP,NNP,3,1
3,3.0,11,attended,1,4,6,2,3,4,-3,5,Thomasschule,Leipzig,ORG,LOC,PROPN,PROPN,dobj,pobj,NNP,NNP,3,1
0,0.0,19,is,9,1,6,5,0,12,8,-3,Ann Karindi Mwangi,8 December 1988,PER-PER-PER,TIME-TIME-TIME,PROPN-PROPN-PROPN,NUM-PROPN-NUM,compound-compound-nsubj,nummod-npadvmod-nummod,NNP-NNP-NNP,CD-NNP-CD,3,1
1,0.0,19,is,9,1,12,11,0,6,8,3,Ann Karindi Mwangi,Kenyan,PER-PER-PER,LOC,PROPN-PROPN-PROPN,ADJ,compound-compound-nsubj,nmod,NNP-NNP-NNP,JJ,4,1
2,2.0,21,moved,9,17,12,-5,16,8,-8,3,Toyota Industries,Japan,ORG-ORG,LOC,PROPN-PROPN,PROPN,nmod-nmod,pobj,NNP-NNPS,NNP,5,1
3,2.0,21,moved,9,2,4,2,1,16,7,-5,Nyahururu,Kenya,LOC,LOC,PROPN,PROPN,pobj,poss,NNP,NNP,3,1
4,2.0,21,moved,9,4,6,2,3,14,5,-3,Kenya,Laikipia County,LOC,LOC-LOC,PROPN,PROPN-PROPN,poss,compound-pobj,NNP,NNP-NNP,2,1
0,1.0,28,released,3,6,9,3,5,18,-3,6,4AD,UK,ORG,LOC,NUM,PROPN,pobj,pobj,CD,NNP,2,1
1,3.0,28,include,3,13,10,-3,12,17,-10,7,R.E.M.,Michael Stipe,ORG,PER-PER,PROPN,PROPN-PROPN,pobj,compound-conj,NNP,NNP-NNP,4,1
0,0.0,26,was,20,23,26,3,22,-1,-3,6,American,U.S.,LOC,LOC,ADJ,PROPN,amod,conj,JJ,NNP,-1,1
0,0.0,35,"""",0,2,31,29,1,3,-2,31,You Would n't Know Love,Heart of Stone,MISC-MISC-MISC-MISC-MISC,MISC-MISC-MISC,PRON-VERB-ADV-VERB-PROPN,PROPN-ADP-PROPN,nsubj-aux-neg-compound-appos,nmod-prep-pobj,PRP-MD-RB-VB-NNP,NNP-IN-NNP,9,1
1,4.0,30,certified,4,10,21,11,9,8,-6,17,RIAA,U.S.,ORG,LOC,PROPN,PROPN,pobj,pobj,NNP,NNP,8,1
0,0.0,16,is,4,1,10,9,0,5,3,6,Lake Abitibi,Ontario,LOC-LOC,LOC,PROPN-PROPN,PROPN,compound-nsubj,pobj,NNP-NNP,NNP,5,1
1,0.0,16,is,4,1,13,12,0,2,3,9,Lake Abitibi,Quebec,LOC-LOC,LOC,PROPN-PROPN,PROPN,compound-nsubj,conj,NNP-NNP,NNP,6,1
2,0.0,16,is,4,1,15,14,0,0,3,11,Lake Abitibi,Canada,LOC-LOC,LOC,PROPN-PROPN,PROPN,compound-nsubj,appos,NNP-NNP,NNP,2,1
3,0.0,16,is,4,10,15,5,9,0,-6,11,Ontario,Canada,LOC,LOC,PROPN,PROPN,pobj,appos,NNP,NNP,5,1
4,0.0,16,is,4,13,15,2,12,0,-9,11,Quebec,Canada,LOC,LOC,PROPN,PROPN,conj,appos,NNP,NNP,6,1
5,5.0,19,is,2,11,17,6,10,1,-9,15,Moose River,James Bay,LOC-LOC,LOC-LOC,PROPN-PROPN,PROPN-PROPN,compound-appos,compound-pobj,NNP-NNP,NNP-NNP,3,1
6,5.0,19,is,2,11,5,-6,10,13,-9,3,Moose River,Abitibi River,LOC-LOC,LOC-LOC,PROPN-PROPN,PROPN-PROPN,compound-appos,compound-attr,NNP-NNP,NNP-NNP,2,1
0,0.0,28,is,7,1,1,0,0,26,6,-6,The Best of the Art of Noise,The Art of Noise,MISC-MISC-MISC-MISC-MISC-MISC-MISC,ORG-ORG-ORG-ORG,DET-ADJ-ADP-DET-PROPN-ADP-PROPN,DET-PROPN-ADP-PROPN,det-nsubj-prep-det-pobj-prep-pobj,det-appos-prep-pobj,DT-JJS-IN-DT-NNP-IN-NNP,DT-NNP-IN-NNP,0,1
1,6.0,63,reissued,5,13,4,-9,12,58,-8,-1,Yebo,China Records,MISC,ORG-ORG,PROPN,PROPN-PROPN,dobj,compound-nsubj,NNP,NNP-NNPS,3,1
2,6.0,63,reissued,5,17,4,-13,16,58,-12,-1,Instruments of Darkness,China Records,MISC-MISC-MISC,ORG-ORG,NOUN-ADP-PROPN,PROPN-PROPN,dobj-prep-pobj,compound-nsubj,NNS-IN-NNP,NNP-NNPS,4,1
3,6.0,63,reissued,5,23,4,-19,22,58,-18,-1,Robinson Crusoe,China Records,MISC-MISC,ORG-ORG,PROPN-PROPN,PROPN-PROPN,compound-conj,compound-nsubj,NNP-NNP,NNP-NNPS,4,1
4,6.0,63,reissued,5,46,42,-4,45,20,-41,37,Beatbox,1988,MISC,TIME,PROPN,NUM,npadvmod,nummod,NNP,CD,2,1
5,6.0,63,reissued,5,50,42,-8,49,20,-45,37,Moments in Love,1988,MISC-MISC-MISC,TIME,NOUN-ADP-NOUN,NUM,appos-prep-pobj,nummod,NNS-IN-NN,CD,3,1
0,0.0,22,is,10,1,13,12,0,8,9,3,Burwell Otis Jones,American,PER-PER-PER,LOC,PROPN-PROPN-PROPN,ADJ,compound-compound-nsubj,amod,NNP-NNP-NNP,JJ,4,1
1,1.0,49,At,0,4,3,-1,3,45,-4,3,Pan American Games,1951,MISC-MISC-MISC,TIME,PROPN-PROPN-PROPN,NUM,compound-compound-dep,pobj,NNP-NNP-NNPS,CD,2,1
2,1.0,49,At,0,9,12,3,8,36,-9,12,Buenos Aires,Argentina,LOC-LOC,LOC,PROPN-PROPN,PROPN,compound-pobj,appos,NNP-NNP,NNP,6,1
3,2.0,32,At,0,7,9,2,6,22,-7,9,Helsinki,Finland,LOC,LOC,PROPN,PROPN,pobj,conj,NNP,NNP,6,1
4,4.0,32,attended,1,1,4,3,0,27,0,3,Jones,University of Michigan,PER,ORG-ORG-ORG,PROPN,PROPN-ADP-PROPN,nsubj,dobj-prep-pobj,NNP,NNP-IN-NNP,2,1
0,0.0,35,is,10,1,9,8,0,25,9,-1,Carry on at Your Convenience,1971,MISC-MISC-MISC-MISC-MISC,TIME,VERB-PART-ADP-DET-PROPN,NUM,nsubj-prt-prep-poss-pobj,pobj,VB-RP-IN-PRP$-NNP,CD,3,1
1,0.0,35,is,10,1,1,0,0,33,9,-9,Carry on at Your Convenience,Carry On,MISC-MISC-MISC-MISC-MISC,MISC-MISC,VERB-PART-ADP-DET-PROPN,PROPN-ADP,nsubj-prt-prep-poss-pobj,compound-pobj,VB-RP-IN-PRP$-NNP,NNP-IN,0,1
2,2.0,30,return,17,6,13,7,5,16,11,-4,Carry On Round the Bend,United Kingdom,MISC-MISC-MISC-MISC-MISC,LOC-LOC,PROPN-ADP-PROPN-DET-PROPN,PROPN-PROPN,nmod-prep-pobj-det-pobj,compound-pobj,NNP-IN-NNP-DT-NNP,NNP-NNP,4,1
0,0.0,26,is,10,2,22,20,1,3,8,12,Center for Free Enterprise,Seoul,ORG-ORG-ORG-ORG,LOC,PROPN-ADP-PROPN-PROPN,PROPN,nsubj-prep-compound-pobj,pobj,NNP-IN-NNP-NNP,NNP,7,1
1,0.0,26,is,10,22,24,2,21,1,-12,14,Seoul,South Korea,LOC,LOC-LOC,PROPN,PROPN-PROPN,pobj,compound-appos,NNP,NNP-NNP,2,1
0,4.0,29,replaced,2,20,8,-12,19,20,-18,6,Tennessee Titans,NFL,ORG-ORG,ORG,PROPN-PROPN,PROPN,compound-pobj,compound,NNP-NNPS,NNP,3,1
0,0.0,33,am,3,17,29,12,16,3,-14,26,Wann Lake Union,Germany,ORG-ORG-ORG,LOC,PROPN-PROPN-PROPN,PROPN,compound-compound-pobj,pobj,NNP-NNP-NNP,NNP,6,1
0,0.0,16,is,1,11,13,2,10,2,-10,12,Venice,Veneto,LOC,LOC,PROPN,PROPN,pobj,conj,NNP,NNP,3,1
1,0.0,16,is,1,13,15,2,12,0,-12,14,Veneto,Italy,LOC,LOC,PROPN,PROPN,conj,appos,NNP,NNP,8,1
0,3.0,13,sank,1,8,11,3,7,1,-7,10,Port Arthur,May 1904,LOC-LOC,TIME-TIME,PROPN-PROPN,PROPN-NUM,compound-pobj,pobj-nummod,NNP-NNP,NNP-CD,5,1
0,0.0,15,"""",0,2,14,12,1,0,-2,14,Harlem Shake,Baauer,MISC-MISC,PER,PROPN-PROPN,PROPN,compound-nsubj,conj,NNP-NNP,NNP,2,1
1,12.0,34,released,4,10,23,13,9,10,-6,19,Harlem Shake,Baauer,MISC-MISC,PER,PROPN-PROPN,PROPN,compound-pobj,poss,NNP-NNP,NNP,7,1
0,0.0,31,is,7,21,30,9,20,0,-14,23,San Basilio,Italy,LOC-LOC,LOC,PROPN-PROPN,PROPN,compound-pobj,appos,NNP-NNP,NNP,5,1
1,0.0,31,is,7,26,30,4,25,0,-19,23,Cagliari,Italy,LOC,LOC,PROPN,PROPN,pobj,appos,NNP,NNP,9,1
2,0.0,31,is,7,2,30,28,1,0,5,23,Sardinia,Italy,LOC,LOC,PROPN,PROPN,pobj,appos,NNP,NNP,3,1
0,0.0,25,is,1,1,17,16,0,7,0,16,Streeterville,United States,LOC,LOC-LOC,PROPN,PROPN-PROPN,nsubj,compound-conj,NNP,NNP-NNP,7,1
1,0.0,25,is,1,7,15,8,6,9,-6,14,Near North Side,Illinois,LOC-LOC-LOC,LOC,PROPN-PROPN-PROPN,PROPN,compound-compound-compound,conj,NNP-NNP-NNP,NNP,6,1
2,0.0,25,is,1,7,17,10,6,7,-6,16,Near North Side,United States,LOC-LOC-LOC,LOC-LOC,PROPN-PROPN-PROPN,PROPN-PROPN,compound-compound-compound,compound-conj,NNP-NNP-NNP,NNP-NNP,6,1
3,0.0,25,is,1,13,17,4,12,7,-12,16,Chicago,United States,LOC,LOC-LOC,PROPN,PROPN-PROPN,pobj,compound-conj,NNP,NNP-NNP,3,1
4,0.0,25,is,1,15,17,2,14,7,-14,16,Illinois,United States,LOC,LOC-LOC,PROPN,PROPN-PROPN,conj,compound-conj,NNP,NNP-NNP,2,1
0,2.0,34,enrolled,2,28,6,-22,27,27,-26,4,Daniel Solander,University of Uppsala,PER-PER,ORG-ORG-ORG,PROPN-PROPN,PROPN-ADP-PROPN,compound-conj,pobj-prep-pobj,NNP-NNP,NNP-IN-NNP,10,1
1,2.0,34,enrolled,2,31,6,-25,30,27,-29,4,Johan Peter Falk,University of Uppsala,PER-PER-PER,ORG-ORG-ORG,PROPN-PROPN-PROPN,PROPN-ADP-PROPN,compound-compound-conj,pobj-prep-pobj,NNP-NNP-NNP,NNP-IN-NNP,12,1
0,0.0,16,is,3,1,6,5,0,9,2,3,One True Love,2012,MISC-MISC-MISC,TIME,NUM-ADJ-NOUN,NUM,nummod-compound-nsubj,nummod,CD-JJ-NN,CD,5,1
1,0.0,16,is,3,1,7,6,0,8,2,4,One True Love,Philippine,MISC-MISC-MISC,LOC,NUM-ADJ-NOUN,ADJ,nummod-compound-nsubj,amod,CD-JJ-NN,JJ,5,1
2,0.0,16,is,3,1,14,13,0,1,2,11,One True Love,GMA Network,MISC-MISC-MISC,ORG-ORG,NUM-ADJ-NOUN,PROPN-PROPN,nummod-compound-nsubj,compound-pobj,CD-JJ-NN,NNP-NNP,6,1
0,0.0,12,is,2,1,9,8,0,2,1,7,Falck Group,Sesto San Giovanni,ORG-ORG,LOC-LOC-LOC,PROPN-PROPN,PROPN-PROPN-PROPN,compound-nsubj,compound-compound-pobj,NNP-NNP,NNP-NNP-NNP,6,1
1,3.0,21,founded,2,15,7,-8,14,13,-13,5,Società anonima Acciaierie e Ferriere Lombarde,Milan,ORG-ORG-ORG-ORG-ORG-ORG,LOC,PROPN-NOUN-PROPN-PROPN-PROPN-PROPN,PROPN,compound-nmod-npadvmod-compound-compound-ROOT,pobj,NNP-NN-NNP-NNP-NNP-NNP,NNP,5,1
0,0.0,31,is,10,1,6,5,0,24,9,-4,Rey Francisco Quiñones,"November 11 , 1963",PER-PER-PER,TIME-TIME-TIME-TIME,PROPN-PROPN-PROPN,PROPN-NUM-PUNCT-NUM,compound-compound-nsubj,npadvmod-nummod-punct-nummod,NNP-NNP-NNPS,"NNP-CD-,-CD",4,1
0,0.0,18,was,10,1,4,3,0,13,9,-6,Lars Sjösten,7 May 1941,PER-PER,TIME-TIME-TIME,PROPN-PROPN,NUM-PROPN-NUM,compound-nsubj,nummod-pobj-nummod,NNP-NNP,CD-NNP-CD,1,1
1,0.0,18,was,10,1,8,7,0,9,9,-2,Lars Sjösten,October 2011,PER-PER,TIME-TIME,PROPN-PROPN,PROPN-NUM,compound-nsubj,npadvmod-nummod,NNP-NNP,NNP-CD,2,1
2,0.0,18,was,10,1,13,12,0,4,9,3,Lars Sjösten,Swedish,PER-PER,LOC,PROPN-PROPN,ADJ,compound-nsubj,amod,NNP-NNP,JJ,3,1
3,1.0,6,born,2,1,5,4,0,0,1,3,Sjösten,Oskarshamn,PER,LOC,PROPN,PROPN,nsubjpass,pobj,NNP,NNP,2,1
0,0.0,18,is,10,1,6,5,0,11,9,-4,Bruno Fraga Soares,"February 27 , 1982",PER-PER-PER,TIME-TIME-TIME-TIME,PROPN-PROPN-PROPN,PROPN-NUM-PUNCT-NUM,compound-compound-nsubj,npadvmod-nummod-punct-nummod,NNP-NNP-NNPS,"NNP-CD-,-CD",4,1
0,0.0,35,is,3,1,8,7,0,26,2,5,Land and Sea,Canadian,MISC-MISC-MISC,LOC,PROPN-CCONJ-PROPN,ADJ,nsubj-cc-conj,amod,NNP-CC-NNP,JJ,6,1
1,0.0,35,is,3,8,14,6,7,20,-5,11,Canadian,Newfoundland,LOC,LOC,ADJ,PROPN,amod,pobj,JJ,NNP,6,1
2,0.0,35,is,3,8,16,8,7,18,-5,13,Canadian,Labrador,LOC,LOC,ADJ,PROPN,amod,conj,JJ,NNP,4,1
0,1.0,65,has,1,59,57,-2,58,7,-58,56,Essex,Thurrock,LOC,LOC,PROPN,PROPN,pobj,pobj,NNP,NNP,4,1
1,1.0,65,has,1,16,26,10,15,38,-15,25,Royal Borough of Greenwich,River Thames,LOC-LOC-LOC-LOC,LOC-LOC,PROPN-PROPN-ADP-PROPN,PROPN-PROPN,compound-dobj-prep-pobj,compound-pobj,NNP-NNP-IN-NNP,NNP-NNP,2,1
0,1.0,19,Land,1,1,4,3,0,14,0,3,Robertson Land,Antarctica,LOC-LOC,LOC,PROPN-PROPN,PROPN,compound-ROOT,pobj,NNP-NNP,NNP,1,1
1,8.0,22,named,2,9,19,10,8,2,-7,17,Prince Charles,Queen Elizabeth II,PER-PER,PER-PER-PER,PROPN-PROPN,PROPN-PROPN-PROPN,compound-pobj,compound-compound-pobj,NNP-NNP,NNP-NNP-NNP,4,1
0,0.0,27,is,8,1,5,4,0,21,7,-3,Ricky Quade,26 August 1950,PER-PER,TIME-TIME-TIME,PROPN-PROPN,NUM-PROPN-NUM,compound-nsubj,nummod-npadvmod-nummod,NNP-NNP,CD-NNP-CD,2,1
1,1.0,35,became,2,1,12,11,0,22,1,10,Quade,Sydney Swans,PER,ORG-ORG,NOUN,PROPN-PROPN,nsubj,compound-pobj,NNS,NNP-NNPS,6,1
2,2.0,53,supported,2,38,41,3,37,11,-36,39,Ariah Park,New South Wales,LOC-LOC,LOC-LOC-LOC,PROPN-PROPN,PROPN-PROPN-PROPN,compound-pobj,compound-compound-appos,NNP-NNP,NNP-NNP-NNP,2,1
0,0.0,23,is,1,1,4,3,0,18,0,3,Futureworld,1976,MISC,TIME,PROPN,NUM,nsubj,nummod,NNP,CD,3,1
1,0.0,23,is,1,1,12,11,0,10,0,11,Futureworld,Richard T. Heffron,MISC,PER-PER-PER,PROPN,PROPN-PROPN-PROPN,nsubj,compound-compound-pobj,NNP,NNP-NNP-NNP,5,1
2,0.0,23,is,1,1,18,17,0,4,0,17,Futureworld,Mayo Simon,MISC,PER-PER,PROPN,PROPN-PROPN,nsubj,compound-pobj,NNP,NNP-NNP,5,1
3,0.0,23,is,1,1,21,20,0,1,0,20,Futureworld,George Schenck,MISC,PER-PER,PROPN,PROPN-PROPN,nsubj,compound-conj,NNP,NNP-NNP,6,1
0,0.0,24,was,13,1,9,8,0,14,12,-4,Lin Youren,"October 12 , 2013",PER-PER,TIME-TIME-TIME-TIME,PROPN-PROPN,PROPN-NUM-PUNCT-NUM,compound-compound,appos-nummod-punct-nummod,NNP-NNP,"NNP-CD-,-CD",4,1
1,3.0,21,born,2,12,10,-2,11,10,-10,8,China,Shanghai,LOC,LOC,PROPN,PROPN,conj,pobj,NNP,NNP,4,1
2,4.0,18,studied,8,11,14,3,10,3,-3,6,Liu Shaochun,1901,PER-PER,TIME,PROPN-PROPN,NUM,compound-pobj,nummod,NNP-NNP,CD,1,1
0,0.0,10,is,2,1,5,4,0,4,1,3,Emanuele Santi,Italian,PER-PER,LOC,PROPN-PROPN,ADJ,compound-nsubj,amod,NNP-NNP,JJ,2,1
0,0.0,22,is,13,1,10,9,0,11,12,-3,Ivi Monteiro,Rio de Janeiro,PER-PER,LOC-LOC-LOC,PROPN-PROPN,PROPN-PROPN-PROPN,compound-nsubj,compound-compound-pobj,NNP-NNP,NNP-NNP-NNP,4,1
1,3.0,28,finished,14,8,11,3,7,16,6,-3,Santo Domingo,Dominican Republic,LOC-LOC,LOC-LOC,PROPN-PROPN,PROPN-PROPN,compound-pobj,compound-pobj,NNP-NNP,NNP-NNP,6,1
2,6.0,20,ended,1,16,19,3,15,0,-15,18,Porto Alegre,Brazil,LOC-LOC,LOC,PROPN-PROPN,PROPN,compound-pobj,appos,NNP-NNPS,NNP,4,1
0,1.0,22,headed,3,1,7,6,0,14,2,4,Live Labs,Gary William Flake,ORG-ORG,PER-PER-PER,PROPN-PROPN,PROPN-PROPN-PROPN,compound-nsubjpass,compound-compound-pobj,NNP-NNPS,NNP-NNP-NNP,4,1
1,6.0,19,resigned,15,4,12,8,3,6,11,-3,Live Labs,Gary William Flake,ORG-ORG,PER-PER-PER,PROPN-PROPN,PROPN-PROPN-PROPN,compound-poss,compound-compound-conj,NNP-NNPS,NNP-NNP-NNP,3,1
2,1.0,22,headed,3,7,21,14,6,0,-4,18,Gary William Flake,Yahoo,PER-PER-PER,ORG,PROPN-PROPN-PROPN,PROPN,compound-compound-pobj,pobj,NNP-NNP-NNP,NNP,4,1
0,9.0,22,impregnated,1,17,1,-16,16,20,-16,0,Nergal,Enlil,PER,PER,PROPN,PROPN,appos,nsubj,NNP,NNP,7,1
1,13.0,25,is,4,10,4,-6,9,20,-6,0,Ninurta,Ninlil,PER,PER,PROPN,PROPN,pobj,nsubj,NNP,NNP,4,1
0,0.0,20,is,9,1,12,11,0,7,8,3,Prem Bandhan,1979,MISC-MISC,TIME,PROPN-PROPN,NUM,compound-compound,nummod,NNP-NNP,CD,6,1
1,0.0,20,is,9,1,14,13,0,5,8,5,Prem Bandhan,Hindi,MISC-MISC,MISC,PROPN-PROPN,PROPN,compound-compound,compound,NNP-NNP,NNP,4,1
2,0.0,20,is,9,1,18,17,0,1,8,9,Prem Bandhan,Ramanand Sagar,MISC-MISC,PER-PER,PROPN-PROPN,PROPN-PROPN,compound-compound,compound-pobj,NNP-NNP,NNP-NNP,7,1
3,3.0,54,became,39,6,13,7,5,40,33,-26,Amar Deep,Rajesh Khanna,MISC-MISC,PER-PER,PROPN-PROPN,PROPN-PROPN,compound-pobj,compound-pobj,NNP-NNP,NNP-NNP,7,1
4,3.0,54,became,39,52,13,-39,51,40,-13,-26,Bhola Bhala,Rajesh Khanna,MISC-MISC,PER-PER,PROPN-PROPN,PROPN-PROPN,compound-pobj,compound-pobj,NNP-NNP,NNP-NNP,8,1
0,0.0,52,was,9,49,5,-44,48,46,-40,-4,Orestes,Agamemnon,PER,PER,PROPN,PROPN,conj,compound,NNPS,NNP,4,1
1,0.0,52,was,9,49,35,-14,48,16,-40,26,Orestes,Clytemnestra,PER,PER,PROPN,PROPN,conj,pobj,NNPS,NNP,8,1
2,0.0,52,was,9,5,20,15,4,31,4,11,Agamemnon,Atreus,PER,PER,PROPN,PROPN,compound,pobj,NNP,NNP,6,1
3,0.0,52,was,9,5,30,25,4,21,4,21,Agamemnon,Menelaus,PER,PER,PROPN,PROPN,compound,pobj,NNP,NNP,5,1
4,2.0,28,commanded,16,16,7,-9,15,20,0,-9,Agamemnon,Menelaus,PER,PER,PROPN,PROPN,nsubj,pobj,NNP,NNP,2,1
5,0.0,52,was,9,5,40,35,4,11,4,31,Agamemnon,Iphigenia,PER,PER,PROPN,PROPN,compound,pobj,NNP,NNP,8,1
6,0.0,52,was,9,5,42,37,4,9,4,33,Agamemnon,Electra,PER,PER,PROPN,PROPN,compound,conj,NNP,NNP,9,1
7,0.0,52,was,9,20,30,10,19,21,-11,21,Atreus,Menelaus,PER,PER,PROPN,PROPN,pobj,pobj,NNP,NNP,5,1
8,0.0,52,was,9,35,40,5,34,11,-26,31,Clytemnestra,Iphigenia,PER,PER,PROPN,PROPN,pobj,pobj,NNP,NNP,8,1
9,0.0,52,was,9,35,42,7,34,9,-26,33,Clytemnestra,Electra,PER,PER,PROPN,PROPN,pobj,conj,NNP,NNP,9,1
10,2.0,28,commanded,16,2,7,5,1,20,14,-9,Helen,Menelaus,PER,PER,PROPN,PROPN,nsubjpass,pobj,NNP,NNP,3,1
0,0.0,31,was,14,1,5,4,0,25,13,-9,Friedrich Gottlob Uhlemann,26 November 1792,PER-PER-PER,TIME-TIME-TIME,PROPN-PROPN-PROPN,NUM-PROPN-NUM,compound-compound-nsubj,nummod-appos-nummod,NNP-NNP-NNP,CD-NNP-CD,2,1
1,0.0,31,was,14,1,9,8,0,21,13,-5,Friedrich Gottlob Uhlemann,Zeitz,PER-PER-PER,LOC,PROPN-PROPN-PROPN,PROPN,compound-compound-nsubj,compound,NNP-NNP-NNP,NNP,2,1
2,0.0,31,was,14,1,11,10,0,19,13,-3,Friedrich Gottlob Uhlemann,19 April 1864,PER-PER-PER,TIME-TIME-TIME,PROPN-PROPN-PROPN,NUM-PROPN-NUM,compound-compound-nsubj,nummod-appos-nummod,NNP-NNP-NNP,CD-NNP-CD,2,1
3,0.0,31,was,14,17,18,1,16,12,-3,4,German,Protestant,LOC,ORG,ADJ,ADJ,amod,amod,JJ,JJ,1,1
4,3.0,19,From,0,14,18,4,13,0,-14,18,Friedrich Wilhelm Gymnasium,Berlin,ORG-ORG-ORG,LOC,PROPN-PROPN-PROPN,PROPN,compound-compound-pobj,pobj,NNP-NNP-NNP,NNP,5,1
0,0.0,37,Eisenberg,1,1,5,4,0,31,0,4,Leon Eisenberg,"August 8 , 1922",PER-PER,TIME-TIME-TIME-TIME,PROPN-PROPN,PROPN-NUM-PUNCT-NUM,compound-ROOT,appos-nummod-punct-nummod,NNP-NNP,"NNP-CD-,-CD",3,1
1,0.0,37,Eisenberg,1,1,10,9,0,26,0,9,Leon Eisenberg,"September 15 , 2009",PER-PER,TIME-TIME-TIME-TIME,PROPN-PROPN,PROPN-NUM-PUNCT-NUM,compound-ROOT,nsubj-nummod-punct-nummod,NNP-NNP,"NNP-CD-,-CD",4,1
2,0.0,37,Eisenberg,1,1,17,16,0,19,0,16,Leon Eisenberg,American,PER-PER,LOC,PROPN-PROPN,ADJ,compound-ROOT,amod,NNP-NNP,JJ,3,1
3,3.0,61,received,1,48,52,4,47,8,-47,51,Massachusetts General Hospital,Boston,ORG-ORG-ORG,LOC,PROPN-PROPN-PROPN,PROPN,compound-compound-conj,pobj,NNP-NNP-NNP,NNP,6,1
0,0.0,21,is,2,1,12,11,0,8,1,10,Michael Waters,My Own Private Idaho,PER-PER,MISC-MISC-MISC-MISC,PROPN-PROPN,DET-PROPN-PROPN-PROPN,compound-nsubj,poss-compound-compound-pobj,NNP-NNP,PRP$-NNP-NNP-NNP,5,1
1,0.0,21,is,2,8,12,4,7,8,-6,10,Gus Van Sant,My Own Private Idaho,PER-PER-PER,MISC-MISC-MISC-MISC,PROPN-PROPN-PROPN,DET-PROPN-PROPN-PROPN,compound-compound-poss,poss-compound-compound-pobj,NNP-NNP-NNP,PRP$-NNP-NNP-NNP,3,1
2,0.0,21,is,2,12,19,7,11,1,-10,17,My Own Private Idaho,River Phoenix,MISC-MISC-MISC-MISC,PER-PER,DET-PROPN-PROPN-PROPN,PROPN-PROPN,poss-compound-compound-pobj,compound-pobj,PRP$-NNP-NNP-NNP,NNP-NNP,6,1
3,1.0,43,is,1,22,25,3,21,17,-21,24,Scott Favor,Keanu Reeves,PER-PER,PER-PER,PROPN-PROPN,PROPN-PROPN,compound-appos,compound-appos,NNP-NNP,NNP-NNPS,1,1
0,7.0,31,change,1,17,18,1,16,12,-16,17,South Vietnam,Vietnam,LOC-LOC,LOC,PROPN-PROPN,PROPN,compound-pobj,pobj,NNP-NNP,NNP,1,1
1,7.0,31,change,1,20,21,1,19,9,-19,20,West Germany,Germany,LOC-LOC,LOC,PROPN-PROPN,PROPN,compound-conj,conj,NNP-NNP,NNP,6,1
0,0.0,35,is,10,1,7,6,0,27,9,-3,Roald Zinnurovich Sagdeev,26 December 1932,PER-PER-PER,TIME-TIME-TIME,PROPN-PROPN-PROPN,NUM-PROPN-NUM,compound-compound-nsubj,nummod-npadvmod-nummod,NNP-NNP-NNP,CD-NNP-CD,3,1
1,0.0,35,is,10,1,15,14,0,19,9,5,Roald Zinnurovich Sagdeev,Russian,PER-PER-PER,LOC,PROPN-PROPN-PROPN,ADJ,compound-compound-nsubj,conj,NNP-NNP-NNP,JJ,3,1
2,0.0,35,is,10,1,26,25,0,8,9,16,Roald Zinnurovich Sagdeev,Space Research Institute of the USSR Academy of Sciences,PER-PER-PER,ORG-ORG-ORG-ORG-ORG-ORG-ORG-ORG-ORG,PROPN-PROPN-PROPN,PROPN-PROPN-PROPN-ADP-DET-PROPN-PROPN-ADP-PROPN,compound-compound-nsubj,compound-compound-pobj-prep-det-compound-pobj-prep-pobj,NNP-NNP-NNP,NNP-NNP-NNP-IN-DT-NNP-NNP-IN-NNPS,7,1
3,1.0,13,was,1,9,11,2,8,1,-8,10,Soviet,Mikhail Gorbachev,LOC,PER-PER,ADJ,PROPN-PROPN,amod,compound-pobj,JJ,NNP-NNP,1,1
4,2.0,7,graduated,1,1,4,3,0,2,0,3,Sagdeev,Moscow State University,PER,ORG-ORG-ORG,PROPN,PROPN-PROPN-PROPN,nsubj,compound-compound-pobj,NNP,NNP-NNP-NNP,3,1
5,6.0,18,was,1,1,10,9,0,7,0,9,Sagdeev,Susan Eisenhower,PER,PER-PER,PROPN,PROPN-PROPN,nsubj,compound-npadvmod,NNP,NNP-NNP,4,1
6,7.0,25,was,1,1,15,14,0,9,0,14,Sagdeev,James Clerk Maxwell Prize in Plasma Physics,PER,MISC-MISC-MISC-MISC-MISC-MISC-MISC,PROPN,PROPN-PROPN-PROPN-PROPN-ADP-PROPN-PROPN,nsubj,compound-compound-compound-conj-prep-compound-pobj,NNP,NNP-NNP-NNP-NNP-IN-NNP-NNP,2,1
0,0.0,30,was,12,1,5,4,0,24,11,-7,Samuel Herbert Cohen,26 October 1918,PER-PER-PER,TIME-TIME-TIME,PROPN-PROPN-PROPN,NUM-PROPN-NUM,compound-compound-nsubj,nummod-appos-nummod,NNP-NNP-NNP,CD-NNP-CD,2,1
1,0.0,30,was,12,1,9,8,0,20,11,-3,Samuel Herbert Cohen,7 October 1969,PER-PER-PER,TIME-TIME-TIME,PROPN-PROPN-PROPN,NUM-PROPN-NUM,compound-compound-nsubj,nummod-appos-nummod,NNP-NNP-NNP,CD-NNP-CD,2,1
0,6.0,22,extends,2,10,21,11,9,0,-8,19,Amur River,Russia,LOC-LOC,LOC,PROPN-PROPN,PROPN,compound-compound,conj,NNP-NNP,NNP,5,1
0,0.0,16,was,11,1,4,3,0,11,10,-7,Rudolf Koechlin,11 November 1862,PER-PER,TIME-TIME-TIME,PROPN-PROPN,NUM-PROPN-NUM,compound-nsubj,nummod-appos-nummod,NNP-NNP,CD-NNP-CD,1,1
1,0.0,16,was,11,1,4,3,0,11,10,-7,Rudolf Koechlin,11 February 1939,PER-PER,TIME-TIME-TIME,PROPN-PROPN,NUM-PROPN-NUM,compound-nsubj,nummod-appos-nummod,NNP-NNP,CD-NNP-CD,1,1
2,1.0,8,born,2,1,7,6,0,0,1,5,Koechlin,Vienna,PER,LOC,PROPN,PROPN,nsubjpass,pobj,NNP,NNP,2,1
3,6.0,16,dealt,4,11,14,3,10,1,-7,10,Tauern,Austria,LOC,LOC,PROPN,PROPN,compound,pobj,NNP,NNP,4,1
0,0.0,24,Scott,2,1,17,16,0,6,1,15,Walter Irving Scott,American,PER-PER-PER,LOC,PROPN-PROPN-PROPN,ADJ,compound-compound-ROOT,amod,NNP-NNP-NNP,JJ,3,1
0,7.0,45,were,20,11,44,33,10,0,9,24,Kuusankoski,Finland,LOC,LOC,PROPN,PROPN,conj,pobj,NNP,NNP,5,1
1,7.0,45,were,20,13,44,31,12,0,7,24,Elimäki,Finland,LOC,LOC,PROPN,PROPN,conj,pobj,NNP,NNP,6,1
2,7.0,45,were,20,15,44,29,14,0,5,24,Anjalankoski,Finland,LOC,LOC,PROPN,PROPN,conj,pobj,NNP,NNP,7,1
3,7.0,45,were,20,19,44,25,18,0,1,24,Jaala,Finland,LOC,LOC,PROPN,PROPN,compound,pobj,NNP,NNP,3,1
0,0.0,37,is,2,1,14,13,0,22,1,12,Packer Park,Pennsylvania,LOC-LOC,LOC,PROPN-PROPN,PROPN,compound-nsubj,conj,NNP-NNP,NNP,8,1
1,0.0,37,is,2,1,16,15,0,20,1,14,Packer Park,United States,LOC-LOC,LOC-LOC,PROPN-PROPN,PROPN-PROPN,compound-nsubj,compound-conj,NNP-NNP,NNP-NNP,8,1
2,0.0,37,is,2,8,16,8,7,20,-6,14,South Philadelphia,United States,LOC-LOC,LOC-LOC,PROPN-PROPN,PROPN-PROPN,compound-compound,compound-conj,NNP-NNP,NNP-NNP,5,1
3,0.0,37,is,2,9,16,7,8,20,-7,14,Philadelphia,United States,LOC,LOC-LOC,PROPN,PROPN-PROPN,pobj,compound-conj,NNP,NNP-NNP,4,1
4,0.0,37,is,2,14,16,2,13,20,-12,14,Pennsylvania,United States,LOC,LOC-LOC,PROPN,PROPN-PROPN,conj,compound-conj,NNP,NNP-NNP,2,1
0,0.0,28,is,5,1,11,10,0,16,4,6,Reisa National Park,Nordreisa Municipality,LOC-LOC-LOC,LOC-LOC,PROPN-PROPN-PROPN,PROPN-PROPN,compound-compound-nsubj,compound-pobj,NNP-NNP-NNP,NNP-NNP,5,1
1,0.0,28,is,5,1,17,16,0,10,4,12,Reisa National Park,Norway,LOC-LOC-LOC,LOC,PROPN-PROPN-PROPN,PROPN,compound-compound-nsubj,npadvmod,NNP-NNP-NNP,NNP,4,1
2,0.0,28,is,5,1,25,24,0,2,4,20,Reisa National Park,28 November 1986,LOC-LOC-LOC,TIME-TIME-TIME,PROPN-PROPN-PROPN,NUM-PROPN-NUM,compound-compound-nsubj,nummod-pobj-nummod,NNP-NNP-NNP,CD-NNP-CD,5,1
3,0.0,28,is,5,11,14,3,10,13,-6,9,Nordreisa Municipality,Troms,LOC-LOC,LOC,PROPN-PROPN,PROPN,compound-pobj,compound,NNP-NNP,NNP,2,1
4,0.0,28,is,5,11,17,6,10,10,-6,12,Nordreisa Municipality,Norway,LOC-LOC,LOC,PROPN-PROPN,PROPN,compound-pobj,npadvmod,NNP-NNP,NNP,7,1
5,0.0,28,is,5,14,17,3,13,10,-9,12,Troms,Norway,LOC,LOC,PROPN,PROPN,compound,npadvmod,NNP,NNP,9,1
6,15.0,30,are,22,12,16,4,11,13,10,-6,Kautokeino,Finnmark county,LOC,LOC-LOC,PROPN,PROPN-NOUN,compound,compound-pobj,NNP,NNP-NN,2,1
7,16.0,10,is,1,5,9,4,4,0,-4,8,Käsivarsi Wilderness Area,Finland,LOC-LOC-LOC,LOC,PROPN-PROPN-PROPN,PROPN,compound-compound-pobj,pobj,NNP-NNP-NNP,NNP,5,1
0,0.0,24,L'Escala,0,3,21,18,2,2,-3,21,Spanish,Catalonia,MISC,LOC,NOUN,PROPN,appos,conj,NN,NNP,12,1
1,0.0,24,L'Escala,0,3,23,20,2,0,-3,23,Spanish,Spain,MISC,LOC,NOUN,PROPN,appos,appos,NN,NNP,4,1
2,0.0,24,L'Escala,0,16,19,3,15,4,-16,19,Alt Empordà,Girona,LOC-LOC,LOC,PROPN-PROPN,PROPN,compound-pobj,pobj,NNP-NNP,NNP,3,1
3,0.0,24,L'Escala,0,16,23,7,15,0,-16,23,Alt Empordà,Spain,LOC-LOC,LOC,PROPN-PROPN,PROPN,compound-pobj,appos,NNP-NNP,NNP,6,1
4,0.0,24,L'Escala,0,19,23,4,18,0,-19,23,Girona,Spain,LOC,LOC,PROPN,PROPN,pobj,appos,NNP,NNP,9,1
5,0.0,24,L'Escala,0,21,23,2,20,0,-21,23,Catalonia,Spain,LOC,LOC,PROPN,PROPN,conj,appos,NNP,NNP,10,1
0,0.0,50,was,16,11,29,18,10,20,5,13,German Empire,Kaiser Wilhelm II,LOC-LOC,PER-PER-PER,PROPN-PROPN,PROPN-PROPN-PROPN,amod-pobj,compound-compound-pobj,NNP-NNP,NNP-NNP-NNP,13,1
0,0.0,20,is,5,2,16,14,1,3,3,11,Bonaparte Pottery Archeological District,Iowa,LOC-LOC-LOC-LOC,LOC,PROPN-PROPN-PROPN-PROPN,PROPN,compound-compound-compound-nsubj,conj,NNP-NNP-NNP-NNP,NNP,8,1
1,0.0,20,is,5,2,18,16,1,1,3,13,Bonaparte Pottery Archeological District,United States,LOC-LOC-LOC-LOC,LOC-LOC,PROPN-PROPN-PROPN-PROPN,PROPN-PROPN,compound-compound-compound-nsubj,compound-appos,NNP-NNP-NNP-NNP,NNP-NNP,7,1
2,0.0,20,is,5,2,18,16,1,1,3,13,Bonaparte,United States,LOC,LOC-LOC,PROPN,PROPN-PROPN,pobj,compound-appos,NNP,NNP-NNP,7,1
3,0.0,20,is,5,16,18,2,15,1,-11,13,Iowa,United States,LOC,LOC-LOC,PROPN,PROPN-PROPN,conj,compound-appos,NNP,NNP-NNP,3,1
0,0.0,22,is,3,1,6,5,0,15,2,3,The Beverly Hillbillies,American,MISC-MISC-MISC,LOC,DET-PROPN-PROPN,ADJ,det-compound-nsubj,amod,DT-NNP-NNPS,JJ,3,1
1,0.0,22,is,3,1,17,16,0,4,2,14,The Beverly Hillbillies,CBS,MISC-MISC-MISC,ORG,DET-PROPN-PROPN,PROPN,det-compound-nsubj,pobj,DT-NNP-NNPS,NNP,6,1
2,3.0,48,followed,2,45,16,-29,44,31,-43,14,The Beverly Hillbillies,CBS,MISC-MISC-MISC,ORG,DET-PROPN-PROPN,PROPN,det-compound-pobj,pobj,DT-NNP-NNPS,NNP,8,1
3,0.0,22,is,3,1,19,18,0,2,2,16,The Beverly Hillbillies,1962,MISC-MISC-MISC,TIME,DET-PROPN-PROPN,NUM,det-compound-nsubj,pobj,DT-NNP-NNPS,CD,7,1
4,0.0,22,is,3,1,21,20,0,0,2,18,The Beverly Hillbillies,1971,MISC-MISC-MISC,TIME,DET-PROPN-PROPN,NUM,det-compound-nsubj,pobj,DT-NNP-NNPS,CD,3,1
5,3.0,48,followed,2,18,16,-2,17,31,-16,14,Petticoat Junction,CBS,MISC-MISC,ORG,PROPN-PROPN,PROPN,compound-appos,pobj,NNP-NNP,NNP,2,1
6,3.0,48,followed,2,26,16,-10,25,31,-24,14,Green Acres,CBS,MISC-MISC,ORG,PROPN-PROPN,PROPN,compound-conj,pobj,NNP-NNP,NNP,3,1
0,0.0,34,was,14,5,19,14,4,14,9,5,Mahabharata,Virata,MISC,PER,PROPN,PROPN,nsubj,pobj,NNP,NNP,5,1
1,9.0,39,engaged,32,14,18,4,13,20,18,-14,Ashwathama,Dronacharya,PER,PER,PROPN,PROPN,appos,pobj,NNP,NNP,5,1
0,0.0,25,is,8,1,15,14,0,9,7,7,Athetis hospes,Noctuidae,MISC-MISC,MISC,NOUN-NOUN,PROPN,amod-nsubj,appos,NN-NNS,NNP,6,1
0,2.0,23,intervened,2,6,10,4,5,12,-4,8,Second Congo War,1998,MISC-MISC-MISC,TIME,PROPN-PROPN-PROPN,NUM,compound-compound-pobj,pobj,NNP-NNP-NNP,CD,4,1
0,0.0,31,is,10,18,22,4,17,8,-8,12,Colombia,Bolívar Department,LOC,LOC-LOC,PROPN,PROPN-PROPN,pobj,compound-pobj,NNP,NNP-NNP,3,1
0,0.0,14,is,2,1,11,10,0,2,1,9,Inner Harbour,Ontario,LOC-LOC,LOC,PROPN-PROPN,PROPN,compound-nsubj,conj,NNP-NNP,NNP,7,1
1,0.0,14,is,2,1,13,12,0,0,1,11,Inner Harbour,Canada,LOC-LOC,LOC,PROPN-PROPN,PROPN,compound-nsubj,appos,NNP-NNP,NNP,2,1
2,0.0,14,is,2,9,13,4,8,0,-7,11,Kingston,Canada,LOC,LOC,PROPN,PROPN,pobj,appos,NNP,NNP,6,1
3,0.0,14,is,2,11,13,2,10,0,-9,11,Ontario,Canada,LOC,LOC,PROPN,PROPN,conj,appos,NNP,NNP,7,1
4,11.0,28,is,16,2,23,21,1,4,14,7,La Salle Causeway,Kingston,LOC-LOC-LOC,LOC,PROPN-PROPN-PROPN,PROPN,compound-compound-nsubj,pobj,NNP-NNP-NNP,NNP,6,1
0,0.0,20,are,8,1,17,16,0,2,7,9,Pnau,Sydney,ORG,LOC,PROPN,PROPN,nsubj,pobj,NNP,NNP,8,1
1,0.0,20,are,8,7,17,10,6,2,1,9,PNAU,Sydney,ORG,LOC,PROPN,PROPN,pobj,pobj,NNP,NNP,6,1
2,0.0,20,are,8,17,19,2,16,0,-9,11,Sydney,Australia,LOC,LOC,PROPN,PROPN,pobj,appos,NNP,NNP,6,1
3,5.0,32,appears,11,19,9,-10,18,22,-8,-2,Empire of the Sun,Nick Littlemore,ORG-ORG-ORG-ORG,PER-PER,PROPN-ADP-DET-PROPN,PROPN-PROPN,appos-prep-det-pobj,compound-nsubj,NNP-IN-DT-NNP,NNP-NNP,6,1
0,11.0,29,headquartered,3,7,9,2,6,19,-4,6,Bronx,New York,LOC,LOC-LOC,PROPN,PROPN-PROPN,pobj,compound-appos,NNP,NNP-NNP,2,1
0,5.0,39,filmed,3,15,17,2,14,21,-12,14,Berlin,Germany,LOC,LOC,PROPN,PROPN,pobj,appos,NNP,NNP,2,1
1,5.0,39,filmed,3,20,22,2,19,16,-17,19,Copenhagen,Denmark,LOC,LOC,PROPN,PROPN,conj,appos,NNP,NNP,2,1
2,5.0,39,filmed,3,25,27,2,24,11,-22,24,Stockholm,Sweden,LOC,LOC,PROPN,PROPN,pobj,appos,NNP,NNP,2,1
3,5.0,39,filmed,3,30,32,2,29,6,-27,29,Oslo,Norway,LOC,LOC,PROPN,PROPN,conj,appos,NNP,NNP,2,1
0,0.0,36,died,10,1,5,4,0,30,9,-5,Pietro Caruso,10 November 1899,PER-PER,TIME-TIME-TIME,PROPN-PROPN,NUM-PROPN-NUM,compound-nsubj,nummod-npadvmod-nummod,NNP-NNP,CD-NNP-CD,2,1
1,0.0,36,died,10,1,9,8,0,26,9,-1,Pietro Caruso,Maddaloni,PER-PER,LOC,PROPN-PROPN,PROPN,compound-nsubj,pobj,NNP-NNP,NNP,1,1
2,0.0,36,died,10,1,12,11,0,23,9,2,Pietro Caruso,22 September 1944,PER-PER,TIME-TIME-TIME,PROPN-PROPN,NUM-PROPN-NUM,compound-nsubj,nummod-npadvmod-nummod,NNP-NNP,CD-NNP-CD,2,1
3,0.0,36,died,10,1,33,32,0,2,9,23,Pietro Caruso,World War II,PER-PER,MISC-MISC-MISC,PROPN-PROPN,PROPN-PROPN-PROPN,compound-nsubj,compound-compound-pobj,NNP-NNP,NNP-NNP-NNP,7,1
0,0.0,18,is,3,2,16,14,1,1,1,13,Christian Shephard,John Terry,PER-PER,PER-PER,PROPN-PROPN,PROPN-PROPN,compound-nsubj,compound-pobj,NNP-NNP,NNP-NNP,8,1
1,1.0,50,is,1,8,11,3,7,38,-7,10,Jack Shephard,Matthew Fox,PER-PER,PER-PER,PROPN-PROPN,PROPN-PROPN,compound-appos,compound-appos,NNP-NNP,NNP-NNP,3,1
2,1.0,50,is,1,35,38,3,34,11,-34,37,Claire Littleton,Emilie de Ravin,PER-PER,PER-PER-PER,PROPN-PROPN,PROPN-PROPN-PROPN,compound-conj,compound-compound-appos,NNP-NNP,NNP-NNP-NNP,2,1
3,3.0,35,featured,10,30,32,2,29,2,-20,22,Jacob,Mark Pellegrino,PER,PER-PER,PROPN,PROPN-PROPN,appos,compound-appos,NNP,NNP-NNP,1,1
4,4.0,35,admitted,16,7,11,4,6,23,9,-5,Man in Black,Titus Welliver,PER-PER-PER,PER-PER,PROPN-ADP-PROPN,PROPN-PROPN,nsubj-prep-pobj,nmod-nmod,NNP-IN-NNP,NNP-NNP,3,1
5,4.0,35,admitted,16,7,14,7,6,20,9,-2,Man in Black,Terry O'Quinn,PER-PER-PER,PER-PER,PROPN-ADP-PROPN,PROPN-PROPN,nsubj-prep-pobj,compound-appos,NNP-IN-NNP,NNP-NNP,2,1
0,0.0,25,had,17,2,5,3,1,19,15,-12,Oruanui,New Zealand,LOC,LOC-LOC,PROPN,PROPN-PROPN,compound,compound-poss,NNP,NNP-NNP,3,1
1,10.0,36,had,4,17,34,17,16,1,-13,30,Waikato River,Tasman Sea,LOC-LOC,LOC-LOC,PROPN-PROPN,PROPN-PROPN,compound-nsubj,compound-pobj,NNP-NNP,NNP-NNP,3,1
2,10.0,36,had,4,17,34,17,16,1,-13,30,Waikato,Tasman Sea,LOC,LOC-LOC,PROPN,PROPN-PROPN,pobj,compound-pobj,NNP,NNP-NNP,3,1
0,0.0,22,is,8,7,12,5,6,9,1,4,Kobelco,Japanese,ORG,LOC,PROPN,ADJ,pobj,amod,NNP,JJ,3,1
1,0.0,22,is,8,7,21,14,6,0,1,13,Kobelco,Kobe,ORG,LOC,PROPN,PROPN,pobj,appos,NNP,NNP,2,1
0,0.0,33,"""",0,2,21,19,1,11,-2,21,"Cripples , Bastards , and Broken Things",Game of Thrones,MISC-MISC-MISC-MISC-MISC-MISC-MISC,MISC-MISC-MISC,NOUN-PUNCT-PROPN-PUNCT-CCONJ-PROPN-NOUN,PROPN-ADP-PROPN,nsubj-punct-conj-punct-cc-compound-conj,appos-prep-pobj,"NNS-,-NNPS-,-CC-NNP-NNS",NNP-IN-NNP,7,1
1,5.0,21,ends,2,8,20,12,7,0,-6,18,Catelyn,Bran,PER,PER,PROPN,PROPN,nsubj,appos,NNP,NNP,2,1
2,5.0,21,ends,2,8,5,-3,7,15,-6,3,Catelyn,Eddard,PER,PER,PROPN,PROPN,nsubj,poss,NNP,NNP,5,1
3,5.0,21,ends,2,20,5,-15,19,15,-18,3,Bran,Eddard,PER,PER,PROPN,PROPN,appos,poss,NNP,NNP,5,1
4,7.0,47,was,5,32,27,-5,31,19,-27,22,Catelyn Stark,Michelle Fairley,PER-PER,PER-PER,PROPN-PROPN,PROPN-PROPN,compound-pobj,compound-poss,NNP-NNP,NNP-NNP,3,1
5,7.0,47,was,5,45,42,-3,44,4,-40,37,Tyrion Lannister,Peter Dinklage,PER-PER,PER-PER,PROPN-PROPN,PROPN-PROPN,compound-pobj,compound-pobj,NNP-NNP,NNP-NNP,2,1
0,0.0,67,is,20,11,56,45,10,10,9,36,Hanga Roa,Easter Island,LOC-LOC,LOC-LOC,PROPN-PROPN,PROPN-PROPN,compound-pobj,compound-pobj,NNP-NNP,NNP-NNP,18,1
1,0.0,67,is,20,11,62,51,10,4,9,42,Hanga Roa,Chile,LOC-LOC,LOC,PROPN-PROPN,PROPN,compound-pobj,pobj,NNP-NNP,NNP,20,1
2,0.0,67,is,20,11,65,54,10,1,9,45,Hanga Roa,Pacific Ocean,LOC-LOC,LOC-LOC,PROPN-PROPN,PROPN-PROPN,compound-pobj,compound-pobj,NNP-NNP,NNP-NNP,21,1
3,0.0,67,is,20,56,62,6,55,4,-36,42,Easter Island,Chile,LOC-LOC,LOC,PROPN-PROPN,PROPN,compound-pobj,pobj,NNP-NNP,NNP,2,1
4,0.0,67,is,20,56,65,9,55,1,-36,45,Easter Island,Pacific Ocean,LOC-LOC,LOC-LOC,PROPN-PROPN,PROPN-PROPN,compound-pobj,compound-pobj,NNP-NNP,NNP-NNP,3,1
0,0.0,24,is,3,1,6,5,0,17,2,3,Miriam Christine Borg,Maltese,PER-PER-PER,LOC,PROPN-PROPN-PROPN,ADJ,compound-compound-nsubj,amod,NNP-NNP-NNP,JJ,3,1
1,0.0,24,is,3,20,23,3,19,0,-17,20,Eurovision Song Contest,1996,MISC-MISC-MISC,TIME,PROPN-PROPN-PROPN,NUM,compound-compound-pobj,appos,NNP-NNP-NNP,CD,8,1
2,2.0,32,took,1,21,20,-1,20,11,-20,19,Eurovision Song Contest,1996,MISC-MISC-MISC,TIME,PROPN-PROPN-PROPN,NUM,compound-compound-pobj,nummod,NNP-NNP-NNP,CD,1,1
3,1.0,22,born,3,1,6,5,0,15,2,3,Miriam Christine,Santo Antônio do Descoberto,PER-PER,LOC-LOC-LOC-LOC,PROPN-PROPN,PROPN-PROPN-VERB-PROPN,compound-nsubjpass,compound-pobj-dep-dobj,NNP-NNP,NNP-NNP-VB-NNP,3,1
4,1.0,22,born,3,1,11,10,0,10,2,8,Miriam Christine,Goiás,PER-PER,LOC,PROPN-PROPN,PROPN,compound-nsubjpass,conj,NNP-NNP,NNP,5,1
5,1.0,22,born,3,6,11,5,5,10,-3,8,Santo Antônio do Descoberto,Goiás,LOC-LOC-LOC-LOC,LOC,PROPN-PROPN-VERB-PROPN,PROPN,compound-pobj-dep-dobj,conj,NNP-NNP-VB-NNP,NNP,6,1
6,1.0,22,born,3,6,13,7,5,8,-3,10,Santo Antônio do Descoberto,Brazil,LOC-LOC-LOC-LOC,LOC,PROPN-PROPN-VERB-PROPN,PROPN,compound-pobj-dep-dobj,appos,NNP-NNP-VB-NNP,NNP,4,1
7,1.0,22,born,3,11,13,2,10,8,-8,10,Goiás,Brazil,LOC,LOC,PROPN,PROPN,conj,appos,NNP,NNP,4,1
0,0.0,22,is,13,1,5,4,0,16,12,-8,Gianluca Forcolin,28 August 1968,PER-PER,TIME-TIME-TIME,PROPN-PROPN,NUM-PROPN-NUM,compound-nsubj,nummod-npadvmod-nummod,NNP-NNP,CD-NNP-CD,2,1
1,0.0,22,is,13,1,9,8,0,12,12,-4,Gianluca Forcolin,San Donà di Piave,PER-PER,LOC-LOC-LOC-LOC,PROPN-PROPN,PROPN-PROPN-ADP-PROPN,compound-nsubj,compound-compound-compound-pobj,NNP-NNP,NNP-NNP-IN-NNP,4,1
2,0.0,22,is,13,9,21,12,8,0,4,8,San Donà di Piave,Italy,LOC-LOC-LOC-LOC,LOC,PROPN-PROPN-ADP-PROPN,PROPN,compound-compound-compound-pobj,appos,NNP-NNP-IN-NNP,NNP,6,1
3,0.0,22,is,13,19,21,2,18,0,-6,8,Veneto,Italy,LOC,LOC,PROPN,PROPN,pobj,appos,NNP,NNP,5,1
4,1.0,45,involved,14,12,4,-8,11,40,2,-10,Forcolin,Liga Veneta – Lega Nord,PER,ORG-ORG-ORG-ORG-ORG,PROPN,PROPN-PROPN-PUNCT-PROPN-PROPN,nsubjpass,compound-compound-compound-compound-pobj,NNP,NNP-NNP-:-NNP-NNP,4,1
5,2.0,66,elected,7,49,52,3,48,13,-42,45,Lega Nord,Umberto Bossi,ORG-ORG,PER-PER,PROPN-PROPN,PROPN-PROPN,compound-compound,compound-pobj,NNP-NNP,NNP-NNP,2,1
6,2.0,66,elected,7,49,64,15,48,1,-42,57,Lega Nord,Flavio Tosi,ORG-ORG,PER-PER,PROPN-PROPN,PROPN-PROPN,compound-compound,compound-pobj,NNP-NNP,NNP-NNPS,13,1
7,4.0,60,elected,19,13,31,18,12,28,6,12,Forcolin,Liga Veneta,PER,ORG-ORG,PROPN,PROPN-PROPN,nsubj,compound-pobj,NNP,NNP-NNP,5,1
0,0.0,26,is,8,5,21,16,4,4,3,13,i Love Katamari,Namco Bandai Games,MISC-MISC-MISC,ORG-ORG-ORG,PRON-VERB-PROPN,PROPN-PROPN-PROPN,pobj-compound-appos,compound-compound-pobj,PRP-VBP-NNP,NNP-NNP-NNPS,10,1
1,0.0,26,is,8,5,25,20,4,0,3,17,i Love Katamari,iOS,MISC-MISC-MISC,MISC,PRON-VERB-PROPN,X,pobj-compound-appos,pobj,PRP-VBP-NNP,ADD,6,1
0,0.0,37,was,10,1,7,6,0,29,9,-3,Birendra Krishna Bhadra,1905,PER-PER-PER,TIME,PROPN-PROPN-PROPN,NUM,compound-compound-nsubj,nummod,NNP-NNP-NNP,CD,3,1
1,0.0,37,was,10,1,9,8,0,27,9,-1,Birendra Krishna Bhadra,1991,PER-PER-PER,TIME,PROPN-PROPN-PROPN,NUM,compound-compound-nsubj,nummod,NNP-NNP-NNP,CD,3,1
2,3.0,23,acted,2,18,21,3,17,1,-16,19,Nishiddha Phal,1955,MISC-MISC,TIME,PROPN-PROPN,NUM,compound-appos,appos,NNP-NNP,CD,1,1
0,0.0,15,was,7,1,4,3,0,10,6,-3,Fanny Geefs,1807,PER-PER,TIME,PROPN-PROPN,NUM,compound-nsubj,nummod,NNP-NNP,CD,2,1
1,0.0,15,was,7,1,10,9,0,4,6,3,Fanny Geefs,Belgian,PER-PER,LOC,PROPN-PROPN,ADJ,compound-nsubj,amod,NNP-NNP,JJ,2,1
2,6.0,31,triptych,1,18,26,8,17,4,-17,25,Charlotte Brontë,Villette,PER-PER,MISC,PROPN-PROPN,PROPN,compound-pobj,attr,NNP-NNP,NNP,5,1
0,1.0,20,was,6,16,19,3,15,0,-10,13,Bnei Brak,Israel,LOC-LOC,LOC,PROPN-PROPN,PROPN,compound-pobj,appos,NNP-NNP,NNP,4,1
0,0.0,24,is,1,1,6,5,0,17,0,5,Uchylsko,Gmina Gorzyce,LOC,LOC-LOC,PROPN,PROPN-PROPN,nsubj,compound-pobj,NNP,NNP-NNP,3,1
1,0.0,24,is,1,1,15,14,0,8,0,14,Uchylsko,Poland,LOC,LOC,PROPN,PROPN,nsubj,appos,NNP,NNP,4,1
2,0.0,24,is,1,6,9,3,5,14,-5,8,Gmina Gorzyce,Wodzisław County,LOC-LOC,LOC-LOC,PROPN-PROPN,PROPN-PROPN,compound-pobj,compound-conj,NNP-NNP,NNP-NNP,1,1
3,0.0,24,is,1,6,12,6,5,11,-5,11,Gmina Gorzyce,Silesian Voivodeship,LOC-LOC,LOC-LOC,PROPN-PROPN,PROPN-PROPN,compound-pobj,compound-conj,NNP-NNP,NNP-NNP,2,1
4,0.0,24,is,1,6,15,9,5,8,-5,14,Gmina Gorzyce,Poland,LOC-LOC,LOC,PROPN-PROPN,PROPN,compound-pobj,appos,NNP-NNP,NNP,1,1
5,0.0,24,is,1,9,12,3,8,11,-8,11,Wodzisław County,Silesian Voivodeship,LOC-LOC,LOC-LOC,PROPN-PROPN,PROPN-PROPN,compound-conj,compound-conj,NNP-NNP,NNP-NNP,1,1
6,0.0,24,is,1,9,15,6,8,8,-8,14,Wodzisław County,Poland,LOC-LOC,LOC,PROPN-PROPN,PROPN,compound-conj,appos,NNP-NNP,NNP,2,1
7,0.0,24,is,1,12,15,3,11,8,-11,14,Silesian Voivodeship,Poland,LOC-LOC,LOC,PROPN-PROPN,PROPN,compound-conj,appos,NNP-NNP,NNP,3,1
0,2.0,54,killed,22,16,19,3,15,34,6,-3,Hannah Britten,Laura Allen,PER-PER,PER-PER,PROPN-PROPN,PROPN-PROPN,compound-appos,compound-appos,NNP-NNP,NNP-NNP,1,1
1,2.0,54,killed,22,44,47,3,43,6,-22,25,Rex Britten,Dylan Minnette,PER-PER,PER-PER,PROPN-PROPN,PROPN-PROPN,compound-appos,compound-appos,NNP-NNP,NNP-NNP,3,1
2,4.0,35,sees,1,23,26,3,22,8,-22,25,Judith Evans,Cherry Jones,PER-PER,PER-PER,PROPN-PROPN,PROPN-PROPN,compound-conj,compound-appos,NNP-NNP,NNP-NNP,1,1
3,5.0,17,conceived,3,11,15,4,10,1,-8,12,Lone Star,Fox,MISC-MISC,ORG,PROPN-PROPN,PROPN,compound-dobj,compound,NNP-NNP,NNP,3,1
4,5.0,17,conceived,3,11,6,-5,10,10,-8,3,Lone Star,Killen,MISC-MISC,PER,PROPN-PROPN,PROPN,compound-dobj,pobj,NNP-NNP,NNP,3,1
5,8.0,27,released,6,5,9,4,4,17,1,3,Awake,Hulu,MISC,ORG,PROPN,PROPN,pobj,pobj,NNP,NNP,2,1
0,0.0,24,is,4,1,7,6,0,16,3,3,Inventec Corporation,Taiwan,ORG-ORG,LOC,PROPN-PROPN,PROPN,compound-compound,npadvmod,NNP-NNP,NNP,-1,1
0,1.0,25,was,1,3,23,20,2,1,-2,22,the United States,North America,LOC-LOC-LOC,LOC-LOC,DET-PROPN-PROPN,PROPN-PROPN,det-compound-pobj,compound-pobj,DT-NNP-NNP,NNP-NNP,6,1
0,0.0,36,Church,1,10,12,2,9,23,-9,11,Mantua,Italy,LOC,LOC,PROPN,PROPN,pobj,appos,NNP,NNP,5,1
1,1.0,16,commissioned,3,6,13,7,5,2,-3,10,Margherita Gonzaga d'Este,Alfonso II d'Este,PER-PER-PER,PER-PER-PER,PROPN-PROPN-PROPN,PROPN-PROPN-NOUN,compound-compound-pobj,compound-compound-pobj,NNP-NNP-NNP,NNP-NNP-NN,5,1
2,3.0,35,decorated,4,11,23,12,10,11,-7,19,Domenico Fetti,Lucrina,PER-PER,PER,PROPN-PROPN,PROPN,compound-pobj,ROOT,NNP-NNP,NNP,-1,1
0,0.0,19,is,14,1,17,16,0,1,13,3,"Ger "" Redser "" O'Grady",Irish,PER-PER-PER-PER-PER,LOC,PROPN-PUNCT-PROPN-PUNCT-PROPN,ADJ,nmod-punct-nmod-punct-nsubj,amod,NNP-``-NNP-''-NNP,JJ,3,1
1,0.0,19,is,14,10,17,7,9,1,4,3,Thurles,Irish,LOC,LOC,PROPN,ADJ,pobj,amod,NNP,JJ,6,1
0,0.0,56,is,19,2,31,29,1,24,17,12,Table Rock House,Ontario,LOC-LOC-LOC,LOC,PROPN-PROPN-PROPN,PROPN,compound-compound-pobj,conj,NNP-NNP-NNP,NNP,9,1
1,0.0,56,is,19,2,33,31,1,22,17,14,Table Rock House,Canada,LOC-LOC-LOC,LOC,PROPN-PROPN-PROPN,PROPN,compound-compound-pobj,appos,NNP-NNP-NNP,NNP,6,1
2,0.0,56,is,19,2,39,37,1,16,17,20,Table Rock House,Canadian,LOC-LOC-LOC,LOC,PROPN-PROPN-PROPN,PROPN,compound-compound-pobj,compound,NNP-NNP-NNP,NNP,10,1
3,0.0,56,is,19,28,31,3,27,24,-9,12,Niagara Falls,Ontario,LOC-LOC,LOC,PROPN-PROPN,PROPN,compound-pobj,conj,NNP-NNP,NNP,2,1
4,0.0,56,is,19,28,33,5,27,22,-9,14,Niagara Falls,Canada,LOC-LOC,LOC,PROPN-PROPN,PROPN,compound-pobj,appos,NNP-NNP,NNP,3,1
5,0.0,56,is,19,31,33,2,30,22,-12,14,Ontario,Canada,LOC,LOC,PROPN,PROPN,conj,appos,NNP,NNP,5,1
6,0.0,56,is,19,31,39,8,30,16,-12,20,Ontario,Canadian,LOC,LOC,PROPN,PROPN,conj,compound,NNP,NNP,9,1
7,5.0,56,provides,12,10,6,-4,9,49,2,-6,Table Rock Centre,Niagara Parks Commission,LOC-LOC-LOC,ORG-ORG-ORG,PROPN-PROPN-PROPN,PROPN-PROPN-PROPN,compound-compound-nsubj,compound-compound-pobj,NNP-NNP-NNP,NNP-NNPS-NNP,7,1
0,0.0,51,Stories,1,1,11,10,0,39,0,10,Deathbird Stories : A Pantheon of Modern Gods,1975,MISC-MISC-MISC-MISC-MISC-MISC-MISC-MISC,TIME,ADJ-NOUN-PUNCT-DET-PROPN-ADP-PROPN-PROPN,NUM,compound-ROOT-punct-det-nsubj-prep-compound-pobj,nummod,JJ-NNS-:-DT-NNP-IN-NNP-NNP,CD,2,1
1,0.0,51,Stories,1,1,19,18,0,31,0,18,Deathbird Stories : A Pantheon of Modern Gods,Harlan Ellison,MISC-MISC-MISC-MISC-MISC-MISC-MISC-MISC,PER-PER,ADJ-NOUN-PUNCT-DET-PROPN-ADP-PROPN-PROPN,PROPN-PROPN,compound-ROOT-punct-det-nsubj-prep-compound-pobj,compound-pobj,JJ-NNS-:-DT-NNP-IN-NNP-NNP,NNP-NNP,4,1
0,0.0,25,Alyth,1,2,24,22,1,0,-1,23,Alyth,Alberta,LOC,LOC,PROPN,PROPN,pobj,npadvmod,NNP,NNP,-1,1
1,0.0,25,Alyth,1,4,24,20,3,0,-3,23,Calgary,Alberta,LOC,LOC,PROPN,PROPN,pobj,npadvmod,NNP,NNP,-1,1
2,1.0,29,serves,14,3,11,8,2,17,11,-3,Canadian Pacific Railway,Canada,ORG-ORG-ORG,LOC,PROPN-PROPN-PROPN,PROPN,compound-compound-poss,pobj,NNP-NNP-NNP,NNP,6,1
3,2.0,36,is,2,34,29,-5,33,6,-32,27,Spiral Tunnels,British Columbia,LOC-LOC,LOC-LOC,PROPN-PROPN,PROPN-PROPN,compound-pobj,compound-appos,NNP-NNPS,NNP-NNP,10,1
0,0.0,37,Hoffmann,2,1,20,19,0,16,1,18,David Zvi Hoffmann,Berlin,PER-PER-PER,LOC,PROPN-PROPN-PROPN,PROPN,compound-compound-ROOT,npadvmod,NNP-NNP-NNP,NNP,2,1
1,0.0,37,Hoffmann,2,10,12,2,9,24,-8,10,Verbó,Austrian Empire,LOC,LOC-LOC,PROPN,PROPN-PROPN,appos,compound-conj,NNP,NNP-NNP,3,1
2,4.0,54,employed,8,52,47,-5,51,6,-44,39,Azriel Hildesheimer,1899,PER-PER,TIME,PROPN-PROPN,NUM,compound-pobj,pobj,NNP-NNP,CD,3,1
3,4.0,54,employed,8,52,30,-22,51,23,-44,22,Azriel Hildesheimer,Berlin,PER-PER,LOC,PROPN-PROPN,PROPN,compound-pobj,pobj,NNP-NNP,NNP,7,1
4,4.0,54,employed,8,37,30,-7,36,23,-29,22,Rabbinical Seminary of Berlin,Berlin,ORG-ORG-ORG-ORG,LOC,PROPN-PROPN-ADP-PROPN,PROPN,compound-pobj-prep-pobj,pobj,NNP-NNP-IN-NNP,NNP,4,1
0,0.0,33,is,3,10,24,14,9,8,-7,21,Vereeniging,South Africa,LOC,LOC-LOC,PROPN,PROPN-PROPN,pobj,compound-pobj,NNP,NNP-NNP,9,1
1,0.0,33,is,3,12,24,12,11,8,-9,21,Vanderbijlpark,South Africa,LOC,LOC-LOC,PROPN,PROPN-PROPN,conj,compound-pobj,NNP,NNP-NNP,10,1
2,0.0,33,is,3,14,24,10,13,8,-11,21,Sasolburg,South Africa,LOC,LOC-LOC,PROPN,PROPN-PROPN,conj,compound-pobj,NNP,NNP-NNP,6,1
0,5.0,26,served,5,9,23,14,8,2,-4,18,Royal Australian Air Force,Australia,ORG-ORG-ORG-ORG,LOC,ADJ-PROPN-PROPN-PROPN,PROPN,compound-compound-compound-pobj,pobj,JJ-NNP-NNP-NNP,NNP,6,1
1,7.0,7,died,1,1,4,3,0,2,0,3,Stanistreet,Bendigo,PER,LOC,PROPN,PROPN,nsubj,pobj,NNP,NNP,1,1
0,3.0,26,is,12,7,7,0,6,18,5,-5,Dick Smith 's Australian Geographic,Dick Smith,ORG-ORG-ORG-ORG-ORG,PER-PER,PROPN-PROPN-PART-PROPN-PROPN,PROPN-PROPN,compound-poss-case-compound-oprd,compound-pobj,NNP-NNP-POS-NNP-NNP,NNP-NNP,0,1
1,3.0,26,is,12,7,25,18,6,0,5,13,Dick Smith 's Australian Geographic,1986,ORG-ORG-ORG-ORG-ORG,TIME,PROPN-PROPN-PART-PROPN-PROPN,NUM,compound-poss-case-compound-oprd,pobj,NNP-NNP-POS-NNP-NNP,CD,4,1
2,3.0,26,is,12,1,7,6,0,18,11,-5,Australian Geographic,Dick Smith,MISC-MISC,PER-PER,PROPN-PROPN,PROPN-PROPN,amod-compound,compound-pobj,NNP-NNP,NNP-NNP,4,1
3,3.0,26,is,12,1,25,24,0,0,11,13,Australian Geographic,1986,MISC-MISC,TIME,PROPN-PROPN,NUM,amod-compound,pobj,NNP-NNP,CD,4,1
0,0.0,39,was,11,1,4,3,0,34,10,-7,Gottfried Semper,29 November 1803,PER-PER,TIME-TIME-TIME,VERB-PROPN,NUM-PROPN-NUM,compound-nsubj,nummod-npadvmod-nummod,VBN-NNP,CD-NNP-CD,2,1
1,0.0,39,was,11,1,8,7,0,30,10,-3,Gottfried Semper,15 May 1879,PER-PER,TIME-TIME-TIME,VERB-PROPN,NUM-PROPN-NUM,compound-nsubj,nummod-appos-nummod,VBN-NNP,CD-NNP-CD,3,1
2,0.0,39,was,11,1,2,1,0,36,10,-9,Gottfried Semper,Semper Opera House,PER-PER,LOC-LOC-LOC,VERB-PROPN,PROPN-PROPN-PROPN,compound-nsubj,compound-compound-dobj,VBN-NNP,NNP-NNP-NNP,1,1
3,0.0,39,was,11,2,34,32,1,4,9,23,Semper Opera House,Dresden,LOC-LOC-LOC,LOC,PROPN-PROPN-PROPN,PROPN,compound-compound-dobj,pobj,NNP-NNP-NNP,NNP,5,1
4,4.0,41,wrote,1,14,20,6,13,20,-13,19,The Four Elements of Architecture,1851,MISC-MISC-MISC-MISC-MISC,TIME,DET-PROPN-PROPN-ADP-PROPN,NUM,det-nummod-ROOT-prep-pobj,pobj,DT-NNP-NNPS-IN-NNP,CD,5,1
5,5.0,29,designed,1,19,21,2,18,7,-18,20,Ringstraße,Vienna,LOC,LOC,PROPN,PROPN,pobj,pobj,NNP,NNP,7,1
0,0.0,65,is,3,1,8,7,0,56,2,5,Bebop,jazz,MISC,MISC,PROPN,NOUN,nsubj,pobj,NNP,NN,6,1
1,0.0,65,is,3,3,8,5,2,56,0,5,bop,jazz,MISC,MISC,NOUN,NOUN,conj,pobj,NN,NN,4,1
0,0.0,24,was,2,1,10,9,0,13,1,8,Lark Force,March 1941,ORG-ORG,TIME-TIME,PROPN-PROPN,PROPN-NUM,compound-nsubj,pobj-nummod,NNP-NNP,NNP-CD,6,1
1,0.0,24,was,2,1,13,12,0,10,1,11,Lark Force,World War II,ORG-ORG,MISC-MISC-MISC,PROPN-PROPN,PROPN-PROPN-PROPN,compound-nsubj,compound-compound-pobj,NNP-NNP,NNP-NNP-NNP,6,1
2,0.0,24,was,2,5,13,8,4,10,-3,11,Australian Army,World War II,ORG-ORG,MISC-MISC-MISC,ADJ-PROPN,PROPN-PROPN-PROPN,compound-compound,compound-compound-pobj,JJ-NNP,NNP-NNP-NNP,5,1
3,1.0,40,raised,11,26,14,-12,25,25,-15,3,MV Neptuna,Australia,MISC-MISC,LOC,PROPN-PROPN,PROPN,compound-conj,pobj,NNP-NNP,NNP,5,1
0,0.0,28,is,1,1,15,14,0,12,0,14,Karlstad Municipality,Värmland County,LOC-LOC,LOC-LOC,PROPN-PROPN,PROPN-PROPN,compound-pobj,compound-pobj,NNP-NNP,NNP-NNP,7,1
1,0.0,28,is,1,1,27,26,0,0,0,26,Karlstad Municipality,Sweden,LOC-LOC,LOC,PROPN-PROPN,PROPN,compound-pobj,pobj,NNP-NNP,NNP,1,1
2,0.0,28,is,1,15,27,12,14,0,-14,26,Värmland County,Sweden,LOC-LOC,LOC,PROPN-PROPN,PROPN,compound-pobj,pobj,NNP-NNP,NNP,8,1
3,0.0,28,is,1,15,27,12,14,0,-14,26,Värmland,Sweden,LOC,LOC,PROPN,PROPN,appos,pobj,NNP,NNP,8,1
0,2.0,19,began,4,2,7,5,1,11,2,3,Jedi Knight,1995,MISC-MISC,TIME,PROPN-PROPN,NUM,compound-compound,pobj,NNP-NNP,CD,3,1
1,2.0,19,began,4,2,13,11,1,5,2,9,Jedi Knight,DOS,MISC-MISC,MISC,PROPN-PROPN,PROPN,compound-compound,pobj,NNP-NNP,NNP,7,1
2,2.0,19,began,4,2,15,13,1,3,2,11,Jedi Knight,Macintosh,MISC-MISC,MISC,PROPN-PROPN,PROPN,compound-compound,conj,NNP-NNP,NNP,8,1
3,2.0,19,began,4,2,18,16,1,0,2,14,Jedi Knight,PlayStation,MISC-MISC,MISC,PROPN-PROPN,PROPN,compound-compound,conj,NNP-NNP,NNP,3,1
4,4.0,28,released,4,11,27,16,10,0,-7,23,Dark Forces II,Katarn,MISC-MISC-MISC,PER,PROPN-PROPN-PROPN,PROPN,compound-compound-pobj,conj,NNP-NNPS-NNP,NNP,6,1
5,6.0,18,developed,3,1,6,5,0,11,2,3,Jedi Outcast,Raven Software,MISC-MISC,ORG-ORG,PROPN-PROPN,PROPN-PROPN,compound-nsubjpass,compound-pobj,NNP-NNP,NNP-NNP,3,1
0,0.0,23,is,5,2,22,20,1,0,3,17,Qu River,China,LOC-LOC,LOC,PROPN-PROPN,PROPN,compound-nsubj,appos,NNP-NNP,NNP,2,1
1,0.0,23,is,5,18,22,4,17,0,-13,17,Yunnan,China,LOC,LOC,PROPN,PROPN,compound,appos,NNP,NNP,4,1
0,7.0,76,dominated,3,1,67,66,0,8,2,64,Egypt,Hosni Mubarak,LOC,PER-PER,PROPN,PROPN-PROPN,nsubj,compound-poss,NNP,NNP-NNP,9,1
0,0.0,20,is,1,1,11,10,0,8,0,10,Helldivers,Arrowhead Game Studios,MISC,ORG-ORG-ORG,PROPN,PROPN-PROPN-PROPN,nsubj,compound-compound-pobj,NNP,NNP-NNP-NNPS,5,1
1,0.0,20,is,1,1,17,16,0,2,0,16,Helldivers,Sony Computer Entertainment,MISC,ORG-ORG-ORG,PROPN,PROPN-PROPN-PROPN,nsubj,compound-compound-pobj,NNP,NNP-NNP-NNP,6,1
2,0.0,20,is,1,11,17,6,10,2,-10,16,Arrowhead Game Studios,Sony Computer Entertainment,ORG-ORG-ORG,ORG-ORG-ORG,PROPN-PROPN-PROPN,PROPN-PROPN-PROPN,compound-compound-pobj,compound-compound-pobj,NNP-NNP-NNPS,NNP-NNP-NNP,7,1
3,1.0,38,released,3,7,7,0,6,30,-4,4,PlayStation 3,PlayStation 4,MISC-MISC,MISC-MISC,PROPN-NUM,PROPN-NUM,pobj-nummod,nmod-nummod,NNP-CD,NNP-CD,0,1
0,0.0,30,was,3,2,17,15,1,12,1,14,Kaiser,World War I,MISC,MISC-MISC-MISC,PROPN,PROPN-PROPN-PROPN,compound,compound-compound-pobj,NNP,NNP-NNP-NNP,9,1
1,0.0,30,was,3,2,24,22,1,5,1,21,Kaiser,Imperial German Navy,MISC,ORG-ORG-ORG,PROPN,ADJ-ADJ-PROPN,compound,amod-amod-pobj,NNP,JJ-JJ-NNP,9,1
2,7.0,34,reorganized,18,7,11,4,6,22,11,-7,Operation Albion,Baltic Sea,MISC-MISC,LOC-LOC,PROPN-PROPN,PROPN-PROPN,compound-pobj,compound-pobj,NNP-NNP,NNP-NNP,2,1
0,2.0,45,worked,5,8,19,11,7,25,-3,14,Pimlico Plumbers,London,ORG-ORG,LOC,PROPN-PROPN,PROPN,compound-pobj,pobj,NNP-NNPS,NNP,2,1
0,0.0,14,is,1,7,10,3,6,3,-6,9,Menderes,Izmir Province,LOC,LOC-LOC,PROPN,PROPN-PROPN,compound,compound-pobj,NNP,NNP-NNP,2,1
1,0.0,14,is,1,7,13,6,6,0,-6,12,Menderes,Turkey,LOC,LOC,PROPN,PROPN,compound,appos,NNP,NNP,4,1
2,0.0,14,is,1,10,13,3,9,0,-9,12,Izmir Province,Turkey,LOC-LOC,LOC,PROPN-PROPN,PROPN,compound-pobj,appos,NNP-NNP,NNP,6,1
0,6.0,33,blamed,10,16,19,3,15,13,-6,9,Fortress Louisbourg,1745,LOC-LOC,TIME,PROPN-PROPN,NUM,compound-pobj,pobj,NNP-NNP,CD,5,1
0,0.0,25,are,1,1,7,6,0,17,0,6,Cranes,Gruidae,MISC,MISC,NOUN,PROPN,nsubj,appos,NNS,NNP,3,1
1,0.0,25,are,1,7,24,17,6,0,-6,23,Gruidae,Gruiformes,MISC,MISC,PROPN,PROPN,appos,appos,NNP,NNP,4,1
0,1.0,15,attended,9,9,3,-6,8,11,0,-6,Janvier,Port - au - Prince,PER,LOC-LOC-LOC-LOC-LOC,PROPN,PROPN-PUNCT-PROPN-PUNCT-PROPN,nsubj,nmod-punct-prep-punct-pobj,NNP,NNP-HYPH-NNP-HYPH-NNP,2,1
0,0.0,25,is,14,1,13,12,0,11,13,-1,Athos Procópio de Oliveira Júnior,Catanduva,PER-PER-PER-PER-PER,LOC,PROPN-PROPN-ADP-PROPN-PROPN,PROPN,compound-compound-compound-compound-nsubj,pobj,NNP-NNP-IN-NNP-NNP,NNP,2,1
1,0.0,25,is,14,1,24,23,0,0,13,10,Athos Procópio de Oliveira Júnior,Brazil,PER-PER-PER-PER-PER,LOC,PROPN-PROPN-ADP-PROPN-PROPN,PROPN,compound-compound-compound-compound-nsubj,pobj,NNP-NNP-IN-NNP-NNP,NNP,3,1
2,0.0,25,is,14,13,24,11,12,0,1,10,Catanduva,Brazil,LOC,LOC,PROPN,PROPN,pobj,pobj,NNP,NNP,3,1
3,6.0,30,was,5,27,29,2,26,0,-22,24,Guayaquil,Ecuador,LOC,LOC,PROPN,PROPN,pobj,appos,NNP,NNP,2,1
0,0.0,14,is,2,1,9,8,0,4,1,7,Abrakurrie Cave,Nullarbor Plain,LOC-LOC,LOC-LOC,PROPN-PROPN,PROPN-PROPN,compound-nsubj,compound-pobj,NNP-NNP,NNP-NNP,4,1
1,0.0,14,is,2,1,12,11,0,1,1,10,Abrakurrie Cave,Western Australia,LOC-LOC,LOC-LOC,PROPN-PROPN,PROPN-PROPN,compound-nsubj,compound-pobj,NNP-NNP,NNP-NNP,4,1
2,0.0,14,is,2,9,12,3,8,1,-7,10,Nullarbor Plain,Western Australia,LOC-LOC,LOC-LOC,PROPN-PROPN,PROPN-PROPN,compound-pobj,compound-pobj,NNP-NNP,NNP-NNP,4,1
3,1.0,43,located,2,8,42,34,7,0,-6,40,Eucla,Australia,LOC,LOC,PROPN,PROPN,pobj,pobj,NNP,NNP,3,1
0,3.0,33,created,2,11,5,-6,10,27,-9,3,Johnny Test,Scott Fellows,MISC-MISC,PER-PER,PROPN-PROPN,PROPN-PROPN,compound-dobj,compound-pobj,NNP-NNP,NNP-NNP,2,1
1,3.0,33,created,2,21,5,-16,20,27,-19,3,Big Time Rush,Scott Fellows,MISC-MISC-MISC,PER-PER,PROPN-PROPN-PROPN,PROPN-PROPN,compound-compound-conj,compound-pobj,NNP-NNP-NNP,NNP-NNP,3,1
2,3.0,33,created,2,26,5,-21,25,27,-24,3,100 Things to Do Before High School,Scott Fellows,MISC-MISC-MISC-MISC-MISC-MISC-MISC,PER-PER,NUM-NOUN-PART-VERB-ADP-PROPN-PROPN,PROPN-PROPN,nummod-conj-aux-relcl-prep-compound-pobj,compound-pobj,CD-NNS-TO-VB-IN-NNP-NNP,NNP-NNP,3,1
3,5.0,27,picked,5,22,25,3,21,1,-17,20,Hulu,United States,ORG,LOC-LOC,PROPN,PROPN-PROPN,pobj,compound-pobj,NNP,NNP-NNP,1,1
0,1.0,89,included,8,26,29,3,25,59,-18,21,William Glackens,1870,PER-PER,TIME,PROPN-PROPN,NUM,compound-conj,nummod,NNP-NNP,CD,1,1
1,1.0,89,included,8,26,31,5,25,57,-18,23,William Glackens,1938,PER-PER,TIME,PROPN-PROPN,NUM,compound-conj,nummod,NNP-NNP,CD,1,1
2,1.0,89,included,8,26,66,40,25,22,-18,58,William Glackens,Pennsylvania Academy of the Fine Arts,PER-PER,ORG-ORG-ORG-ORG-ORG-ORG,PROPN-PROPN,PROPN-PROPN-ADP-DET-PROPN-PROPN,compound-conj,compound-pobj-prep-det-compound-pobj,NNP-NNP,NNP-NNP-IN-DT-NNP-NNPS,8,1
3,1.0,89,included,8,34,37,3,33,51,-26,29,John Sloan,1871,PER-PER,TIME,PROPN-PROPN,NUM,compound-conj,nummod,NNP-NNP,CD,1,1
4,1.0,89,included,8,34,39,5,33,49,-26,31,John Sloan,1951,PER-PER,TIME,PROPN-PROPN,NUM,compound-conj,nummod,NNP-NNP,CD,1,1
5,1.0,89,included,8,34,66,32,33,22,-26,58,John Sloan,Pennsylvania Academy of the Fine Arts,PER-PER,ORG-ORG-ORG-ORG-ORG-ORG,PROPN-PROPN,PROPN-PROPN-ADP-DET-PROPN-PROPN,compound-conj,compound-pobj-prep-det-compound-pobj,NNP-NNP,NNP-NNP-IN-DT-NNP-NNPS,8,1
6,1.0,89,included,8,43,46,3,42,42,-35,38,Everett Shinn,1876,PER-PER,TIME,PROPN-PROPN,NUM,compound-conj,nummod,NNP-NNP,CD,1,1
7,1.0,89,included,8,43,48,5,42,40,-35,40,Everett Shinn,1953,PER-PER,TIME,PROPN-PROPN,NUM,compound-conj,nummod,NNP-NNP,CD,1,1
8,1.0,89,included,8,62,66,4,61,22,-54,58,Thomas Anshutz,Pennsylvania Academy of the Fine Arts,PER-PER,ORG-ORG-ORG-ORG-ORG-ORG,PROPN-PROPN,PROPN-PROPN-ADP-DET-PROPN-PROPN,compound-pobj,compound-pobj-prep-det-compound-pobj,NNP-NNP,NNP-NNP-IN-DT-NNP-NNPS,2,1
9,1.0,89,included,8,66,83,17,65,5,-58,75,Pennsylvania Academy of the Fine Arts,Philadelphia,ORG-ORG-ORG-ORG-ORG-ORG,LOC,PROPN-PROPN-ADP-DET-PROPN-PROPN,PROPN,compound-pobj-prep-det-compound-pobj,pobj,NNP-NNP-IN-DT-NNP-NNPS,NNP,12,1
10,1.0,89,included,8,10,13,3,9,75,-2,5,Robert Henri,1865,PER-PER,TIME,PROPN-PROPN,NUM,compound-dobj,nummod,NNP-NNP,CD,2,1
11,1.0,89,included,8,10,15,5,9,73,-2,7,Robert Henri,1929,PER-PER,TIME,PROPN-PROPN,NUM,compound-dobj,nummod,NNP-NNP,CD,1,1
12,1.0,89,included,8,18,21,3,17,67,-10,13,George Luks,1867,PER-PER,TIME,PROPN-PROPN,NUM,compound-conj,nummod,NNP-NNP,CD,1,1
13,1.0,89,included,8,18,23,5,17,65,-10,15,George Luks,1933,PER-PER,TIME,PROPN-PROPN,NUM,compound-conj,nummod,NNP-NNP,CD,1,1
0,0.0,18,is,8,15,17,2,14,0,-7,9,Lombardy,Italy,LOC,LOC,PROPN,PROPN,pobj,appos,NNP,NNP,5,1
1,4.0,58,was,1,24,24,0,23,33,-23,23,Pliny the Elder,Pliny the Younger,PER-PER-PER,PER-PER-PER,PROPN-DET-PROPN,PROPN-DET-PROPN,appos-det-appos,conj-det-appos,NNP-DT-NNP,NNP-DT-NNP,0,1
2,4.0,58,was,1,41,47,6,40,10,-40,46,Cosima Liszt,Richard Wagner,PER-PER,PER-PER,PROPN-PROPN,PROPN-PROPN,compound-conj,compound-pobj,NNP-NNP,NNP-NNP,3,1
0,0.0,13,is,3,1,11,10,0,1,2,8,Anil 's Ghost,Michael Ondaatje,MISC-MISC-MISC,PER-PER,PROPN-PART-NOUN,PROPN-PROPN,poss-case-nsubj,compound-pobj,NNP-POS-NN,NNP-NNP,6,1
0,0.0,15,is,2,9,12,3,8,2,-7,10,Midtown Manhattan,New York City,LOC-LOC,LOC-LOC-LOC,PROPN-PROPN,PROPN-PROPN-PROPN,compound-pobj,compound-compound-pobj,NNP-NNP,NNP-NNP-NNP,3,1
0,6.0,43,explains,18,1,11,10,0,31,17,-7,Jerry Remy,California Angels,PER-PER,ORG-ORG,PROPN-PROPN,PROPN-PROPN,compound-nsubj,compound-pobj,NNP-NNP,NNP-NNPS,5,1
1,9.0,29,is,17,16,25,9,15,3,1,8,Texas Rangers,Major League Baseball,ORG-ORG,ORG-ORG-ORG,PROPN-PROPN,PROPN-PROPN-PROPN,compound-pobj,compound-compound-compound,NNP-NNP,NNP-NNP-NNP,8,1
2,11.0,48,wore,18,4,11,7,3,36,14,-7,Mike Sweeney,Kansas City Royals,PER-PER,ORG-ORG-ORG,PROPN-PROPN,PROPN-PROPN-PROPN,compound-appos,compound-compound-pobj,NNP-NNP,NNP-NNP-NNPS,4,1
3,11.0,48,wore,18,34,38,4,33,9,-16,20,John Franco,Mets,PER-PER,ORG,PROPN-PROPN,PROPN,compound-appos,pobj,NNP-NNP,NNPS,1,1
4,11.0,48,wore,18,41,45,4,40,2,-23,27,Jason Varitek,Boston Red Sox,PER-PER,ORG-ORG-ORG,PROPN-PROPN,PROPN-PROPN-PROPN,compound-conj,compound-compound-pobj,NNP-NNP,NNP-NNP-NNPS,3,1
0,0.0,20,was,11,1,4,3,0,15,10,-7,Ketil Skogen,26 August 1884,PER-PER,TIME-TIME-TIME,PROPN-PROPN,NUM-PROPN-NUM,compound-nsubj,nummod-appos-nummod,NNP-NNP,CD-NNP-CD,1,1
1,0.0,20,was,11,1,8,7,0,11,10,-3,Ketil Skogen,21 March 1970,PER-PER,TIME-TIME-TIME,PROPN-PROPN,NUM-PROPN-NUM,compound-nsubj,nummod-appos-nummod,NNP-NNP,CD-NNP-CD,2,1
2,0.0,20,was,11,1,14,13,0,5,10,3,Ketil Skogen,Norwegian,PER-PER,LOC,PROPN-PROPN,ADJ,compound-nsubj,amod,NNP-NNP,JJ,2,1
3,0.0,20,was,11,1,18,17,0,1,10,7,Ketil Skogen,Liberal Party,PER-PER,ORG-ORG,PROPN-PROPN,PROPN-PROPN,compound-nsubj,compound-pobj,NNP-NNP,NNP-NNP,4,1
0,0.0,37,is,3,2,17,15,1,19,1,14,Seed,The Walking Dead,MISC,MISC-MISC-MISC,NOUN,DET-VERB-PROPN,nsubj,det-compound-appos,NN,DT-VBG-NNP,7,1
1,4.0,16,is,3,2,13,11,1,2,1,10,Seed,The Walking Dead,MISC,MISC-MISC-MISC,NOUN,DET-VERB-ADJ,nsubj,det-compound-pobj,NN,DT-VBG-JJ,6,1
2,3.0,17,cares,7,3,5,2,2,11,4,-2,Michonne,Danai Gurira,PER,PER-PER,PROPN,PROPN-PROPN,nsubj,compound-appos,NNP,NNP-NNP,1,1
3,3.0,17,cares,7,12,14,2,11,2,-5,7,Andrea,Laurie Holden,PER,PER-PER,PROPN,PROPN-PROPN,pobj,compound-appos,NNP,NNP-NNP,1,1
0,0.0,13,is,6,1,5,4,0,7,5,-1,Carlos Moscardini,1959,PER-PER,TIME,PROPN-PROPN,NUM,compound-nsubj,npadvmod,NNP-NNP,CD,1,1
1,0.0,13,is,6,1,9,8,0,3,5,3,Carlos Moscardini,Argentine,PER-PER,LOC,PROPN-PROPN,ADJ,compound-nsubj,amod,NNP-NNP,JJ,2,1
0,0.0,31,was,15,1,4,3,0,26,14,-11,Otto Cuntz,10 September 1865,PER-PER,TIME-TIME-TIME,PROPN-PROPN,NUM-PROPN-NUM,compound-nsubj,nummod-appos-nummod,NNP-NNP,CD-NNP-CD,1,1
1,0.0,31,was,15,1,8,7,0,22,14,-7,Otto Cuntz,Stettin,PER-PER,LOC,PROPN-PROPN,PROPN,compound-nsubj,compound,NNP-NNP,NNP,2,1
2,0.0,31,was,15,1,10,9,0,20,14,-5,Otto Cuntz,1 December 1932,PER-PER,TIME-TIME-TIME,PROPN-PROPN,NUM-PROPN-NUM,compound-nsubj,nummod-appos-nummod,NNP-NNP,CD-NNP-CD,1,1
3,0.0,31,was,15,1,14,13,0,16,14,-1,Otto Cuntz,Graz,PER-PER,LOC,PROPN-PROPN,PROPN,compound-nsubj,appos,NNP-NNP,NNP,2,1
4,1.0,25,studied,1,23,11,-12,22,13,-22,10,Hermann Usener,Bonn,PER-PER,LOC,PROPN-PROPN,PROPN,compound-conj,conj,NNP-NNP,NNP,5,1
0,0.0,67,is,12,32,27,-5,31,39,-20,15,Hampton,United States,LOC,LOC-LOC,PROPN,PROPN-PROPN,conj,compound-conj,NNP,NNP-NNP,8,1
1,0.0,67,is,12,65,27,-38,64,39,-53,15,North Carolina,United States,LOC-LOC,LOC-LOC,PROPN-PROPN,PROPN-PROPN,compound-pobj,compound-conj,NNP-NNP,NNP-NNP,8,1
2,2.0,26,located,16,20,25,5,19,0,-4,9,Driver,Virginia,LOC,LOC,PROPN,PROPN,compound,appos,NNP,NNP,3,1
3,2.0,26,located,16,23,25,2,22,0,-7,9,Suffolk,Virginia,LOC,LOC,PROPN,PROPN,pobj,appos,NNP,NNP,6,1
0,1.0,27,is,1,7,13,6,6,13,-6,12,Province of British Columbia,Canada,LOC-LOC-LOC-LOC,LOC,PROPN-ADP-PROPN-PROPN,PROPN,pobj-prep-compound-pobj,pobj,NNP-IN-NNP-NNP,NNP,4,1
0,0.0,28,is,3,1,10,9,0,17,2,7,Return of Saturn,American,MISC-MISC-MISC,LOC,PROPN-ADP-PROPN,ADJ,nsubj-prep-pobj,amod,NNP-IN-NNP,JJ,6,1
1,0.0,28,is,3,1,13,12,0,14,2,10,Return of Saturn,No Doubt,MISC-MISC-MISC,ORG-ORG,PROPN-ADP-PROPN,PROPN-PROPN,nsubj-prep-pobj,det-ROOT,NNP-IN-NNP,NNP-NNP,3,1
2,0.0,28,is,3,1,23,22,0,4,2,20,Return of Saturn,Trauma Records,MISC-MISC-MISC,ORG-ORG,PROPN-ADP-PROPN,PROPN-PROPN,nsubj-prep-pobj,compound-pobj,NNP-IN-NNP,NNP-NNPS,6,1
3,0.0,28,is,3,1,26,25,0,1,2,23,Return of Saturn,Interscope Records,MISC-MISC-MISC,ORG-ORG,PROPN-ADP-PROPN,PROPN-PROPN,nsubj-prep-pobj,compound-conj,NNP-IN-NNP,NNP-NNPS,7,1
4,0.0,28,is,3,13,23,10,12,4,-10,20,No Doubt,Trauma Records,ORG-ORG,ORG-ORG,PROPN-PROPN,PROPN-PROPN,det-ROOT,compound-pobj,NNP-NNP,NNP-NNPS,3,1
5,0.0,28,is,3,13,26,13,12,1,-10,23,No Doubt,Interscope Records,ORG-ORG,ORG-ORG,PROPN-PROPN,PROPN-PROPN,det-ROOT,compound-conj,NNP-NNP,NNP-NNPS,4,1
0,0.0,27,Claudius,1,23,26,3,22,0,-22,25,Claudian Family,Rome,PER-PER,LOC,PROPN-PROPN,PROPN,compound-pobj,pobj,NNP-NNP,NNP,4,1
1,1.0,23,was,1,9,18,9,8,4,-8,17,Tiberius Claudius Nero,Appius Claudius Caecus,PER-PER-PER,PER-PER-PER,PROPN-PROPN-PROPN,PROPN-PROPN-PROPN,compound-compound-pobj,compound-compound-pobj,NNP-NNP-NNP,NNP-NNP-NNP,7,1
2,5.0,31,had,4,1,9,8,0,21,3,5,Drusus,Tiberius Claudius Nero,PER,PER-PER-PER,VERB,PROPN-PROPN-PROPN,nsubj,compound-compound-oprd,VB,NNP-NNP-NNP,6,1
0,0.0,31,is,3,1,14,13,0,16,2,11,Sally Engelhard Pingree,Charles W. Engelhard Jr.,PER-PER-PER,PER-PER-PER-PER,PROPN-PROPN-PROPN,PROPN-PROPN-PROPN-PROPN,compound-compound-nsubj,compound-compound-compound-pobj,NNP-NNP-NNP,NNP-NNP-NNP-NNP,8,1
0,2.0,13,disappeared,8,7,2,-5,6,10,1,-6,GPT,the mid-1990s,ORG,TIME-TIME,PROPN,DET-NOUN,appos,det-pobj,NNP,DT-NNS,4,1
1,4.0,28,amalgamated,5,8,8,0,7,19,-3,3,Siemens Communications,Siemens Enterprise Communications,ORG-ORG,ORG-ORG-ORG,PROPN-PROPN,PROPN-PROPN-PROPN,compound-pobj,compound-compound-pobj,NNP-NNP,NNP-NNP-NNP,0,1
2,4.0,28,amalgamated,5,8,26,18,7,1,-3,21,Siemens Enterprise Communications,2008,ORG-ORG-ORG,TIME,PROPN-PROPN-PROPN,NUM,compound-compound-pobj,pobj,NNP-NNP-NNP,CD,3,1
3,6.0,31,renamed,14,17,17,0,16,13,-3,3,Marconi plc,Marconi Corporation plc,ORG-ORG,ORG-ORG-ORG,PROPN-PROPN,PROPN-PROPN-PROPN,compound-pobj,compound-compound-pobj,NNP-NNP,NNP-NNP-NNP,0,1
4,6.0,31,renamed,14,17,13,-4,16,17,-3,-1,Marconi plc,GEC,ORG-ORG,ORG,PROPN-PROPN,PROPN,compound-pobj,nsubjpass,NNP-NNP,NNP,3,1
5,6.0,31,renamed,14,17,13,-4,16,17,-3,-1,Marconi Corporation plc,GEC,ORG-ORG-ORG,ORG,PROPN-PROPN-PROPN,PROPN,compound-compound-pobj,nsubjpass,NNP-NNP-NNP,NNP,3,1
6,7.0,25,sold,14,4,2,-2,3,22,10,-12,Marconi Communications,2005,ORG-ORG,TIME,PROPN-PROPN,NUM,compound-appos,pobj,NNP-NNP,CD,2,1
7,7.0,25,sold,14,4,23,19,3,1,10,9,Marconi Communications,Telent plc,ORG-ORG,ORG-ORG,PROPN-PROPN,PROPN-NOUN,compound-appos,compound-oprd,NNP-NNP,NNP-NN,4,1
8,7.0,25,sold,14,4,2,-2,3,22,10,-12,Marconi Corporation plc,2005,ORG-ORG-ORG,TIME,PROPN-PROPN-VERB,NUM,compound-nsubj-advmod,pobj,NNP-NNP-VBD,CD,2,1
9,7.0,25,sold,14,4,23,19,3,1,10,9,Marconi Corporation plc,Telent plc,ORG-ORG-ORG,ORG-ORG,PROPN-PROPN-VERB,PROPN-NOUN,compound-nsubj-advmod,compound-oprd,NNP-NNP-VBD,NNP-NN,4,1
0,0.0,22,is,1,13,16,3,12,5,-12,15,Sula Municipality,Møre og Romsdal,LOC-LOC,LOC-LOC-LOC,PROPN-PROPN,PROPN-ADP-PROPN,compound-pobj,pobj-prep-compound,NNP-NNP,NNP-IN-NNP,3,1
1,0.0,22,is,1,13,21,8,12,0,-12,20,Sula Municipality,Norway,LOC-LOC,LOC,PROPN-PROPN,PROPN,compound-pobj,appos,NNP-NNP,NNP,5,1
2,0.0,22,is,1,16,21,5,15,0,-15,20,Møre og Romsdal,Norway,LOC-LOC-LOC,LOC,PROPN-ADP-PROPN,PROPN,pobj-prep-compound,appos,NNP-IN-NNP,NNP,4,1
0,0.0,14,were,1,1,4,3,0,9,0,3,Divinyls,Australian,ORG,LOC,NOUN,ADJ,nsubj,amod,NNS,JJ,2,1
1,0.0,14,were,1,1,13,12,0,0,0,12,Divinyls,1980,ORG,TIME,NOUN,NUM,nsubj,pobj,NNS,CD,1,1
0,4.0,32,began,7,30,29,-1,29,2,-23,22,Heinz Fischer,Austria,PER-PER,LOC,PROPN-PROPN,PROPN,compound-pobj,compound,NNP-NNP,NNP,1,1
1,6.0,39,is,26,5,18,13,4,20,21,-8,Sebastian Kurz,Austria,PER-PER,LOC,PROPN-PROPN,PROPN,compound-nsubj,poss,NNP-NNP,NNP,9,1
0,0.0,33,is,6,27,30,3,26,2,-21,24,Ian Fleming,James Bond series,PER-PER,MISC-MISC-MISC,PROPN-PROPN,PROPN-PROPN-NOUN,compound-poss,compound-compound-pobj,NNP-NNP,NNP-NNP-NN,2,1
1,2.0,23,released,8,6,20,14,5,2,2,12,Guardian Angel,John Murray publishers,MISC-MISC,ORG-ORG-ORG,PROPN-PROPN,PROPN-PROPN-NOUN,compound-appos,compound-compound-pobj,NNP-NNP,NNP-NNP-NNS,4,1
0,0.0,20,is,10,1,19,18,0,0,9,9,Erfurt,Germany,LOC,LOC,PROPN,PROPN,pobj,pobj,NNP,NNP,2,1
0,1.0,15,born,2,1,5,4,0,9,1,3,Badev,Prilep,PER,LOC,PROPN,PROPN,nsubjpass,pobj,NNP,NNP,4,1
1,1.0,15,born,2,5,12,7,4,2,-3,10,Prilep,Republic of Macedonia,LOC,LOC-LOC-LOC,PROPN,PROPN-ADP-PROPN,pobj,appos-prep-pobj,NNP,NNP-IN-NNP,5,1
2,1.0,15,born,2,7,12,5,6,2,-5,10,Ottoman Empire,Republic of Macedonia,LOC-LOC,LOC-LOC-LOC,PROPN-PROPN,PROPN-ADP-PROPN,compound-appos,appos-prep-pobj,NNP-NNP,NNP-IN-NNP,5,1
3,5.0,7,died,1,4,6,2,3,0,-3,5,Sofia,Bulgaria,LOC,LOC,PROPN,PROPN,pobj,appos,NNP,NNP,4,1
0,1.0,21,was,1,6,17,11,5,3,-5,16,Milo I the Great,Guy III of Montlhéry,PER-PER-PER-PER,PER-PER-PER-PER,PROPN-PROPN-DET-ADJ,PROPN-PROPN-ADP-PROPN,pobj-ROOT-det-appos,compound-pobj-prep-pobj,NNP-NNP-DT-JJ,NNP-NNP-IN-NNP,5,1
1,13.0,30,made,20,18,29,11,17,0,2,9,Louis VI,France,PER-PER,LOC,PROPN-PROPN,PROPN,compound-nsubj,pobj,NNP-NNP,NNP,2,1
0,0.0,37,was,4,11,28,17,10,8,-7,24,Hollywood Studios,Bay Lake,ORG-ORG,LOC-LOC,PROPN-PROPN,PROPN-PROPN,compound-pobj,compound-pobj,NNP-NNPS,NNP-NNP,8,1
1,0.0,37,was,4,11,31,20,10,5,-7,27,Hollywood Studios,Florida,ORG-ORG,LOC,PROPN-PROPN,PROPN,compound-pobj,appos,NNP-NNPS,NNP,4,1
2,0.0,37,was,4,23,31,8,22,5,-19,27,Walt Disney World Resort,Florida,LOC-LOC-LOC-LOC,LOC,PROPN-PROPN-PROPN-PROPN,PROPN,compound-compound-compound-pobj,appos,NNP-NNP-NNP-NNP,NNP,5,1
3,1.0,22,inspired,3,21,14,-7,20,7,-18,11,Fantasia,Walt Disney,MISC,ORG-ORG,PROPN,PROPN-PROPN,appos,compound-poss,NNP,NNP-NNP,6,1
0,0.0,18,was,9,1,4,3,0,13,8,-5,Ferdinando Sanfelice,1675,PER-PER,TIME,PROPN-PROPN,NUM,compound-nsubj,nummod,NNP-NNP,CD,1,1
1,1.0,9,born,2,1,5,4,0,3,1,3,Sanfelice,Naples,PER,LOC,PROPN,PROPN,nsubjpass,pobj,NNP,NNP,2,1
2,7.0,29,worked,2,1,7,6,0,21,1,5,Sanfelice,Naples,PER,LOC,PROPN,PROPN,nsubj,pobj,NNP,NNP,4,1
3,5.0,56,included,23,37,32,-5,36,23,-14,9,Palazzo Serra di Cassano,Naples,LOC-LOC-LOC-LOC,LOC,PROPN-PROPN-ADP-PROPN,PROPN,compound-nsubj-compound-appos,pobj,NNP-NNP-IN-NNP,NNP,3,1
4,7.0,29,worked,2,10,7,-3,9,21,-8,5,San Lorenzo Maggiore,Naples,LOC-LOC-LOC,LOC,PROPN-PROPN-PROPN,PROPN,compound-compound-pobj,pobj,NNP-NNP-NNP,NNP,4,1
5,7.0,29,worked,2,10,7,-3,9,21,-8,5,San Giovanni a Carbonara,Naples,LOC-LOC-LOC-LOC,LOC,PROPN-PROPN-DET-PROPN,PROPN,compound-conj-det-appos,pobj,NNP-NNP-DT-NNP,NNP,4,1
0,0.0,25,was,8,1,5,4,0,19,7,-3,Françoise Prévost,1680,PER-PER,TIME,PROPN-PROPN,NUM,compound-nsubj,nummod,NNP-NNP,CD,2,1
1,0.0,25,was,8,1,7,6,0,17,7,-1,Françoise Prévost,1741,PER-PER,TIME,PROPN-PROPN,NUM,compound-nsubj,nummod,NNP-NNP,CD,1,1
2,0.0,25,was,8,1,11,10,0,13,7,3,Françoise Prévost,French,PER-PER,LOC,PROPN-PROPN,ADJ,compound-nsubj,amod,NNP-NNP,JJ,2,1
3,3.0,18,performed,4,16,14,-2,15,3,-12,10,Les Horaces,Corneille,MISC-MISC,PER,PROPN-PROPN,PROPN,compound-pobj,poss,NNP-NNP,NNP,2,1
0,0.0,26,is,9,8,24,16,7,1,1,15,Sparkle,Curtis Mayfield,MISC,PER-PER,PROPN,PROPN-PROPN,appos,compound-pobj,NNP,NNP-NNP,9,1
1,1.0,26,is,9,21,24,3,20,1,-12,15,Sparkle,Irene Cara,MISC,PER-PER,PROPN,PROPN-PROPN,appos,compound-dobj,NNP,NNP-NNP,3,1
0,1.0,13,composed,2,8,11,3,7,1,-6,9,Heart,Nancy Wilson,ORG,PER-PER,PROPN,PROPN-PROPN,compound,compound-conj,NNP,NNP-NNP,2,1
1,4.0,62,Like,0,2,26,24,1,35,-2,26,Heart,Nancy Wilson,ORG,PER-PER,PROPN,PROPN-PROPN,poss,compound-pobj,NNP,NNP-NNP,7,1
2,2.0,26,"""",0,2,24,22,1,1,-2,24,There 's The Girl,Bad Animals,MISC-MISC-MISC-MISC,MISC-MISC,ADV-VERB-DET-PROPN,PROPN-PROPN,expl-ccomp-det-attr,compound-appos,EX-VBZ-DT-NNP,NNP-NNPS,7,1
0,0.0,20,Oddworld,0,1,1,0,0,18,-1,1,Oddworld : Abe 's Exoddus,Oddworld Inhabitants,MISC-MISC-MISC-MISC-MISC,ORG-ORG,NOUN-PUNCT-PROPN-PART-PROPN,PROPN-PROPN,ROOT-punct-poss-case-nsubj,compound-pobj,NN-:-NNP-POS-NNP,NNP-NNPS,0,1
1,0.0,20,Oddworld,0,1,18,17,0,1,-1,18,Oddworld : Abe 's Exoddus,GT Interactive,MISC-MISC-MISC-MISC-MISC,ORG-ORG,NOUN-PUNCT-PROPN-PART-PROPN,PROPN-PROPN,ROOT-punct-poss-case-nsubj,compound-pobj,NN-:-NNP-POS-NNP,NNP-NNP,7,1
0,0.0,41,Play,36,25,1,-24,24,39,11,-35,Oscar Hijuelos,The Mambo Kings Play Songs of Love,PER-PER,MISC-MISC-MISC-MISC-MISC-MISC-MISC,PROPN-PROPN,DET-PROPN-NOUN-VERB-PROPN-ADP-PROPN,compound-compound,det-compound-nsubj-ROOT-dobj-prep-pobj,NNP-NNP,DT-NNP-NNS-VBP-NNP-IN-NNP,11,1
1,1.0,56,is,2,54,22,-32,53,33,-52,20,Los Lobos,Latin,PER-PER,LOC,PROPN-PROPN,ADJ,compound-conj,amod,NNP-NNP,JJ,13,1
2,4.0,46,adds,5,26,33,7,25,12,-21,28,Beautiful Maria of My Soul,Antonio Banderas,MISC-MISC-MISC-MISC-MISC,PER-PER,ADJ-PROPN-ADP-DET-PROPN,PROPN-PROPN,amod-pobj-prep-poss-pobj,compound-dobj,JJ-NNP-IN-PRP$-NNP,NNP-NNPS,2,1
0,0.0,25,is,2,1,18,17,0,6,1,16,Luke Skywalker,Star Wars,PER-PER,MISC-MISC,PROPN-PROPN,PROPN-PROPN,compound-nsubj,compound-compound,NNP-NNP,NNP-NNPS,8,1
1,0.0,25,is,2,1,23,22,0,1,1,21,Luke Skywalker,George Lucas,PER-PER,PER-PER,PROPN-PROPN,PROPN-PROPN,compound-nsubj,compound-pobj,NNP-NNP,NNP-NNP,10,1
2,0.0,25,is,2,18,23,5,17,1,-16,21,Star Wars,George Lucas,MISC-MISC,PER-PER,PROPN-PROPN,PROPN-PROPN,compound-compound,compound-pobj,NNP-NNPS,NNP-NNP,4,1
3,2.0,72,is,1,48,10,-38,47,61,-47,9,Anakin Skywalker,Leia Organa,PER-PER,PER-PER,PROPN-PROPN,PROPN-PROPN,compound-pobj,compound-pobj,NNP-NNP,NNP-NNP,10,1
4,2.0,72,is,1,51,61,10,50,10,-50,60,Darth Vader,Padmé Amidala,PER-PER,PER-PER,PROPN-PROPN,PROPN-PROPN,compound-appos,compound-pobj,NNP-NNP,NNP-NNP,4,1
5,2.0,72,is,1,51,10,-41,50,61,-50,9,Darth Vader,Leia Organa,PER-PER,PER-PER,PROPN-PROPN,PROPN-PROPN,compound-appos,compound-pobj,NNP-NNP,NNP-NNP,11,1
6,2.0,72,is,1,61,10,-51,60,61,-60,9,Padmé Amidala,Leia Organa,PER-PER,PER-PER,PROPN-PROPN,PROPN-PROPN,compound-pobj,compound-pobj,NNP-NNP,NNP-NNP,13,1
0,0.0,23,Colby,2,1,5,4,0,17,1,3,Moses French Colby,"July 2 , 1795",PER-PER-PER,TIME-TIME-TIME-TIME,PROPN-PROPN-PROPN,PROPN-NUM-PUNCT-NUM,compound-amod-ROOT,appos-nummod-punct-nummod,NNP-NNP-NNP,"NNP-CD-,-CD",3,1
1,0.0,23,Colby,2,1,10,9,0,12,1,8,Moses French Colby,"May 4 , 1863",PER-PER-PER,TIME-TIME-TIME-TIME,PROPN-PROPN-PROPN,PROPN-NUM-PUNCT-NUM,compound-amod-ROOT,nsubj-nummod-punct-nummod,NNP-NNP-NNP,"NNP-CD-,-CD",3,1
0,0.0,28,is,8,1,5,4,0,22,7,-3,Fursy Teyssier,22 September 1985,PER-PER,TIME-TIME-TIME,PROPN-PROPN,NUM-PROPN-NUM,compound-nsubj,nummod-npadvmod-nummod,NNP-NNP,CD-NNP-CD,2,1
1,0.0,28,is,8,1,11,10,0,16,7,3,Fursy Teyssier,French,PER-PER,LOC,PROPN-PROPN,ADJ,compound-nsubj,amod,NNP-NNP,JJ,2,1
0,1.0,18,appointed,5,12,14,2,11,3,-7,9,U.S.,George Herbert Walker Bush,LOC,PER-PER-PER-PER,PROPN,PROPN-PROPN-PROPN-PROPN,compound,compound-compound-compound-pobj,NNP,NNP-NNP-NNP-NNP,2,1
0,4.0,35,passed,3,28,6,-22,27,28,-25,3,Bill Clinton,the United States,PER-PER,LOC-LOC-LOC,PROPN-PROPN,DET-PROPN-PROPN,compound-pobj,det-compound-compound,NNP-NNP,DT-NNP-NNP,8,1
0,0.0,12,is,2,1,11,10,0,0,1,9,Love Story,Yelawolf,MISC-MISC,PER,PROPN-PROPN,PROPN,compound-nsubj,pobj,NNP-NNP,NNP,2,1
0,0.0,39,was,14,1,5,4,0,33,13,-9,John Moran Bailey,"November 23 , 1904",PER-PER-PER,TIME-TIME-TIME-TIME,PROPN-PROPN-PROPN,PROPN-NUM-PUNCT-NUM,compound-compound-nsubj,appos-nummod-punct-nummod,NNP-NNP-NNP,"NNP-CD-,-CD",3,1
1,0.0,39,was,14,1,10,9,0,28,13,-4,John Moran Bailey,"April 10 , 1975",PER-PER-PER,TIME-TIME-TIME-TIME,PROPN-PROPN-PROPN,PROPN-NUM-PUNCT-NUM,compound-compound-nsubj,appos-nummod-punct-nummod,NNP-NNP-NNP,"NNP-CD-,-CD",4,1
2,0.0,39,was,14,1,17,16,0,21,13,3,John Moran Bailey,American,PER-PER-PER,LOC,PROPN-PROPN-PROPN,ADJ,compound-compound-nsubj,amod,NNP-NNP-NNP,JJ,3,1
3,0.0,39,was,14,1,27,26,0,11,13,13,John Moran Bailey,New Deal coalition,PER-PER-PER,ORG-ORG-ORG,PROPN-PROPN-PROPN,PROPN-PROPN-NOUN,compound-compound-nsubj,compound-compound-dobj,NNP-NNP-NNP,NNP-NNP-NN,8,1
4,4.0,18,educated,6,5,3,-2,4,14,1,-3,Bailey,Catholic University of America,PER,ORG-ORG-ORG-ORG,PROPN,PROPN-PROPN-ADP-PROPN,nsubjpass,compound-pobj-prep-pobj,NNP,NNP-NNP-IN-NNP,2,1
5,4.0,18,educated,6,5,15,10,4,2,1,9,Bailey,Harvard Law School,PER,ORG-ORG-ORG,PROPN,PROPN-PROPN-PROPN,nsubjpass,compound-compound-conj,NNP,NNP-NNP-NNP,5,1
0,0.0,9,Smirnova,1,1,5,4,0,3,0,4,Elena Smirnova,6 May 1888,PER-PER,TIME-TIME-TIME,PROPN-PROPN,NUM-PROPN-NUM,compound-ROOT,nummod-appos-nummod,NNP-NNP,CD-NNP-CD,2,1
1,1.0,29,),0,21,28,7,20,0,-21,28,Mariinsky Theater,Russia,LOC-LOC,LOC,PROPN-PROPN,PROPN,compound-pobj,pobj,NNP-NNP,NNP,4,1
2,4.0,38,fled,8,20,35,15,19,2,-12,27,Berlin,Europe,LOC,LOC,PROPN,PROPN,pobj,pobj,NNP,NNP,4,1
0,0.0,46,is,2,1,40,39,0,5,1,38,Deep Impact,Maximilian Schell,MISC-MISC,PER-PER,ADJ-PROPN,PROPN-PROPN,compound-nsubj,compound-conj,JJ-NNP,NNP-NNP,7,1
1,0.0,46,is,2,1,44,43,0,1,1,42,Deep Impact,Morgan Freeman,MISC-MISC,PER-PER,ADJ-PROPN,PROPN-PROPN,compound-nsubj,compound-conj,JJ-NNP,NNP-NNP,8,1
2,0.0,46,is,2,1,14,13,0,31,1,12,Deep Impact,Mimi Leder,MISC-MISC,PER-PER,ADJ-PROPN,PROPN-PROPN,compound-nsubj,compound-pobj,JJ-NNP,NNP-NNP,5,1
3,0.0,46,is,2,1,19,18,0,26,1,17,Deep Impact,Bruce Joel Rubin,MISC-MISC,PER-PER-PER,ADJ-PROPN,PROPN-PROPN-PROPN,compound-nsubj,compound-compound-pobj,JJ-NNP,NNP-NNP-NNP,6,1
4,0.0,46,is,2,1,23,22,0,22,1,21,Deep Impact,Michael Tolkin,MISC-MISC,PER-PER,ADJ-PROPN,PROPN-PROPN,compound-nsubj,compound-conj,JJ-NNP,NNP-NNP,6,1
5,0.0,46,is,2,1,28,27,0,17,1,26,Deep Impact,Robert Duvall,MISC-MISC,PER-PER,ADJ-PROPN,PROPN-PROPN,compound-nsubj,compound-dobj,JJ-NNP,NNP-NNP,3,1
6,0.0,46,is,2,1,31,30,0,14,1,29,Deep Impact,Téa Leoni,MISC-MISC,PER-PER,ADJ-PROPN,PROPN-PROPN,compound-nsubj,compound-conj,JJ-NNP,NNP-NNP,4,1
7,0.0,46,is,2,1,34,33,0,11,1,32,Deep Impact,Elijah Wood,MISC-MISC,PER-PER,ADJ-PROPN,PROPN-PROPN,compound-nsubj,compound-conj,JJ-NNP,NNP-NNP,5,1
8,0.0,46,is,2,1,37,36,0,8,1,35,Deep Impact,Vanessa Redgrave,MISC-MISC,PER-PER,ADJ-PROPN,PROPN-PROPN,compound-nsubj,compound-conj,JJ-NNP,NNP-NNP,6,1
0,0.0,49,is,18,46,48,2,45,0,-28,30,London,England,LOC,LOC,PROPN,PROPN,npadvmod,appos,NNP,NNP,13,1
0,0.0,18,is,8,1,5,4,0,12,7,-3,Neil Marshall,25 May 1970,PER-PER,TIME-TIME-TIME,PROPN-PROPN,NUM-PROPN-NUM,compound-nsubj,nummod-npadvmod-nummod,NNP-NNP,CD-NNP-CD,2,1
1,2.0,14,followed,1,10,13,3,9,0,-9,12,The Descent,2005,MISC-MISC,TIME,DET-PROPN,NUM,det-appos,pobj,DT-NNP,CD,4,1
2,3.0,15,directed,2,4,6,2,3,8,-2,4,Doomsday,2008,MISC,TIME,PROPN,NUM,dobj,pobj,NNP,CD,2,1
0,0.0,19,is,5,3,15,12,2,3,2,10,Herøy,Nordland,LOC,LOC,PROPN,PROPN,pobj,compound,NNP,NNP,8,1
1,0.0,19,is,5,15,18,3,14,0,-10,13,Nordland,Norway,LOC,LOC,PROPN,PROPN,compound,appos,NNP,NNP,8,1
0,0.0,34,Alpi,1,1,9,8,0,24,0,8,Ilaria Alpi,Rome,PER-PER,LOC,PROPN-PROPN,PROPN,compound-ROOT,compound,NNP-NNP,NNP,2,1
1,0.0,34,Alpi,1,1,20,19,0,13,0,19,Ilaria Alpi,Italian,PER-PER,LOC,PROPN-PROPN,ADJ,compound-ROOT,amod,NNP-NNP,JJ,2,1
2,1.0,37,claimed,11,34,36,2,33,0,-23,25,Bosaso,Somalia,LOC,LOC,PROPN,PROPN,pobj,appos,NNP,NNP,10,1
3,3.0,14,born,2,1,13,12,0,0,1,11,Alpi,RAI,PER,ORG,PROPN,PROPN,nsubjpass,pobj,NNP,NNP,2,1
4,3.0,14,born,2,13,9,-4,12,4,-11,7,RAI,Italian,ORG,LOC,PROPN,ADJ,pobj,amod,NNP,JJ,7,1
5,4.0,26,portrayed,21,5,24,19,4,1,16,3,Ilaria Alpi - Il più crudele dei giorni,Giovanna Mezzogiorno,MISC-MISC-MISC-MISC-MISC-MISC-MISC-MISC,PER-PER,PROPN-PROPN-PUNCT-PROPN-ADJ-NOUN-NOUN-NOUN,PROPN-PROPN,compound-compound-punct-nmod-compound-nmod-compound-appos,compound-pobj,NNP-NNP-HYPH-NNP-JJ-NN-NN-NN,NNP-NNP,7,1
0,0.0,20,is,2,1,9,8,0,10,1,7,Columbia Island,Potomac River,LOC-LOC,LOC-LOC,PROPN-PROPN,PROPN-PROPN,compound-nsubj,compound-pobj,NNP-NNP,NNP-NNP,5,1
1,0.0,20,is,2,1,18,17,0,1,1,16,Columbia Island,United States,LOC-LOC,LOC-LOC,PROPN-PROPN,PROPN-PROPN,compound-nsubj,compound-pobj,NNP-NNP,NNP-NNP,4,1
2,7.0,25,are,9,14,22,8,13,2,-5,13,George Washington Memorial Parkway,National Park Service,LOC-LOC-LOC-LOC,ORG-ORG-ORG,PROPN-PROPN-PROPN-PROPN,PROPN-PROPN-PROPN,compound-compound-compound-pobj,compound-compound-pobj,NNP-NNP-NNP-NNP,NNP-NNP-NNP,8,1
0,0.0,23,is,9,1,6,5,0,16,8,-3,Frederick David Sears,27 November 1989,PER-PER-PER,TIME-TIME-TIME,PROPN-PROPN-PROPN,NUM-PROPN-NUM,compound-compound-nsubj,nummod-npadvmod-nummod,NNP-NNP-NNP,CD-NNP-CD,3,1
1,0.0,23,is,9,1,21,20,0,1,8,12,Frederick David Sears,Ipswich Town,PER-PER-PER,ORG-ORG,PROPN-PROPN-PROPN,PROPN-PROPN,compound-compound-nsubj,compound-pobj,NNP-NNP-NNP,NNP-NNP,8,1
2,4.0,30,had,1,1,10,9,0,19,0,9,Sears,Coventry City,PER,ORG-ORG,NOUN,PROPN-PROPN,nsubj,compound-conj,NNS,NNP-NNP,3,1
3,4.0,30,had,1,1,13,12,0,16,0,12,Sears,Scunthorpe United,PER,ORG-ORG,NOUN,PROPN-PROPN,nsubj,compound-conj,NNS,NNP-NNP,4,1
4,4.0,30,had,1,1,18,17,0,11,0,17,Sears,Colchester United,PER,ORG-ORG,NOUN,PROPN-PROPN,nsubj,compound-dobj,NNS,NNP-NNP,3,1
5,4.0,30,had,1,1,7,6,0,22,0,6,Sears,Crystal Palace,PER,ORG-ORG,NOUN,PROPN-PROPN,nsubj,compound-pobj,NNS,NNP-NNP,2,1
0,0.0,18,is,8,1,7,6,0,10,7,-1,Cingulata,Xenarthra,MISC,MISC,PROPN,PROPN,nsubj,appos,NNP,NNP,3,1
1,4.0,34,allowed,8,23,26,3,22,7,-15,18,Pliocene,Pleistocene,TIME,TIME,PROPN,PROPN,pobj,conj,NNP,NNP,4,1
2,5.0,54,died,17,22,30,8,21,23,-5,13,Quaternary,Holocene,TIME,TIME,PROPN,PROPN,compound,pobj,NNP,NNP,4,1
0,0.0,21,was,14,1,5,4,0,15,13,-9,James Hugh Relfe,"October 17 , 1791",PER-PER-PER,TIME-TIME-TIME-TIME,PROPN-PROPN-PROPN,PROPN-NUM-PUNCT-NUM,compound-compound-nsubj,nmod-nummod-punct-nummod,NNP-NNP-NNP,"NNP-CD-,-CD",3,1
1,8.0,28,elected,2,1,6,5,0,21,1,4,Relfe,Democrat,PER,ORG,PROPN,PROPN,nsubjpass,pobj,NNP,NNP,2,1
0,0.0,27,–,2,1,18,17,0,8,1,16,President Trump – The Piers Morgan Interview,ITV,MISC-MISC-MISC-MISC-MISC-MISC-MISC,ORG,PROPN-PROPN-PUNCT-DET-PROPN-PROPN-PROPN,PROPN,compound-compound-ROOT-det-compound-compound-nsubj,pobj,NNP-NNP-.-DT-NNPS-NNP-NNP,NNP,6,1
1,0.0,27,–,2,18,20,2,17,6,-16,18,ITV,the United Kingdom,ORG,LOC-LOC-LOC,PROPN,DET-PROPN-PROPN,pobj,det-compound-pobj,NNP,DT-NNP-NNP,2,1
0,0.0,14,is,1,1,12,11,0,1,0,11,Waterloo,United States,LOC,LOC-LOC,PROPN,PROPN-PROPN,nsubj,compound-appos,NNP,NNP-NNP,4,1
1,0.0,14,is,1,6,12,6,5,1,-5,11,Seneca County,United States,LOC-LOC,LOC-LOC,PROPN-PROPN,PROPN-PROPN,compound-pobj,compound-appos,NNP-NNP,NNP-NNP,1,1
2,0.0,14,is,1,9,12,3,8,1,-8,11,New York,United States,LOC-LOC,LOC-LOC,PROPN-PROPN,PROPN-PROPN,compound-conj,compound-appos,NNP-NNP,NNP-NNP,2,1
3,7.0,22,is,1,14,17,3,13,4,-13,16,Finger Lakes,Seneca Lake,LOC-LOC,LOC-LOC,PROPN-PROPN,PROPN-PROPN,compound-pobj,compound-conj,NNP-NNP,NNP-NNP,1,1
4,7.0,22,is,1,14,20,6,13,1,-13,19,Finger Lakes,Cayuga Lake,LOC-LOC,LOC-LOC,PROPN-PROPN,PROPN-PROPN,compound-pobj,compound-conj,NNP-NNP,NNP-NNP,2,1
0,0.0,20,is,8,1,5,4,0,14,7,-3,Janni Bach,28 April 1966,PER-PER,TIME-TIME-TIME,PROPN-PROPN,NUM-PROPN-NUM,compound-nsubj,nummod-npadvmod-nummod,NNP-NNP,CD-NNP-CD,2,1
1,0.0,20,is,8,1,11,10,0,8,7,3,Janni Bach,Danish,PER-PER,LOC,PROPN-PROPN,PROPN,compound-nsubj,npadvmod,NNP-NNP,NNP,4,1
2,4.0,16,was,1,1,9,8,0,6,0,8,Bach,2000 Summer Olympics,PER,MISC-MISC-MISC,PROPN,NUM-PROPN-PROPN,nsubj,nummod-compound-pobj,NNP,CD-NNP-NNPS,3,1
3,5.0,18,played,4,7,10,3,6,7,-3,6,Roskilde Håndbold,Denmark,ORG-ORG,LOC,PROPN-PROPN,PROPN,compound-pobj,pobj,NNP-NNP,NNP,3,1
4,5.0,18,played,4,13,17,4,12,0,-9,13,University of Sydney,Australia,ORG-ORG-ORG,LOC,PROPN-ADP-PROPN,PROPN,conj-prep-pobj,pobj,NNP-IN-NNP,NNP,3,1
0,0.0,19,is,4,11,15,4,10,3,-7,11,Edwards Plateau,U.S.,LOC-LOC,LOC,PROPN-PROPN,PROPN,compound-pobj,compound,NNP-NNP,NNP,2,1
1,0.0,19,is,4,11,18,7,10,0,-7,14,Edwards Plateau,Texas,LOC-LOC,LOC,PROPN-PROPN,PROPN,compound-pobj,pobj,NNP-NNP,NNP,5,1
2,0.0,19,is,4,15,18,3,14,0,-11,14,U.S.,Texas,LOC,LOC,PROPN,PROPN,compound,pobj,NNP,NNP,7,1
3,9.0,26,grew,8,1,6,5,0,19,7,-2,Bexar County,San Antonio,LOC-LOC,LOC-LOC,PROPN-PROPN,PROPN-PROPN,compound-nsubj,compound-dobj,NNP-NNP,NNP-NNP,2,1
0,0.0,29,was,25,1,6,5,0,22,24,-19,Wiesław Marian Chrzanowski,20 December 1923,PER-PER-PER,TIME-TIME-TIME,NOUN-PROPN-PROPN,NUM-PROPN-NUM,compound-compound-nsubj,nummod-nmod-nummod,NN-NNP-NNP,CD-NNP-CD,2,1
1,0.0,29,was,25,1,10,9,0,18,24,-15,Wiesław Marian Chrzanowski,29 April 2012,PER-PER-PER,TIME-TIME-TIME,NOUN-PROPN-PROPN,NUM-PROPN-NUM,compound-compound-nsubj,nummod-npadvmod-nummod,NN-NNP-NNP,CD-NNP-CD,3,1
2,2.0,10,born,2,7,9,2,6,0,-5,7,Warsaw,Poland,LOC,LOC,PROPN,PROPN,pobj,appos,NNP,NNP,5,1
3,3.0,21,was,5,19,2,-17,18,18,-14,-3,Home Army,World War II,ORG-ORG,MISC-MISC-MISC,PROPN-PROPN,PROPN-PROPN-PROPN,compound-appos,compound-compound-pobj,NNP-NNP,NNP-NNP-NNP,5,1
0,0.0,26,is,15,1,5,4,0,20,14,-10,Paul Raphaelson,1968,PER-PER,TIME,PROPN-PROPN,NUM,compound-nsubj,npadvmod,NNP-NNP,CD,1,1
1,0.0,26,is,15,1,13,12,0,12,14,-2,Paul Raphaelson,USA,PER-PER,LOC,PROPN-PROPN,PROPN,compound-nsubj,npadvmod,NNP-NNP,NNP,1,1
2,0.0,26,is,15,1,18,17,0,7,14,3,Paul Raphaelson,American,PER-PER,LOC,PROPN-PROPN,ADJ,compound-nsubj,amod,NNP-NNP,JJ,2,1
3,2.0,26,work,1,22,20,-2,21,5,-21,19,New York,Brooklyn,LOC-LOC,LOC,PROPN-PROPN,PROPN,compound-appos,pobj,NNP-NNP,NNP,2,1
0,0.0,21,is,6,14,17,3,13,3,-8,11,Indre Fosen,Trøndelag county,LOC-LOC,LOC-LOC,PROPN-PROPN,PROPN-NOUN,compound-pobj,compound-pobj,NNP-NNP,NNP-NN,2,1
1,0.0,21,is,6,14,20,6,13,0,-8,14,Indre Fosen,Norway,LOC-LOC,LOC,PROPN-PROPN,PROPN,compound-pobj,appos,NNP-NNP,NNP,6,1
2,0.0,21,is,6,17,20,3,16,0,-11,14,Trøndelag county,Norway,LOC-LOC,LOC,PROPN-NOUN,PROPN,compound-pobj,appos,NNP-NN,NNP,8,1
3,2.0,24,is,1,17,23,6,16,0,-16,22,Høybakken,Bjugn,LOC,LOC,PROPN,PROPN,pobj,pobj,NNP,NNP,7,1
0,0.0,20,was,11,2,6,4,1,13,9,-5,Henry Archdale Tomkinson,1881,PER-PER-PER,TIME,PROPN-PROPN-PROPN,NUM,compound-compound-nsubj,nummod,NNP-NNP-NNP,CD,2,1
1,0.0,20,was,11,2,8,6,1,11,9,-3,Henry Archdale Tomkinson,21 January 1937,PER-PER-PER,TIME-TIME-TIME,PROPN-PROPN-PROPN,NUM-PROPN-NUM,compound-compound-nsubj,nummod-appos-nummod,NNP-NNP-NNP,CD-NNP-CD,2,1
0,0.0,23,is,14,1,11,10,0,11,13,-3,Clas Eriksson,Karlstad,PER-PER,LOC,PROPN-PROPN,PROPN,compound-nsubj,pobj,NNP-NNP,NNP,3,1
1,0.0,23,is,14,1,13,12,0,9,13,-1,Clas Eriksson,Sweden,PER-PER,LOC,PROPN-PROPN,PROPN,compound-nsubj,appos,NNP-NNP,NNP,1,1
2,0.0,23,is,14,1,19,18,0,3,13,5,Clas Eriksson,Swedish,PER-PER,LOC,PROPN-PROPN,ADJ,compound-nsubj,amod,NNP-NNP,JJ,4,1
3,0.0,23,is,14,11,13,2,10,9,3,-1,Karlstad,Sweden,LOC,LOC,PROPN,PROPN,pobj,appos,NNP,NNP,4,1
4,2.0,24,played,5,5,18,13,4,5,0,13,Eriksson,Grums IK,PER,ORG-ORG,PROPN,PROPN-PROPN,nsubj,compound-pobj,NNP,NNP-NNP,5,1
5,5.0,38,plays,9,1,5,4,0,32,8,-4,Eriksson,Joel Eriksson Ek,PER,PER-PER-PER,PROPN,PROPN-PROPN-PROPN,poss,compound-compound-appos,NNP,NNP-NNP-NNP,4,1
6,5.0,38,plays,9,13,18,5,12,19,-4,9,Minnesota Wild,National Hockey League,ORG-ORG,ORG-ORG-ORG,PROPN-PROPN,PROPN-PROPN-PROPN,compound-compound,compound-compound-pobj,NNP-NNP,NNP-NNP-NNP,4,1
0,0.0,36,was,3,6,18,12,5,17,-3,15,American,Richard Nixon,LOC,PER-PER,ADJ,PROPN-PROPN,amod,compound-pobj,JJ,NNP-NNP,4,1
0,3.0,35,used,19,24,28,4,23,6,-5,9,Allies,World War II,ORG,MISC-MISC-MISC,PROPN,PROPN-PROPN-PROPN,poss,compound-compound-pobj,NNPS,NNP-NNP-NNP,5,1
0,0.0,16,was,11,1,4,3,0,11,10,-7,Hermann Finck,21 March 1527,PER-PER,TIME-TIME-TIME,PROPN-PROPN,NUM-PROPN-NUM,compound-nsubj,nummod-appos-nummod,NNP-NNP,CD-NNP-CD,1,1
1,0.0,16,was,11,1,8,7,0,7,10,-3,Hermann Finck,28 December 1558,PER-PER,TIME-TIME-TIME,PROPN-PROPN,NUM-PROPN-NUM,compound-nsubj,nummod-appos-nummod,NNP-NNP,CD-NNP-CD,2,1
2,0.0,16,was,11,1,14,13,0,1,10,3,Hermann Finck,German,PER-PER,LOC,PROPN-PROPN,ADJ,compound-nsubj,amod,NNP-NNP,JJ,2,1
3,1.0,20,born,11,10,14,4,9,5,1,3,Hermann,Pirna,PER,LOC,PROPN,PROPN,nsubjpass,pobj,NNP,NNP,2,1
4,1.0,20,born,11,10,19,9,9,0,1,8,Hermann,Wittenberg,PER,LOC,PROPN,PROPN,nsubjpass,pobj,NNP,NNP,2,1
0,0.0,19,is,5,1,15,14,0,3,4,10,Tales of Mystery and Imagination,The Alan Parsons Project,MISC-MISC-MISC-MISC-MISC,ORG-ORG-ORG-ORG,NOUN-ADP-PROPN-CCONJ-PROPN,DET-PROPN-PROPN-PROPN,nsubj-prep-pobj-cc-conj,det-compound-compound-ROOT,NNS-IN-NNP-CC-NNP,DT-NNP-NNPS-NNP,6,1
1,4.0,61,include,5,11,8,-3,10,52,-6,3,The Crazy World of Arthur Brown,Arthur Brown,ORG-ORG-ORG-ORG-ORG-ORG,PER-PER,DET-PROPN-PROPN-ADP-PROPN-PROPN,PROPN-PROPN,det-compound-pobj-prep-compound-pobj,compound-dobj,DT-NNP-NNP-IN-NNP-NNP,NNP-NNP,3,1
0,0.0,55,is,11,39,51,12,38,3,-28,40,Nootka Island,British Columbia,LOC-LOC,LOC-LOC,PROPN-PROPN,PROPN-PROPN,compound-pobj,compound-appos,NNP-NNP,NNP-NNP,7,1
1,0.0,55,is,11,39,54,15,38,0,-28,43,Nootka Island,Canada,LOC-LOC,LOC,PROPN-PROPN,PROPN,compound-pobj,appos,NNP-NNP,NNP,9,1
2,0.0,55,is,11,39,51,12,38,3,-28,40,Nootka Sound,British Columbia,LOC-LOC,LOC-LOC,PROPN-PROPN,PROPN-PROPN,compound-pobj,compound-appos,NNP-NNP,NNP-NNP,7,1
3,0.0,55,is,11,39,54,15,38,0,-28,43,Nootka Sound,Canada,LOC-LOC,LOC,PROPN-PROPN,PROPN,compound-pobj,appos,NNP-NNP,NNP,9,1
4,0.0,55,is,11,48,51,3,47,3,-37,40,Vancouver Island,British Columbia,LOC-LOC,LOC-LOC,PROPN-PROPN,PROPN-PROPN,compound-pobj,compound-appos,NNP-NNP,NNP-NNP,1,1
5,0.0,55,is,11,48,54,6,47,0,-37,43,Vancouver Island,Canada,LOC-LOC,LOC,PROPN-PROPN,PROPN,compound-pobj,appos,NNP-NNP,NNP,9,1
6,0.0,55,is,11,51,54,3,50,0,-40,43,British Columbia,Canada,LOC-LOC,LOC,PROPN-PROPN,PROPN,compound-appos,appos,NNP-NNP,NNP,10,1
0,0.0,22,is,8,1,5,4,0,16,7,-3,Kerron Stewart,16 April 1984,PER-PER,TIME-TIME-TIME,PROPN-PROPN,NUM-PROPN-NUM,compound-nsubj,nummod-npadvmod-nummod,NNP-NNP,CD-NNP-CD,2,1
1,6.0,30,ran,10,3,8,5,2,21,7,-2,2009 World Athletics Championships,Berlin,MISC-MISC-MISC-MISC,LOC,NUM-PROPN-PROPN-PROPN,PROPN,nummod-compound-compound-pobj,pobj,CD-NNP-NNP-NNP,NNP,4,1
0,0.0,36,was,15,32,35,3,31,0,-17,20,Western Tasmania,Australia,LOC-LOC,LOC,PROPN-PROPN,PROPN,compound-pobj,appos,NNP-NNP,NNP,10,1
1,1.0,47,proposed,27,4,9,5,3,37,23,-18,Hydro - Electric Commission,Tasmania,ORG-ORG-ORG-ORG,LOC,PROPN-PUNCT-PROPN-PROPN,PROPN,compound-punct-compound-pobj,pobj,NNP-HYPH-NNP-NNP,NNP,5,1
0,2.0,29,has,10,10,3,-7,9,25,0,-7,Sanitarium,Melbourne,ORG,LOC,PROPN,PROPN,nsubj,pobj,NNP,NNP,4,1
1,2.0,29,has,10,10,8,-2,9,20,0,-2,Sanitarium,1898,ORG,TIME,PROPN,NUM,nsubj,pobj,NNP,CD,1,1
2,2.0,29,has,10,3,5,2,2,23,7,-5,Melbourne,Victoria,LOC,LOC,PROPN,PROPN,pobj,appos,NNP,NNP,4,1
0,0.0,20,is,1,1,15,14,0,4,0,14,Lappkärret,Sweden,LOC,LOC,PROPN,PROPN,nsubj,appos,NNP,NNP,2,1
1,0.0,20,is,1,7,13,6,6,6,-6,12,Norra Djurgården,Stockholm,LOC-LOC,LOC,PROPN-PROPN,PROPN,compound-pobj,pobj,NNP-NNP,NNP,3,1
2,0.0,20,is,1,7,15,8,6,4,-6,14,Norra Djurgården,Sweden,LOC-LOC,LOC,PROPN-PROPN,PROPN,compound-pobj,appos,NNP-NNP,NNP,3,1
3,0.0,20,is,1,13,15,2,12,4,-12,14,Stockholm,Sweden,LOC,LOC,PROPN,PROPN,pobj,appos,NNP,NNP,6,1
0,0.0,21,was,15,1,6,5,0,14,14,-9,Littleberry C. Mosby Jr.,"January 28 , 1757",PER-PER-PER-PER,TIME-TIME-TIME-TIME,PROPN-PROPN-PROPN-PROPN,PROPN-NUM-PUNCT-NUM,compound-compound-compound-subtok,nsubj-nummod-punct-nummod,NNP-NNP-NNP-NNP,"NNP-CD-,-CD",-1,1
1,0.0,21,was,15,1,11,10,0,9,14,-4,Littleberry C. Mosby Jr.,"October 26 , 1821",PER-PER-PER-PER,TIME-TIME-TIME-TIME,PROPN-PROPN-PROPN-PROPN,PROPN-NUM-PUNCT-NUM,compound-compound-compound-subtok,npadvmod-nummod-punct-nummod,NNP-NNP-NNP-NNP,"NNP-CD-,-CD",-1,1
2,0.0,21,was,15,1,18,17,0,2,14,3,Littleberry C. Mosby Jr.,American,PER-PER-PER-PER,LOC,PROPN-PROPN-PROPN-PROPN,ADJ,compound-compound-compound-subtok,amod,NNP-NNP-NNP-NNP,JJ,-1,1
3,1.0,32,served,7,27,31,4,26,0,-20,24,Siege of Savannah,1778,MISC-MISC-MISC,TIME,PROPN-ADP-PROPN,NUM,pobj-prep-pobj,pobj,NNP-IN-NNP,CD,5,1
0,0.0,12,is,2,1,7,6,0,4,1,5,Bayview Village,Toronto,LOC-LOC,LOC,PROPN-PROPN,PROPN,compound-nsubj,pobj,NNP-NNP,NNP,5,1
1,0.0,12,is,2,1,9,8,0,2,1,7,Bayview Village,Ontario,LOC-LOC,LOC,PROPN-PROPN,PROPN,compound-nsubj,conj,NNP-NNP,NNP,6,1
2,0.0,12,is,2,1,11,10,0,0,1,9,Bayview Village,Canada,LOC-LOC,LOC,PROPN-PROPN,PROPN,compound-nsubj,appos,NNP-NNP,NNP,2,1
3,0.0,12,is,2,7,9,2,6,2,-5,7,Toronto,Ontario,LOC,LOC,PROPN,PROPN,pobj,conj,NNP,NNP,3,1
4,0.0,12,is,2,7,11,4,6,0,-5,9,Toronto,Canada,LOC,LOC,PROPN,PROPN,pobj,appos,NNP,NNP,5,1
5,0.0,12,is,2,9,11,2,8,0,-7,9,Ontario,Canada,LOC,LOC,PROPN,PROPN,conj,appos,NNP,NNP,6,1
0,1.0,31,known,20,3,26,23,2,4,17,6,German Air Force,Germany,ORG-ORG-ORG,LOC,ADJ-PROPN-PROPN,PROPN,amod-compound-compound,poss,JJ-NNP-NNP,NNP,9,1
1,3.0,20,seen,7,3,13,10,2,6,4,6,Mechtersheimer,CSU,PER,ORG,PROPN,PROPN,poss,pobj,NNP,NNP,5,1
0,0.0,18,is,10,1,6,5,0,11,9,-4,James Michael Osting,"April 7 , 1977",PER-PER-PER,TIME-TIME-TIME-TIME,PROPN-PROPN-PROPN,PROPN-NUM-PUNCT-NUM,compound-compound-nsubj,npadvmod-nummod-punct-nummod,NNP-NNP-NNP,"NNP-CD-,-CD",4,1
1,1.0,19,drafted,2,1,17,16,0,1,1,15,Osting,Atlanta Braves,PER,ORG-ORG,VERB,PROPN-PROPN,nsubjpass,compound-pobj,VBG,NNP-NNPS,5,1
2,2.0,19,traded,5,9,13,4,8,5,-4,8,Bruce Chen,Philadelphia Phillies,PER-PER,ORG-ORG,PROPN-PROPN,PROPN-PROPN,compound-pobj,compound-compound,NNP-NNP,NNP-NNPS,5,1
0,2.0,33,depicted,2,21,28,7,20,4,-19,26,Jean Rouch,French,PER-PER,LOC,PROPN-PROPN,ADJ,compound-pobj,amod,NNP-NNP,JJ,2,1
1,3.0,25,was,7,16,24,8,15,0,-9,17,Niger,Africa,LOC,LOC,PROPN,PROPN,pobj,pobj,NNP,NNP,2,1
0,0.0,39,is,8,1,5,4,0,33,7,-3,Andrew Baines,17 June 1962,PER-PER,TIME-TIME-TIME,PROPN-PROPN,NUM-PROPN-NUM,compound-nsubj,nummod-npadvmod-nummod,NNP-NNP,CD-NNP-CD,2,1
0,1.0,33,operated,5,21,23,2,20,9,-16,18,Brantford,Ontario,LOC,LOC,PROPN,PROPN,pobj,conj,NNP,NNP,2,1
1,9.0,47,provides,2,41,39,-2,40,7,-39,37,CNE,Ontario,MISC,LOC,PROPN,PROPN,conj,poss,NNP,NNP,3,1
0,0.0,19,is,9,1,6,5,0,12,8,-3,Valgerd Svarstad Haugland,23 August 1956,PER-PER-PER,TIME-TIME-TIME,PROPN-PROPN-PROPN,NUM-PROPN-NUM,compound-compound-nsubj,nummod-npadvmod-nummod,NNP-NNP-NNP,CD-NNP-CD,3,1
1,1.0,6,born,2,1,5,4,0,0,1,3,Haugland,Kvam,PER,LOC,PROPN,PROPN,nsubjpass,pobj,NNP,NNP,2,1
2,2.0,15,was,1,6,10,4,5,4,-5,9,Christian Democratic Party,Norway,ORG-ORG-ORG,LOC,PROPN-PROPN-PROPN,PROPN,compound-compound-pobj,pobj,NNP-NNP-NNP,NNP,4,1
0,0.0,20,was,12,1,5,4,0,14,11,-7,Elena Carter Richardson,26 December 1948,PER-PER-PER,TIME-TIME-TIME,PROPN-PROPN-PROPN,NUM-PROPN-NUM,compound-compound-nsubj,nummod-appos-nummod,NNP-NNP-NNP,CD-NNP-CD,2,1
1,0.0,20,was,12,1,9,8,0,10,11,-3,Elena Carter Richardson,4 February 2006,PER-PER-PER,TIME-TIME-TIME,PROPN-PROPN-PROPN,NUM-PROPN-NUM,compound-compound-nsubj,nummod-appos-appos,NNP-NNP-NNP,CD-NNP-CD,2,1
2,0.0,20,was,12,1,15,14,0,4,11,3,Elena Carter Richardson,American,PER-PER-PER,LOC,PROPN-PROPN-PROPN,ADJ,compound-compound-nsubj,amod,NNP-NNP-NNP,JJ,3,1
3,1.0,38,trained,10,5,5,0,4,32,5,-5,Mexico City,Mexico,LOC-LOC,LOC,PROPN-PROPN,PROPN,compound-pobj,appos,NNP-NNP,NNP,0,1
0,0.0,28,was,13,1,4,3,0,23,12,-9,Karlheinz Martin,"May 6 , 1886",PER-PER,TIME-TIME-TIME-TIME,PROPN-PROPN,PROPN-NUM-PUNCT-NUM,compound-nsubj,nmod-nummod-punct-npadvmod,NNP-NNP,"NNP-CD-,-CD",2,1
1,0.0,28,was,13,1,9,8,0,18,12,-4,Karlheinz Martin,"January 13 , 1948",PER-PER,TIME-TIME-TIME-TIME,PROPN-PROPN,PROPN-NUM-PUNCT-NUM,compound-nsubj,appos-nummod-punct-nummod,NNP-NNP,"NNP-CD-,-CD",3,1
2,1.0,40,am,8,14,12,-2,13,27,-6,4,Martin,Hamburg,PER,LOC,PROPN,PROPN,nsubj,conj,NNP,NNP,1,1
3,7.0,17,revived,6,8,11,3,7,5,-2,5,Bertolt Brecht,The Threepenny Opera,PER-PER,MISC-MISC-MISC,PROPN-PROPN,DET-PROPN-PROPN,compound-poss,compound-compound-dobj,NNP-NNP,DT-NNP-NNP,2,1
0,0.0,44,is,8,1,5,4,0,38,7,-3,Michael Haneke,23 March 1942,PER-PER,TIME-TIME-TIME,PROPN-PROPN,NUM-PROPN-NUM,compound-compound,nummod-npadvmod-nummod,NNP-NNP,CD-NNP-CD,2,1
1,0.0,44,is,8,22,25,3,21,18,-14,17,Funny Games,1997,MISC-MISC,TIME,PROPN-PROPN,NUM,compound-pobj,appos,NNP-NNPS,CD,1,1
2,0.0,44,is,8,28,30,2,27,13,-20,22,Caché,2005,MISC,TIME,PROPN,NUM,conj,appos,NNP,CD,2,1
0,1.0,48,follows,15,7,12,5,6,35,8,-3,American,Washington,LOC,LOC,ADJ,PROPN,amod,appos,JJ,NNP,4,1
1,2.0,39,published,19,1,7,6,0,31,18,-12,Deadly Premonition,2010,MISC-MISC,TIME,PROPN-PROPN,NUM,amod-nsubjpass,pobj,NNP-NNP,CD,2,1
2,2.0,39,published,19,1,22,21,0,16,18,3,Deadly Premonition,Ignition Entertainment,MISC-MISC,ORG-ORG,PROPN-PROPN,PROPN-PROPN,amod-nsubjpass,compound-pobj,NNP-NNP,NNP-NNP,4,1
0,0.0,20,Wettstein,1,1,4,3,0,15,0,3,Richard Wettstein,30 June 1863,PER-PER,TIME-TIME-TIME,PROPN-PROPN,NUM-PROPN-NUM,compound-ROOT,nummod-appos-nummod,NNP-NNP,CD-NNP-CD,1,1
1,0.0,20,Wettstein,1,1,8,7,0,11,0,7,Richard Wettstein,Vienna,PER-PER,LOC,PROPN-PROPN,PROPN,compound-ROOT,compound,NNP-NNP,NNP,1,1
2,0.0,20,Wettstein,1,1,10,9,0,9,0,9,Richard Wettstein,10 August 1931,PER-PER,TIME-TIME-TIME,PROPN-PROPN,NUM-PROPN-NUM,compound-ROOT,nummod-nsubj-nummod,NNP-NNP,CD-NNP-CD,1,1
3,0.0,20,Wettstein,1,1,14,13,0,5,0,13,Richard Wettstein,Trins,PER-PER,LOC,PROPN-PROPN,PROPN,compound-ROOT,pobj,NNP-NNP,NNP,1,1
4,0.0,20,Wettstein,1,1,18,17,0,1,0,17,Richard Wettstein,Austrian,PER-PER,LOC,PROPN-PROPN,ADJ,compound-ROOT,amod,NNP-NNP,JJ,2,1
5,2.0,26,studied,1,12,17,5,11,8,-11,16,Anton Kerner von Marilaun,1831,PER-PER-PER-PER,TIME,PROPN-PROPN-PROPN-PROPN,NUM,compound-compound-compound-pobj,appos,NNP-NNP-NNP-NNP,CD,4,1
0,0.0,29,is,11,17,21,4,16,7,-6,10,Burgettstown,United States,LOC,LOC-LOC,PROPN,PROPN-PROPN,pobj,compound-conj,NNP,NNP-NNP,3,1
1,0.0,29,is,11,19,21,2,18,7,-8,10,Pennsylvania,United States,LOC,LOC-LOC,PROPN,PROPN-PROPN,conj,compound-conj,NNP,NNP-NNP,2,1
2,9.0,31,lost,3,12,22,10,11,8,-9,19,Stage AE,Pittsburgh,LOC-LOC,LOC,PROPN-PROPN,PROPN,compound-pobj,pobj,NNP-NNP,NNP,4,1
3,9.0,31,lost,3,25,22,-3,24,8,-22,19,North Shore,Pittsburgh,LOC-LOC,LOC,PROPN-PROPN,PROPN,compound-pobj,pobj,NNP-NNP,NNP,1,1
4,9.0,31,lost,3,29,22,-7,28,8,-26,19,Heinz Field,Pittsburgh,LOC-LOC,LOC,PROPN-PROPN,PROPN,compound-pobj,pobj,NNP-NNP,NNP,6,1
0,0.0,31,"""",0,2,27,25,1,3,-2,27,To Be or Not to Be,1983,MISC-MISC-MISC-MISC-MISC-MISC,TIME,PART-VERB-CCONJ-ADV-PART-VERB,NUM,prep-pobj-cc-neg-aux-auxpass,pobj,TO-VB-CC-RB-TO-VB,CD,5,1
1,0.0,31,"""",0,2,29,27,1,1,-2,29,To Be or Not to Be,Island Records,MISC-MISC-MISC-MISC-MISC-MISC,ORG-ORG,PART-VERB-CCONJ-ADV-PART-VERB,PROPN-PROPN,prep-pobj-cc-neg-aux-auxpass,compound-pobj,TO-VB-CC-RB-TO-VB,NNP-NNPS,6,1
2,0.0,31,"""",0,14,29,15,13,1,-14,29,The Hitler Rap,Island Records,MISC-MISC-MISC,ORG-ORG,DET-PROPN-PROPN,PROPN-PROPN,compound-compound-pobj,compound-pobj,DT-NNP-NNP,NNP-NNPS,8,1
3,0.0,31,"""",0,24,29,5,23,1,-24,29,Mel Brooks,Island Records,PER-PER,ORG-ORG,PROPN-PROPN,PROPN-PROPN,compound-pobj,compound-pobj,NNP-NNP,NNP-NNPS,4,1
0,0.0,14,is,3,1,13,12,0,0,2,10,Nairobi,Kenya,LOC,LOC,PROPN,PROPN,pobj,appos,NNP,NNP,3,1
1,7.0,25,is,14,1,4,3,0,20,13,-10,Musa Otieno,Kenyan,PER-PER,LOC,PROPN-PROPN,ADJ,compound-nsubj,amod,NNP-NNP,JJ,2,1
2,8.0,17,retained,3,8,1,-7,7,15,-5,-2,Hope Centre,Nairobi,LOC-LOC,LOC,PROPN-PROPN,PROPN,compound-appos,pobj,NNP-NNP,NNP,3,1
0,0.0,54,spelled,3,50,53,3,49,0,-47,50,Haryana,India,LOC,LOC,PROPN,PROPN,compound,pobj,NNP,NNP,8,1
1,0.0,54,spelled,3,50,36,-14,49,17,-47,33,Haryana,Hisar District,LOC,LOC-LOC,PROPN,PROPN-PROPN,compound,compound-pobj,NNP,NNP-NNP,8,1
2,0.0,54,spelled,3,50,36,-14,49,17,-47,33,Haryana,Hisar Division,LOC,LOC-LOC,PROPN,PROPN-PROPN,compound,compound-pobj,NNP,NNP-NNP,8,1
3,0.0,54,spelled,3,19,36,17,18,17,-16,33,Hansi,Hisar District,LOC,LOC-LOC,PROPN,PROPN-PROPN,nmod,compound-pobj,NNP,NNP-NNP,8,1
4,0.0,54,spelled,3,36,36,0,35,17,-33,33,Hisar,Hisar Division,LOC,LOC-LOC,PROPN,PROPN-PROPN,conj,compound-pobj,NNP,NNP-NNP,0,1
5,0.0,54,spelled,3,36,36,0,35,17,-33,33,Hisar District,Hisar Division,LOC-LOC,LOC-LOC,PROPN-PROPN,PROPN-PROPN,compound-pobj,compound-pobj,NNP-NNP,NNP-NNP,0,1
0,3.0,35,began,19,30,22,-8,29,12,-11,3,Volga Bulgaria,Europe,LOC-LOC,LOC,PROPN-PROPN,PROPN,compound-conj,dobj,NNP-NNP,NNP,6,1
1,3.0,35,began,19,33,22,-11,32,12,-14,3,Kievan Rus,Europe,LOC-LOC,LOC,PROPN-PROPN,PROPN,compound-conj,dobj,NNP-NNP,NNP,7,1
2,4.0,21,destroyed,1,4,11,7,3,9,-3,10,Rus,Moscow,LOC,LOC,PROPN,PROPN,compound,conj,NNP,NNP,2,1
3,6.0,32,returned,25,15,9,-6,14,22,10,-16,Genghis Khan,Ögedei Khan,PER-PER,PER-PER,PROPN-PROPN,PROPN-PROPN,compound-pobj,compound-pobj,NNP-NNP,NNP-NNP,3,1
4,6.0,32,returned,25,9,24,15,8,7,16,-1,Ögedei Khan,1241,PER-PER,TIME,PROPN-PROPN,NUM,compound-pobj,pobj,NNP-NNP,CD,7,1
0,0.0,37,was,25,1,10,9,0,26,24,-15,Bartolomeo Altomonte,24 February 1694,PER-PER,TIME-TIME-TIME,PROPN-PROPN,NUM-PROPN-NUM,compound-nsubj,nummod-appos-nummod,NNP-NNP,CD-NNP-CD,4,1
1,0.0,37,was,25,1,17,16,0,19,24,-8,Bartolomeo Altomonte,11 November 1783,PER-PER,TIME-TIME-TIME,PROPN-PROPN,NUM-PROPN-NUM,compound-nsubj,nummod-appos-nummod,NNP-NNP,CD-NNP-CD,4,1
2,0.0,37,was,25,1,22,21,0,14,24,-3,Bartolomeo Altomonte,Sankt Florian,PER-PER,LOC-LOC,PROPN-PROPN,PROPN-PROPN,compound-nsubj,compound-pobj,NNP-NNP,NNP-NNP,4,1
3,0.0,37,was,25,7,10,3,6,26,18,-15,Bartholomäus Hohenberg,24 February 1694,PER-PER,TIME-TIME-TIME,PROPN-PROPN,NUM-PROPN-NUM,compound-pobj,nummod-appos-nummod,NNP-NNP,CD-NNP-CD,1,1
4,0.0,37,was,25,7,17,10,6,19,18,-8,Bartholomäus Hohenberg,11 November 1783,PER-PER,TIME-TIME-TIME,PROPN-PROPN,NUM-PROPN-NUM,compound-pobj,nummod-appos-nummod,NNP-NNP,CD-NNP-CD,1,1
5,0.0,37,was,25,7,22,15,6,14,18,-3,Bartholomäus Hohenberg,Sankt Florian,PER-PER,LOC-LOC,PROPN-PROPN,PROPN-PROPN,compound-pobj,compound-pobj,NNP-NNP,NNP-NNP,5,1
6,0.0,37,was,25,22,28,6,21,8,3,3,Sankt Florian,Austrian,LOC-LOC,LOC,PROPN-PROPN,ADJ,compound-pobj,amod,NNP-NNP,JJ,4,1
7,4.0,24,spent,1,1,13,12,0,10,0,12,Altomonte,Austrian,PER,LOC,PROPN,ADJ,nsubj,amod,NNP,JJ,3,1
0,0.0,22,Lett,1,1,5,4,0,16,0,4,Evelyn Lett,"Oct. 17 , 1896",PER-PER,TIME-TIME-TIME-TIME,PROPN-PROPN,PROPN-NUM-PUNCT-NUM,compound-ROOT,npadvmod-nummod-punct-nummod,NNP-NNP,"NNP-CD-,-CD",3,1
1,0.0,22,Lett,1,1,10,9,0,11,0,9,Evelyn Lett,"March 26 , 1999",PER-PER,TIME-TIME-TIME-TIME,PROPN-PROPN,PROPN-NUM-PUNCT-NUM,compound-ROOT,nsubj-nummod-punct-nummod,NNP-NNP,"NNP-CD-,-CD",4,1
2,0.0,22,Lett,1,1,17,16,0,4,0,16,Evelyn Lett,Canadian,PER-PER,LOC,PROPN-PROPN,ADJ,compound-ROOT,amod,NNP-NNP,JJ,4,1
3,1.0,21,moved,9,5,7,2,4,13,4,-2,Wawanesa,Manitoba,LOC,LOC,PROPN,PROPN,pobj,appos,NNP,NNP,5,1
4,6.0,18,was,1,5,9,4,4,8,-4,8,Sherwood Lett,Canadian,PER-PER,LOC,PROPN-PROPN,ADJ,compound-pobj,amod,NNP-NNP,JJ,1,1
0,1.0,57,scheduled,2,19,51,32,18,5,-17,49,Parliament of Australia,House of Representatives,ORG-ORG-ORG,ORG-ORG-ORG,PROPN-ADP-PROPN,PROPN-ADP-PROPN,pobj-prep-pobj,pobj-prep-pobj,NNP-IN-NNP,NNP-IN-NNPS,14,1
0,0.0,22,is,13,7,21,14,6,0,6,8,French,France,MISC,LOC,PROPN,PROPN,appos,appos,NNP,NNP,4,1
1,0.0,22,is,13,3,21,18,2,0,10,8,Pierre de Coubertin Stadium,France,LOC-LOC-LOC-LOC,LOC,PROPN-ADP-PROPN-PROPN,PROPN,compound-compound-compound-appos,appos,NNP-IN-NNP-NNP,NNP,3,1
2,0.0,22,is,13,19,21,2,18,0,-6,8,Paris,France,LOC,LOC,PROPN,PROPN,pobj,appos,NNP,NNP,5,1
3,2.0,24,rebuilt,15,2,8,6,1,15,13,-7,Stade Pierre de Coubertin,1937,LOC-LOC-LOC-LOC,TIME,PROPN-PROPN-PROPN-PROPN,NUM,compound-compound-compound-nsubj,pobj,NNP-NNP-NNP-NNP,CD,3,1
0,0.0,20,is,9,1,6,5,0,13,8,-3,François Asselineau,14 September 1957,PER-PER,TIME-TIME-TIME,PROPN-PROPN,NUM-PROPN-NUM,compound-nsubj,nummod-npadvmod-nummod,NNP-NNP,CD-NNP-CD,2,1
1,2.0,17,promotes,2,4,10,6,3,6,-2,8,France,European Union,LOC,ORG-ORG,PROPN,PROPN-PROPN,poss,compound-pobj,NNP,NNP-NNP,4,1
2,2.0,17,promotes,2,4,14,10,3,2,-2,12,France,Eurozone,LOC,LOC,PROPN,PROPN,poss,conj,NNP,NNP,6,1
3,2.0,17,promotes,2,4,16,12,3,0,-2,14,France,NATO,LOC,ORG,PROPN,PROPN,poss,conj,NNP,NNP,4,1
0,2.0,15,held,6,9,11,2,8,3,-3,5,Colombo,Sri Lanka,LOC,LOC-LOC,PROPN,PROPN-PROPN,pobj,compound-npadvmod,NNP,NNP-NNP,3,1
0,1.0,13,was,1,9,12,3,8,0,-8,11,Iranian Revolution,1979,MISC-MISC,TIME,PROPN-PROPN,NUM,compound-pobj,pobj,NNP-NNP,CD,6,1
0,8.0,32,saw,9,15,24,9,14,7,-6,15,Augustus,Roman Empire,PER,LOC-LOC,PROPN,PROPN-PROPN,pobj,compound-dobj,NNP,NNP-NNP,5,1
0,1.0,24,episode,2,13,5,-8,12,18,-11,3,Comedy Central,the United States,ORG-ORG,LOC-LOC-LOC,PROPN-PROPN,DET-PROPN-PROPN,compound-pobj,det-compound-pobj,NNP-NNP,DT-NNP-NNP,5,1
0,3.0,30,been,10,26,29,3,25,0,-16,19,Angela Merkel,CDU,PER-PER,ORG,PROPN-PROPN,PROPN,compound-poss,pobj,NNP-NNP,NNP,7,1
1,5.0,32,remains,2,20,23,3,19,8,-18,21,European Union,Poland,ORG-ORG,LOC,PROPN-PROPN,PROPN,compound-pobj,pobj,NNP-NNP,NNP,3,1
2,6.0,26,hosted,1,7,1,-6,6,24,-6,0,Bonn,Germany,LOC,LOC,PROPN,PROPN,pobj,nsubj,NNP,NNP,3,1
3,6.0,26,hosted,1,7,11,4,6,14,-6,10,Bonn,German,LOC,LOC,PROPN,ADJ,pobj,amod,NNP,JJ,2,1
0,0.0,18,is,11,1,10,9,0,7,10,-1,Vasileios Reppas,Athens,PER-PER,LOC,PROPN-PROPN,PROPN,compound-compound,pobj,NNP-NNP,NNP,2,1
1,2.0,39,qualified,1,1,14,13,0,24,0,13,Reppas,2008 Summer Olympics,PER,MISC-MISC-MISC,PROPN,NUM-PROPN-PROPN,nsubj,nummod-compound-pobj,NNP,CD-NNP-NNPS,5,1
2,2.0,39,qualified,1,14,18,4,13,20,-13,17,2008 Summer Olympics,Beijing,MISC-MISC-MISC,LOC,NUM-PROPN-PROPN,PROPN,nummod-compound-pobj,pobj,CD-NNP-NNPS,NNP,6,1
0,0.0,7,is,2,1,5,4,0,1,1,3,Ray Monette,American,PER-PER,LOC,PROPN-PROPN,ADJ,compound-nsubj,amod,NNP-NNP,JJ,2,1
1,4.0,18,appears,2,12,16,4,11,1,-10,14,Stoney & Meatloaf,1971,MISC-MISC-MISC,TIME,PROPN-CCONJ-PROPN,NUM,pobj-cc-conj,appos,NNP-CC-NNP,CD,5,1
0,0.0,16,is,3,1,6,5,0,9,2,3,John Gregory Myre,American,PER-PER-PER,LOC,PROPN-PROPN-PROPN,ADJ,compound-compound-nsubj,amod,NNP-NNP-NNP,JJ,3,1
1,4.0,56,covered,1,34,37,3,33,18,-33,36,Vladimir Putin,Russia,PER-PER,LOC,PROPN-PROPN,PROPN,compound-pobj,poss,NNP-NNP,NNP,6,1
2,4.0,56,covered,1,52,55,3,51,0,-51,54,U.S.,Afghanistan,LOC,LOC,PROPN,PROPN,compound,pobj,NNP,NNP,10,1
3,5.0,13,is,1,8,12,4,7,0,-7,11,Middle East Institute,Washington,ORG-ORG-ORG,LOC,PROPN-PROPN-PROPN,PROPN,compound-compound-pobj,pobj,NNP-NNP-NNP,NNP,5,1
0,0.0,22,is,2,1,17,16,0,4,1,15,Church Street,New South Wales,LOC-LOC,LOC-LOC-LOC,PROPN-PROPN,PROPN-PROPN-PROPN,compound-nsubj,compound-compound-conj,NNP-NNP,NNP-NNP-NNP,4,1
1,0.0,22,is,2,1,21,20,0,0,1,19,Church Street,Australia,LOC-LOC,LOC,PROPN-PROPN,PROPN,compound-nsubj,npadvmod,NNP-NNP,NNP,2,1
2,0.0,22,is,2,15,17,2,14,4,-13,15,Wollongong,New South Wales,LOC,LOC-LOC-LOC,PROPN,PROPN-PROPN-PROPN,pobj,compound-compound-conj,NNP,NNP-NNP-NNP,3,1
3,0.0,22,is,2,15,21,6,14,0,-13,19,Wollongong,Australia,LOC,LOC,PROPN,PROPN,pobj,npadvmod,NNP,NNP,3,1
4,0.0,22,is,2,17,21,4,16,0,-15,19,New South Wales,Australia,LOC-LOC-LOC,LOC,PROPN-PROPN-PROPN,PROPN,compound-compound-conj,npadvmod,NNP-NNP-NNP,NNP,4,1
0,0.0,39,was,24,1,16,15,0,22,23,-8,Jacob Billikopf,Vilnius,PER-PER,LOC,PROPN-PROPN,PROPN,compound-nsubj,conj,NNP-NNP,NNP,-1,1
1,0.0,39,was,24,1,20,19,0,18,23,-4,Jacob Billikopf,"December 31 , 1950",PER-PER,TIME-TIME-TIME-TIME,PROPN-PROPN,PROPN-NUM-PUNCT-NUM,compound-nsubj,appos-nummod-punct-nummod,NNP-NNP,"NNP-CD-,-CD",-1,1
2,0.0,39,was,24,16,18,2,15,20,8,-6,Vilnius,Lithuania,LOC,LOC,PROPN,PROPN,conj,compound,NNP,NNP,2,1
0,0.0,22,was,14,1,5,4,0,16,13,-9,Richard Jackson Jr.,"July 3 , 1764",PER-PER-PER,TIME-TIME-TIME-TIME,PROPN-PROPN-PROPN,PROPN-NUM-PUNCT-NUM,compound-compound-nsubj,npadvmod-nummod-punct-nummod,NNP-NNP-NNP,"NNP-CD-,-CD",3,1
1,0.0,22,was,14,1,17,16,0,4,13,3,Richard Jackson Jr.,U.S.,PER-PER-PER,LOC,PROPN-PROPN-PROPN,PROPN,compound-compound-nsubj,compound,NNP-NNP-NNP,NNP,3,1
0,0.0,26,"""",0,2,12,10,1,13,-2,12,Magic Carpet Ride,John Kay,MISC-MISC-MISC,PER-PER,PROPN-PROPN-PROPN,PROPN-PROPN,compound-compound-nsubj,compound-pobj,NNP-NNP-NNP,NNP-NNP,6,1
1,0.0,26,"""",0,2,25,23,1,0,-2,25,Magic Carpet Ride,Steppenwolf,MISC-MISC-MISC,ORG,PROPN-PROPN-PROPN,PROPN,compound-compound-nsubj,pobj,NNP-NNP-NNP,NNP,3,1
2,0.0,26,"""",0,15,25,10,14,0,-15,25,Rushton Moreve,Steppenwolf,PER-PER,ORG,PROPN-PROPN,PROPN,compound-conj,pobj,NNP-NNP,NNP,6,1
0,0.0,34,was,13,1,10,9,0,23,12,-3,Chuan Ratanarak,1920,PER-PER,TIME,PROPN-PROPN,NUM,compound-nsubj,nummod,NNP-NNP,CD,1,1
1,1.0,23,was,5,5,13,8,4,9,0,8,Chuan,Chinese,PER,LOC,PROPN,ADJ,nsubj,amod,NNP,JJ,5,1
2,4.0,14,is,1,6,12,6,5,1,-5,11,Krit Ratanarak,Chachchon Ratanarak,ORG-ORG,PER-PER,PROPN-PROPN,PROPN-PROPN,compound-pobj,compound-pobj,NNP-NNP,NNP-NNP,5,1
0,0.0,26,"""",0,11,24,13,10,1,-11,24,Coming Up,Nude Records,MISC-MISC,ORG-ORG,VERB-PART,PROPN-PROPN,acl-prt,compound-pobj,VBG-RP,NNP-NNPS,6,1
1,6.0,30,written,10,4,29,25,3,0,6,19,Digging a Hole,Suede,MISC-MISC-MISC,ORG,VERB-DET-NOUN,PROPN,acl-det-dobj,pobj,VBG-DT-NN,NNP,5,1
0,4.0,18,is,7,15,11,-4,14,6,-8,4,Hyun Jin Moon,Moon,PER-PER-PER,PER,PROPN-PROPN-PROPN,PROPN,compound-compound-appos,poss,NNP-NNP-NNP,NNP,4,1
0,0.0,24,was,7,1,4,3,0,19,6,-3,Bartolomeo Passerotti,1529,PER-PER,TIME,PROPN-PROPN,NUM,compound-nsubj,nummod,NNP-NNP,CD,1,1
1,0.0,24,was,7,1,6,5,0,17,6,-1,Bartolomeo Passerotti,1592,PER-PER,TIME,PROPN-PROPN,NUM,compound-nsubj,nummod,NNP-NNP,CD,1,1
2,6.0,17,were,14,8,10,2,7,6,6,-4,Ventura,Aurelio,PER,PER,PROPN,PROPN,pobj,conj,NNP,NNP,3,1
3,6.0,17,were,14,8,12,4,7,4,6,-2,Ventura,Tiburzio,PER,PER,PROPN,PROPN,pobj,conj,NNP,NNP,4,1
4,6.0,17,were,14,10,12,2,9,4,4,-2,Aurelio,Tiburzio,PER,PER,PROPN,PROPN,conj,conj,NNP,NNP,3,1
0,0.0,26,is,4,1,22,21,0,3,3,18,Zubtsovsky District,Tver Oblast,LOC-LOC,LOC-LOC,PROPN-PROPN,PROPN-PROPN,compound-nsubj,compound-pobj,NNP-NNP,NNP-NNP,7,1
1,0.0,26,is,4,1,25,24,0,0,3,21,Zubtsovsky District,Russia,LOC-LOC,LOC,PROPN-PROPN,PROPN,compound-nsubj,appos,NNP-NNP,NNP,2,1
2,0.0,26,is,4,18,25,7,17,0,-14,21,thirty - six,Russia,NUM-NUM-NUM,LOC,NUM-PUNCT-NUM,PROPN,compound-punct-pobj,appos,CD-HYPH-CD,NNP,6,1
3,0.0,26,is,4,22,25,3,21,0,-18,21,Tver Oblast,Russia,LOC-LOC,LOC,PROPN-PROPN,PROPN,compound-pobj,appos,NNP-NNP,NNP,7,1
0,0.0,25,was,3,2,17,15,1,7,1,14,Combat Box,U.S. Army Air Forces,MISC-MISC,ORG-ORG-ORG-ORG,PROPN-PROPN,PROPN-PROPN-PROPN-PROPN,compound-nsubj,compound-compound-compound-pobj,NNP-NNP,NNP-NNP-NNP-NNPS,8,1
1,0.0,25,was,3,2,22,20,1,2,1,19,Combat Box,World War II,MISC-MISC,MISC-MISC-MISC,PROPN-PROPN,PROPN-PROPN-PROPN,compound-nsubj,compound-compound-pobj,NNP-NNP,NNP-NNP-NNP,8,1
0,0.0,34,is,25,1,31,30,0,2,24,6,Kiswarani,Andes,LOC,LOC,PROPN,PROPN,nsubj,pobj,NNP,NNP,7,1
1,0.0,34,is,25,1,33,32,0,0,24,8,Kiswarani,Peru,LOC,LOC,PROPN,PROPN,nsubj,pobj,NNP,NNP,4,1
2,0.0,34,is,25,24,31,7,23,2,1,6,Quisuarani,Andes,LOC,LOC,PROPN,PROPN,dobj,pobj,NNP,NNP,6,1
3,0.0,34,is,25,24,33,9,23,0,1,8,Quisuarani,Peru,LOC,LOC,PROPN,PROPN,dobj,pobj,NNP,NNP,3,1
4,0.0,34,is,25,31,33,2,30,0,-6,8,Andes,Peru,LOC,LOC,PROPN,PROPN,pobj,pobj,NNP,NNP,5,1
0,5.0,44,had,7,26,34,8,25,9,-19,27,Saturday Night Live,1975,MISC-MISC-MISC,TIME,PROPN-PROPN-PROPN,NUM,compound-compound-appos,pobj,NNP-NNP-NNP,CD,4,1
0,0.0,16,was,11,1,4,3,0,11,10,-7,Bhuvaraghan Palaniappan,5 November 1930,PER-PER,TIME-TIME-TIME,PROPN-PROPN,NUM-PROPN-NUM,compound-nsubj,nummod-appos-nummod,NNP-NNP,CD-NNP-CD,1,1
1,0.0,16,was,11,1,8,7,0,7,10,-3,Bhuvaraghan Palaniappan,23 March 2014,PER-PER,TIME-TIME-TIME,PROPN-PROPN,NUM-PROPN-NUM,compound-nsubj,nummod-appos-nummod,NNP-NNP,CD-NNP-CD,1,1
2,0.0,16,was,11,1,14,13,0,1,10,3,Bhuvaraghan Palaniappan,Indian,PER-PER,LOC,PROPN-PROPN,ADJ,compound-nsubj,amod,NNP-NNP,JJ,2,1
3,1.0,28,received,9,9,12,3,8,15,0,3,Palaniappan,Padma Shri,PER,MISC-MISC,PROPN,PROPN-PROPN,nsubj,compound-compound,NNP,NNP-NNP,2,1
4,1.0,28,received,9,19,21,2,18,6,-10,12,India,Abdul Kalam,LOC,PER-PER,PROPN,PROPN-PROPN,pobj,compound-appos,NNP,NNP-NNP,2,1
0,0.0,43,was,12,1,5,4,0,37,11,-7,Andrea Dandolo,September 1298,PER-PER,TIME-TIME,PROPN-PROPN,PROPN-NUM,compound-nsubj,npadvmod-nummod,NNP-NNP,NNP-CD,3,1
1,0.0,43,was,12,1,11,10,0,31,11,-1,Andrea Dandolo,Venice,PER-PER,LOC,PROPN-PROPN,PROPN,compound-nsubj,pobj,NNP-NNP,NNP,2,1
2,0.0,43,was,12,1,42,41,0,0,11,30,Andrea Dandolo,Venetians,PER-PER,LOC,PROPN-PROPN,PROPN,compound-nsubj,pobj,NNP-NNP,NNPS,2,1
3,0.0,43,was,12,11,18,7,10,24,1,6,Venice,Venetian,LOC,LOC,PROPN,ADJ,pobj,amod,NNP,JJ,4,1
4,0.0,43,was,12,11,42,31,10,0,1,30,Venice,Venetians,LOC,LOC,PROPN,PROPN,pobj,pobj,NNP,NNPS,2,1
5,0.0,43,was,12,27,31,4,26,11,-15,19,Battle of Curzola,8 September 1298,MISC-MISC-MISC,TIME-TIME-TIME,PROPN-ADP-PROPN,NUM-PROPN-NUM,pobj-prep-pobj,nummod-appos-nummod,NNP-IN-NNP,CD-NNP-CD,7,1
6,0.0,43,was,12,27,42,15,26,0,-15,30,Battle of Curzola,Venetians,MISC-MISC-MISC,LOC,PROPN-ADP-PROPN,PROPN,pobj-prep-pobj,pobj,NNP-IN-NNP,NNPS,8,1
0,0.0,39,was,14,1,5,4,0,33,13,-9,John Mitchell Vanderslice,"August 31 , 1846",PER-PER-PER,TIME-TIME-TIME-TIME,PROPN-PROPN-PROPN,PROPN-NUM-PUNCT-NUM,compound-compound-nsubj,appos-nummod-punct-nummod,NNP-NNP-NNP,"NNP-CD-,-CD",3,1
1,0.0,39,was,14,1,10,9,0,28,13,-4,John Mitchell Vanderslice,"March 12 , 1915",PER-PER-PER,TIME-TIME-TIME-TIME,PROPN-PROPN-PROPN,PROPN-NUM-PUNCT-NUM,compound-compound-nsubj,npadvmod-nummod-punct-nummod,NNP-NNP-NNP,"NNP-CD-,-CD",4,1
2,0.0,39,was,14,1,17,16,0,21,13,3,John Mitchell Vanderslice,United States,PER-PER-PER,LOC-LOC,PROPN-PROPN-PROPN,PROPN-PROPN,compound-compound-nsubj,compound-compound,NNP-NNP-NNP,NNP-NNP,4,1
3,0.0,39,was,14,1,24,23,0,14,13,10,John Mitchell Vanderslice,Union Army,PER-PER-PER,ORG-ORG,PROPN-PROPN-PROPN,PROPN-PROPN,compound-compound-nsubj,compound-pobj,NNP-NNP-NNP,NNP-NNP,6,1
4,0.0,39,was,14,24,28,4,23,10,-10,14,Union Army,American Civil War,ORG-ORG,MISC-MISC-MISC,PROPN-PROPN,PROPN-PROPN-PROPN,compound-pobj,compound-compound-pobj,NNP-NNP,NNP-NNP-NNP,5,1
0,0.0,15,is,3,1,6,5,0,8,2,3,All That Jazz,1979,MISC-MISC-MISC,TIME,DET-ADP-NOUN,NUM,predet-det-nsubj,nummod,DT-IN-NN,CD,4,1
1,2.0,23,inspired,3,14,19,5,13,3,-11,16,Lenny,1975,MISC,TIME,PROPN,NUM,appos,nummod,NNP,CD,3,1
0,0.0,14,was,6,1,13,12,0,0,5,7,Simone Martini,Siena,PER-PER,LOC,PROPN-PROPN,PROPN,compound-nsubj,pobj,NNP-NNP,NNP,2,1
0,0.0,33,was,6,14,18,4,13,14,-8,12,Elephant Island,South Shetland Islands,LOC-LOC,LOC-LOC-LOC,PROPN-PROPN,PROPN-PROPN-PROPN,compound-pobj,compound-compound-pobj,NNP-NNP,NNP-NNP-NNPS,5,1
1,12.0,20,moved,13,3,8,5,2,11,10,-5,First World War,1919,MISC-MISC-MISC,TIME,PROPN-PROPN-PROPN,NUM,compound-compound-pobj,pobj,NNP-NNP-NNP,CD,4,1
0,0.0,17,is,1,1,16,15,0,0,0,15,Drivdalen,Norway,LOC,LOC,PROPN,PROPN,nsubj,appos,NNP,NNP,1,1
1,0.0,17,is,1,11,13,2,10,3,-10,12,Oppdal,Trøndelag county,LOC,LOC-LOC,PROPN,PROPN-NOUN,pobj,compound-pobj,NNP,NNP-NN,1,1
2,0.0,17,is,1,11,16,5,10,0,-10,15,Oppdal,Norway,LOC,LOC,PROPN,PROPN,pobj,appos,NNP,NNP,8,1
3,0.0,17,is,1,13,16,3,12,0,-12,15,Trøndelag county,Norway,LOC-LOC,LOC,PROPN-NOUN,PROPN,compound-pobj,appos,NNP-NN,NNP,9,1
0,0.0,26,"""",0,2,25,23,1,0,-2,25,Because You Left,Lost,MISC-MISC-MISC,MISC,ADP-PRON-VERB,VERB,mark-nsubj-advcl,ROOT,IN-PRP-VBD,VBN,3,1
0,1.0,24,run,2,6,9,3,5,14,-4,7,Innsbruck,Austria,LOC,LOC,PROPN,PROPN,pobj,pobj,NNP,NNP,3,1
1,1.0,24,run,2,12,15,3,11,8,-10,13,Fortezza,Italy,LOC,LOC,PROPN,PROPN,pobj,pobj,NNP,NNP,3,1
0,1.0,39,founded,3,19,37,18,18,1,-16,34,Sony,PlayStation,ORG,MISC,PROPN,PROPN,poss,compound,NNP,NNP,4,1
1,1.0,39,founded,3,6,8,2,5,30,-3,5,Tokyo,Japan,LOC,LOC,PROPN,PROPN,pobj,conj,NNP,NNP,4,1
2,5.0,16,moved,5,5,12,7,4,3,0,7,SIE,San Mateo,ORG,LOC-LOC,PROPN,PROPN-PROPN,nsubj,compound-pobj,NNP,NNP-NNP,2,1
0,0.0,29,is,2,1,5,4,0,23,1,3,Morgan Stanley,American,ORG-ORG,LOC,PROPN-PROPN,ADJ,compound-nsubj,amod,NNP-NNP,JJ,4,1
1,0.0,29,is,2,1,24,23,0,4,1,22,Morgan Stanley,Manhattan,ORG-ORG,LOC,PROPN-PROPN,PROPN,compound-nsubj,conj,NNP-NNP,NNP,8,1
2,0.0,29,is,2,1,26,25,0,2,1,24,Morgan Stanley,New York City,ORG-ORG,LOC-LOC-LOC,PROPN-PROPN,PROPN-PROPN-PROPN,compound-nsubj,compound-compound-appos,NNP-NNP,NNP-NNP-NNP,9,1
3,0.0,29,is,2,15,24,9,14,4,-13,22,1585 Broadway,Manhattan,LOC-LOC,LOC,NUM-PROPN,PROPN,nummod-pobj,conj,CD-NNP,NNP,3,1
4,0.0,29,is,2,1,24,23,0,4,1,22,Morgan Stanley Building,Manhattan,LOC-LOC-LOC,LOC,PROPN-PROPN-PROPN,PROPN,compound-compound-pobj,conj,NNP-NNP-NNP,NNP,8,1
5,0.0,29,is,2,24,26,2,23,2,-22,24,Manhattan,New York City,LOC,LOC-LOC-LOC,PROPN,PROPN-PROPN-PROPN,conj,compound-compound-appos,NNP,NNP-NNP-NNP,3,1
6,2.0,55,came,27,3,13,10,2,41,24,-14,Morgan Stanley,Henry Sturgis Morgan,ORG-ORG,PER-PER-PER,PROPN-PROPN,PROPN-PROPN-PROPN,compound-nsubj,compound-compound-pobj,NNP-NNP,NNP-NNP-NNP,2,1
0,6.0,24,reported,3,9,19,10,8,4,-6,16,Okpuje,Nigeria,LOC,LOC,PROPN,PROPN,pobj,pobj,NNP,NNP,4,1
1,6.0,24,reported,3,11,19,8,10,4,-8,16,Nsukka,Nigeria,LOC,LOC,PROPN,PROPN,compound,pobj,NNP,NNP,4,1
2,10.0,23,exported,4,7,8,1,6,14,-3,4,South Africa,Africa,LOC-LOC,LOC,PROPN-PROPN,PROPN,compound-pobj,pobj,NNP-NNP,NNP,3,1
0,0.0,20,is,1,14,19,5,13,0,-13,18,New York City,Queens,LOC-LOC-LOC,LOC,PROPN-PROPN-PROPN,PROPN,compound-compound-compound,pobj,NNP-NNP-NNP,NNP,8,1
0,0.0,17,is,2,9,13,4,8,3,-7,11,Lisle,US,LOC,LOC,PROPN,PROPN,pobj,conj,NNP,NNP,4,1
1,0.0,17,is,2,11,13,2,10,3,-9,11,Illinois,US,LOC,LOC,PROPN,PROPN,conj,conj,NNP,NNP,5,1
2,3.0,17,holds,1,7,13,6,6,3,-6,12,Association of Theological Schools,United States,ORG-ORG-ORG-ORG,LOC-LOC,PROPN-ADP-PROPN-PROPN,PROPN-PROPN,pobj-prep-compound-pobj,compound-pobj,NNP-IN-NNP-NNPS,NNP-NNP,3,1
3,3.0,17,holds,1,7,16,9,6,0,-6,15,Association of Theological Schools,Canada,ORG-ORG-ORG-ORG,LOC,PROPN-ADP-PROPN-PROPN,PROPN,pobj-prep-compound-pobj,conj,NNP-IN-NNP-NNPS,NNP,5,1
4,4.0,29,joined,9,21,24,3,20,4,-12,15,Mel Gibson,The Passion of the Christ,PER-PER,MISC-MISC-MISC-MISC-MISC,PROPN-PROPN,DET-PROPN-ADP-DET-PROPN,compound-poss,det-dobj-prep-det-pobj,NNP-NNP,DT-NNP-IN-DT-NNP,1,1
0,1.0,6,born,2,1,5,4,0,0,1,3,Francisco,Valencia,PER,LOC,PROPN,PROPN,nsubjpass,pobj,NNP,NNP,2,1
1,3.0,40,attributed,16,27,11,-16,26,28,-11,-5,Francisco,Valencia,PER,LOC,PROPN,PROPN,nsubj,pobj,NNP,NNP,3,1
2,4.0,23,died,15,15,22,7,14,0,0,7,Francisco,1514,PER,TIME,PROPN,NUM,nsubj,pobj,NNP,CD,1,1
3,4.0,23,died,15,7,13,6,6,9,8,-2,Rodrigo,1518,PER,TIME,PROPN,NUM,pobj,pobj,NNP,CD,2,1
0,0.0,31,is,6,2,2,0,1,28,4,-4,Espoo Cathedral,Espoo,LOC-LOC,LOC,PROPN-PROPN,PROPN,compound-nsubj,pobj,NNP-NNP,NNP,0,1
0,0.0,67,Society,4,51,54,3,50,12,-47,50,Alexandre Walewski,Napoleon,PER-PER,PER,PROPN-PROPN,PROPN,compound-dobj,poss,NNP-NNP,NNP,3,1
1,1.0,17,was,3,5,15,10,4,1,-2,12,Adam Jerzy Czartoryski,Wladyslaw Czartoryski,PER-PER-PER,PER-PER,PROPN-PROPN-PROPN,PROPN-PROPN,compound-compound-attr,compound-appos,NNP-NNP-NNP,NNP-NNP,5,1
0,4.0,70,came,20,11,3,-8,10,66,9,-17,Heavier Than Heaven,Charles R. Cross,MISC-MISC-MISC,PER-PER-PER,PROPN-ADP-PROPN,PROPN-PROPN-PROPN,pobj-prep-pobj,compound-compound-pobj,NNP-IN-NNP,NNP-NNP-NNP,5,1
1,4.0,70,came,20,11,8,-3,10,61,9,-12,Heavier Than Heaven,2001,MISC-MISC-MISC,TIME,PROPN-ADP-PROPN,NUM,pobj-prep-pobj,nummod,NNP-IN-NNP,CD,5,1
0,0.0,95,is,14,2,43,41,1,51,12,29,Upper Galilee,Israel,LOC-LOC,LOC,PROPN-PROPN,PROPN,compound-nsubj,dobj,NNP-NNP,NNP,7,1
0,0.0,19,is,11,1,14,13,0,4,10,3,Frank George Wisner II,American,PER-PER-PER-PER,LOC,PROPN-PROPN-PROPN-PROPN,ADJ,compound-compound-compound-nsubj,amod,NNP-NNP-NNP-NNP,JJ,3,1
1,1.0,15,is,1,8,11,3,7,3,-7,10,Frank Wisner,1909,PER-PER,TIME,PROPN-PROPN,NUM,compound-pobj,nummod,NNP-NNP,CD,1,1
2,1.0,15,is,1,8,13,5,7,1,-7,12,Frank Wisner,1965,PER-PER,TIME,PROPN-PROPN,NUM,compound-pobj,npadvmod,NNP-NNP,CD,3,1
3,4.0,17,reports,4,15,13,-2,14,3,-11,9,Hosni Mubarak,Egyptian,PER-PER,LOC,PROPN-PROPN,ADJ,compound-pobj,amod,NNP-NNP,JJ,1,1
0,0.0,47,"""",0,17,32,15,16,14,-17,32,Eurovision Song Contest 1992,Géraldine Olivier,MISC-MISC-MISC-MISC,PER-PER,PROPN-PROPN-PROPN-NUM,PROPN-PROPN,compound-compound-pobj-appos,compound-pobj,NNP-NNP-NNP-CD,NNP-NNP,12,1
1,2.0,44,performed,16,10,12,2,9,31,6,-4,Malmö,Sweden,LOC,LOC,PROPN,PROPN,pobj,appos,NNP,NNP,5,1
0,0.0,44,was,4,2,11,9,1,32,2,7,Battle of Naseby,English Civil War,MISC-MISC-MISC,MISC-MISC-MISC,PROPN-ADP-PROPN,PROPN-PROPN-PROPN,nsubj-prep-pobj,compound-compound-pobj,NNP-IN-NNP,NNP-NNP-NNP,6,1
1,0.0,44,was,4,2,17,15,1,26,2,13,Battle of Naseby,14 June 1645,MISC-MISC-MISC,TIME-TIME-TIME,PROPN-ADP-PROPN,NUM-PROPN-NUM,nsubj-prep-pobj,nummod-pobj-nummod,NNP-IN-NNP,CD-NNP-CD,5,1
2,0.0,44,was,4,11,27,16,10,16,-7,23,English Civil War,Charles I,MISC-MISC-MISC,PER-PER,PROPN-PROPN-PROPN,PROPN-PROPN,compound-compound-pobj,compound-pobj,NNP-NNP-NNP,NNP-NNP,9,1
3,0.0,44,was,4,11,42,31,10,1,-7,38,English Civil War,Oliver Cromwell,MISC-MISC-MISC,PER-PER,PROPN-PROPN-PROPN,PROPN-PROPN,compound-compound-pobj,compound-conj,NNP-NNP-NNP,NNP-NNP,9,1
0,0.0,18,is,2,1,8,7,0,9,1,6,Yellowtail Dam,Bighorn River,LOC-LOC,LOC-LOC,PROPN-PROPN,PROPN-PROPN,compound-nsubj,compound-pobj,NNP-NNP,NNP-NNP,4,1
1,0.0,18,is,2,1,13,12,0,4,1,11,Yellowtail Dam,Montana,LOC-LOC,LOC,PROPN-PROPN,PROPN,compound-nsubj,pobj,NNP-NNP,NNP,5,1
2,7.0,23,transformed,10,8,18,10,7,4,2,8,Yellowtail Dam,Montana,LOC-LOC,LOC,PROPN-PROPN,PROPN,compound-pobj,poss,NNP-NNP,NNP,12,1
3,0.0,18,is,2,1,7,6,0,10,1,5,Yellowtail Dam,the United States,LOC-LOC,LOC-LOC-LOC,PROPN-PROPN,DET-PROPN-PROPN,compound-nsubj,det-compound-pobj,NNP-NNP,DT-NNP-NNP,5,1
4,0.0,18,is,2,8,13,5,7,4,-6,11,Bighorn River,Montana,LOC-LOC,LOC,PROPN-PROPN,PROPN,compound-pobj,pobj,NNP-NNP,NNP,5,1
5,0.0,18,is,2,8,7,-1,7,10,-6,5,Bighorn River,the United States,LOC-LOC,LOC-LOC-LOC,PROPN-PROPN,DET-PROPN-PROPN,compound-pobj,det-compound-pobj,NNP-NNP,DT-NNP-NNP,1,1
6,0.0,18,is,2,13,7,-6,12,10,-11,5,Montana,the United States,LOC,LOC-LOC-LOC,PROPN,DET-PROPN-PROPN,pobj,det-compound-pobj,NNP,DT-NNP-NNP,6,1
0,0.0,26,is,1,17,19,2,16,6,-16,18,Sunderland,Bennington County,LOC,LOC-LOC,PROPN,PROPN-PROPN,conj,compound-conj,NNP,NNP-NNP,2,1
1,0.0,26,is,1,17,24,7,16,1,-16,23,Sunderland,United States,LOC,LOC-LOC,PROPN,PROPN-PROPN,conj,compound-conj,NNP,NNP-NNP,3,1
2,0.0,26,is,1,19,22,3,18,3,-18,21,Bennington County,Vermont,LOC-LOC,LOC,PROPN-PROPN,PROPN,compound-conj,conj,NNP-NNP,NNP,1,1
3,0.0,26,is,1,19,24,5,18,1,-18,23,Bennington County,United States,LOC-LOC,LOC-LOC,PROPN-PROPN,PROPN-PROPN,compound-conj,compound-conj,NNP-NNP,NNP-NNP,1,1
4,0.0,26,is,1,22,24,2,21,1,-21,23,Vermont,United States,LOC,LOC-LOC,PROPN,PROPN-PROPN,conj,compound-conj,NNP,NNP-NNP,2,1
0,0.0,29,was,13,1,4,3,0,24,12,-9,Alessandro Malaspina,"November 5 , 1754",PER-PER,TIME-TIME-TIME-TIME,PROPN-PROPN,PROPN-NUM-PUNCT-NUM,compound-nsubj,appos-nummod-punct-nummod,NNP-NNP,"NNP-CD-,-CD",2,1
1,0.0,29,was,13,1,9,8,0,19,12,-4,Alessandro Malaspina,"April 9 , 1810",PER-PER,TIME-TIME-TIME-TIME,PROPN-PROPN,PROPN-NUM-PUNCT-NUM,compound-nsubj,appos-nummod-punct-nummod,NNP-NNP,"NNP-CD-,-CD",3,1
2,1.0,76,undertook,7,36,64,28,35,11,-29,57,Pacific Ocean,Philippines,LOC-LOC,LOC,PROPN-PROPN,PROPN,compound-pobj,conj,NNP-NNP,NNPS,6,1
3,1.0,76,undertook,7,36,69,33,35,6,-29,62,Pacific Ocean,New Zealand,LOC-LOC,LOC-LOC,PROPN-PROPN,PROPN-PROPN,compound-pobj,compound-pobj,NNP-NNP,NNP-NNP,8,1
4,1.0,76,undertook,7,36,72,36,35,3,-29,65,Pacific Ocean,Australia,LOC-LOC,LOC,PROPN-PROPN,PROPN,compound-pobj,conj,NNP-NNP,NNP,10,1
0,0.0,34,Otskheli,1,1,6,5,0,27,0,5,Petre Otskheli,"November 25 , 1907",PER-PER,TIME-TIME-TIME-TIME,PROPN-PROPN,PROPN-NUM-PUNCT-NUM,compound-ROOT,nsubj-nummod-punct-nummod,NNP-NNP,"NNP-CD-,-CD",2,1
1,2.0,21,studied,5,5,13,8,4,7,0,8,Otskheli,Tbilisi State Academy of Arts,PER,ORG-ORG-ORG-ORG-ORG,PROPN,PROPN-PROPN-PROPN-ADP-PROPN,nsubj,compound-compound-conj-prep-pobj,NNP,NNP-NNP-NNP-IN-NNPS,4,1
0,0.0,32,was,15,23,31,8,22,0,-8,16,Cao Wei,China,PER-PER,LOC,PROPN-PROPN,PROPN,compound-pobj,pobj,NNP-NNP,NNP,5,1
0,0.0,37,is,4,1,15,14,0,21,3,11,Return to Castle Wolfenstein,Activision,MISC-MISC-MISC-MISC,ORG,VERB-ADP-PROPN-PROPN,PROPN,nsubj-prep-compound-pobj,pobj,VB-IN-NNP-NNP,NNP,4,1
1,0.0,37,is,4,1,24,23,0,12,3,20,Return to Castle Wolfenstein,Microsoft Windows,MISC-MISC-MISC-MISC,MISC-MISC,VERB-ADP-PROPN-PROPN,PROPN-PROPN,nsubj-prep-compound-pobj,compound-pobj,VB-IN-NNP-NNP,NNP-NNP,6,1
2,0.0,37,is,4,1,29,28,0,7,3,25,Return to Castle Wolfenstein,PlayStation 2,MISC-MISC-MISC-MISC,MISC-MISC,VERB-ADP-PROPN-PROPN,PROPN-NUM,nsubj-prep-compound-pobj,pobj-nummod,VB-IN-NNP-NNP,NNP-CD,7,1
3,0.0,37,is,4,1,32,31,0,4,3,28,Return to Castle Wolfenstein,Xbox,MISC-MISC-MISC-MISC,MISC,VERB-ADP-PROPN-PROPN,PROPN,nsubj-prep-compound-pobj,conj,VB-IN-NNP-NNP,NNP,8,1
4,0.0,37,is,4,1,34,33,0,2,3,30,Return to Castle Wolfenstein,Linux,MISC-MISC-MISC-MISC,MISC,VERB-ADP-PROPN-PROPN,PROPN,nsubj-prep-compound-pobj,conj,VB-IN-NNP-NNP,NNP,9,1
5,0.0,37,is,4,1,36,35,0,0,3,32,Return to Castle Wolfenstein,Macintosh,MISC-MISC-MISC-MISC,MISC,VERB-ADP-PROPN-PROPN,PROPN,nsubj-prep-compound-pobj,conj,VB-IN-NNP-NNP,NNP,3,1
0,0.0,18,is,4,1,15,14,0,2,3,11,Further Down the Spiral,Nine Inch Nails,MISC-MISC-MISC-MISC,ORG-ORG-ORG,ADV-ADP-DET-PROPN,PROPN-PROPN-PROPN,advmod-prep-det-pobj,compound-compound-pobj,RB-IN-DT-NNP,NNP-NNP-NNP,6,1
0,0.0,36,Hubbard,2,1,5,4,0,30,1,3,Mabel Gardiner Hubbard,"November 25 , 1857",PER-PER-PER,TIME-TIME-TIME-TIME,PROPN-PROPN-PROPN,PROPN-NUM-PUNCT-NUM,compound-compound-ROOT,appos-nummod-punct-npadvmod,NNP-NNP-NNP,"NNP-CD-,-CD",3,1
1,0.0,36,Hubbard,2,1,10,9,0,25,1,8,Mabel Gardiner Hubbard,"January 3 , 1923",PER-PER-PER,TIME-TIME-TIME-TIME,PROPN-PROPN-PROPN,PROPN-NUM-PUNCT-NUM,compound-compound-ROOT,nsubj-nummod-punct-nummod,NNP-NNP-NNP,"NNP-CD-,-CD",3,1
2,0.0,36,Hubbard,2,1,2,1,0,33,1,0,Mabel Gardiner Hubbard,Gardiner Greene Hubbard,PER-PER-PER,PER-PER-PER,PROPN-PROPN-PROPN,PROPN-PROPN-PROPN,compound-compound-ROOT,compound-compound-pobj,NNP-NNP-NNP,NNP-NNP-NNP,1,1
0,0.0,20,is,10,2,16,14,1,3,8,6,Nushagak River,Alaska,LOC-LOC,LOC,PROPN-PROPN,PROPN,compound-nsubj,pobj,NNP-NNP,NNP,5,1
1,0.0,20,is,10,2,18,16,1,1,8,8,Nushagak River,United States,LOC-LOC,LOC-LOC,PROPN-PROPN,PROPN-PROPN,compound-nsubj,compound-appos,NNP-NNP,NNP-NNP,5,1
2,0.0,20,is,10,7,18,11,6,1,3,8,Central Alaskan,United States,MISC-MISC,LOC-LOC,PROPN-PROPN,PROPN-PROPN,compound-amod,compound-appos,NNP-NNP,NNP-NNP,9,1
3,0.0,20,is,10,9,18,9,8,1,1,8,Yup'ik,United States,LOC,LOC-LOC,PROPN,PROPN-PROPN,pobj,compound-appos,NNP,NNP-NNP,7,1
4,0.0,20,is,10,16,18,2,15,1,-6,8,Alaska,United States,LOC,LOC-LOC,PROPN,PROPN-PROPN,pobj,compound-appos,NNP,NNP-NNP,2,1
5,1.0,25,begins,1,11,17,6,10,7,-10,16,Nushagak Bay,Bristol Bay,LOC-LOC,LOC-LOC,PROPN-PROPN,PROPN-PROPN,compound-pobj,compound-pobj,NNP-NNP,NNP-NNP,3,1
0,0.0,18,is,1,9,13,4,8,4,-8,12,Koinadugu District,Northern Province,LOC-LOC,LOC-LOC,PROPN-PROPN,PROPN-PROPN,compound-pobj,compound-pobj,NNP-NNP,NNP-NNP,5,1
1,0.0,18,is,1,9,16,7,8,1,-8,15,Koinadugu District,Sierra Leone,LOC-LOC,LOC-LOC,PROPN-PROPN,PROPN-PROPN,compound-pobj,compound-pobj,NNP-NNP,NNP-NNP,7,1
2,5.0,28,is,1,20,13,-7,19,14,-19,12,Kono District,Sierra Leone,LOC-LOC,LOC-LOC,PROPN-PROPN,PROPN-PROPN,compound-pobj,compound-pobj,NNP-NNP,NNP-NNP,8,1
3,9.0,15,celebrated,7,5,1,-4,4,13,2,-6,Ernest Bai Koroma,Sierra Leone,PER-PER-PER,LOC-LOC,PROPN-PROPN-PROPN,PROPN-PROPN,compound-compound-appos,compound-poss,NNP-NNP-NNP,NNP-NNP,3,1
0,2.0,28,recorded,5,26,24,-2,25,3,-21,19,United States,Tennessee,LOC-LOC,LOC,PROPN-PROPN,PROPN,compound-appos,appos,NNP-NNP,NNP,2,1
1,5.0,19,released,5,2,17,15,1,1,3,12,Break Away,RCA Records,MISC-MISC,ORG-ORG,VERB-PART,PROPN-PROPN,compound-nsubjpass,compound-pobj,VB-RP,NNP-NNPS,4,1
0,0.0,29,Sanaksenaho,1,1,4,3,0,24,0,3,Seppo Sanaksenaho,"May 5 , 1938",PER-PER,TIME-TIME-TIME-TIME,PROPN-PROPN,PROPN-NUM-PUNCT-NUM,compound-ROOT,appos-nummod-punct-nummod,NNP-NNP,"NNP-CD-,-CD",2,1
1,0.0,29,Sanaksenaho,1,1,16,15,0,12,0,15,Seppo Sanaksenaho,Finnish,PER-PER,LOC,PROPN-PROPN,ADJ,compound-ROOT,amod,NNP-NNP,JJ,2,1
2,1.0,11,born,2,1,5,4,0,5,1,3,Sanaksenaho,Oulu,PER,LOC,PROPN,PROPN,nsubjpass,pobj,NNP,NNP,4,1
3,1.0,11,born,2,5,7,2,4,3,-3,5,Oulu,Finland,LOC,LOC,PROPN,PROPN,pobj,appos,NNP,NNP,4,1
4,3.0,17,received,1,1,10,9,0,6,0,9,Sanaksenaho,Pennsylvania State University,PER,ORG-ORG-ORG,PROPN,PROPN-PROPN-PROPN,nsubj,compound-compound-pobj,NNP,NNP-NNP-NNP,5,1
5,3.0,17,received,1,10,14,4,9,2,-9,13,Pennsylvania State University,the United States,ORG-ORG-ORG,LOC-LOC-LOC,PROPN-PROPN-PROPN,DET-PROPN-PROPN,compound-compound-pobj,det-compound-pobj,NNP-NNP-NNP,DT-NNP-NNP,4,1
0,0.0,15,is,10,1,5,4,0,9,9,-5,Klaus Schedl,4 January 1966,PER-PER,TIME-TIME-TIME,PROPN-PROPN,NUM-PROPN-NUM,compound-nsubj,nummod-npadvmod-nummod,NNP-NNP,CD-NNP-CD,2,1
1,0.0,15,is,10,1,9,8,0,5,9,-1,Klaus Schedl,Stuttgart,PER-PER,LOC,PROPN-PROPN,PROPN,compound-nsubj,pobj,NNP-NNP,NNP,1,1
2,0.0,15,is,10,1,13,12,0,1,9,3,Klaus Schedl,German,PER-PER,LOC,PROPN-PROPN,ADJ,compound-nsubj,amod,NNP-NNP,JJ,2,1
3,0.0,15,is,10,9,13,4,8,1,1,3,Stuttgart,German,LOC,LOC,PROPN,ADJ,pobj,amod,NNP,JJ,3,1
0,1.0,31,adopted,18,4,29,25,3,1,14,11,Marcus Vipsanius Agrippa,Gaius Caesar,PER-PER-PER,PER-PER,PROPN-PROPN-PROPN,PROPN-PROPN,compound-compound-pobj,compound-appos,NNP-NNP-NNP,NNP-NNP,8,1
0,0.0,21,is,2,1,20,19,0,0,1,18,Stantec Tower,Alberta,LOC-LOC,LOC,PROPN-PROPN,PROPN,compound-nsubj,appos,NNP-NNP,NNP,2,1
1,0.0,21,is,2,14,18,4,13,2,-12,16,Ice District,Edmonton,LOC-LOC,LOC,PROPN-PROPN,PROPN,compound-pobj,pobj,NNP-NNP,NNP,3,1
2,0.0,21,is,2,14,20,6,13,0,-12,18,Ice District,Alberta,LOC-LOC,LOC,PROPN-PROPN,PROPN,compound-pobj,appos,NNP-NNP,NNP,6,1
3,0.0,21,is,2,18,20,2,17,0,-16,18,Edmonton,Alberta,LOC,LOC,PROPN,PROPN,pobj,appos,NNP,NNP,9,1
4,3.0,19,be,6,4,16,12,3,2,2,10,Stantec Tower,Canada,LOC-LOC,LOC,PROPN-PROPN,PROPN,compound-nsubj,pobj,NNP-NNP,NNP,4,1
0,0.0,16,is,8,1,5,4,0,10,7,-3,Boris Kollár,14 August 1965,PER-PER,TIME-TIME-TIME,PROPN-PROPN,NUM-PROPN-NUM,compound-nsubj,nummod-npadvmod-nummod,NNP-NNP,CD-NNP-CD,2,1
1,0.0,16,is,8,1,15,14,0,0,7,7,Boris Kollár,Bratislava,PER-PER,LOC,PROPN-PROPN,PROPN,compound-nsubj,pobj,NNP-NNP,NNP,2,1
2,6.0,14,lived,1,10,12,2,9,1,-9,11,Miami,United States,LOC,LOC-LOC,PROPN,PROPN-PROPN,pobj,compound-appos,NNP,NNP-NNP,2,1
0,0.0,23,located,15,2,13,11,1,9,13,-2,Cabinet Mountains Wilderness,1964,LOC-LOC-LOC,TIME,PROPN-PROPN-PROPN,NUM,compound-compound-nsubjpass,pobj,NNP-NNPS-NNP,CD,2,1
1,0.0,23,located,15,2,19,17,1,3,13,4,Cabinet Mountains Wilderness,U.S.,LOC-LOC-LOC,LOC,PROPN-PROPN-PROPN,PROPN,compound-compound-nsubjpass,compound,NNP-NNPS-NNP,NNP,3,1
2,0.0,23,located,15,2,22,20,1,0,13,7,Cabinet Mountains Wilderness,Montana,LOC-LOC-LOC,LOC,PROPN-PROPN-PROPN,PROPN,compound-compound-nsubjpass,pobj,NNP-NNPS-NNP,NNP,2,1
3,0.0,23,located,15,11,19,8,10,3,4,4,Congress,U.S.,ORG,LOC,PROPN,PROPN,pobj,compound,NNP,NNP,5,1
4,0.0,23,located,15,11,22,11,10,0,4,7,Congress,Montana,ORG,LOC,PROPN,PROPN,pobj,pobj,NNP,NNP,4,1
5,0.0,23,located,15,19,22,3,18,0,-4,7,U.S.,Montana,LOC,LOC,PROPN,PROPN,compound,pobj,NNP,NNP,3,1
0,0.0,23,is,2,1,19,18,0,3,1,17,Mount Cardigan,New Hampshire,LOC-LOC,LOC-LOC,PROPN-PROPN,PROPN-PROPN,compound-nsubj,compound-pobj,NNP-NNP,NNP-NNP,6,1
1,0.0,23,is,2,1,22,21,0,0,1,20,Mount Cardigan,USA,LOC-LOC,LOC,PROPN-PROPN,PROPN,compound-nsubj,npadvmod,NNP-NNP,NNP,2,1
2,0.0,23,is,2,14,19,5,13,3,-12,17,Orange,New Hampshire,LOC,LOC-LOC,PROPN,PROPN-PROPN,pobj,compound-pobj,NNP,NNP-NNP,5,1
3,0.0,23,is,2,14,22,8,13,0,-12,20,Orange,USA,LOC,LOC,PROPN,PROPN,pobj,npadvmod,NNP,NNP,7,1
4,0.0,23,is,2,16,22,6,15,0,-14,20,Alexandria,USA,LOC,LOC,PROPN,PROPN,conj,npadvmod,NNP,NNP,5,1
5,0.0,23,is,2,19,22,3,18,0,-17,20,New Hampshire,USA,LOC-LOC,LOC,PROPN-PROPN,PROPN,compound-pobj,npadvmod,NNP-NNP,NNP,6,1
0,0.0,32,Planet,2,1,29,28,0,2,1,27,The Living Planet : A Portrait of the Earth,19 January 1984,MISC-MISC-MISC-MISC-MISC-MISC-MISC-MISC-MISC,TIME-TIME-TIME,DET-PROPN-PROPN-PUNCT-DET-PROPN-ADP-DET-PROPN,NUM-PROPN-NUM,det-compound-ROOT-punct-det-nsubj-prep-det-pobj,nummod-pobj-nummod,DT-NNP-NNP-:-DT-NNP-IN-DT-NNP,CD-NNP-CD,6,1
1,0.0,32,Planet,2,12,27,15,11,4,-10,25,BBC,UK,ORG,LOC,PROPN,PROPN,compound,pobj,NNP,NNP,3,1
2,4.0,22,followed,12,15,20,5,14,1,-3,8,The Trials of Life,1990,MISC-MISC-MISC-MISC,TIME,DET-PROPN-ADP-PROPN,NUM,det-pobj-prep-pobj,appos,DT-NNPS-IN-NNP,CD,1,1
3,5.0,49,wrote,7,15,19,4,14,29,-8,12,The First Eden,1987,MISC-MISC-MISC,TIME,DET-PROPN-PROPN,NUM,det-compound-appos,appos,DT-NNP-NNP,CD,2,1
0,0.0,21,is,9,1,12,11,0,8,8,3,Diane Ladd,American,PER-PER,LOC,PROPN-PROPN,ADJ,compound-nsubj,amod,NNP-NNP,JJ,2,1
1,3.0,43,went,1,31,35,4,30,7,-30,34,Wild at Heart,1990,MISC-MISC-MISC,TIME,PROPN-ADP-PROPN,NUM,pobj-prep-pobj,appos,NNP-IN-NNP,CD,5,1
2,3.0,43,went,1,38,41,3,37,1,-37,40,Rambling Rose,1991,MISC-MISC,TIME,PROPN-PROPN,NUM,compound-conj,appos,NNP-NNP,CD,1,1
3,4.0,36,include,4,6,8,2,5,27,-2,4,Chinatown,1974,MISC,TIME,PROPN,NUM,dobj,npadvmod,NNP,CD,2,1
4,4.0,36,include,4,11,15,4,10,20,-7,11,Ghosts of Mississippi,1996,MISC-MISC-MISC,TIME,NOUN-ADP-PROPN,NUM,conj-prep-pobj,appos,NNS-IN-NNP,CD,2,1
5,4.0,36,include,4,18,21,3,17,14,-14,17,Primary Colors,1998,MISC-MISC,TIME,PROPN-PROPN,NUM,compound-conj,appos,NNP-NNPS,CD,1,1
6,4.0,36,include,4,24,27,3,23,8,-20,23,28 Days,2000,MISC-MISC,TIME,NUM-NOUN,NUM,nummod-conj,appos,CD-NNS,CD,1,1
7,4.0,36,include,4,31,34,3,30,1,-27,30,American Cowslip,2008,MISC-MISC,TIME,PROPN-PROPN,NUM,compound-conj,appos,NNP-NNP,CD,1,1
8,5.0,19,is,1,1,7,6,0,11,0,6,Ladd,Laura Dern,PER,PER-PER,PROPN,PROPN-PROPN,nsubj,compound-pobj,NNP,NNP-NNP,3,1
9,5.0,19,is,1,7,17,10,6,1,-6,16,Laura Dern,Bruce Dern,PER-PER,PER-PER,PROPN-PROPN,PROPN-PROPN,compound-pobj,compound-appos,NNP-NNP,NNP-NNP,4,1
0,1.0,28,featured,10,6,8,2,5,19,4,-2,Welland,Ontario,LOC,LOC,PROPN,PROPN,pobj,nsubj,NNP,NNP,3,1
1,2.0,45,managed,3,9,17,8,8,27,-6,14,Pete LaCock,Peter Marshall,PER-PER,PER-PER,PROPN-PROPN,PROPN-PROPN,compound-pobj,compound-appos,NNP-NNP,NNP-NNP,2,1
0,8.0,34,had,4,2,14,12,1,19,2,10,Australian Fabians,Australia,ORG-ORG,LOC,ADJ-PROPN,PROPN,compound-nsubj,pobj,JJ-NNPS,NNP,3,1
0,0.0,17,is,2,1,16,15,0,0,1,14,Palazzo Uguccioni,Italy,LOC-LOC,LOC,PROPN-PROPN,PROPN,compound-nsubj,appos,NNP-NNP,NNP,2,1
1,0.0,17,is,2,9,16,7,8,0,-7,14,Piazza della Signoria,Italy,LOC-LOC-LOC,LOC,PROPN-NOUN-PROPN,PROPN,compound-pobj-appos,appos,NNP-NN-NNP,NNP,4,1
2,0.0,17,is,2,13,16,3,12,0,-11,14,Florence,Italy,LOC,LOC,PROPN,PROPN,pobj,appos,NNP,NNP,6,1
0,0.0,19,are,4,2,15,13,1,3,2,11,Willamette Falls Locks,U.S.,LOC-LOC-LOC,LOC,PROPN-PROPN-PROPN,PROPN,compound-compound-nsubj,compound,NNP-NNP-NNP,NNP,7,1
1,0.0,19,are,4,2,18,16,1,0,2,14,Willamette Falls Locks,Oregon,LOC-LOC-LOC,LOC,PROPN-PROPN-PROPN,PROPN,compound-compound-nsubj,pobj,NNP-NNP-NNP,NNP,3,1
2,0.0,19,are,4,2,15,13,1,3,2,11,Willamette River,U.S.,LOC-LOC,LOC,PROPN-PROPN,PROPN,compound-pobj,compound,NNP-NNP,NNP,7,1
3,0.0,19,are,4,2,18,16,1,0,2,14,Willamette River,Oregon,LOC-LOC,LOC,PROPN-PROPN,PROPN,compound-pobj,pobj,NNP-NNP,NNP,3,1
4,0.0,19,are,4,15,18,3,14,0,-11,14,U.S.,Oregon,LOC,LOC,PROPN,PROPN,compound,pobj,NNP,NNP,6,1
0,1.0,10,located,2,6,9,3,5,0,-4,7,Ain,France,LOC,LOC,PROPN,PROPN,compound,pobj,NNP,NNP,3,1
0,0.0,24,is,7,2,23,21,1,0,5,16,Eastern Thousand Buddha Caves,China,LOC-LOC-LOC-LOC,LOC,ADJ-NUM-PROPN-PROPN,PROPN,compound-compound-compound-nsubj,appos,JJ-CD-NNP-NNPS,NNP,4,1
1,0.0,24,is,7,17,20,3,16,3,-10,13,Guazhou County,Gansu,LOC-LOC,LOC,PROPN-PROPN,PROPN,compound-pobj,appos,NNP-NNP,NNP,3,1
2,0.0,24,is,7,17,23,6,16,0,-10,16,Guazhou County,China,LOC-LOC,LOC,PROPN-PROPN,PROPN,compound-pobj,appos,NNP-NNP,NNP,6,1
3,0.0,24,is,7,20,23,3,19,0,-13,16,Gansu,China,LOC,LOC,PROPN,PROPN,appos,appos,NNP,NNP,5,1
0,0.0,28,(;,3,1,5,4,0,22,2,2,Sergey Sergeyevich Kamenev,"April 4 ( 16 ) , 1881",PER-PER-PER,TIME-TIME-TIME-TIME-TIME-TIME-TIME,PROPN-PROPN-PROPN,PROPN-NUM-PUNCT-NUM-PUNCT-PUNCT-NUM,compound-compound-compound,npadvmod-nummod-punct-appos-punct-punct-nummod,NNP-NNP-NNP,"NNP-CD--LRB--CD--RRB--,-CD",4,1
1,0.0,28,(;,3,1,20,19,0,7,2,17,Sergey Sergeyevich Kamenev,Soviet,PER-PER-PER,LOC,PROPN-PROPN-PROPN,ADJ,compound-compound-compound,amod,NNP-NNP-NNP,JJ,5,1
2,4.0,24,replaced,5,7,21,14,6,2,-2,16,Jukums Vācietis,Russian Civil War,PER-PER,MISC-MISC-MISC,PROPN-PROPN,ADJ-PROPN-PROPN,compound-dobj,amod-compound-pobj,NNP-NNP,JJ-NNP-NNP,4,1
3,4.0,24,replaced,5,17,21,4,16,2,-12,16,Red Army,Russian Civil War,ORG-ORG,MISC-MISC-MISC,PROPN-PROPN,ADJ-PROPN-PROPN,compound-pobj,amod-compound-pobj,NNP-NNP,JJ-NNP-NNP,7,1
4,5.0,19,was,1,7,12,5,6,6,-6,11,Revolutionary Military Council,USSR,ORG-ORG-ORG,ORG,PROPN-PROPN-PROPN,PROPN,compound-compound-pobj,pobj,NNP-NNP-NNP,NNP,5,1
0,0.0,44,is,20,8,11,3,7,32,12,-9,the United States,George W. Bush,LOC-LOC-LOC,PER-PER-PER,DET-PROPN-PROPN,PROPN-PROPN-PROPN,det-compound-pobj,compound-compound-nsubj,DT-NNP-NNP,NNP-NNP-NNP,3,1
1,0.0,44,is,20,11,36,25,10,7,9,16,George W. Bush,American,PER-PER-PER,LOC,PROPN-PROPN-PROPN,ADJ,compound-compound-nsubj,amod,NNP-NNP-NNP,JJ,10,1
2,0.0,44,is,20,16,36,20,15,7,4,16,Task Force on New Americans,American,ORG-ORG-ORG-ORG-ORG,LOC,PROPN-PROPN-ADP-PROPN-PROPN,ADJ,compound-appos-prep-compound-pobj,amod,NNP-NNP-IN-NNP-NNPS,JJ,8,1
3,3.0,11,Aguilar,1,1,11,10,0,-1,0,10,Alfonso Aguilar,U.S.,PER-PER,LOC,PROPN-PROPN,PROPN,compound-ROOT,pobj,NNP-NNP,NNP,-1,1
0,6.0,23,centers,3,10,14,4,9,8,-7,11,Gainesville Regional Airport,Florida,LOC-LOC-LOC,LOC,PROPN-PROPN-PROPN,PROPN,compound-compound-appos,pobj,NNP-NNP-NNP,NNP,2,1
0,0.0,20,is,7,14,1,-13,13,18,-7,-6,Calais,Washington County,LOC,LOC-LOC,PROPN,PROPN-PROPN,pobj,compound-conj,NNP,NNP-NNP,7,1
1,0.0,20,is,7,1,19,18,0,0,6,12,Washington County,Maine,LOC-LOC,LOC,PROPN-PROPN,PROPN,compound-conj,appos,NNP-NNP,NNP,3,1
0,0.0,17,is,1,1,9,8,0,7,0,8,Lament,Einstürzende Neubauten,MISC,ORG-ORG,NOUN,PROPN-PROPN,nsubj,compound-pobj,NN,NNP-NNP,3,1
1,3.0,44,is,9,28,31,3,27,12,-19,22,Kaiser Wilhelm,Germany,PER-PER,LOC,PROPN-PROPN,PROPN,compound-pobj,pobj,NNP-NNP,NNP,3,1
2,5.0,30,includes,3,9,16,7,8,13,-6,13,James Reese Europe,the United States,PER-PER-PER,LOC-LOC-LOC,PROPN-PROPN-PROPN,DET-PROPN-PROPN,compound-compound-pobj,det-compound-poss,NNP-NNP-NNP,DT-NNP-NNP,6,1
0,0.0,34,is,15,1,25,24,0,8,14,10,Colossal Cave Adventure,1976,MISC-MISC-MISC,TIME,PROPN-PROPN-PROPN,NUM,compound-compound-nsubj,pobj,NNP-NNP-NNP,CD,4,1
1,0.0,34,is,15,1,28,27,0,5,14,13,Colossal Cave Adventure,Will Crowther,MISC-MISC-MISC,PER-PER,PROPN-PROPN-PROPN,PROPN-PROPN,compound-compound-nsubj,compound-pobj,NNP-NNP-NNP,NNP-NNP,5,1
2,0.0,34,is,15,1,32,31,0,1,14,17,Colossal Cave Adventure,PDP-10,MISC-MISC-MISC,MISC,PROPN-PROPN-PROPN,PROPN,compound-compound-nsubj,compound,NNP-NNP-NNP,NNP,7,1
0,0.0,16,was,3,12,14,2,11,1,-9,11,Wellington,New Zealand,LOC,LOC-LOC,PROPN,PROPN-PROPN,pobj,compound-appos,NNP,NNP-NNP,2,1
0,7.0,29,ended,9,14,18,4,13,10,-5,9,J - platform,June 2005,MISC-MISC-MISC,TIME-TIME,PROPN-PUNCT-NOUN,PROPN-NUM,compound-punct-pobj,pobj-nummod,NNP-HYPH-NN,NNP-CD,7,1
1,7.0,29,ended,9,23,8,-15,22,20,-14,-1,Pontiac Sunfire,General Motors,MISC-MISC,ORG-ORG,PROPN-PROPN,PROPN-PROPN,compound-pobj,compound-nsubj,NNP-NNP,NNP-NNPS,3,1
0,2.0,67,included,13,25,3,-22,24,63,-12,-10,Eleanor Roosevelt,the United States,PER-PER,LOC-LOC-LOC,PROPN-PROPN,DET-PROPN-PROPN,compound-appos,det-compound-pobj,NNP-NNP,DT-NNP-NNP,5,1
1,2.0,67,included,13,39,42,3,38,24,-26,29,René Cassin,France,PER-PER,LOC,PROPN-PROPN,PROPN,compound-conj,pobj,NNP-NNP,NNP,1,1
2,2.0,67,included,13,44,47,3,43,19,-31,34,Charles Malik,Lebanon,PER-PER,LOC,PROPN-PROPN,PROPN,compound-conj,pobj,NNP-NNP,NNP,1,1
3,2.0,67,included,13,49,53,4,48,13,-36,40,P. C. Chang,Republic of China,PER-PER-PER,LOC-LOC-LOC,PROPN-PROPN-PROPN,PROPN-ADP-PROPN,compound-compound-conj,nmod-prep-pobj,NNP-NNP-NNP,NNP-IN-NNP,4,1
4,2.0,67,included,13,61,64,3,60,2,-48,51,Hansa Mehta,India,PER-PER,LOC,PROPN-PROPN,PROPN,compound-conj,pobj,NNP-NNP,NNP,1,1
0,0.0,21,was,16,1,5,4,0,15,15,-11,Oleg Ivanovich Dahl,25 May 1941,PER-PER-PER,TIME-TIME-TIME,PROPN-PROPN-PROPN,NUM-PROPN-NUM,compound-compound-nsubj,nummod-appos-nummod,NNP-NNP-NNP,CD-NNP-CD,3,1
1,0.0,21,was,16,1,9,8,0,11,15,-7,Oleg Ivanovich Dahl,Moscow,PER-PER-PER,LOC,PROPN-PROPN-PROPN,PROPN,compound-compound-nsubj,compound,NNP-NNP-NNP,NNP,5,1
2,0.0,21,was,16,1,11,10,0,9,15,-5,Oleg Ivanovich Dahl,3 March 1981,PER-PER-PER,TIME-TIME-TIME,PROPN-PROPN-PROPN,NUM-PROPN-NUM,compound-compound-nsubj,nummod-appos-nummod,NNP-NNP-NNP,CD-NNP-CD,5,1
3,0.0,21,was,16,1,15,14,0,5,15,-1,Oleg Ivanovich Dahl,Kiev,PER-PER-PER,LOC,PROPN-PROPN-PROPN,PROPN,compound-compound-nsubj,appos,NNP-NNP-NNP,NNP,4,1
4,0.0,21,was,16,1,19,18,0,1,15,3,Oleg Ivanovich Dahl,Soviet,PER-PER-PER,LOC,PROPN-PROPN-PROPN,ADJ,compound-compound-nsubj,amod,NNP-NNP-NNP,JJ,4,1
5,2.0,53,included,4,33,36,3,32,16,-29,32,King Lear,1969,MISC-MISC,TIME,PROPN-PROPN,NUM,compound-conj,appos,NNP-NNP,CD,1,1
6,2.0,53,included,4,39,45,6,38,7,-35,41,On Thursday and Never Again,1977,MISC-MISC-MISC-MISC-MISC,TIME,ADP-PROPN-CCONJ-PROPN-ADV,NUM,prep-pobj-cc-neg-conj,appos,IN-NNP-CC-NNP-RB,CD,3,1
7,2.0,53,included,4,48,51,3,47,1,-44,47,September Vacation,1979,MISC-MISC,TIME,PROPN-PROPN,NUM,compound-conj,appos,NNP-NNP,CD,1,1
8,3.0,16,played,2,9,12,3,8,3,-7,10,Uninvited Friend,Leonid Maryagin,MISC-MISC,PER-PER,PROPN-PROPN,PROPN-PROPN,compound-pobj,compound-pobj,NNP-NNP,NNP-NNP,5,1
0,0.0,27,is,1,1,11,10,0,15,0,10,Idesia,Salicaceae,MISC,MISC,PROPN,PROPN,nsubj,pobj,NNP,NNP,2,1
1,0.0,27,is,1,1,18,17,0,8,0,17,Idesia,Flacourtiaceae,MISC,MISC,PROPN,PROPN,nsubj,npadvmod,NNP,NNP,3,1
0,2.0,9,based,3,1,6,5,0,2,2,3,Black Isle,Irvine,ORG-ORG,LOC,PROPN-PROPN,PROPN,compound-nsubjpass,pobj,NNP-NNP,NNP,4,1
1,2.0,9,based,3,6,8,2,5,0,-3,5,Irvine,California,LOC,LOC,PROPN,PROPN,pobj,appos,NNP,NNP,4,1
2,3.0,18,formed,3,12,6,-6,11,11,-9,3,Black Isle Studios,1996,ORG-ORG-ORG,TIME,PROPN-PROPN-NOUN,NUM,compound-compound-appos,pobj,NNP-NNP-NNS,CD,4,1
0,0.0,20,was,2,1,5,4,0,14,1,3,Franklin District,New Zealand,LOC-LOC,LOC-LOC,PROPN-PROPN,PROPN-PROPN,compound-nsubj,nmod-nmod,NNP-NNP,NNP-NNP,3,1
0,0.0,33,"""",0,2,13,11,1,19,-2,13,Time Will Crawl,David Bowie,MISC-MISC-MISC,PER-PER,NOUN-VERB-NOUN,PROPN-PROPN,compound-aux-nsubj,compound-pobj,NN-MD-NN,NNP-NNP,6,1
1,0.0,33,"""",0,2,26,24,1,6,-2,26,Time Will Crawl,Never Let Me Down,MISC-MISC-MISC,MISC-MISC-MISC-MISC,NOUN-VERB-NOUN,ADV-VERB-PRON-PART,compound-aux-nsubj,neg-ROOT-nsubj-ccomp,NN-MD-NN,RB-VB-PRP-RP,3,1
2,0.0,33,"""",0,2,31,29,1,1,-2,31,Time Will Crawl,1987,MISC-MISC-MISC,TIME,NOUN-VERB-NOUN,NUM,compound-aux-nsubj,npadvmod,NN-MD-NN,CD,5,1
3,0.0,33,"""",0,26,31,5,25,1,-26,31,Never Let Me Down,1987,MISC-MISC-MISC-MISC,TIME,ADV-VERB-PRON-PART,NUM,neg-ROOT-nsubj-ccomp,npadvmod,RB-VB-PRP-RP,CD,2,1
0,0.0,37,Roberval,0,20,22,2,19,14,-20,22,Quebec,Canada,LOC,LOC,PROPN,PROPN,pobj,appos,NNP,NNP,2,1
0,0.0,42,is,3,1,6,5,0,35,2,3,Ángel Rodríguez Lozano,Spanish,PER-PER-PER,LOC,PROPN-PROPN-PROPN,ADJ,compound-compound-nsubj,amod,NNP-NNP-NNP,JJ,4,1
1,0.0,42,is,3,24,37,13,23,4,-21,34,Vanguardia de la Ciencia,April 1995,MISC-MISC-MISC-MISC,TIME-TIME,PROPN-PROPN-PROPN-PROPN,PROPN-NUM,compound-compound-compound-appos,pobj-nummod,NNP-NNP-NNP-NNP,NNP-CD,11,1
2,0.0,42,is,3,24,40,16,23,1,-21,37,Vanguardia de la Ciencia,June 2007,MISC-MISC-MISC-MISC,TIME-TIME,PROPN-PROPN-PROPN-PROPN,PROPN-NUM,compound-compound-compound-appos,pobj-nummod,NNP-NNP-NNP-NNP,NNP-CD,12,1
3,4.0,20,born,4,1,7,6,0,12,3,3,Ángel Rodríguez Lozano,1952,PER-PER-PER,TIME,PROPN-PROPN-PROPN,NUM,compound-compound-nsubjpass,pobj,NNP-NNP-NNP,CD,3,1
4,4.0,20,born,4,1,13,12,0,6,3,9,Ángel Rodríguez Lozano,La Garrovilla,PER-PER-PER,LOC-LOC,PROPN-PROPN-PROPN,PROPN-PROPN,compound-compound-nsubjpass,compound-pobj,NNP-NNP-NNP,NNP-NNP,6,1
0,0.0,30,is,14,1,28,27,0,1,13,14,KFXL - TV,United States,ORG-ORG-ORG,LOC-LOC,PROPN-PUNCT-PROPN,PROPN-PROPN,compound-punct-nsubj,compound-conj,NNP-HYPH-NNP,NNP-NNP,9,1
1,0.0,30,is,14,17,28,11,16,1,-3,14,Fox,United States,ORG,LOC-LOC,PROPN,PROPN-PROPN,npadvmod,compound-conj,NNP,NNP-NNP,7,1
2,0.0,30,is,14,26,28,2,25,1,-12,14,Nebraska,United States,LOC,LOC-LOC,PROPN,PROPN-PROPN,conj,compound-conj,NNP,NNP-NNP,2,1
0,0.0,45,is,11,1,5,4,0,39,10,-6,Bruno Kramm,13 October 1967,PER-PER,TIME-TIME-TIME,PROPN-PROPN,NUM-PROPN-NUM,compound-nsubj,nummod-npadvmod-nummod,NNP-NNP,CD-NNP-CD,2,1
1,0.0,45,is,11,1,10,9,0,34,10,-1,Bruno Kramm,Munich,PER-PER,LOC,PROPN-PROPN,PROPN,compound-nsubj,pobj,NNP-NNP,NNP,1,1
2,0.0,45,is,11,1,14,13,0,30,10,3,Bruno Kramm,German,PER-PER,LOC,PROPN-PROPN,ADJ,compound-nsubj,amod,NNP-NNP,JJ,2,1
3,6.0,31,arrested,10,8,14,6,7,16,2,4,Bruno Kramm,German,PER-PER,LOC,PROPN-PROPN,ADJ,compound-nsubjpass,amod,NNP-NNP,JJ,3,1
4,0.0,45,is,11,10,14,4,9,30,1,3,Munich,German,LOC,LOC,PROPN,ADJ,pobj,amod,NNP,JJ,3,1
5,5.0,25,was,2,1,9,8,0,15,1,7,Bruno Kramm,Pirate Party Germany,PER-PER,ORG-ORG-ORG,PROPN-PROPN,PROPN-PROPN-PROPN,compound-nsubj,compound-compound-pobj,NNP-NNP,NNP-NNP-NNP,5,1
0,0.0,10,is,1,1,6,5,0,3,0,5,Gambir,Central Jakarta,LOC,LOC-LOC,PROPN,PROPN-PROPN,nsubj,compound-pobj,NNP,NNP-NNP,3,1
1,0.0,10,is,1,6,9,3,5,0,-5,8,Central Jakarta,Indonesia,LOC-LOC,LOC,PROPN-PROPN,PROPN,compound-pobj,appos,NNP-NNP,NNP,4,1
2,6.0,20,located,13,10,8,-2,9,11,3,-5,Gambir Station,Jakarta,LOC-LOC,LOC,PROPN-PROPN,PROPN,compound-appos,pobj,NNP-NNP,NNP,2,1
0,2.0,18,was,1,17,7,-10,16,10,-16,6,Haiti,Jean - Bertrand Aristide,LOC,PER-PER-PER-PER,PROPN,PROPN-PUNCT-PROPN-PROPN,pobj,compound-punct-compound-poss,NNP,NNP-HYPH-NNP-NNP,7,1
0,0.0,20,is,6,1,19,18,0,0,5,13,The Supremes Sing Rodgers & Hart,1967,MISC-MISC-MISC-MISC-MISC-MISC,TIME,DET-PROPN-PROPN-PROPN-CCONJ-PROPN,NUM,det-compound-compound-nsubj-cc-conj,pobj,DT-NNP-NNP-NNP-CC-NNP,CD,4,1
1,7.0,31,included,12,21,17,-4,20,13,-9,5,The Supremes Sing Rodgers & Hart : The Complete Recordings,Motown,MISC-MISC-MISC-MISC-MISC-MISC-MISC-MISC-MISC-MISC,ORG,DET-PROPN-PROPN-PROPN-CCONJ-PROPN-PUNCT-DET-PROPN-PROPN,PROPN,det-compound-compound-ROOT-cc-conj-punct-det-compound-appos,nmod,DT-NNP-NNP-NNP-CC-NNP-:-DT-NNP-NNPS,NNP,5,1
0,1.0,21,attended,6,1,15,14,0,5,5,9,Turiaf,Gonzaga University,PER,ORG-ORG,PROPN,PROPN-PROPN,nsubj,compound-pobj,NNP,NNP-NNP,3,1
1,1.0,21,attended,6,15,18,3,14,2,-9,12,Gonzaga University,the United States,ORG-ORG,LOC-LOC-LOC,PROPN-PROPN,DET-PROPN-PROPN,compound-pobj,det-compound-pobj,NNP-NNP,DT-NNP-NNP,3,1
2,2.0,23,played,4,4,8,4,3,14,0,4,Turiaf,Bulldogs,PER,ORG,PROPN,PROPN,nsubj,compound,NNP,NNPS,3,1
3,3.0,20,entered,6,6,17,11,5,2,0,11,Turiaf,Los Angeles Lakers,PER,ORG-ORG-ORG,PROPN,PROPN-PROPN-PROPN,nsubj,compound-compound-pobj,NNP,NNP-NNP-NNP,4,1
4,3.0,20,entered,6,17,10,-7,16,9,-11,4,Los Angeles Lakers,NBA,ORG-ORG-ORG,ORG,PROPN-PROPN-PROPN,PROPN,compound-compound-pobj,compound,NNP-NNP-NNP,NNP,5,1
0,0.0,19,Stuttgart,0,14,18,4,13,0,-14,18,German,Bundestag,LOC,ORG,ADJ,PROPN,amod,appos,JJ,NNP,7,1
0,0.0,30,is,16,23,26,3,22,3,-7,10,Neuse River,North Carolina,LOC-LOC,LOC-LOC,PROPN-PROPN,PROPN-PROPN,compound-pobj,compound-pobj,NNP-NNP,NNP-NNP,2,1
1,0.0,30,is,16,23,29,6,22,0,-7,13,Neuse River,USA,LOC-LOC,LOC,PROPN-PROPN,PROPN,compound-pobj,appos,NNP-NNP,NNP,4,1
2,0.0,30,is,16,26,29,3,25,0,-10,13,North Carolina,USA,LOC-LOC,LOC,PROPN-PROPN,PROPN,compound-pobj,appos,NNP-NNP,NNP,6,1
0,2.0,31,is,12,12,7,-5,11,23,0,-5,UIC,University of Illinois system,ORG,ORG-ORG-ORG-ORG,PROPN,PROPN-ADP-PROPN-NOUN,nsubj,nmod-prep-pobj-pobj,NNP,NNP-IN-NNP-NN,6,1
0,1.0,20,led,12,2,19,17,1,0,10,7,Nordic Council,Copenhagen,ORG-ORG,LOC,PROPN-PROPN,PROPN,compound-appos,pobj,NNP-NNP,NNP,3,1
1,6.0,20,is,5,7,11,4,6,8,-2,6,Britt Bohlin Olsson,Sweden,PER-PER-PER,LOC,PROPN-PROPN-PROPN,PROPN,compound-compound-attr,pobj,NNP-NNP-NNP,NNP,2,1
0,2.0,15,was,1,6,13,7,5,1,-5,12,North Central Province,Sri Lanka,LOC-LOC-LOC,LOC-LOC,PROPN-PROPN-PROPN,PROPN-PROPN,compound-compound-pobj,compound-pobj,NNP-NNP-NNP,NNP-NNP,4,1
1,2.0,15,was,1,7,13,6,6,1,-6,12,Central Province,Sri Lanka,LOC-LOC,LOC-LOC,PROPN-PROPN,PROPN-PROPN,compound-conj,compound-pobj,NNP-NNP,NNP-NNP,3,1
0,0.0,37,are,5,2,29,27,1,7,3,24,Kyle Hills,Antarctica,LOC-LOC,LOC,PROPN-PROPN,PROPN,compound-nsubj,appos,NNP-NNP,NNP,10,1
1,0.0,37,are,5,26,29,3,25,7,-21,24,Ross Island,Antarctica,LOC-LOC,LOC,PROPN-PROPN,PROPN,compound-pobj,appos,NNP-NNP,NNP,3,1
0,0.0,19,is,2,1,5,4,0,13,1,3,High Rollers,American,MISC-MISC,LOC,ADJ-PROPN,ADJ,amod-nsubj,amod,JJ-NNPS,JJ,4,1
1,2.0,17,debuted,2,1,13,12,0,3,1,11,High Rollers,NBC,MISC-MISC,ORG,PROPN-PROPN,PROPN,amod-nsubj,poss,NNP-NNPS,NNP,7,1
2,6.0,40,brought,7,9,7,-2,8,32,-2,0,High Rollers,NBC,MISC-MISC,ORG,PROPN-PROPN,PROPN,compound-dobj,nsubj,NNP-NNPS,NNP,1,1
0,0.0,18,is,2,14,16,2,13,1,-12,14,Larvik,Vestfold county,LOC,LOC-LOC,PROPN,PROPN-NOUN,pobj,compound-appos,NNP,NNP-NN,2,1
0,1.0,46,made,11,20,23,3,19,22,-9,12,Dollar Dreams,2000,MISC-MISC,TIME,PROPN-PROPN,NUM,compound-appos,appos,NNP-NNPS,CD,1,1
1,2.0,12,screened,3,7,11,4,6,0,-4,8,International Film Festival,India,MISC-MISC-MISC,LOC,PROPN-PROPN-PROPN,PROPN,compound-compound-pobj,pobj,NNP-NNP-NNP,NNP,4,1
2,3.0,17,garnered,2,1,5,4,0,11,1,3,Sekhar,filmfare Awards South,PER,MISC-MISC-MISC,PROPN,NOUN-PROPN-PROPN,nsubj,compound-compound-dobj,NNP,NN-NNPS-NNP,3,1
3,3.0,17,garnered,2,1,12,11,0,4,1,10,Sekhar,Nandi Awards,PER,MISC-MISC,PROPN,PROPN-PROPN,nsubj,compound-conj,NNP,NNP-NNPS,2,1
4,5.0,12,was,6,5,11,6,4,0,1,5,Anand,2004,MISC,TIME,PROPN,NUM,appos,pobj,NNP,CD,2,1
0,0.0,34,is,5,2,24,22,1,9,3,19,Walk Away Renée,Left Banke,MISC-MISC-MISC,ORG-ORG,VERB-ADV-PROPN,PROPN-PROPN,compound-compound-nsubj,compound-appos,VB-RB-NNP,NNP-NNP,7,1
1,0.0,34,is,5,2,32,30,1,1,3,27,Walk Away Renée,July 1966,MISC-MISC-MISC,TIME-TIME,VERB-ADV-PROPN,PROPN-NUM,compound-compound-nsubj,pobj-nummod,VB-RB-NNP,NNP-CD,8,1
2,4.0,40,got,1,17,11,-6,16,28,-16,10,California Dreamin,Mamas & the Papas,MISC-MISC,ORG-ORG-ORG-ORG,PROPN-PROPN,PROPN-CCONJ-DET-PROPN,compound-appos,pobj-cc-det-compound,NNP-NNP,NNP-CC-DT-NNP,3,1
3,8.0,23,returned,2,1,15,14,0,7,1,13,The Four Tops,1967,ORG-ORG-ORG,TIME,DET-PROPN-NOUN,NUM,det-compound-pobj,appos,DT-NNP-NNS,CD,8,1
0,0.0,21,was,14,1,5,4,0,15,13,-9,William Boyd Sloan,"July 9 , 1895",PER-PER-PER,TIME-TIME-TIME-TIME,PROPN-PROPN-PROPN,PROPN-NUM-PUNCT-NUM,compound-compound-nsubj,appos-nummod-punct-nummod,NNP-NNP-NNP,"NNP-CD-,-CD",3,1
1,0.0,21,was,14,1,10,9,0,10,13,-4,William Boyd Sloan,"October 22 , 1970",PER-PER-PER,TIME-TIME-TIME-TIME,PROPN-PROPN-PROPN,PROPN-NUM-PUNCT-NUM,compound-compound-nsubj,appos-nummod-punct-nummod,NNP-NNP-NNP,"NNP-CD-,-CD",3,1
2,1.0,16,read,7,7,3,-4,6,12,0,-4,Sloan,Gainesville,PER,LOC,PROPN,PROPN,nsubj,pobj,NNP,NNP,4,1
3,6.0,35,nominated,8,26,29,3,25,5,-18,21,Northern District,Georgia,LOC-LOC,LOC,PROPN-PROPN,PROPN,compound-pobj,pobj,NNP-NNP,NNP,3,1
0,0.0,15,is,8,1,5,4,0,9,7,-3,Pavel Kuka,19 July 1968,PER-PER,TIME-TIME-TIME,PROPN-PROPN,NUM-PROPN-NUM,compound-nsubj,nummod-npadvmod-nummod,NNP-NNP,CD-NNP-CD,2,1
1,0.0,15,is,8,1,11,10,0,3,7,3,Pavel Kuka,Czech,PER-PER,LOC,PROPN-PROPN,ADJ,compound-nsubj,amod,NNP-NNP,JJ,3,1
2,1.0,29,started,5,5,3,-2,4,25,0,-2,Kuka,Prague,PER,LOC,PROPN,PROPN,nsubj,pobj,NNP,NNP,1,1
3,1.0,29,started,5,5,12,7,4,16,0,7,Kuka,Slavia Praha,PER,ORG-ORG,PROPN,PROPN-PROPN,nsubj,compound-pobj,NNP,NNP-NNP,4,1
4,5.0,34,played,7,7,25,18,6,8,0,18,Kuka,Euro 96,PER,MISC-MISC,PROPN,PROPN-NUM,nsubj,pobj-nummod,NNP,NNP-CD,8,1
5,5.0,34,played,7,7,25,18,6,8,0,18,Kuka,Euro 2000,PER,MISC-MISC,PROPN,PROPN-NUM,nsubj,pobj-nummod,NNP,NNP-CD,8,1
0,0.0,38,is,15,24,26,2,23,11,-9,11,Albay,Bicol Region,LOC,LOC-LOC,PROPN,PROPN-PROPN,pobj,compound-pobj,NNP,NNP-NNP,1,1
1,0.0,38,is,15,24,37,13,23,0,-9,22,Albay,Philippines,LOC,LOC,PROPN,PROPN,pobj,pobj,NNP,NNP,7,1
2,0.0,38,is,15,26,37,11,25,0,-11,22,Bicol Region,Philippines,LOC-LOC,LOC,PROPN-PROPN,PROPN,compound-pobj,pobj,NNP-NNP,NNP,8,1
3,0.0,38,is,15,34,37,3,33,0,-19,22,Luzon,Philippines,LOC,LOC,PROPN,PROPN,pobj,pobj,NNP,NNP,4,1
0,0.0,31,Dzurilla,1,1,9,8,0,21,0,8,Vladimír Dzurilla,Bratislava,PER-PER,LOC,PROPN-PROPN,PROPN,compound-ROOT,pobj,NNP-NNP,NNP,3,1
1,0.0,31,Dzurilla,1,1,11,10,0,19,0,10,Vladimír Dzurilla,Slovakia,PER-PER,LOC,PROPN-PROPN,PROPN,compound-ROOT,compound,NNP-NNP,NNP,4,1
2,0.0,31,Dzurilla,1,1,24,23,0,6,0,23,Vladimír Dzurilla,Slovak,PER-PER,LOC,PROPN-PROPN,ADJ,compound-ROOT,compound,NNP-NNP,JJ,4,1
3,0.0,31,Dzurilla,1,9,11,2,8,19,-8,10,Bratislava,Slovakia,LOC,LOC,PROPN,PROPN,pobj,compound,NNP,NNP,3,1
4,0.0,31,Dzurilla,1,9,24,15,8,6,-8,23,Bratislava,Slovak,LOC,LOC,PROPN,ADJ,pobj,compound,NNP,JJ,7,1
5,0.0,31,Dzurilla,1,9,30,21,8,0,-8,29,Bratislava,Czechoslovakia,LOC,LOC,PROPN,PROPN,pobj,pobj,NNP,NNP,5,1
6,2.0,28,battling,12,10,16,6,9,11,2,4,Jiri Holecek,Czechoslovakia,PER-PER,LOC,PROPN-PROPN,PROPN,compound-conj,poss,NNP-NNP,NNP,10,1
7,3.0,34,known,8,2,21,19,1,12,6,13,North American,Canada,LOC-LOC,LOC,ADJ-ADJ,PROPN,amod-amod,pobj,JJ-JJ,NNP,6,1
0,0.0,32,"""",0,2,24,22,1,7,-2,24,Warm and Beautiful,1976,MISC-MISC-MISC,TIME,ADJ-CCONJ-ADJ,NUM,nsubj-cc-conj,nummod,JJ-CC-JJ,CD,10,1
1,0.0,32,"""",0,2,21,19,1,10,-2,21,Warm and Beautiful,Wings at the Speed of Sound,MISC-MISC-MISC,MISC-MISC-MISC-MISC-MISC-MISC,ADJ-CCONJ-ADJ,PROPN-ADP-DET-PROPN-ADP-PROPN,nsubj-cc-conj,appos-prep-det-pobj-prep-pobj,JJ-CC-JJ,NNP-IN-DT-NNP-IN-NNP,8,1
2,1.0,12,is,1,8,11,3,7,0,-7,10,Paul,Linda,PER,PER,PROPN,PROPN,pobj,pobj,NNP,NNP,3,1
3,2.0,51,varied,6,25,29,4,24,21,-19,23,Paul,Linda,PER,PER,PROPN,PROPN,nsubj,pobj,NNP,NNP,6,1
4,3.0,26,rearranged,9,9,5,-4,8,20,0,-4,Paul,Linda,PER,PER,PROPN,PROPN,nsubj,poss,NNP,NNP,4,1
5,3.0,26,rearranged,9,5,2,-3,4,23,4,-7,Linda,1998,PER,TIME,PROPN,NUM,poss,pobj,NNP,CD,5,1
0,0.0,37,is,11,1,6,5,0,30,10,-5,Gary Norman Hurring,10 October 1961,PER-PER-PER,TIME-TIME-TIME,PROPN-PROPN-PROPN,NUM-PROPN-NUM,compound-compound-nsubj,nummod-npadvmod-nummod,NNP-NNP-NNP,CD-NNP-CD,3,1
1,0.0,37,is,11,1,10,9,0,26,10,-1,Gary Norman Hurring,Auckland,PER-PER-PER,LOC,PROPN-PROPN-PROPN,PROPN,compound-compound-nsubj,pobj,NNP-NNP-NNP,NNP,2,1
2,0.0,37,is,11,1,17,16,0,19,10,6,Gary Norman Hurring,New Zealand,PER-PER-PER,LOC-LOC,PROPN-PROPN-PROPN,PROPN-PROPN,compound-compound-nsubj,compound-pobj,NNP-NNP-NNP,NNP-NNP,5,1
3,0.0,37,is,11,1,27,26,0,9,10,16,Gary Norman Hurring,1978 Commonwealth Games,PER-PER-PER,MISC-MISC-MISC,PROPN-PROPN-PROPN,NUM-PROPN-PROPN,compound-compound-nsubj,nummod-compound-pobj,NNP-NNP-NNP,CD-NNP-NNPS,7,1
4,0.0,37,is,11,10,17,7,9,19,1,6,Auckland,New Zealand,LOC,LOC-LOC,PROPN,PROPN-PROPN,pobj,compound-pobj,NNP,NNP-NNP,5,1
5,4.0,14,appointed,2,1,11,10,0,2,1,9,Hurring,2012 Summer Olympics,PER,MISC-MISC-MISC,PROPN,NUM-PROPN-PROPN,nsubjpass,nummod-compound-pobj,NNP,CD-NNP-NNPS,4,1
6,5.0,39,is,1,12,32,20,11,6,-11,31,Lincoln Hurring,1952 Summer Olympics,PER-PER,MISC-MISC-MISC,PROPN-PROPN,NUM-PROPN-PROPN,compound-appos,nummod-compound-pobj,NNP-NNP,CD-NNP-NNPS,7,1
7,5.0,39,is,1,15,32,17,14,6,-14,31,Jean Stewart,1952 Summer Olympics,PER-PER,MISC-MISC-MISC,PROPN-PROPN,NUM-PROPN-PROPN,compound-conj,nummod-compound-pobj,NNP-NNP,CD-NNP-NNPS,8,1
8,5.0,39,is,1,32,36,4,31,2,-31,35,1952 Summer Olympics,Helsinki,MISC-MISC-MISC,LOC,NUM-PROPN-PROPN,PROPN,nummod-compound-pobj,pobj,CD-NNP-NNPS,NNP,2,1
9,5.0,39,is,1,32,38,6,31,0,-31,37,1952 Summer Olympics,Finland,MISC-MISC-MISC,LOC,NUM-PROPN-PROPN,PROPN,nummod-compound-pobj,appos,CD-NNP-NNPS,NNP,8,1
10,5.0,39,is,1,36,38,2,35,0,-35,37,Helsinki,Finland,LOC,LOC,PROPN,PROPN,pobj,appos,NNP,NNP,8,1
0,0.0,17,is,4,11,13,2,10,3,-7,9,Baltimore,Maryland,LOC,LOC,PROPN,PROPN,pobj,conj,NNP,NNP,2,1
1,0.0,17,is,4,11,15,4,10,1,-7,11,Baltimore,United States,LOC,LOC-LOC,PROPN,PROPN-PROPN,pobj,compound-appos,NNP,NNP-NNP,2,1
2,0.0,17,is,4,13,15,2,12,1,-9,11,Maryland,United States,LOC,LOC-LOC,PROPN,PROPN-PROPN,conj,compound-appos,NNP,NNP-NNP,2,1
0,0.0,49,is,3,1,45,44,0,3,2,42,Alkali Falls,U.S.,LOC-LOC,LOC,PROPN-PROPN,PROPN,compound-nsubj,compound,NNP-NNP,NNP,4,1
1,0.0,49,is,3,1,36,35,0,12,2,33,Alkali Falls,Oregon,LOC-LOC,LOC,PROPN-PROPN,PROPN,compound-nsubj,pobj,NNP-NNP,NNP,4,1
2,0.0,49,is,3,29,45,16,28,3,-26,42,Mount Bailey,U.S.,LOC-LOC,LOC,PROPN-PROPN,PROPN,compound-pobj,compound,NNP-NNP,NNP,7,1
3,0.0,49,is,3,32,45,13,31,3,-29,42,Diamond Lake,U.S.,LOC-LOC,LOC,PROPN-PROPN,PROPN,compound-conj,compound,NNP-NNP,NNP,8,1
4,0.0,49,is,3,36,45,9,35,3,-33,42,Oregon Route 230,U.S.,LOC-LOC-LOC,LOC,PROPN-PROPN-NUM,PROPN,compound-pobj-nummod,compound,NNP-NNP-CD,NNP,4,1
5,0.0,49,is,3,40,45,5,39,3,-37,42,douglas County,U.S.,LOC-LOC,LOC,ADJ-PROPN,PROPN,compound-pobj,compound,JJ-NNP,NNP,6,1
6,0.0,49,is,3,40,36,-4,39,12,-37,33,douglas County,Oregon,LOC-LOC,LOC,ADJ-PROPN,PROPN,compound-pobj,pobj,JJ-NNP,NNP,2,1
7,0.0,49,is,3,45,36,-9,44,12,-42,33,U.S.,Oregon,LOC,LOC,PROPN,PROPN,compound,pobj,NNP,NNP,4,1
0,2.0,20,were,6,8,19,11,7,0,-2,13,Anne Frank,Amsterdam,PER-PER,LOC,PROPN-PROPN,PROPN,compound-attr,pobj,NNP-NNP,NNP,2,1
0,0.0,24,is,2,17,23,6,16,0,-15,21,Guantanamo Bay detention camps,Cuba,LOC-LOC-LOC-LOC,LOC,PROPN-PROPN-NOUN-NOUN,PROPN,compound-compound-compound-pobj,pobj,NNP-NNP-NN-NNS,NNP,8,1
1,1.0,27,reports,4,7,17,10,6,9,-3,13,Abdulqadirakhum,Xinjiang,PER,LOC,PROPN,PROPN,nsubjpass,compound,NNP,NNP,3,1
2,1.0,27,reports,4,7,18,11,6,8,-3,14,Abdulqadirakhum,China,PER,LOC,PROPN,PROPN,nsubjpass,pobj,NNP,NNP,2,1
3,1.0,27,reports,4,17,18,1,16,8,-13,14,Xinjiang,China,LOC,LOC,PROPN,PROPN,compound,pobj,NNP,NNP,3,1
0,0.0,22,is,1,1,4,3,0,17,0,3,Vaastav,1999,MISC,TIME,PROPN,NUM,nsubj,nummod,NNP,CD,2,1
1,0.0,22,is,1,1,13,12,0,8,0,12,Vaastav,Mahesh Manjrekar,MISC,PER-PER,PROPN,PROPN-PROPN,nsubj,compound-pobj,NNP,NNP-NNP,5,1
2,0.0,22,is,1,1,20,19,0,1,0,19,Vaastav,Namrata Shirodkar,MISC,PER-PER,PROPN,PROPN-PROPN,nsubj,compound-conj,NNP,NNP-NNP,6,1
0,0.0,52,released,18,1,21,20,0,30,17,3,Liberty Belle and the Black Diamond Express,March 1986,MISC-MISC-MISC-MISC-MISC-MISC-MISC,TIME-TIME,PROPN-PROPN-CCONJ-DET-PROPN-PROPN-PROPN,PROPN-NUM,compound-nsubjpass-cc-det-compound-compound-conj,pobj-nummod,NNP-NNP-CC-DT-NNP-NNP-NNP,NNP-CD,4,1
1,0.0,52,released,18,13,27,14,12,24,5,9,The Go - Betweens,Beggars Banquet Records,ORG-ORG-ORG-ORG,ORG-ORG-ORG,DET-PROPN-PUNCT-PROPN,PROPN-PROPN-PROPN,det-compound-punct-pobj,compound-compound-pobj,DT-NNP-HYPH-NNP,NNP-NNP-NNPS,8,1
2,1.0,13,recorded,3,10,12,2,9,0,-7,9,London,England,LOC,LOC,PROPN,PROPN,pobj,appos,NNP,NNP,6,1
3,3.0,33,had,10,1,6,5,0,26,9,-4,The Life At Hand,1986,MISC-MISC-MISC-MISC,TIME,DET-PROPN-ADP-PROPN,NUM,det-appos-prep-pobj,pobj,DT-NNP-IN-NNP,CD,3,1
4,3.0,33,had,10,30,6,-24,29,26,-20,-4,Little Joe,1986,MISC-MISC,TIME,ADJ-PROPN,NUM,compound-conj,pobj,JJ-NNP,CD,6,1
0,0.0,19,"""",0,2,17,15,1,1,-2,17,Where 's Your Love,Greatest Hits,MISC-MISC-MISC-MISC,MISC-MISC,ADV-VERB-DET-NOUN,PROPN-PROPN,advmod-csubj-poss-nsubj,compound-appos,WRB-VBZ-PRP$-NN,NNP-NNP,5,1
0,0.0,18,was,4,1,7,6,0,10,3,3,Standard Oil Co. Inc.,American,ORG-ORG-ORG-ORG,LOC,PROPN-PROPN-PROPN-PROPN,ADJ,compound-compound-compound-nsubj,amod,NNP-NNP-NNP-NNP,JJ,4,1
0,1.0,18,educated,2,1,6,5,0,11,1,4,Salkow,City College of New York,PER,ORG-ORG-ORG-ORG-ORG,PROPN,PROPN-PROPN-ADP-PROPN-PROPN,nsubjpass,compound-pobj-prep-compound-pobj,NNP,NNP-NNP-IN-NNP-NNP,3,1
1,1.0,18,educated,2,1,12,11,0,5,1,10,Salkow,Columbia University,PER,ORG-ORG,PROPN,PROPN-PROPN,nsubjpass,compound-conj,NNP,NNP-NNP,4,1
2,1.0,18,educated,2,1,15,14,0,2,1,13,Salkow,Harvard Law School,PER,ORG-ORG-ORG,PROPN,PROPN-PROPN-PROPN,nsubjpass,compound-compound-conj,NNP,NNP-NNP-NNP,6,1
3,4.0,59,joined,4,45,56,11,44,2,-41,52,The Last Man on Earth,Vincent Price,MISC-MISC-MISC-MISC-MISC,PER-PER,DET-ADJ-NOUN-ADP-PROPN,PROPN-PROPN,det-amod-conj-prep-pobj,compound-dobj,DT-JJ-NN-IN-NNP,NNP-NNP,3,1
4,5.0,20,commissioned,6,5,10,5,4,9,1,4,Salkow,United States Marine Corps,PER,ORG-ORG-ORG-ORG,PROPN,PROPN-PROPN-PROPN-PROPN,nsubjpass,compound-compound-compound-pobj,NNP,NNP-NNP-NNP-NNP,4,1
0,0.0,24,Bricka,2,1,5,4,0,18,1,3,Carl Frederik Bricka,"July 10 , 1845",PER-PER-PER,TIME-TIME-TIME-TIME,PROPN-PROPN-PROPN,PROPN-NUM-PUNCT-NUM,compound-compound-ROOT,appos-nummod-punct-npadvmod,NNP-NNP-NNP,"NNP-CD-,-CD",3,1
1,0.0,24,Bricka,2,1,10,9,0,13,1,8,Carl Frederik Bricka,"August 23 , 1903",PER-PER-PER,TIME-TIME-TIME-TIME,PROPN-PROPN-PROPN,PROPN-NUM-PUNCT-NUM,compound-compound-ROOT,nsubj-nummod-punct-nummod,NNP-NNP-NNP,"NNP-CD-,-CD",3,1
2,0.0,24,Bricka,2,1,17,16,0,6,1,15,Carl Frederik Bricka,Danish,PER-PER-PER,LOC,PROPN-PROPN-PROPN,ADJ,compound-compound-ROOT,amod,NNP-NNP-NNP,JJ,3,1
3,1.0,9,born,3,1,6,5,0,2,2,3,Carl Bricka,Copenhagen,PER-PER,LOC,PROPN-PROPN,PROPN,compound-nsubjpass,pobj,NNP-NNP,NNP,4,1
4,1.0,9,born,3,6,8,2,5,0,-3,5,Copenhagen,Denmark,LOC,LOC,PROPN,PROPN,pobj,appos,NNP,NNP,4,1
5,2.0,18,was,13,4,9,5,3,8,9,-4,Frederik Vilhelm Theodor Bricka,1809,PER-PER-PER-PER,TIME,PROPN-PROPN-PROPN-PROPN,NUM,compound-compound-compound-appos,npadvmod,NNP-NNP-NNP-NNP,CD,5,1
6,6.0,27,became,1,1,10,9,0,16,0,9,Bricka,Danish Historical Society,PER,ORG-ORG-ORG,PROPN,PROPN-PROPN-PROPN,nsubj,compound-compound-pobj,NNP,NNP-NNP-NNP,6,1
0,1.0,13,over,0,3,9,6,2,3,-3,9,Mississippi River,Louisiana,LOC-LOC,LOC,PROPN-PROPN,PROPN,compound-pobj,conj,NNP-NNP,NNP,4,1
1,1.0,13,over,0,3,11,8,2,1,-3,11,Mississippi River,United States,LOC-LOC,LOC-LOC,PROPN-PROPN,PROPN-PROPN,compound-pobj,compound-appos,NNP-NNP,NNP-NNP,4,1
2,1.0,13,over,0,6,11,5,5,1,-6,11,New Orleans,United States,LOC-LOC,LOC-LOC,PROPN-PROPN,PROPN-PROPN,compound-pobj,compound-appos,NNP-NNP,NNP-NNP,2,1
3,1.0,13,over,0,9,11,2,8,1,-9,11,Louisiana,United States,LOC,LOC-LOC,PROPN,PROPN-PROPN,conj,compound-appos,NNP,NNP-NNP,2,1
0,0.0,22,is,4,1,19,18,0,2,3,15,A Charlie Brown Christmas,Charles M. Schulz,MISC-MISC-MISC-MISC,PER-PER-PER,DET-PROPN-PROPN-PROPN,PROPN-PROPN-PROPN,det-compound-compound-nsubj,compound-compound-pobj,DT-NNP-NNP-NNP,NNP-NNP-NNP,6,1
1,0.0,22,is,4,16,19,3,15,2,-12,15,Peanuts,Charles M. Schulz,MISC,PER-PER-PER,PROPN,PROPN-PROPN-PROPN,pobj,compound-compound-pobj,NNP,NNP-NNP-NNP,5,1
0,0.0,31,is,2,1,17,16,0,13,1,15,Spring Gulch,Pitkin County,LOC-LOC,LOC-LOC,PROPN-PROPN,PROPN-PROPN,compound-nsubj,compound-pobj,NNP-NNP,NNP-NNP,7,1
1,0.0,31,is,2,1,30,29,0,0,1,28,Spring Gulch,USA,LOC-LOC,LOC,PROPN-PROPN,PROPN,compound-nsubj,appos,NNP-NNP,NNP,2,1
2,0.0,31,is,2,12,30,18,11,0,-10,28,Thompson Creek Road,USA,LOC-LOC-LOC,LOC,PROPN-PROPN-PROPN,PROPN,compound-compound-pobj,appos,NNP-NNP-NNP,NNP,6,1
3,0.0,31,is,2,17,30,13,16,0,-15,28,Pitkin County,USA,LOC-LOC,LOC,PROPN-PROPN,PROPN,compound-pobj,appos,NNP-NNP,NNP,7,1
4,0.0,31,is,2,26,30,4,25,0,-24,28,Carbondale,USA,LOC,LOC,PROPN,PROPN,pobj,appos,NNP,NNP,6,1
0,0.0,38,is,13,3,10,7,2,27,10,-3,Modern Persian,Middle Persian,MISC-MISC,MISC-MISC,PROPN-PROPN,PROPN-PROPN,compound-appos,compound-appos,NNP-NNP,NNP-NNP,3,1
0,0.0,28,is,5,1,20,19,0,7,4,15,Store Torungen Lighthouse,Arendal,LOC-LOC-LOC,LOC,PROPN-PROPN-PROPN,PROPN,compound-compound-nsubj,pobj,NNP-NNP-NNP,NNP,6,1
1,0.0,28,is,5,1,27,26,0,0,4,22,Store Torungen Lighthouse,Norway,LOC-LOC-LOC,LOC,PROPN-PROPN-PROPN,PROPN,compound-compound-nsubj,appos,NNP-NNP-NNP,NNP,3,1
2,0.0,28,is,5,1,20,19,0,7,4,15,Store Torungen,Arendal,LOC-LOC,LOC,PROPN-PROPN,PROPN,compound-pobj,pobj,NNP-NNP,NNP,6,1
3,0.0,28,is,5,1,27,26,0,0,4,22,Store Torungen,Norway,LOC-LOC,LOC,PROPN-PROPN,PROPN,compound-pobj,appos,NNP-NNP,NNP,3,1
4,0.0,28,is,5,20,22,2,19,5,-15,17,Arendal,Aust - Agder county,LOC,LOC-LOC-LOC-LOC,PROPN,PROPN-PUNCT-PROPN-NOUN,pobj,compound-punct-compound-pobj,NNP,NNP-HYPH-NNP-NN,3,1
5,0.0,28,is,5,20,27,7,19,0,-15,22,Arendal,Norway,LOC,LOC,PROPN,PROPN,pobj,appos,NNP,NNP,5,1
0,3.0,31,tells,9,25,28,3,24,2,-16,19,Marshall Lee,Donald Glover,PER-PER,PER-PER,PROPN-PROPN,PROPN-PROPN,compound-appos,compound-appos,NNP-NNP,NNP-NNP,1,1
1,4.0,16,"""",0,2,9,7,1,6,-2,9,Bad Little Boy,Cartoon Network,MISC-MISC-MISC,ORG-ORG,ADJ-ADJ-NOUN,PROPN-PROPN,compound-compound-nsubj,compound-pobj,JJ-JJ-NN,NNP-NNP,4,1
0,0.0,36,Hanehalli,2,22,35,13,21,0,-20,33,Uttara Kannada,Karnataka,LOC-LOC,LOC,PROPN-PROPN,PROPN,compound-compound,pobj,NNP-NNP,NNP,7,1
1,0.0,36,Hanehalli,2,32,35,3,31,0,-30,33,Indian,Karnataka,LOC,LOC,ADJ,PROPN,amod,pobj,JJ,NNP,10,1
2,1.0,16,joins,11,10,14,4,9,1,1,3,Gangavali River,Arabian Sea,LOC-LOC,LOC-LOC,PROPN-PROPN,PROPN-PROPN,compound-nsubj,compound-dobj,NNP-NNP,NNP-NNP,2,1
0,1.0,25,born,2,1,5,4,0,19,1,3,Morrison,Lithgow,PER,LOC,PROPN,PROPN,nsubjpass,pobj,NNP,NNP,4,1
1,1.0,25,born,2,1,20,19,0,4,1,18,Morrison,University of Sydney,PER,ORG-ORG-ORG,PROPN,PROPN-ADP-PROPN,nsubjpass,pobj-prep-pobj,NNP,NNP-IN-NNP,7,1
2,1.0,25,born,2,5,7,2,4,17,-3,5,Lithgow,New South Wales,LOC,LOC-LOC-LOC,PROPN,PROPN-PROPN-PROPN,pobj,compound-compound-appos,NNP,NNP-NNP-NNP,3,1
0,0.0,35,is,3,16,24,8,15,10,-13,21,Jefferson Airplane,Pacific High Recording Studios,ORG-ORG,ORG-ORG-ORG-ORG,PROPN-PROPN,PROPN-PROPN-PROPN-PROPN,compound-pobj,compound-compound-compound-pobj,NNP-NNP,NNP-NNP-NNP-NNPS,10,1
1,7.0,43,released,31,21,38,17,20,4,10,7,Thirty Seconds Over Winterland,Early Flight,MISC-MISC-MISC-MISC,MISC-MISC,PROPN-PROPN-ADP-PROPN,PROPN-PROPN,compound-appos-prep-pobj,compound-compound,NNP-NNPS-IN-NNP,NNP-NNP,9,1
0,0.0,23,is,3,1,11,10,0,11,2,8,Dancing Stage Fusion,Konami,MISC-MISC-MISC,ORG,PROPN-PROPN-PROPN,PROPN,compound-compound-nsubj,pobj,NNP-NNP-NNP,NNP,5,1
1,0.0,23,is,3,1,14,13,0,8,2,11,Dancing Stage Fusion,European PlayStation,MISC-MISC-MISC,MISC-MISC,PROPN-PROPN-PROPN,PROPN-PROPN,compound-compound-nsubj,compound-pobj,NNP-NNP-NNP,NNP-NNP,6,1
2,0.0,23,is,3,1,20,19,0,2,2,17,Dancing Stage Fusion,5 November 2004,MISC-MISC-MISC,TIME-TIME-TIME,PROPN-PROPN-PROPN,NUM-PROPN-NUM,compound-compound-nsubj,nummod-pobj-nummod,NNP-NNP-NNP,CD-NNP-CD,6,1
3,3.0,42,was,7,5,27,22,4,14,2,20,Dancing Stage EuroMix 2,Dance Dance Revolution,MISC-MISC-MISC-MISC,MISC-MISC-MISC,PROPN-PROPN-PROPN-NUM,PROPN-PROPN-PROPN,compound-pobj-appos-nummod,compound-compound-compound,NNP-NNP-NNP-CD,NNP-NNP-NNP,9,1
4,3.0,42,was,7,5,34,29,4,7,2,27,Dancing Stage EuroMix 2,Konami,MISC-MISC-MISC-MISC,ORG,PROPN-PROPN-PROPN-NUM,PROPN,compound-pobj-appos-nummod,pobj,NNP-NNP-NNP-CD,NNP,9,1
5,3.0,42,was,7,27,34,7,26,7,-20,27,Dance Dance Revolution,Konami,MISC-MISC-MISC,ORG,PROPN-PROPN-PROPN,PROPN,compound-compound-compound,pobj,NNP-NNP-NNP,NNP,4,1
6,3.0,42,was,7,27,41,14,26,0,-20,34,Dance Dance Revolution Extreme,2002,MISC-MISC-MISC-MISC,TIME,PROPN-PROPN-PROPN-PROPN,NUM,compound-compound-compound-pobj,pobj,NNP-NNP-NNP-NNP,CD,6,1
7,5.0,19,featured,6,13,18,5,12,0,-7,12,Dance Dance Revolution SuperNova,2006,MISC-MISC-MISC-MISC,TIME,PROPN-PROPN-PROPN-PROPN,NUM,compound-compound-compound-pobj,pobj,NNP-NNP-NNP-NNP,CD,7,1
0,0.0,25,is,8,1,5,4,0,19,7,-3,Emma Trott,24 December 1989,PER-PER,TIME-TIME-TIME,PROPN-PROPN,NUM-PROPN-NUM,compound-nsubj,nummod-npadvmod-nummod,NNP-NNP,CD-NNP-CD,2,1
1,0.0,25,is,8,1,12,11,0,12,7,4,Emma Trott,English,PER-PER,LOC,PROPN-PROPN,ADJ,compound-nsubj,amod,NNP-NNP,JJ,3,1
2,0.0,25,is,8,16,23,7,15,1,-8,15,Cheshunt,New Zealand,LOC,LOC-LOC,PROPN,PROPN-PROPN,pobj,compound-appos,NNP,NNP-NNP,5,1
3,0.0,25,is,8,21,23,2,20,1,-13,15,Christchurch,New Zealand,LOC,LOC-LOC,PROPN,PROPN-PROPN,pobj,compound-appos,NNP,NNP-NNP,2,1
4,4.0,29,is,1,27,22,-5,26,6,-26,21,Linda Villumsen,New Zealand,PER-PER,LOC-LOC,PROPN-PROPN,PROPN-PROPN,compound-pobj,compound-compound,NNP-NNP,NNP-NNP,2,1
0,0.0,21,Page,2,1,5,4,0,15,1,3,George True Page,"September 22 , 1859",PER-PER-PER,TIME-TIME-TIME-TIME,PROPN-PROPN-NOUN,PROPN-NUM-PUNCT-NUM,compound-compound-ROOT,appos-nummod-punct-npadvmod,NNP-NNP-NN,"NNP-CD-,-CD",3,1
1,0.0,21,Page,2,1,10,9,0,10,1,8,George True Page,"November 4 , 1941",PER-PER-PER,TIME-TIME-TIME-TIME,PROPN-PROPN-NOUN,PROPN-NUM-PUNCT-NUM,compound-compound-ROOT,nsubj-nummod-punct-nummod,NNP-NNP-NN,"NNP-CD-,-CD",4,1
2,1.0,27,attended,8,8,3,-5,7,23,0,-5,Page,Spring Bay,PER,LOC-LOC,PROPN,PROPN-PROPN,nsubj,compound-pobj,NNP,NNP-NNP,3,1
3,2.0,25,was,1,20,22,2,19,2,-19,21,Peoria,Illinois,LOC,LOC,PROPN,PROPN,pobj,appos,NNP,NNP,5,1
4,2.0,25,was,1,7,9,2,6,15,-6,8,Denver,Colorado,LOC,LOC,PROPN,PROPN,pobj,npadvmod,NNP,NNP,4,1
0,2.0,15,was,1,9,13,4,8,1,-8,12,British,Elizabeth II,LOC,PER-PER,ADJ,PROPN-PROPN,amod,compound-appos,JJ,NNP-NNP,1,1
1,6.0,14,married,1,1,3,2,0,10,0,2,Mary,Viscount Lascelles,PER,PER-PER,PROPN,PROPN-PROPN,nsubj,compound-dobj,NNP,NNP-NNP,1,1
0,0.0,22,Busac,1,1,4,3,0,17,0,3,William Busac,1020,PER-PER,TIME,PROPN-PROPN,NUM,compound-ROOT,npadvmod,NNP-NNP,CD,3,1
1,0.0,22,Busac,1,1,1,0,0,20,0,0,William Busac,William I,PER-PER,PER-PER,PROPN-PROPN,PROPN-PROPN,compound-ROOT,compound-pobj,NNP-NNP,NNP-NNP,0,1
2,0.0,22,Busac,1,1,21,20,0,0,0,20,William I,Lesceline,PER-PER,PER,PROPN-PROPN,PROPN,compound-pobj,appos,NNP-NNP,NNP,1,1
3,3.0,24,appealed,1,23,8,-15,22,15,-22,7,Soissons,France,LOC,LOC,PROPN,PROPN,pobj,pobj,NNPS,NNP,5,1
4,3.0,24,appealed,1,5,8,3,4,15,-4,7,Henry I,France,PER-PER,LOC,PROPN-PRON,PROPN,pobj-appos,pobj,NNP-PRP,NNP,1,1
0,0.0,38,was,11,1,4,3,0,33,10,-7,Pauline Bonaparte,20 October 1780,PER-PER,TIME-TIME-TIME,PROPN-PROPN,NUM-PROPN-NUM,compound-nsubj,nummod-appos-nummod,NNP-NNP,CD-NNP-CD,1,1
1,0.0,38,was,11,1,8,7,0,29,10,-3,Pauline Bonaparte,9 June 1825,PER-PER,TIME-TIME-TIME,PROPN-PROPN,NUM-PROPN-NUM,compound-nsubj,nummod-npadvmod-nummod,NNP-NNP,CD-NNP-CD,2,1
2,0.0,38,was,11,1,35,34,0,2,10,24,Pauline Bonaparte,Sulmona,PER-PER,LOC,PROPN-PROPN,PROPN,compound-nsubj,pobj,NNP-NNP,NNP,8,1
3,0.0,38,was,11,22,24,2,21,13,-11,13,Guastalla,Italy,LOC,LOC,PROPN,PROPN,pobj,pobj,NNP,NNP,4,1
4,1.0,25,was,1,10,7,-3,9,17,-9,6,Carlo Buonaparte,Letizia Ramolino,PER-PER,PER-PER,PROPN-PROPN,PROPN-PROPN,compound-conj,compound-pobj,NNP-NNP,NNP-NNP,1,1
5,1.0,25,was,1,13,21,8,12,3,-12,20,Corsica,Louis XVI of France,LOC,PER-PER-PER-PER,PROPN,PROPN-PROPN-ADP-PROPN,poss,compound-pobj-prep-pobj,NNP,NNP-NNP-IN-NNP,6,1
6,2.0,14,was,6,5,13,8,4,0,1,7,Napoleon,French,PER,LOC,PROPN,PROPN,appos,pobj,NNP,NNP,2,1
7,3.0,18,married,1,3,17,14,2,0,-2,16,Charles Leclerc,1802,PER-PER,TIME,PROPN-PROPN,NUM,compound-dobj,pobj,NNP-NNP,CD,2,1
0,0.0,21,Underwood,2,1,5,4,0,15,1,3,Emory Marvin Underwood,"December 11 , 1877",PER-PER-PER,TIME-TIME-TIME-TIME,NOUN-PROPN-PROPN,PROPN-NUM-PUNCT-NUM,compound-compound-ROOT,appos-nummod-punct-npadvmod,NN-NNP-NNP,"NNP-CD-,-CD",3,1
1,0.0,21,Underwood,2,1,10,9,0,10,1,8,Emory Marvin Underwood,"August 28 , 1960",PER-PER-PER,TIME-TIME-TIME-TIME,NOUN-PROPN-PROPN,PROPN-NUM-PUNCT-NUM,compound-compound-ROOT,nsubj-nummod-punct-nummod,NN-NNP-NNP,"NNP-CD-,-CD",3,1
2,1.0,11,received,8,3,6,3,2,4,5,-2,Douglas County,Georgia,LOC-LOC,LOC,PROPN-PROPN,PROPN,compound-pobj,appos,NNP-NNP,NNP,4,1
0,0.0,27,is,22,1,5,4,0,21,21,-17,Borys Buryak,25 October 1953,PER-PER,TIME-TIME-TIME,PROPN-PROPN,NUM-PROPN-NUM,compound-nsubj,nummod-npadvmod-nummod,NNP-NNP,CD-NNP-CD,2,1
1,0.0,27,is,22,1,9,8,0,17,21,-13,Borys Buryak,Podvirne,PER-PER,LOC,PROPN-PROPN,PROPN,compound-nsubj,pobj,NNP-NNP,NNP,4,1
2,0.0,27,is,22,1,11,10,0,15,21,-11,Borys Buryak,Chernivtsi Oblast,PER-PER,LOC-LOC,PROPN-PROPN,PROPN-PROPN,compound-nsubj,compound-appos,NNP-NNP,NNP-NNP,4,1
3,2.0,22,graduated,1,1,5,4,0,16,0,4,Buryak,Ivan Trush College of Arts,PER,ORG-ORG-ORG-ORG-ORG,NOUN,PROPN-PROPN-PROPN-ADP-PROPN,nsubj,compound-compound-pobj-prep-pobj,NN,NNP-NNP-NNP-IN-NNPS,3,1
4,2.0,22,graduated,1,1,16,15,0,5,0,15,Buryak,Lviv Academy of Arts,PER,ORG-ORG-ORG-ORG,NOUN,PROPN-PROPN-ADP-PROPN,nsubj,compound-pobj-prep-pobj,NN,NNP-NNP-IN-NNP,2,1
5,5.0,18,lives,2,7,9,2,6,8,-5,7,Lviv,Ukraine,LOC,LOC,PROPN,PROPN,pobj,appos,NNP,NNP,3,1
0,0.0,37,consists,5,2,35,33,1,1,3,30,Peter Guice Memorial Bridge,North Carolina,LOC-LOC-LOC-LOC,LOC-LOC,PROPN-PROPN-PROPN-PROPN,PROPN-PROPN,compound-compound-compound-nsubj,compound-appos,NNP-NNP-NNP-NNP,NNP-NNP,5,1
1,0.0,37,consists,5,20,35,15,19,1,-15,30,Green River,North Carolina,LOC-LOC,LOC-LOC,PROPN-PROPN,PROPN-PROPN,compound-pobj,compound-appos,NNP-NNP,NNP-NNP,9,1
2,0.0,37,consists,5,25,32,7,24,4,-20,27,East Flat Rock,Henderson County,LOC-LOC-LOC,LOC-LOC,PROPN-PROPN-PROPN,PROPN-PROPN,compound-compound-pobj,compound-pobj,NNP-NNP-NNP,NNP-NNP,5,1
3,0.0,37,consists,5,29,32,3,28,4,-24,27,Saluda,Henderson County,LOC,LOC-LOC,PROPN,PROPN-PROPN,conj,compound-pobj,NNP,NNP-NNP,7,1
4,0.0,37,consists,5,29,35,6,28,1,-24,30,Saluda,North Carolina,LOC,LOC-LOC,PROPN,PROPN-PROPN,conj,compound-appos,NNP,NNP-NNP,9,1
5,0.0,37,consists,5,32,35,3,31,1,-27,30,Henderson County,North Carolina,LOC-LOC,LOC-LOC,PROPN-PROPN,PROPN-PROPN,compound-pobj,compound-appos,NNP-NNP,NNP-NNP,2,1
6,1.0,37,is,19,14,17,3,13,19,5,-2,Emlenton Bridge,Pennsylvania,LOC-LOC,LOC,PROPN-PROPN,PROPN,compound-conj,pobj,NNP-NNP,NNP,5,1
7,1.0,37,is,19,14,33,19,13,3,5,14,Emlenton Bridge,United States,LOC-LOC,LOC-LOC,PROPN-PROPN,PROPN-PROPN,compound-conj,compound-pobj,NNP-NNP,NNP-NNP,8,1
8,1.0,37,is,19,17,33,16,16,3,2,14,Pennsylvania,United States,LOC,LOC-LOC,PROPN,PROPN-PROPN,pobj,compound-pobj,NNP,NNP-NNP,5,1
9,1.0,37,is,19,28,33,5,27,3,-9,14,Interstate Highway,United States,LOC-LOC,LOC-LOC,PROPN-PROPN,PROPN-PROPN,compound-dobj,compound-pobj,NNP-NNP,NNP-NNP,3,1
10,1.0,37,is,19,33,10,-23,32,26,-14,-9,United States,West Virginia,LOC-LOC,LOC-LOC,PROPN-PROPN,PROPN-PROPN,compound-pobj,compound-pobj,NNP-NNP,NNP-NNP,9,1
0,1.0,37,garnered,3,19,11,-8,18,25,-16,8,France,European,LOC,LOC,PROPN,ADJ,conj,amod,NNP,JJ,4,1
1,1.0,37,garnered,3,25,11,-14,24,25,-22,8,Sweden,European,LOC,LOC,PROPN,ADJ,conj,amod,NNP,JJ,6,1
2,1.0,37,garnered,3,28,11,-17,27,25,-25,8,Greece,European,LOC,LOC,PROPN,ADJ,conj,amod,NNP,JJ,5,1
0,0.0,20,is,6,1,9,8,0,10,5,3,Hamza Ali Abbasi,Pakistani,PER-PER-PER,LOC,PROPN-PROPN-PROPN,ADJ,compound-compound-nsubj,amod,NNP-NNP-NNP,JJ,3,1
1,3.0,22,made,1,11,15,4,10,6,-10,14,The Glorious Resolve,2010,MISC-MISC-MISC,TIME,DET-PROPN-PROPN,NUM,det-compound-appos,appos,DT-NNP-NNP,CD,2,1
2,5.0,20,received,1,13,18,5,12,1,-12,17,Jawani Phir Nahi Ani,2015,MISC-MISC-MISC-MISC,TIME,PROPN-PROPN-PROPN-PROPN,NUM,compound-compound-compound-appos,appos,NNP-NNP-NNP-NNP,CD,2,1
0,1.0,12,is,4,8,11,3,7,0,-4,7,National Gallery,London,LOC-LOC,LOC,PROPN-PROPN,PROPN,compound-pobj,pobj,NNP-NNP,NNP,3,1
0,0.0,32,Mielczewski,1,1,5,4,0,26,0,4,Marcin Mielczewski,1600,PER-PER,TIME,PROPN-PROPN,NUM,compound-ROOT,nummod,NNP-NNP,CD,1,1
1,2.0,19,became,3,9,17,8,8,1,-6,14,Charles Ferdinand Vasa,Władysław IV,PER-PER-PER,PER-PER,PROPN-PROPN-PROPN,PROPN-PROPN,compound-compound-pobj,compound-pobj,NNP-NNP-NNP,NNP-NNP,4,1
2,3.0,8,died,1,1,4,3,0,3,0,3,Mielczewski,Warsaw,PER,LOC,PROPN,PROPN,nsubj,pobj,NNP,NNP,1,1
0,0.0,50,is,3,16,9,-7,15,40,-13,6,George W. Bush,the United States,PER-PER-PER,LOC-LOC-LOC,PROPN-PROPN-PROPN,DET-PROPN-PROPN,compound-compound-compound,det-compound-pobj,NNP-NNP-NNP,DT-NNP-NNP,4,1
0,4.0,40,awarded,3,1,6,5,0,33,2,3,Pavel Prokkonen,Order of Lenin,PER-PER,MISC-MISC-MISC,PROPN-PROPN,NOUN-ADP-PROPN,compound-nsubjpass,dobj-prep-pobj,NNP-NNP,NN-IN-NNP,3,1
1,4.0,40,awarded,3,1,6,5,0,33,2,3,Pavel Prokkonen,Order of the Red Banner of Labour,PER-PER,MISC-MISC-MISC-MISC-MISC-MISC-MISC,PROPN-PROPN,NOUN-ADP-DET-PROPN-PROPN-ADP-PROPN,compound-nsubjpass,appos-prep-det-compound-pobj-prep-pobj,NNP-NNP,NN-IN-DT-NNP-NNP-IN-NNP,3,1
2,4.0,40,awarded,3,1,6,5,0,33,2,3,Pavel Prokkonen,Order of the Badge of Honor,PER-PER,MISC-MISC-MISC-MISC-MISC-MISC,PROPN-PROPN,NOUN-ADP-DET-PROPN-ADP-PROPN,compound-nsubjpass,conj-prep-det-pobj-prep-pobj,NNP-NNP,NN-IN-DT-NNP-IN-NNP,3,1
0,0.0,39,Barbarian,0,1,13,12,0,25,-1,13,Barbarian : The Ultimate Warrior,Commodore 64,MISC-MISC-MISC-MISC-MISC,MISC-MISC,NOUN-PUNCT-DET-PROPN-PROPN,PROPN-NUM,ROOT-punct-det-compound-nsubj,pobj-nummod,NN-:-DT-NNP-NNP,NNP-CD,6,1
1,0.0,39,Barbarian,0,1,18,17,0,20,-1,18,Barbarian : The Ultimate Warrior,1987,MISC-MISC-MISC-MISC-MISC,TIME,NOUN-PUNCT-DET-PROPN-PROPN,NUM,ROOT-punct-det-compound-nsubj,pobj,NN-:-DT-NNP-NNP,CD,3,1
0,4.0,74,relied,1,1,10,9,0,63,0,9,NGSCB,Trusted Computing Group,MISC,ORG-ORG-ORG,PROPN,PROPN-PROPN-PROPN,nsubj,compound-compound-pobj,NNP,NNP-NNP-NNP,8,1
1,10.0,48,differed,1,12,7,-5,11,40,-11,6,Windows Presentation Foundation,Microsoft,MISC-MISC-MISC,ORG,PROPN-PROPN-PROPN,PROPN,compound-compound-pobj,nsubj,NNP-NNP-NNP,NNP,4,1
2,11.0,70,emerged,12,17,15,-2,16,54,-5,3,BitLocker,Microsoft,MISC,ORG,PROPN,PROPN,nmod,poss,NNP,NNP,5,1
0,1.0,39,was,11,17,21,4,16,17,-6,10,Robert Walpole,Whig,PER-PER,ORG,PROPN-PROPN,PROPN,compound-pobj,appos,NNP-NNP,NNP,3,1
1,4.0,29,defeated,20,23,27,4,22,1,-3,7,Margaret Thatcher,Conservative Party,PER-PER,ORG-ORG,PROPN-PROPN,PROPN-PROPN,compound-pobj,compound-pobj,NNP-NNP,NNP-NNP,2,1
0,5.0,91,recasts,58,77,64,-13,76,26,-19,6,Numa Pompilius,Rome,PER-PER,LOC,PROPN-PROPN,PROPN,compound-appos,pobj,NNP-NNP,NNP,6,1
0,0.0,37,(;,3,2,5,3,1,31,1,2,Benedict XIV,31 March 1675,PER-PER,TIME-TIME-TIME,PROPN-PROPN,NUM-PROPN-NUM,compound-nsubj,nummod-npadvmod-nummod,NNP-NNP,CD-NNP-CD,2,1
1,0.0,37,(;,3,2,10,8,1,26,1,7,Benedict XIV,3 May 1758,PER-PER,TIME-TIME-TIME,PROPN-PROPN,NUM-PROPN-NUM,compound-nsubj,nummod-dep-nummod,NNP-NNP,CD-NNP-CD,2,1
2,0.0,37,(;,3,2,26,24,1,10,1,23,Benedict XIV,Catholic Church,PER-PER,ORG-ORG,PROPN-PROPN,PROPN-PROPN,compound-nsubj,compound-pobj,NNP-NNP,NNP-NNP,6,1
3,0.0,37,(;,3,2,12,10,1,24,1,9,Benedict XIV,1758,PER-PER,TIME,PROPN-PROPN,NUM,compound-nsubj,pobj,NNP-NNP,CD,3,1
0,0.0,22,Allan,2,1,5,4,0,16,1,3,Absalom Shade Allan,"November 26 , 1843",PER-PER-PER,TIME-TIME-TIME-TIME,PROPN-PROPN-PROPN,PROPN-NUM-PUNCT-NUM,compound-compound-ROOT,appos-nummod-punct-nummod,NNP-NNP-NNP,"NNP-CD-,-CD",3,1
1,0.0,22,Allan,2,1,10,9,0,11,1,8,Absalom Shade Allan,"February 1 , 1928",PER-PER-PER,TIME-TIME-TIME-TIME,PROPN-PROPN-PROPN,PROPN-NUM-PUNCT-NUM,compound-compound-ROOT,nsubj-nummod-punct-appos,NNP-NNP-NNP,"NNP-CD-,-CD",4,1
2,2.0,24,born,2,21,23,2,20,0,-19,21,Aberdeen,Scotland,LOC,LOC,PROPN,PROPN,pobj,appos,NNP,NNP,7,1
0,0.0,27,was,14,1,5,4,0,21,13,-9,Frederick William Anderson,"September 28 , 1883",PER-PER-PER,TIME-TIME-TIME-TIME,PROPN-PROPN-PROPN,PROPN-NUM-PUNCT-NUM,compound-compound-nsubj,appos-nummod-punct-npadvmod,NNP-NNP-NNP,"NNP-CD-,-CD",3,1
1,0.0,27,was,14,1,10,9,0,16,13,-4,Frederick William Anderson,"April 28 , 1955",PER-PER-PER,TIME-TIME-TIME-TIME,PROPN-PROPN-PROPN,PROPN-NUM-PUNCT-NUM,compound-compound-nsubj,appos-nummod-punct-nummod,NNP-NNP-NNP,"NNP-CD-,-CD",4,1
2,1.0,18,represented,1,9,6,-3,8,11,-8,5,British Columbia,Legislative Assembly,LOC-LOC,ORG-ORG,PROPN-PROPN,PROPN-PROPN,compound-pobj,compound-pobj,NNP-NNP,NNP-NNP,2,1
0,0.0,22,is,4,1,15,14,0,6,3,11,Cape Arkona,Rügen,LOC-LOC,LOC,PROPN-PROPN,PROPN,compound-nsubj,pobj,NNP-NNP,NNP,5,1
1,2.0,39,belongs,15,5,32,27,4,6,10,17,Cape Arkona,Rügen,LOC-LOC,LOC,PROPN-PROPN,PROPN,compound-pobj,pobj,NNP-NNP,NNP,5,1
2,5.0,20,referred,4,1,13,12,0,6,3,9,Cape Arkona,Rügen,LOC-LOC,LOC,PROPN-PROPN,PROPN,compound-nsubjpass,pobj,NNP-NNP,NNP,6,1
3,0.0,22,is,4,1,21,20,0,0,3,17,Cape Arkona,Germany,LOC-LOC,LOC,PROPN-PROPN,PROPN,compound-nsubj,pobj,NNP-NNP,NNP,9,1
4,0.0,22,is,4,15,21,6,14,0,-11,17,Rügen,Germany,LOC,LOC,PROPN,PROPN,pobj,pobj,NNP,NNP,4,1
5,2.0,39,belongs,15,14,21,7,13,17,1,6,Vitt,Putgarten,LOC,LOC,PROPN,PROPN,pobj,pobj,NNP,NNP,2,1
0,0.0,52,encompasses,7,1,28,27,0,23,6,21,Loyola University Chicago,Illinois,ORG-ORG-ORG,LOC,PROPN-PROPN-PROPN,PROPN,compound-compound-pobj,appos,NNP-NNP-NNP,NNP,4,1
1,0.0,52,encompasses,7,35,37,2,34,14,-28,30,Rome,Italy,LOC,LOC,PROPN,PROPN,pobj,conj,NNP,NNP,2,1
2,0.0,52,encompasses,7,39,41,2,38,10,-32,34,Beijing,China,LOC,LOC,PROPN,PROPN,npadvmod,conj,NNP,NNP,3,1
3,2.0,35,school,3,6,19,13,5,15,-3,16,Quinlan,1922,ORG,TIME,PROPN,NUM,nsubj,pobj,NNP,CD,3,1
0,2.0,46,purports,2,12,17,5,11,28,-10,15,Zechariah,John the Baptist,PER,PER-PER-PER,PROPN,PROPN-DET-PROPN,pobj,pobj-det-appos,NNP,NNP-DT-NNP,6,1
0,0.0,27,is,11,1,6,5,0,20,10,-5,Camilo José Vergara,1944,PER-PER-PER,TIME,PROPN-PROPN-PROPN,NUM,compound-compound-nsubj,npadvmod,NNP-NNP-NNP,CD,3,1
1,0.0,27,is,11,1,8,7,0,18,10,-3,Camilo José Vergara,Santiago,PER-PER-PER,LOC,PROPN-PROPN-PROPN,PROPN,compound-compound-nsubj,pobj,NNP-NNP-NNP,NNP,5,1
2,0.0,27,is,11,1,10,9,0,16,10,-1,Camilo José Vergara,Chile,PER-PER-PER,LOC,PROPN-PROPN-PROPN,PROPN,compound-compound-nsubj,appos,NNP-NNP-NNP,NNP,3,1
3,0.0,27,is,11,8,10,2,7,16,3,-1,Santiago,Chile,LOC,LOC,PROPN,PROPN,pobj,appos,NNP,NNP,4,1
4,3.0,60,turned,11,41,44,3,40,15,-30,33,South Bronx,New York City,LOC-LOC,LOC-LOC-LOC,PROPN-PROPN,PROPN-PROPN-PROPN,compound-conj,compound-compound-pobj,NNP-NNP,NNP-NNP-NNP,3,1
0,5.0,47,reopened,5,30,14,-16,29,32,-25,9,Flint,GM,LOC,ORG,PROPN,PROPN,conj,nmod,NNP,NNP,5,1
0,0.0,24,Rice,2,1,5,4,0,18,1,3,Helen Steiner Rice,"May 19 , 1900",PER-PER-PER,TIME-TIME-TIME-TIME,PROPN-PROPN-PROPN,PROPN-NUM-PUNCT-NUM,compound-compound-ROOT,appos-nummod-punct-npadvmod,NNP-NNP-NNP,"NNP-CD-,-CD",3,1
1,0.0,24,Rice,2,1,10,9,0,13,1,8,Helen Steiner Rice,"April 23 , 1981",PER-PER-PER,TIME-TIME-TIME-TIME,PROPN-PROPN-PROPN,PROPN-NUM-PUNCT-NUM,compound-compound-ROOT,nsubj-nummod-punct-nummod,NNP-NNP-NNP,"NNP-CD-,-CD",4,1
2,13.0,29,died,1,23,28,5,22,0,-22,27,Elmwood Cemetery,Ohio,LOC-LOC,LOC,PROPN-PROPN,PROPN,compound-pobj,appos,NNP-NNP,NNP,4,1
3,14.0,18,were,12,7,12,5,6,5,5,0,Jimmy Carter,Rosalynn,PER-PER,PER,PROPN-PROPN,PROPN,compound-nsubj,appos,NNP-NNP,NNP,2,1
0,0.0,19,is,3,1,14,13,0,4,2,11,Bust a Groove,Sony PlayStation,MISC-MISC-MISC,MISC-MISC,VERB-DET-NOUN,PROPN-PROPN,nsubj-det-dobj,compound-pobj,VB-DT-NN,NNP-NNP,6,1
1,0.0,19,is,3,1,18,17,0,0,2,15,Bust a Groove,1998,MISC-MISC-MISC,TIME,VERB-DET-NOUN,NUM,nsubj-det-dobj,pobj,VB-DT-NN,CD,4,1
0,0.0,35,occurred,4,2,32,30,1,2,2,28,Capture of Jericho,First World War,MISC-MISC-MISC,MISC-MISC-MISC,PROPN-ADP-PROPN,PROPN-PROPN-PROPN,nsubj-prep-pobj,compound-compound-pobj,NNP-IN-NNP,NNP-NNP-NNP,8,1
1,0.0,35,occurred,4,26,32,6,25,2,-22,28,Sinai and Palestine Campaign,First World War,MISC-MISC-MISC-MISC,MISC-MISC-MISC,PROPN-CCONJ-PROPN-PROPN,PROPN-PROPN-PROPN,nmod-cc-conj-pobj,compound-compound-pobj,NNP-CC-NNP-NNP,NNP-NNP-NNP,5,1
2,2.0,21,attacked,5,3,7,4,2,13,2,2,British Empire,Ottoman,LOC-LOC,LOC,PROPN-PROPN,PROPN,compound-compound,compound,NNP-NNP,NNP,3,1
0,0.0,24,"""",0,2,18,16,1,5,-2,18,Looking for the Perfect Beat,Afrika Bambaataa,MISC-MISC-MISC-MISC-MISC,ORG-ORG,VERB-ADP-DET-PROPN-PROPN,PROPN-PROPN,csubj-prep-det-compound-pobj,compound-pobj,VBG-IN-DT-NNP-NNP,NNP-NNP,5,1
1,0.0,24,"""",0,2,4,2,1,19,-2,4,Looking for the Perfect Beat,the Soulsonic Force,MISC-MISC-MISC-MISC-MISC,ORG-ORG-ORG,VERB-ADP-DET-PROPN-PROPN,DET-PROPN-PROPN,csubj-prep-det-compound-pobj,det-compound-conj,VBG-IN-DT-NNP-NNP,DT-NNP-NNP,2,1
2,7.0,49,"""",0,6,48,42,5,0,-6,48,Beat Dis,1988,MISC-MISC,TIME,PROPN-PROPN,NUM,nmod-dobj,pobj,NNP-NNP,CD,-1,1
3,8.0,13,took,10,5,8,3,4,4,5,-2,Energie,1998,MISC,TIME,PROPN,NUM,nsubj,appos,NNP,CD,2,1
0,0.0,18,is,4,4,16,12,3,1,0,12,Canada,North America,LOC,LOC-LOC,PROPN,PROPN-PROPN,pobj,compound-pobj,NNP,NNP-NNP,7,1
0,0.0,22,is,5,2,21,19,1,0,3,16,West Fork Salmon River,Oregon,LOC-LOC-LOC-LOC,LOC,PROPN-PROPN-PROPN-PROPN,PROPN,compound-compound-compound-nsubj,pobj,NNP-NNP-NNP-NNP,NNP,3,1
1,0.0,22,is,5,14,18,4,13,3,-9,13,Clackamas County,U.S.,LOC-LOC,LOC,PROPN-PROPN,PROPN,compound-pobj,compound,NNP-NNP,NNP,6,1
2,0.0,22,is,5,14,21,7,13,0,-9,16,Clackamas County,Oregon,LOC-LOC,LOC,PROPN-PROPN,PROPN,compound-pobj,pobj,NNP-NNP,NNP,6,1
3,0.0,22,is,5,18,21,3,17,0,-13,16,U.S.,Oregon,LOC,LOC,PROPN,PROPN,compound,pobj,NNP,NNP,4,1
4,1.0,44,flows,16,9,13,4,8,30,7,-3,Mount Hood,Cascade Range,LOC-LOC,LOC-LOC,PROPN-PROPN,PROPN-PROPN,compound-pobj,compound-pobj,NNP-NNP,NNP-NNP,4,1
0,0.0,14,is,8,1,5,4,0,8,7,-3,Nina Solheim,4 August 1979,PER-PER,TIME-TIME-TIME,PROPN-PROPN,NUM-PROPN-NUM,compound-nsubj,nummod-npadvmod-nummod,NNP-NNP,CD-NNP-CD,3,1
1,1.0,34,won,1,20,24,4,19,9,-19,23,2008 Summer Olympics,Beijing,MISC-MISC-MISC,LOC,NUM-PROPN-PROPN,PROPN,nummod-compound-pobj,pobj,CD-NNP-NNPS,NNP,4,1
2,2.0,24,qualified,2,19,23,4,18,0,-17,21,2004 Summer Olympics,Athens,MISC-MISC-MISC,LOC,NUM-PROPN-PROPN,PROPN,nummod-compound-pobj,pobj,CD-NNP-NNPS,NNP,8,1
3,3.0,15,lost,1,7,10,3,6,4,-6,9,Luo Wei,China,PER-PER,LOC,PROPN-PROPN,PROPN,compound-pobj,pobj,NNP-NNP,NNP,5,1
4,4.0,40,won,19,9,14,5,8,25,10,-5,2001 World Taekwondo Championships,Jeju,MISC-MISC-MISC-MISC,LOC,NUM-PROPN-PROPN-PROPN,PROPN,nummod-compound-compound-pobj,pobj,CD-NNP-NNP-NNPS,NNP,4,1
5,4.0,40,won,19,14,16,2,13,23,5,-3,Jeju,South Korea,LOC,LOC-LOC,PROPN,PROPN-PROPN,pobj,compound-appos,NNP,NNP-NNP,2,1
6,4.0,40,won,19,33,37,4,32,2,-14,18,2006 World Cup,Bangkok,MISC-MISC-MISC,LOC,NUM-PROPN-PROPN,PROPN,nummod-compound-pobj,pobj,CD-NNP-NNP,NNP,4,1
7,4.0,40,won,19,37,39,2,36,0,-18,20,Bangkok,Thailand,LOC,LOC,PROPN,PROPN,pobj,appos,NNP,NNP,6,1
0,0.0,37,is,3,1,31,30,0,5,2,28,Andes to Amazon,UK,MISC-MISC-MISC,LOC,PROPN-ADP-PROPN,PROPN,nsubj-prep-pobj,pobj,NNP-IN-NNP,NNP,4,1
1,0.0,37,is,3,1,33,32,0,3,2,30,Andes to Amazon,BBC2,MISC-MISC-MISC,ORG,PROPN-ADP-PROPN,PROPN,nsubj-prep-pobj,pobj,NNP-IN-NNP,NNP,4,1
2,0.0,37,is,3,15,31,16,14,5,-12,28,BBC Natural History Unit,UK,ORG-ORG-ORG-ORG,LOC,PROPN-PROPN-PROPN-PROPN,PROPN,compound-compound-compound-pobj,pobj,NNP-NNP-NNP-NNP,NNP,7,1
3,0.0,37,is,3,20,22,2,19,14,-17,19,Bristol,England,LOC,LOC,PROPN,PROPN,pobj,conj,NNP,NNP,3,1
4,0.0,37,is,3,20,31,11,19,5,-17,28,Bristol,UK,LOC,LOC,PROPN,PROPN,pobj,pobj,NNP,NNP,8,1
5,0.0,37,is,3,22,31,9,21,5,-19,28,England,UK,LOC,LOC,PROPN,PROPN,conj,pobj,NNP,NNP,9,1
0,0.0,23,lived,5,20,22,2,19,0,-15,17,Kobe,Japan,LOC,LOC,PROPN,PROPN,pobj,appos,NNP,NNP,8,1
1,1.0,17,enrolled,2,5,8,3,4,8,-3,6,Sophia University,Tokyo,ORG-ORG,LOC,PROPN-PROPN,PROPN,compound-pobj,pobj,NNP-NNP,NNP,3,1
0,0.0,20,is,6,2,12,10,1,7,4,6,Chaco National Park,Argentina,LOC-LOC-LOC,LOC,PROPN-PROPN-PROPN,PROPN,compound-compound-nsubj,pobj,NNP-NNP-NNP,NNP,4,1
1,0.0,20,is,6,12,2,-10,11,17,-6,-4,Argentina,Chaco,LOC,LOC,PROPN,PROPN,pobj,pobj,NNP,NNP,4,1
0,0.0,23,was,13,1,4,3,0,18,12,-9,Asahel Grant,"August 17 , 1807",PER-PER,TIME-TIME-TIME-TIME,PROPN-PROPN,PROPN-NUM-PUNCT-NUM,compound-nsubj,appos-nummod-punct-nummod,NNP-NNP,"NNP-CD-,-CD",2,1
1,0.0,23,was,13,1,9,8,0,13,12,-4,Asahel Grant,"April 24 , 1844",PER-PER,TIME-TIME-TIME-TIME,PROPN-PROPN,PROPN-NUM-PUNCT-NUM,compound-nsubj,npadvmod-nummod-punct-nummod,NNP-NNP,"NNP-CD-,-CD",2,1
0,0.0,32,is,1,1,18,17,0,13,0,17,Piera,Anoia,LOC,LOC,NOUN,PROPN,nsubj,pobj,NN,NNP,10,1
1,0.0,32,is,1,1,22,21,0,9,0,21,Piera,Spain,LOC,LOC,NOUN,PROPN,nsubj,appos,NN,NNP,3,1
2,0.0,32,is,1,18,20,2,17,11,-17,19,Anoia,Catalonia,LOC,LOC,PROPN,PROPN,pobj,pobj,NNP,NNP,2,1
3,0.0,32,is,1,18,22,4,17,9,-17,21,Anoia,Spain,LOC,LOC,PROPN,PROPN,pobj,appos,NNP,NNP,9,1
4,0.0,32,is,1,20,22,2,19,9,-19,21,Catalonia,Spain,LOC,LOC,PROPN,PROPN,pobj,appos,NNP,NNP,11,1
0,1.0,24,is,1,8,10,2,7,13,-7,9,Victoria,Australia,LOC,LOC,PROPN,PROPN,conj,conj,NNP,NNP,3,1
0,3.0,35,spelled,11,28,30,2,27,4,-17,19,Finnish,Helsingfors,LOC,LOC,ADJ,PROPN,amod,conj,JJ,NNP,2,1
1,3.0,35,spelled,11,28,32,4,27,2,-17,21,Finnish,Helsinki,LOC,LOC,ADJ,PROPN,amod,appos,JJ,NNP,2,1
0,0.0,18,died,8,1,5,4,0,12,7,-3,Hanscarl Leuner,1919,PER-PER,TIME,PROPN-PROPN,NUM,compound-nsubj,npadvmod,NNP-NNP,CD,2,1
1,0.0,18,died,8,1,7,6,0,10,7,-1,Hanscarl Leuner,Bautzen,PER-PER,LOC,PROPN-PROPN,PROPN,compound-nsubj,pobj,NNP-NNP,NNP,2,1
2,0.0,18,died,8,1,10,9,0,7,7,2,Hanscarl Leuner,1996,PER-PER,TIME,PROPN-PROPN,NUM,compound-nsubj,npadvmod,NNP-NNP,CD,2,1
3,0.0,18,died,8,1,12,11,0,5,7,4,Hanscarl Leuner,Göttingen,PER-PER,LOC,PROPN-PROPN,PROPN,compound-nsubj,pobj,NNP-NNP,NNP,2,1
4,0.0,18,died,8,1,16,15,0,1,7,8,Hanscarl Leuner,German,PER-PER,LOC,PROPN-PROPN,ADJ,compound-nsubj,amod,NNP-NNP,JJ,3,1
5,0.0,18,died,8,7,16,9,6,1,1,8,Bautzen,German,LOC,LOC,PROPN,ADJ,pobj,amod,NNP,JJ,3,1
6,0.0,18,died,8,12,16,4,11,1,-4,8,Göttingen,German,LOC,LOC,PROPN,ADJ,pobj,amod,NNP,JJ,3,1
0,1.0,24,was,2,11,19,8,10,4,-9,17,Hepworth,Ben Nicholson,PER,PER-PER,PROPN,PROPN-PROPN,pobj,compound-pobj,NNP,NNP-NNP,3,1
0,4.0,24,is,2,22,10,-12,21,13,-20,8,SoftBank Group,Masayoshi Son,ORG-ORG,PER-PER,PROPN-PROPN,PROPN-PROPN,compound-conj,compound-pobj,NNP-NNP,NNP-NNP,4,1
0,0.0,36,is,11,29,33,4,28,2,-18,22,Paracel Islands,South China Sea,LOC-LOC,LOC-LOC-LOC,PROPN-PROPN,PROPN-PROPN-PROPN,compound-pobj,compound-compound-pobj,NNP-NNPS,NNP-NNP-NNP,3,1
1,1.0,23,occupied,5,18,21,3,17,1,-13,16,Sansha city,Hainan Province,LOC-LOC,LOC-LOC,PROPN-NOUN,PROPN-PROPN,compound-pobj,compound-pobj,NNP-NN,NNP-NNP,2,1
0,0.0,16,is,3,1,12,11,0,3,2,9,World Wide Live,Scorpions,MISC-MISC-MISC,ORG,PROPN-PROPN-PROPN,PROPN,compound-compound-nsubj,pobj,NNP-NNP-NNP,NNPS,6,1
1,0.0,16,is,3,1,15,14,0,0,2,12,World Wide Live,1985,MISC-MISC-MISC,TIME,PROPN-PROPN-PROPN,NUM,compound-compound-nsubj,pobj,NNP-NNP-NNP,CD,3,1
2,5.0,12,Arena,1,1,4,3,0,7,0,3,Sports Arena,San Diego,LOC-LOC,LOC-LOC,PROPN-PROPN,PROPN-PROPN,compound-ROOT,compound-appos,NNPS-NNP,NNP-NNP,1,1
3,7.0,12,Amphitheatre,1,1,7,6,0,4,0,6,Pacific Amphitheatre,CA,LOC-LOC,LOC,PROPN-PROPN,PROPN,compound-ROOT,conj,NNP-NNP,NNP,3,1
4,8.0,8,Bercy,0,1,5,4,0,2,-1,5,Bercy,France,LOC,LOC,PROPN,PROPN,ROOT,conj,NNP,NNP,4,1
5,8.0,8,Bercy,0,3,5,2,2,2,-3,5,Paris,France,LOC,LOC,PROPN,PROPN,conj,conj,NNP,NNP,3,1
6,9.0,9,Sporthalle,0,1,3,2,0,5,-1,3,Sporthalle,Cologne,LOC,LOC,PROPN,PROPN,ROOT,conj,NNP,NNP,3,1
7,9.0,9,Sporthalle,0,3,5,2,2,3,-3,5,Cologne,West Germany,LOC,LOC-LOC,PROPN,PROPN-PROPN,conj,compound-conj,NNP,NNP-NNP,2,1
0,0.0,17,"""",0,2,12,10,1,4,-2,12,"Homer to the Max """,The Simpsons,MISC-MISC-MISC-MISC-MISC,MISC-MISC,NOUN-ADP-DET-PROPN-PUNCT,DET-PROPN,nsubj-prep-det-pobj-punct,det-poss,NN-IN-DT-NNP-'',DT-NNPS,6,1
1,1.0,17,aired,2,6,5,-1,5,11,-4,3,Fox,the United States,ORG,LOC-LOC-LOC,PROPN,DET-PROPN-PROPN,compound,det-compound-pobj,NNP,DT-NNP-NNP,1,1
0,0.0,28,is,8,19,27,8,18,0,-11,19,Andhra Pradesh,India,LOC-LOC,LOC,PROPN-PROPN,PROPN,compound-pobj,pobj,NNP-NNP,NNP,5,1
1,0.0,28,is,8,22,27,5,21,0,-14,19,Telangana,India,LOC,LOC,PROPN,PROPN,conj,pobj,NNP,NNP,7,1
0,0.0,29,made,13,10,12,2,9,16,3,-1,Guinean,Sékou Touré,LOC,PER-PER,ADJ,PROPN-PROPN,amod,compound-appos,JJ,NNP-NNP,1,1
1,0.0,29,made,13,19,25,6,18,3,-6,12,Brazzaville,Republic of the Congo,LOC,LOC-LOC-LOC-LOC,PROPN,PROPN-ADP-DET-PROPN,pobj,pobj-prep-det-pobj,NNP,NNP-IN-DT-NNP,5,1
0,0.0,7,is,2,1,5,4,0,1,1,3,Michael Helm,Canadian,PER-PER,LOC,PROPN-PROPN,ADJ,compound-nsubj,amod,NNP-NNP,JJ,2,1
1,1.0,24,born,2,5,7,2,4,16,-3,5,Eston,Saskatchewan,LOC,LOC,PROPN,PROPN,pobj,conj,NNP,NNP,4,1
2,2.0,22,nominated,11,5,8,3,4,13,6,-3,The Projectionist,1997,MISC-MISC,TIME,DET-PROPN,NUM,det-appos,appos,DT-NNP,CD,1,1
3,3.0,33,novel,2,5,12,7,4,20,-3,10,In the Place of Last Things,2004,MISC-MISC-MISC-MISC-MISC-MISC,TIME,ADP-DET-PROPN-ADP-ADJ-NOUN,NUM,prep-det-pobj-prep-amod-pobj,appos,IN-DT-NNP-IN-JJ-NNS,CD,4,1
4,6.0,14,teaches,2,10,13,3,9,0,-8,11,York University,Toronto,ORG-ORG,LOC,PROPN-PROPN,PROPN,compound-pobj,pobj,NNP-NNP,NNP,5,1
0,0.0,18,was,13,1,4,3,0,13,12,-9,Paul Chaudet,17 November 1904,PER-PER,TIME-TIME-TIME,PROPN-PROPN,NUM-PROPN-NUM,compound-nsubj,nummod-appos-nummod,NNP-NNP,CD-NNP-CD,1,1
1,0.0,18,was,13,1,8,7,0,9,12,-5,Paul Chaudet,Rivaz,PER-PER,LOC,PROPN-PROPN,PROPN,compound-nsubj,compound,NNP-NNP,NNP,2,1
2,0.0,18,was,13,1,10,9,0,7,12,-3,Paul Chaudet,7 August 1977,PER-PER,TIME-TIME-TIME,PROPN-PROPN,NUM-PROPN-NUM,compound-nsubj,nummod-appos-nummod,NNP-NNP,CD-NNP-CD,2,1
0,0.0,34,features,2,1,1,0,0,32,1,-1,Nintendo Land,Nintendo,MISC-MISC,ORG,PROPN-PROPN,PROPN,compound-nsubj,compound,NNP-NNP,NNP,0,1
1,1.0,56,designed,3,10,10,0,9,45,-7,7,Wii Sports,Wii,MISC-MISC,MISC,PROPN-PROPN,PROPN,compound-nsubj,dobj,NNP-NNPS,NNP,0,1
0,0.0,22,Hacker,2,1,5,4,0,16,1,3,Viktor von Hacker,"October 21 , 1852",PER-PER-PER,TIME-TIME-TIME-TIME,PROPN-PROPN-PROPN,PROPN-NUM-PUNCT-NUM,compound-compound-ROOT,appos-nummod-punct-nummod,NNP-NNP-NNP,"NNP-CD-,-CD",3,1
1,0.0,22,Hacker,2,1,10,9,0,11,1,8,Viktor von Hacker,"May 20 , 1933",PER-PER-PER,TIME-TIME-TIME-TIME,PROPN-PROPN-PROPN,PROPN-NUM-PUNCT-NUM,compound-compound-ROOT,nsubj-nummod-punct-nummod,NNP-NNP-NNP,"NNP-CD-,-CD",4,1
2,0.0,22,Hacker,2,1,17,16,0,4,1,15,Viktor von Hacker,Austrian,PER-PER-PER,LOC,PROPN-PROPN-PROPN,ADJ,compound-compound-ROOT,amod,NNP-NNP-NNP,JJ,3,1
3,0.0,22,Hacker,2,1,21,20,0,0,1,19,Viktor von Hacker,Vienna,PER-PER-PER,LOC,PROPN-PROPN-PROPN,PROPN,compound-compound-ROOT,pobj,NNP-NNP-NNP,NNP,3,1
4,1.0,31,received,3,24,27,3,23,3,-21,24,Theodor Billroth,1829,PER-PER,TIME,PROPN-PROPN,NUM,compound-pobj,nummod,NNP-NNP,CD,1,1
5,1.0,31,received,3,24,29,5,23,1,-21,26,Theodor Billroth,1894,PER-PER,TIME,PROPN-PROPN,NUM,compound-pobj,nummod,NNP-NNP,CD,1,1
6,4.0,25,credited,15,6,9,3,5,15,9,-6,Carl Beck,1856,PER-PER,TIME,PROPN-PROPN,NUM,compound-pobj,nummod,NNP-NNP,CD,2,1
7,7.0,48,published,11,3,6,3,2,41,8,-5,Georg Lotheissen,1868,PER-PER,TIME,PROPN-PROPN,NUM,compound-pobj,nummod,NNP-NNP,CD,2,1
8,7.0,48,published,11,3,8,5,2,39,8,-3,Georg Lotheissen,1941,PER-PER,TIME,PROPN-PROPN,NUM,compound-pobj,nummod,NNP-NNP,CD,1,1
0,1.0,49,is,1,6,3,-3,5,45,-5,2,Lowercase Capital,the United States,ORG-ORG,LOC-LOC-LOC,PROPN-PROPN,DET-PROPN-PROPN,compound-pobj,det-compound-pobj,NNP-NNP,DT-NNP-NNP,2,1
0,0.0,12,is,4,1,3,2,0,8,3,-1,Salammbô,1862,MISC,TIME,PROPN,NUM,nsubj,appos,NNP,CD,2,1
1,4.0,71,were,14,12,1,-11,11,69,2,-13,Madame Bovary,Flaubert,MISC-MISC,PER,PROPN-PROPN,PROPN,compound-appos,poss,NNP-NNP,NNP,8,1
0,9.0,13,Anderson,2,1,5,4,0,7,1,3,Carl C. Anderson,1877,PER-PER-PER,TIME,PROPN-PROPN-PROPN,NUM,compound-compound-ROOT,nummod,NNP-NNP-NNP,CD,2,1
1,9.0,13,Anderson,2,1,10,9,0,2,1,8,Carl C. Anderson,U.S.,PER-PER-PER,LOC,PROPN-PROPN-PROPN,PROPN,compound-compound-ROOT,compound,NNP-NNP-NNP,NNP,2,1
2,9.0,13,Anderson,2,1,7,6,0,5,1,5,Carl C. Anderson,1912,PER-PER-PER,TIME,PROPN-PROPN-PROPN,NUM,compound-compound-ROOT,nummod,NNP-NNP-NNP,CD,2,1
3,9.0,13,Anderson,2,10,13,3,9,-1,-8,11,U.S.,Ohio,LOC,LOC,PROPN,PROPN,compound,pobj,NNP,NNP,-1,1
4,10.0,10,Anderson,2,1,5,4,0,4,1,3,Carl David Anderson,1905,PER-PER-PER,TIME,PROPN-PROPN-PROPN,NUM,compound-compound-ROOT,nummod,NNP-NNP-NNP,CD,3,1
5,10.0,10,Anderson,2,1,7,6,0,2,1,5,Carl David Anderson,1991,PER-PER-PER,TIME,PROPN-PROPN-PROPN,NUM,compound-compound-ROOT,nummod,NNP-NNP-NNP,CD,2,1
6,11.0,10,Anderson,2,1,5,4,0,4,1,3,Carl Thomas Anderson,1865,PER-PER-PER,TIME,PROPN-PROPN-PROPN,NUM,compound-compound-ROOT,nummod,NNP-NNP-NNP,CD,3,1
7,11.0,10,Anderson,2,1,7,6,0,2,1,5,Carl Thomas Anderson,1948,PER-PER-PER,TIME,PROPN-PROPN-PROPN,NUM,compound-compound-ROOT,appos,NNP-NNP-NNP,CD,2,1
0,0.0,32,was,5,2,5,3,1,26,3,0,Gordon Riots,1780,MISC-MISC,TIME,PROPN-PROPN,NUM,compound-nsubj,pobj,NNP-NNPS,CD,1,1
1,0.0,32,was,5,2,14,12,1,17,3,9,Gordon Riots,London,MISC-MISC,LOC,PROPN-PROPN,PROPN,compound-nsubj,pobj,NNP-NNPS,NNP,3,1
2,0.0,32,was,5,17,20,3,16,11,-12,15,Papists Act,1778,MISC-MISC,TIME,PROPN-PROPN,NUM,compound-pobj,pobj,NNPS-NNP,CD,1,1
0,0.0,30,is,10,1,17,16,0,12,9,7,Mega Man ZX Advent,Inti Creates,MISC-MISC-MISC-MISC,ORG-ORG,PROPN-PROPN-PROPN-PROPN,PROPN-PROPN,compound-compound-compound-nsubj,compound-pobj,NNP-NNP-NNP-NNP,NNP-NNP,6,1
1,0.0,30,is,10,1,22,21,0,7,9,12,Mega Man ZX Advent,Capcom,MISC-MISC-MISC-MISC,ORG,PROPN-PROPN-PROPN-PROPN,PROPN,compound-compound-compound-nsubj,pobj,NNP-NNP-NNP-NNP,NNP,6,1
2,0.0,30,is,10,1,25,24,0,4,9,15,Mega Man ZX Advent,Nintendo DS,MISC-MISC-MISC-MISC,MISC-MISC,PROPN-PROPN-PROPN-PROPN,PROPN-PROPN,compound-compound-compound-nsubj,compound-compound,NNP-NNP-NNP-NNP,NNP-NNP,8,1
0,0.0,41,is,5,1,39,38,0,1,4,34,The Ox - Bow Incident,Jane Darwell,MISC-MISC-MISC-MISC-MISC,PER-PER,DET-PROPN-PUNCT-PROPN-PROPN,PROPN-PROPN,det-compound-punct-compound-nsubj,compound-conj,DT-NNP-HYPH-NNP-NNP,NNP-NNP,8,1
1,0.0,41,is,5,1,8,7,0,32,4,3,The Ox - Bow Incident,1943,MISC-MISC-MISC-MISC-MISC,TIME,DET-PROPN-PUNCT-PROPN-PROPN,NUM,det-compound-punct-compound-nsubj,nummod,DT-NNP-HYPH-NNP-NNP,CD,4,1
2,0.0,41,is,5,1,14,13,0,26,4,9,The Ox - Bow Incident,William A. Wellman,MISC-MISC-MISC-MISC-MISC,PER-PER-PER,DET-PROPN-PUNCT-PROPN-PROPN,PROPN-PROPN-PROPN,det-compound-punct-compound-nsubj,compound-compound-pobj,DT-NNP-HYPH-NNP-NNP,NNP-NNP-NNP,7,1
3,0.0,41,is,5,1,19,18,0,21,4,14,The Ox - Bow Incident,Henry Fonda,MISC-MISC-MISC-MISC-MISC,PER-PER,DET-PROPN-PUNCT-PROPN-PROPN,PROPN-PROPN,det-compound-punct-compound-nsubj,compound-dobj,DT-NNP-HYPH-NNP-NNP,NNP-NNP,4,1
4,0.0,41,is,5,1,22,21,0,18,4,17,The Ox - Bow Incident,Dana Andrews,MISC-MISC-MISC-MISC-MISC,PER-PER,DET-PROPN-PUNCT-PROPN-PROPN,PROPN-PROPN,det-compound-punct-compound-nsubj,compound-conj,DT-NNP-HYPH-NNP-NNP,NNP-NNP,5,1
5,0.0,41,is,5,1,25,24,0,15,4,20,The Ox - Bow Incident,Mary Beth Hughes,MISC-MISC-MISC-MISC-MISC,PER-PER-PER,DET-PROPN-PUNCT-PROPN-PROPN,PROPN-PROPN-PROPN,det-compound-punct-compound-nsubj,compound-compound-conj,DT-NNP-HYPH-NNP-NNP,NNP-NNP-NNP,7,1
6,0.0,41,is,5,1,30,29,0,10,4,25,The Ox - Bow Incident,Anthony Quinn,MISC-MISC-MISC-MISC-MISC,PER-PER,DET-PROPN-PUNCT-PROPN-PROPN,PROPN-PROPN,det-compound-punct-compound-nsubj,compound-pobj,DT-NNP-HYPH-NNP-NNP,NNP-NNP,5,1
7,0.0,41,is,5,1,14,13,0,26,4,9,The Ox - Bow Incident,William Eythe,MISC-MISC-MISC-MISC-MISC,PER-PER,DET-PROPN-PUNCT-PROPN-PROPN,PROPN-PROPN,det-compound-punct-compound-nsubj,compound-conj,DT-NNP-HYPH-NNP-NNP,NNP-NNP,7,1
8,0.0,41,is,5,1,36,35,0,4,4,31,The Ox - Bow Incident,Harry Morgan,MISC-MISC-MISC-MISC-MISC,PER-PER,DET-PROPN-PUNCT-PROPN-PROPN,PROPN-PROPN,det-compound-punct-compound-nsubj,compound-conj,DT-NNP-HYPH-NNP-NNP,NNP-NNP,7,1
0,0.0,43,was,11,2,6,4,1,36,9,-5,Thomas A. McLaughlin,1896,PER-PER-PER,TIME,PROPN-PROPN-PROPN,NUM,compound-compound-nsubj,nummod,NNP-NNP-NNP,CD,4,1
1,2.0,11,studied,1,1,4,3,0,6,0,3,McLaughlin,University College Dublin,PER,ORG-ORG-ORG,PROPN,PROPN-PROPN-PROPN,nsubj,compound-compound-pobj,NNP,NNP-NNP-NNP,3,1
2,2.0,11,studied,1,1,4,3,0,6,0,3,McLaughlin,University College Galway,PER,ORG-ORG-ORG,PROPN,PROPN-PROPN-PROPN,nsubj,compound-compound-conj,NNP,NNP-NNP-NNP,3,1
3,4.0,20,impressed,2,9,14,5,8,5,-7,12,Pomerania,Germany,LOC,LOC,PROPN,PROPN,dobj,pobj,NNP,NNP,3,1
0,0.0,24,was,19,1,4,3,0,19,18,-15,Julius Strasburger,26 December 1871,PER-PER,TIME-TIME-TIME,PROPN-PROPN,NUM-PROPN-NUM,compound-nsubj,nummod-appos-nummod,NNP-NNP,CD-NNP-CD,1,1
1,0.0,24,was,19,1,9,8,0,14,18,-10,Julius Strasburger,Jena,PER-PER,LOC,PROPN-PROPN,PROPN,compound-nsubj,compound,NNP-NNP,NNP,3,1
2,0.0,24,was,19,1,11,10,0,12,18,-8,Julius Strasburger,28 October 1934,PER-PER,TIME-TIME-TIME,PROPN-PROPN,NUM-PROPN-NUM,compound-nsubj,nummod-appos-nummod,NNP-NNP,CD-NNP-CD,3,1
3,0.0,24,was,19,1,16,15,0,7,18,-3,Julius Strasburger,Frankfurt am Main,PER-PER,LOC-LOC-LOC,PROPN-PROPN,PROPN-VERB-PROPN,compound-nsubj,pobj-ccomp-acomp,NNP-NNP,NNP-VBP-NNP,3,1
4,1.0,14,was,1,7,10,3,6,3,-6,9,Eduard Strasburger,1844,PER-PER,TIME,PROPN-PROPN,NUM,compound-pobj,nummod,NNP-NNP,CD,4,1
5,1.0,14,was,1,7,12,5,6,1,-6,11,Eduard Strasburger,1912,PER-PER,TIME,PROPN-PROPN,NUM,compound-pobj,nummod,NNP-NNP,CD,4,1
6,3.0,34,served,4,10,18,8,9,15,-6,14,Carl Gerhardt,Berlin,PER-PER,LOC,PROPN-PROPN,PROPN,compound-pobj,pobj,NNP-NNP,NNP,5,1
7,7.0,38,named,18,3,6,3,2,31,15,-12,Adolf Schmidt,1865,PER-PER,TIME,PROPN-PROPN,NUM,compound-pobj,nummod,NNP-NNP,CD,2,1
0,9.0,31,attacked,15,10,14,4,9,16,5,-1,German war cemetery,Oslo,LOC-LOC-LOC,LOC,ADJ-NOUN-NOUN,PROPN,amod-compound-pobj,pobj,JJ-NN-NN,NNP,5,1
0,0.0,13,is,2,1,9,8,0,3,1,7,Comanche County,U.S.,LOC-LOC,LOC,PROPN-PROPN,PROPN,compound-nsubj,compound,NNP-NNP,NNP,5,1
1,0.0,13,is,2,1,12,11,0,0,1,10,Comanche County,Oklahoma,LOC-LOC,LOC,PROPN-PROPN,PROPN,compound-nsubj,pobj,NNP-NNP,NNP,2,1
2,0.0,13,is,2,9,12,3,8,0,-7,10,U.S.,Oklahoma,LOC,LOC,PROPN,PROPN,compound,pobj,NNP,NNP,5,1
3,6.0,31,was,19,8,15,7,7,15,11,-4,Comanche County,Indian Territory,LOC-LOC,LOC-LOC,PROPN-PROPN,PROPN-PROPN,compound-nsubj,compound-pobj,NNP-NNP,NNP-NNP,5,1
0,0.0,42,is,22,1,31,30,0,10,21,9,Jungle Strike,Electronic Arts,MISC-MISC,ORG-ORG,PROPN-PROPN,PROPN-PROPN,compound-nsubj,compound-pobj,NNP-NNP,NNP-NNPS,6,1
1,0.0,42,is,22,1,34,33,0,7,21,12,Jungle Strike,1993,MISC-MISC,TIME,PROPN-PROPN,NUM,compound-nsubj,pobj,NNP-NNP,CD,5,1
2,0.0,42,is,22,1,37,36,0,4,21,15,Jungle Strike,Sega Genesis / Mega Drive,MISC-MISC,MISC-MISC-MISC-MISC-MISC,PROPN-PROPN,PROPN-PROPN-SYM-PROPN-PROPN,compound-nsubj,nmod-nmod-punct-compound-pobj,NNP-NNP,NNP-NNP-SYM-NNP-NNP,7,1
3,0.0,42,is,22,6,31,25,5,10,16,9,The Sequel to Desert Strike,Electronic Arts,MISC-MISC-MISC-MISC-MISC,ORG-ORG,DET-PROPN-ADP-PROPN-PROPN,PROPN-PROPN,det-appos-prep-compound-pobj,compound-pobj,DT-NNP-IN-NNP-NNP,NNP-NNPS,8,1
4,0.0,42,is,22,6,37,31,5,4,16,15,The Sequel to Desert Strike,Sega Genesis / Mega Drive,MISC-MISC-MISC-MISC-MISC,MISC-MISC-MISC-MISC-MISC,DET-PROPN-ADP-PROPN-PROPN,PROPN-PROPN-SYM-PROPN-PROPN,det-appos-prep-compound-pobj,nmod-nmod-punct-compound-pobj,DT-NNP-IN-NNP-NNP,NNP-NNP-SYM-NNP-NNP,9,1
5,0.0,42,is,22,9,31,22,8,10,13,9,Desert Strike part II,Electronic Arts,MISC-MISC-MISC-MISC,ORG-ORG,PROPN-PROPN-NOUN-PROPN,PROPN-PROPN,compound-conj-nsubj-dobj,compound-pobj,NNP-NNP-NN-NNP,NNP-NNPS,10,1
6,0.0,42,is,22,9,34,25,8,7,13,12,Desert Strike part II,1993,MISC-MISC-MISC-MISC,TIME,PROPN-PROPN-NOUN-PROPN,NUM,compound-conj-nsubj-dobj,pobj,NNP-NNP-NN-NNP,CD,9,1
0,1.0,29,found,2,15,19,4,14,9,-13,17,South America,Colombia,LOC-LOC,LOC,PROPN-PROPN,PROPN,compound-pobj,pobj,NNP-NNP,NNP,6,1
1,1.0,29,found,2,15,21,6,14,7,-13,19,South America,Uruguay,LOC-LOC,LOC,PROPN-PROPN,PROPN,compound-pobj,pobj,NNP-NNP,NNP,7,1
0,1.0,23,composed,4,10,13,3,9,9,-6,9,U.S,Oregon,LOC,LOC,PROPN,PROPN,compound,pobj,NNP,NNP,3,1
1,1.0,23,composed,4,10,15,5,9,7,-6,11,U.S,Washington,LOC,LOC,PROPN,PROPN,compound,conj,NNP,NNP,4,1
2,1.0,23,composed,4,18,21,3,17,1,-14,17,Canadian,British Columbia,LOC,LOC-LOC,ADJ,PROPN-PROPN,amod,compound-pobj,JJ,NNP-NNP,2,1
0,0.0,44,is,3,21,24,3,20,19,-18,21,Saraswathi Gora,1912,PER-PER,TIME,PROPN-PROPN,NUM,compound-conj,nummod,NNP-NNP,CD,2,1
1,0.0,44,is,3,21,26,5,20,17,-18,23,Saraswathi Gora,2006,PER-PER,TIME,PROPN-PROPN,NUM,compound-conj,nummod,NNP-NNP,CD,1,1
2,0.0,44,is,3,21,43,22,20,0,-18,40,Saraswathi Gora,Atheism,PER-PER,MISC,PROPN-PROPN,PROPN,compound-conj,conj,NNP-NNP,NNP,7,1
3,1.0,24,shifted,18,5,14,9,4,9,13,-4,Mudnur,India,LOC,LOC,PROPN,PROPN,compound,nsubjpass,NNP,NNP,6,1
4,1.0,24,shifted,18,8,14,6,7,9,10,-4,Krishna,India,LOC,LOC,PROPN,PROPN,compound,nsubjpass,NNP,NNP,8,1
5,5.0,22,is,4,1,12,11,0,9,3,8,Gora,Lavanam,PER,PER,PROPN,PROPN,poss,nsubj,NNP,NNP,6,1
0,0.0,15,is,7,1,10,9,0,4,6,3,Princessa,Spanish,PER,LOC,PROPN,ADJ,nsubj,amod,NNP,JJ,6,1
0,0.0,50,priest,1,43,46,3,42,3,-42,45,Second Temple,Jerusalem,LOC-LOC,LOC,PROPN-PROPN,PROPN,compound-pobj,pobj,NNP-NNP,NNP,3,1
1,3.0,48,belonged,3,17,27,10,16,20,-14,24,Aaron,Hebrew Bible,PER,MISC-MISC,PROPN,PROPN-PROPN,pobj,compound-pobj,NNP,NNP-NNP,4,1
2,3.0,48,belonged,3,17,33,16,16,14,-14,30,Aaron,Moses,PER,PER,PROPN,PROPN,pobj,pobj,NNP,NNP,5,1
0,0.0,20,is,11,1,10,9,0,9,10,-1,Ondřej Polívka,Prague,PER-PER,LOC,PROPN-PROPN,PROPN,compound-nsubj,pobj,NNP-NNP,NNP,1,1
1,0.0,20,is,11,1,18,17,0,1,10,7,Ondřej Polívka,Czech Republic,PER-PER,LOC-LOC,PROPN-PROPN,PROPN-PROPN,compound-nsubj,compound-pobj,NNP-NNP,NNP-NNP,4,1
2,1.0,42,competed,1,5,9,4,4,32,-4,8,2012 Summer Olympics,London,MISC-MISC-MISC,LOC,NUM-PROPN-PROPN,PROPN,nummod-compound-pobj,pobj,CD-NNP-NNPS,NNP,4,1
3,1.0,42,competed,1,9,11,2,8,30,-8,10,London,England,LOC,LOC,PROPN,PROPN,pobj,appos,NNP,NNP,6,1
0,4.0,24,interviewed,22,1,4,3,0,19,21,-18,Juliane Lorenz,Fassbinder,PER-PER,PER,PROPN-PROPN,PROPN,compound-nsubjpass,compound,NNP-NNP,NNP,3,1
1,5.0,21,talks,13,10,1,-9,9,19,3,-12,Ingrid Caven,Fassbinder,PER-PER,PER,PROPN-PROPN,PROPN,compound-conj,nmod,NNP-NNP,NNP,4,1
0,0.0,15,is,10,1,7,6,0,7,9,-3,Russell Boyd,21 April 1944,PER-PER,TIME-TIME-TIME,PROPN-PROPN,NUM-PROPN-NUM,compound-compound,nummod-npadvmod-nummod,NNP-NNP,CD-NNP-CD,3,1
1,1.0,28,rose,1,11,16,5,10,11,-10,15,Picnic at Hanging Rock,1975,MISC-MISC-MISC-MISC,TIME,PROPN-ADP-VERB-PROPN,NUM,pobj-prep-compound-pobj,appos,NNP-IN-VBG-NNP,CD,2,1
2,3.0,21,served,1,6,10,4,5,10,-5,9,Tender Mercies,1983,MISC-MISC,TIME,PROPN-PROPN,NUM,compound-pobj,nummod,NNP-NNP,CD,1,1
0,0.0,42,is,14,37,40,3,36,1,-23,26,Susi,1963,PER,TIME,PROPN,NUM,conj,npadvmod,NNP,CD,3,1
1,3.0,33,were,19,32,16,-16,31,16,-13,-3,Eurovision,Son de Sol,MISC,ORG-ORG-ORG,PROPN,PROPN-PROPN-PROPN,pobj,compound-compound-appos,NNP,NNP-NNP-NNP,4,1
2,3.0,33,were,19,16,30,14,15,2,3,11,Son de Sol,Spain,ORG-ORG-ORG,LOC,PROPN-PROPN-PROPN,PROPN,compound-compound-appos,dobj,NNP-NNP-NNP,NNP,6,1
0,5.0,26,moved,16,5,9,4,4,16,11,-7,Latin Quarter,Paris,LOC-LOC,LOC,PROPN-PROPN,PROPN,compound-pobj,pobj,NNP-NNP,NNP,4,1
1,7.0,22,is,1,7,17,10,6,4,-6,16,ParisTech,Paris,ORG,LOC,PROPN,PROPN,pobj,compound,NNP,NNP,6,1
0,0.0,29,Simitko,1,23,24,1,22,4,-22,23,Kurdish,Iranian,LOC,LOC,ADJ,ADJ,amod,amod,JJ,JJ,2,1
1,2.0,19,born,2,13,8,-5,12,10,-11,6,Iran,West Azarbaijan,LOC,LOC-LOC,PROPN,PROPN-PROPN,pobj,compound-compound,NNP,NNP-NNP,5,1
0,1.0,14,registered,3,2,11,9,1,2,1,8,Bank,Karachi,ORG,LOC,PROPN,PROPN,nsubjpass,pobj,NNP,NNP,6,1
1,1.0,14,registered,3,2,13,11,1,0,1,10,Bank,London,ORG,LOC,PROPN,PROPN,nsubjpass,conj,NNP,NNP,2,1
0,0.0,63,was,47,1,5,4,0,57,46,-42,Friedrich von Duhn,17 April 1851,PER-PER-PER,TIME-TIME-TIME,PROPN-PROPN-PROPN,NUM-PROPN-NUM,compound-compound-nsubj,nummod-appos-nummod,NNP-NNP-NNP,CD-NNP-CD,2,1
1,0.0,63,was,47,1,9,8,0,53,46,-38,Friedrich von Duhn,Lübeck,PER-PER-PER,LOC,PROPN-PROPN-PROPN,PROPN,compound-compound-nsubj,compound,NNP-NNP-NNP,NNP,2,1
2,0.0,63,was,47,1,11,10,0,51,46,-36,Friedrich von Duhn,5 February 1930,PER-PER-PER,TIME-TIME-TIME,PROPN-PROPN-PROPN,NUM-PROPN-NUM,compound-compound-nsubj,nummod-appos-nummod,NNP-NNP-NNP,CD-NNP-CD,2,1
3,0.0,63,was,47,1,15,14,0,47,46,-32,Friedrich von Duhn,Heidelberg,PER-PER-PER,LOC,PROPN-PROPN-PROPN,PROPN,compound-compound-nsubj,pobj,NNP-NNP-NNP,NNP,2,1
0,0.0,14,was,9,1,6,5,0,7,8,-3,Edward Kilenyi,1910,PER-PER,TIME,PROPN-PROPN,NUM,compound-nsubj,nummod,NNP-NNP,CD,3,1
1,0.0,14,was,9,1,8,7,0,5,8,-1,Edward Kilenyi,2000,PER-PER,TIME,PROPN-PROPN,NUM,compound-nsubj,nummod,NNP-NNP,CD,2,1
2,2.0,27,studied,3,1,16,15,0,10,2,13,Kilenyi,Franz Liszt Academy of Music,PER,ORG-ORG-ORG-ORG-ORG,PROPN,PROPN-PROPN-PROPN-ADP-PROPN,npadvmod,compound-compound-pobj-prep-pobj,NNP,NNP-NNP-NNP-IN-NNP,5,1
3,2.0,27,studied,3,12,16,4,11,10,-9,13,Ernő Dohnányi,Franz Liszt Academy of Music,PER-PER,ORG-ORG-ORG-ORG-ORG,PROPN-PROPN,PROPN-PROPN-PROPN-ADP-PROPN,compound-pobj,compound-compound-pobj-prep-pobj,NNP-NNP,NNP-NNP-NNP-IN-NNP,5,1
4,3.0,26,became,2,9,13,4,8,12,-7,11,Florida State University,Tallahassee,ORG-ORG-ORG,LOC,PROPN-PROPN-PROPN,PROPN,compound-compound-pobj,pobj,NNP-NNP-NNP,NNP,4,1
0,0.0,22,is,3,1,14,13,0,7,2,11,Chalmette High School,St. Bernard Parish,ORG-ORG-ORG,LOC-LOC-LOC,PROPN-PROPN-PROPN,PROPN-PROPN-PROPN,compound-compound-nsubj,compound-compound-pobj,NNP-NNP-NNP,NNP-NNP-NNP,8,1
1,0.0,22,is,3,1,20,19,0,1,2,17,Chalmette High School,United States,ORG-ORG-ORG,LOC-LOC,PROPN-PROPN-PROPN,PROPN-PROPN,compound-compound-nsubj,compound-appos,NNP-NNP-NNP,NNP-NNP,9,1
2,0.0,22,is,3,1,14,13,0,7,2,11,Chalmette area,St. Bernard Parish,LOC-LOC,LOC-LOC-LOC,PROPN-NOUN,PROPN-PROPN-PROPN,compound-pobj,compound-compound-pobj,NNP-NN,NNP-NNP-NNP,8,1
3,0.0,22,is,3,1,20,19,0,1,2,17,Chalmette area,United States,LOC-LOC,LOC-LOC,PROPN-NOUN,PROPN-PROPN,compound-pobj,compound-appos,NNP-NN,NNP-NNP,9,1
4,2.0,22,opened,3,1,6,5,0,15,2,3,Chalmette High School,1954,ORG-ORG-ORG,TIME,PROPN-PROPN-PROPN,NUM,compound-compound-nsubj,pobj,NNP-NNP-NNP,CD,3,1
0,0.0,30,was,14,1,5,4,0,24,13,-9,Joseph Matthäus Aigner,18 January 1818,PER-PER-PER,TIME-TIME-TIME,PROPN-PROPN-PROPN,NUM-PROPN-NUM,compound-compound-nsubj,nummod-appos-nummod,NNP-NNP-NNP,CD-NNP-CD,2,1
1,0.0,30,was,14,1,10,9,0,19,13,-4,Joseph Matthäus Aigner,February 1886,PER-PER-PER,TIME-TIME,PROPN-PROPN-PROPN,PROPN-NUM,compound-compound-nsubj,appos-nummod,NNP-NNP-NNP,NNP-CD,3,1
2,0.0,30,was,14,1,17,16,0,12,13,3,Joseph Matthäus Aigner,Austrian,PER-PER-PER,LOC,PROPN-PROPN-PROPN,ADJ,compound-compound-nsubj,amod,NNP-NNP-NNP,JJ,4,1
3,1.0,29,painted,1,25,28,3,24,0,-24,27,Maximilian I,Mexico,PER-PER,LOC,PROPN-PRON,PROPN,compound-conj,pobj,NNP-PRP,NNP,9,1
4,1.0,29,painted,1,5,13,8,4,15,-4,12,Franz Joseph I,Elizabeth,PER-PER-PER,PER,PROPN-PROPN-PRON,PROPN,compound-pobj-ROOT,appos,NNP-NNP-PRP,NNP,3,1
5,2.0,13,married,3,6,9,3,5,3,-3,6,Fanny Matras,1828,PER-PER,TIME,PROPN-PROPN,NUM,compound-dobj,nummod,NNP-NNP,CD,2,1
0,0.0,23,is,6,1,5,4,0,17,5,-1,Daan Forest Park,Da'an District,LOC-LOC-LOC,LOC-LOC,PROPN-PROPN-PROPN,PROPN-PROPN,compound-compound-nsubj,compound-pobj,NNP-NNP-NNP,NNP-NNP,2,1
1,0.0,23,is,6,5,20,15,4,2,1,14,Da'an District,Taipei,LOC-LOC,LOC,PROPN-PROPN,PROPN,compound-pobj,pobj,NNP-NNP,NNP,9,1
2,0.0,23,is,6,5,22,17,4,0,1,16,Da'an District,Taiwan,LOC-LOC,LOC,PROPN-PROPN,PROPN,compound-pobj,appos,NNP-NNP,NNP,3,1
3,0.0,23,is,6,20,22,2,19,0,-14,16,Taipei,Taiwan,LOC,LOC,PROPN,PROPN,pobj,appos,NNP,NNP,8,1
0,0.0,27,is,8,1,5,4,0,21,7,-3,Stuart O'Grady,6 August 1973,PER-PER,TIME-TIME-TIME,PROPN-PROPN,NUM-PROPN-NUM,compound-nsubj,nummod-npadvmod-nummod,NNP-NNP,CD-NNP-CD,2,1
1,6.0,67,removed,4,47,55,8,46,11,-43,51,Joop Zoetemelk,Tours de France,PER-PER,MISC-MISC-MISC,PROPN-PROPN,PROPN-PROPN-PROPN,compound-nsubj,compound-compound-pobj,NNP-NNP,NNP-NNP-NNP,5,1
0,2.0,18,returned,1,6,15,9,5,2,-5,14,The Road to Here,Equity Music Group,MISC-MISC-MISC-MISC,ORG-ORG-ORG,DET-PROPN-ADP-ADV,PROPN-PROPN-PROPN,det-pobj-prep-pobj,compound-compound-pobj,DT-NNP-IN-RB,NNP-NNP-NNP,4,1
1,2.0,18,returned,1,6,4,-2,5,13,-5,3,The Road to Here,2005,MISC-MISC-MISC-MISC,TIME,DET-PROPN-ADP-ADV,NUM,det-pobj-prep-pobj,pobj,DT-NNP-IN-RB,CD,1,1
2,6.0,35,scored,6,4,32,28,3,2,2,26,Little White Church,The Reason Why,MISC-MISC-MISC,MISC-MISC-MISC,PROPN-PROPN-PROPN,DET-PROPN-ADV,compound-compound-pobj,det-appos-advmod,NNP-NNP-NNP,DT-NNP-WRB,8,1
0,0.0,30,is,12,10,29,19,9,0,2,17,Gardermoen Station,Norway,LOC-LOC,LOC,PROPN-PROPN,PROPN,compound-pobj,pobj,NNP-NNP,NNP,5,1
1,0.0,30,is,12,10,29,19,9,0,2,17,Gardermoen,Norway,LOC,LOC,PROPN,PROPN,appos,pobj,NNP,NNP,5,1
0,1.0,49,occurs,3,17,46,29,16,2,-14,43,Mascarene Islands,Indian Ocean,LOC-LOC,LOC-LOC,PROPN-PROPN,PROPN-PROPN,compound-pobj,compound-compound,NNP-NNPS,NNP-NNP,11,1
1,1.0,49,occurs,3,8,46,38,7,2,-5,43,Réunion,Indian Ocean,LOC,LOC-LOC,PROPN,PROPN-PROPN,conj,compound-compound,NNP,NNP-NNP,8,1
0,0.0,9,is,3,2,8,6,1,0,1,5,Negri River,Australia,LOC-LOC,LOC,PROPN-PROPN,PROPN,compound-nsubj,pobj,NNP-NNP,NNP,2,1
0,0.0,36,is,7,2,35,33,1,0,5,28,National Film Award for Best Choreography,India,MISC-MISC-MISC-MISC-MISC-MISC,LOC,PROPN-PROPN-PROPN-ADP-PROPN-PROPN,PROPN,compound-compound-nsubj-prep-compound-pobj,pobj,NNP-NNP-NNP-IN-NNP-NNP,NNP,3,1
1,0.0,36,is,7,2,35,33,1,0,5,28,National Film Awards,India,MISC-MISC-MISC,LOC,PROPN-PROPN-PROPN,PROPN,compound-compound-pobj,pobj,NNP-NNP-NNPS,NNP,3,1
2,0.0,36,is,7,19,35,16,18,0,-12,28,Directorate of Film Festivals,India,ORG-ORG-ORG-ORG,LOC,PROPN-ADP-PROPN-PROPN,PROPN,pobj-prep-compound-pobj,pobj,NNP-IN-NNP-NNPS,NNP,8,1
0,0.0,24,was,3,1,13,12,0,10,2,10,The Out Crowd,Matt Hollywood,ORG-ORG-ORG,PER-PER,DET-PROPN-PROPN,PROPN-PROPN,det-amod-nsubj,compound-dobj,DT-NNP-NNP,NNP-NNP,5,1
1,0.0,24,was,3,13,1,-12,12,22,-10,-2,Matt Hollywood,The Brian Jonestown Massacre,PER-PER,ORG-ORG-ORG-ORG,PROPN-PROPN,DET-PROPN-PROPN-PROPN,compound-dobj,det-compound-compound-pobj,NNP-NNP,DT-NNP-NNP-NNP,5,1
2,1.0,29,formed,1,27,9,-18,26,19,-26,8,Sarah Jane,Portland,PER-PER,LOC,PROPN-PROPN,PROPN,compound-conj,pobj,NNP-NNP,NNP,7,1
3,7.0,40,joined,26,25,28,3,24,11,1,2,Sarah Jane,Portland,PER-PER,LOC,PROPN-PROPN,PROPN,compound-nsubj,compound,NNP-NNP,NNP,8,1
4,4.0,33,Saw,2,1,11,10,0,21,1,9,Then I Saw The Holy City,Brian Coates,MISC-MISC-MISC-MISC-MISC-MISC,PER-PER,ADV-PRON-VERB-DET-PROPN-PROPN,PROPN-PROPN,advmod-nsubj-ROOT-det-compound-nsubjpass,compound-pobj,RB-PRP-VBD-DT-NNP-NNP,NNP-NNP,4,1
5,7.0,40,joined,26,21,28,7,20,11,5,2,The Upsidedown,Portland,ORG-ORG,LOC,DET-PROPN,PROPN,det-appos,compound,DT-NNP,NNP,8,1
0,0.0,17,is,4,1,10,9,0,6,3,6,Fatehpur Sikri,Agra District,LOC-LOC,LOC-LOC,PROPN-PROPN,PROPN-PROPN,compound-nsubj,compound-pobj,NNP-NNP,NNP-NNP,4,1
1,0.0,17,is,4,1,13,12,0,3,3,9,Fatehpur Sikri,Uttar Pradesh,LOC-LOC,LOC-LOC,PROPN-PROPN,PROPN-PROPN,compound-nsubj,compound-pobj,NNP-NNP,NNP-NNP,6,1
2,0.0,17,is,4,1,16,15,0,0,3,12,Fatehpur Sikri,India,LOC-LOC,LOC,PROPN-PROPN,PROPN,compound-nsubj,appos,NNP-NNP,NNP,2,1
3,0.0,17,is,4,10,13,3,9,3,-6,9,Agra District,Uttar Pradesh,LOC-LOC,LOC-LOC,PROPN-PROPN,PROPN-PROPN,compound-pobj,compound-pobj,NNP-NNP,NNP-NNP,2,1
4,0.0,17,is,4,10,16,6,9,0,-6,12,Agra District,India,LOC-LOC,LOC,PROPN-PROPN,PROPN,compound-pobj,appos,NNP-NNP,NNP,4,1
5,0.0,17,is,4,13,16,3,12,0,-9,12,Uttar Pradesh,India,LOC-LOC,LOC,PROPN-PROPN,PROPN,compound-pobj,appos,NNP-NNP,NNP,6,1
6,7.0,33,born,5,4,13,9,3,19,1,8,Jahangir,1569,PER,TIME,PROPN,NUM,appos,pobj,NNP,CD,2,1
0,0.0,12,is,2,1,9,8,0,2,1,7,Pressure Chief,American,MISC-MISC,LOC,NOUN-PROPN,ADJ,compound-nsubj,amod,NN-NNP,JJ,5,1
1,0.0,12,is,2,1,11,10,0,0,1,9,Pressure Chief,Cake,MISC-MISC,ORG,NOUN-PROPN,PROPN,compound-nsubj,pobj,NN-NNP,NNP,2,1
2,7.0,29,Hang,5,4,12,8,3,16,1,7,She 'll Hang the Baskets,Tougher Than It Is,MISC-MISC-MISC-MISC-MISC,MISC-MISC-MISC-MISC,PRON-VERB-VERB-DET-NOUN,ADJ-ADP-PRON-VERB,nsubj-aux-ROOT-det-dobj,conj-mark-nsubj-auxpass,PRP-MD-VB-DT-NNS,JJR-IN-PRP-VBZ,4,1
3,7.0,29,Hang,5,12,22,10,11,6,-7,17,Tougher Than It Is,Cake,MISC-MISC-MISC-MISC,ORG,ADJ-ADP-PRON-VERB,PROPN,conj-mark-nsubj-auxpass,poss,JJR-IN-PRP-VBZ,NNP,9,1
4,7.0,29,Hang,5,26,22,-4,25,6,-21,17,Prolonging the Magic,Cake,MISC-MISC-MISC,ORG,PROPN-DET-PROPN,PROPN,advcl-det-dobj,poss,NNP-DT-NNP,NNP,5,1
0,0.0,17,is,10,1,5,4,0,11,9,-5,Jaak Jõerüüt,9 December 1947,PER-PER,TIME-TIME-TIME,PROPN-PROPN,NUM-PROPN-NUM,compound-nsubj,nummod-npadvmod-nummod,NNP-NNP,CD-NNP-CD,2,1
1,0.0,17,is,10,1,9,8,0,7,9,-1,Jaak Jõerüüt,Tallinn,PER-PER,LOC,PROPN-PROPN,PROPN,compound-nsubj,pobj,NNP-NNP,NNP,1,1
2,9.0,14,served,2,1,10,9,0,3,1,8,Jõerüüt,United Nations,PER,ORG-ORG,PROPN,PROPN-PROPN,nsubj,compound-pobj,NNP,NNP-NNP,5,1
0,4.0,20,joined,11,1,7,6,0,12,10,-4,Godchaux,Donna Jean Godchaux,PER,PER-PER-PER,PROPN,PROPN-PROPN-PROPN,poss,compound-compound-dobj,NNP,NNP-NNP-NNP,5,1
0,0.0,26,was,19,1,22,21,0,3,18,3,Set Them Free,American,MISC-MISC-MISC,LOC,VERB-PRON-PROPN,ADJ,csubj-dobj-oprd,amod,VB-PRP-NNP,JJ,5,1
1,0.0,26,was,19,12,22,10,11,3,7,3,Kentucky,American,LOC,LOC,PROPN,ADJ,pobj,amod,NNP,JJ,4,1
0,0.0,26,is,3,2,18,16,1,7,1,15,Dragonstone,Game of Thrones,MISC,MISC-MISC-MISC,PROPN,PROPN-ADP-PROPN,nsubj,appos-prep-pobj,NNP,NNP-IN-NNP,8,1
0,0.0,13,is,3,1,9,8,0,3,2,6,Stranmillis,Belfast,LOC,LOC,PROPN,PROPN,nsubj,pobj,NNP,NNP,5,1
0,8.0,26,sent,3,3,15,12,2,10,0,12,Yaropolk,Vladimir,PER,PER,PROPN,PROPN,nsubj,appos,NNP,NNP,4,1
0,2.0,27,made,1,10,12,2,9,14,-9,11,Palunku,2006,MISC,TIME,PROPN,NUM,pobj,appos,NNP,CD,6,1
0,0.0,13,is,2,1,9,8,0,3,1,7,Worcester County,U.S.,LOC-LOC,LOC,PROPN-PROPN,PROPN,compound-nsubj,compound,NNP-NNP,NNP,4,1
1,0.0,13,is,2,1,12,11,0,0,1,10,Worcester County,Maryland,LOC-LOC,LOC,PROPN-PROPN,PROPN,compound-nsubj,pobj,NNP-NNP,NNP,2,1
2,0.0,13,is,2,9,12,3,8,0,-7,10,U.S.,Maryland,LOC,LOC,PROPN,PROPN,compound,pobj,NNP,NNP,4,1
3,6.0,50,includes,2,43,47,4,42,2,-41,45,Assateague Island,Atlantic Ocean,LOC-LOC,LOC-LOC,PROPN-PROPN,PROPN-PROPN,compound-conj,compound-compound,NNP-NNP,NNP-NNP,10,1
0,0.0,30,is,12,16,28,12,15,1,-4,16,MyNetworkTV,United States,ORG,LOC-LOC,NOUN,PROPN-PROPN,npadvmod,compound-appos,NN,NNP-NNP,6,1
1,0.0,30,is,12,23,28,5,22,1,-11,16,St. George,United States,LOC-LOC,LOC-LOC,PROPN-PROPN,PROPN-PROPN,compound-pobj,compound-appos,NNP-NNP,NNP-NNP,1,1
2,0.0,30,is,12,26,28,2,25,1,-14,16,Utah,United States,LOC,LOC-LOC,PROPN,PROPN-PROPN,appos,compound-appos,NNP,NNP-NNP,2,1
3,4.0,23,Building,1,4,20,16,3,2,-3,19,East St. George Boulevard,Utah,LOC-LOC-LOC-LOC,LOC,PROPN-PROPN-PROPN-PROPN,PROPN,compound-compound-compound-pobj,compound,NNP-NNP-NNP-NNP,NNP,9,1
4,5.0,120,relays,90,66,70,4,65,49,24,-20,Farnsworth Peak,Oquirrh Mountains,LOC-LOC,LOC-LOC,PROPN-PROPN,PROPN-PROPN,compound-pobj,compound-pobj,NNP-NNP,NNP-NNPS,4,1
0,0.0,26,is,6,1,23,22,0,2,5,17,Faurot Field,University of Missouri,LOC-LOC,ORG-ORG-ORG,PROPN-PROPN,PROPN-ADP-PROPN,compound-nsubj,pobj-prep-pobj,NNP-NNP,NNP-IN-NNP,7,1
1,2.0,24,is,1,19,22,3,18,1,-18,21,Arrowhead Stadium,Kansas City,LOC-LOC,LOC-LOC,PROPN-PROPN,PROPN-PROPN,compound-pobj,compound-pobj,NNP-NNP,NNP-NNP,2,1
0,0.0,40,is,3,8,11,3,7,28,-5,8,Delaware County,New York,LOC-LOC,LOC-LOC,PROPN-PROPN,PROPN-PROPN,compound-pobj,compound-appos,NNP-NNP,NNP-NNP,1,1
1,1.0,21,is,1,6,19,13,5,1,-5,18,New York City 's,Delaware Watershed,LOC-LOC-LOC-LOC,LOC-LOC,PROPN-PROPN-PROPN-PART,PROPN-PROPN,compound-compound-poss-case,compound-pobj,NNP-NNP-NNP-POS,NNP-NNP,10,1
0,0.0,55,is,2,51,54,3,50,0,-49,52,Berlin Wall,1989,LOC-LOC,TIME,PROPN-PROPN,NUM,compound-pobj,pobj,NNP-NNP,CD,13,1
1,3.0,33,had,2,1,31,30,0,1,1,29,Atomic Blonde,Focus Features,MISC-MISC,ORG-ORG,PROPN-PROPN,PROPN-PROPN,compound-nsubj,compound-pobj,NNP-NNP,NNP-NNP,4,1
0,0.0,35,was,17,14,16,2,13,18,3,-1,Göttingen,Germany,LOC,LOC,PROPN,PROPN,pobj,appos,NNP,NNP,5,1
1,5.0,12,died,2,1,8,7,0,3,1,6,Georg Klindworth,Paris,PER-PER,LOC,PROPN-PROPN,PROPN,compound-nsubj,pobj,NNP-NNP,NNP,2,1
2,5.0,12,died,2,1,10,9,0,1,1,8,Georg Klindworth,January 1882,PER-PER,TIME-TIME,PROPN-PROPN,PROPN-NUM,compound-nsubj,pobj-nummod,NNP-NNP,NNP-CD,4,1
0,0.0,31,"""",0,2,22,20,1,8,-2,22,The Light In Our Soul,My Number One,MISC-MISC-MISC-MISC-MISC,MISC-MISC-MISC,DET-NOUN-ADP-DET-PROPN,DET-PROPN-NUM,det-nsubj-prep-poss-pobj,poss-appos-nummod,DT-NN-IN-PRP$-NNP,PRP$-NNP-CD,2,1
1,0.0,31,"""",0,2,26,24,1,4,-2,26,The Light In Our Soul,2005,MISC-MISC-MISC-MISC-MISC,TIME,DET-NOUN-ADP-DET-PROPN,NUM,det-nsubj-prep-poss-pobj,nummod,DT-NN-IN-PRP$-NNP,CD,6,1
2,0.0,31,"""",0,2,29,27,1,1,-2,29,The Light In Our Soul,Helena Paparizou,MISC-MISC-MISC-MISC-MISC,PER-PER,DET-NOUN-ADP-DET-PROPN,PROPN-PROPN,det-nsubj-prep-poss-pobj,compound-pobj,DT-NN-IN-PRP$-NNP,NNP-NNP,4,1
3,0.0,31,"""",0,22,26,4,21,4,-22,26,My Number One,2005,MISC-MISC-MISC,TIME,DET-PROPN-NUM,NUM,poss-appos-nummod,nummod,PRP$-NNP-CD,CD,4,1
4,0.0,31,"""",0,22,29,7,21,1,-22,29,My Number One,Helena Paparizou,MISC-MISC-MISC,PER-PER,DET-PROPN-NUM,PROPN-PROPN,poss-appos-nummod,compound-pobj,PRP$-NNP-CD,NNP-NNP,2,1
0,1.0,13,was,1,7,12,5,6,0,-6,11,Sweden,Stockholm,LOC,LOC,PROPN,PROPN,pobj,pobj,NNP,NNP,3,1
1,6.0,25,used,19,5,14,9,4,10,14,-5,Sweden,Stockholm,LOC,LOC,PROPN,PROPN,pobj,pobj,NNP,NNP,7,1
2,3.0,29,founded,3,8,12,4,7,16,-5,9,Johan Ulric Egge,1730,PER-PER-PER,TIME,PROPN-PROPN-PROPN,NUM,compound-compound-appos,nummod,NNP-NNP-NNP,CD,4,1
3,6.0,25,used,19,16,5,-11,15,19,3,-14,Gothenburg,Sweden,LOC,LOC,PROPN,PROPN,conj,pobj,NNP,NNP,3,1
4,9.0,31,performed,11,6,10,4,5,20,5,-1,Romeo and Juliet,Shakespeare,MISC-MISC-MISC,PER,PROPN-CCONJ-PROPN,PROPN,nsubjpass-cc-conj,pobj,NNP-CC-NNP,NNP,3,1
5,9.0,31,performed,11,6,8,2,5,22,5,-3,Romeo and Juliet,Juliet,MISC-MISC-MISC,PER,PROPN-CCONJ-PROPN,PROPN,nsubjpass-cc-conj,pobj,NNP-CC-NNP,NNP,2,1
0,3.0,24,occurs,4,20,22,2,19,1,-16,18,Quevedo,El Buscón,PER,PER-PER,PROPN,PROPN-PROPN,poss,compound-pobj,NNP,NNP-NNP,2,1
0,2.0,11,Arzamastsev,1,1,5,4,0,5,0,4,Zakhar Arzamastsev,1992,PER-PER,TIME,PROPN-PROPN,NUM,compound-ROOT,npadvmod,NNP-NNP,CD,2,1
1,3.0,15,Bron,1,1,5,4,0,9,0,4,Zakhar Bron,1947,PER-PER,TIME,PROPN-PROPN,NUM,compound-ROOT,npadvmod,NNP-NNP,CD,2,1
2,4.0,22,Chernyshyov,1,1,4,3,0,17,0,3,Zakhar Chernyshyov,1722,PER-PER,TIME,PROPN-PROPN,NUM,compound-ROOT,nummod,NNP-NNP,CD,1,1
3,4.0,22,Chernyshyov,1,1,6,5,0,15,0,5,Zakhar Chernyshyov,1784,PER-PER,TIME,PROPN-PROPN,NUM,compound-ROOT,nummod,NNP-NNP,CD,1,1
4,5.0,12,Dubensky,1,1,5,4,0,6,0,4,Zakhar Dubensky,1978,PER-PER,TIME,PROPN-PROPN,NUM,compound-ROOT,appos,NNP-NNP,CD,2,1
5,5.0,12,Dubensky,1,1,12,11,0,-1,0,11,Zakhar Dubensky,Russia,PER-PER,LOC,PROPN-PROPN,PROPN,compound-ROOT,pobj,NNP-NNP,NNP,-1,1
6,7.0,15,May,1,1,5,4,0,9,0,4,Zakhar May,1969,PER-PER,TIME,PROPN-PROPN,NUM,compound-ROOT,npadvmod,NNP-NNP,CD,2,1
7,8.0,14,Pashutin,1,1,5,4,0,8,0,4,Zakhar Pashutin,1974,PER-PER,TIME,PROPN-PROPN,NUM,compound-ROOT,npadvmod,NNP-NNP,CD,1,1
8,9.0,23,Prilepin,1,1,5,4,0,17,0,4,Zakhar Prilepin,1975,PER-PER,TIME,PROPN-PROPN,NUM,compound-ROOT,npadvmod,NNP-NNP,CD,1,1
9,9.0,23,Prilepin,1,1,19,18,0,3,0,18,Zakhar Prilepin,National Bolshevik Party,PER-PER,ORG-ORG-ORG,PROPN-PROPN,PROPN-PROPN-PROPN,compound-ROOT,compound-compound-pobj,NNP-NNP,NNP-NNP-NNP,6,1
0,0.0,31,"""",0,2,9,7,1,21,-2,9,Where the Party At,2001,MISC-MISC-MISC-MISC,TIME,ADV-DET-PROPN-ADP,NUM,advmod-det-nsubj-prep,nummod,WRB-DT-NNP-IN,CD,3,1
1,0.0,31,"""",0,2,18,16,1,12,-2,18,Where the Party At,Jagged Edge,MISC-MISC-MISC-MISC,ORG-ORG,ADV-DET-PROPN-ADP,PROPN-PROPN,advmod-det-nsubj-prep,compound-appos,WRB-DT-NNP-IN,NNP-NNP,4,1
2,0.0,31,"""",0,2,30,28,1,0,-2,30,Where the Party At,Nelly,MISC-MISC-MISC-MISC,PER,ADV-DET-PROPN-ADP,ADV,advmod-det-nsubj-prep,pobj,WRB-DT-NNP-IN,RB,3,1
3,3.0,26,nominated,3,13,17,4,12,8,-10,14,44th Grammy Awards,2002,MISC-MISC-MISC,TIME,ADJ-PROPN-PROPN,NUM,amod-compound-pobj,pobj,JJ-NNP-NNPS,CD,4,1
0,4.0,29,reunited,7,11,18,7,10,10,-4,11,Beatle,George Martin,ORG,PER-PER,PROPN,PROPN-PROPN,dobj,compound-appos,NNP,NNP-NNP,2,1
0,0.0,19,is,1,1,17,16,0,1,0,16,Sunnyside,United States,LOC,LOC-LOC,PROPN,PROPN-PROPN,nsubj,compound-appos,NNP,NNP-NNP,3,1
1,0.0,19,is,1,8,10,2,7,8,-7,9,Aquasco,Prince George 's County,LOC,LOC-LOC-LOC-LOC,PROPN,PROPN-PROPN-PART-PROPN,pobj,compound-poss-case-conj,NNP,NNP-NNP-POS-NNP,3,1
2,0.0,19,is,1,8,15,7,7,3,-7,14,Aquasco,Maryland,LOC,LOC,PROPN,PROPN,pobj,conj,NNP,NNP,3,1
3,0.0,19,is,1,8,17,9,7,1,-7,16,Aquasco,United States,LOC,LOC-LOC,PROPN,PROPN-PROPN,pobj,compound-appos,NNP,NNP-NNP,3,1
4,0.0,19,is,1,10,15,5,9,3,-9,14,Prince George 's County,Maryland,LOC-LOC-LOC-LOC,LOC,PROPN-PROPN-PART-PROPN,PROPN,compound-poss-case-conj,conj,NNP-NNP-POS-NNP,NNP,2,1
5,0.0,19,is,1,10,17,7,9,1,-9,16,Prince George 's County,United States,LOC-LOC-LOC-LOC,LOC-LOC,PROPN-PROPN-PART-PROPN,PROPN-PROPN,compound-poss-case-conj,compound-appos,NNP-NNP-POS-NNP,NNP-NNP,2,1
6,0.0,19,is,1,15,17,2,14,1,-14,16,Maryland,United States,LOC,LOC-LOC,PROPN,PROPN-PROPN,conj,compound-appos,NNP,NNP-NNP,2,1
7,8.0,49,was,15,37,28,-9,36,20,-22,13,Thomas Stone,United States Declaration of Independence,PER-PER,MISC-MISC-MISC-MISC-MISC,PROPN-PROPN,PROPN-PROPN-PROPN-ADP-PROPN,compound-pobj,compound-compound-pobj-prep-pobj,NNP-NNP,NNP-NNP-NNP-IN-NNP,6,1
0,0.0,45,is,11,24,29,5,23,15,-13,18,Los Angeles,United States,LOC-LOC,LOC-LOC,PROPN-PROPN,PROPN-PROPN,compound-pobj,compound-appos,NNP-NNP,NNP-NNP,1,1
1,0.0,45,is,11,27,29,2,26,15,-16,18,California,United States,LOC,LOC-LOC,PROPN,PROPN-PROPN,appos,compound-appos,NNP,NNP-NNP,2,1
0,0.0,23,is,3,2,11,9,1,11,1,8,Lycée Hoche,Versailles,ORG-ORG,LOC,PROPN-PROPN,PROPN,compound-nsubj,pobj,NNP-NNP,NNP,3,1
1,3.0,23,named,6,9,22,13,8,0,-3,16,Lycée Hoche,Versailles,ORG-ORG,LOC,PROPN-PROPN,PROPN,compound-oprd,pobj,NNP-NNP,NNP,2,1
2,4.0,38,is,25,3,34,31,2,3,22,9,Lycée Hoche,France,ORG-ORG,LOC,PROPN-PROPN,PROPN,compound-nsubj,pobj,NNP-NNP,NNP,7,1
3,4.0,38,is,25,3,34,31,2,3,22,9,Lycée Louis - le - Grand,France,ORG-ORG-ORG-ORG-ORG-ORG,LOC,PROPN-PROPN-PUNCT-PROPN-PUNCT-PROPN,PROPN,compound-compound-punct-compound-punct-conj,pobj,NNP-NNP-HYPH-NNP-HYPH-NNP,NNP,7,1
4,4.0,38,is,25,3,34,31,2,3,22,9,Lycée Stanislas,France,ORG-ORG,LOC,PROPN-PROPN,PROPN,compound-conj,pobj,NNP-NNP,NNP,7,1
5,4.0,38,is,25,3,34,31,2,3,22,9,Lycée Sainte - Geneviève,France,ORG-ORG-ORG-ORG,LOC,PROPN-PROPN-PUNCT-PROPN,PROPN,compound-compound-punct-conj,pobj,NNP-NNP-HYPH-NNP,NNP,7,1
0,0.0,35,is,5,1,14,13,0,20,4,9,Fort Mississauga National Historic Site,Ontario,LOC-LOC-LOC-LOC-LOC,LOC,PROPN-PROPN-PROPN-PROPN-PROPN,PROPN,compound-compound-compound-compound-nsubj,appos,NNP-NNP-NNP-NNP-NNP,NNP,4,1
1,0.0,35,is,5,1,34,33,0,0,4,29,Fort Mississauga National Historic Site,Canada,LOC-LOC-LOC-LOC-LOC,LOC,PROPN-PROPN-PROPN-PROPN-PROPN,PROPN,compound-compound-compound-compound-nsubj,appos,NNP-NNP-NNP-NNP-NNP,NNP,3,1
2,0.0,35,is,5,13,14,1,12,20,-8,9,Lake Ontario,Ontario,LOC-LOC,LOC,PROPN-PROPN,PROPN,compound-pobj,appos,NNP-NNP,NNP,5,1
3,0.0,35,is,5,13,34,21,12,0,-8,29,Lake Ontario,Canada,LOC-LOC,LOC,PROPN-PROPN,PROPN,compound-pobj,appos,NNP-NNP,NNP,6,1
4,0.0,35,is,5,21,14,-7,20,20,-16,9,Niagara River,Ontario,LOC-LOC,LOC,PROPN-PROPN,PROPN,compound-pobj,appos,NNP-NNP,NNP,6,1
5,0.0,35,is,5,21,34,13,20,0,-16,29,Niagara River,Canada,LOC-LOC,LOC,PROPN-PROPN,PROPN,compound-pobj,appos,NNP-NNP,NNP,5,1
6,0.0,35,is,5,14,34,20,13,0,-9,29,Ontario,Canada,LOC,LOC,PROPN,PROPN,appos,appos,NNP,NNP,3,1
0,1.0,13,located,4,9,7,-2,8,5,-5,3,Fiji,Suva,LOC,LOC,PROPN,PROPN,poss,pobj,NNP,NNP,5,1
1,4.0,28,are,16,13,6,-7,12,21,3,-10,New Zealand,Commonwealth of Nations,LOC-LOC,ORG-ORG-ORG,PROPN-PROPN,PROPN-ADP-PROPN,compound-pobj,pobj-prep-pobj,NNP-NNP,NNP-IN-NNP,8,1
0,0.0,12,is,1,1,4,3,0,7,0,3,Ballblazer,1984,MISC,TIME,PROPN,NUM,nsubj,nummod,NNP,CD,2,1
1,0.0,12,is,1,1,10,9,0,1,0,9,Ballblazer,Lucasfilm Games,MISC,ORG-ORG,PROPN,PROPN-PROPN,nsubj,compound-pobj,NNP,NNP-NNPS,4,1
2,7.0,21,released,15,13,19,6,12,1,2,4,Ballblazer Champions,Sony PlayStation,MISC-MISC,MISC-MISC,PROPN-PROPN,PROPN-PROPN,compound-pobj,compound-pobj,NNP-NNPS,NNP-NNP,5,1
0,0.0,21,released,11,7,14,7,6,6,4,3,Tanu Weds Manu Returns,22 May 2015,MISC-MISC-MISC-MISC,TIME-TIME-TIME,PROPN-PROPN-PROPN-PROPN,NUM-PROPN-NUM,compound-compound-compound-nsubjpass,nummod-pobj-nummod,NNP-NNP-NNP-NNP,CD-NNP-CD,8,1
1,3.0,28,won,11,8,16,8,7,11,3,5,Tanu Weds Manu Returns,Best Original Screenplay,MISC-MISC-MISC-MISC,MISC-MISC-MISC,PROPN-PROPN-PROPN-PROPN,PROPN-PROPN-PROPN,compound-compound-compound-nsubj,compound-compound-conj,NNP-NNP-NNP-NNP,NNP-NNP-NNP,5,1
0,0.0,42,Gibson,2,1,5,4,0,36,1,3,William F. Gibson,"September 7 , 1933",PER-PER-PER,TIME-TIME-TIME-TIME,PROPN-PROPN-PROPN,PROPN-NUM-PUNCT-NUM,compound-compound-ROOT,appos-nummod-punct-nummod,NNP-NNP-NNP,"NNP-CD-,-CD",3,1
1,1.0,16,was,1,1,13,12,0,2,0,12,Gibson,Meharry Medical College,PER,ORG-ORG-ORG,PROPN,PROPN-PROPN-PROPN,nsubj,compound-compound-conj,NNP,NNP-NNP-NNP,4,1
2,1.0,16,was,1,1,10,9,0,5,0,9,Gibson,State University,PER,ORG-ORG,PROPN,PROPN-PROPN,nsubj,compound-appos,NNP,NNP-NNP,2,1
3,2.0,24,served,1,18,7,-11,17,16,-17,6,Margaret Bush Wilson,NAACP,PER-PER-PER,ORG,PROPN-PROPN-PROPN,PROPN,compound-compound-dobj,poss,NNP-NNP-NNP,NNP,10,1
0,0.0,30,is,9,5,17,12,4,12,4,8,Arabic,United Arab Emirates,MISC,LOC-LOC-LOC,PROPN,PROPN-PROPN-PROPN,pobj,compound-compound-appos,NNP,NNP-NNP-NNP,6,1
1,0.0,30,is,9,2,17,15,1,12,7,8,Dubai,United Arab Emirates,LOC,LOC-LOC-LOC,PROPN,PROPN-PROPN-PROPN,pobj,compound-compound-appos,NNP,NNP-NNP-NNP,4,1
0,0.0,67,is,3,1,64,63,0,2,2,61,Prophets of Rage,B - Real,MISC-MISC-MISC,PER-PER-PER,NOUN-ADP-NOUN,PROPN-PUNCT-NOUN,nsubj-prep-pobj,compound-punct-conj,NNS-IN-NN,NNP-HYPH-NN,4,1
1,0.0,67,is,3,1,13,12,0,53,2,10,Prophets of Rage,American,MISC-MISC-MISC,LOC,NOUN-ADP-NOUN,ADJ,nsubj-prep-pobj,amod,NNS-IN-NN,JJ,8,1
2,0.0,67,is,3,1,1,0,0,65,2,-2,Prophets of Rage,Prophets of Rage,MISC-MISC-MISC,ORG-ORG-ORG,NOUN-ADP-NOUN,PROPN-ADP-PROPN,nsubj-prep-pobj,pobj-prep-pobj,NNS-IN-NN,NNPS-IN-NNP,0,1
3,0.0,67,is,3,1,37,36,0,29,2,34,Prophets of Rage,Tim Commerford,MISC-MISC-MISC,PER-PER,NOUN-ADP-NOUN,PROPN-PROPN,nsubj-prep-pobj,compound-appos,NNS-IN-NN,NNP-NNP,4,1
4,0.0,67,is,3,1,41,40,0,25,2,38,Prophets of Rage,Tom Morello,MISC-MISC-MISC,PER-PER,NOUN-ADP-NOUN,PROPN-PROPN,nsubj-prep-pobj,compound-conj,NNS-IN-NN,NNP-NNP,5,1
5,0.0,67,is,3,1,46,45,0,20,2,43,Prophets of Rage,Brad Wilk,MISC-MISC-MISC,PER-PER,NOUN-ADP-NOUN,PROPN-PROPN,nsubj-prep-pobj,compound-conj,NNS-IN-NN,NNP-NNP,6,1
6,0.0,67,is,3,1,57,56,0,9,2,54,Prophets of Rage,Chuck D,MISC-MISC-MISC,PER-PER,NOUN-ADP-NOUN,PROPN-PROPN,nsubj-prep-pobj,compound-dobj,NNS-IN-NN,NNP-NNP,5,1
7,0.0,67,is,3,61,64,3,60,2,-58,61,Cypress Hill,B - Real,ORG-ORG,PER-PER-PER,PROPN-PROPN,PROPN-PUNCT-NOUN,compound-compound,compound-punct-conj,NNP-NNP,NNP-HYPH-NN,2,1
8,0.0,67,is,3,61,13,-48,60,53,-58,10,Cypress Hill,American,ORG-ORG,LOC,PROPN-PROPN,ADJ,compound-compound,amod,NNP-NNP,JJ,8,1
9,0.0,67,is,3,64,13,-51,63,53,-61,10,B - Real,American,PER-PER-PER,LOC,PROPN-PUNCT-NOUN,ADJ,compound-punct-conj,amod,NNP-HYPH-NN,JJ,8,1
10,0.0,67,is,3,3,37,34,2,29,0,34,Rage Against the Machine and Audioslave,Tim Commerford,ORG-ORG-ORG-ORG-ORG-ORG,PER-PER,NOUN-ADP-DET-PROPN-CCONJ-PROPN,PROPN-PROPN,pobj-prep-det-pobj-cc-conj,compound-appos,NN-IN-DT-NNP-CC-NNP,NNP-NNP,2,1
11,0.0,67,is,3,50,57,7,49,9,-47,54,Public Enemy,Chuck D,ORG-ORG,PER-PER,PROPN-PROPN,PROPN-PROPN,compound-poss,compound-dobj,NNP-NNP,NNP-NNP,2,1
0,0.0,28,is,5,2,16,14,1,11,3,11,Anahita Temple,Iran,LOC-LOC,LOC,PROPN-PROPN,PROPN,compound-nsubj,pobj,NNP-NNP,NNP,4,1
1,1.0,17,located,10,13,15,2,12,1,-3,5,Kangāvar,Kermanshah Province,LOC,LOC-LOC,PROPN,PROPN-PROPN,pobj,compound-pobj,NNP,NNP-NNP,1,1
0,0.0,13,was,8,1,4,3,0,8,7,-4,Barbro Stigsdotter,1472,PER-PER,TIME,PROPN-PROPN,NUM,compound-nsubj,npadvmod,NNP-NNP,CD,2,1
1,2.0,28,was,2,1,7,6,0,20,1,5,Barbro Stigsdotter,Stig Hansson,PER-PER,PER-PER,PROPN-PROPN,PROPN-PROPN,compound-nsubj,compound-pobj,NNP-NNP,NNP-NNP,4,1
2,9.0,53,featured,22,36,30,-6,35,22,-14,8,Bridget of Sweden,Swedish,PER-PER-PER,LOC,PROPN-ADP-PROPN,ADJ,pobj-prep-pobj,amod,NNP-IN-NNP,JJ,4,1
3,9.0,53,featured,22,43,30,-13,42,22,-21,8,Hedvig Charlotta Nordenflycht,Swedish,PER-PER-PER,LOC,PROPN-PROPN-PROPN,ADJ,compound-compound-conj,amod,NNP-NNP-NNP,JJ,6,1
4,9.0,53,featured,22,40,30,-10,39,22,-18,8,Sophia Elisabet Brenner,Swedish,PER-PER-PER,LOC,PROPN-PROPN-PROPN,ADJ,compound-compound-conj,amod,NNP-NNP-NNP,JJ,4,1
5,9.0,53,featured,22,51,30,-21,50,22,-29,8,Vendela Skytte,Swedish,PER-PER,LOC,PROPN-PROPN,ADJ,compound-conj,amod,NNP-NNP,JJ,7,1
0,0.0,25,was,13,1,4,3,0,20,12,-9,Al Chang,"July 13 , 1922",PER-PER,TIME-TIME-TIME-TIME,PROPN-PROPN,PROPN-NUM-PUNCT-NUM,compound-nsubj,nmod-nummod-punct-nummod,NNP-NNP,"NNP-CD-,-CD",2,1
1,0.0,25,was,13,1,9,8,0,15,12,-4,Al Chang,"September 30 , 2007",PER-PER,TIME-TIME-TIME-TIME,PROPN-PROPN,PROPN-NUM-PUNCT-NUM,compound-nsubj,appos-nummod-punct-nummod,NNP-NNP,"NNP-CD-,-CD",2,1
2,0.0,25,was,13,1,16,15,0,8,12,3,Al Chang,American,PER-PER,LOC,PROPN-PROPN,ADJ,compound-nsubj,amod,NNP-NNP,JJ,3,1
3,1.0,45,was,1,28,33,5,27,11,-27,32,U.S. Army,World War II,ORG-ORG,MISC-MISC-MISC,PROPN-PROPN,PROPN-PROPN-PROPN,compound-pobj,compound-compound-pobj,NNP-NNP,NNP-NNP-NNP,8,1
0,0.0,20,owned,10,8,18,10,7,1,2,8,Vogue,Conde Nast,MISC,ORG-ORG,PROPN,PROPN-PROPN,nsubjpass,compound-pobj,NNP,NNP-NNP,4,1
1,1.0,9,published,4,1,7,6,0,1,3,3,British Vogue,autumn 1916,MISC-MISC,TIME-TIME,PROPN-PROPN,NOUN-NUM,amod-nsubjpass,pobj-nummod,NNP-NNP,NN-CD,4,1
0,0.0,29,is,6,16,27,11,15,1,-10,21,Amazon,South America,LOC,LOC-LOC,PROPN,PROPN-PROPN,pobj,compound-pobj,NNP,NNP-NNP,6,1
1,0.0,29,is,6,18,27,9,17,1,-12,21,Orinoco,South America,LOC,LOC-LOC,PROPN,PROPN-PROPN,conj,compound-pobj,NNP,NNP-NNP,7,1
2,0.0,29,is,6,20,27,7,19,1,-14,21,Essequibo,South America,LOC,LOC-LOC,PROPN,PROPN-PROPN,conj,compound-pobj,NNP,NNP-NNP,8,1
3,0.0,29,is,6,22,24,2,21,4,-16,18,Paraná,Paraguay,LOC,LOC,PROPN,PROPN,conj,conj,NNP,NNP,7,1
4,0.0,29,is,6,22,27,5,21,1,-16,21,Paraná,South America,LOC,LOC-LOC,PROPN,PROPN-PROPN,conj,compound-pobj,NNP,NNP-NNP,9,1
5,0.0,29,is,6,24,27,3,23,1,-18,21,Paraguay,South America,LOC,LOC-LOC,PROPN,PROPN-PROPN,conj,compound-pobj,NNP,NNP-NNP,2,1
6,1.0,8,included,2,1,7,6,0,0,1,5,Mesonauta,Cichlasomatinae,MISC,MISC,PROPN,PROPN,nsubjpass,pobj,NNP,NNP,2,1
0,0.0,17,lies,3,1,9,8,0,7,2,6,Udawalawe National Park,Sabaragamuwa,LOC-LOC-LOC,LOC,PROPN-PROPN-PROPN,PROPN,compound-compound-nsubj,pobj,NNP-NNP-NNP,NNP,7,1
1,0.0,17,lies,3,9,15,6,8,1,-6,12,Sabaragamuwa,Sri Lanka,LOC,LOC-LOC,PROPN,PROPN-PROPN,pobj,compound-pobj,NNP,NNP-NNP,7,1
0,0.0,21,Houghton,2,1,5,4,0,15,1,3,George Hendric Houghton,"February 1 , 1820",PER-PER-PER,TIME-TIME-TIME-TIME,PROPN-PROPN-PROPN,PROPN-NUM-PUNCT-NUM,compound-compound-ROOT,npadvmod-nummod-punct-npadvmod,NNP-NNP-NNP,"NNP-CD-,-CD",3,1
1,0.0,21,Houghton,2,1,10,9,0,10,1,8,George Hendric Houghton,"November 17 , 1897",PER-PER-PER,TIME-TIME-TIME-TIME,PROPN-PROPN-PROPN,PROPN-NUM-PUNCT-NUM,compound-compound-ROOT,nsubj-nummod-punct-nummod,NNP-NNP-NNP,"NNP-CD-,-CD",3,1
2,0.0,21,Houghton,2,1,17,16,0,3,1,15,George Hendric Houghton,American,PER-PER-PER,LOC,PROPN-PROPN-PROPN,PROPN,compound-compound-ROOT,compound,NNP-NNP-NNP,NNP,5,1
0,0.0,37,Mitchell,1,1,10,9,0,26,0,9,Chuck Mitchell,"June 22 , 1992",PER-PER,TIME-TIME-TIME-TIME,PROPN-PROPN,PROPN-NUM-PUNCT-NUM,compound-ROOT,nsubj-nummod-punct-nummod,NNP-NNP,"NNP-CD-,-CD",3,1
1,0.0,37,Mitchell,1,26,31,5,25,5,-25,30,Porky,1982,PER,TIME,PROPN,NUM,pobj,pobj,NNP,CD,7,1
2,7.0,17,died,4,4,9,5,3,7,0,5,Mitchell,Hollywood,PER,LOC,PROPN,PROPN,nsubj,pobj,NNP,NNP,4,1
0,0.0,32,were,1,14,19,5,13,12,-13,18,Zimbabwe,Robert Mugabe,LOC,PER-PER,PROPN,PROPN-PROPN,pobj,compound-pobj,NNP,NNP-NNP,3,1
0,0.0,26,is,6,1,13,12,0,12,5,7,"Garrison "" Gary "" Arthur Ewing",CBS,PER-PER-PER-PER-PER-PER,ORG,PROPN-PUNCT-PROPN-PUNCT-PROPN-PROPN,PROPN,nsubj-punct-nmod-punct-compound-appos,compound,NNP-``-NNP-''-NNP-NNP,NNP,6,1
1,1.0,29,played,7,17,27,10,16,1,-10,20,Dallas,September 1978,MISC,TIME-TIME,PROPN,PROPN-NUM,compound,pobj-nummod,NNP,NNP-CD,3,1
2,2.0,30,was,2,10,14,4,9,15,-8,12,Jock Ewing,Ellie Ewing,PER-PER,PER-PER,PROPN-PROPN,PROPN-PROPN,compound-appos,compound-conj,NNP-NNP,NNP-NNP,1,1
0,1.0,24,won,1,16,23,7,15,0,-15,22,1928 Summer Olympics,Amsterdam,MISC-MISC-MISC,LOC,NUM-PROPN-PROPN,PROPN,nummod-compound-pobj,pobj,CD-NNP-NNPS,NNP,4,1
0,0.0,16,is,8,1,5,4,0,10,7,-3,Neil Humphreys,5 December 1974,PER-PER,TIME-TIME-TIME,PROPN-PROPN,NUM-PROPN-NUM,compound-nsubj,nummod-npadvmod-nummod,NNP-NNP,CD-NNP-CD,2,1
1,1.0,29,migrated,10,10,4,-6,9,24,0,-6,Humphreys,Dagenham,PER,LOC,PROPN,PROPN,nsubj,pobj,NNP,NNP,4,1
2,1.0,29,migrated,10,10,8,-2,9,20,0,-2,Humphreys,England,PER,LOC,PROPN,PROPN,nsubj,conj,NNP,NNP,1,1
3,1.0,29,migrated,10,6,8,2,5,20,4,-2,London,England,LOC,LOC,PROPN,PROPN,conj,conj,NNP,NNP,6,1
0,3.0,45,started,9,12,16,4,11,28,-3,7,A Different World,1987,MISC-MISC-MISC,TIME,DET-ADJ-PROPN,NUM,det-compound-pobj,pobj,DT-JJ-NNP,CD,4,1
0,0.0,24,is,4,2,23,21,1,0,2,19,Château de Pirou,France,LOC-LOC-LOC,LOC,PROPN-PROPN-PROPN,PROPN,compound-compound-nsubj,pobj,NNP-NNP-NNP,NNP,3,1
1,0.0,24,is,4,4,23,19,3,0,0,19,Pirou,France,LOC,LOC,PROPN,PROPN,pobj,pobj,NNP,NNP,1,1
0,7.0,36,released,30,21,25,4,20,10,9,-5,Adventure 02,Digimon Adventure tri,MISC-MISC,MISC-MISC-MISC,PROPN-NUM,PROPN-PROPN-NOUN,pobj-nummod,compound-oprd-oprd,NNP-CD,NNP-NNP-NNS,11,1
1,7.0,36,released,30,25,33,8,24,2,5,3,Digimon Adventure tri,2015,MISC-MISC-MISC,TIME,PROPN-PROPN-NOUN,NUM,compound-oprd-oprd,pobj,NNP-NNP-NNS,CD,-1,1
0,0.0,24,is,3,1,14,13,0,9,2,11,Me Musical Nephews,Seymour Kneitel,MISC-MISC-MISC,PER-PER,PRON-PROPN-PROPN,PROPN-PROPN,compound-compound-nsubj,compound-pobj,PRP-NNP-NNP,NNP-NNP,6,1
1,4.0,14,was,3,9,13,4,8,0,-6,10,Riot in Rhythm,1950,MISC-MISC-MISC,TIME,PROPN-ADP-PROPN,NUM,pobj-prep-pobj,pobj,NNP-IN-NNP,CD,7,1
0,0.0,33,is,12,9,11,2,8,21,3,-1,Donetsk,Ukraine,LOC,LOC,PROPN,PROPN,nmod,pobj,NNP,NNP,4,1
0,0.0,21,is,2,1,15,14,0,5,1,13,Shaji Kailas,Malayalam,PER-PER,MISC,PROPN-PROPN,PROPN,compound-nsubj,nmod,NNP-NNP,NNP,6,1
1,3.0,45,made,5,24,2,-22,23,42,-19,-3,Ekalavyan,Renji Panicker,MISC,PER-PER,PROPN,PROPN-PROPN,conj,compound-pobj,NNP,NNP-NNP,5,1
2,3.0,45,made,5,34,36,2,33,8,-29,31,Commissioner,1994,MISC,TIME,PROPN,NUM,conj,appos,NNP,CD,2,1
3,3.0,45,made,5,40,43,3,39,1,-35,38,The King,1995,MISC-MISC,TIME,DET-PROPN,NUM,det-conj,appos,DT-NNP,CD,1,1
4,3.0,45,made,5,12,14,2,11,30,-7,9,Thalastaanam,1992,MISC,TIME,PROPN,NUM,pobj,appos,NNP,CD,2,1
5,4.0,33,brought,5,17,20,3,16,12,-12,15,Aaraam Thampuran,1997,MISC-MISC,TIME,PROPN-PROPN,NUM,compound-pobj,appos,NNP-NNP,CD,1,1
0,0.0,15,is,1,7,14,7,6,0,-6,13,Motilal Nehru National Institute of Technology,Allahabad,ORG-ORG-ORG-ORG-ORG-ORG,LOC,PROPN-PROPN-PROPN-PROPN-ADP-PROPN,PROPN,compound-compound-compound-pobj-prep-pobj,npadvmod,NNP-NNP-NNP-NNP-IN-NNP,NNP,5,1
1,3.0,44,draws,2,32,12,-20,31,31,-30,10,IIIT - A,India,ORG-ORG-ORG,LOC,PROPN-PUNCT-NOUN,PROPN,compound-punct-conj,pobj,NNP-HYPH-NN,NNP,8,1
2,3.0,44,draws,2,36,12,-24,35,31,-34,10,HBTI,India,ORG,LOC,PROPN,PROPN,conj,pobj,NNP,NNP,9,1
0,2.0,23,nat,0,9,11,2,8,11,-9,11,Meißen,Germany,LOC,LOC,PROPN,PROPN,appos,appos,NNP,NNP,2,1
1,2.0,23,nat,0,9,15,6,8,7,-9,15,Meißen,German,LOC,LOC,PROPN,ADJ,appos,amod,NNP,JJ,4,1
0,0.0,30,"""",0,2,22,20,1,7,-2,22,A Very Crappy Christmas,South Park,MISC-MISC-MISC-MISC,MISC-MISC,DET-ADV-PROPN-PROPN,PROPN-PROPN,det-advmod-compound-nsubj,compound-appos,DT-RB-NNP-NNP,NNP-NNP,9,1
1,1.0,16,aired,2,5,9,4,4,6,-3,7,Comedy Central,United States,ORG-ORG,LOC-LOC,PROPN-PROPN,PROPN-PROPN,compound-pobj,compound-pobj,NNP-NNP,NNP-NNP,2,1
0,5.0,48,discovered,7,45,47,2,44,0,-38,40,Sozopol,Bulgaria,LOC,LOC,PROPN,PROPN,conj,pobj,NNP,NNP,6,1
0,0.0,23,is,3,1,8,7,0,14,2,5,Bemidji,Beltrami County,LOC,LOC-LOC,NOUN,PROPN-PROPN,nsubj,compound-pobj,NNS,NNP-NNP,4,1
1,0.0,23,is,3,8,19,11,7,3,-5,16,Beltrami County,Minnesota,LOC-LOC,LOC,PROPN-PROPN,PROPN,compound-pobj,pobj,NNP-NNP,NNP,6,1
2,0.0,23,is,3,8,21,13,7,1,-5,18,Beltrami County,United States,LOC-LOC,LOC-LOC,PROPN-PROPN,PROPN-PROPN,compound-pobj,compound-appos,NNP-NNP,NNP-NNP,5,1
3,0.0,23,is,3,19,21,2,18,1,-16,18,Minnesota,United States,LOC,LOC-LOC,PROPN,PROPN-PROPN,pobj,compound-appos,NNP,NNP-NNP,3,1
4,1.0,47,estimates,17,7,3,-4,6,43,10,-14,American Community Survey,the United States Census Bureau,MISC-MISC-MISC,ORG-ORG-ORG-ORG-ORG,PROPN-PROPN-PROPN,DET-PROPN-PROPN-PROPN-PROPN,nmod-nmod-prep,det-compound-compound-compound-nsubj,NNP-NNP-NNP,DT-NNP-NNP-NNP-NNP,3,1
5,4.0,32,lies,1,9,17,8,8,14,-8,16,Lake Bemidji,Mississippi River,LOC-LOC,LOC-LOC,PROPN-PROPN,PROPN-PROPN,compound-pobj,compound-dobj,NNP-NNP,NNP-NNP,7,1
6,5.0,21,is,1,19,14,-5,18,6,-18,13,Paul Bunyan,U.S.,PER-PER,LOC,PROPN-PROPN,PROPN,compound-pobj,pobj,NNP-NNP,NNP,4,1
0,1.0,39,headed,3,6,15,9,5,23,-3,12,Mehdi Bazargan,Freedom Movement of Iran,PER-PER,MISC-MISC-MISC-MISC,PROPN-PROPN,PROPN-PROPN-ADP-PROPN,compound-pobj,compound-pobj-prep-pobj,NNP-NNP,NNP-NNP-IN-NNP,5,1
0,0.0,18,is,2,1,17,16,0,0,1,15,Straits Quay,Malaysia,LOC-LOC,LOC,PROPN-PROPN,PROPN,compound-nsubj,appos,NNP-NNP,NNP,2,1
1,0.0,18,is,2,12,15,3,11,2,-10,13,George Town,Penang,LOC-LOC,LOC,PROPN-PROPN,PROPN,compound-pobj,appos,NNP-NNP,NNP,2,1
2,0.0,18,is,2,15,17,2,14,0,-13,15,Penang,Malaysia,LOC,LOC,PROPN,PROPN,appos,appos,NNP,NNP,6,1
0,0.0,22,is,1,1,15,14,0,6,0,14,Wikiquote,Wikimedia Foundation,MISC,ORG-ORG,PROPN,PROPN-PROPN,nsubj,compound-pobj,NNP,NNP-NNP,8,1
0,0.0,21,is,10,1,9,8,0,11,9,-1,The Reivers : A Reminiscence,1962,MISC-MISC-MISC-MISC-MISC,TIME,DET-PROPN-PUNCT-DET-NOUN,NUM,det-nsubj-punct-det-appos,pobj,DT-NNPS-:-DT-NN,CD,2,1
1,0.0,21,is,10,1,19,18,0,1,9,9,The Reivers : A Reminiscence,William Faulkner,MISC-MISC-MISC-MISC-MISC,PER-PER,DET-PROPN-PUNCT-DET-NOUN,PROPN-PROPN,det-nsubj-punct-det-appos,compound-appos,DT-NNPS-:-DT-NN,NNP-NNP,4,1
2,2.0,26,won,2,1,9,8,0,16,1,7,Faulkner,A Fable,PER,MISC-MISC,PROPN,DET-PROPN,nsubj,det-appos,NNP,DT-NNP,4,1
3,8.0,20,adapted,3,1,11,10,0,8,2,8,The Reivers,Mark Rydell,MISC-MISC,PER-PER,DET-PROPN,PROPN-PROPN,det-nsubjpass,compound-pobj,DT-NNPS,NNP-NNP,6,1
4,8.0,20,adapted,3,1,15,14,0,4,2,12,The Reivers,Steve McQueen,MISC-MISC,PER-PER,DET-PROPN,PROPN-PROPN,det-nsubjpass,compound-dobj,DT-NNPS,NNP-NNP,6,1
0,1.0,26,studied,1,19,22,3,18,3,-18,21,Alfred Vulpian,1826,PER-PER,TIME,PROPN-PROPN,NUM,compound-pobj,nummod,NNP-NNP,CD,2,1
1,1.0,26,studied,1,19,24,5,18,1,-18,23,Alfred Vulpian,1887,PER-PER,TIME,PROPN-PROPN,NUM,compound-pobj,nummod,NNP-NNP,CD,1,1
2,2.0,33,returned,11,25,29,4,24,3,-14,18,Augustus Volney Waller,1816,PER-PER-PER,TIME,PROPN-PROPN-PROPN,NUM,compound-compound-pobj,nummod,NNP-NNP-NNP,CD,3,1
3,2.0,33,returned,11,25,31,6,24,1,-14,20,Augustus Volney Waller,1870,PER-PER-PER,TIME,PROPN-PROPN-PROPN,NUM,compound-compound-pobj,nummod,NNP-NNP-NNP,CD,2,1
4,3.0,37,became,3,19,22,3,18,14,-16,19,Moritz Schiff,1823,PER-PER,TIME,PROPN-PROPN,NUM,compound-dobj,nummod,NNP-NNP,CD,2,1
5,3.0,37,became,3,19,24,5,18,12,-16,21,Moritz Schiff,1896,PER-PER,TIME,PROPN-PROPN,NUM,compound-dobj,nummod,NNP-NNP,CD,1,1
6,4.0,27,were,8,10,14,4,9,12,-2,6,Joseph Jules Dejerine,1849,PER-PER-PER,TIME,PROPN-PROPN-PROPN,NUM,compound-compound-attr,nummod,NNP-NNP-NNP,CD,2,1
7,4.0,27,were,8,10,16,6,9,10,-2,8,Joseph Jules Dejerine,1917,PER-PER-PER,TIME,PROPN-PROPN-PROPN,NUM,compound-compound-attr,npadvmod,NNP-NNP-NNP,CD,2,1
8,4.0,27,were,8,19,23,4,18,3,-11,15,Paul Charles Dubois,1848,PER-PER-PER,TIME,PROPN-PROPN-PROPN,NUM,compound-compound-conj,nummod,NNP-NNP-NNP,CD,3,1
9,4.0,27,were,8,19,25,6,18,1,-11,17,Paul Charles Dubois,1918,PER-PER-PER,TIME,PROPN-PROPN-PROPN,NUM,compound-compound-conj,npadvmod,NNP-NNP-NNP,CD,2,1
10,6.0,33,authored,8,11,14,3,10,18,-3,6,Jules Cotard,1840,PER-PER,TIME,PROPN-PROPN,NUM,compound-pobj,nummod,NNP-NNP,CD,2,1
0,2.0,30,released,1,6,9,3,5,20,-5,8,Ihan pomona,20 February 2015,MISC-MISC,TIME-TIME-TIME,PROPN-NOUN,NUM-PROPN-NUM,compound-appos,nummod-pobj-nummod,NNP-NN,CD-NNP-CD,3,1
0,0.0,39,Montoya,1,1,5,4,0,33,0,4,Gustavo Montoya,"July 9 , 1905",PER-PER,TIME-TIME-TIME-TIME,PROPN-PROPN,PROPN-NUM-PUNCT-NUM,compound-ROOT,ROOT-nummod-punct-nummod,NNP-NNP,"NNP-CD-,-CD",2,1
1,0.0,39,Montoya,1,1,5,4,0,33,0,4,Gustavo Montoya,"July 12 , 2003",PER-PER,TIME-TIME-TIME-TIME,PROPN-PROPN,PROPN-NUM-PUNCT-NUM,compound-ROOT,npadvmod-nummod-punct-nummod,NNP-NNP,"NNP-CD-,-CD",2,1
2,1.0,28,born,2,14,26,12,13,1,-12,24,Porfirio Díaz,Mexican Revolution,PER-PER,MISC-MISC,PROPN-PROPN,PROPN-PROPN,compound-compound,compound-pobj,NNP-NNP,NNP-NNP,12,1
0,0.0,44,is,2,1,14,13,0,29,1,12,Animal Crossing,Nintendo,MISC-MISC,ORG,PROPN-PROPN,PROPN,compound-nsubj,pobj,NNP-NNP,NNP,3,1
1,2.0,34,released,6,2,14,12,1,19,4,8,Animal Crossing,Nintendo 64,MISC-MISC,MISC-MISC,PROPN-PROPN,PROPN-NUM,compound-compound,pobj-nummod,NNP-NNP,NNP-CD,6,1
2,2.0,34,released,6,2,22,20,1,11,4,16,Animal Crossing,GameCube,MISC-MISC,MISC,PROPN-PROPN,PROPN,compound-compound,pobj,NNP-NNP,NNP,4,1
3,2.0,34,released,6,2,14,12,1,19,4,8,Animal Crossing,Nintendo DS,MISC-MISC,MISC-MISC,PROPN-PROPN,PROPN-PROPN,compound-compound,compound-conj,NNP-NNP,NNP-NNP,6,1
4,2.0,34,released,6,2,28,26,1,5,4,22,Animal Crossing,Wii,MISC-MISC,MISC,PROPN-PROPN,PROPN,compound-compound,conj,NNP-NNP,NNP,5,1
0,0.0,26,is,4,1,13,12,0,12,3,9,Never Take Friendship Personal,Anberlin,MISC-MISC-MISC-MISC,ORG,ADV-VERB-NOUN-PROPN,PROPN,neg-csubj-compound-dobj,pobj,RB-VB-NN-NNP,NNP,3,1
1,0.0,26,is,4,1,17,16,0,8,3,13,Never Take Friendship Personal,"February 1 , 2005",MISC-MISC-MISC-MISC,TIME-TIME-TIME-TIME,ADV-VERB-NOUN-PROPN,PROPN-NUM-PUNCT-NUM,neg-csubj-compound-dobj,pobj-nummod-punct-nummod,RB-VB-NN-NNP,"NNP-CD-,-CD",6,1
2,0.0,26,is,4,1,22,21,0,3,3,18,Never Take Friendship Personal,Tooth & Nail Records,MISC-MISC-MISC-MISC,ORG-ORG-ORG-ORG,ADV-VERB-NOUN-PROPN,PROPN-CCONJ-PROPN-PROPN,neg-csubj-compound-dobj,pobj-cc-compound-conj,RB-VB-NN-NNP,NNP-CC-NNP-NNPS,6,1
3,2.0,22,were,2,5,11,6,4,10,-3,9,A Day Late,Paperthin Hymn,MISC-MISC-MISC,MISC-MISC,DET-NOUN-PROPN,PROPN-PROPN,det-compound-attr,compound-nmod,DT-NN-NNP,NNP-NNP,3,1
0,0.0,47,is,10,17,19,2,16,27,-7,9,Victoria,Australia,LOC,LOC,PROPN,PROPN,pobj,appos,NNP,NNP,4,1
1,1.0,29,created,2,1,5,4,0,23,1,3,VGLRL,October 1997,ORG,TIME-TIME,PROPN,PROPN-NUM,nsubjpass,pobj-nummod,NNP,NNP-CD,4,1
0,2.0,22,appeared,3,6,19,13,5,2,-3,16,Ingram,Qwest Records,PER,ORG-ORG,PROPN,PROPN-PROPN,poss,compound-compound,NNP,NNP-NNPS,9,1
1,2.0,22,appeared,3,10,19,9,9,2,-7,16,It 's Your Night,Qwest Records,MISC-MISC-MISC-MISC,ORG-ORG,PRON-VERB-DET-PROPN,PROPN-PROPN,nsubj-ROOT-poss-attr,compound-compound,PRP-VBZ-PRP$-NNP,NNP-NNPS,4,1
2,9.0,23,Feel,15,15,21,6,14,1,0,6,I Feel for You,Prince,MISC-MISC-MISC-MISC,MISC,PRON-VERB-ADP-PRON,PROPN,nsubj-ROOT-prep-pobj,npadvmod,PRP-VBP-IN-PRP,NNP,4,1
0,1.0,37,bore,7,15,9,-6,14,27,-8,2,Zeus,Helen,PER,PER,PROPN,PROPN,pobj,dobj,NNP,NNP,4,1
1,1.0,37,bore,7,15,11,-4,14,25,-8,4,Zeus,Polydeuces,PER,PER,PROPN,PROPN,pobj,conj,NNP,NNPS,4,1
0,3.0,61,built,21,8,12,4,7,48,13,-9,Green Eyed Soul,2001,MISC-MISC-MISC,TIME,PROPN-PROPN-NOUN,NUM,compound-compound-npadvmod,appos,NNP-NNP-NN,CD,2,1
0,1.0,18,created,3,16,6,-10,15,11,-13,3,Rocky,Sylvester Stallone,MISC,PER-PER,PROPN,PROPN-PROPN,compound,compound-pobj,NNP,NNP-NNP,3,1
1,6.0,56,received,14,11,2,-9,10,53,3,-12,Creed,Stallone,MISC,PER,PROPN,PROPN,pobj,nsubj,NNP,NNP,2,1
2,6.0,56,received,14,11,9,-2,10,46,3,-5,Creed,2015,MISC,TIME,PROPN,NUM,pobj,pobj,NNP,CD,3,1
0,0.0,36,is,5,2,31,29,1,4,3,26,Monroe Township Public Schools,New Jersey,LOC-LOC-LOC-LOC,LOC-LOC,PROPN-PROPN-PROPN-PROPN,PROPN-PROPN,compound-compound-compound-nsubj,compound-conj,NNP-NNP-NNP-NNPS,NNP-NNP,5,1
1,0.0,36,is,5,2,34,32,1,1,3,29,Monroe Township Public Schools,United States,LOC-LOC-LOC-LOC,LOC-LOC,PROPN-PROPN-PROPN-PROPN,PROPN-PROPN,compound-compound-compound-nsubj,compound-appos,NNP-NNP-NNP-NNPS,NNP-NNP,5,1
2,0.0,36,is,5,2,28,26,1,7,3,23,Monroe Township,Gloucester County,LOC-LOC,LOC-LOC,PROPN-PROPN,PROPN-PROPN,compound-pobj,compound-pobj,NNP-NNP,NNP-NNP,4,1
3,0.0,36,is,5,2,34,32,1,1,3,29,Monroe Township,United States,LOC-LOC,LOC-LOC,PROPN-PROPN,PROPN-PROPN,compound-pobj,compound-appos,NNP-NNP,NNP-NNP,5,1
4,0.0,36,is,5,28,31,3,27,4,-23,26,Gloucester County,New Jersey,LOC-LOC,LOC-LOC,PROPN-PROPN,PROPN-PROPN,compound-pobj,compound-conj,NNP-NNP,NNP-NNP,1,1
5,0.0,36,is,5,28,34,6,27,1,-23,29,Gloucester County,United States,LOC-LOC,LOC-LOC,PROPN-PROPN,PROPN-PROPN,compound-pobj,compound-appos,NNP-NNP,NNP-NNP,1,1
6,0.0,36,is,5,31,34,3,30,1,-26,29,New Jersey,United States,LOC-LOC,LOC-LOC,PROPN-PROPN,PROPN-PROPN,compound-conj,compound-appos,NNP-NNP,NNP-NNP,2,1
0,0.0,30,"""",0,2,25,23,1,4,-2,25,The Harvest Of Love,Pye Records,MISC-MISC-MISC-MISC,ORG-ORG,DET-PROPN-ADP-NOUN,PROPN-PROPN,det-nsubj-prep-pobj,compound-pobj,DT-NNP-IN-NN,NNP-NNPS,5,1
1,0.0,30,"""",0,20,25,5,19,4,-20,25,Benny Hill,Pye Records,PER-PER,ORG-ORG,PROPN-PROPN,PROPN-PROPN,compound-pobj,compound-pobj,NNP-NNP,NNP-NNPS,7,1
0,2.0,50,was,6,44,49,5,43,0,-38,43,Chinese,Yunnan,LOC,LOC,ADJ,PROPN,amod,pobj,JJ,NNP,6,1
1,2.0,50,was,6,24,49,25,23,0,-18,43,Kunming,Yunnan,LOC,LOC,PROPN,PROPN,pobj,pobj,NNP,NNP,7,1
0,0.0,26,"""",0,2,19,17,1,6,-2,19,My Favourite Game,The Cardigans,MISC-MISC-MISC,ORG-ORG,DET-PROPN-PROPN,DET-PROPN,poss-compound-nsubj,det-poss,PRP$-NNP-NNP,DT-NNPS,11,1
0,3.0,28,is,17,14,17,3,13,10,3,0,Liliaceae,Liliales,MISC,MISC,PROPN,PROPN,npadvmod,pobj,NNP,NNP,10,1
0,0.0,27,is,14,2,26,24,1,0,12,12,Nordfriedhof,Germany,LOC,LOC,PROPN,PROPN,nsubj,pobj,NNP,NNP,4,1
1,0.0,27,is,14,22,24,2,21,2,-8,10,Munich,Bavaria,LOC,LOC,PROPN,PROPN,nmod,nmod,NNP,NNP,3,1
2,0.0,27,is,14,22,26,4,21,0,-8,12,Munich,Germany,LOC,LOC,PROPN,PROPN,nmod,pobj,NNP,NNP,7,1
3,0.0,27,is,14,24,26,2,23,0,-10,12,Bavaria,Germany,LOC,LOC,PROPN,PROPN,nmod,pobj,NNP,NNP,8,1
0,0.0,39,born,14,1,5,4,0,33,13,-9,Henry C. Nields,18 March 1838,PER-PER-PER,TIME-TIME-TIME,PROPN-PROPN-PROPN,NUM-PROPN-NUM,compound-compound-nsubjpass,nummod-nmod-nummod,NNP-NNP-NNP,CD-NNP-CD,3,1
1,0.0,39,born,14,1,31,30,0,7,13,17,Henry C. Nields,United States Navy,PER-PER-PER,ORG-ORG-ORG,PROPN-PROPN-PROPN,PROPN-PROPN-PROPN,compound-compound-nsubjpass,compound-compound-pobj,NNP-NNP-NNP,NNP-NNP-NNP,7,1
2,0.0,39,born,14,1,36,35,0,2,13,22,Henry C. Nields,American Civil War,PER-PER-PER,MISC-MISC-MISC,PROPN-PROPN-PROPN,PROPN-PROPN-PROPN,compound-compound-nsubjpass,compound-compound-pobj,NNP-NNP-NNP,NNP-NNP-NNP,7,1
0,1.0,15,aired,2,5,8,3,4,6,-3,6,NBC,United States,ORG,LOC-LOC,PROPN,PROPN-PROPN,pobj,compound-pobj,NNP,NNP-NNP,1,1
0,0.0,18,is,3,1,6,5,0,11,2,3,Sweet and Lowdown,1999,MISC-MISC-MISC,TIME,PROPN-CCONJ-PROPN,NUM,nsubj-cc-conj,nummod,NNP-CC-NNP,CD,4,1
1,0.0,18,is,3,1,7,6,0,10,2,4,Sweet and Lowdown,American,MISC-MISC-MISC,LOC,PROPN-CCONJ-PROPN,ADJ,nsubj-cc-conj,amod,NNP-CC-NNP,JJ,5,1
2,0.0,18,is,3,1,16,15,0,1,2,13,Sweet and Lowdown,Woody Allen,MISC-MISC-MISC,PER-PER,PROPN-CCONJ-PROPN,PROPN-PROPN,nsubj-cc-conj,compound-pobj,NNP-CC-NNP,NNP-NNP,7,1
0,0.0,19,is,1,1,9,8,0,9,0,8,Idylwood,CDP,LOC,MISC,PROPN,PROPN,nsubj,appos,NNP,NNP,3,1
1,0.0,19,is,1,1,12,11,0,6,0,11,Idylwood,Fairfax County,LOC,LOC-LOC,PROPN,PROPN-PROPN,nsubj,compound-pobj,NNP,NNP-NNP,3,1
2,0.0,19,is,1,1,17,16,0,1,0,16,Idylwood,United States,LOC,LOC-LOC,PROPN,PROPN-PROPN,nsubj,compound-appos,NNP,NNP-NNP,4,1
3,0.0,19,is,1,12,15,3,11,3,-11,14,Fairfax County,Virginia,LOC-LOC,LOC,PROPN-PROPN,PROPN,compound-pobj,appos,NNP-NNP,NNP,1,1
4,0.0,19,is,1,12,17,5,11,1,-11,16,Fairfax County,United States,LOC-LOC,LOC-LOC,PROPN-PROPN,PROPN-PROPN,compound-pobj,compound-appos,NNP-NNP,NNP-NNP,1,1
5,0.0,19,is,1,15,17,2,14,1,-14,16,Virginia,United States,LOC,LOC-LOC,PROPN,PROPN-PROPN,appos,compound-appos,NNP,NNP-NNP,2,1
6,3.0,86,led,43,15,19,4,14,66,28,-24,Orange Line,Washington Metrorail,LOC-LOC,LOC-LOC,PROPN-PROPN,PROPN-PROPN,compound-conj,compound-compound,NNP-NNP,NNP-NNP,3,1
0,1.0,49,born,2,21,19,-2,20,29,-19,17,Latvia,Riga,LOC,LOC,PROPN,PROPN,appos,pobj,NNP,NNP,5,1
0,0.0,65,took,4,2,12,10,1,52,2,8,Battle of Groningen,Second World War,MISC-MISC-MISC,MISC-MISC-MISC,PROPN-ADP-PROPN,PROPN-PROPN-PROPN,nsubj-prep-pobj,compound-compound-pobj,NNP-IN-NNP,NNP-NNP-NNP,7,1
1,0.0,65,took,4,2,19,17,1,45,2,15,Battle of Groningen,"April 13 to 16 , 1945",MISC-MISC-MISC,TIME-TIME-TIME-TIME-TIME-TIME,PROPN-ADP-PROPN,PROPN-NUM-ADP-NUM-PUNCT-NUM,nsubj-prep-pobj,pobj-nummod-prep-pobj-punct-npadvmod,NNP-IN-NNP,"NNP-CD-IN-CD-,-CD",5,1
2,0.0,65,took,4,48,12,-36,47,52,-44,8,2nd Canadian Infantry Division,Second World War,ORG-ORG-ORG-ORG,MISC-MISC-MISC,ADJ-PROPN-PROPN-PROPN,PROPN-PROPN-PROPN,amod-compound-compound-pobj,compound-compound-pobj,JJ-NNP-NNP-NNP,NNP-NNP-NNP,10,1
3,0.0,65,took,4,12,16,4,11,48,-8,12,Second World War,Europe,MISC-MISC-MISC,LOC,PROPN-PROPN-PROPN,PROPN,compound-compound-pobj,pobj,NNP-NNP-NNP,NNP,6,1
0,0.0,36,Malfunkshun,0,1,9,8,0,26,-1,9,Malfunkshun : The Andrew Wood Story,2005,MISC-MISC-MISC-MISC-MISC-MISC,TIME,PROPN-PUNCT-DET-PROPN-PROPN-PROPN,NUM,ROOT-punct-det-compound-compound-nsubj,nummod,NNP-:-DT-NNP-NNP-NNP,CD,4,1
0,0.0,16,is,1,7,10,3,6,5,-6,9,Mukim Teja,Kampar District,LOC-LOC,LOC-LOC,PROPN-PROPN,PROPN-PROPN,compound-pobj,compound-conj,NNP-NNP,NNP-NNP,1,1
1,0.0,16,is,1,7,15,8,6,0,-6,14,Mukim Teja,Malaysia,LOC-LOC,LOC,PROPN-PROPN,PROPN,compound-pobj,appos,NNP-NNP,NNP,5,1
2,0.0,16,is,1,10,13,3,9,2,-9,12,Kampar District,Perak,LOC-LOC,LOC,PROPN-PROPN,PROPN,compound-conj,conj,NNP-NNP,NNP,2,1
3,0.0,16,is,1,10,15,5,9,0,-9,14,Kampar District,Malaysia,LOC-LOC,LOC,PROPN-PROPN,PROPN,compound-conj,appos,NNP-NNP,NNP,6,1
4,0.0,16,is,1,13,15,2,12,0,-12,14,Perak,Malaysia,LOC,LOC,PROPN,PROPN,conj,appos,NNP,NNP,8,1
0,0.0,22,was,11,7,18,11,6,3,4,7,Papiamentu,Kingdom of the Netherlands,MISC,LOC-LOC-LOC-LOC,NOUN,PROPN-ADP-DET-PROPN,appos,pobj-prep-det-pobj,NN,NNP-IN-DT-NNP,6,1
1,4.0,36,become,22,6,18,12,5,17,16,-4,Surinam,South America,LOC,LOC-LOC,PROPN,PROPN-PROPN,pobj,compound-pobj,NNP,NNP-NNP,6,1
0,7.0,26,changed,12,24,11,-13,23,14,-12,-1,Jutland Peninsula,Danish,LOC-LOC,LOC,PROPN-PROPN,ADJ,compound-pobj,amod,NNP-NNP,JJ,5,1
0,0.0,19,is,2,1,10,9,0,8,1,8,Dos Reales,the United States,ORG-ORG,LOC-LOC-LOC,PROPN-PROPN,DET-PROPN-PROPN,compound-nsubj,det-compound-pobj,NNP-NNP,DT-NNP-NNP,5,1
1,0.0,19,is,2,11,10,-1,10,8,-9,8,Midwest,the United States,LOC,LOC-LOC-LOC,PROPN,DET-PROPN-PROPN,pobj,det-compound-pobj,NNP,DT-NNP-NNP,1,1
2,0.0,19,is,2,13,10,-3,12,8,-11,8,Great Plains,the United States,LOC-LOC,LOC-LOC-LOC,ADJ-PROPN,DET-PROPN-PROPN,compound-conj,det-compound-pobj,JJ-NNPS,DT-NNP-NNP,1,1
3,2.0,28,founded,11,19,14,-5,18,13,-8,3,Leticia,Alvaro Quezada,PER,PER-PER,PROPN,PROPN-PROPN,appos,compound-pobj,NNP,NNP-NNP,2,1
0,0.0,41,is,20,1,10,9,0,30,19,-10,Evelina De Lain,2 February 1977,PER-PER-PER,TIME-TIME-TIME,PROPN-PROPN-PROPN,NUM-PROPN-NUM,compound-compound-nsubj,nummod-pobj-nummod,NNP-NNP-NNP,CD-NNP-CD,4,1
1,0.0,41,is,20,1,14,13,0,26,19,-6,Evelina De Lain,Zhovti Vody,PER-PER-PER,LOC-LOC,PROPN-PROPN-PROPN,PROPN-PROPN,compound-compound-nsubj,compound-pobj,NNP-NNP-NNP,NNP-NNP,4,1
2,0.0,41,is,20,14,19,5,13,21,6,-1,Zhovti Vody,Ukraine,LOC-LOC,LOC,PROPN-PROPN,PROPN,compound-pobj,appos,NNP-NNP,NNP,3,1
3,0.0,41,is,20,17,19,2,16,21,3,-1,Dnipropetrovsk,Ukraine,LOC,LOC,PROPN,PROPN,pobj,appos,NNP,NNP,2,1
0,5.0,53,included,51,38,41,3,37,11,13,-10,Braunlage,Sankt Andreasberg,LOC,LOC-LOC,PROPN,PROPN-PROPN,compound,compound-pobj,NNP,NNP-NNP,2,1
1,5.0,53,included,51,38,9,-29,37,43,13,-42,Braunlage,Goslar,LOC,LOC,PROPN,PROPN,compound,pobj,NNP,NNP,8,1
2,5.0,53,included,51,41,25,-16,40,27,10,-26,Sankt Andreasberg,Upper Harz,LOC-LOC,LOC-LOC,PROPN-PROPN,PROPN-PROPN,compound-pobj,compound-pobj,NNP-NNP,NNP-NNP,6,1
0,0.0,25,is,2,1,13,12,0,11,1,11,Hyrule Warriors,Omega Force,MISC-MISC,ORG-ORG,PROPN-PROPN,PROPN-PROPN,compound-nsubj,compound-pobj,NNP-NNPS,NNP-NNP,5,1
1,0.0,25,is,2,1,16,15,0,8,1,14,Hyrule Warriors,Team Ninja,MISC-MISC,ORG-ORG,PROPN-PROPN,PROPN-PROPN,compound-nsubj,compound-conj,NNP-NNPS,NNP-NNP,6,1
2,1.0,16,released,3,1,8,7,0,7,2,5,Hyrule Warriors,August 2014,MISC-MISC,TIME-TIME,PROPN-PROPN,PROPN-NUM,compound-nsubjpass,pobj-nummod,NNP-NNPS,NNP-CD,4,1
0,0.0,10,is,2,1,8,7,0,1,1,6,Athrips mongolorum,Gelechiidae,MISC-MISC,MISC,NOUN-NOUN,PROPN,compound-nsubj,compound,NNS-NN,NNP,4,1
1,1.0,18,found,2,14,16,2,13,1,-12,14,China,Ningxia,LOC,LOC,PROPN,PROPN,conj,appos,NNP,NNP,2,1
0,4.0,46,announced,7,5,43,38,4,2,2,36,Department of Energy,U.S.,ORG-ORG-ORG,LOC,PROPN-ADP-PROPN,PROPN,nsubj-prep-pobj,compound,NNP-IN-NNP,NNP,12,1
0,0.0,32,is,12,28,30,2,27,1,-16,18,Brooklyn,New York,LOC,LOC-LOC,PROPN,PROPN-PROPN,pobj,compound-appos,NNP,NNP-NNP,2,1
0,0.0,39,was,3,2,11,9,1,27,1,8,Balinese Room,Texas,LOC-LOC,LOC,PROPN-PROPN,PROPN,compound-nsubj,appos,NNP-NNP,NNP,3,1
1,0.0,39,was,3,2,13,11,1,25,1,10,Balinese Room,United States,LOC-LOC,LOC-LOC,PROPN-PROPN,PROPN-PROPN,compound-nsubj,compound-appos,NNP-NNP,NNP-NNP,4,1
2,0.0,39,was,3,9,13,4,8,25,-6,10,Galveston,United States,LOC,LOC-LOC,PROPN,PROPN-PROPN,pobj,compound-appos,NNP,NNP-NNP,5,1
3,0.0,39,was,3,9,36,27,8,2,-6,33,Galveston,Gulf of Mexico,LOC,LOC-LOC-LOC,PROPN,PROPN-ADP-PROPN,pobj,pobj-prep-pobj,NNP,NNP-IN-NNP,12,1
4,0.0,39,was,3,11,13,2,10,25,-8,10,Texas,United States,LOC,LOC-LOC,PROPN,PROPN-PROPN,appos,compound-appos,NNP,NNP-NNP,3,1
5,0.0,39,was,3,11,36,25,10,2,-8,33,Texas,Gulf of Mexico,LOC,LOC-LOC-LOC,PROPN,PROPN-ADP-PROPN,appos,pobj-prep-pobj,NNP,NNP-IN-NNP,10,1
0,0.0,25,is,5,19,24,5,18,0,-14,19,Farewell 1 Tour,2005,MISC-MISC-MISC,TIME,PROPN-NUM-NOUN,NUM,nmod-nummod-pobj,pobj,NNP-CD-NN,CD,7,1
1,3.0,33,performed,2,12,9,-3,11,23,-10,7,Soul Searchin ',Glenn Frey,MISC-MISC-MISC,PER-PER,PROPN-PROPN-PUNCT,PROPN-PROPN,compound-appos-punct,compound-pobj,NNP-NNP-'',NNP-NNP,1,1
2,3.0,33,performed,2,24,9,-15,23,23,-22,7,True Love,Glenn Frey,MISC-MISC,PER-PER,ADJ-NOUN,PROPN-PROPN,compound-pobj,compound-pobj,JJ-NN,NNP-NNP,5,1
3,3.0,33,performed,2,28,9,-19,27,23,-26,7,Strange Weather,Glenn Frey,MISC-MISC,PER-PER,PROPN-PROPN,PROPN-PROPN,compound-appos,compound-pobj,NNP-NNP,NNP-NNP,5,1
4,3.0,33,performed,2,31,9,-22,30,23,-29,7,After Hours,Glenn Frey,MISC-MISC,PER-PER,ADP-PROPN,PROPN-PROPN,conj-pobj,compound-pobj,IN-NNP,NNP-NNP,7,1
5,6.0,19,worked,2,13,11,-2,12,7,-11,9,Long Road Out of Eden,Eagles,MISC-MISC-MISC-MISC-MISC,ORG,PROPN-PROPN-ADP-ADP-PROPN,PROPN,compound-ROOT-advmod-prep-pobj,pobj,NNP-NNP-IN-IN-NNP,NNPS,1,1
0,2.0,35,assumed,3,11,15,4,10,19,-8,12,Star Trek reboot,2009,MISC-MISC-MISC,TIME,PROPN-PROPN-VERB,NUM,compound-compound-pobj,appos,NNP-NNP-VBD,CD,2,1
1,2.0,35,assumed,3,11,26,15,10,8,-8,23,Star Trek Into Darkness,2013,MISC-MISC-MISC-MISC,TIME,PROPN-PROPN-ADP-PROPN,NUM,compound-appos-prep-pobj,appos,NNP-NNP-IN-NNP,CD,5,1
2,2.0,35,assumed,3,11,11,0,10,23,-8,8,Star Trek Into Darkness,Star Trek Beyond,MISC-MISC-MISC-MISC,MISC-MISC-MISC,PROPN-PROPN-ADP-PROPN,PROPN-PROPN-PROPN,compound-appos-prep-pobj,compound-compound-conj,NNP-NNP-IN-NNP,NNP-NNP-NNP,0,1
0,0.0,18,is,4,2,7,5,1,10,2,3,Road to Ruin,1970,MISC-MISC-MISC,TIME,PROPN-ADP-PROPN,NUM,nsubj-prep-pobj,nummod,NNP-IN-NNP,CD,3,1
1,0.0,18,is,4,14,16,2,13,1,-10,12,John,Beverley Martyn,PER,PER-PER,PROPN,PROPN-PROPN,npadvmod,compound-conj,NNP,NNP-NNP,2,1
0,0.0,41,was,18,17,27,10,16,13,1,9,NSFP,Weimar Germany,ORG,LOC-LOC,PROPN,PROPN-PROPN,appos,compound-pobj,NNP,NNP-NNP,6,1
1,0.0,41,was,18,17,31,14,16,9,1,13,NSFP,April 1924,ORG,TIME-TIME,PROPN,PROPN-NUM,appos,pobj-nummod,NNP,NNP-CD,8,1
2,4.0,47,notes,2,34,31,-3,33,15,-32,29,Reinhold Wulle,NSFP,PER-PER,ORG,PROPN-PROPN,PROPN,compound-nsubj,compound,NNP-NNP,NNP,2,1
0,12.0,80,include,5,19,7,-12,18,72,-14,2,Guy Picciotto,Fugazi,PER-PER,ORG,PROPN-PROPN,PROPN,compound-poss,amod,NNP-NNP,NNP,3,1
0,0.0,14,is,6,1,5,4,0,8,5,-1,Philip Maneval,1956,PER-PER,TIME,PROPN-PROPN,NUM,compound-nsubj,npadvmod,NNP-NNP,CD,2,1
1,0.0,14,is,6,1,9,8,0,4,5,3,Philip Maneval,American,PER-PER,LOC,PROPN-PROPN,ADJ,compound-nsubj,amod,NNP-NNP,JJ,3,1
2,6.0,18,lives,5,8,10,2,7,7,-3,5,Swarthmore,Pennsylvania,LOC,LOC,PROPN,PROPN,pobj,appos,NNP,NNP,4,1
0,0.0,36,is,3,2,11,9,1,24,1,8,Kopelman Quartet,2002,ORG-ORG,TIME,PROPN-PROPN,NUM,compound-nsubj,pobj,NNP-NNP,CD,4,1
1,0.0,36,is,3,2,13,11,1,22,1,10,Kopelman Quartet,Mikhail Kopelman,ORG-ORG,PER-PER,PROPN-PROPN,PROPN-PROPN,compound-nsubj,compound-pobj,NNP-NNP,NNP-NNP,5,1
2,2.0,41,played,3,13,15,2,12,25,-10,12,Musikverein,Vienna,LOC,LOC,PROPN,PROPN,pobj,conj,NNP,NNP,3,1
3,4.0,38,included,3,32,5,-27,31,32,-29,2,Ravinia Festival,the United States,MISC-MISC,LOC-LOC-LOC,PROPN-PROPN,DET-PROPN-PROPN,compound-conj,det-compound-pobj,NNP-NNP,DT-NNP-NNP,7,1
0,7.0,21,shows,7,13,16,3,12,4,-6,9,Sveriges Television,Sweden,ORG-ORG,LOC,PROPN-PROPN,PROPN,compound-pobj,poss,NNP-NNP,NNP,3,1
1,7.0,21,shows,7,13,20,7,12,0,-6,13,Sveriges Television,Yle,ORG-ORG,ORG,PROPN-PROPN,PROPN,compound-pobj,pobj,NNP-NNP,NNP,5,1
0,0.0,16,was,11,1,4,3,0,11,10,-7,Kenneth Rowntree,14 March 1915,PER-PER,TIME-TIME-TIME,PROPN-PROPN,NUM-PROPN-NUM,compound-nsubj,nummod-appos-nummod,NNP-NNP,CD-NNP-CD,1,1
1,0.0,16,was,11,1,14,13,0,1,10,3,Kenneth Rowntree,British,PER-PER,LOC,PROPN-PROPN,ADJ,compound-nsubj,amod,NNP-NNP,JJ,2,1
2,2.0,33,was,22,16,30,14,15,2,6,8,First World War,Second World War,MISC-MISC-MISC,MISC-MISC-MISC,PROPN-PROPN-PROPN,PROPN-PROPN-PROPN,compound-nmod-nmod,compound-compound-pobj,NNP-NNP-NNP,NNP-NNP-NNP,8,1
3,2.0,33,was,22,6,10,4,5,22,16,-12,Howard Doncaster Rowntree,1879,PER-PER-PER,TIME,PROPN-PROPN-PROPN,NUM,compound-compound-pobj,npadvmod,NNP-NNP-NNP,CD,4,1
0,0.0,27,was,14,1,5,4,0,21,13,-9,William Stuart Reyburn,"December 17 , 1882",PER-PER-PER,TIME-TIME-TIME-TIME,PROPN-PROPN-PROPN,PROPN-NUM-PUNCT-NUM,compound-compound-nsubj,nmod-nummod-punct-nummod,NNP-NNP-NNP,"NNP-CD-,-CD",3,1
1,0.0,27,was,14,1,10,9,0,16,13,-4,William Stuart Reyburn,"July 25 , 1946",PER-PER-PER,TIME-TIME-TIME-TIME,PROPN-PROPN-PROPN,PROPN-NUM-PUNCT-NUM,compound-compound-nsubj,appos-nummod-punct-nummod,NNP-NNP-NNP,"NNP-CD-,-CD",4,1
2,0.0,27,was,14,1,17,16,0,9,13,3,William Stuart Reyburn,Republican,PER-PER-PER,ORG,PROPN-PROPN-PROPN,ADJ,compound-compound-nsubj,amod,NNP-NNP-NNP,JJ,3,1
3,1.0,18,born,2,1,5,4,0,12,1,3,Reyburn,Philadelphia,PER,LOC,PROPN,PROPN,nsubjpass,pobj,NNP,NNP,4,1
4,1.0,18,born,2,7,5,-2,6,12,-5,3,Pennsylvania,Philadelphia,LOC,LOC,PROPN,PROPN,appos,pobj,NNP,NNP,4,1
0,2.0,30,qualified,1,25,29,4,24,0,-24,28,2004 Summer Olympics,Athens,MISC-MISC-MISC,LOC,NUM-PROPN-PROPN,PROPN,nummod-compound-pobj,pobj,CD-NNP-NNPS,NNP,2,1
1,3.0,40,granted,3,31,35,4,30,4,-28,32,Atlanta,United States,LOC,LOC-LOC,PROPN,PROPN-PROPN,pobj,compound-appos,NNP,NNP-NNP,3,1
2,4.0,51,fired,1,23,26,3,22,24,-22,25,Amanda Mondol,Colombia,PER-PER,LOC,PROPN-PROPN,PROPN,compound-pobj,pobj,NNP-NNP,NNP,1,1
3,4.0,51,fired,1,30,33,3,29,17,-29,32,Margarita Tarradell,Cuba,PER-PER,LOC,PROPN-PROPN,PROPN,compound-conj,pobj,NNP-NNP,NNP,1,1
0,0.0,34,is,1,1,4,3,0,29,0,3,Proteus,2013,MISC,TIME,PROPN,NUM,nsubj,nummod,NNP,CD,2,1
1,0.0,34,is,1,1,21,20,0,12,0,20,Proteus,Microsoft Windows,MISC,MISC-MISC,PROPN,PROPN-PROPN,nsubj,compound-pobj,NNP,NNP-NNP,5,1
2,0.0,34,is,1,1,24,23,0,9,0,23,Proteus,OS X,MISC,MISC-MISC,PROPN,PROPN-PROPN,nsubj,compound-conj,NNP,NNP-NNP,2,1
3,0.0,34,is,1,1,27,26,0,6,0,26,Proteus,Linux,MISC,MISC,PROPN,PROPN,nsubj,conj,NNP,NNP,3,1
4,5.0,28,developed,9,8,12,4,7,15,1,3,Proteus,Curve Studios,MISC,ORG-ORG,PROPN,PROPN-PROPN,pobj,compound-pobj,NNP,NNP-NNPS,3,1
0,4.0,27,reflected,4,24,26,2,23,0,-20,22,Zeus,Hera,PER,PER,PROPN,PROPN,pobj,conj,NNP,NNP,8,1
1,4.0,27,reflected,4,24,12,-12,23,14,-20,8,Zeus,Eileithyia,PER,PER,PROPN,PROPN,pobj,pobj,NNP,NNP,7,1
2,4.0,27,reflected,4,26,12,-14,25,14,-22,8,Hera,Eileithyia,PER,PER,PROPN,PROPN,conj,pobj,NNP,NNP,3,1
0,0.0,21,was,11,1,4,3,0,16,10,-7,Renzo Montagnani,11 September 1930,PER-PER,TIME-TIME-TIME,PROPN-PROPN,NUM-PROPN-NUM,compound-nsubj,nummod-appos-nummod,NNP-NNP,CD-NNP-CD,1,1
1,0.0,21,was,11,1,14,13,0,6,10,3,Renzo Montagnani,Italian,PER-PER,LOC,PROPN-PROPN,ADJ,compound-nsubj,amod,NNP-NNP,JJ,3,1
2,1.0,21,born,2,1,5,4,0,15,1,3,Montagnani,Alessandria,PER,LOC,PROPN,PROPN,nsubjpass,pobj,NNP,NNP,4,1
3,1.0,21,born,2,5,7,2,4,13,-3,5,Alessandria,Piedmont,LOC,LOC,PROPN,PROPN,pobj,conj,NNP,NNP,4,1
4,2.0,41,was,4,33,37,4,32,3,-29,33,Amici miei,1982,MISC-MISC,TIME,PROPN-VERB,NUM,compound-compound,appos,NNP-VBD,CD,3,1
5,2.0,41,was,4,10,12,2,9,28,-6,8,Metello,1970,MISC,TIME,PROPN,NUM,pobj,appos,NNP,CD,2,1
6,6.0,9,died,1,1,4,3,0,4,0,3,Montagnani,Rome,PER,LOC,PROPN,PROPN,nsubj,pobj,NNP,NNP,3,1
0,0.0,16,is,6,1,5,4,0,10,5,-1,Bruce McLean,1944,PER-PER,TIME,PROPN-PROPN,NUM,compound-nsubj,npadvmod,NNP-NNP,CD,1,1
1,1.0,33,born,2,1,5,4,0,27,1,3,McLean,Glasgow School of Art,PER,ORG-ORG-ORG-ORG,PROPN,PROPN-PROPN-ADP-PROPN,nsubjpass,compound-pobj-prep-pobj,NNP,NNP-NNP-IN-NNP,2,1
2,6.0,27,had,2,9,12,3,8,14,-7,10,Tate Gallery,London,LOC-LOC,LOC,PROPN-PROPN,PROPN,compound-pobj,pobj,NNP-NNP,NNP,1,1
0,2.0,28,featured,3,11,17,6,10,10,-8,14,Sheer Heart Attack,1974,MISC-MISC-MISC,TIME,PROPN-PROPN-PROPN,NUM,compound-compound-npadvmod,pobj,NNP-NNP-NNP,CD,5,1
1,6.0,25,told,7,13,10,-3,12,14,-6,3,Mojo,British,MISC,LOC,PROPN,ADJ,dobj,amod,NNP,JJ,4,1
0,0.0,23,is,3,2,6,4,1,16,1,3,Reminiscing,1978,MISC,TIME,VERB,NUM,csubj,nummod,VBG,CD,3,1
1,6.0,22,used,7,1,17,16,0,4,6,10,The Other Guys,Will Ferrell,MISC-MISC-MISC,PER-PER,DET-PROPN-PROPN,PROPN-PROPN,det-compound-nsubj,compound-dobj,DT-NNP-NNPS,NNP-NNP,6,1
2,6.0,22,used,7,1,20,19,0,1,6,13,The Other Guys,Mark Wahlberg,MISC-MISC-MISC,PER-PER,DET-PROPN-PROPN,PROPN-PROPN,det-compound-nsubj,compound-conj,DT-NNP-NNPS,NNP-NNP,7,1
0,0.0,52,reigned,26,2,5,3,1,46,24,-21,John XXIII,25 November 1881,PER-PER,TIME-TIME-TIME,PROPN-PROPN,NUM-PROPN-NUM,compound-nsubj,nummod-appos-nummod,NNP-NNP,CD-NNP-CD,1,1
1,0.0,52,reigned,26,2,9,7,1,42,24,-17,John XXIII,3 June 1963,PER-PER,TIME-TIME-TIME,PROPN-PROPN,NUM-PROPN-NUM,compound-nsubj,nummod-npadvmod-nummod,NNP-NNP,CD-NNP-CD,2,1
2,0.0,52,reigned,26,2,23,21,1,28,24,-3,John XXIII,2 April 2005,PER-PER,TIME-TIME-TIME,PROPN-PROPN,NUM-PROPN-NUM,compound-nsubj,nummod-npadvmod-nummod,NNP-NNP,CD-NNP-CD,2,1
3,0.0,52,reigned,26,2,32,30,1,19,24,6,John XXIII,Roman Catholic Church,PER-PER,ORG-ORG-ORG,PROPN-PROPN,PROPN-PROPN-PROPN,compound-nsubj,compound-compound-pobj,NNP-NNP,NNP-NNP-NNP,6,1
4,0.0,52,reigned,26,2,39,37,1,12,24,13,John XXIII,Vatican City,PER-PER,LOC-LOC,PROPN-PROPN,PROPN-PROPN,compound-nsubj,compound-pobj,NNP-NNP,NNP-NNP,8,1
5,0.0,52,reigned,26,2,23,21,1,28,24,-3,John Paul II,2 April 2005,PER-PER-PER,TIME-TIME-TIME,PROPN-PROPN-PROPN,NUM-PROPN-NUM,compound-compound-conj,nummod-npadvmod-nummod,NNP-NNP-NNP,CD-NNP-CD,2,1
6,0.0,52,reigned,26,2,32,30,1,19,24,6,John Paul II,Roman Catholic Church,PER-PER-PER,ORG-ORG-ORG,PROPN-PROPN-PROPN,PROPN-PROPN-PROPN,compound-compound-conj,compound-compound-pobj,NNP-NNP-NNP,NNP-NNP-NNP,6,1
7,0.0,52,reigned,26,2,39,37,1,12,24,13,John Paul II,Vatican City,PER-PER-PER,LOC-LOC,PROPN-PROPN-PROPN,PROPN-PROPN,compound-compound-conj,compound-pobj,NNP-NNP-NNP,NNP-NNP,8,1
0,0.0,21,is,3,1,6,5,0,14,2,3,Club Sport Emelec,Ecuadorian,ORG-ORG-ORG,LOC,PROPN-PROPN-PROPN,ADJ,compound-compound-nsubj,amod,NNP-NNP-NNP,JJ,4,1
1,0.0,21,is,3,1,11,10,0,9,2,8,Club Sport Emelec,Guayaquil,ORG-ORG-ORG,LOC,PROPN-PROPN-PROPN,PROPN,compound-compound-nsubj,pobj,NNP-NNP-NNP,NNP,5,1
2,5.0,32,founded,2,1,10,9,0,21,1,8,Emelec,George Capwell,ORG,PER-PER,PROPN,PROPN-PROPN,nsubjpass,compound-pobj,NNP,NNP-NNP,3,1
0,0.0,26,was,1,1,8,7,0,17,0,7,Chelsea,New York City,ORG,TIME-TIME-TIME,PROPN,PROPN-PROPN-PROPN,nsubj,compound-compound-pobj,NNP,NNP-NNP-NNP,4,1
1,1.0,25,released,1,11,13,2,10,11,-10,12,Chelsea,1971,MISC,TIME,PROPN,NUM,appos,pobj,NNP,CD,2,1
0,0.0,27,was,13,23,26,3,22,0,-10,13,Rexist Party,Belgium,ORG-ORG,LOC,PROPN-PROPN,PROPN,compound-pobj,pobj,NNP-NNP,NNP,5,1
1,4.0,74,derives,4,10,14,4,9,59,-6,10,Charles Maurras,French,PER-PER,LOC,PROPN-PROPN,ADJ,compound-pobj,amod,NNP-NNP,JJ,1,1
0,0.0,17,was,12,1,15,14,0,1,11,3,Brian Malzard Foss,British,PER-PER-PER,LOC,PROPN-PROPN-PROPN,ADJ,compound-compound-nsubj,amod,NNP-NNP-NNP,JJ,3,1
1,5.0,17,Following,0,9,12,3,8,4,-9,12,Birkbeck College,London,ORG-ORG,LOC,PROPN-PROPN,PROPN,compound-pobj,appos,NNP-NNP,NNP,5,1
2,6.0,45,became,1,5,6,1,4,38,-4,5,Educational Psychology,Psychology,MISC-MISC,MISC,PROPN-PROPN,PROPN,compound-pobj,pobj,NNP-NNP,NNP,3,1
0,0.0,21,is,8,1,5,4,0,15,7,-3,Wolf Kahler,3 April 1940,PER-PER,TIME-TIME-TIME,PROPN-PROPN,NUM-PROPN-NUM,compound-nsubj,nummod-npadvmod-nummod,NNP-NNP,CD-NNP-CD,2,1
1,5.0,16,played,1,4,11,7,3,4,-3,10,Prince of Tübingen,1975,PER-PER-PER,TIME,PROPN-ADP-PROPN,NUM,dobj-prep-pobj,nummod,NNP-IN-NNP,CD,4,1
2,5.0,16,played,1,14,11,-3,13,4,-13,10,Barry Lyndon,1975,MISC-MISC,TIME,PROPN-PROPN,NUM,compound-appos,nummod,NNP-NNP,CD,1,1
3,7.0,16,played,10,12,14,2,11,1,-2,4,KGB,Yuri Andropov,ORG,PER-PER,PROPN,PROPN-PROPN,compound,compound-dobj,NNP,NNP-NNP,1,1
0,2.0,22,found,6,10,20,10,9,1,-4,14,Smoky Hill Chalk of the Niobrara Formation,United States,LOC-LOC-LOC-LOC-LOC-LOC-LOC,LOC-LOC,PROPN-PROPN-PROPN-ADP-DET-PROPN-PROPN,PROPN-PROPN,compound-compound-pobj-prep-det-compound-pobj,compound-appos,NNP-NNP-NNP-IN-DT-NNP-NNP,NNP-NNP,6,1
1,2.0,22,found,6,18,20,2,17,1,-12,14,Kansas,United States,LOC,LOC-LOC,PROPN,PROPN-PROPN,pobj,compound-appos,NNP,NNP-NNP,2,1
2,5.0,29,discovered,12,25,28,3,24,0,-13,16,Logan County,Kansas,LOC-LOC,LOC,PROPN-PROPN,PROPN,compound-pobj,appos,NNP-NNP,NNP,5,1
0,2.0,16,are,2,6,15,9,5,0,-4,13,Roppongi Hills Mori Tower,Tokyo,LOC-LOC-LOC-LOC,LOC,PROPN-PROPN-PROPN-PROPN,PROPN,compound-compound-compound-pobj,npadvmod,NNP-NNP-NNP-NNP,NNP,5,1
1,2.0,16,are,2,6,13,7,5,2,-4,11,Roppongi,Minato,LOC,LOC,PROPN,PROPN,pobj,appos,NNP,NNP,6,1
2,2.0,16,are,2,6,15,9,5,0,-4,13,Roppongi,Tokyo,LOC,LOC,PROPN,PROPN,pobj,npadvmod,NNP,NNP,5,1
0,0.0,45,is,4,1,8,7,0,36,3,4,Patmos,Greek,LOC,LOC,PROPN,ADJ,nsubj,amod,NNP,JJ,2,1
1,0.0,45,is,4,1,12,11,0,32,3,8,Patmos,Aegean Sea,LOC,LOC-LOC,PROPN,PROPN-PROPN,nsubj,compound-pobj,NNP,NNP-NNP,4,1
2,0.0,45,is,4,8,12,4,7,32,-4,8,Greek,Aegean Sea,LOC,LOC-LOC,ADJ,PROPN-PROPN,amod,compound-pobj,JJ,NNP-NNP,2,1
3,0.0,45,is,4,28,36,8,27,8,-24,32,John,New Testament,PER,MISC-MISC,PROPN,PROPN-PROPN,appos,compound-pobj,NNP,NNP-NNP,3,1
4,0.0,45,is,4,31,36,5,30,8,-27,32,Book of Revelation,New Testament,MISC-MISC-MISC,MISC-MISC,PROPN-ADP-PROPN,PROPN-PROPN,pobj-prep-pobj,compound-pobj,NNP-IN-NNP,NNP-NNP,3,1
0,0.0,27,Stein,2,1,5,4,0,21,1,3,Charles M. Stein,"March 22 , 1920",PER-PER-PER,TIME-TIME-TIME-TIME,PROPN-PROPN-PROPN,PROPN-NUM-PUNCT-NUM,compound-compound-ROOT,appos-nummod-punct-nummod,NNP-NNP-NNP,"NNP-CD-,-CD",3,1
1,0.0,27,Stein,2,1,10,9,0,16,1,8,Charles M. Stein,"November 24 , 2016",PER-PER-PER,TIME-TIME-TIME-TIME,PROPN-PROPN-PROPN,PROPN-NUM-PUNCT-NUM,compound-compound-ROOT,nsubj-nummod-punct-nummod,NNP-NNP-NNP,"NNP-CD-,-CD",3,1
2,0.0,27,Stein,2,1,17,16,0,9,1,15,Charles M. Stein,American,PER-PER-PER,LOC,PROPN-PROPN-PROPN,ADJ,compound-compound-ROOT,amod,NNP-NNP-NNP,JJ,4,1
0,4.0,43,featured,2,26,22,-4,25,20,-24,20,Maze,Kumi,MISC,PER,PROPN,PROPN,pobj,poss,NNP,NNP,3,1
0,0.0,26,is,8,1,6,5,0,19,7,-2,Street Mobster,Japan,MISC-MISC,LOC,PROPN-PROPN,PROPN,compound-nsubj,pobj,NNP-NNP,NNP,2,1
1,0.0,26,is,8,1,11,10,0,14,7,3,Street Mobster,1972,MISC-MISC,TIME,PROPN-PROPN,NUM,compound-nsubj,nummod,NNP-NNP,CD,3,1
2,0.0,26,is,8,1,17,16,0,8,7,9,Street Mobster,Kinji Fukasaku,MISC-MISC,PER-PER,PROPN-PROPN,PROPN-PROPN,compound-nsubj,compound-pobj,NNP-NNP,NNP-NNP,5,1
3,0.0,26,is,8,1,21,20,0,4,7,13,Street Mobster,Bunta Sugawara,MISC-MISC,PER-PER,PROPN-PROPN,PROPN-PROPN,compound-nsubj,compound-dobj,NNP-NNP,NNP-NNP,5,1
4,0.0,26,is,8,1,24,23,0,1,7,16,Street Mobster,Noboru Ando,MISC-MISC,PER-PER,PROPN-PROPN,PROPN-PROPN,compound-nsubj,compound-conj,NNP-NNP,NNP-NNP,6,1
0,0.0,18,was,3,1,17,16,0,0,2,14,Senieji Trakai Castle,Lithuania,LOC-LOC-LOC,LOC,PROPN-PROPN-PROPN,PROPN,compound-compound-nsubj,npadvmod,NNP-NNP-NNP,NNP,3,1
1,2.0,24,held,9,6,8,2,5,15,3,-1,Kęstutis,Birutė,PER,PER,PROPN,PROPN,pobj,conj,NNP,NNP,5,1
2,2.0,24,held,9,6,21,15,5,2,3,12,Kęstutis,Vytautas,PER,PER,PROPN,PROPN,pobj,pobj,NNP,NNP,6,1
3,2.0,24,held,9,8,21,13,7,2,1,12,Birutė,Vytautas,PER,PER,PROPN,PROPN,conj,pobj,NNP,NNP,3,1
4,2.0,24,held,9,21,23,2,20,0,-12,14,Vytautas,1350,PER,TIME,PROPN,NUM,pobj,pobj,NNP,CD,2,1
0,1.0,26,began,1,5,10,5,4,15,-4,9,Weimar Republic,Berlin,LOC-LOC,LOC,PROPN-PROPN,PROPN,compound-pobj,conj,NNP-NNP,NNP,4,1
0,0.0,23,was,13,1,4,3,0,18,12,-9,Clarence Profit,"June 26 , 1912",PER-PER,TIME-TIME-TIME-TIME,PROPN-PROPN,PROPN-NUM-PUNCT-NUM,compound-nsubj,nmod-nummod-punct-nummod,NNP-NNP,"NNP-CD-,-CD",2,1
1,0.0,23,was,13,1,9,8,0,13,12,-4,Clarence Profit,"October 22 , 1944",PER-PER,TIME-TIME-TIME-TIME,PROPN-PROPN,PROPN-NUM-PUNCT-NUM,compound-nsubj,appos-nummod-punct-nummod,NNP-NNP,"NNP-CD-,-CD",3,1
2,5.0,13,composed,3,6,11,5,5,1,-3,8,Lullaby In Rhythm,Edgar Sampson,MISC-MISC-MISC,PER-PER,PROPN-ADP-PROPN,PROPN-PROPN,dobj-prep-pobj,compound-pobj,NNP-IN-NNP,NNP-NNP,4,1
0,3.0,33,began,1,23,25,2,22,7,-22,24,Albury,Australia,LOC,LOC,PROPN,PROPN,pobj,pobj,NNP,NNP,2,1
0,0.0,32,is,1,1,14,13,0,17,0,13,Euryanthe,Carl Maria von Weber,MISC,PER-PER-PER-PER,PROPN,PROPN-PROPN-PROPN-PROPN,nsubj,compound-compound-compound-pobj,NNP,NNP-NNP-NNP-NNP,4,1
1,0.0,32,is,1,23,27,4,22,4,-22,26,Theater am Kärntnertor,Vienna,LOC-LOC-LOC,LOC,PROPN-VERB-PROPN,PROPN,pobj-ROOT-attr,appos,NNP-VBP-NNP,NNP,3,1
2,1.0,48,staged,15,39,43,4,38,4,-24,28,Rosamunde,Franz Schubert,MISC,PER-PER,PROPN,PROPN-PROPN,dobj,compound-nsubj,NNP,NNP-NNP,3,1
3,4.0,64,Freischütz,62,7,2,-5,6,61,55,-60,Alfonso und Estrella,Schubert,MISC-MISC-MISC,PER,PROPN-PROPN-PROPN,PROPN,amod-compound-pobj,poss,NNP-NNP-NNP,NNP,3,1
4,4.0,64,Freischütz,62,49,51,2,48,12,13,-11,Mozart,Die Zauberflöte,PER,MISC-MISC,PROPN,PROPN-PROPN,poss,compound-pobj,NNP,NNP-NNP,2,1
5,4.0,64,Freischütz,62,62,59,-3,61,4,0,-3,Der Freischütz,Weber,MISC-MISC,PER,PROPN-PROPN,PROPN,compound-ROOT,poss,NNP-NNP,NNP,2,1
0,0.0,34,is,13,1,5,4,0,28,12,-8,Louis Jani,"December 6 , 1957",PER-PER,TIME-TIME-TIME-TIME,PROPN-PROPN,PROPN-NUM-PUNCT-NUM,compound-nsubj,npadvmod-nummod-punct-nummod,NNP-NNP,"NNP-CD-,-CD",3,1
1,0.0,34,is,13,1,10,9,0,23,12,-3,Louis Jani,Montreal,PER-PER,LOC,PROPN-PROPN,PROPN,compound-nsubj,pobj,NNP-NNP,NNP,4,1
2,0.0,34,is,13,10,12,2,9,21,3,-1,Montreal,Quebec,LOC,LOC,PROPN,PROPN,pobj,appos,NNP,NNP,5,1
3,0.0,34,is,13,10,18,8,9,15,3,5,Montreal,Canada,LOC,LOC,PROPN,PROPN,pobj,pobj,NNP,NNP,9,1
4,1.0,14,missed,3,7,6,-1,6,7,-4,3,Moscow Olympics,1980,MISC-MISC,TIME,PROPN-PROPN,NUM,compound-dobj,nummod,NNP-NNPS,CD,1,1
5,4.0,27,led,4,16,18,2,15,8,-12,14,Sydney,Australia,LOC,LOC,PROPN,PROPN,pobj,appos,NNP,NNP,3,1
6,5.0,23,lives,3,6,8,2,5,14,-3,5,Ottawa,Ontario,LOC,LOC,PROPN,PROPN,pobj,conj,NNP,NNP,4,1
0,0.0,11,is,1,1,7,6,0,3,0,6,Kamerik,Dutch,LOC,LOC,PROPN,ADJ,nsubj,amod,NNP,JJ,3,1
0,15.0,19,campaign,0,12,9,-3,11,9,-12,9,John Howard,Australian,PER-PER,LOC,PROPN-PROPN,ADJ,compound-pobj,amod,NNP-NNP,JJ,2,1
0,0.0,34,is,13,1,10,9,0,23,12,-3,David Eaton,Cleveland,PER-PER,LOC,PROPN-PROPN,PROPN,compound-nsubj,npadvmod,NNP-NNP,NNP,2,1
0,0.0,30,is,4,2,18,16,1,11,2,14,Stephen Phillips House,Salem,LOC-LOC-LOC,LOC,PROPN-PROPN-PROPN,PROPN,compound-compound-nsubj,pobj,NNP-NNP-NNP,NNP,4,1
1,0.0,30,is,4,2,20,18,1,9,2,16,Stephen Phillips House,Massachusetts,LOC-LOC-LOC,LOC,PROPN-PROPN-PROPN,PROPN,compound-compound-nsubj,conj,NNP-NNP-NNP,NNP,5,1
2,0.0,30,is,4,2,22,20,1,7,2,18,Stephen Phillips House,United States,LOC-LOC-LOC,LOC-LOC,PROPN-PROPN-PROPN,PROPN-PROPN,compound-compound-nsubj,compound-conj,NNP-NNP-NNP,NNP-NNP,5,1
3,0.0,30,is,4,14,18,4,13,11,-10,14,McIntire Historic District,Salem,LOC-LOC-LOC,LOC,PROPN-PROPN-PROPN,PROPN,compound-compound-pobj,pobj,NNP-NNP-NNP,NNP,5,1
4,0.0,30,is,4,14,20,6,13,9,-10,16,McIntire Historic District,Massachusetts,LOC-LOC-LOC,LOC,PROPN-PROPN-PROPN,PROPN,compound-compound-pobj,conj,NNP-NNP-NNP,NNP,6,1
5,0.0,30,is,4,14,22,8,13,7,-10,18,McIntire Historic District,United States,LOC-LOC-LOC,LOC-LOC,PROPN-PROPN-PROPN,PROPN-PROPN,compound-compound-pobj,compound-conj,NNP-NNP-NNP,NNP-NNP,6,1
6,0.0,30,is,4,18,22,4,17,7,-14,18,Salem,United States,LOC,LOC-LOC,PROPN,PROPN-PROPN,pobj,compound-conj,NNP,NNP-NNP,3,1
7,0.0,30,is,4,20,22,2,19,7,-16,18,Massachusetts,United States,LOC,LOC-LOC,PROPN,PROPN-PROPN,conj,compound-conj,NNP,NNP-NNP,2,1
0,0.0,25,is,9,1,18,17,0,6,8,9,Mario,Shigeru Miyamoto,PER,PER-PER,PROPN,PROPN-PROPN,nsubj,compound-pobj,NNP,NNP-NNP,6,1
0,0.0,62,is,3,1,6,5,0,55,2,3,A Free Soul,1931,MISC-MISC-MISC,TIME,DET-PROPN-PROPN,NUM,det-compound-nsubj,nummod,DT-NNP-NNP,CD,4,1
1,0.0,62,is,3,1,20,19,0,41,2,17,A Free Soul,San Francisco,MISC-MISC-MISC,LOC-LOC,DET-PROPN-PROPN,PROPN-PROPN,det-compound-nsubj,compound-compound,DT-NNP-NNP,NNP-NNP,8,1
2,1.0,17,Shearer,5,1,5,4,0,11,4,0,A Free Soul,Norma Shearer,MISC-MISC-MISC,PER-PER,DET-PROPN-PROPN,PROPN-PROPN,det-compound-nsubj,compound-ROOT,DT-NNP-NNP,NNP-NNP,3,1
3,1.0,17,Shearer,5,1,8,7,0,8,4,3,A Free Soul,Leslie Howard,MISC-MISC-MISC,PER-PER,DET-PROPN-PROPN,PROPN-PROPN,det-compound-nsubj,compound-conj,DT-NNP-NNP,NNP-NNP,4,1
4,1.0,17,Shearer,5,1,11,10,0,5,4,6,A Free Soul,Lionel Barrymore,MISC-MISC-MISC,PER-PER,DET-PROPN-PROPN,PROPN-PROPN,det-compound-nsubj,compound-conj,DT-NNP-NNP,NNP-NNP,5,1
5,1.0,17,Shearer,5,1,15,14,0,1,4,10,A Free Soul,Clark Gable,MISC-MISC-MISC,PER-PER,DET-PROPN-PROPN,PROPN-PROPN,det-compound-nsubj,compound-conj,DT-NNP-NNP,NNP-NNP,6,1
6,2.0,35,became,3,7,23,16,6,11,-4,20,Barrymore,Academy Award for Best Actor,PER,MISC-MISC-MISC-MISC-MISC,PROPN,PROPN-PROPN-ADP-PROPN-PROPN,poss,compound-dobj-prep-compound-pobj,NNP,NNP-NNP-IN-NNP-NNP,7,1
0,0.0,46,is,4,2,17,15,1,28,2,13,Bridge River Country,British Columbia,LOC-LOC-LOC,LOC-LOC,PROPN-PROPN-PROPN,PROPN-PROPN,compound-compound-nsubj,compound-pobj,NNP-NNP-NNP,NNP-NNP,7,1
1,0.0,46,is,4,2,20,18,1,25,2,16,Bridge River Country,Canada,LOC-LOC-LOC,LOC,PROPN-PROPN-PROPN,PROPN,compound-compound-nsubj,appos,NNP-NNP-NNP,NNP,3,1
2,0.0,46,is,4,17,20,3,16,25,-13,16,British Columbia,Canada,LOC-LOC,LOC,PROPN-PROPN,PROPN,compound-pobj,appos,NNP-NNP,NNP,6,1
0,0.0,38,Greystoke,0,1,14,13,0,23,-1,14,"Greystoke : The Legend of Tarzan , Lord of the Apes",1984,MISC-MISC-MISC-MISC-MISC-MISC-MISC-MISC-MISC-MISC-MISC,TIME,PROPN-PUNCT-DET-PROPN-ADP-PROPN-PUNCT-PROPN-ADP-DET-PROPN,NUM,ROOT-punct-det-nsubj-prep-pobj-punct-appos-prep-det-pobj,nummod,"NNP-:-DT-NNP-IN-NNP-,-NNP-IN-DT-NNPS",CD,5,1
1,0.0,38,Greystoke,0,1,21,20,0,16,-1,21,"Greystoke : The Legend of Tarzan , Lord of the Apes",Hugh Hudson,MISC-MISC-MISC-MISC-MISC-MISC-MISC-MISC-MISC-MISC-MISC,PER-PER,PROPN-PUNCT-DET-PROPN-ADP-PROPN-PUNCT-PROPN-ADP-DET-PROPN,PROPN-PROPN,ROOT-punct-det-nsubj-prep-pobj-punct-appos-prep-det-pobj,compound-pobj,"NNP-:-DT-NNP-IN-NNP-,-NNP-IN-DT-NNPS",NNP-NNP,6,1
2,0.0,38,Greystoke,0,6,36,30,5,1,-6,36,Tarzan of the Apes,1912,MISC-MISC-MISC-MISC,TIME,PROPN-ADP-DET-PROPN,NUM,pobj-prep-det-pobj,appos,NNP-IN-DT-NNPS,CD,9,1
3,3.0,40,went,1,12,17,5,11,22,-11,16,57th Academy Awards,Best Actor in a Supporting Role,MISC-MISC-MISC,MISC-MISC-MISC-MISC-MISC-MISC,ADJ-PROPN-PROPN,PROPN-PROPN-ADP-DET-PROPN-PROPN,amod-compound-compound,compound-pobj-prep-det-compound-pobj,JJ-NNP-NNPS,NNP-NNP-IN-DT-NNP-NNP,4,1
4,3.0,40,went,1,12,17,5,11,22,-11,16,57th Academy Awards,Best Writing,MISC-MISC-MISC,MISC-MISC,ADJ-PROPN-PROPN,PROPN-PROPN,amod-compound-compound,compound-conj,JJ-NNP-NNPS,NNP-NNP,4,1
5,3.0,40,went,1,12,17,5,11,22,-11,16,57th Academy Awards,Best Makeup,MISC-MISC-MISC,MISC-MISC,ADJ-PROPN-PROPN,PROPN-PROPN,amod-compound-compound,compound-conj,JJ-NNP-NNPS,NNP-NNP,4,1
0,0.0,26,is,14,1,11,10,0,14,13,-3,Kelly Williams Brown,Covington,PER-PER-PER,LOC,PROPN-PROPN-PROPN,PROPN,compound-compound-nsubj,pobj,NNP-NNP-NNP,NNP,5,1
1,0.0,26,is,14,11,22,11,10,3,3,8,Covington,American,LOC,LOC,PROPN,ADJ,pobj,amod,NNP,JJ,6,1
2,0.0,26,is,14,13,22,9,12,3,1,8,Louisiana,American,LOC,LOC,PROPN,ADJ,appos,amod,NNP,JJ,4,1
0,2.0,32,reborn,4,8,16,8,7,15,-4,12,Confessin,Al Neiburg,MISC,PER-PER,PROPN,PROPN-PROPN,pobj,compound-pobj,NNP,NNP-NNP,8,1
0,0.0,33,was,11,1,5,4,0,27,10,-6,Ahmed Djoghlaf,25 November 1953,PER-PER,TIME-TIME-TIME,PROPN-PROPN,NUM-PROPN-NUM,compound-nsubj,nummod-npadvmod-nummod,NNP-NNP,CD-NNP-CD,2,1
1,0.0,33,was,11,1,9,8,0,23,10,-2,Ahmed Djoghlaf,Algiers,PER-PER,LOC,PROPN-PROPN,PROPN,compound-nsubj,pobj,NNP-NNP,NNP,2,1
0,2.0,34,demonstrated,4,31,10,-21,30,23,-27,6,Montreux Jazz Festival,Switzerland,MISC-MISC-MISC,LOC,PROPN-PROPN-PROPN,PROPN,compound-compound-pobj,pobj,NNP-NNP-NNP,NNP,9,1
0,0.0,14,is,9,1,6,5,0,7,8,-3,Sergey Semyonovich Sobyanin,21 June 1958,PER-PER-PER,TIME-TIME-TIME,PROPN-PROPN-PROPN,NUM-PROPN-NUM,compound-compound-compound,nummod-npadvmod-nummod,NNP-NNP-NNP,CD-NNP-CD,3,1
1,2.0,41,served,2,24,18,-6,23,22,-22,16,Mikhail Fradkov,Russia,PER-PER,LOC,PROPN-PROPN,PROPN,compound-poss,pobj,NNP-NNP,NNP,4,1
2,4.0,20,considered,2,13,10,-3,12,9,-11,8,Vladimir Bogdanov,Russian,PER-PER,LOC,PROPN-PROPN,ADJ,compound-pobj,amod,NNP-NNP,JJ,2,1
3,4.0,20,considered,2,19,10,-9,18,9,-17,8,Surgutneftegaz,Russian,ORG,LOC,PROPN,ADJ,pobj,amod,NNP,JJ,7,1
0,1.0,22,known,3,14,20,6,13,1,-11,17,The Motor City Machine Guns,Chris Sabin,MISC-MISC-MISC-MISC-MISC,PER-PER,DET-PROPN-PROPN-PROPN-PROPN,PROPN-PROPN,det-compound-compound-compound-pobj,compound-pobj,DT-NNP-NNP-NNP-NNP,NNP-NNP,4,1
0,0.0,55,was,36,1,5,4,0,49,35,-31,Jaja Anucha Wachuku,1 January 1918,PER-PER-PER,TIME-TIME-TIME,PROPN-PROPN-PROPN,NUM-PROPN-NUM,compound-compound-nsubj,nummod-appos-nummod,NNP-NNP-NNP,CD-NNP-CD,2,1
1,0.0,55,was,36,1,9,8,0,45,35,-27,Jaja Anucha Wachuku,7 November 1996,PER-PER-PER,TIME-TIME-TIME,PROPN-PROPN-PROPN,NUM-PROPN-NUM,compound-compound-nsubj,nummod-appos-nummod,NNP-NNP-NNP,CD-NNP-CD,2,1
2,1.0,26,was,1,8,8,0,7,17,-7,7,Nigerian House of Representatives,Nigerian,ORG-ORG-ORG-ORG,LOC,PROPN-PROPN-ADP-PROPN,PROPN,compound-pobj-prep-pobj,amod,NNP-NNP-IN-NNPS,NNP,0,1
3,5.0,60,was,28,58,53,-5,57,6,-30,25,Goodluck Jonathan,Pioneer Political Leader,PER-PER,MISC-MISC-MISC,PROPN-PROPN,PROPN-PROPN-PROPN,compound-pobj,compound-compound-conj,NNP-NNP,NNP-NNP-NNP,4,1
0,0.0,8,is,3,1,6,5,0,1,2,3,Samantha Jane Sacramento,Gibraltar,PER-PER-PER,LOC,PROPN-PROPN-PROPN,PROPN,compound-compound-nsubj,compound,NNP-NNP-NNP,NNP,3,1
1,2.0,7,born,3,1,6,5,0,0,2,3,Samantha Sacramento,Gibraltar,PER-PER,LOC,PROPN-PROPN,PROPN,compound-nsubjpass,pobj,NNP-NNP,NNP,2,1
2,3.0,24,attended,1,11,15,4,10,8,-10,14,University of Wales,Cardiff,ORG-ORG-ORG,LOC,PROPN-ADP-PROPN,PROPN,pobj-prep-pobj,pobj,NNP-IN-NNP,NNP,4,1
3,7.0,23,elected,2,1,9,8,0,13,1,7,Sacramento,Gibraltar Socialist Labour Party,PER,ORG-ORG-ORG-ORG,PROPN,PROPN-PROPN-PROPN-PROPN,nsubjpass,compound-compound-compound-pobj,NNP,NNP-NNP-NNP-NNP,5,1
0,6.0,29,voted,5,4,8,4,3,20,1,3,Carner,Bob Jones Award,PER,MISC-MISC-MISC,PROPN,PROPN-PROPN-PROPN,nsubjpass,compound-compound-dobj,NNP,NNP-NNP-NNP,3,1
0,0.0,54,Am,1,1,37,36,0,16,0,36,I Am Curious ( Blue ),1968,MISC-MISC-MISC-MISC-MISC-MISC,TIME,PRON-VERB-PROPN-PUNCT-PROPN-PUNCT,NUM,nsubj-ROOT-attr-punct-appos-punct,nummod,PRP-VBP-NNP--LRB--NNP--RRB-,CD,3,1
1,0.0,54,Am,1,1,42,41,0,11,0,41,I Am Curious ( Blue ),Vilgot Sjöman,MISC-MISC-MISC-MISC-MISC-MISC,PER-PER,PRON-VERB-PROPN-PUNCT-PROPN-PUNCT,PROPN-PROPN,nsubj-ROOT-attr-punct-appos-punct,compound-pobj,PRP-VBP-NNP--LRB--NNP--RRB-,NNP-NNP,5,1
0,2.0,14,is,7,7,12,5,6,1,0,5,Hickenlooper,Wesleyan University,PER,ORG-ORG,PROPN,PROPN-PROPN,nsubj,compound-pobj,NNP,NNP-NNP,3,1
1,7.0,26,elected,4,14,16,2,13,9,-10,12,Republican,U.S.,ORG,LOC,ADJ,PROPN,amod,compound,JJ,NNP,1,1
0,0.0,22,is,1,11,14,3,10,7,-10,13,Long Branch,Monmouth County,LOC-LOC,LOC-LOC,PROPN-PROPN,PROPN-PROPN,compound-pobj,compound-conj,NNP-NNP,NNP-NNP,1,1
1,0.0,22,is,1,11,20,9,10,1,-10,19,Long Branch,United States,LOC-LOC,LOC-LOC,PROPN-PROPN,PROPN-PROPN,compound-pobj,compound-conj,NNP-NNP,NNP-NNP,3,1
2,0.0,22,is,1,14,17,3,13,4,-13,16,Monmouth County,New Jersey,LOC-LOC,LOC-LOC,PROPN-PROPN,PROPN-PROPN,compound-conj,compound-conj,NNP-NNP,NNP-NNP,1,1
3,0.0,22,is,1,14,20,6,13,1,-13,19,Monmouth County,United States,LOC-LOC,LOC-LOC,PROPN-PROPN,PROPN-PROPN,compound-conj,compound-conj,NNP-NNP,NNP-NNP,2,1
4,0.0,22,is,1,17,20,3,16,1,-16,19,New Jersey,United States,LOC-LOC,LOC-LOC,PROPN-PROPN,PROPN-PROPN,compound-conj,compound-conj,NNP-NNP,NNP-NNP,1,1
0,0.0,37,is,14,1,5,4,0,31,13,-9,Mats Rådberg,8 June 1948,PER-PER,TIME-TIME-TIME,PROPN-PROPN,NUM-PROPN-NUM,compound-nsubj,nummod-npadvmod-nummod,NNP-NNP,CD-NNP-CD,2,1
1,0.0,37,is,14,1,9,8,0,27,13,-5,Mats Rådberg,Brännkyrka Parish,PER-PER,LOC-LOC,PROPN-PROPN,PROPN-PROPN,compound-nsubj,compound-pobj,NNP-NNP,NNP-NNP,3,1
2,0.0,37,is,14,1,17,16,0,19,13,3,Mats Rådberg,Swedish,PER-PER,LOC,PROPN-PROPN,ADJ,compound-nsubj,amod,NNP-NNP,JJ,4,1
3,0.0,37,is,14,12,17,5,11,19,2,3,Stockholm,Swedish,LOC,LOC,PROPN,ADJ,pobj,amod,NNP,JJ,3,1
0,0.0,35,marked,10,2,9,7,1,25,8,-1,Occupation of the Hainburger Au,December 1984,LOC-LOC-LOC-LOC-LOC,TIME-TIME,PROPN-ADP-DET-PROPN-PROPN,PROPN-NUM,nsubj-prep-det-compound-pobj,pobj-nummod,NNP-IN-DT-NNP-NNP,NNP-CD,5,1
1,0.0,35,marked,10,2,34,32,1,0,8,24,Occupation of the Hainburger Au,Austria,LOC-LOC-LOC-LOC-LOC,LOC,PROPN-ADP-DET-PROPN-PROPN,PROPN,nsubj-prep-det-compound-pobj,pobj,NNP-IN-DT-NNP-NNP,NNP,4,1
0,0.0,26,was,13,1,4,3,0,21,12,-9,Imre Makovecz,"November 20 , 1935",PER-PER,TIME-TIME-TIME-TIME,PROPN-PROPN,PROPN-NUM-PUNCT-NUM,compound-nsubj,appos-nummod-punct-nummod,NNP-NNP,"NNP-CD-,-CD",2,1
1,0.0,26,was,13,1,9,8,0,16,12,-4,Imre Makovecz,"September 27 , 2011",PER-PER,TIME-TIME-TIME-TIME,PROPN-PROPN,PROPN-NUM-PUNCT-NUM,compound-nsubj,appos-nummod-punct-nummod,NNP-NNP,"NNP-CD-,-CD",2,1
2,0.0,26,was,13,1,16,15,0,9,12,3,Imre Makovecz,Hungarian,PER-PER,LOC,PROPN-PROPN,ADJ,compound-nsubj,amod,NNP-NNP,JJ,2,1
3,1.0,8,born,2,1,7,6,0,0,1,5,Makovecz,Budapest,PER,LOC,PROPN,PROPN,nsubjpass,pobj,NNP,NNP,2,1
0,0.0,18,is,8,1,5,4,0,12,7,-3,José Biriukov,3 February 1963,PER-PER,TIME-TIME-TIME,PROPN-PROPN,NUM-PROPN-NUM,compound-nsubj,nummod-npadvmod-nummod,NNP-NNP,CD-NNP-CD,2,1
0,0.0,28,is,5,24,26,2,23,1,-19,21,Tree,2014,MISC,TIME,PROPN,NUM,appos,appos,NNP,CD,2,1
1,1.0,33,released,12,23,31,8,22,1,-11,19,Something,Avex Trax,MISC,ORG-ORG,NOUN,PROPN-PROPN,pobj,compound-pobj,NN,NNP-NNP,3,1
0,0.0,29,is,8,1,5,4,0,23,7,-3,Simon Luhrs,18 June 1970,PER-PER,TIME-TIME-TIME,PROPN-PROPN,NUM-PROPN-NUM,compound-nsubj,nummod-npadvmod-nummod,NNP-NNP,CD-NNP-CD,2,1
1,5.0,24,got,1,16,8,-8,15,15,-15,7,Hawthorn,AFL,ORG,ORG,PROPN,PROPN,pobj,compound,NNP,NNP,3,1
0,0.0,16,was,7,1,15,14,0,0,6,8,Gardianul,Bucharest,MISC,LOC,PROPN,PROPN,nsubj,pobj,NNP,NNP,4,1
0,0.0,23,are,3,2,22,20,1,0,1,19,Galápagos Islands,Ecuador,LOC-LOC,LOC,PROPN-PROPN,PROPN,compound-nsubj,pobj,NNP-NNPS,NNP,2,1
0,0.0,41,is,4,2,15,13,1,25,2,11,Parish of Bherwerre,New South Wales,LOC-LOC-LOC,LOC-LOC-LOC,PROPN-ADP-PROPN,PROPN-PROPN-PROPN,nsubj-prep-pobj,compound-compound-pobj,NNP-IN-NNP,NNP-NNP-NNP,8,1
1,0.0,41,is,4,10,15,5,9,25,-6,11,County of St Vincent,New South Wales,LOC-LOC-LOC-LOC,LOC-LOC-LOC,PROPN-ADP-PROPN-PROPN,PROPN-PROPN-PROPN,pobj-prep-compound-pobj,compound-compound-pobj,NNP-IN-NNP-NNP,NNP-NNP-NNP,5,1
0,0.0,16,was,4,1,13,12,0,2,3,9,Bullet Train for Australia,2013,ORG-ORG-ORG-ORG,TIME,PROPN-PROPN-ADP-PROPN,NUM,compound-nsubj-prep-pobj,pobj,NNP-NNP-IN-NNP,CD,4,1
1,3.0,35,grew,2,14,7,-7,13,27,-12,5,Tim Bohm,Bullet Train for Canberra party,PER-PER,MISC-MISC-MISC-MISC-MISC,PROPN-PROPN,PROPN-PROPN-ADP-PROPN-NOUN,compound-pobj,compound-pobj-prep-compound-pobj,NNP-NNP,NNP-NNP-IN-NNP-NN,6,1
2,5.0,12,involved,3,6,9,3,5,2,-3,6,Glenn Druery,Minor Party Alliance,PER-PER,ORG-ORG-ORG,PROPN-PROPN,PROPN-PROPN-PROPN,compound-poss,compound-compound-pobj,NNP-NNP,NNP-NNP-NNP,2,1
0,0.0,19,is,8,1,5,4,0,13,7,-3,Ralf Scheepers,5 February 1965,PER-PER,TIME-TIME-TIME,PROPN-PROPN,NUM-PROPN-NUM,compound-nsubj,nummod-npadvmod-nummod,NNP-NNP,CD-NNP-CD,2,1
1,0.0,19,is,8,1,17,16,0,1,7,9,Ralf Scheepers,Primal Fear,PER-PER,ORG-ORG,PROPN-PROPN,PROPN-PROPN,compound-nsubj,compound-pobj,NNP-NNP,NNP-NNP,-1,1
2,1.0,45,has,1,20,23,3,19,21,-19,22,Judas Priest,Rob Halford,ORG-ORG,PER-PER,PROPN-PROPN,PROPN-PROPN,compound-poss,compound-pobj,NNP-NNP,NNP-NNP,1,1
3,4.0,26,provides,2,23,25,2,22,0,-21,23,Baltmannsweiler,Germany,LOC,LOC,PROPN,PROPN,pobj,appos,NNP,NNP,10,1
0,1.0,26,auditioned,10,10,5,-5,9,20,0,-5,Malik,Bradford,PER,LOC,PROPN,PROPN,nsubj,pobj,NNP,NNP,5,1
1,1.0,26,auditioned,10,10,7,-3,9,18,0,-3,Malik,West Yorkshire,PER,LOC-LOC,PROPN,PROPN-PROPN,nsubj,compound-appos,NNP,NNP-NNP,5,1
2,1.0,26,auditioned,10,5,7,2,4,18,5,-3,Bradford,West Yorkshire,LOC,LOC-LOC,PROPN,PROPN-PROPN,pobj,compound-appos,NNP,NNP-NNP,2,1
3,3.0,18,left,1,1,16,15,0,1,0,15,Malik,RCA Records,PER,ORG-ORG,PROPN,PROPN-PROPN,nsubj,compound-pobj,NNP,NNP-NNPS,4,1
4,4.0,54,became,29,29,5,-24,28,48,0,-24,Malik,R&B,PER,MISC,PROPN,NOUN,nsubj,dobj,NNP,NN,3,1
5,4.0,54,became,29,14,18,4,13,35,15,-11,Mind of Mine,2016,MISC-MISC-MISC,TIME,PROPN-ADP-PROPN,NUM,appos-prep-pobj,appos,NNP-IN-NNP,CD,4,1
0,0.0,42,"""",0,2,10,8,1,31,-2,10,My Story,R&B,MISC-MISC,MISC,DET-NOUN,PROPN,poss-nsubj,pobj,PRP$-NN,NNP,2,1
0,0.0,14,located,4,1,11,10,0,2,3,7,Fawkner,Victoria,LOC,LOC,NOUN,PROPN,compound,pobj,NN,NNP,7,1
1,0.0,14,located,4,1,13,12,0,0,3,9,Fawkner,Australia,LOC,LOC,NOUN,PROPN,compound,appos,NN,NNP,3,1
2,0.0,14,located,4,8,11,3,7,2,-4,7,Upfield,Victoria,LOC,LOC,PROPN,PROPN,compound,pobj,NNP,NNP,3,1
3,0.0,14,located,4,8,13,5,7,0,-4,9,Upfield,Australia,LOC,LOC,PROPN,PROPN,compound,appos,NNP,NNP,3,1
4,0.0,14,located,4,11,13,2,10,0,-7,9,Victoria,Australia,LOC,LOC,PROPN,PROPN,pobj,appos,NNP,NNP,6,1
0,4.0,23,born,2,1,5,4,0,17,1,3,Hollister,Kalamazoo,PER,LOC,PROPN,PROPN,nsubjpass,pobj,NNP,NNP,2,1
1,8.0,31,recruited,4,27,17,-10,26,13,-23,13,East Lansing,Michigan,LOC-LOC,LOC,PROPN-PROPN,PROPN,compound-conj,pobj,NNP-NNP,NNP,5,1
0,0.0,30,was,11,1,6,5,0,23,10,-5,Jean IV de Brosse,1505,PER-PER-PER-PER,TIME,PROPN-PROPN-X-PROPN,NUM,compound-compound-nmod-nsubj,appos,NNP-NNP-FW-NNP,CD,3,1
1,0.0,30,was,11,1,8,7,0,21,10,-3,Jean IV de Brosse,Lamballe,PER-PER-PER-PER,LOC,PROPN-PROPN-X-PROPN,PROPN,compound-compound-nmod-nsubj,compound,NNP-NNP-FW-NNP,NNP,3,1
2,0.0,30,was,11,1,10,9,0,19,10,-1,Jean IV de Brosse,1564,PER-PER-PER-PER,TIME,PROPN-PROPN-X-PROPN,NUM,compound-compound-nmod-nsubj,nummod,NNP-NNP-FW-NNP,CD,2,1
3,0.0,30,was,11,1,16,15,0,13,10,5,Jean IV de Brosse,René de Brosse,PER-PER-PER-PER,PER-PER-PER,PROPN-PROPN-X-PROPN,PROPN-PROPN-PROPN,compound-compound-nmod-nsubj,nmod-nmod-pobj,NNP-NNP-FW-NNP,NNP-NNP-NNP,6,1
4,2.0,30,married,4,14,17,3,13,12,-10,13,Francis I,France,PER-PER,LOC,PROPN-PROPN,PROPN,compound-pobj,pobj,NNP-NNP,NNP,5,1
0,3.0,29,participated,5,14,16,2,13,12,-9,11,Stockholm,Sweden,LOC,LOC,PROPN,PROPN,pobj,appos,NNP,NNP,6,1
0,0.0,22,is,3,1,1,0,0,20,2,-2,Kilju Ch'ŏngnyŏn Station,Kilju - ŭp,LOC-LOC-LOC,LOC-LOC-LOC,PROPN-PROPN-PROPN,PROPN-PUNCT-PROPN,compound-compound-nsubj,compound-punct-pobj,NNP-NNP-NNP,NNP-HYPH-NNP,0,1
1,0.0,22,is,3,1,16,15,0,5,2,13,Kilju Ch'ŏngnyŏn Station,North Korea,LOC-LOC-LOC,LOC-LOC,PROPN-PROPN-PROPN,PROPN-PROPN,compound-compound-nsubj,compound-appos,NNP-NNP-NNP,NNP-NNP,8,1
2,0.0,22,is,3,1,16,15,0,5,2,13,Kilju - ŭp,North Korea,LOC-LOC-LOC,LOC-LOC,PROPN-PUNCT-PROPN,PROPN-PROPN,compound-punct-pobj,compound-appos,NNP-HYPH-NNP,NNP-NNP,8,1
3,0.0,22,is,3,1,16,15,0,5,2,13,Kilju,North Hamgyŏng,LOC,LOC-LOC,PROPN,PROPN-PROPN,compound,compound-compound,NNP,NNP-NNP,8,1
4,0.0,22,is,3,1,16,15,0,5,2,13,Kilju,North Korea,LOC,LOC-LOC,PROPN,PROPN-PROPN,compound,compound-appos,NNP,NNP-NNP,8,1
5,0.0,22,is,3,16,16,0,15,5,-13,13,North Hamgyŏng,North Korea,LOC-LOC,LOC-LOC,PROPN-PROPN,PROPN-PROPN,compound-compound,compound-appos,NNP-NNP,NNP-NNP,0,1
6,1.0,18,is,1,8,15,7,7,2,-7,14,Paektusan Ch'ŏngnyŏn,Korean State Railway,LOC-LOC,LOC-LOC-LOC,PROPN-PROPN,PROPN-PROPN-PROPN,compound-pobj,compound-compound-pobj,NNP-NNP,NNP-NNP-NNP,4,1
7,1.0,18,is,1,11,15,4,10,2,-10,14,P'yŏngra,Korean State Railway,LOC,LOC-LOC-LOC,PROPN,PROPN-PROPN-PROPN,amod,compound-compound-pobj,NNP,NNP-NNP-NNP,3,1
0,0.0,23,was,13,1,4,3,0,18,12,-9,Lélia Abramo,"February 8 , 1911",PER-PER,TIME-TIME-TIME-TIME,PROPN-PROPN,PROPN-NUM-PUNCT-NUM,compound-nsubj,appos-nummod-punct-nummod,NNP-NNP,"NNP-CD-,-CD",2,1
1,0.0,23,was,13,1,9,8,0,13,12,-4,Lélia Abramo,"April 9 , 2004",PER-PER,TIME-TIME-TIME-TIME,PROPN-PROPN,PROPN-NUM-PUNCT-NUM,compound-nsubj,npadvmod-nummod-punct-nummod,NNP-NNP,"NNP-CD-,-CD",2,1
2,1.0,32,born,7,6,12,6,5,19,1,5,Abramo,São Paulo,PER,LOC-LOC,PROPN,PROPN-PROPN,nsubjpass,compound-pobj,NNP,NNP-NNP,4,1
3,7.0,52,played,1,1,23,22,0,28,0,22,Abramo,São Paulo,PER,LOC-LOC,PROPN,PROPN-PROPN,nsubj,compound-compound,NNP,NNP-NNP,8,1
0,0.0,75,Khizeh,1,22,64,42,21,10,-21,63,Israeli war of independence,1948,MISC-MISC-MISC-MISC,TIME,ADJ-NOUN-ADP-NOUN,NUM,amod-pobj-prep-pobj,pobj,JJ-NN-IN-NN,CD,8,1
0,2.0,36,was,11,24,20,-4,23,15,-13,9,Diogo de Gouveia,António de Gouveia,PER-PER-PER,PER-PER-PER,PROPN-ADP-PROPN,PROPN-PROPN-PROPN,compound-nmod-conj,compound-compound-conj,NNP-IN-NNP,NNP-NNP-NNP,3,1
1,2.0,36,was,11,16,20,4,15,15,-5,9,André de Gouveia,António de Gouveia,PER-PER-PER,PER-PER-PER,PROPN-PROPN-PROPN,PROPN-PROPN-PROPN,nmod-nmod-pobj,compound-compound-conj,NNP-NNP-NNP,NNP-NNP-NNP,5,1
0,2.0,7,born,3,1,6,5,0,0,2,3,Hans Gutmann,Cologne,PER-PER,LOC,PROPN-PROPN,PROPN,compound-nsubjpass,pobj,NNP-NNP,NNP,2,1
1,3.0,16,joined,3,14,6,-8,13,9,-11,3,International Brigades,Spanish Civil War,ORG-ORG,MISC-MISC-MISC,PROPN-PROPN,ADJ-PROPN-PROPN,compound-pobj,amod-compound-dobj,NNP-NNPS,JJ-NNP-NNP,6,1
2,5.0,21,are,1,16,19,3,15,1,-15,18,Agencia EFE,Madrid,ORG-ORG,LOC,PROPN-PROPN,PROPN,compound-pobj,appos,NNP-NNP,NNP,6,1
3,10.0,18,took,4,12,16,4,11,1,-8,12,Kahlo,Diego Rivera,PER,PER-PER,PROPN,PROPN-PROPN,pobj,compound-appos,NNP,NNP-NNP,3,1
4,11.0,20,photographed,2,10,7,-3,9,12,-8,5,Gerardo Murillo,Mexican,PER-PER,LOC,PROPN-PROPN,ADJ,compound-pobj,amod,NNP-NNP,JJ,2,1
5,11.0,20,photographed,2,13,7,-6,12,12,-11,5,Jesús Reyes Ferreira,Mexican,PER-PER-PER,LOC,PROPN-PROPN-PROPN,ADJ,compound-compound-conj,amod,NNP-NNP-NNP,JJ,4,1
6,11.0,20,photographed,2,17,7,-10,16,12,-15,5,José Clemente Orozco,Mexican,PER-PER-PER,LOC,PROPN-PROPN-PROPN,ADJ,compound-compound-conj,amod,NNP-NNP-NNP,JJ,5,1
7,12.0,9,died,2,1,5,4,0,3,1,3,Juan Guzmán,Mexico City,PER-PER,LOC-LOC,PROPN-PROPN,PROPN-PROPN,compound-nsubj,compound-pobj,NNP-NNP,NNP-NNP,3,1
0,0.0,22,is,3,1,12,11,0,9,2,9,Mullion,Lizard Peninsula,LOC,LOC-LOC,NOUN,PROPN-PROPN,nsubj,compound-pobj,NN,NNP-NNP,4,1
1,0.0,22,is,3,1,20,19,0,1,2,17,Mullion,United Kingdom,LOC,LOC-LOC,NOUN,PROPN-PROPN,nsubj,compound-appos,NN,NNP-NNP,5,1
2,0.0,22,is,3,12,16,4,11,5,-9,13,Lizard Peninsula,Cornwall,LOC-LOC,LOC,PROPN-PROPN,PROPN,compound-pobj,pobj,NNP-NNP,NNP,5,1
3,0.0,22,is,3,12,20,8,11,1,-9,17,Lizard Peninsula,United Kingdom,LOC-LOC,LOC-LOC,PROPN-PROPN,PROPN-PROPN,compound-pobj,compound-appos,NNP-NNP,NNP-NNP,5,1
4,0.0,22,is,3,16,18,2,15,3,-13,15,Cornwall,England,LOC,LOC,PROPN,PROPN,pobj,conj,NNP,NNP,2,1
5,0.0,22,is,3,16,20,4,15,1,-13,17,Cornwall,United Kingdom,LOC,LOC-LOC,PROPN,PROPN-PROPN,pobj,compound-appos,NNP,NNP-NNP,2,1
6,0.0,22,is,3,18,20,2,17,1,-15,17,England,United Kingdom,LOC,LOC-LOC,PROPN,PROPN-PROPN,conj,compound-appos,NNP,NNP-NNP,2,1
0,0.0,30,is,6,1,21,20,0,8,5,15,Close Combat : First to Fight,Destineer Studios,MISC-MISC-MISC-MISC-MISC-MISC,ORG-ORG,PROPN-PROPN-PUNCT-ADV-PART-PROPN,PROPN-PROPN,amod-dep-punct-advmod-prep-pobj,compound-pobj,NNP-NNP-:-RB-TO-NNP,NNP-NNP,5,1
1,0.0,30,is,6,1,24,23,0,5,5,18,Close Combat : First to Fight,Microsoft Windows,MISC-MISC-MISC-MISC-MISC-MISC,MISC-MISC,PROPN-PROPN-PUNCT-ADV-PART-PROPN,PROPN-PROPN,amod-dep-punct-advmod-prep-pobj,compound-pobj,NNP-NNP-:-RB-TO-NNP,NNP-NNP,7,1
2,0.0,30,is,6,1,27,26,0,2,5,21,Close Combat : First to Fight,Macintosh,MISC-MISC-MISC-MISC-MISC-MISC,MISC,PROPN-PROPN-PUNCT-ADV-PART-PROPN,PROPN,amod-dep-punct-advmod-prep-pobj,conj,NNP-NNP-:-RB-TO-NNP,NNP,9,1
3,0.0,30,is,6,1,29,28,0,0,5,23,Close Combat : First to Fight,Xbox,MISC-MISC-MISC-MISC-MISC-MISC,MISC,PROPN-PROPN-PUNCT-ADV-PART-PROPN,PROPN,amod-dep-punct-advmod-prep-pobj,conj,NNP-NNP-:-RB-TO-NNP,NNP,2,1
4,2.0,40,commands,2,31,18,-13,30,21,-29,16,Syria,United Nations,LOC,ORG-ORG,PROPN,PROPN-PROPN,nsubj,compound-nsubj,NNP,NNP-NNP,5,1
5,2.0,40,commands,2,33,18,-15,32,21,-31,16,Iran,United Nations,LOC,ORG-ORG,PROPN,PROPN-PROPN,conj,compound-nsubj,NNP,NNP-NNP,3,1
6,5.0,41,designed,2,14,12,-2,13,28,-12,10,3rd Battalion 1st Marines,Marines,ORG-ORG-ORG-ORG,ORG,PROPN-PROPN-NOUN-PROPN,PROPN,compound-compound-compound-pobj,dobj,NNP-NNP-NN-NNPS,NNPS,1,1
7,5.0,41,designed,2,25,27,2,24,13,-23,25,Fallujah,Iraq,LOC,LOC,PROPN,PROPN,pobj,appos,NNP,NNP,4,1
0,0.0,57,was,7,1,4,3,0,52,6,-3,François Caron,1600,PER-PER,TIME,PROPN-PROPN,NUM,compound-nsubj,nummod,NNP-NNP,CD,1,1
1,0.0,57,was,7,1,6,5,0,50,6,-1,François Caron,1673,PER-PER,TIME,PROPN-PROPN,NUM,compound-nsubj,nummod,NNP-NNP,CD,1,1
2,3.0,12,disputes,1,10,7,-3,9,4,-9,6,Guillaume Courtet,French,PER-PER,LOC,PROPN-PROPN,ADJ,compound-appos,amod,NNP-NNP,JJ,2,1
0,3.0,21,shows,8,1,19,18,0,1,7,11,The Drifting Classroom,Kazuo Umezu,MISC-MISC-MISC,PER-PER,DET-PROPN-NOUN,PROPN-PROPN,det-compound-pobj,compound-pobj,DT-NNP-NN,NNP-NNP,4,1
1,5.0,21,"""",0,2,13,11,1,7,-2,13,Dozing Green,Uroboros,MISC-MISC,MISC,VERB-PROPN,PROPN,compound-nsubj,pobj,VBG-NNP,NNP,3,1
0,7.0,44,voted,15,19,42,23,18,1,-4,27,Forza Italia,March 2009,ORG-ORG,TIME-TIME,PROPN-PROPN,PROPN-NUM,compound-dobj,pobj-nummod,NNP-NNP,NNP-CD,6,1
0,0.0,39,was,9,17,24,7,16,14,-8,15,Chalk River Laboratories,Ontario,ORG-ORG-ORG,LOC,PROPN-PROPN-PROPN,PROPN,compound-compound-pobj,conj,NNP-NNP-NNP,NNP,5,1
1,0.0,39,was,9,17,24,7,16,14,-8,15,Chalk River,Ontario,LOC-LOC,LOC,PROPN-PROPN,PROPN,compound-pobj,conj,NNP-NNP,NNP,5,1
2,12.0,22,are,6,13,13,0,12,8,-7,7,Canada Science and Technology Museum,Canada,LOC-LOC-LOC-LOC-LOC,LOC,PROPN-PROPN-CCONJ-PROPN-PROPN,PROPN,nmod-nmod-cc-conj-pobj,appos,NNP-NNP-CC-NNP-NNP,NNP,0,1
3,12.0,22,are,6,19,13,-6,18,8,-13,7,Ottawa,Canada,LOC,LOC,PROPN,PROPN,pobj,appos,NNP,NNP,2,1
0,0.0,28,is,4,1,26,25,0,1,3,22,Nancy M. O'Fallon Dowdy,Cold War,PER-PER-PER-PER,MISC-MISC,PROPN-PROPN-PROPN-PROPN,PROPN-PROPN,compound-compound-compound-nsubj,compound-pobj,NNP-NNP-NNP-NNP,NNP-NNP,7,1
0,0.0,12,is,1,1,7,6,0,4,0,6,Noordeloos,Dutch,LOC,LOC,PROPN,ADJ,nsubj,amod,NNP,JJ,3,1
1,0.0,12,is,1,1,10,9,0,1,0,9,Noordeloos,South Holland,LOC,LOC-LOC,PROPN,PROPN-PROPN,nsubj,compound-pobj,NNP,NNP-NNP,5,1
2,0.0,12,is,1,7,10,3,6,1,-6,9,Dutch,South Holland,LOC,LOC-LOC,ADJ,PROPN-PROPN,amod,compound-pobj,JJ,NNP-NNP,2,1
3,6.0,14,is,1,10,13,3,9,0,-9,12,Ottawa County,Michigan,LOC-LOC,LOC,PROPN-PROPN,PROPN,compound-pobj,appos,NNP-NNP,NNP,6,1
0,0.0,48,was,6,1,5,4,0,42,5,-1,Guy,1012,PER,TIME,PROPN,NUM,compound,nummod,NNP,CD,3,1
1,0.0,48,was,6,1,18,17,0,29,5,12,Guy,Guaimar IV,PER,PER-PER,PROPN,PROPN-PROPN,compound,compound-pobj,NNP,NNP-NNP,7,1
0,7.0,15,led,9,7,12,5,6,2,2,3,Adolf Stoecker,Christian Social Party,PER-PER,ORG-ORG-ORG,PROPN-PROPN,PROPN-PROPN-PROPN,compound-appos,compound-compound-dobj,NNP-NNP,NNP-NNP-NNP,4,1
0,0.0,26,was,11,1,18,17,0,7,10,7,Wyndham Robertson,U.S.,PER-PER,LOC,PROPN-PROPN,PROPN,compound-nsubj,compound,NNP-NNP,NNP,4,1
1,0.0,26,was,11,18,21,3,17,4,-7,10,U.S.,Virginia,LOC,LOC,PROPN,PROPN,compound,pobj,NNP,NNP,4,1
2,2.0,17,advocated,4,4,2,-2,3,14,0,-2,Robertson,Whig,PER,ORG,PROPN,PROPN,nsubj,dep,NNP,NNP,1,1
0,0.0,21,"""",0,2,17,15,1,3,-2,17,Ashtray Heart,Battle for the Sun,MISC-MISC,MISC-MISC-MISC-MISC,PROPN-PROPN,PROPN-ADP-DET-PROPN,compound-nsubj,npadvmod-prep-det-pobj,NNP-NNP,NNP-IN-DT-NNP,6,1
0,0.0,40,is,2,37,39,2,36,0,-35,37,Suffolk,UK,LOC,LOC,PROPN,PROPN,pobj,appos,NNP,NNP,8,1
0,2.0,31,was,2,15,7,-8,14,23,-13,5,Billboard Top Electronic Albums,the United States,MISC-MISC-MISC-MISC,LOC-LOC-LOC,PROPN-PROPN-PROPN-PROPN,DET-PROPN-PROPN,compound-compound-compound-pobj,det-compound-pobj,NNP-NNP-NNP-NNPS,DT-NNP-NNP,7,1
1,3.0,63,featured,20,46,55,9,45,7,-26,35,Woman On the Verge,Gossip Girl,MISC-MISC-MISC-MISC,MISC-MISC,NOUN-ADP-DET-PROPN,PROPN-PROPN,appos-prep-det-pobj,compound-appos,NN-IN-DT-NNP,NNP-NNP,4,1
0,0.0,20,is,1,1,16,15,0,3,0,15,Vithura,Kerala state,LOC,LOC-LOC,PROPN,PROPN-NOUN,nsubj,compound-pobj,NNP,NNP-NN,7,1
1,0.0,20,is,1,1,19,18,0,0,0,18,Vithura,India,LOC,LOC,PROPN,PROPN,nsubj,pobj,NNP,NNP,1,1
2,0.0,20,is,1,11,19,8,10,0,-10,18,Thiruvananthapuram,India,LOC,LOC,PROPN,PROPN,pobj,pobj,NNP,NNP,6,1
0,0.0,19,is,3,1,13,12,0,5,2,10,Machine + Soul,Gary Numan,MISC-MISC-MISC,PER-PER,PROPN-CCONJ-NOUN,PROPN-PROPN,nsubj-cc-conj,compound-pobj,NNP-CC-NN,NNP-NNP,5,1
1,0.0,19,is,3,1,18,17,0,0,2,15,Machine + Soul,1992,MISC-MISC-MISC,TIME,PROPN-CCONJ-NOUN,NUM,nsubj-cc-conj,pobj,NNP-CC-NN,CD,3,1
2,3.0,23,released,18,10,21,11,9,1,8,3,Metal Rhythm,IRS Records,MISC-MISC,ORG-ORG,PROPN-PROPN,PROPN-PROPN,compound-appos,compound-pobj,NNP-NNP,NNP-NNPS,4,1
3,3.0,23,released,18,15,21,6,14,1,3,3,Outland,IRS Records,MISC,ORG-ORG,PROPN,PROPN-PROPN,conj,compound-pobj,NNP,NNP-NNPS,3,1
0,3.0,34,is,2,15,23,8,14,10,-13,21,Lloyd George,Manchester,PER-PER,LOC,PROPN-PROPN,PROPN,compound-poss,pobj,NNP-NNP,NNP,7,1
1,3.0,34,is,2,15,25,10,14,8,-13,23,Lloyd George,January 1863,PER-PER,TIME-TIME,PROPN-PROPN,PROPN-NUM,compound-poss,pobj-nummod,NNP-NNP,NNP-CD,9,1
2,3.0,34,is,2,15,31,16,14,2,-13,29,Lloyd George,1945,PER-PER,TIME,PROPN-PROPN,NUM,compound-poss,pobj,NNP-NNP,CD,9,1
3,3.0,34,is,2,15,33,18,14,0,-13,31,Lloyd George,Llanystumdwy,PER-PER,LOC,PROPN-PROPN,PROPN,compound-poss,pobj,NNP-NNP,NNP,10,1
0,0.0,20,is,1,1,15,14,0,4,0,14,Remuera,North Island,LOC,LOC-LOC,NOUN,PROPN-PROPN,nsubj,compound-pobj,NN,NNP-NNP,3,1
1,0.0,20,is,1,1,18,17,0,1,0,17,Remuera,New Zealand,LOC,LOC-LOC,NOUN,PROPN-PROPN,nsubj,compound-pobj,NN,NNP-NNP,5,1
2,0.0,20,is,1,11,15,4,10,4,-10,14,Auckland,North Island,LOC,LOC-LOC,PROPN,PROPN-PROPN,pobj,compound-pobj,NNP,NNP-NNP,3,1
3,0.0,20,is,1,11,18,7,10,1,-10,17,Auckland,New Zealand,LOC,LOC-LOC,PROPN,PROPN-PROPN,pobj,compound-pobj,NNP,NNP-NNP,5,1
4,0.0,20,is,1,15,18,3,14,1,-14,17,North Island,New Zealand,LOC-LOC,LOC-LOC,PROPN-PROPN,PROPN-PROPN,compound-pobj,compound-pobj,NNP-NNP,NNP-NNP,2,1
0,0.0,32,Şahin,1,18,20,2,17,11,-17,19,Siegen,West Germany,LOC,LOC-LOC,PROPN,PROPN-PROPN,pobj,compound-appos,NNP,NNP-NNP,2,1
1,3.0,18,lives,12,15,17,2,14,0,-3,5,Cologne,Germany,LOC,LOC,PROPN,PROPN,pobj,appos,NNP,NNP,4,1
0,4.0,28,released,5,5,25,20,4,2,0,20,Duval,Kalina Maloyer,PER,PER-PER,PROPN,PROPN-PROPN,nsubj,compound-appos,NNP,NNP-NNP,5,1
1,5.0,51,was,1,26,29,3,25,21,-25,28,Ways,1983,MISC,TIME,NOUN,NUM,npadvmod,appos,NNS,CD,2,1
2,5.0,51,was,1,33,38,5,32,12,-32,37,Lovers Will Survive,1986,MISC-MISC-MISC,TIME,NOUN-VERB-VERB,NUM,nsubj-aux-conj,npadvmod,NNS-MD-VB,CD,2,1
3,5.0,51,was,1,43,49,6,42,1,-42,48,When You Were Mine,1987,MISC-MISC-MISC-MISC,TIME,ADV-PRON-VERB-NOUN,NUM,advmod-nsubj-conj-attr,npadvmod,WRB-PRP-VBD-NN,CD,2,1
0,0.0,22,is,5,5,15,10,4,6,0,10,Tarlac,Philippines,LOC,LOC,PROPN,PROPN,pobj,pobj,NNP,NNP,1,1
0,0.0,7,is,2,1,5,4,0,1,1,3,Martin Auer,Austrian,PER-PER,LOC,PROPN-PROPN,ADJ,compound-nsubj,amod,NNP-NNP,JJ,2,1
0,0.0,26,was,10,1,5,4,0,20,9,-5,Olga Grigoryevna Shatunovskaya,1901,PER-PER-PER,TIME,PROPN-PROPN-PROPN,NUM,compound-compound-nsubj,nummod,NNP-NNP-NNP,CD,3,1
1,0.0,26,was,10,1,7,6,0,18,9,-3,Olga Grigoryevna Shatunovskaya,Baku,PER-PER-PER,LOC,PROPN-PROPN-PROPN,PROPN,compound-compound-nsubj,compound,NNP-NNP-NNP,NNP,4,1
2,0.0,26,was,10,1,9,8,0,16,9,-1,Olga Grigoryevna Shatunovskaya,1990,PER-PER-PER,TIME,PROPN-PROPN-PROPN,NUM,compound-compound-nsubj,nummod,NNP-NNP-NNP,CD,4,1
0,0.0,19,is,2,1,14,13,0,4,1,12,Collaroy Plateau,New South Wales,LOC-LOC,LOC-LOC-LOC,PROPN-PROPN,PROPN-PROPN-PROPN,compound-nsubj,compound-compound-pobj,NNP-NNP,NNP-NNP-NNP,7,1
1,0.0,19,is,2,8,14,6,7,4,-6,12,Sydney,New South Wales,LOC,LOC-LOC-LOC,PROPN,PROPN-PROPN-PROPN,pobj,compound-compound-pobj,NNP,NNP-NNP-NNP,6,1
2,0.0,19,is,2,8,18,10,7,0,-6,16,Sydney,Australia,LOC,LOC,PROPN,PROPN,pobj,npadvmod,NNP,NNP,3,1
3,0.0,19,is,2,14,18,4,13,0,-12,16,New South Wales,Australia,LOC-LOC-LOC,LOC,PROPN-PROPN-PROPN,PROPN,compound-compound-pobj,npadvmod,NNP-NNP-NNP,NNP,7,1
4,6.0,26,is,2,10,21,11,9,4,-8,19,PPC-1,Australia,MISC,LOC,PROPN,PROPN,compound,dobj,NNP,NNP,8,1
0,1.0,60,were,35,12,16,4,11,43,23,-19,The Lost World,1925,MISC-MISC-MISC,TIME,DET-PROPN-PROPN,NUM,det-compound-pobj,pobj,DT-NNP-NNP,CD,6,1
1,1.0,60,were,35,50,54,4,49,5,-15,19,Jaws,Steven Spielberg,MISC,PER-PER,PROPN,PROPN-PROPN,conj,compound-pobj,NNP,NNP-NNP,4,1
2,1.0,60,were,35,50,59,9,49,0,-15,24,Jaws,1975,MISC,TIME,PROPN,NUM,conj,pobj,NNP,CD,3,1
3,2.0,30,produced,11,15,17,2,14,12,-4,6,Grizzly,1976,MISC,TIME,PROPN,NUM,pobj,appos,NNP,CD,2,1
4,2.0,30,produced,11,26,28,2,25,1,-15,17,Alligator,1980,MISC,TIME,PROPN,NUM,conj,npadvmod,NNP,CD,2,1
5,3.0,25,produced,7,20,23,3,19,1,-13,16,The Shallows,2016,MISC-MISC,TIME,DET-PROPN,NUM,det-conj,appos,DT-NNPS,CD,1,1
0,2.0,31,gained,1,13,17,4,12,13,-12,16,Bradley Wiggins,2012 Tour de France,PER-PER,MISC-MISC-MISC-MISC,PROPN-PROPN,NUM-PROPN-ADP-PROPN,compound-pobj,nummod-compound-nmod-pobj,NNP-NNP,CD-NNP-IN-NNP,5,1
1,2.0,31,gained,1,13,17,4,12,13,-12,16,Bradley Wiggins,2012 Summer Olympics,PER-PER,MISC-MISC-MISC,PROPN-PROPN,NUM-PROPN-PROPN,compound-pobj,nummod-compound-pobj,NNP-NNP,CD-NNP-NNPS,5,1
2,2.0,31,gained,1,17,30,13,16,0,-16,29,2012 Summer Olympics,London,MISC-MISC-MISC,LOC,NUM-PROPN-PROPN,PROPN,nummod-compound-pobj,pobj,CD-NNP-NNPS,NNP,6,1
3,4.0,27,associated,11,20,25,5,19,1,-9,14,2011 Tour de France,Cadel Evans,MISC-MISC-MISC-MISC,PER-PER,NUM-PROPN-ADP-PROPN,PROPN-PROPN,nummod-nmod-compound-compound,compound-appos,CD-NNP-IN-NNP,NNP-NNP,3,1
0,2.0,22,became,2,7,13,6,6,8,-5,11,Elena Gilbert,The Vampire Diaries,PER-PER,MISC-MISC-MISC,PROPN-PROPN,DET-PROPN-PROPN,compound-dobj,compound-compound-appos,NNP-NNP,DT-NNP-NNPS,4,1
1,2.0,22,became,2,10,13,3,9,8,-8,11,Katherine Pierce,The Vampire Diaries,PER-PER,MISC-MISC-MISC,PROPN-PROPN,DET-PROPN-PROPN,compound-conj,compound-compound-appos,NNP-NNP,DT-NNP-NNPS,3,1
2,3.0,55,appeared,3,19,1,-18,18,53,-16,-2,The Final Girls,Dobrev,MISC-MISC-MISC,PER,DET-PROPN-PROPN,PROPN,det-compound-ROOT,nsubj,DT-NNP-NNPS,NNP,6,1
0,0.0,17,is,10,1,6,5,0,10,9,-4,Rodney Allan Atkins,"March 28 , 1969",PER-PER-PER,TIME-TIME-TIME-TIME,PROPN-PROPN-PROPN,PROPN-NUM-PUNCT-NUM,compound-compound-nsubj,npadvmod-nummod-punct-nummod,NNP-NNP-NNP,"NNP-CD-,-CD",4,1
1,0.0,17,is,10,1,13,12,0,3,9,3,Rodney Allan Atkins,American,PER-PER-PER,LOC,PROPN-PROPN-PROPN,ADJ,compound-compound-nsubj,amod,NNP-NNP-NNP,JJ,5,1
2,6.0,17,produced,7,1,6,5,0,10,6,-1,Take a Back Road,2011,MISC-MISC-MISC-MISC,TIME,VERB-DET-PROPN-PROPN,NUM,advcl-det-compound-dobj,appos,VB-DT-NNP-NNP,CD,2,1
0,0.0,37,is,9,1,26,25,0,10,8,17,Tyrone Keys,Chicago Bears,PER-PER,ORG-ORG,PROPN-PROPN,PROPN-PROPN,compound-nsubj,compound-pobj,NNP-NNP,NNP-NNPS,7,1
1,0.0,37,is,9,1,29,28,0,7,8,20,Tyrone Keys,Tampa Bay Buccaneers,PER-PER,ORG-ORG-ORG,PROPN-PROPN,PROPN-PROPN-PROPN,compound-nsubj,compound-compound-conj,NNP-NNP,NNP-NNP-NNP,9,1
2,0.0,37,is,9,1,34,33,0,2,8,25,Tyrone Keys,San Diego Chargers,PER-PER,ORG-ORG-ORG,PROPN-PROPN,PROPN-PROPN-PROPN,compound-nsubj,compound-compound-conj,NNP-NNP,NNP-NNP-NNPS,10,1
0,0.0,21,Wood,2,1,5,4,0,15,1,3,Ernest Edward Wood,"August 24 , 1875",PER-PER-PER,TIME-TIME-TIME-TIME,PROPN-PROPN-PROPN,PROPN-NUM-PUNCT-NUM,compound-compound-ROOT,appos-nummod-punct-nummod,NNP-NNP-NNP,"NNP-CD-,-CD",3,1
1,0.0,21,Wood,2,1,17,16,0,3,1,15,Ernest Edward Wood,U.S.,PER-PER-PER,LOC,PROPN-PROPN-PROPN,PROPN,compound-compound-ROOT,compound,NNP-NNP-NNP,NNP,3,1
2,0.0,21,Wood,2,17,20,3,16,0,-15,18,U.S.,Missouri,LOC,LOC,PROPN,PROPN,compound,pobj,NNP,NNP,2,1
3,1.0,25,attended,7,7,3,-4,6,21,0,-4,Wood,Chico,PER,LOC,PROPN,PROPN,nsubj,pobj,NNP,NNP,4,1
4,1.0,25,attended,7,7,17,10,6,7,0,10,Wood,Stockton ( California ) High School,PER,ORG-ORG-ORG-ORG-ORG-ORG,PROPN,PROPN-PUNCT-PROPN-PUNCT-PROPN-PROPN,nsubj,nmod-punct-nmod-punct-compound-pobj,NNP,NNP--LRB--NNP--RRB--NNP-NNP,6,1
5,3.0,21,admitted,6,17,20,3,16,0,-11,14,St. Louis,Missouri,LOC-LOC,LOC,PROPN-PROPN,PROPN,compound-pobj,appos,NNP-NNP,NNP,4,1
6,4.0,43,presented,1,1,7,6,0,35,0,6,Wood,Democratic,PER,ORG,PROPN,ADJ,nsubj,amod,NNP,JJ,3,1
7,5.0,16,moved,1,4,7,3,3,8,-3,6,Los Angeles,California,LOC-LOC,LOC,PROPN-PROPN,PROPN,compound-pobj,appos,NNP-NNP,NNP,3,1
8,6.0,21,died,1,4,20,16,3,0,-3,19,Los Angeles,California,LOC-LOC,LOC,PROPN-PROPN,PROPN,compound-pobj,appos,NNP-NNP,NNP,3,1
0,0.0,25,is,3,1,6,5,0,18,2,3,North by Northwest,1959,MISC-MISC-MISC,TIME,NOUN-ADP-PROPN,NUM,advmod-prep-pobj,nummod,NN-IN-NNP,CD,4,1
1,0.0,25,is,3,1,12,11,0,12,2,9,North by Northwest,Alfred Hitchcock,MISC-MISC-MISC,PER-PER,NOUN-ADP-PROPN,PROPN-PROPN,advmod-prep-pobj,compound-pobj,NN-IN-NNP,NNP-NNP,6,1
2,0.0,25,is,3,1,16,15,0,8,2,13,North by Northwest,Cary Grant,MISC-MISC-MISC,PER-PER,NOUN-ADP-PROPN,PROPN-PROPN,advmod-prep-pobj,compound-dobj,NN-IN-NNP,NNP-NNP,6,1
3,0.0,25,is,3,1,19,18,0,5,2,16,North by Northwest,Eva Marie Saint,MISC-MISC-MISC,PER-PER-PER,NOUN-ADP-PROPN,PROPN-PROPN-PROPN,advmod-prep-pobj,compound-compound-conj,NN-IN-NNP,NNP-NNP-NNP,8,1
4,0.0,25,is,3,1,23,22,0,1,2,20,North by Northwest,James Mason,MISC-MISC-MISC,PER-PER,NOUN-ADP-PROPN,PROPN-PROPN,advmod-prep-pobj,compound-conj,NN-IN-NNP,NNP-NNP,8,1
0,2.0,35,credited,7,14,32,18,13,2,-7,25,East Asia,Japan,LOC-LOC,LOC,PROPN-PROPN,PROPN,compound-pobj,dobj,NNP-NNP,NNP,6,1
0,0.0,23,is,3,1,21,20,0,1,2,18,George Louis Costanza,Jason Alexander,PER-PER-PER,PER-PER,PROPN-PROPN-PROPN,PROPN-PROPN,compound-compound-nsubj,compound-pobj,NNP-NNP-NNP,NNP-NNP,6,1
1,0.0,23,is,3,12,14,2,11,8,-9,11,Seinfeld,1989,MISC,TIME,PROPN,NUM,appos,nummod,NNP,CD,2,1
2,0.0,23,is,3,12,16,4,11,6,-9,13,Seinfeld,1998,MISC,TIME,PROPN,NUM,appos,appos,NNP,CD,2,1
0,3.0,20,develop,9,13,19,6,12,0,-4,10,Argentina,1816,LOC,TIME,PROPN,NUM,nsubj,pobj,NNP,CD,3,1
1,7.0,28,is,5,10,18,8,9,9,-5,13,Latin America,Americas,LOC-LOC,LOC,PROPN-PROPN,PROPN,compound-pobj,pobj,NNP-NNP,NNPS,5,1
0,0.0,30,"""",0,19,28,9,18,1,-19,28,Eurovision Song Contest 1970,Gianni Morandi,MISC-MISC-MISC-MISC,PER-PER,PROPN-PROPN-PROPN-NUM,PROPN-PROPN,compound-compound-pobj-appos,compound-pobj,NNP-NNP-NNP-CD,NNP-NNP,7,1
1,6.0,21,succeeded,2,9,12,3,8,8,-7,10,1971 Contest,Massimo Ranieri,MISC-MISC,PER-PER,NUM-PROPN,PROPN-PROPN,nummod-pobj,compound-pobj,CD-NNP,NNP-NNP,2,1
2,6.0,21,succeeded,2,12,5,-7,11,15,-10,3,Massimo Ranieri,Italian,PER-PER,LOC,PROPN-PROPN,ADJ,compound-pobj,amod,NNP-NNP,JJ,6,1
0,2.0,27,discovered,3,6,9,3,5,17,-3,6,Katanga Province,Zaire,LOC-LOC,LOC,PROPN-PROPN,PROPN,compound-pobj,appos,NNP-NNP,NNP,3,1
1,2.0,27,discovered,3,20,23,3,19,3,-17,20,Hans Stille,1876,PER-PER,TIME,PROPN-PROPN,NUM,compound-appos,nummod,NNP-NNP,CD,1,1
2,2.0,27,discovered,3,20,25,5,19,1,-17,22,Hans Stille,1966,PER-PER,TIME,PROPN-PROPN,NUM,compound-appos,nummod,NNP-NNP,CD,1,1
3,3.0,28,reported,3,11,15,4,10,12,-8,12,La Rioja Province,Argentina,LOC-LOC-LOC,LOC,PROPN-PROPN-PROPN,PROPN,compound-compound-conj,appos,NNP-NNP-NNP,NNP,3,1
4,3.0,28,reported,3,24,27,3,23,0,-21,24,Harz Mountains,Germany,LOC-LOC,LOC,PROPN-PROPN,PROPN,compound-pobj,appos,NNP-NNPS,NNP,3,1
5,4.0,43,include,2,18,22,4,17,20,-16,20,Shinkolobwe,Congo,LOC,LOC,PROPN,PROPN,compound,pobj,NNP,NNP,4,1
0,0.0,49,known,5,19,21,2,18,27,-14,16,Florida,United States,LOC,LOC-LOC,PROPN,PROPN-PROPN,appos,compound-appos,NNP,NNP-NNP,2,1
0,0.0,28,was,11,1,4,3,0,23,10,-7,Blagoje Vidinić,11 June 1934,PER-PER,TIME-TIME-TIME,PROPN-PROPN,NUM-PROPN-NUM,compound-nsubj,nummod-npadvmod-nummod,NNP-NNP,CD-NNP-CD,2,1
1,0.0,28,was,11,1,8,7,0,19,10,-3,Blagoje Vidinić,29 December 2006,PER-PER,TIME-TIME-TIME,PROPN-PROPN,NUM-PROPN-NUM,compound-nsubj,nummod-appos-nummod,NNP-NNP,CD-NNP-CD,2,1
2,1.0,29,played,5,25,28,3,24,0,-20,23,FC Sion,Switzerland,ORG-ORG,LOC,PROPN-PROPN,PROPN,compound-pobj,pobj,NNP-NNP,NNP,3,1
3,2.0,27,moved,4,12,17,5,11,9,-8,13,Los Angeles Toros,National Professional Soccer League,ORG-ORG-ORG,ORG-ORG-ORG-ORG,PROPN-PROPN-PROPN,PROPN-PROPN-PROPN-PROPN,compound-compound-dobj,compound-compound-compound-pobj,NNP-NNP-NNP,NNP-NNP-NNP-NNP,4,1
4,3.0,26,started,1,11,18,7,10,7,-10,17,San Diego Toros,NASL,ORG-ORG-ORG,ORG,PROPN-PROPN-PROPN,PROPN,compound-compound-appos,pobj,NNP-NNP-NNP,NNP,5,1
0,0.0,40,is,22,20,22,2,19,17,2,0,Mannheim,Germany,LOC,LOC,PROPN,PROPN,pobj,nsubj,NNP,NNP,1,1
1,3.0,14,established,3,2,8,6,1,5,1,5,IDS,1964,ORG,TIME,PROPN,NUM,nsubjpass,pobj,NNP,CD,2,1
0,0.0,28,was,7,1,6,5,0,21,6,-1,Peter John Fos,1949,PER-PER-PER,TIME,PROPN-PROPN-PROPN,NUM,compound-compound-nsubj,npadvmod,NNP-NNP-NNP,CD,2,1
1,2.0,46,holds,1,1,11,10,0,34,0,10,Fos,University of New Orleans,PER,ORG-ORG-ORG-ORG,PROPN,PROPN-ADP-PROPN-PROPN,nsubj,pobj-prep-compound-pobj,NNP,NNP-IN-NNP-NNP,6,1
2,2.0,46,holds,1,1,44,43,0,1,0,43,Fos,Tulane University,PER,ORG-ORG,PROPN,PROPN-PROPN,nsubj,compound-pobj,NNP,NNP-NNP,5,1
0,0.0,27,is,3,2,21,19,1,5,1,18,Beware,Hall of Fame,MISC,MISC-MISC-MISC,PROPN,PROPN-ADP-PROPN,nsubj,pobj-prep-pobj,NNP,NNP-IN-NNP,7,1
1,0.0,27,is,3,2,25,23,1,1,1,22,Beware,2013,MISC,TIME,PROPN,NUM,nsubj,appos,NNP,CD,2,1
2,0.0,27,is,3,21,25,4,20,1,-18,22,Hall of Fame,2013,MISC-MISC-MISC,TIME,PROPN-ADP-PROPN,NUM,pobj-prep-pobj,appos,NNP-IN-NNP,CD,7,1
0,0.0,25,is,19,1,18,17,0,6,18,-1,Hanna Lis,Warsaw,PER-PER,LOC,PROPN-PROPN,PROPN,compound-nsubj,pobj,NNP-NNP,NNP,2,1
1,0.0,25,is,19,1,22,21,0,2,18,3,Hanna Lis,Polish,PER-PER,LOC,PROPN-PROPN,ADJ,compound-nsubj,amod,NNP-NNP,JJ,-1,1
2,0.0,25,is,19,10,22,12,9,2,9,3,Smoktunowicz,Polish,PER,LOC,PROPN,ADJ,appos,amod,NNP,JJ,-1,1
3,7.0,16,made,3,11,9,-2,10,6,-8,6,Rób swoje ryzyko jest twoje,Polish,MISC-MISC-MISC-MISC-MISC,LOC,PROPN-NOUN-NOUN-VERB-NOUN,ADJ,compound-nsubj-ccomp-amod-dobj,amod,NNP-NN-NNS-VBP-NN,JJ,1,1
0,1.0,25,is,1,19,24,5,18,0,-18,23,Darrell Scott,Sandy,PER-PER,PER,PROPN-PROPN,PROPN,compound-pobj,appos,NNP-NNP,NNP,5,1
1,2.0,16,was,2,1,10,9,0,5,1,8,Rachel Scott,Columbine High School,PER-PER,MISC-MISC-MISC,PROPN-PROPN,PROPN-PROPN-PROPN,compound-nsubj,compound-compound-pobj,NNP-NNP,NNP-NNP-NNP,7,1
2,2.0,16,was,2,1,15,14,0,0,1,13,Rachel Scott,1999,PER-PER,TIME,PROPN-PROPN,NUM,compound-nsubj,pobj,NNP-NNP,CD,2,1
0,0.0,51,is,8,1,5,4,0,45,7,-3,Emil Boc,6 September 1966,PER-PER,TIME-TIME-TIME,PROPN-PROPN,NUM-PROPN-NUM,compound-compound,nummod-npadvmod-nummod,NNP-NNP,CD-NNP-CD,2,1
1,0.0,51,is,8,1,11,10,0,39,7,3,Emil Boc,Romanian,PER-PER,LOC,PROPN-PROPN,ADJ,compound-compound,amod,NNP-NNP,JJ,-1,1
2,0.0,51,is,8,1,18,17,0,32,7,10,Emil Boc,Romania,PER-PER,LOC,PROPN-PROPN,PROPN,compound-compound,pobj,NNP-NNP,NNP,-1,1
3,0.0,51,is,8,11,41,30,10,9,-3,33,Romanian,Transylvania,LOC,LOC,ADJ,PROPN,amod,pobj,JJ,NNP,4,1
4,0.0,51,is,8,18,41,23,17,9,-10,33,Romania,Transylvania,LOC,LOC,PROPN,PROPN,pobj,pobj,NNP,NNP,6,1
5,1.0,30,was,1,1,8,7,0,21,0,7,Boc,Democratic Liberal Party,PER,ORG-ORG-ORG,PROPN,PROPN-PROPN-PROPN,nsubj,compound-compound-pobj,NNP,NNP-NNP-NNP,4,1
0,0.0,23,was,2,1,5,4,0,17,1,3,Popstars Live,Australian,MISC-MISC,LOC,NOUN-PROPN,ADJ,compound-nsubj,amod,NNS-NNP,JJ,3,1
1,0.0,23,was,2,1,18,17,0,4,1,16,Popstars Live,Seven Network,MISC-MISC,ORG-ORG,NOUN-PROPN,PROPN-PROPN,compound-nsubj,compound-pobj,NNS-NNP,NNP-NNP,8,1
2,3.0,11,premiered,2,1,6,5,0,4,1,4,Popstars Live,Seven Network,MISC-MISC,ORG-ORG,NOUN-PROPN,PROPN-PROPN,compound-nsubj,compound-pobj,NNS-NNP,NNP-NNP,3,1
0,0.0,22,was,11,1,4,3,0,17,10,-7,Hermann Emminghaus,20 May 1845,PER-PER,TIME-TIME-TIME,PROPN-PROPN,NUM-PROPN-NUM,compound-nsubj,nummod-nmod-nummod,NNP-NNP,CD-NNP-CD,1,1
1,0.0,22,was,11,1,8,7,0,13,10,-3,Hermann Emminghaus,17 February 1904,PER-PER,TIME-TIME-TIME,PROPN-PROPN,NUM-PROPN-NUM,compound-nsubj,nummod-npadvmod-nummod,NNP-NNP,CD-NNP-CD,2,1
2,3.0,24,was,2,7,10,3,6,13,-5,8,Carl Gerhardt,1833,PER-PER,TIME,PROPN-PROPN,NUM,compound-pobj,appos,NNP-NNP,CD,2,1
3,4.0,27,worked,5,19,23,4,18,3,-14,18,Franz von Rinecker,1811,PER-PER-PER,TIME,PROPN-PROPN-PROPN,NUM,compound-compound-pobj,npadvmod,NNP-NNP-NNP,CD,4,1
4,6.0,20,filled,10,13,16,3,12,3,-3,6,Emil Kraepelin,1856,PER-PER,TIME,PROPN-PROPN,NUM,compound-pobj,npadvmod,NNP-NNP,CD,3,1
5,7.0,35,became,3,3,11,8,2,23,0,8,Emminghaus,University of Freiburg,PER,ORG-ORG-ORG,PROPN,PROPN-ADP-PROPN,nsubj,pobj-prep-pobj,NNP,NNP-IN-NNP,4,1
0,0.0,29,is,3,8,19,11,7,9,-5,16,Ladysmith Black Mambazo,1960,ORG-ORG-ORG,TIME,PROPN-PROPN-PROPN,NUM,compound-compound-pobj,pobj,NNP-NNP-NNP,CD,5,1
1,1.0,32,born,2,1,5,4,0,26,1,3,Abednego,Ladysmith,PER,LOC,PROPN,PROPN,nsubjpass,pobj,NNP,NNP,4,1
2,1.0,32,born,2,1,21,20,0,10,1,19,Abednego,Albert,PER,PER,PROPN,PROPN,nsubjpass,attr,NNP,NNP,5,1
3,4.0,35,remained,11,11,19,8,10,15,0,8,Abednego,Albert,PER,PER,PROPN,PROPN,nsubj,pobj,NNP,NNP,1,1
4,1.0,32,born,2,1,23,22,0,8,1,21,Abednego,Milton,PER,PER,PROPN,PROPN,nsubjpass,conj,NNP,NNP,6,1
5,4.0,35,remained,11,11,7,-4,10,27,0,-4,Abednego,Milton,PER,PER,PROPN,PROPN,nsubj,appos,NNP,NNP,3,1
6,1.0,32,born,2,25,27,2,24,4,-23,25,Funokwakhe,Mehlo,PER,PER,PROPN,PROPN,conj,conj,NNP,NNP,3,1
7,1.0,32,born,2,25,30,5,24,1,-23,28,Funokwakhe,Joseph Mazibuko,PER,PER-PER,PROPN,PROPN-PROPN,conj,compound-conj,NNP,NNP-NNP,3,1
8,1.0,32,born,2,25,23,-2,24,8,-23,21,Funokwakhe,Milton,PER,PER,PROPN,PROPN,conj,conj,NNP,NNP,3,1
9,1.0,32,born,2,27,30,3,26,1,-25,28,Mehlo,Joseph Mazibuko,PER,PER-PER,PROPN,PROPN-PROPN,conj,compound-conj,NNP,NNP-NNP,2,1
10,1.0,32,born,2,27,23,-4,26,8,-25,21,Mehlo,Milton,PER,PER,PROPN,PROPN,conj,conj,NNP,NNP,4,1
11,1.0,32,born,2,30,21,-9,29,10,-28,19,Joseph Mazibuko,Albert,PER-PER,PER,PROPN-PROPN,PROPN,compound-conj,attr,NNP-NNP,NNP,5,1
12,1.0,32,born,2,30,23,-7,29,8,-28,21,Joseph Mazibuko,Milton,PER-PER,PER,PROPN-PROPN,PROPN,compound-conj,conj,NNP-NNP,NNP,4,1
13,1.0,32,born,2,5,7,2,4,24,-3,5,Ladysmith,South Africa,LOC,LOC-LOC,PROPN,PROPN-PROPN,pobj,compound-appos,NNP,NNP-NNP,2,1
14,1.0,32,born,2,21,23,2,20,8,-19,21,Albert,Milton,PER,PER,PROPN,PROPN,attr,conj,NNP,NNP,3,1
15,4.0,35,remained,11,19,7,-12,18,27,-8,-4,Albert,Milton,PER,PER,PROPN,PROPN,pobj,appos,NNP,NNP,4,1
0,0.0,15,is,5,3,9,6,2,5,2,4,Craig A. Franklin,United States Air Force,PER-PER-PER,ORG-ORG-ORG-ORG,PROPN-PROPN-PROPN,PROPN-PROPN-PROPN-PROPN,compound-compound-nsubj,compound-compound-nmod-nmod,NNP-NNP-NNP,NNP-NNP-NNP-NNP,5,1
1,1.0,18,was,1,7,13,6,6,4,-6,12,3rd Air Force,Ramstein Air Base,ORG-ORG-ORG,LOC-LOC-LOC,PROPN-PROPN-PROPN,PROPN-PROPN-PROPN,compound-compound-pobj,compound-compound-pobj,NNP-NNP-NNP,NNP-NNP-NNP,8,1
0,3.0,39,shown,11,9,6,-3,8,32,2,-5,Holy Spirit,Annunciation,MISC-MISC,MISC,PROPN-PROPN,PROPN,compound-nsubjpass,pobj,NNP-NNP,NNP,2,1
1,3.0,39,shown,11,6,31,25,5,7,5,20,Annunciation,Archangel Gabriel,MISC,PER-PER,PROPN,PROPN-PROPN,pobj,compound-nsubj,NNP,NNP-NNP,4,1
0,0.0,77,are,4,1,18,17,0,58,3,14,A Flock of Seagulls,1980,ORG-ORG-ORG-ORG,TIME,DET-PROPN-ADP-PROPN,NUM,det-nsubj-prep-pobj,pobj,DT-NNP-IN-NNPS,CD,5,1
1,0.0,77,are,4,1,20,19,0,56,3,16,A Flock of Seagulls,Liverpool,ORG-ORG-ORG-ORG,LOC,DET-PROPN-ADP-PROPN,PROPN,det-nsubj-prep-pobj,pobj,DT-NNP-IN-NNPS,NNP,5,1
2,1.0,65,had,2,1,63,62,0,1,1,61,"The More You Live , the More You Love",1984,MISC-MISC-MISC-MISC-MISC-MISC-MISC-MISC-MISC,TIME,DET-ADV-PRON-VERB-PUNCT-DET-ADJ-PRON-VERB,NUM,det-amod-compound-conj-punct-det-amod-compound-appos,appos,"DT-RBR-PRP-VBP-,-DT-JJR-PRP-VBP",CD,3,1
0,0.0,31,is,9,1,6,5,0,24,8,-3,Sverrir Ingi Ingason,5 August 1993,PER-PER-PER,TIME-TIME-TIME,PROPN-PROPN-PROPN,NUM-PROPN-NUM,nsubj-csubj-nsubj,nummod-npadvmod-nummod,NNP-NNP-NNP,CD-NNP-CD,3,1
1,0.0,31,is,9,1,19,18,0,11,8,10,Sverrir Ingi Ingason,FC Rostov,PER-PER-PER,ORG-ORG,PROPN-PROPN-PROPN,PROPN-PROPN,nsubj-csubj-nsubj,compound-pobj,NNP-NNP-NNP,NNP-NNP,6,1
2,1.0,14,played,2,1,7,6,0,6,1,5,Sverrir,Breiðablik UBK,PER,ORG-ORG,PROPN,PROPN-PROPN,nsubj,compound-pobj,NNP,NNP-NNP,3,1
3,1.0,14,played,2,1,12,11,0,1,1,10,Sverrir,Viking FK,PER,ORG-ORG,PROPN,PROPN-PROPN,nsubj,compound-pobj,NNP,NNP-NNP,5,1
4,2.0,15,moved,9,12,14,2,11,0,-3,5,Lokeren,Belgium,LOC,LOC,PROPN,PROPN,pobj,pobj,NNP,NNP,4,1
0,0.0,31,was,13,16,19,3,15,11,-3,6,U.S.,New Hampshire,LOC,LOC-LOC,PROPN,PROPN-PROPN,compound,compound-pobj,NNP,NNP-NNP,2,1
1,1.0,24,attended,8,8,20,12,7,3,0,12,Wilson,Harvard University,PER,ORG-ORG,PROPN,PROPN-PROPN,nsubj,compound-pobj,NNP,NNP-NNP,3,1
2,1.0,24,attended,8,8,3,-5,7,20,0,-5,Wilson,Peterborough,PER,LOC,PROPN,PROPN,nsubj,pobj,NNP,NNP,1,1
3,1.0,24,attended,8,8,10,2,7,13,0,2,Wilson,Phillips Academy,PER,ORG-ORG,PROPN,PROPN-PROPN,nsubj,compound-dobj,NNP,NNP-NNP,1,1
4,4.0,22,elected,2,1,6,5,0,15,1,4,Wilson,Federalist,PER,ORG,PROPN,PROPN,nsubjpass,pobj,NNP,NNP,2,1
0,1.0,53,appeared,1,36,13,-23,35,39,-35,12,San Francisco Giants,Major League Baseball,ORG-ORG-ORG,ORG-ORG-ORG,PROPN-PROPN-PROPN,PROPN-PROPN-PROPN,compound-compound-pobj,compound-compound-pobj,NNP-NNP-NNPS,NNP-NNP-NNP,12,1
0,0.0,22,Heart,2,10,19,9,9,2,-8,17,Robert Jordan,Wheel of Time,PER-PER,MISC-MISC-MISC,PROPN-PROPN,PROPN-ADP-PROPN,compound-pobj,appos-prep-pobj,NNP-NNP,NNP-IN-NNP,5,1
0,0.0,13,is,2,8,11,3,7,1,-6,9,Essex County,New York,LOC-LOC,LOC-LOC,PROPN-PROPN,PROPN-PROPN,compound-pobj,compound-appos,NNP-NNP,NNP-NNP,1,1
1,3.0,41,slopes,2,28,32,4,27,8,-26,30,Saint Lawrence River,Canada,LOC-LOC-LOC,LOC,PROPN-PROPN-PROPN,PROPN,compound-compound-appos,pobj,NNP-NNP-NNP,NNP,3,1
2,3.0,41,slopes,2,9,17,8,8,23,-7,15,Duck Hole,Cold River,LOC-LOC,LOC-LOC,PROPN-PROPN,PROPN-PROPN,compound-compound,compound-pobj,NNP-NNP,NNP-NNP,6,1
3,3.0,41,slopes,2,17,24,7,16,16,-15,22,Cold River,Raquette River,LOC-LOC,LOC-LOC,PROPN-PROPN,PROPN-PROPN,compound-pobj,compound-pobj,NNP-NNP,NNP-NNP,5,1
0,0.0,44,born,4,1,6,5,0,37,3,2,Gohar Ayub Khan,15 January 1937,PER-PER-PER,TIME-TIME-TIME,PROPN-PROPN-PROPN,NUM-PROPN-NUM,compound-compound-compound,nummod-npadvmod-nummod,NNP-NNP-NNP,CD-NNP-CD,3,1
1,0.0,44,born,4,1,28,27,0,15,3,24,Gohar Ayub Khan,Pakistan Muslim League,PER-PER-PER,ORG-ORG-ORG,PROPN-PROPN-PROPN,PROPN-PROPN-PROPN,compound-compound-compound,compound-compound-pobj,NNP-NNP-NNP,NNP-NNP-NNP,10,1
2,0.0,44,born,4,13,42,29,12,1,-9,38,Pakistani,Nawaz Sharif,LOC,PER-PER,ADJ,PROPN-PROPN,amod,compound-pobj,JJ,NNP-NNP,11,1
3,3.0,23,given,14,11,4,-7,10,18,3,-10,Gohar Ayub Khan,Royal Military Academy Sandhurst,PER-PER-PER,ORG-ORG-ORG-ORG,PROPN-PROPN-PROPN,PROPN-PROPN-PROPN-PROPN,compound-compound-nsubjpass,compound-compound-compound-pobj,NNP-NNP-NNP,NNP-NNP-NNP-NNP,7,1
4,3.0,23,given,14,11,19,8,10,3,3,5,Gohar Ayub Khan,Pakistan Army,PER-PER-PER,ORG-ORG,PROPN-PROPN-PROPN,PROPN-PROPN,compound-compound-nsubjpass,compound-pobj,NNP-NNP-NNP,NNP-NNP,5,1
0,2.0,51,helped,36,38,6,-32,37,44,-2,-30,Union,Army of the Cumberland,ORG,ORG-ORG-ORG-ORG,PROPN,PROPN-ADP-DET-PROPN,compound,pobj-prep-det-pobj,NNP,NNP-IN-DT-NNP,11,1
0,0.0,25,was,11,1,4,3,0,20,10,-7,Homi Wadia,22 May 1911,PER-PER,TIME-TIME-TIME,PROPN-PROPN,NUM-PROPN-NUM,compound-nsubj,nummod-nmod-nummod,NNP-NNP,CD-NNP-CD,1,1
1,0.0,25,was,11,1,8,7,0,16,10,-3,Homi Wadia,10 December 2004,PER-PER,TIME-TIME-TIME,PROPN-PROPN,NUM-PROPN-NUM,compound-nsubj,nummod-npadvmod-nummod,NNP-NNP,CD-NNP-CD,2,1
2,0.0,25,was,11,1,22,21,0,2,10,11,Homi Wadia,Hindi,PER-PER,MISC,PROPN-PROPN,ADJ,compound-nsubj,compound,NNP-NNP,JJ,5,1
3,2.0,40,directed,8,15,17,2,14,22,-7,9,Hunterwali,1935,MISC,TIME,PROPN,NUM,pobj,npadvmod,NNP,CD,2,1
4,2.0,40,directed,8,20,24,4,19,15,-12,16,Miss Frontier Mail,1936,MISC-MISC-MISC,TIME,PROPN-PROPN-PROPN,NUM,compound-compound-conj,appos,NNP-NNP-NNP,CD,2,1
5,2.0,40,directed,8,27,30,3,26,9,-19,22,Diamond Queen,1940,MISC-MISC,TIME,PROPN-PROPN,NUM,compound-conj,appos,NNP-NNP,CD,1,1
6,2.0,40,directed,8,35,38,3,34,1,-27,30,Hatim Tai,1956,MISC-MISC,TIME,PROPN-PROPN,NUM,compound-conj,appos,NNP-NNP,CD,4,1
7,4.0,12,was,2,1,10,9,0,1,1,8,Homi Wadia,Fearless Nadia,PER-PER,PER-PER,PROPN-PROPN,PROPN-PROPN,compound-nsubj,compound-appos,NNP-NNP,NNP-NNP,4,1
8,5.0,16,was,1,1,7,6,0,8,0,6,Homi,JBH Wadia,PER,PER-PER,PROPN,PROPN-PROPN,nsubj,compound-pobj,NNP,NNP-NNP,3,1
0,0.0,14,is,1,7,11,4,6,2,-6,10,City of Brisbane,Queensland,LOC-LOC-LOC,LOC,PROPN-ADP-PROPN,PROPN,pobj-prep-pobj,conj,NNP-IN-NNP,NNP,3,1
1,0.0,14,is,1,7,13,6,6,0,-6,12,City of Brisbane,Australia,LOC-LOC-LOC,LOC,PROPN-ADP-PROPN,PROPN,pobj-prep-pobj,appos,NNP-IN-NNP,NNP,5,1
2,0.0,14,is,1,11,13,2,10,0,-10,12,Queensland,Australia,LOC,LOC,PROPN,PROPN,conj,appos,NNP,NNP,8,1
0,4.0,20,is,5,13,18,5,12,1,-8,13,Museo Nacional de Antropología,Mexico City,LOC-LOC-LOC-LOC,LOC-LOC,PROPN-PROPN-PROPN-PROPN,PROPN-PROPN,nmod-compound-compound-pobj,compound-pobj,NNP-NNP-NNP-NNP,NNP-NNP,3,1
0,1.0,28,is,1,15,23,8,14,4,-14,22,To Bring You My Love,February 1995,MISC-MISC-MISC-MISC-MISC,TIME-TIME,PART-VERB-PRON-DET-NOUN,PROPN-NUM,aux-ROOT-dative-poss-dobj,pobj-nummod,TO-VB-PRP-PRP$-NN,NNP-CD,4,1
1,1.0,28,is,1,15,26,11,14,1,-14,25,To Bring You My Love,Island Records,MISC-MISC-MISC-MISC-MISC,ORG-ORG,PART-VERB-PRON-DET-NOUN,PROPN-PROPN,aux-ROOT-dative-poss-dobj,compound-pobj,TO-VB-PRP-PRP$-NN,NNP-NNPS,3,1
0,0.0,30,was,20,1,9,8,0,20,19,-11,Antonio Adamini,Bigogno,PER-PER,LOC,PROPN-PROPN,PROPN,compound-nsubj,pobj,NNP-NNP,NNP,2,1
1,0.0,30,was,20,1,13,12,0,16,19,-7,Antonio Adamini,"June 16 , 1846",PER-PER,TIME-TIME-TIME-TIME,PROPN-PROPN,PROPN-NUM-PUNCT-NUM,compound-nsubj,npadvmod-nummod-punct-nummod,NNP-NNP,"NNP-CD-,-CD",3,1
2,0.0,30,was,20,1,18,17,0,11,19,-2,Antonio Adamini,St. Petersburg,PER-PER,LOC-LOC,PROPN-PROPN,PROPN-PROPN,compound-nsubj,compound-appos,NNP-NNP,NNP-NNP,2,1
3,0.0,30,was,20,1,26,25,0,3,19,6,Antonio Adamini,Russian,PER-PER,LOC,PROPN-PROPN,ADJ,compound-nsubj,amod,NNP-NNP,JJ,2,1
4,3.0,39,was,5,16,29,13,15,9,-11,24,Alexander Column,1834,MISC-MISC,TIME,PROPN-PROPN,NUM,compound-appos,conj,NNP-NNP,CD,5,1
5,5.0,16,designed,2,8,15,7,7,0,-6,13,Battle of Borodino,Smolensk,MISC-MISC-MISC,LOC,PROPN-ADP-PROPN,PROPN,pobj-prep-pobj,pobj,NNP-IN-NNP,NNP,4,1
0,0.0,26,is,12,11,22,11,10,3,1,10,Lacey,Once Upon a Time,PER,MISC-MISC-MISC-MISC,PROPN,ADV-ADP-DET-NOUN,pobj,ROOT-prep-det-pobj,NNP,RB-IN-DT-NN,2,1
0,0.0,43,is,3,1,39,38,0,3,2,36,Pocatello Regional Airport,Idaho,LOC-LOC-LOC,LOC,PROPN-PROPN-PROPN,PROPN,compound-compound-nsubj,conj,NNP-NNP-NNP,NNP,15,1
1,0.0,43,is,3,1,41,40,0,1,2,38,Pocatello Regional Airport,United States,LOC-LOC-LOC,LOC-LOC,PROPN-PROPN-PROPN,PROPN-PROPN,compound-compound-nsubj,compound-appos,NNP-NNP-NNP,NNP-NNP,15,1
2,0.0,43,is,3,1,36,35,0,6,2,33,Pocatello,Bannock County,LOC,LOC-LOC,PROPN,PROPN-PROPN,pobj,compound-pobj,NNP,NNP-NNP,13,1
3,0.0,43,is,3,1,41,40,0,1,2,38,Pocatello,United States,LOC,LOC-LOC,PROPN,PROPN-PROPN,pobj,compound-appos,NNP,NNP-NNP,15,1
4,0.0,43,is,3,36,39,3,35,3,-33,36,Bannock County,Idaho,LOC-LOC,LOC,PROPN-PROPN,PROPN,compound-pobj,conj,NNP-NNP,NNP,2,1
5,0.0,43,is,3,36,41,5,35,1,-33,38,Bannock County,United States,LOC-LOC,LOC-LOC,PROPN-PROPN,PROPN-PROPN,compound-pobj,compound-appos,NNP-NNP,NNP-NNP,2,1
6,0.0,43,is,3,39,41,2,38,1,-36,38,Idaho,United States,LOC,LOC-LOC,PROPN,PROPN-PROPN,conj,compound-appos,NNP,NNP-NNP,2,1
0,0.0,35,is,5,2,30,28,1,4,3,25,Union Beach School System,New Jersey,ORG-ORG-ORG-ORG,LOC-LOC,PROPN-PROPN-PROPN-PROPN,PROPN-PROPN,compound-compound-compound-nsubj,compound-conj,NNP-NNP-NNP-NNP,NNP-NNP,8,1
1,0.0,35,is,5,2,33,31,1,1,3,28,Union Beach School System,United States,ORG-ORG-ORG-ORG,LOC-LOC,PROPN-PROPN-PROPN-PROPN,PROPN-PROPN,compound-compound-compound-nsubj,compound-appos,NNP-NNP-NNP-NNP,NNP-NNP,8,1
2,0.0,35,is,5,2,27,25,1,7,3,22,Union Beach,Monmouth County,LOC-LOC,LOC-LOC,PROPN-PROPN,PROPN-PROPN,compound-pobj,compound-pobj,NNP-NNP,NNP-NNP,7,1
3,0.0,35,is,5,2,33,31,1,1,3,28,Union Beach,United States,LOC-LOC,LOC-LOC,PROPN-PROPN,PROPN-PROPN,compound-pobj,compound-appos,NNP-NNP,NNP-NNP,8,1
4,0.0,35,is,5,27,30,3,26,4,-22,25,Monmouth County,New Jersey,LOC-LOC,LOC-LOC,PROPN-PROPN,PROPN-PROPN,compound-pobj,compound-conj,NNP-NNP,NNP-NNP,1,1
5,0.0,35,is,5,27,33,6,26,1,-22,28,Monmouth County,United States,LOC-LOC,LOC-LOC,PROPN-PROPN,PROPN-PROPN,compound-pobj,compound-appos,NNP-NNP,NNP-NNP,1,1
6,0.0,35,is,5,30,33,3,29,1,-25,28,New Jersey,United States,LOC-LOC,LOC-LOC,PROPN-PROPN,PROPN-PROPN,compound-conj,compound-appos,NNP-NNP,NNP-NNP,2,1
0,0.0,33,is,7,17,21,4,16,11,-10,14,McDonnell Douglas,Boeing,ORG-ORG,ORG,PROPN-PROPN,PROPN,compound-pobj,appos,NNP-NNP,NNP,2,1
0,0.0,55,was,12,1,5,4,0,49,11,-7,Claude Stanley Choules,3 March 1901,PER-PER-PER,TIME-TIME-TIME,PROPN-PROPN-PROPN,NUM-PROPN-NUM,compound-compound-nsubj,nummod-nmod-nummod,NNP-NNP-NNPS,CD-NNP-CD,3,1
1,0.0,55,was,12,1,9,8,0,45,11,-3,Claude Stanley Choules,5 May 2011,PER-PER-PER,TIME-TIME-TIME,PROPN-PROPN-PROPN,NUM-PROPN-NUM,compound-compound-nsubj,nummod-appos-nummod,NNP-NNP-NNPS,CD-NNP-CD,3,1
2,0.0,55,was,12,1,21,20,0,33,11,9,Claude Stanley Choules,Perth,PER-PER-PER,LOC,PROPN-PROPN-PROPN,PROPN,compound-compound-nsubj,pobj,NNP-NNP-NNPS,NNP,7,1
3,0.0,55,was,12,1,39,38,0,15,11,27,Claude Stanley Choules,First World War,PER-PER-PER,MISC-MISC-MISC,PROPN-PROPN-PROPN,PROPN-PROPN-PROPN,compound-compound-nsubj,compound-compound-pobj,NNP-NNP-NNPS,NNP-NNP-NNP,9,1
4,0.0,55,was,12,1,49,48,0,5,11,37,Claude Stanley Choules,Royal Navy,PER-PER-PER,ORG-ORG,PROPN-PROPN-PROPN,PROPN-PROPN,compound-compound-nsubj,compound-pobj,NNP-NNP-NNPS,NNP-NNP,5,1
5,0.0,55,was,12,21,23,2,20,31,-9,11,Perth,Western Australia,LOC,LOC-LOC,PROPN,PROPN-PROPN,pobj,compound-appos,NNP,NNP-NNP,2,1
6,2.0,32,was,1,16,19,3,15,12,-15,18,Scapa Flow,1919,LOC-LOC,TIME,PROPN-PROPN,NUM,compound-pobj,pobj,NNP-NNP,CD,7,1
7,5.0,21,became,1,15,18,3,14,2,-14,17,Stanley Lucas,21 June 2010,PER-PER,TIME-TIME-TIME,PROPN-PROPN,NUM-PROPN-NUM,compound-pobj,nummod-pobj-nummod,NNP-NNP,CD-NNP-CD,4,1
8,5.0,21,became,1,15,9,-6,14,11,-14,8,Stanley Lucas,United Kingdom,PER-PER,LOC-LOC,PROPN-PROPN,PROPN-PROPN,compound-pobj,compound-pobj,NNP-NNP,NNP-NNP,6,1
9,7.0,22,went,16,20,6,-14,19,15,-4,-10,Reginald Dean,British,PER-PER,LOC,PROPN-PROPN,PROPN,compound-pobj,npadvmod,NNP-NNP,NNP,6,1
0,0.0,34,Boase,1,1,16,15,0,17,0,15,Wendy Boase,Australia,PER-PER,LOC,PROPN-PROPN,PROPN,compound-ROOT,pobj,NNP-NNP,NNP,2,1
1,0.0,34,Boase,1,14,16,2,13,17,-13,15,Melbourne,Australia,LOC,LOC,PROPN,PROPN,nmod,pobj,NNP,NNP,7,1
0,3.0,35,won,10,9,5,-4,8,29,1,-5,De Niro,Academy Award,PER-PER,MISC-MISC,PROPN-PROPN,PROPN-PROPN,compound-nsubj,compound-compound,NNP-NNP,NNP-NNP,3,1
1,3.0,35,won,10,9,13,4,8,21,1,3,De Niro,Oscars,PER-PER,MISC,PROPN-PROPN,PROPN,compound-nsubj,dobj,NNP-NNP,NNPS,2,1
2,3.0,35,won,10,30,33,3,29,1,-20,23,Raging Bull,1980,MISC-MISC,TIME,PROPN-PROPN,NUM,compound-pobj,appos,NNP-NNP,CD,1,1
3,3.0,35,won,10,16,19,3,15,15,-6,9,Vito Corleone,The Godfather Part II,PER-PER,MISC-MISC-MISC-MISC,PROPN-PROPN,DET-PROPN-PROPN-PROPN,compound-dobj,det-compound-compound-pobj,NNP-NNP,DT-NNP-NNP-NNP,4,1
4,3.0,35,won,10,19,24,5,18,10,-9,14,The Godfather Part II,1974,MISC-MISC-MISC-MISC,TIME,DET-PROPN-PROPN-PROPN,NUM,det-compound-compound-pobj,appos,DT-NNP-NNP-NNP,CD,6,1
5,6.0,26,was,4,12,7,-5,11,18,-8,3,Kennedy Center Honors,the United States,MISC-MISC-MISC,LOC-LOC-LOC,PROPN-PROPN-PROPN,DET-PROPN-PROPN,compound-compound-pobj,det-compound-pobj,NNP-NNP-NNP,DT-NNP-NNP,4,1
6,6.0,26,was,4,7,24,17,6,1,-3,20,the United States,Barack Obama,LOC-LOC-LOC,PER-PER,DET-PROPN-PROPN,PROPN-PROPN,det-compound-pobj,compound-appos,DT-NNP-NNP,NNP-NNP,6,1
0,0.0,24,is,10,16,23,7,15,0,-6,13,Baltic Sea,Estonia,LOC-LOC,LOC,PROPN-PROPN,PROPN,compound-pobj,pobj,NNP-NNP,NNP,4,1
1,1.0,53,comprises,1,1,12,11,0,40,0,11,Öakse,Soonlepa Gulf,LOC,LOC-LOC,PROPN,PROPN-PROPN,nsubj,compound-pobj,NNP,NNP-NNP,3,1
0,6.0,29,is,1,6,27,21,5,1,-5,26,John,Christian,ORG,ORG,PROPN,ADJ,pobj,amod,NNP,JJ,6,1
0,0.0,21,is,1,1,12,11,0,8,0,11,Summit,United States,LOC,LOC-LOC,PROPN,PROPN-PROPN,nsubj,compound-conj,NNP,NNP-NNP,4,1
1,0.0,21,is,1,7,10,3,6,10,-6,9,Boyd County,Kentucky,LOC-LOC,LOC,PROPN-PROPN,PROPN,compound-pobj,conj,NNP-NNP,NNP,1,1
2,0.0,21,is,1,7,12,5,6,8,-6,11,Boyd County,United States,LOC-LOC,LOC-LOC,PROPN-PROPN,PROPN-PROPN,compound-pobj,compound-conj,NNP-NNP,NNP-NNP,1,1
3,0.0,21,is,1,10,12,2,9,8,-9,11,Kentucky,United States,LOC,LOC-LOC,PROPN,PROPN-PROPN,conj,compound-conj,NNP,NNP-NNP,2,1
0,0.0,21,was,12,1,9,8,0,11,11,-3,Charles Stephen Boreham,15 May 1925,PER-PER-PER,TIME-TIME-TIME,PROPN-PROPN-PROPN,NUM-PROPN-NUM,compound-compound-nsubj,nummod-appos-nummod,NNP-NNP-NNP,CD-NNP-CD,2,1
1,1.0,14,born,2,5,7,2,4,6,-3,5,Richmond,Tasmania,LOC,LOC,PROPN,PROPN,pobj,conj,NNP,NNP,3,1
2,1.0,14,born,2,5,9,4,4,4,-3,7,Richmond,Australia,LOC,LOC,PROPN,PROPN,pobj,appos,NNP,NNP,4,1
3,1.0,14,born,2,7,9,2,6,4,-5,7,Tasmania,Australia,LOC,LOC,PROPN,PROPN,conj,appos,NNP,NNP,3,1
0,0.0,22,was,8,1,20,19,0,1,7,12,Amrut Rao,Raghunath Rao,PER-PER,PER-PER,PROPN-PROPN,PROPN-PROPN,compound-nsubj,compound-pobj,NNP-NNP,NNP-NNP,5,1
0,0.0,49,(;,5,37,48,11,36,0,-32,43,Île de la Cité,France,LOC-LOC-LOC-LOC,LOC,PROPN-PROPN-PROPN-PROPN,PROPN,compound-compound-compound-pobj,appos,NNP-NNP-NNP-NNP,NNP,5,1
1,0.0,49,(;,5,5,48,43,4,0,0,43,Paris,France,LOC,LOC,PROPN,PROPN,pobj,appos,NNP,NNP,2,1
2,5.0,24,revived,22,6,10,4,5,13,16,-12,Victor Hugo,The Hunchback of Notre Dame,PER-PER,MISC-MISC-MISC-MISC-MISC,PROPN-PROPN,DET-PROPN-ADP-PROPN-PROPN,compound-poss,det-appos-prep-compound-pobj,NNP-NNP,DT-NNP-IN-NNP-NNP,2,1
0,0.0,18,is,1,11,17,6,10,0,-10,16,Belgrade,Serbia,LOC,LOC,PROPN,PROPN,pobj,pobj,NNP,NNP,5,1
0,0.0,36,is,3,1,35,34,0,0,2,32,Crkvine,Serbia,LOC,LOC,PROPN,PROPN,nsubj,pobj,NNP,NNP,2,1
1,0.0,36,is,3,16,21,5,15,14,-13,18,Stubline,Obrenovac,LOC,LOC,PROPN,PROPN,pobj,pobj,NNP,NNP,3,1
2,0.0,36,is,3,16,28,12,15,7,-13,25,Stubline,City of Belgrade,LOC,LOC-LOC-LOC,PROPN,PROPN-ADP-PROPN,pobj,pobj-prep-pobj,NNP,NNP-IN-NNP,7,1
3,0.0,36,is,3,16,35,19,15,0,-13,32,Stubline,Serbia,LOC,LOC,PROPN,PROPN,pobj,pobj,NNP,NNP,4,1
4,0.0,36,is,3,21,28,7,20,7,-18,25,Obrenovac,City of Belgrade,LOC,LOC-LOC-LOC,PROPN,PROPN-ADP-PROPN,pobj,pobj-prep-pobj,NNP,NNP-IN-NNP,6,1
5,0.0,36,is,3,21,35,14,20,0,-18,32,Obrenovac,Serbia,LOC,LOC,PROPN,PROPN,pobj,pobj,NNP,NNP,3,1
6,0.0,36,is,3,28,35,7,27,0,-25,32,City of Belgrade,Serbia,LOC-LOC-LOC,LOC,PROPN-ADP-PROPN,PROPN,pobj-prep-pobj,pobj,NNP-IN-NNP,NNP,7,1
0,0.0,40,is,2,1,15,14,0,24,1,13,Melana Chasmata,Triptykon,MISC-MISC,ORG,PROPN-PROPN,PROPN,compound-nsubj,pobj,NNP-NNP,NNP,3,1
1,0.0,40,is,2,1,19,18,0,20,1,17,Melana Chasmata,Prowling Death Records,MISC-MISC,ORG-ORG-ORG,PROPN-PROPN,PROPN-PROPN-PROPN,compound-nsubj,compound-compound-nmod,NNP-NNP,NNP-NNP-NNPS,7,1
2,0.0,40,is,2,1,23,22,0,16,1,21,Melana Chasmata,Century Media Records,MISC-MISC,ORG-ORG-ORG,PROPN-PROPN,PROPN-PROPN-PROPN,compound-nsubj,compound-compound-pobj,NNP-NNP,NNP-NNP-NNPS,6,1
3,0.0,40,is,2,15,19,4,14,20,-13,17,Triptykon,Prowling Death Records,ORG,ORG-ORG-ORG,PROPN,PROPN-PROPN-PROPN,pobj,compound-compound-nmod,NNP,NNP-NNP-NNPS,6,1
4,0.0,40,is,2,15,23,8,14,16,-13,21,Triptykon,Century Media Records,ORG,ORG-ORG-ORG,PROPN,PROPN-PROPN-PROPN,pobj,compound-compound-pobj,NNP,NNP-NNP-NNPS,5,1
5,5.0,49,provided,17,45,48,3,44,0,-28,31,Eparistera Daimones,2010,MISC-MISC,TIME,PROPN-PROPN,NUM,compound-pobj,pobj,NNP-NNP,CD,3,1
6,5.0,49,provided,17,45,42,-3,44,6,-28,25,Eparistera Daimones,Triptykon,MISC-MISC,ORG,PROPN-PROPN,PROPN,compound-pobj,poss,NNP-NNP,NNP,3,1
7,8.0,18,released,12,6,15,9,5,2,6,3,Tree of Suffocating Souls,17 November 2014,MISC-MISC-MISC-MISC,TIME-TIME-TIME,NOUN-ADP-PROPN-PROPN,NUM-PROPN-NUM,pobj-prep-compound-pobj,nummod-pobj-nummod,NN-IN-NNP-NNPS,CD-NNP-CD,6,1
0,0.0,17,was,11,1,5,4,0,11,10,-6,William Harry Towers,13 July 1920,PER-PER-PER,TIME-TIME-TIME,PROPN-PROPN-PROPN,NUM-PROPN-NUM,compound-compound-nsubj,nummod-nmod-nummod,NNP-NNP-NNPS,CD-NNP-CD,2,1
1,0.0,17,was,11,1,9,8,0,7,10,-2,William Harry Towers,April 2000,PER-PER-PER,TIME-TIME,PROPN-PROPN-PROPN,PROPN-NUM,compound-compound-nsubj,npadvmod-nummod,NNP-NNP-NNPS,NNP-CD,3,1
2,2.0,12,signed,2,1,5,4,0,6,1,3,Bill Towers,Leicester City,PER-PER,LOC-LOC,PROPN-PROPN,PROPN-PROPN,compound-nsubj,compound-pobj,NNP-NNP,NNP-NNP,3,1
3,2.0,12,signed,2,1,10,9,0,1,1,8,Bill Towers,Bentley Eng,PER-PER,PER-PER,PROPN-PROPN,PROPN-PROPN,compound-nsubj,compound-pobj,NNP-NNP,NNP-NNP,3,1
4,5.0,52,played,6,6,25,19,5,26,0,19,Towers,FA Cup,PER,MISC-MISC,PROPN,PROPN-PROPN,nsubj,compound-pobj,NNP,NNP-NNP,3,1
0,0.0,25,is,3,2,16,14,1,8,1,13,East River,West Virginia,LOC-LOC,LOC-LOC,PROPN-PROPN,PROPN-PROPN,compound-nsubj,compound-pobj,NNP-NNP,NNP-NNP,4,1
1,0.0,25,is,3,2,8,6,1,16,1,5,East River,the United States,LOC-LOC,LOC-LOC-LOC,PROPN-PROPN,DET-PROPN-PROPN,compound-nsubj,det-compound-pobj,NNP-NNP,DT-NNP-NNP,5,1
2,0.0,25,is,3,9,16,7,8,8,-6,13,New River,West Virginia,LOC-LOC,LOC-LOC,PROPN-PROPN,PROPN-PROPN,compound-pobj,compound-pobj,NNP-NNP,NNP-NNP,6,1
3,0.0,25,is,3,9,8,-1,8,16,-6,5,New River,the United States,LOC-LOC,LOC-LOC-LOC,PROPN-PROPN,DET-PROPN-PROPN,compound-pobj,det-compound-pobj,NNP-NNP,DT-NNP-NNP,1,1
4,0.0,25,is,3,16,8,-8,15,16,-13,5,West Virginia,the United States,LOC-LOC,LOC-LOC-LOC,PROPN-PROPN,DET-PROPN-PROPN,compound-pobj,det-compound-pobj,NNP-NNP,DT-NNP-NNP,7,1
5,0.0,25,is,3,17,8,-9,16,16,-14,5,Virginia,the United States,LOC,LOC-LOC-LOC,PROPN,DET-PROPN-PROPN,dobj,det-compound-pobj,NNP,DT-NNP-NNP,8,1
6,1.0,33,is,10,7,18,11,6,14,3,8,Ohio,Mississippi River,LOC,LOC-LOC,PROPN,PROPN-PROPN,conj,compound-pobj,NNP,NNP-NNP,7,1
7,3.0,71,rises,1,56,11,-45,55,59,-55,10,Hardy,West Virginia,LOC,LOC-LOC,ADJ,PROPN-PROPN,conj,compound-appos,JJ,NNP-NNP,6,1
8,4.0,21,flows,1,16,19,3,15,1,-15,18,Glen Lyn,Giles County,LOC-LOC,LOC-LOC,PROPN-PROPN,PROPN-PROPN,compound-pobj,compound-pobj,NNP-NNP,NNP-NNP,2,1
9,4.0,21,flows,1,19,10,-9,18,10,-18,9,Giles County,Virginia,LOC-LOC,LOC,PROPN-PROPN,PROPN,compound-pobj,dobj,NNP-NNP,NNP,7,1
0,3.0,41,In,0,30,40,10,29,0,-30,40,Partaw,Albania,LOC,LOC,PROPN,PROPN,conj,pobj,NNP,NNP,3,1
1,4.0,10,forced,2,9,7,-2,8,2,-7,5,Peroz I.,Zoroastrianism,PER-PER,ORG,PROPN-NOUN,PROPN,compound-pobj,pobj,NNP-NN,NNP,1,1
0,0.0,29,is,4,1,18,17,0,10,3,14,The Kaiser Aluminum Hour,the United States,MISC-MISC-MISC-MISC,LOC-LOC-LOC,DET-PROPN-PROPN-PROPN,DET-PROPN-PROPN,det-compound-compound-nsubj,det-compound-pobj,DT-NNP-NNP-NNP,DT-NNP-NNP,7,1
1,0.0,29,is,4,1,28,27,0,0,3,24,The Kaiser Aluminum Hour,NBC,MISC-MISC-MISC-MISC,ORG,DET-PROPN-PROPN-PROPN,PROPN,det-compound-compound-nsubj,pobj,DT-NNP-NNP-NNP,NNP,3,1
0,0.0,34,Meyer,1,1,4,3,0,29,0,3,Joseph Meyer,"March 12 , 1894",PER-PER,TIME-TIME-TIME-TIME,PROPN-PROPN,PROPN-NUM-PUNCT-NUM,compound-ROOT,appos-nummod-punct-nummod,NNP-NNP,"NNP-CD-,-CD",2,1
1,0.0,34,Meyer,1,1,9,8,0,24,0,8,Joseph Meyer,"June 22 , 1987",PER-PER,TIME-TIME-TIME-TIME,PROPN-PROPN,PROPN-NUM-PUNCT-NUM,compound-ROOT,nsubj-nummod-punct-nummod,NNP-NNP,"NNP-CD-,-CD",3,1
2,2.0,50,were,6,32,38,6,31,11,-26,32,If You Knew Susie,1925,MISC-MISC-MISC-MISC,TIME,ADP-PRON-PROPN-PROPN,NUM,mark-nsubj-compound-conj,appos,IN-PRP-NNP-NNP,CD,3,1
3,5.0,23,recorded,2,7,11,4,6,11,-5,9,Summer Colors,1967,MISC-MISC,TIME,PROPN-PROPN,NUM,compound-appos,pobj,NNP-NNPS,CD,4,1
0,5.0,16,are,6,8,3,-5,7,12,-2,-3,China,Asian Volleyball Cup,LOC,MISC-MISC-MISC,PROPN,PROPN-PROPN-PROPN,attr,compound-compound-compound,NNP,NNP-NNP-NNP,5,1
1,5.0,16,are,6,10,3,-7,9,12,-4,-3,South Korea,Asian Volleyball Cup,LOC-LOC,MISC-MISC-MISC,PROPN-PROPN,PROPN-PROPN-PROPN,compound-conj,compound-compound-compound,NNP-NNP,NNP-NNP-NNP,5,1
2,6.0,15,took,7,11,14,3,10,0,-4,7,Nakhon Pathom,Thailand,LOC-LOC,LOC,PROPN-PROPN,PROPN,compound-pobj,appos,NNP-NNP,NNP,3,1
0,0.0,24,was,3,1,7,6,0,16,2,4,Greater Manchester East,1984,LOC-LOC-LOC,TIME,PROPN-PROPN-PROPN,NUM,compound-compound-nsubj,pobj,NNP-NNP-NNP,CD,4,1
1,0.0,24,was,3,1,21,20,0,2,2,18,Greater Manchester,North West England,LOC-LOC,LOC-LOC-LOC,PROPN-PROPN,PROPN-PROPN-PROPN,compound-pobj,compound-compound-pobj,NNP-NNP,NNP-NNP-NNP,6,1
2,3.0,33,used,14,12,28,16,11,4,2,14,the United Kingdom,England,LOC-LOC-LOC,LOC,DET-PROPN-PROPN,PROPN,det-compound-nsubj,pobj,DT-NNP-NNP,NNP,8,1
3,3.0,33,used,14,12,30,18,11,2,2,16,the United Kingdom,Scotland,LOC-LOC-LOC,LOC,DET-PROPN-PROPN,PROPN,det-compound-nsubj,conj,DT-NNP-NNP,NNP,9,1
4,3.0,33,used,14,12,32,20,11,0,2,18,the United Kingdom,Wales,LOC-LOC-LOC,LOC,DET-PROPN-PROPN,PROPN,det-compound-nsubj,conj,DT-NNP-NNP,NNP,3,1
0,0.0,28,is,4,12,26,14,11,1,-8,22,Weißkugel,Ötztal Alps,LOC,LOC-LOC,PROPN,PROPN-PROPN,dobj,compound-pobj,NNP,NNP-NNPS,6,1
1,0.0,28,is,4,16,26,10,15,1,-12,22,Wildspitze,Ötztal Alps,LOC,LOC-LOC,PROPN,PROPN-PROPN,conj,compound-pobj,NNP,NNP-NNPS,4,1
0,0.0,24,was,12,1,5,4,0,18,11,-7,Johan Jakob Jakobsen,15 April 1937,PER-PER-PER,TIME-TIME-TIME,PROPN-PROPN-PROPN,NUM-PROPN-NUM,compound-compound-nsubj,nummod-appos-nummod,NNP-NNP-NNP,CD-NNP-CD,2,1
1,0.0,24,was,12,1,9,8,0,14,11,-3,Johan Jakob Jakobsen,30 June 2018,PER-PER-PER,TIME-TIME-TIME,PROPN-PROPN-PROPN,NUM-PROPN-NUM,compound-compound-nsubj,nummod-npadvmod-nummod,NNP-NNP-NNP,CD-NNP-CD,3,1
0,0.0,37,War,2,2,5,3,1,31,0,3,Korean War,"June 25 , 1950",MISC-MISC,TIME-TIME-TIME-TIME,PROPN-PROPN,PROPN-NUM-PUNCT-NUM,amod-ROOT,npadvmod-nummod-punct-nummod,NNP-NNP,"NNP-CD-,-CD",2,1
0,0.0,31,Sheridan,2,1,5,4,0,25,1,3,Philip Henry Sheridan,"March 6 , 1831",PER-PER-PER,TIME-TIME-TIME-TIME,PROPN-PROPN-PROPN,PROPN-NUM-PUNCT-NUM,compound-compound-ROOT,appos-nummod-punct-nummod,NNP-NNP-NNP,"NNP-CD-,-CD",3,1
1,0.0,31,Sheridan,2,1,10,9,0,20,1,8,Philip Henry Sheridan,"August 5 , 1888",PER-PER-PER,TIME-TIME-TIME-TIME,PROPN-PROPN-PROPN,PROPN-NUM-PUNCT-NUM,compound-compound-ROOT,nsubj-nummod-punct-nummod,NNP-NNP-NNP,"NNP-CD-,-CD",4,1
2,0.0,31,Sheridan,2,1,24,23,0,6,1,22,Philip Henry Sheridan,Union,PER-PER-PER,ORG,PROPN-PROPN-PROPN,PROPN,compound-compound-ROOT,compound,NNP-NNP-NNP,NNP,4,1
3,0.0,31,Sheridan,2,1,28,27,0,2,1,26,Philip Henry Sheridan,American Civil War,PER-PER-PER,MISC-MISC-MISC,PROPN-PROPN-PROPN,PROPN-PROPN-PROPN,compound-compound-ROOT,compound-compound-pobj,NNP-NNP-NNP,NNP-NNP-NNP,7,1
4,4.0,14,fought,1,1,8,7,0,5,0,7,Sheridan,Indian Wars,PER,MISC-MISC,PROPN,ADJ-PROPN,nsubj,compound-pobj,NNP,JJ-NNPS,2,1
0,0.0,30,centred,8,4,7,3,3,22,4,-1,Zimbabwe,Africa,LOC,LOC,PROPN,PROPN,pobj,pobj,NNP,NNP,5,1
0,0.0,37,"""",0,2,23,21,1,13,-2,23,Sentiments songes,French,MISC-MISC,LOC,NOUN-NOUN,ADJ,nsubj-ROOT,amod,NNS-NNS,JJ,2,1
1,0.0,37,"""",0,2,36,34,1,0,-2,36,Sentiments songes,Fanny,MISC-MISC,PER,NOUN-NOUN,PROPN,nsubj-ROOT,pobj,NNS-NNS,NNP,1,1
2,0.0,37,"""",0,27,36,9,26,0,-27,36,Eurovision Song Contest 1997,Fanny,MISC-MISC-MISC-MISC,PER,PROPN-PROPN-PROPN-NUM,PROPN,compound-compound-pobj-appos,pobj,NNP-NNP-NNP-CD,NNP,6,1
3,6.0,19,succeeded,2,9,12,3,8,6,-7,10,1998 Contest,Marie Line,MISC-MISC,PER-PER,NUM-PROPN,PROPN-PROPN,nummod-pobj,compound-pobj,CD-NNP,NNP-NNP,2,1
4,6.0,19,succeeded,2,12,5,-7,11,13,-10,3,Marie Line,French,PER-PER,LOC,PROPN-PROPN,ADJ,compound-pobj,amod,NNP-NNP,JJ,6,1
5,6.0,19,succeeded,2,16,5,-11,15,13,-14,3,Où aller,French,MISC-MISC,LOC,PROPN-NOUN,ADJ,amod-pobj,amod,NNP-NN,JJ,6,1
0,2.0,25,founded,3,2,9,7,1,15,1,6,BSP,Belgian Labour Party,ORG,ORG-ORG-ORG,PROPN,PROPN-PROPN-PROPN,nsubjpass,compound-compound-pobj,NNP,NNP-NNP-NNP,6,1
1,2.0,25,founded,3,9,13,4,8,11,-6,10,Belgian Labour Party,1885,ORG-ORG-ORG,TIME,PROPN-PROPN-PROPN,NUM,compound-compound-pobj,nummod,NNP-NNP-NNP,CD,3,1
2,6.0,35,split,13,11,21,10,10,13,2,8,Belgian Socialist Party,Socialistische Partij,ORG-ORG-ORG,ORG-ORG,PROPN-PROPN-PROPN,PROPN-PROPN,compound-compound-nsubj,compound-appos,NNP-NNP-NNP,NNP-NNP,3,1
3,6.0,35,split,13,11,29,18,10,5,2,16,Belgian Socialist Party,Parti Socialiste,ORG-ORG-ORG,ORG-ORG,PROPN-PROPN-PROPN,PROPN-PROPN,compound-compound-nsubj,compound-conj,NNP-NNP-NNP,NNP-NNP,4,1
0,0.0,22,is,1,1,11,10,0,10,0,10,Nihil,KMFDM,MISC,ORG,PROPN,PROPN,nsubj,appos,NNP,NNP,2,1
1,0.0,22,is,1,11,20,9,10,1,-10,19,KMFDM,Wax Trax!/TVT,ORG,ORG-ORG,PROPN,PROPN-PROPN,appos,pobj-ROOT,NNP,NNP-NNP,4,1
0,0.0,25,is,12,2,21,19,1,3,10,9,Yale University,New Haven,ORG-ORG,LOC-LOC,PROPN-PROPN,PROPN-PROPN,compound-pobj,compound-pobj,NNP-NNP,NNP-NNP,6,1
1,0.0,25,is,12,2,24,22,1,0,10,12,Yale University,Connecticut,ORG-ORG,LOC,PROPN-PROPN,PROPN,compound-pobj,appos,NNP-NNP,NNP,2,1
2,2.0,15,is,3,5,10,5,4,4,-2,7,Ernesto Zedillo,Mexico,PER-PER,LOC,PROPN-PROPN,PROPN,compound-attr,pobj,NNP-NNP,NNP,2,1
0,0.0,31,is,3,1,12,11,0,18,2,9,Monte San Martino,Province of Macerata,LOC-LOC-LOC,LOC-LOC-LOC,PROPN-PROPN-PROPN,PROPN-ADP-PROPN,compound-compound-nsubj,pobj-prep-pobj,NNP-NNP-NNP,NNP-IN-NNP,6,1
1,0.0,31,is,3,1,17,16,0,13,2,14,Monte San Martino,Italian,LOC-LOC-LOC,LOC,PROPN-PROPN-PROPN,ADJ,compound-compound-nsubj,amod,NNP-NNP-NNP,JJ,7,1
2,0.0,31,is,3,12,17,5,11,13,-9,14,Province of Macerata,Italian,LOC-LOC-LOC,LOC,PROPN-ADP-PROPN,ADJ,pobj-prep-pobj,amod,NNP-IN-NNP,JJ,3,1
3,0.0,31,is,3,12,19,7,11,11,-9,16,Province of Macerata,Marche,LOC-LOC-LOC,LOC,PROPN-ADP-PROPN,PROPN,pobj-prep-pobj,appos,NNP-IN-NNP,NNP,4,1
4,0.0,31,is,3,12,14,2,11,16,-9,11,Province of Macerata,Macerata,LOC-LOC-LOC,LOC,PROPN-ADP-PROPN,PROPN,pobj-prep-pobj,pobj,NNP-IN-NNP,NNP,2,1
5,0.0,31,is,3,17,19,2,16,11,-14,16,Italian,Marche,LOC,LOC,ADJ,PROPN,amod,appos,JJ,NNP,5,1
6,4.0,33,founded,6,2,9,7,1,23,4,3,Monte San Martino Trust,1989,ORG-ORG-ORG-ORG,TIME,PROPN-PROPN-PROPN-PROPN,NUM,compound-compound-compound-nsubjpass,pobj,NNP-NNP-NNP-NNP,CD,4,1
0,0.0,32,is,9,1,6,5,0,25,8,-3,Muhammad Akbar Nasution,6 May 1983,PER-PER-PER,TIME-TIME-TIME,PROPN-PROPN-PROPN,NUM-PROPN-NUM,compound-compound-nsubj,nummod-npadvmod-nummod,NNP-NNP-NNP,CD-NNP-CD,3,1
1,3.0,54,travelled,11,9,47,38,8,6,2,36,Nasurion,Chaffey College,PER,ORG-ORG,PROPN,PROPN-PROPN,nsubj,compound-pobj,NNP,NNP-NNP,7,1
2,3.0,54,travelled,11,47,53,6,46,0,-36,42,Chaffey College,California,ORG-ORG,LOC,PROPN-PROPN,PROPN,compound-pobj,appos,NNP-NNP,NNP,7,1
3,3.0,54,travelled,11,50,53,3,49,0,-39,42,Rancho Cucamonga,California,LOC-LOC,LOC,PROPN-PROPN,PROPN,compound-pobj,appos,NNP-NNP,NNP,7,1
0,0.0,55,was,8,4,23,19,3,31,4,15,Central American,Guatemala,ORG-ORG,ORG,ADJ-ADJ,PROPN,amod-amod,pobj,JJ-JJ,NNP,10,1
1,0.0,55,was,8,4,25,21,3,29,4,17,Central American,El Salvador,ORG-ORG,ORG-ORG,ADJ-ADJ,PROPN-PROPN,amod-amod,compound-conj,JJ-JJ,NNP-NNP,10,1
2,0.0,55,was,8,4,28,24,3,26,4,20,Central American,Honduras,ORG-ORG,ORG,ADJ-ADJ,PROPN,amod-amod,conj,JJ-JJ,NNP,12,1
3,0.0,55,was,8,4,31,27,3,23,4,23,Central American,Nicaragua,ORG-ORG,ORG,ADJ-ADJ,PROPN,amod-amod,conj,JJ-JJ,NNP,4,1
0,0.0,50,"""",0,2,17,15,1,32,-2,17,Have You Ever Been in Love,Celine Dion,MISC-MISC-MISC-MISC-MISC-MISC,PER-PER,VERB-PRON-ADV-VERB-ADP-NOUN,PROPN-PROPN,aux-nsubj-advmod-ccomp-prep-pobj,compound-pobj,VBP-PRP-RB-VBN-IN-NN,NNP-NNP,6,1
1,0.0,50,"""",0,2,28,26,1,21,-2,28,Have You Ever Been in Love,A New Day Has Come,MISC-MISC-MISC-MISC-MISC-MISC,MISC-MISC-MISC-MISC-MISC,VERB-PRON-ADV-VERB-ADP-NOUN,DET-PROPN-NOUN-VERB-VERB,aux-nsubj-advmod-ccomp-prep-pobj,det-compound-nsubj-aux-ROOT,VBP-PRP-RB-VBN-IN-NN,DT-NNP-NN-VBZ-VBN,8,1
2,0.0,50,"""",0,28,34,6,27,15,-28,34,A New Day Has Come,2002,MISC-MISC-MISC-MISC-MISC,TIME,DET-PROPN-NOUN-VERB-VERB,NUM,det-compound-nsubj-aux-ROOT,npadvmod,DT-NNP-NN-VBZ-VBN,CD,8,1
3,0.0,50,"""",0,28,45,17,27,4,-28,45,A New Day Has Come,One Heart,MISC-MISC-MISC-MISC-MISC,MISC-MISC,DET-PROPN-NOUN-VERB-VERB,NUM-PROPN,det-compound-nsubj-aux-ROOT,nummod-appos,DT-NNP-NN-VBZ-VBN,CD-NNP,9,1
4,0.0,50,"""",0,45,48,3,44,1,-45,48,One Heart,2003,MISC-MISC,TIME,NUM-PROPN,NUM,nummod-appos,appos,CD-NNP,CD,1,1
5,6.0,51,"""",0,2,12,10,1,38,-2,12,Have You Ever Been in Love,14 April 2003,MISC-MISC-MISC-MISC-MISC-MISC,TIME-TIME-TIME,VERB-PRON-ADV-VERB-ADP-PROPN,NUM-PROPN-NUM,aux-nsubj-advmod-advcl-prep-pobj,nummod-pobj-nummod,VBP-PRP-RB-VBN-IN-NNP,CD-NNP-CD,4,1
0,0.0,30,is,8,2,14,12,1,15,6,6,Add Some Music to Your Day,Brian Wilson,MISC-MISC-MISC-MISC-MISC-MISC,PER-PER,VERB-DET-NOUN-ADP-DET-NOUN,PROPN-PROPN,csubj-det-dobj-prep-poss-pobj,compound-pobj,VB-DT-NN-IN-PRP$-NN,NNP-NNP,7,1
1,0.0,30,is,8,2,17,15,1,12,6,9,Add Some Music to Your Day,Joe Knott,MISC-MISC-MISC-MISC-MISC-MISC,PER-PER,VERB-DET-NOUN-ADP-DET-NOUN,PROPN-PROPN,csubj-det-dobj-prep-poss-pobj,compound-conj,VB-DT-NN-IN-PRP$-NN,NNP-NNP,8,1
2,0.0,30,is,8,2,24,22,1,5,6,16,Add Some Music to Your Day,American,MISC-MISC-MISC-MISC-MISC-MISC,LOC,VERB-DET-NOUN-ADP-DET-NOUN,ADJ,csubj-det-dobj-prep-poss-pobj,amod,VB-DT-NN-IN-PRP$-NN,JJ,12,1
3,0.0,30,is,8,2,27,25,1,2,6,19,Add Some Music to Your Day,The Beach Boys,MISC-MISC-MISC-MISC-MISC-MISC,ORG-ORG-ORG,VERB-DET-NOUN-ADP-DET-NOUN,DET-PROPN-PROPN,csubj-det-dobj-prep-poss-pobj,det-compound-ROOT,VB-DT-NN-IN-PRP$-NN,DT-NNP-NNPS,7,1
4,4.0,12,released,3,11,9,-2,10,2,-8,6,Sunflower,1970,MISC,TIME,PROPN,NUM,appos,nummod,NNP,CD,4,1
0,0.0,24,died,3,1,15,14,0,8,2,12,Zhuge Shang,Shu Han,PER-PER,LOC-LOC,PROPN-PROPN,PROPN-PROPN,compound-nsubj,compound-pobj,NNP-NNP,NNP-NNP,6,1
1,0.0,24,died,3,1,23,22,0,0,2,20,Zhuge Shang,China,PER-PER,LOC,PROPN-PROPN,PROPN,compound-nsubj,pobj,NNP-NNP,NNP,2,1
2,1.0,24,was,1,10,10,0,9,13,-9,9,Zhuge Zhan,Zhuge Liang,PER-PER,PER-PER,PROPN-PROPN,PROPN-PROPN,compound-pobj,compound-pobj,NNP-NNP,NNP-NNP,0,1
3,2.0,58,led,16,35,37,2,34,20,-19,21,Mianyang,Sichuan,LOC,LOC,PROPN,PROPN,pobj,pobj,NNP,NNP,2,1
4,2.0,58,led,16,54,56,2,53,1,-38,40,Longnan,Gansu,LOC,LOC,PROPN,PROPN,conj,npadvmod,NNP,NNP,3,1
0,0.0,28,was,13,1,4,3,0,23,12,-9,Noah Noble,"January 15 , 1794",PER-PER,TIME-TIME-TIME-TIME,PROPN-PROPN,PROPN-NUM-PUNCT-NUM,compound-nsubj,nmod-nummod-punct-nummod,NNP-NNP,"NNP-CD-,-CD",2,1
1,0.0,28,was,13,1,9,8,0,18,12,-4,Noah Noble,"February 8 , 1844",PER-PER,TIME-TIME-TIME-TIME,PROPN-PROPN,PROPN-NUM-PUNCT-NUM,compound-nsubj,appos-nummod-punct-nummod,NNP-NNP,"NNP-CD-,-CD",3,1
2,0.0,28,was,13,1,20,19,0,7,12,7,Noah Noble,U.S.,PER-PER,LOC,PROPN-PROPN,PROPN,compound-nsubj,compound,NNP-NNP,NNP,4,1
3,0.0,28,was,13,20,23,3,19,4,-7,10,U.S.,Indiana,LOC,LOC,PROPN,PROPN,compound,pobj,NNP,NNP,4,1
0,0.0,42,was,18,2,5,3,1,36,16,-13,Karl Mayr,5 January 1883,PER-PER,TIME-TIME-TIME,PROPN-PROPN,NUM-PROPN-NUM,compound-nsubj,nummod-appos-nummod,NNP-NNP,CD-NNP-CD,1,1
1,0.0,42,was,18,2,9,7,1,32,16,-9,Karl Mayr,Mindelheim,PER-PER,LOC,PROPN-PROPN,PROPN,compound-nsubj,compound,NNP-NNP,NNP,2,1
2,0.0,42,was,18,2,11,9,1,30,16,-7,Karl Mayr,9 February 1945,PER-PER,TIME-TIME-TIME,PROPN-PROPN,NUM-PROPN-NUM,compound-nsubj,nummod-appos-nummod,NNP-NNP,CD-NNP-CD,2,1
3,0.0,42,was,18,2,15,13,1,26,16,-3,Karl Mayr,Buchenwald concentration camp,PER-PER,LOC-LOC-LOC,PROPN-PROPN,PROPN-NOUN-NOUN,compound-nsubj,compound-compound-pobj,NNP-NNP,NNP-NN-NN,3,1
4,6.0,23,tracked,2,1,18,17,0,4,1,16,Mayr,Buchenwald Concentration Camp,PER,LOC-LOC-LOC,PROPN,PROPN-PROPN-PROPN,nsubjpass,compound-compound-pobj,NNP,NNP-NNP-NNP,8,1
0,0.0,23,"""",0,2,12,10,1,10,-2,12,Hometown Glory,Adele,MISC-MISC,PER,PROPN-NOUN,PROPN,compound-nsubj,pobj,NNP-NN,NNP,3,1
1,4.0,13,"""",0,2,10,8,1,2,-2,10,Hometown Glory,Adele,MISC-MISC,PER,PROPN-NOUN,PROPN,compound-nsubj,nsubj,NNP-NN,NNP,4,1
2,0.0,23,"""",0,12,21,9,11,1,-12,21,Adele,United Kingdom,PER,LOC-LOC,PROPN,PROPN-PROPN,pobj,compound-pobj,NNP,NNP-NNP,4,1
3,1.0,13,appears,2,9,11,2,8,1,-7,9,19,2008,MISC,TIME,NUM,NUM,nummod,appos,CD,CD,4,1
4,3.0,27,wrote,1,1,21,20,0,5,0,20,Adele,West Norwood,PER,LOC-LOC,PROPN,PROPN-PROPN,nsubj,compound-pobj,NNP,NNP-NNP,6,1
5,5.0,34,released,8,12,15,3,11,18,-4,7,Jamie T,Pacemaker Recordings,PER-PER,ORG-ORG,PROPN-PROPN,PROPN-PROPN,compound-poss,compound-compound,NNP-NNP,NNP-NNP,1,1
0,0.0,44,is,4,1,1,0,0,42,3,-3,Cecilia & The Argonauts,Cecilia Ferrer,ORG-ORG-ORG-ORG,PER-PER,PROPN-CCONJ-DET-PROPN,PROPN-PROPN,nsubj-cc-det-conj,compound-pobj,NNP-CC-DT-NNPS,NNP-NNP,0,1
1,1.0,32,born,3,1,6,5,0,25,2,3,Cecilia Ferrer,Stockholm,PER-PER,LOC,PROPN-PROPN,PROPN,compound-nsubjpass,pobj,NNP-NNP,NNP,4,1
2,1.0,32,born,3,1,10,9,0,21,2,7,Cecilia Ferrer,1982,PER-PER,TIME,PROPN-PROPN,NUM,compound-nsubjpass,pobj,NNP-NNP,CD,2,1
3,1.0,32,born,3,6,8,2,5,23,-3,5,Stockholm,Sweden,LOC,LOC,PROPN,PROPN,pobj,appos,NNP,NNP,4,1
4,4.0,24,put,13,5,23,18,4,0,8,10,Royal Swedish Academy of Music,University,ORG-ORG-ORG-ORG-ORG,ORG,PROPN-PROPN-PROPN-ADP-PROPN,PROPN,compound-compound-pobj-prep-pobj,pobj,NNP-NNP-NNP-IN-NNP,NNP,5,1
5,5.0,20,is,2,4,9,5,3,10,-2,7,Cecilia & The Argonauts,Pop,ORG-ORG-ORG-ORG,MISC,PROPN-CCONJ-DET-PROPN,PROPN,attr-cc-det-conj,compound,NNP-CC-DT-NNPS,NNP,3,1
0,0.0,17,is,1,1,15,14,0,1,0,14,Upgrade,Leigh Whannell,MISC,PER-PER,PROPN,PROPN-PROPN,nsubj,compound-pobj,NNP,NNP-NNP,5,1
1,3.0,14,produced,3,6,11,5,5,2,-3,8,Jason Blum,Blumhouse Productions,PER-PER,ORG-ORG,PROPN-PROPN,PROPN-PROPN,compound-pobj,compound-compound,NNP-NNP,NNP-NNP,5,1
0,0.0,57,was,12,24,26,2,23,30,-12,14,Pottsville,Schuylkill County,LOC,LOC-LOC,PROPN,PROPN-PROPN,pobj,compound-conj,NNP,NNP-NNP,2,1
1,0.0,57,was,12,24,31,7,23,25,-12,19,Pottsville,U.S.,LOC,LOC,PROPN,PROPN,pobj,appos,NNP,NNP,6,1
2,0.0,57,was,12,26,29,3,25,27,-14,17,Schuylkill County,Pennsylvania,LOC-LOC,LOC,PROPN-PROPN,PROPN,compound-conj,conj,NNP-NNP,NNP,2,1
3,0.0,57,was,12,26,31,5,25,25,-14,19,Schuylkill County,U.S.,LOC-LOC,LOC,PROPN-PROPN,PROPN,compound-conj,appos,NNP-NNP,NNP,6,1
4,0.0,57,was,12,29,31,2,28,25,-17,19,Pennsylvania,U.S.,LOC,LOC,PROPN,PROPN,conj,appos,NNP,NNP,8,1
5,2.0,66,are,2,24,42,18,23,23,-22,40,Lehigh Canal,American,LOC-LOC,LOC,PROPN-PROPN,ADJ,compound-pobj,amod,NNP-NNP,JJ,5,1
6,2.0,66,are,2,24,63,39,23,2,-22,61,Lehigh Canal,U.S.,LOC-LOC,LOC,PROPN-PROPN,PROPN,compound-pobj,compound,NNP-NNP,NNP,5,1
0,0.0,32,was,15,1,6,5,0,25,14,-9,Leopold Ritter von Dittel,"May 29 , 1815",PER-PER-PER-PER,TIME-TIME-TIME-TIME,PROPN-PROPN-PROPN-PROPN,PROPN-NUM-PUNCT-NUM,compound-compound-compound-nsubj,appos-nummod-punct-nummod,NNP-NNP-NNP-NNP,"NNP-CD-,-CD",3,1
1,0.0,32,was,15,1,11,10,0,20,14,-4,Leopold Ritter von Dittel,"July 28 , 1898",PER-PER-PER-PER,TIME-TIME-TIME-TIME,PROPN-PROPN-PROPN-PROPN,PROPN-NUM-PUNCT-NUM,compound-compound-compound-nsubj,appos-nummod-punct-nummod,NNP-NNP-NNP-NNP,"NNP-CD-,-CD",4,1
2,0.0,32,was,15,1,22,21,0,9,14,7,Leopold Ritter von Dittel,Fulnek,PER-PER-PER-PER,LOC,PROPN-PROPN-PROPN-PROPN,PROPN,compound-compound-compound-nsubj,pobj,NNP-NNP-NNP-NNP,NNP,4,1
3,0.0,32,was,15,22,30,8,21,1,-7,15,Fulnek,Czech Republic,LOC,LOC-LOC,PROPN,PROPN-PROPN,pobj,compound-pobj,NNP,NNP-NNP,5,1
4,2.0,29,was,6,11,15,4,10,13,-5,9,Johann von Dumreicher,1815,PER-PER-PER,TIME,PROPN-PROPN-PROPN,NUM,compound-compound-pobj,appos,NNP-NNP-NNP,CD,4,1
5,5.0,29,remembered,2,22,25,3,21,3,-20,23,Maximilian Nitze,1848,PER-PER,TIME,PROPN-PROPN,NUM,compound-pobj,nummod,NNP-NNP,CD,1,1
6,5.0,29,remembered,2,22,27,5,21,1,-20,25,Maximilian Nitze,1906,PER-PER,TIME,PROPN-PROPN,NUM,compound-pobj,nummod,NNP-NNP,CD,1,1
7,7.0,43,named,27,2,5,3,1,37,25,-22,Felix Legueu,1863,PER-PER,TIME,PROPN-PROPN,NUM,compound-pobj,nummod,NNP-NNP,CD,2,1
8,7.0,43,named,27,2,7,5,1,35,25,-20,Felix Legueu,1939,PER-PER,TIME,PROPN-PROPN,NUM,compound-pobj,nummod,NNP-NNP,CD,1,1
9,7.0,43,named,27,10,13,3,9,29,17,-14,Émile Forgue,1860,PER-PER,TIME,PROPN-PROPN,NUM,compound-conj,nummod,NNP-NNP,CD,1,1
10,7.0,43,named,27,10,15,5,9,27,17,-12,Émile Forgue,1943,PER-PER,TIME,PROPN-PROPN,NUM,compound-conj,nummod,NNP-NNP,CD,1,1
0,0.0,18,were,3,2,15,13,1,2,1,12,Calgary,Alberta,LOC,LOC,PROPN,PROPN,pobj,npadvmod,NNP,NNP,7,1
1,0.0,18,were,3,2,17,15,1,0,1,14,Calgary,Canada,LOC,LOC,PROPN,PROPN,pobj,appos,NNP,NNP,2,1
2,0.0,18,were,3,15,17,2,14,0,-12,14,Alberta,Canada,LOC,LOC,PROPN,PROPN,npadvmod,appos,NNP,NNP,7,1
0,0.0,17,are,2,1,9,8,0,7,1,7,Sweet Savage,Belfast,ORG-ORG,LOC,PROPN-PROPN,PROPN,compound-nsubj,pobj,NNP-NNP,NNP,5,1
1,1.0,13,included,3,8,11,3,7,1,-5,8,Def Leppard,Vivian Campbell,ORG-ORG,PER-PER,PROPN-PROPN,PROPN-PROPN,compound-conj,compound-dobj,NNP-NNP,NNP-NNP,3,1
0,0.0,17,is,4,1,16,15,0,0,3,12,The New Dark Age,Kiuas,MISC-MISC-MISC-MISC,ORG,DET-PROPN-PROPN-PROPN,PROPN,det-compound-compound-nsubj,pobj,DT-NNP-NNP-NNP,NNP,3,1
0,0.0,35,is,13,25,34,9,24,0,-12,21,Netivot,Israel,LOC,LOC,PROPN,PROPN,pobj,pobj,NNP,NNP,7,1
1,2.0,18,born,2,5,17,12,4,0,-3,15,Arfoud,Morocco,LOC,LOC,PROPN,PROPN,pobj,pobj,NNP,NNP,2,1
0,0.0,22,Pascal,1,1,6,5,0,15,0,5,Claude Pascal,"February 19 , 1921",PER-PER,TIME-TIME-TIME-TIME,PROPN-PROPN,PROPN-NUM-PUNCT-NUM,compound-ROOT,npadvmod-nummod-punct-nummod,NNP-NNP,"NNP-CD-,-CD",3,1
1,0.0,22,Pascal,1,1,6,5,0,15,0,5,Claude Pascal,"February 28 , 2017",PER-PER,TIME-TIME-TIME-TIME,PROPN-PROPN,PROPN-NUM-PUNCT-NUM,compound-ROOT,npadvmod-nummod-punct-nummod,NNP-NNP,"NNP-CD-,-CD",3,1
0,0.0,14,is,9,1,4,3,0,9,8,-5,Maurizio Gasparri,Rome,PER-PER,LOC,PROPN-PROPN,PROPN,compound-nsubj,appos,NNP-NNP,NNP,2,1
1,0.0,14,is,9,1,6,5,0,7,8,-3,Maurizio Gasparri,18 July 1956,PER-PER,TIME-TIME-TIME,PROPN-PROPN,NUM-PROPN-NUM,compound-nsubj,nummod-appos-nummod,NNP-NNP,CD-NNP-CD,2,1
0,0.0,13,is,1,10,12,2,9,0,-9,11,Puebla,Mexico,LOC,LOC,PROPN,PROPN,pobj,appos,NNP,NNP,7,1
1,7.0,25,took,3,18,24,6,17,0,-15,21,Puebla,Mexico,LOC,LOC,PROPN,PROPN,pobj,pobj,NNP,NNP,4,1
2,4.0,19,founded,2,15,18,3,14,0,-13,16,Italian,Veneto,LOC,LOC,ADJ,PROPN,amod,pobj,JJ,NNP,5,1
3,10.0,17,declared,11,7,9,2,6,7,4,-2,Segusino,Italy,LOC,LOC,PROPN,PROPN,pobj,appos,NNP,NNP,6,1
0,0.0,40,is,8,6,23,17,5,16,2,15,Aapravasi Ghat,Mauritius,LOC-LOC,LOC,PROPN-PROPN,PROPN,compound-appos,pobj,NNP-NNP,NNP,4,1
1,0.0,40,is,8,15,19,4,14,20,-7,11,Port Louis,Indian Ocean,LOC-LOC,LOC-LOC,PROPN-PROPN,PROPN-PROPN,compound-pobj,compound-compound,NNP-NNP,NNP-NNP,5,1
2,0.0,40,is,8,15,23,8,14,16,-7,15,Port Louis,Mauritius,LOC-LOC,LOC,PROPN-PROPN,PROPN,compound-pobj,pobj,NNP-NNP,NNP,4,1
3,0.0,40,is,8,19,23,4,18,16,-11,15,Indian Ocean,Mauritius,LOC-LOC,LOC,PROPN-PROPN,PROPN,compound-compound,pobj,NNP-NNP,NNP,5,1
0,4.0,16,is,1,1,1,0,0,14,0,0,Lee,Lee Kuan Yew,PER,PER-PER-PER,PROPN,PROPN-PROPN-PROPN,nsubj,compound-compound-appos,NNP,NNP-NNP-NNP,0,1
1,4.0,16,is,1,1,7,6,0,8,0,6,Lee Kuan Yew,Singapore,PER-PER-PER,LOC,PROPN-PROPN-PROPN,PROPN,compound-compound-appos,poss,NNP-NNP-NNP,NNP,5,1
2,5.0,42,graduated,1,1,4,3,0,37,0,3,Lee,Trinity College,PER,ORG-ORG,PROPN,PROPN-PROPN,nsubj,compound-pobj,NNP,NNP-NNP,2,1
3,5.0,42,graduated,1,1,7,6,0,34,0,6,Lee,Cambridge University,PER,ORG-ORG,PROPN,PROPN-PROPN,nsubj,compound-appos,NNP,NNP-NNP,3,1
4,5.0,42,graduated,1,1,36,35,0,5,0,35,Lee,Harvard,PER,ORG,PROPN,PROPN,nsubj,poss,NNP,NNP,5,1
5,5.0,42,graduated,1,1,38,37,0,3,0,37,Lee,Kennedy School of Government,PER,ORG-ORG-ORG-ORG,PROPN,PROPN-PROPN-ADP-PROPN,nsubj,compound-pobj-prep-pobj,NNP,NNP-NNP-IN-NNP,3,1
0,2.0,32,shot,7,16,13,-3,15,18,-9,6,Aaliyah,Detroit,PER,LOC,PROPN,PROPN,nsubj,pobj,NNP,NNP,4,1
0,0.0,19,is,3,1,18,17,0,0,2,15,myki,Australia,MISC,LOC,NOUN,PROPN,nsubj,appos,NN,NNP,2,1
1,0.0,19,is,3,16,18,2,15,0,-13,15,Victoria,Australia,LOC,LOC,PROPN,PROPN,pobj,appos,NNP,NNP,10,1
0,0.0,20,is,1,1,14,13,0,5,0,13,Darksiders,Vigil Games,MISC,ORG-ORG,NOUN,PROPN-PROPN,nsubj,compound-pobj,NNS,NNP-NNPS,4,1
1,0.0,20,is,1,1,19,18,0,0,0,18,Darksiders,THQ,MISC,ORG,NOUN,PROPN,nsubj,pobj,NNS,NNP,1,1
2,1.0,24,takes,2,8,23,15,7,0,-6,21,Four Horsemen of the Apocalypse,War,MISC-MISC-MISC-MISC-MISC,PER,PROPN-PROPN-ADP-DET-PROPN,PROPN,nummod-pobj-prep-det-pobj,pobj,NNP-NNPS-IN-DT-NNP,NNP,4,1
0,1.0,38,coined,15,14,32,18,13,5,1,17,Mark Latham,Labor,PER-PER,ORG,PROPN-PROPN,PROPN,compound-nsubj,compound,NNP-NNP,NNP,5,1
1,3.0,33,recognised,2,1,31,30,0,1,1,29,Mark Latham,Labor,PER-PER,ORG,PROPN-PROPN,PROPN,compound-nsubj,compound,NNP-NNP,NNP,8,1
0,0.0,23,is,4,12,20,8,11,2,-8,16,Fatih,Istanbul,LOC,LOC,PROPN,PROPN,pobj,pobj,NNP,NNP,7,1
1,0.0,23,is,4,12,22,10,11,0,-8,18,Fatih,Turkey,LOC,LOC,PROPN,PROPN,pobj,appos,NNP,NNP,2,1
2,0.0,23,is,4,20,22,2,19,0,-16,18,Istanbul,Turkey,LOC,LOC,PROPN,PROPN,pobj,appos,NNP,NNP,7,1
0,0.0,12,is,2,1,1,0,0,10,1,-1,Google Keep,Google,MISC-MISC,ORG,PROPN-PROPN,PROPN,compound-nsubj,pobj,NNP-NNP,NNP,0,1
1,11.0,33,received,4,3,3,0,2,29,1,-1,Google Keep,Google,MISC-MISC,ORG,PROPN-PROPN,PROPN,compound-nsubj,compound,NNP-NNP,NNP,0,1
0,0.0,26,was,12,1,5,4,0,20,11,-7,Léon Louis Rostan,17 March 1790,PER-PER-PER,TIME-TIME-TIME,PROPN-PROPN-PROPN,NUM-PROPN-NUM,compound-compound-nsubj,nummod-nmod-nummod,NNP-NNP-NNP,CD-NNP-CD,2,1
1,0.0,26,was,12,1,9,8,0,16,11,-3,Léon Louis Rostan,4 October 1866,PER-PER-PER,TIME-TIME-TIME,PROPN-PROPN-PROPN,NUM-PROPN-NUM,compound-compound-nsubj,nummod-appos-nummod,NNP-NNP-NNP,CD-NNP-CD,2,1
2,0.0,26,was,12,1,22,21,0,3,11,10,Léon Louis Rostan,Académie Nationale de Médecine,PER-PER-PER,ORG-ORG-ORG-ORG,PROPN-PROPN-PROPN,PROPN-PROPN-PROPN-PROPN,compound-compound-nsubj,compound-compound-compound-pobj,NNP-NNP-NNP,NNP-NNP-NNP-NNP,7,1
3,2.0,29,was,1,6,9,3,5,19,-5,8,Philippe Pinel,1745,PER-PER,TIME,PROPN-PROPN,NUM,compound-pobj,nummod,NNP-NNP,CD,2,1
0,0.0,49,was,15,9,42,33,8,6,6,27,the United States,Congress,LOC-LOC-LOC,ORG,DET-PROPN-PROPN,PROPN,det-compound-pobj,nsubj,DT-NNP-NNP,NNP,8,1
0,2.0,19,headquartered,3,11,18,7,10,0,-8,15,South Lake Union,WA,LOC-LOC-LOC,LOC,PROPN-PROPN-PROPN,PROPN,compound-compound-compound,appos,NNP-NNP-NNP,NNP,7,1
0,0.0,30,is,14,23,29,6,22,0,-9,15,Helmand,Afghanistan,LOC,LOC,PROPN,PROPN,nmod,pobj,NNP,NNP,7,1
1,0.0,30,is,14,25,29,4,24,0,-11,15,Kandahar,Afghanistan,LOC,LOC,PROPN,PROPN,conj,pobj,NNP,NNP,5,1
0,0.0,45,is,16,37,42,5,36,2,-21,26,Bocaue,Bulacan,LOC,LOC,PROPN,PROPN,pobj,pobj,NNP,NNP,2,1
1,0.0,45,is,16,37,44,7,36,0,-21,28,Bocaue,Philippines,LOC,LOC,PROPN,PROPN,pobj,appos,NNP,NNP,4,1
2,0.0,45,is,16,39,42,3,38,2,-23,26,Santa Maria,Bulacan,LOC-LOC,LOC,PROPN-PROPN,PROPN,compound-conj,pobj,NNP-NNP,NNP,4,1
3,0.0,45,is,16,39,44,5,38,0,-23,28,Santa Maria,Philippines,LOC-LOC,LOC,PROPN-PROPN,PROPN,compound-conj,appos,NNP-NNP,NNP,6,1
4,0.0,45,is,16,42,44,2,41,0,-26,28,Bulacan,Philippines,LOC,LOC,PROPN,PROPN,pobj,appos,NNP,NNP,2,1
0,0.0,27,was,11,1,4,3,0,22,10,-7,Nitin Bose,26 April 1897,PER-PER,TIME-TIME-TIME,PROPN-PROPN,NUM-PROPN-NUM,compound-nsubj,nummod-nmod-nummod,NNP-NNP,CD-NNP-CD,1,1
1,0.0,27,was,11,1,8,7,0,18,10,-3,Nitin Bose,14 April 1986,PER-PER,TIME-TIME-TIME,PROPN-PROPN,NUM-PROPN-NUM,compound-nsubj,nummod-appos-nummod,NNP-NNP,CD-NNP-CD,1,1
2,4.0,40,occurred,9,21,25,4,20,14,-12,16,Bhagya Chakra,Bengali,MISC-MISC,MISC,PROPN-PROPN,PROPN,compound-pobj,compound,NNP-NNP,NNP,1,1
3,4.0,40,occurred,9,38,35,-3,37,4,-29,26,Dhoop Chhaon,Hindi,MISC-MISC,MISC,PROPN-PROPN,PROPN,compound-appos,compound,NNP-NNP,NNP,1,1
0,0.0,28,was,11,2,7,5,1,20,9,-4,William Pitt Leleiohoku II,1854,PER-PER-PER-PER,TIME,PROPN-PROPN-PROPN-PROPN,NUM,compound-compound-compound-nsubj,nummod,NNP-NNP-NNP-NNP,CD,2,1
1,0.0,28,was,11,2,9,7,1,18,9,-2,William Pitt Leleiohoku II,1877,PER-PER-PER-PER,TIME,PROPN-PROPN-PROPN-PROPN,NUM,compound-compound-compound-nsubj,nummod,NNP-NNP-NNP-NNP,CD,2,1
2,1.0,48,was,1,41,44,3,40,3,-40,43,David Kalākaua,1836,PER-PER,TIME,PROPN-PROPN,NUM,compound-appos,nummod,NNP-NNP,CD,2,1
3,1.0,48,was,1,41,46,5,40,1,-40,45,David Kalākaua,1891,PER-PER,TIME,PROPN-PROPN,NUM,compound-appos,nummod,NNP-NNP,CD,3,1
4,1.0,48,was,1,41,22,-19,40,25,-40,21,David Kalākaua,Liliuokalani,PER-PER,PER,PROPN-PROPN,PROPN,compound-appos,appos,NNP-NNP,NNP,8,1
5,1.0,48,was,1,22,24,2,21,23,-21,23,Liliuokalani,1838,PER,TIME,PROPN,NUM,appos,nummod,NNP,CD,3,1
6,1.0,48,was,1,22,26,4,21,21,-21,25,Liliuokalani,1917,PER,TIME,PROPN,NUM,appos,nummod,NNP,CD,2,1
7,1.0,48,was,1,22,30,8,21,17,-21,29,Liliuokalani,Miriam Likelike,PER,PER-PER,PROPN,PROPN-PROPN,appos,compound-conj,NNP,NNP-NNP,6,1
0,0.0,30,was,12,1,5,4,0,24,11,-7,Antonio Maria Bononcini,18 June 1677,PER-PER-PER,TIME-TIME-TIME,PROPN-PROPN-PROPN,NUM-PROPN-NUM,compound-compound-nsubj,nummod-nmod-nummod,NNP-NNP-NNP,CD-NNP-CD,3,1
1,0.0,30,was,12,1,9,8,0,20,11,-3,Antonio Maria Bononcini,8 July 1726,PER-PER-PER,TIME-TIME-TIME,PROPN-PROPN-PROPN,NUM-PROPN-NUM,compound-compound-nsubj,nummod-npadvmod-nummod,NNP-NNP-NNP,CD-NNP-CD,2,1
2,0.0,30,was,12,1,15,14,0,14,11,3,Antonio Maria Bononcini,Italian,PER-PER-PER,LOC,PROPN-PROPN-PROPN,ADJ,compound-compound-nsubj,amod,NNP-NNP-NNP,JJ,3,1
3,0.0,30,was,12,1,28,27,0,1,11,16,Antonio Maria Bononcini,Giovanni Bononcini,PER-PER-PER,PER-PER,PROPN-PROPN-PROPN,PROPN-PROPN,compound-compound-nsubj,compound-pobj,NNP-NNP-NNP,NNP-NNP,6,1
4,6.0,17,returned,3,12,6,-6,11,10,-9,3,Milan,Italy,LOC,LOC,PROPN,PROPN,pobj,pobj,NNP,NNP,5,1
5,6.0,17,returned,3,14,6,-8,13,10,-11,3,Naples,Italy,LOC,LOC,PROPN,PROPN,conj,pobj,NNP,NNP,6,1
0,1.0,26,founded,3,7,13,6,6,12,-4,10,Communist League,1934,ORG-ORG,TIME,PROPN-PROPN,NUM,compound-pobj,pobj,NNP-NNP,CD,3,1
1,4.0,36,represented,3,9,14,5,8,21,-6,11,Second United Front Cabinet,1969,ORG-ORG-ORG-ORG,TIME,PROPN-PROPN-PROPN-PROPN,NUM,compound-compound-compound-pobj,appos,NNP-NNP-NNP-NNP,CD,3,1
0,0.0,21,was,13,1,4,3,0,16,12,-9,John Small,"August 27 , 1746",PER-PER,TIME-TIME-TIME-TIME,PROPN-PROPN,PROPN-NUM-PUNCT-NUM,compound-nsubj,appos-nummod-punct-nummod,NNP-NNP,"NNP-CD-,-CD",2,1
1,0.0,21,was,13,1,9,8,0,11,12,-4,John Small,"July 18 , 1831",PER-PER,TIME-TIME-TIME-TIME,PROPN-PROPN,PROPN-NUM-PUNCT-NUM,compound-nsubj,appos-nummod-punct-nummod,NNP-NNP,"NNP-CD-,-CD",3,1
2,4.0,23,came,1,21,4,-17,20,18,-20,3,Toronto,Canada,LOC,LOC,PROPN,PROPN,appos,pobj,NNP,NNP,3,1
0,1.0,18,owned,10,6,16,10,5,1,4,6,Western & Atlantic Railroad,U.S.,LOC-LOC-LOC-LOC,LOC,PROPN-CCONJ-PROPN-PROPN,PROPN,nmod-cc-conj-nsubjpass,compound,NNP-CC-NNP-NNP,NNP,6,1
0,0.0,24,was,10,15,17,2,14,6,-5,7,Ottawa,Ontario,LOC,LOC,PROPN,PROPN,pobj,conj,NNP,NNP,3,1
1,0.0,24,was,10,15,19,4,14,4,-5,9,Ottawa,Canada,LOC,LOC,PROPN,PROPN,pobj,conj,NNP,NNP,2,1
2,0.0,24,was,10,17,19,2,16,4,-7,9,Ontario,Canada,LOC,LOC,PROPN,PROPN,conj,conj,NNP,NNP,3,1
3,6.0,34,drowned,4,8,13,5,7,20,-4,9,Gatineau River,Quebec,LOC-LOC,LOC,PROPN-PROPN,PROPN,compound-pobj,appos,NNP-NNP,NNP,4,1
0,0.0,14,is,7,1,5,4,0,8,6,-2,Cinqué Lee,July 1966,PER-PER,TIME-TIME,PROPN-PROPN,PROPN-NUM,compound-nsubj,npadvmod-nummod,NNP-NNP,NNP-CD,3,1
1,3.0,17,had,2,7,10,3,6,6,-5,8,School Daze,1988,MISC-MISC,TIME,PROPN-PROPN,NUM,compound-pobj,appos,NNP-NNP,CD,1,1
2,3.0,17,had,2,13,15,2,12,1,-11,13,Oldboy,2013,MISC,TIME,PROPN,NUM,conj,appos,NNP,CD,2,1
3,4.0,34,appeared,5,14,17,3,13,16,-9,12,Mystery Train,1989,MISC-MISC,TIME,PROPN-PROPN,NUM,compound-appos,appos,NNP-NNP,CD,1,1
4,4.0,34,appeared,5,20,24,4,19,9,-15,19,Coffee and Cigarettes,2003,MISC-MISC-MISC,TIME,PROPN-CCONJ-PROPN,NUM,conj-cc-conj,appos,NNP-CC-NNP,CD,2,1
5,5.0,60,is,1,15,18,3,14,41,-14,17,Nowhere Fast,1997,MISC-MISC,TIME,PROPN-PROPN,NUM,compound-appos,appos,NNP-NNP,CD,1,1
6,5.0,60,is,1,21,26,5,20,33,-20,25,Sink Like a Stone,2000,MISC-MISC-MISC-MISC,TIME,VERB-ADP-DET-NOUN,NUM,conj-prep-det-pobj,appos,VB-IN-DT-NN,CD,2,1
7,5.0,60,is,1,32,35,3,31,24,-31,34,UR4 Given,2004,MISC-MISC,TIME,PROPN-PROPN,NUM,compound-npadvmod,appos,NNP-NNP,CD,1,1
8,5.0,60,is,1,46,57,11,45,2,-45,56,Burn Out the Day,Sean Bohary,MISC-MISC-MISC-MISC,PER-PER,VERB-PART-DET-NOUN,PROPN-PROPN,parataxis-prt-det-dobj,compound-pobj,VB-RP-DT-NN,NNP-NNP,5,1
0,0.0,29,was,17,1,4,3,0,24,16,-13,Hans Zerny,11 June 1887,PER-PER,TIME-TIME-TIME,PROPN-PROPN,NUM-PROPN-NUM,compound-nsubj,nummod-appos-nummod,NNP-NNP,CD-NNP-CD,2,1
1,0.0,29,was,17,1,10,9,0,18,16,-7,Hans Zerny,Währing,PER-PER,LOC,PROPN-PROPN,PROPN,compound-nsubj,nmod,NNP-NNP,NNP,2,1
2,0.0,29,was,17,1,12,11,0,16,16,-5,Hans Zerny,14 September 1945,PER-PER,TIME-TIME-TIME,PROPN-PROPN,NUM-PROPN-NUM,compound-nsubj,nummod-appos-nummod,NNP-NNP,CD-NNP-CD,2,1
0,3.0,29,aged,8,16,22,6,15,6,-8,14,Chorlton - on - Medlock,Manchester,LOC-LOC-LOC-LOC-LOC,LOC,PROPN-PUNCT-ADP-PUNCT-PROPN,PROPN,pobj-punct-prep-punct-pobj,compound,NNP-HYPH-IN-HYPH-NNP,NNP,4,1
1,4.0,54,"""",0,24,22,-2,23,31,-24,22,Andy Rourke,Smiths,PER-PER,ORG,PROPN-PROPN,PROPN,compound-pobj,compound,NNP-NNP,NNP,2,1
2,4.0,54,"""",0,24,2,-22,23,51,-24,2,Andy Rourke,The Smiths,PER-PER,ORG-ORG,PROPN-PROPN,DET-PROPN,compound-pobj,det-compound,NNP-NNP,DT-NNP,10,1
3,4.0,54,"""",0,27,22,-5,26,31,-27,22,Mike Joyce,Smiths,PER-PER,ORG,PROPN-PROPN,PROPN,compound-conj,compound,NNP-NNP,NNP,3,1
4,4.0,54,"""",0,27,2,-25,26,51,-27,2,Mike Joyce,The Smiths,PER-PER,ORG-ORG,PROPN-PROPN,DET-PROPN,compound-conj,det-compound,NNP-NNP,DT-NNP,11,1
5,4.0,54,"""",0,22,16,-6,21,37,-22,16,Smiths,Morrissey,ORG,PER,PROPN,PROPN,compound,poss,NNP,NNP,5,1
6,4.0,54,"""",0,16,2,-14,15,51,-16,2,Morrissey,The Smiths,PER,ORG-ORG,PROPN,DET-PROPN,poss,det-compound,NNP,DT-NNP,9,1
0,0.0,19,is,4,15,18,3,14,0,-11,14,North Sumatra,Indonesia,LOC-LOC,LOC,PROPN-PROPN,PROPN,compound-conj,appos,NNP-NNP,NNP,6,1
0,2.0,22,came,7,21,11,-10,20,10,-14,4,MIT,U.S.,ORG,LOC,PROPN,PROPN,pobj,pobj,NNP,NNP,2,1
1,6.0,35,returned,4,34,7,-27,33,27,-30,3,Kunming,China,LOC,LOC,PROPN,PROPN,pobj,pobj,NNP,NNP,2,1
2,8.0,41,returned,5,5,23,18,4,17,0,18,Jen,Johns Hopkins University,PER,ORG-ORG-ORG,PROPN,PROPN-PROPN-PROPN,nsubj,compound-compound-pobj,NNP,NNP-NNP-NNP,4,1
0,2.0,42,features,5,27,33,6,26,8,-22,28,Two Men and a Wardrobe,1958,MISC-MISC-MISC-MISC-MISC,TIME,NUM-PROPN-CCONJ-DET-PROPN,NUM,nummod-pobj-cc-det-conj,appos,CD-NNPS-CC-DT-NNP,CD,2,1
1,2.0,42,features,5,36,40,4,35,1,-31,35,Rosemary 's Baby,1968,MISC-MISC-MISC,TIME,PROPN-PART-PROPN,NUM,poss-case-conj,appos,NNP-POS-NNP,CD,3,1
2,3.0,40,plays,8,2,8,6,1,31,6,0,The Fat and the Lean,Polanski,MISC-MISC-MISC-MISC-MISC,PER,DET-PROPN-CCONJ-DET-PROPN,PROPN,det-pobj-cc-det-conj,nsubj,DT-NNP-CC-DT-NNP,NNP,2,1
3,8.0,31,interpreted,7,1,13,12,0,17,6,6,The Fat and the Lean,Polanski,MISC-MISC-MISC-MISC-MISC,PER,DET-PROPN-CCONJ-DET-PROPN,PROPN,det-nsubjpass-cc-det-conj,poss,DT-NNP-CC-DT-NNP,NNP,7,1
0,0.0,17,is,2,1,13,12,0,3,1,11,Medical Center,Maryland,LOC-LOC,LOC,PROPN-PROPN,PROPN,compound-nsubj,appos,NNP-NNP,NNP,6,1
1,0.0,17,is,2,1,15,14,0,1,1,13,Medical Center,United States,LOC-LOC,LOC-LOC,PROPN-PROPN,PROPN-PROPN,compound-nsubj,compound-appos,NNP-NNP,NNP-NNP,6,1
2,0.0,17,is,2,7,15,8,6,1,-5,13,Washington Metro,United States,LOC-LOC,LOC-LOC,PROPN-PROPN,PROPN-PROPN,compound-compound,compound-appos,NNP-NNP,NNP-NNP,4,1
3,0.0,17,is,2,11,13,2,10,3,-9,11,Bethesda,Maryland,LOC,LOC,PROPN,PROPN,pobj,appos,NNP,NNP,2,1
4,0.0,17,is,2,11,15,4,10,1,-9,13,Bethesda,United States,LOC,LOC-LOC,PROPN,PROPN-PROPN,pobj,compound-appos,NNP,NNP-NNP,2,1
5,0.0,17,is,2,13,15,2,12,1,-11,13,Maryland,United States,LOC,LOC-LOC,PROPN,PROPN-PROPN,appos,compound-appos,NNP,NNP-NNP,2,1
0,0.0,22,was,9,1,6,5,0,15,8,-3,Jan Joost van Cossiau,c.1660,PER-PER-PER-PER,TIME,PROPN-PROPN-PROPN-PROPN,PROPN,compound-compound-compound-nsubj,compound,NNP-NNP-NNP-NNP,NNP,3,1
1,3.0,21,are,1,14,17,3,13,3,-13,16,Gaspard Dughet,1613,PER-PER,TIME,PROPN-PROPN,NUM,compound-pobj,nummod,NNP-NNP,CD,1,1
2,3.0,21,are,1,14,19,5,13,1,-13,18,Gaspard Dughet,1675,PER-PER,TIME,PROPN-PROPN,NUM,compound-pobj,nummod,NNP-NNP,CD,1,1
3,7.0,10,died,4,1,7,6,0,2,3,3,Jan Joost van Cossiau,Mainz,PER-PER-PER-PER,LOC,PROPN-PROPN-PROPN-PROPN,PROPN,compound-compound-compound-nsubj,pobj,NNP-NNP-NNP-NNP,NNP,3,1
0,0.0,17,is,4,1,7,6,0,9,3,3,Gaali Gopura,1962,MISC-MISC,TIME,PROPN-PROPN,NUM,compound-nsubj,nummod,NNP-NNP,CD,3,1
1,0.0,17,is,4,1,8,7,0,8,3,4,Gaali Gopura,Kannada,MISC-MISC,MISC,PROPN-PROPN,PROPN,compound-nsubj,compound,NNP-NNP,NNP,2,1
0,0.0,30,is,4,2,29,27,1,0,2,25,Gouina Hydroelectric Plant,Mali,LOC-LOC-LOC,LOC,PROPN-PROPN-PROPN,PROPN,compound-compound-nsubj,pobj,NNP-NNP-NNP,NNP,3,1
1,0.0,30,is,4,2,26,24,1,3,2,22,Gouina Falls,Senegal River,LOC-LOC,LOC-LOC,PROPN-PROPN,PROPN-PROPN,compound-pobj,compound-pobj,NNP-NNP,NNP-NNP,8,1
2,0.0,30,is,4,2,29,27,1,0,2,25,Gouina Falls,Mali,LOC-LOC,LOC,PROPN-PROPN,PROPN,compound-pobj,pobj,NNP-NNP,NNP,3,1
3,0.0,30,is,4,26,29,3,25,0,-22,25,Senegal River,Mali,LOC-LOC,LOC,PROPN-PROPN,PROPN,compound-pobj,pobj,NNP-NNP,NNP,7,1
4,1.0,12,located,2,7,10,3,6,1,-5,8,Diamou,Kayes Region,LOC,LOC-LOC,PROPN,PROPN-PROPN,pobj,compound-pobj,NNP,NNP-NNP,1,1
5,3.0,11,laid,6,1,3,2,0,7,5,-3,Mauritanian,Mohamed Ould Abdel Aziz,LOC,PER-PER-PER-PER,ADJ,PROPN-PROPN-PROPN-PROPN,amod,compound-compound-compound-nsubj,JJ,NNP-NNP-NNP-NNP,2,1
0,0.0,26,is,16,6,14,8,5,11,10,-2,TES,Bucharest,ORG,LOC,PROPN,PROPN,appos,pobj,NNP,NNP,4,1
1,0.0,26,is,16,6,16,10,5,9,10,0,TES,Romania,ORG,LOC,PROPN,PROPN,appos,nsubj,NNP,NNP,3,1
2,0.0,26,is,16,14,16,2,13,9,2,0,Bucharest,Romania,LOC,LOC,PROPN,PROPN,pobj,nsubj,NNP,NNP,1,1
0,0.0,25,was,10,1,13,12,0,11,9,3,Mulla Ali Kani,Iranian,PER-PER-PER,LOC,PROPN-PROPN-PROPN,PROPN,compound-compound-nsubj,nmod,NNP-NNP-NNP,NNP,5,1
1,0.0,25,was,10,1,14,13,0,10,9,4,Mulla Ali Kani,Shia,PER-PER-PER,ORG,PROPN-PROPN-PROPN,PROPN,compound-compound-nsubj,nmod,NNP-NNP-NNP,NNP,4,1
2,6.0,22,died,1,1,4,3,0,17,0,3,Kani,Tehran,PER,LOC,PROPN,PROPN,nsubj,pobj,NNP,NNP,3,1
3,6.0,22,died,1,1,6,5,0,15,0,5,Kani,1888,PER,TIME,PROPN,NUM,nsubj,appos,NNP,CD,1,1
0,0.0,33,is,3,1,27,26,0,5,2,24,Sergio Claudio Cirigliano,Argentina,PER-PER-PER,LOC,PROPN-PROPN-PROPN,PROPN,compound-compound-nsubj,pobj,NNP-NNP-NNP,NNP,8,1
1,0.0,33,is,3,6,22,16,5,10,-3,19,Argentinian,Buenos Aires,LOC,LOC-LOC,ADJ,PROPN-PROPN,amod,compound-pobj,JJ,NNP-NNP,4,1
2,0.0,33,is,3,22,27,5,21,5,-19,24,Buenos Aires,Argentina,LOC-LOC,LOC,PROPN-PROPN,PROPN,compound-pobj,pobj,NNP-NNP,NNP,3,1
0,1.0,29,are,4,13,17,4,12,11,-9,13,Hudson Square,Manhattan,LOC-LOC,LOC,PROPN-PROPN,PROPN,compound-compound,pobj,NNP-NNP,NNP,6,1
0,0.0,32,is,2,1,11,10,0,20,1,9,Empty Estate,Wild Nothing,MISC-MISC,ORG-ORG,PROPN-PROPN,PROPN-PROPN,amod-nsubj,compound-pobj,NNP-NNP,NNP-NNP,3,1
1,0.0,32,is,2,11,21,10,10,10,-9,19,Wild Nothing,Captured Tracks,ORG-ORG,ORG-ORG,PROPN-PROPN,PROPN-PROPN,compound-pobj,amod-pobj,NNP-NNP,NNP-NNP,3,1
2,0.0,32,is,2,11,25,14,10,6,-9,23,Wild Nothing,US,ORG-ORG,LOC,PROPN-PROPN,PROPN,compound-pobj,nmod,NNP-NNP,NNP,7,1
3,0.0,32,is,2,21,25,4,20,6,-19,23,Captured Tracks,US,ORG-ORG,LOC,PROPN-PROPN,PROPN,amod-pobj,nmod,NNP-NNP,NNP,4,1
4,1.0,30,released,14,26,28,2,25,1,-12,14,Nocturne,2012,MISC,TIME,PROPN,NUM,appos,appos,NNP,CD,3,1
0,0.0,12,is,1,1,11,10,0,0,0,10,Avellaneda,Argentina,LOC,LOC,PROPN,PROPN,nsubj,appos,NNP,NNP,1,1
1,0.0,12,is,1,7,11,4,6,0,-6,10,Río Negro Province,Argentina,LOC-LOC-LOC,LOC,PROPN-PROPN-PROPN,PROPN,compound-compound-pobj,appos,NNP-NNP-NNP,NNP,5,1
0,0.0,18,is,11,1,6,5,0,11,10,-5,José María Mijares,1921,PER-PER-PER,TIME,PROPN-PROPN-PROPN,NUM,compound-compound-nsubj,npadvmod,NNP-NNP-NNP,CD,3,1
1,0.0,18,is,11,1,8,7,0,9,10,-3,José María Mijares,Havana,PER-PER-PER,LOC,PROPN-PROPN-PROPN,PROPN,compound-compound-nsubj,pobj,NNP-NNP-NNP,NNP,5,1
2,0.0,18,is,11,1,10,9,0,7,10,-1,José María Mijares,Cuba,PER-PER-PER,LOC,PROPN-PROPN-PROPN,PROPN,compound-compound-nsubj,npadvmod,NNP-NNP-NNP,NNP,2,1
3,0.0,18,is,11,1,14,13,0,3,10,3,José María Mijares,Cuban,PER-PER-PER,LOC,PROPN-PROPN-PROPN,ADJ,compound-compound-nsubj,amod,NNP-NNP-NNP,JJ,4,1
4,0.0,18,is,11,8,10,2,7,7,3,-1,Havana,Cuba,LOC,LOC,PROPN,PROPN,pobj,npadvmod,NNP,NNP,5,1
5,0.0,18,is,11,8,14,6,7,3,3,3,Havana,Cuban,LOC,LOC,PROPN,ADJ,pobj,amod,NNP,JJ,7,1
0,0.0,48,is,6,16,41,25,15,6,-10,35,United Kingdom,David Cameron,LOC-LOC,PER-PER,PROPN-PROPN,PROPN-PROPN,compound-pobj,compound-pobj,NNP-NNP,NNP-NNP,11,1
1,0.0,48,is,6,16,46,30,15,1,-10,40,United Kingdom,Tony Benn,LOC-LOC,PER-PER,PROPN-PROPN,PROPN-PROPN,compound-pobj,compound-conj,NNP-NNP,NNP-NNP,12,1
2,0.0,48,is,6,41,44,3,40,3,-35,38,David Cameron,Labour,PER-PER,ORG,PROPN-PROPN,PROPN,compound-pobj,compound,NNP-NNP,NNP,2,1
3,3.0,20,is,13,15,18,3,14,1,-2,5,Jude Woodward,Socialist Action,PER-PER,ORG-ORG,PROPN-PROPN,PROPN-PROPN,compound-attr,compound-pobj,NNP-NNP,NNP-NNP,2,1
0,0.0,47,"""",0,2,12,10,1,34,-2,12,( We 've Got ) Honey Love,1967,MISC-MISC-MISC-MISC-MISC-MISC-MISC,TIME,PUNCT-PRON-VERB-VERB-PUNCT-PROPN-NOUN,NUM,punct-nsubj-aux-ROOT-punct-compound-nsubj,nummod,-LRB--PRP-VBP-VBN--RRB--NNP-NN,CD,4,1
1,0.0,47,"""",0,2,18,16,1,28,-2,18,( We 've Got ) Honey Love,The Velvelettes,MISC-MISC-MISC-MISC-MISC-MISC-MISC,ORG-ORG,PUNCT-PRON-VERB-VERB-PUNCT-PROPN-NOUN,DET-PROPN,punct-nsubj-aux-ROOT-punct-compound-nsubj,det-appos,-LRB--PRP-VBP-VBN--RRB--NNP-NN,DT-NNPS,7,1
0,0.0,37,is,2,1,5,4,0,31,1,3,Matt Birkbeck,American,PER-PER,LOC,PROPN-PROPN,ADJ,compound-nsubj,amod,NNP-NNP,JJ,2,1
0,0.0,51,is,2,1,23,22,0,27,1,21,Cape Enrage,New Brunswick,LOC-LOC,LOC-LOC,PROPN-PROPN,PROPN-PROPN,compound-nsubj,compound-conj,NNP-NNP,NNP-NNP,12,1
1,0.0,51,is,2,1,26,25,0,24,1,24,Cape Enrage,Canada,LOC-LOC,LOC,PROPN-PROPN,PROPN,compound-nsubj,conj,NNP-NNP,NNP,8,1
2,0.0,51,is,2,12,23,11,11,27,-10,21,Barn Marsh Island,New Brunswick,LOC-LOC-LOC,LOC-LOC,PROPN-PROPN-PROPN,PROPN-PROPN,compound-compound-pobj,compound-conj,NNP-NNP-NNP,NNP-NNP,6,1
3,0.0,51,is,2,12,26,14,11,24,-10,24,Barn Marsh Island,Canada,LOC-LOC-LOC,LOC,PROPN-PROPN-PROPN,PROPN,compound-compound-pobj,conj,NNP-NNP-NNP,NNP,2,1
4,0.0,51,is,2,20,23,3,19,27,-18,21,Albert County,New Brunswick,LOC-LOC,LOC-LOC,PROPN-PROPN,PROPN-PROPN,compound-pobj,compound-conj,NNP-NNP,NNP-NNP,1,1
5,0.0,51,is,2,20,26,6,19,24,-18,24,Albert County,Canada,LOC-LOC,LOC,PROPN-PROPN,PROPN,compound-pobj,conj,NNP-NNP,NNP,5,1
6,0.0,51,is,2,23,26,3,22,24,-21,24,New Brunswick,Canada,LOC-LOC,LOC,PROPN-PROPN,PROPN,compound-conj,conj,NNP-NNP,NNP,6,1
0,5.0,28,applied,2,8,6,-2,7,21,-6,4,George W. Bush,U.S.,PER-PER-PER,LOC,PROPN-PROPN-PROPN,PROPN,compound-compound-poss,compound,NNP-NNP-NNP,NNP,2,1
1,5.0,28,applied,2,14,6,-8,13,21,-12,4,Harriet Miers,U.S.,PER-PER,LOC,PROPN-PROPN,PROPN,compound-pobj,compound,NNP-NNP,NNP,4,1
2,5.0,28,applied,2,18,6,-12,17,21,-16,4,Supreme Court,U.S.,ORG-ORG,LOC,PROPN-PROPN,PROPN,compound-pobj,compound,NNP-NNP,NNP,4,1
0,0.0,19,is,12,1,9,8,0,9,11,-3,David Jack,Bristol,PER-PER,LOC,PROPN-PROPN,PROPN,compound-nsubj,pobj,NNP-NNP,NNP,4,1
1,0.0,19,is,12,1,15,14,0,3,11,3,David Jack,American,PER-PER,LOC,PROPN-PROPN,ADJ,compound-nsubj,amod,NNP-NNP,JJ,3,1
2,0.0,19,is,12,9,15,6,8,3,3,3,Bristol,American,LOC,LOC,PROPN,ADJ,pobj,amod,NNP,JJ,7,1
3,0.0,19,is,12,11,15,4,10,3,1,3,Pennsylvania,American,LOC,LOC,PROPN,ADJ,appos,amod,NNP,JJ,5,1
0,0.0,42,M.D.,2,1,11,10,0,30,1,9,Gideon Koren M.D.,1947,PER-PER-PER,TIME,PROPN-PROPN-PROPN,NUM,compound-compound-ROOT,npadvmod,NNP-NNP-NNP,CD,3,1
1,0.0,42,M.D.,2,1,21,20,0,20,1,19,Gideon Koren M.D.,Israel,PER-PER-PER,LOC,PROPN-PROPN-PROPN,PROPN,compound-compound-ROOT,pobj,NNP-NNP-NNP,NNP,4,1
2,0.0,42,M.D.,2,13,16,3,12,25,-11,14,Tel Aviv,Mandatory Palestine,LOC-LOC,LOC-LOC,PROPN-PROPN,PROPN-PROPN,compound-pobj,compound-appos,NNP-NNP,NNP-NNP,3,1
3,0.0,42,M.D.,2,13,21,8,12,20,-11,19,Tel Aviv,Israel,LOC-LOC,LOC,PROPN-PROPN,PROPN,compound-pobj,pobj,NNP-NNP,NNP,4,1
4,0.0,42,M.D.,2,16,21,5,15,20,-14,19,Mandatory Palestine,Israel,LOC-LOC,LOC,PROPN-PROPN,PROPN,compound-appos,pobj,NNP-NNP,NNP,1,1
0,6.0,23,listed,21,5,17,12,4,5,16,-4,Jeffery,U.S.,PER,LOC,PROPN,PROPN,appos,pobj,NNP,NNP,7,1
0,0.0,17,(;,2,1,4,3,0,12,1,2,Adamantios Androutsopoulos,20 August 1919,PER-PER,TIME-TIME-TIME,PROPN-PROPN,NUM-PROPN-NUM,compound-nsubj,nummod-nsubj-nummod,NNP-NNP,CD-NNP-CD,2,1
1,0.0,17,(;,2,1,8,7,0,8,1,6,Adamantios Androutsopoulos,10 November 2000,PER-PER,TIME-TIME-TIME,PROPN-PROPN,NUM-PROPN-NUM,compound-nsubj,nummod-npadvmod-nummod,NNP-NNP,CD-NNP-CD,2,1
2,2.0,12,born,2,7,9,2,6,2,-5,7,Messenia,Greece,LOC,LOC,PROPN,PROPN,conj,conj,NNP,NNP,5,1
0,2.0,31,contains,3,8,3,-5,7,27,-5,0,Ceratomyrmex,Haidomyrmecini,MISC,MISC,PROPN,PROPN,dobj,appos,NNP,NNP,3,1
1,2.0,31,contains,3,10,3,-7,9,27,-7,0,Haidomyrmex,Haidomyrmecini,MISC,MISC,PROPN,PROPN,conj,appos,NNP,NNP,4,1
2,2.0,31,contains,3,16,3,-13,15,27,-13,0,Linguamyrmex,Haidomyrmecini,MISC,MISC,PROPN,PROPN,conj,appos,NNP,NNP,1,1
3,2.0,31,contains,3,21,19,-2,20,11,-18,16,Baikuris,Sphecomyrmini,MISC,MISC,PROPN,PROPN,dobj,nsubj,NNP,NNP,2,1
4,2.0,31,contains,3,27,19,-8,26,11,-24,16,Sphecomyrma,Sphecomyrmini,MISC,MISC,PROPN,PROPN,conj,nsubj,NNP,NNP,5,1
5,3.0,34,made,16,33,3,-30,32,30,-17,-13,Formicidae,Sphecomyrmodes,MISC,MISC,PROPN,PROPN,pobj,nsubjpass,NNP,NNP,3,1
6,3.0,34,made,16,33,25,-8,32,8,-17,9,Formicidae,Gerontoformica,MISC,MISC,PROPN,PROPN,pobj,pobj,NNP,NNP,3,1
0,0.0,30,is,4,1,25,24,0,4,3,21,Catoosa Wildlife Management Area,Tennessee,LOC-LOC-LOC-LOC,LOC,PROPN-PROPN-PROPN-PROPN,PROPN,compound-compound-compound-nsubj,pobj,NNP-NNP-NNP-NNP,NNP,5,1
1,0.0,30,is,4,14,25,11,13,4,-10,21,Upper Cumberland Plateau,Tennessee,LOC-LOC-LOC,LOC,PROPN-PROPN-PROPN,PROPN,compound-compound-pobj,pobj,NNP-NNP-NNP,NNP,5,1
2,0.0,30,is,4,14,13,-1,13,16,-10,9,Upper Cumberland Plateau,the United States,LOC-LOC-LOC,LOC-LOC-LOC,PROPN-PROPN-PROPN,DET-PROPN-PROPN,compound-compound-pobj,det-compound-pobj,NNP-NNP-NNP,DT-NNP-NNP,1,1
3,0.0,30,is,4,18,25,7,17,4,-14,21,Morgan,Tennessee,LOC,LOC,PROPN,PROPN,pobj,pobj,NNP,NNP,7,1
4,0.0,30,is,4,18,13,-5,17,16,-14,9,Morgan,the United States,LOC,LOC-LOC-LOC,PROPN,DET-PROPN-PROPN,pobj,det-compound-pobj,NNP,DT-NNP-NNP,5,1
5,0.0,30,is,4,15,25,10,14,4,-11,21,Cumberland,Tennessee,LOC,LOC,PROPN,PROPN,conj,pobj,NNP,NNP,4,1
6,0.0,30,is,4,15,13,-2,14,16,-11,9,Cumberland,the United States,LOC,LOC-LOC-LOC,PROPN,DET-PROPN-PROPN,conj,det-compound-pobj,NNP,DT-NNP-NNP,2,1
7,0.0,30,is,4,22,25,3,21,4,-18,21,Fentress,Tennessee,LOC,LOC,PROPN,PROPN,conj,pobj,NNP,NNP,1,1
8,0.0,30,is,4,22,13,-9,21,16,-18,9,Fentress,the United States,LOC,LOC-LOC-LOC,PROPN,DET-PROPN-PROPN,conj,det-compound-pobj,NNP,DT-NNP-NNP,5,1
9,0.0,30,is,4,25,13,-12,24,16,-21,9,Tennessee,the United States,LOC,LOC-LOC-LOC,PROPN,DET-PROPN-PROPN,pobj,det-compound-pobj,NNP,DT-NNP-NNP,6,1
0,0.0,15,is,8,1,5,4,0,9,7,-3,Aleksander Lasoń,10 November 1951,PER-PER,TIME-TIME-TIME,PROPN-PROPN,NUM-PROPN-NUM,compound-nsubj,nummod-npadvmod-nummod,NNP-NNP,CD-NNP-CD,2,1
1,0.0,15,is,8,1,11,10,0,3,7,3,Aleksander Lasoń,Polish,PER-PER,LOC,PROPN-PROPN,ADJ,compound-nsubj,amod,NNP-NNP,JJ,2,1
2,2.0,18,studied,1,11,17,6,10,0,-10,16,Karol Szymanowski Academy of Music,Katowice,ORG-ORG-ORG-ORG-ORG,LOC,PROPN-PROPN-PROPN-ADP-PROPN,PROPN,compound-compound-pobj-prep-pobj,pobj,NNP-NNP-NNP-IN-NNP,NNP,8,1
0,0.0,12,"""",0,2,11,9,1,0,-2,11,November Spawned a Monster,Morrissey,MISC-MISC-MISC-MISC,PER,PROPN-VERB-DET-PROPN,PROPN,nsubj-ccomp-det-dobj,pobj,NNP-VBD-DT-NNP,NNP,2,1
1,12.0,41,Spawned,8,2,15,13,1,25,6,7,November Spawned a Monster,Morrissey,MISC-MISC-MISC-MISC,PER,PROPN-VERB-DET-PROPN,PROPN,nsubj-ROOT-det-dobj,poss,NNP-VBD-DT-NNP,NNP,-1,1
2,12.0,41,Spawned,8,2,28,26,1,12,6,20,November Spawned a Monster,Australia,MISC-MISC-MISC-MISC,LOC,PROPN-VERB-DET-PROPN,PROPN,nsubj-ROOT-det-dobj,appos,NNP-VBD-DT-NNP,NNP,-1,1
3,12.0,41,Spawned,8,2,32,30,1,8,6,24,November Spawned a Monster,Robert Chuter,MISC-MISC-MISC-MISC,PER-PER,PROPN-VERB-DET-PROPN,PROPN-PROPN,nsubj-ROOT-det-dobj,compound-pobj,NNP-VBD-DT-NNP,NNP-NNP,-1,1
4,12.0,41,Spawned,8,26,28,2,25,12,-18,20,Sydney,Australia,LOC,LOC,PROPN,PROPN,pobj,appos,NNP,NNP,2,1
0,0.0,38,Stephens,1,1,5,4,0,32,0,4,Patricia Stephens Due,"December 9 , 1939",PER-PER-PER,TIME-TIME-TIME-TIME,PROPN-PROPN-PROPN,PROPN-NUM-PUNCT-NUM,compound-ROOT-prep,nmod-nummod-punct-nummod,NNP-NNP-NNP,"NNP-CD-,-CD",3,1
1,0.0,38,Stephens,1,1,10,9,0,27,0,9,Patricia Stephens Due,"February 7 , 2012",PER-PER-PER,TIME-TIME-TIME-TIME,PROPN-PROPN-PROPN,PROPN-NUM-PUNCT-NUM,compound-ROOT-prep,npadvmod-nummod-punct-nummod,NNP-NNP-NNP,"NNP-CD-,-CD",2,1
2,0.0,38,Stephens,1,1,18,17,0,19,0,17,Patricia Stephens Due,the United States,PER-PER-PER,LOC-LOC-LOC,PROPN-PROPN-PROPN,DET-PROPN-PROPN,compound-ROOT-prep,det-compound-pobj,NNP-NNP-NNP,DT-NNP-NNP,5,1
3,0.0,38,Stephens,1,18,37,19,17,0,-17,36,the United States,Florida,LOC-LOC-LOC,LOC,DET-PROPN-PROPN,PROPN,det-compound-pobj,pobj,DT-NNP-NNP,NNP,5,1
0,0.0,37,is,5,1,24,23,0,12,4,19,Xanthorhiza,Ranunculaceae,MISC,MISC,PROPN,PROPN,pobj,pobj,NNP,NNP,6,1
1,1.0,22,is,1,7,10,3,6,11,-6,9,United States,Maine,LOC-LOC,LOC,PROPN-PROPN,PROPN,compound-pobj,pobj,NNP-NNP,NNP,5,1
2,1.0,22,is,1,7,14,7,6,7,-6,13,United States,Florida,LOC-LOC,LOC,PROPN-PROPN,PROPN,compound-pobj,pobj,NNP-NNP,NNP,6,1
3,1.0,22,is,1,7,18,11,6,3,-6,17,United States,Ohio,LOC-LOC,LOC,PROPN-PROPN,PROPN,compound-pobj,pobj,NNP-NNP,NNP,6,1
4,1.0,22,is,1,7,21,14,6,0,-6,20,United States,Texas,LOC-LOC,LOC,PROPN-PROPN,PROPN,compound-pobj,conj,NNP-NNP,NNP,4,1
0,3.0,50,is,1,1,14,13,0,35,0,13,Robinson,Cleveland Indians,PER,ORG-ORG,PROPN,PROPN-PROPN,nsubj,compound-pobj,NNP,NNP-NNPS,4,1
1,3.0,50,is,1,1,40,39,0,9,0,39,Robinson,Detroit Tigers,PER,ORG-ORG,PROPN,PROPN-PROPN,nsubj,compound-pobj,NNP,NNP-NNP,5,1
2,3.0,50,is,1,1,43,42,0,6,0,42,Robinson,New York Yankees,PER,ORG-ORG-ORG,PROPN,PROPN-PROPN-PROPN,nsubj,compound-compound-conj,NNP,NNP-NNP-NNPS,5,1
0,3.0,34,arrested,6,18,20,2,17,13,-12,14,NKVD,Lavrentiy Beria,ORG,PER-PER,PROPN,PROPN-PROPN,compound,compound-pobj,NNP,NNP-NNP,1,1
1,4.0,25,became,15,9,12,3,8,12,6,-3,Joseph Stalin,1953,PER-PER,TIME,PROPN-PROPN,NUM,compound-pobj,pobj,NNP-NNP,CD,6,1
0,4.0,50,calls,8,27,32,5,26,17,-19,24,Birmingham,United Kingdom,LOC,LOC-LOC,PROPN,PROPN-PROPN,pobj,compound-pobj,NNP,NNP-NNP,5,1
1,4.0,50,calls,8,29,32,3,28,17,-21,24,Edinburgh,United Kingdom,LOC,LOC-LOC,PROPN,PROPN-PROPN,conj,compound-pobj,NNP,NNP-NNP,1,1
2,4.0,50,calls,8,38,40,2,37,9,-30,32,Hambantota,Sri Lanka,LOC,LOC-LOC,PROPN,PROPN-PROPN,pobj,compound-pobj,NNP,NNP-NNP,1,1
3,4.0,50,calls,8,40,5,-35,39,44,-32,-3,Sri Lanka,Commonwealth,LOC-LOC,ORG,PROPN-PROPN,PROPN,compound-pobj,compound,NNP-NNP,NNP,13,1
0,0.0,22,is,1,1,13,12,0,8,0,12,Relayer,Yes,MISC,ORG,NOUN,INTJ,nsubj,intj,NN,UH,-1,1
1,0.0,22,is,1,1,17,16,0,4,0,16,Relayer,November 1974,MISC,TIME-TIME,NOUN,PROPN-NUM,nsubj,pobj-nummod,NN,NNP-CD,-1,1
2,0.0,22,is,1,1,20,19,0,1,0,19,Relayer,Atlantic Records,MISC,ORG-ORG,NOUN,PROPN-PROPN,nsubj,compound-pobj,NN,NNP-NNPS,-1,1
3,1.0,37,left,4,19,3,-16,18,33,-15,-1,Yes,Rick Wakeman,ORG,PER-PER,INTJ,PROPN-PROPN,intj,compound-nsubj,UH,NNP-NNP,2,1
4,1.0,37,left,4,19,28,9,18,8,-15,24,Yes,Chris Squire,ORG,PER-PER,INTJ,PROPN-PROPN,intj,compound-poss,UH,NNP-NNP,5,1
5,1.0,37,left,4,33,36,3,32,0,-29,32,Virginia Water,Surrey,LOC-LOC,LOC,PROPN-PROPN,PROPN,compound-pobj,npadvmod,NNP-NNP,NNP,7,1
0,0.0,19,is,7,2,10,8,1,8,5,3,Airmail Flyers ' Medal of Honor,United States,MISC-MISC-MISC-MISC-MISC-MISC,LOC-LOC,PROPN-PROPN-PART-PROPN-ADP-PROPN,PROPN-PROPN,compound-poss-case-nsubj-prep-pobj,compound-compound,NNP-NNPS-POS-NNP-IN-NNP,NNP-NNP,4,1
0,0.0,20,is,3,1,1,0,0,18,2,-2,United Sound Systems,United States,ORG-ORG-ORG,LOC-LOC,PROPN-PROPN-PROPN,PROPN-PROPN,compound-compound-nsubj,compound-appos,NNP-NNP-NNPS,NNP-NNP,0,1
1,0.0,20,is,3,16,1,-15,15,18,-13,-2,Michigan,United States,LOC,LOC-LOC,PROPN,PROPN-PROPN,conj,compound-appos,NNP,NNP-NNP,8,1
0,0.0,18,is,4,2,17,15,1,0,2,13,Telegraph - Journal,Canada,ORG-ORG-ORG,LOC,PROPN-PUNCT-PROPN,PROPN,compound-punct-nsubj,appos,NNP-HYPH-NNP,NNP,3,1
1,0.0,18,is,4,11,17,6,10,0,-7,13,Saint John,Canada,LOC-LOC,LOC,PROPN-PROPN,PROPN,compound-pobj,appos,NNP-NNP,NNP,5,1
2,0.0,18,is,4,14,17,3,13,0,-10,13,New Brunswick,Canada,LOC-LOC,LOC,PROPN-PROPN,PROPN,compound-conj,appos,NNP-NNP,NNP,6,1
0,0.0,41,was,27,1,10,9,0,30,26,-17,Rudolf Hieronymus Eusebius von Colloredo - Waldsee,2 November 1585,PER-PER-PER-PER-PER-PER-PER,TIME-TIME-TIME,PROPN-PROPN-PROPN-PROPN-PROPN-PUNCT-PROPN,NUM-PROPN-NUM,compound-compound-nsubj-compound-compound-punct-appos,nummod-npadvmod-nummod,NNP-NNP-NNP-NNP-NNP-HYPH-NNP,CD-NNP-CD,3,1
1,0.0,41,was,27,14,24,10,13,16,13,-3,České Budějovice,Czech Republic,LOC-LOC,LOC-LOC,PROPN-PROPN,PROPN-PROPN,compound-pobj,compound-pobj,NNP-NNP,NNP-NNP,5,1
2,4.0,22,built,5,8,20,12,7,1,-3,15,Schönborn Palace,Czech Republic,LOC-LOC,LOC-LOC,PROPN-PROPN,PROPN-PROPN,compound-dobj,compound-pobj,NNP-NNP,NNP-NNP,3,1
0,0.0,23,is,2,2,8,6,1,14,0,6,Trugberg,Bernese Alps,LOC,LOC-LOC,PROPN,PROPN-PROPN,nsubj,compound-pobj,NNP,NNP-NNP,3,1
1,0.0,23,is,2,2,15,13,1,7,0,13,Trugberg,Mönch,LOC,LOC,PROPN,PROPN,nsubj,pobj,NNP,NNP,3,1
2,0.0,23,is,2,2,20,18,1,2,0,18,Trugberg,Valais,LOC,LOC,PROPN,PROPN,nsubj,pobj,NNP,NNP,5,1
3,0.0,23,is,2,2,22,20,1,0,0,20,Trugberg,Switzerland,LOC,LOC,PROPN,PROPN,nsubj,appos,NNP,NNP,1,1
4,0.0,23,is,2,8,20,12,7,2,-6,18,Bernese Alps,Valais,LOC-LOC,LOC,PROPN-PROPN,PROPN,compound-pobj,pobj,NNP-NNP,NNP,6,1
5,0.0,23,is,2,8,22,14,7,0,-6,20,Bernese Alps,Switzerland,LOC-LOC,LOC,PROPN-PROPN,PROPN,compound-pobj,appos,NNP-NNP,NNP,4,1
6,0.0,23,is,2,15,20,5,14,2,-13,18,Mönch,Valais,LOC,LOC,PROPN,PROPN,pobj,pobj,NNP,NNP,2,1
7,0.0,23,is,2,15,22,7,14,0,-13,20,Mönch,Switzerland,LOC,LOC,PROPN,PROPN,pobj,appos,NNP,NNP,4,1
8,0.0,23,is,2,20,22,2,19,0,-18,20,Valais,Switzerland,LOC,LOC,PROPN,PROPN,pobj,appos,NNP,NNP,6,1
0,0.0,16,is,1,1,15,14,0,0,0,14,Breiavatnet,Norway,LOC,LOC,PROPN,PROPN,nsubj,appos,NNP,NNP,1,1
1,0.0,16,is,1,10,12,2,9,3,-9,11,Stavanger,Rogaland county,LOC,LOC-LOC,PROPN,PROPN-NOUN,pobj,compound-pobj,NNP,NNP-NN,1,1
2,0.0,16,is,1,10,15,5,9,0,-9,14,Stavanger,Norway,LOC,LOC,PROPN,PROPN,pobj,appos,NNP,NNP,4,1
3,0.0,16,is,1,12,15,3,11,0,-11,14,Rogaland county,Norway,LOC-LOC,LOC,PROPN-NOUN,PROPN,compound-pobj,appos,NNP-NN,NNP,5,1
0,1.0,28,graduated,4,4,7,3,3,20,0,3,DeLong,Balboa High School,PER,ORG-ORG-ORG,PROPN,PROPN-PROPN-PROPN,nsubj,compound-compound-pobj,NNP,NNP-NNP-NNP,3,1
1,1.0,28,graduated,4,7,14,7,6,13,-3,10,Balboa High School,California,ORG-ORG-ORG,LOC,PROPN-PROPN-PROPN,PROPN,compound-compound-pobj,appos,NNP-NNP-NNP,NNP,5,1
0,0.0,21,is,4,2,19,17,1,1,2,15,Philadelphia Liberty FC,United States,ORG-ORG-ORG,LOC-LOC,PROPN-PROPN-PROPN,PROPN-PROPN,compound-compound-nsubj,compound-appos,NNP-NNP-NNP,NNP-NNP,8,1
1,0.0,21,is,4,7,19,12,6,1,-3,15,North American,United States,LOC-LOC,LOC-LOC,ADJ-ADJ,PROPN-PROPN,amod-amod,compound-appos,JJ-JJ,NNP-NNP,6,1
2,0.0,21,is,4,14,17,3,13,3,-10,13,West Chester,Pennsylvania,LOC-LOC,LOC,PROPN-PROPN,PROPN,compound-pobj,conj,NNP-NNP,NNP,2,1
3,0.0,21,is,4,14,19,5,13,1,-10,15,West Chester,United States,LOC-LOC,LOC-LOC,PROPN-PROPN,PROPN-PROPN,compound-pobj,compound-appos,NNP-NNP,NNP-NNP,2,1
4,0.0,21,is,4,17,19,2,16,1,-13,15,Pennsylvania,United States,LOC,LOC-LOC,PROPN,PROPN-PROPN,conj,compound-appos,NNP,NNP-NNP,2,1
0,0.0,20,was,12,1,15,14,0,4,11,3,Franklin Harper Elmore,United States,PER-PER-PER,LOC-LOC,PROPN-PROPN-PROPN,PROPN-PROPN,compound-compound-nsubj,compound-compound,NNP-NNP-NNP,NNP-NNP,4,1
1,5.0,41,appointed,2,1,36,35,0,4,1,34,Elmore,"Washington , D.C.",PER,LOC-LOC-LOC,PROPN,PROPN-PUNCT-PROPN,nsubjpass,pobj-punct-appos,NNP,"NNP-,-NNP",8,1
0,0.0,44,is,3,2,40,38,1,3,1,37,Ventadour Lake,Quebec,LOC-LOC,LOC,PROPN-PROPN,PROPN,compound-nsubj,pobj,NNP-NNP,NNP,6,1
1,0.0,44,is,3,2,43,41,1,0,1,40,Ventadour Lake,Canada,LOC-LOC,LOC,PROPN-PROPN,PROPN,compound-nsubj,pobj,NNP-NNP,NNP,2,1
2,0.0,44,is,3,14,23,9,13,20,-11,20,Eeyou Istchee James Bay,Jamésie,LOC-LOC-LOC-LOC,LOC,PROPN-PROPN-PROPN-PROPN,PROPN,compound-compound-compound-pobj,pobj,NNP-NNP-NNP-NNP,NNP,8,1
3,0.0,44,is,3,14,43,29,13,0,-11,40,Eeyou Istchee James Bay,Canada,LOC-LOC-LOC-LOC,LOC,PROPN-PROPN-PROPN-PROPN,PROPN,compound-compound-compound-pobj,pobj,NNP-NNP-NNP-NNP,NNP,7,1
4,0.0,44,is,3,23,43,20,22,0,-20,40,Jamésie,Canada,LOC,LOC,PROPN,PROPN,pobj,pobj,NNP,NNP,3,1
5,0.0,44,is,3,40,43,3,39,0,-37,40,Quebec,Canada,LOC,LOC,PROPN,PROPN,pobj,pobj,NNP,NNP,6,1
0,0.0,42,is,12,1,5,4,0,36,11,-7,Andrea Ferrante,16 August 1968,PER-PER,TIME-TIME-TIME,PROPN-PROPN,NUM-PROPN-NUM,compound-nsubj,nummod-npadvmod-nummod,NNP-NNP,CD-NNP-CD,2,1
1,0.0,42,is,12,1,9,8,0,32,11,-3,Andrea Ferrante,Palermo,PER-PER,LOC,PROPN-PROPN,PROPN,compound-nsubj,conj,NNP-NNP,NNP,2,1
2,1.0,124,divided,24,61,53,-8,60,70,-37,29,Andrea Ferrante,Palermo,PER-PER,LOC,PROPN-PROPN,PROPN,compound-nsubj,pobj,NNP-NNP,NNP,3,1
0,0.0,34,was,16,31,33,2,30,0,-15,17,Osby,Sweden,LOC,LOC,PROPN,PROPN,pobj,appos,NNP,NNP,8,1
0,1.0,79,known,3,1,14,13,0,64,2,11,ALA,Denis Verdini,ORG,PER-PER,NOUN,PROPN-PROPN,compound,compound-appos,NN,NNP-NNP,6,1
1,1.0,79,known,3,68,77,9,67,1,-65,74,Matteo Renzi,Democratic Party,PER-PER,ORG-ORG,PROPN-PROPN,PROPN-PROPN,compound-pobj,compound-pobj,NNP-NNP,NNP-NNP,2,1
0,0.0,18,is,1,1,17,16,0,0,0,16,Eickendorf,Germany,LOC,LOC,PROPN,PROPN,nsubj,appos,NNP,NNP,1,1
1,0.0,18,is,1,10,17,7,9,0,-9,16,Salzlandkreis,Germany,LOC,LOC,PROPN,PROPN,pobj,appos,NNP,NNP,3,1
2,7.0,28,was,1,19,24,5,18,3,-18,23,Joseph Freiherr von Eichendorff,1788,PER-PER-PER-PER,TIME,PROPN-PROPN-PROPN-PROPN,NUM,compound-compound-compound-appos,nummod,NNP-NNP-NNP-NNP,CD,2,1
3,7.0,28,was,1,19,26,7,18,1,-18,25,Joseph Freiherr von Eichendorff,1857,PER-PER-PER-PER,TIME,PROPN-PROPN-PROPN-PROPN,NUM,compound-compound-compound-appos,nummod,NNP-NNP-NNP-NNP,CD,2,1
0,0.0,64,is,1,1,18,17,0,45,0,17,Cloverfield,J. J. Abrams,MISC,PER-PER-PER,PROPN,PROPN-PROPN-PROPN,nsubj,compound-compound-pobj,NNP,NNP-NNP-NNP,6,1
1,0.0,64,is,1,1,48,47,0,15,0,47,Cloverfield / Kishin,2008,MISC-MISC-MISC,TIME,PROPN-SYM-PROPN,NUM,nmod-punct-oprd,appos,NNP-SYM-NNP,CD,8,1
2,6.0,20,released,11,2,14,12,1,5,9,3,Cloverfield Paradox,Netflix,MISC-MISC,ORG,PROPN-PROPN,PROPN,compound-nsubjpass,pobj,NNP-NNP,NNP,2,1
0,0.0,25,is,7,16,22,6,15,2,-9,15,Bayn al - Qasrayn,Cairo,LOC-LOC-LOC-LOC,LOC,PROPN-PROPN-PUNCT-PROPN,PROPN,compound-compound-punct-compound,pobj,NNP-NNP-HYPH-NNP,NNP,5,1
1,0.0,25,is,7,16,24,8,15,0,-9,17,Bayn al - Qasrayn,Egypt,LOC-LOC-LOC-LOC,LOC,PROPN-PROPN-PUNCT-PROPN,PROPN,compound-compound-punct-compound,appos,NNP-NNP-HYPH-NNP,NNP,7,1
2,0.0,25,is,7,22,24,2,21,0,-15,17,Cairo,Egypt,LOC,LOC,PROPN,PROPN,pobj,appos,NNP,NNP,8,1
0,1.0,28,is,1,1,13,12,0,14,0,12,Roulette,Rockabilly Genre,PER,MISC-MISC,PROPN,PROPN-PROPN,nsubj,compound-pobj,NNP,NNP-NNP,4,1
0,10.0,20,written,3,7,10,3,6,9,-4,7,Ngaanyatjarra,Western Australia,LOC,LOC-LOC,PROPN,PROPN-PROPN,compound,compound-pobj,NNP,NNP-NNP,2,1
0,2.0,31,is,4,11,14,3,10,16,-7,10,North America,US,LOC-LOC,LOC,PROPN-PROPN,PROPN,compound-pobj,appos,NNP-NNP,NNP,2,1
1,2.0,31,is,4,11,16,5,10,14,-7,12,North America,Canada,LOC-LOC,LOC,PROPN-PROPN,PROPN,compound-pobj,conj,NNP-NNP,NNP,3,1
2,2.0,31,is,4,11,18,7,10,12,-7,14,North America,Mexico,LOC-LOC,LOC,PROPN-PROPN,PROPN,compound-pobj,conj,NNP-NNP,NNP,4,1
3,6.0,39,was,27,7,23,16,6,15,20,-4,Jeff Meckstroth,United States,PER-PER,LOC-LOC,PROPN-PROPN,PROPN-PROPN,compound-appos,compound-nsubj,NNP-NNP,NNP-NNP,5,1
0,2.0,25,comprises,4,18,22,4,17,2,-14,18,Republika Srpska,Bosnia and Herzegovina,LOC-LOC,LOC-LOC-LOC,PROPN-PROPN,PROPN-CCONJ-PROPN,compound-compound,pobj-cc-conj,NNP-NNP,NNP-CC-NNP,4,1
1,4.0,19,is,4,2,16,14,1,2,2,12,Serbian Orthodox Church,Eastern Orthodox,LOC-LOC-LOC,ORG-ORG,PROPN-PROPN-PROPN,PROPN-PROPN,amod-compound-nsubj,compound-compound,NNP-NNP-NNP,NNP-NNP,6,1
2,6.0,20,achieved,2,2,7,5,1,12,0,5,Church,1219,LOC,TIME,PROPN,NUM,nsubj,pobj,NNP,CD,1,1
3,6.0,20,achieved,2,2,12,10,1,7,0,10,Church,St. Sava,LOC,PER-PER,PROPN,PROPN-PROPN,nsubj,compound-pobj,NNP,NNP-NNP,4,1
0,0.0,14,is,9,1,12,11,0,1,8,3,Peter Linz,American,PER-PER,LOC,PROPN-PROPN,ADJ,compound-nsubj,amod,NNP-NNP,JJ,2,1
1,2.0,17,took,2,13,16,3,12,0,-11,14,Sesame Street,2017,MISC-MISC,TIME,PROPN-PROPN,NUM,compound-pobj,pobj,NNP-NNP,CD,4,1
0,0.0,16,was,11,1,4,3,0,11,10,-7,Marie Gevers,30 December 1883,PER-PER,TIME-TIME-TIME,PROPN-PROPN,NUM-PROPN-NUM,compound-nsubj,nummod-nmod-nummod,NNP-NNPS,CD-NNP-CD,1,1
1,0.0,16,was,11,1,14,13,0,1,10,3,Marie Gevers,Belgian,PER-PER,LOC,PROPN-PROPN,ADJ,compound-nsubj,amod,NNP-NNPS,JJ,2,1
0,0.0,30,Sings,2,1,1,0,0,28,1,-1,Johnny Mathis Sings the Music of Bacharach & Kaempfert,Johnny Mathis,MISC-MISC-MISC-MISC-MISC-MISC-MISC-MISC-MISC,PER-PER,PROPN-PROPN-VERB-DET-PROPN-ADP-PROPN-CCONJ-PROPN,PROPN-PROPN,compound-nsubj-ROOT-det-dobj-prep-pobj-cc-conj,compound-pobj,NNP-NNP-VBZ-DT-NNP-IN-NNP-CC-NNP,NNP-NNP,0,1
1,0.0,30,Sings,2,1,28,27,0,1,1,26,Johnny Mathis Sings the Music of Bacharach & Kaempfert,Columbia Records,MISC-MISC-MISC-MISC-MISC-MISC-MISC-MISC-MISC,ORG-ORG,PROPN-PROPN-VERB-DET-PROPN-ADP-PROPN-CCONJ-PROPN,PROPN-PROPN,compound-nsubj-ROOT-det-dobj-prep-pobj-cc-conj,compound-pobj,NNP-NNP-VBZ-DT-NNP-IN-NNP-CC-NNP,NNP-NNPS,6,1
2,0.0,30,Sings,2,1,28,27,0,1,1,26,Johnny Mathis,Columbia Records,PER-PER,ORG-ORG,PROPN-PROPN,PROPN-PROPN,compound-pobj,compound-pobj,NNP-NNP,NNP-NNPS,6,1
3,1.0,64,was,9,61,52,-9,60,11,-52,43,Johnny Mathis Sings,Mathis,MISC-MISC-MISC,PER,PROPN-PROPN-PROPN,PROPN,compound-compound-pobj,nsubj,NNP-NNP-NNPS,NNP,4,1
4,3.0,37,came,16,1,35,34,0,1,15,19,The Lady Smiles,Matt Monro,MISC-MISC-MISC,PER-PER,DET-PROPN-PROPN,PROPN-PROPN,det-compound-conj,compound-pobj,DT-NNP-NNP,NNP-NNP,4,1
0,0.0,12,is,3,8,11,3,7,0,-5,8,Addis Ababa,Ethiopia,LOC-LOC,LOC,PROPN-PROPN,PROPN,compound-pobj,appos,NNP-NNP,NNP,4,1
0,0.0,26,is,5,2,14,12,1,11,3,9,Make Me Bad,American,MISC-MISC-MISC,LOC,VERB-PRON-ADJ,PROPN,csubj-nsubj-ccomp,amod,VB-PRP-JJ,NNP,9,1
1,0.0,26,is,5,2,18,16,1,7,3,13,Make Me Bad,Korn,MISC-MISC-MISC,ORG,VERB-PRON-ADJ,PROPN,csubj-nsubj-ccomp,appos,VB-PRP-JJ,NNP,7,1
0,3.0,44,posed,6,19,36,17,18,7,-13,30,Ernest Hoschedé,Alice,PER-PER,PER,PROPN-PROPN,PROPN,compound-attr,appos,NNP-NNP,NNP,3,1
1,3.0,44,posed,6,19,3,-16,18,40,-13,-3,Ernest Hoschedé,Suzanne,PER-PER,PER,PROPN-PROPN,PROPN,compound-attr,appos,NNP-NNP,NNP,5,1
2,3.0,44,posed,6,19,5,-14,18,38,-13,-1,Ernest Hoschedé,Blanche Hoschedé,PER-PER,PER-PER,PROPN-PROPN,PROPN-PROPN,compound-attr,compound-conj,NNP-NNP,NNP-NNP,5,1
3,3.0,44,posed,6,36,3,-33,35,40,-30,-3,Alice,Suzanne,PER,PER,PROPN,PROPN,appos,appos,NNP,NNP,8,1
4,3.0,44,posed,6,36,5,-31,35,38,-30,-1,Alice,Blanche Hoschedé,PER,PER-PER,PROPN,PROPN-PROPN,appos,compound-conj,NNP,NNP-NNP,8,1
5,3.0,44,posed,6,3,5,2,2,38,3,-1,Suzanne,Blanche Hoschedé,PER,PER-PER,PROPN,PROPN-PROPN,appos,compound-conj,NNP,NNP-NNP,2,1
6,4.0,41,canvases,17,24,27,3,23,13,-7,10,Musée d'Orsay,Paris,LOC-LOC,LOC,PROPN-PROPN,PROPN,compound-appos,npadvmod,NNP-NNP,NNP,1,1
0,0.0,18,is,3,1,17,16,0,0,2,14,Live & Inspired,Godsmack,MISC-MISC-MISC,ORG,VERB-CCONJ-PROPN,PROPN,nsubj-cc-conj,pobj,VB-CC-NNP,NNP,3,1
0,0.0,124,is,16,72,5,-67,71,118,-56,-11,Democratic Party of Russia,Russian,ORG-ORG-ORG-ORG,MISC,PROPN-PROPN-ADP-PROPN,ADJ,compound-conj-prep-pobj,amod,NNP-NNP-IN-NNP,JJ,13,1
0,2.0,12,was,2,1,10,9,0,1,1,8,Anatoly Koni,Fyodor Koni,PER-PER,PER-PER,PROPN-PROPN,PROPN-PROPN,compound-nsubj,compound-pobj,NNP-NNP,NNP-NNP,5,1
0,0.0,43,is,13,1,6,5,0,36,12,-7,Jacques Prost,1946,PER-PER,TIME,PROPN-PROPN,NUM,compound-nsubj,pobj,NNP-NNP,CD,2,1
1,0.0,43,is,13,1,8,7,0,34,12,-5,Jacques Prost,Bourg - en - Bresse,PER-PER,LOC-LOC-LOC-LOC-LOC,PROPN-PROPN,PROPN-PUNCT-PROPN-PUNCT-PROPN,compound-nsubj,pobj-punct-compound-punct-appos,NNP-NNP,NNP-HYPH-NNP-HYPH-NNP,4,1
2,0.0,43,is,13,1,16,15,0,26,12,3,Jacques Prost,French,PER-PER,LOC,PROPN-PROPN,ADJ,compound-nsubj,amod,NNP-NNP,JJ,2,1
3,1.0,54,sciences,11,18,22,4,17,31,-7,11,Jacques Prost,Harvard University,PER-PER,ORG-ORG,PROPN-PROPN,PROPN-PROPN,compound-nsubj,compound-pobj,NNP-NNP,NNP-NNP,3,1
0,2.0,17,lived,5,4,8,4,3,8,1,3,Joseph Brodsky,Leningrad,PER-PER,LOC,PROPN-PROPN,PROPN,compound-nsubj,pobj,NNP-NNP,NNP,4,1
0,0.0,14,was,1,4,13,9,3,0,-3,12,Malayalam,India,MISC,LOC,PROPN,PROPN,nmod,appos,NNP,NNP,3,1
1,0.0,14,was,1,11,13,2,10,0,-10,12,Kerala,India,LOC,LOC,PROPN,PROPN,pobj,appos,NNP,NNP,6,1
0,1.0,58,recorded,22,11,20,9,10,37,11,-2,Space Ballerinas,Olympia,ORG-ORG,LOC,PROPN-PROPN,PROPN,compound-pobj,pobj,NNP-NNP,NNP,7,1
1,1.0,58,recorded,22,28,33,5,27,24,-6,11,All Your Faded Things,2003,MISC-MISC-MISC-MISC,TIME,DET-DET-ADJ-NOUN,NUM,predet-poss-compound-appos,appos,DT-PRP$-JJ-NNS,CD,2,1
2,1.0,58,recorded,22,28,37,9,27,20,-6,15,All Your Faded Things,Justin Trosper,MISC-MISC-MISC-MISC,PER-PER,DET-DET-ADJ-NOUN,PROPN-PROPN,predet-poss-compound-appos,compound-pobj,DT-PRP$-JJ-NNS,NNP-NNP,5,1
3,1.0,58,recorded,22,28,45,17,27,12,-6,23,All Your Faded Things,This Is an Exercise,MISC-MISC-MISC-MISC,MISC-MISC-MISC-MISC,DET-DET-ADJ-NOUN,DET-VERB-DET-NOUN,predet-poss-compound-appos,nsubj-ROOT-det-attr,DT-PRP$-JJ-NNS,DT-VBZ-DT-NN,4,1
4,1.0,58,recorded,22,45,50,5,44,7,-23,28,This Is an Exercise,2006,MISC-MISC-MISC-MISC,TIME,DET-VERB-DET-NOUN,NUM,nsubj-ROOT-det-attr,appos,DT-VBZ-DT-NN,CD,2,1
5,1.0,58,recorded,22,45,54,9,44,3,-23,32,This Is an Exercise,Kill Rock Stars,MISC-MISC-MISC-MISC,ORG-ORG-ORG,DET-VERB-DET-NOUN,PROPN-PROPN-PROPN,nsubj-ROOT-det-attr,compound-compound-compound,DT-VBZ-DT-NN,NNP-NNP-NNP,4,1
0,0.0,21,"""",0,2,20,18,1,0,-2,20,Insane in the Mainframe,Futurama,MISC-MISC-MISC-MISC,MISC,ADJ-ADP-DET-NOUN,PROPN,nsubj-prep-det-pobj,appos,JJ-IN-DT-NN,NNP,3,1
1,1.0,17,aired,2,6,5,-1,5,11,-4,3,Fox,the United States,ORG,LOC-LOC-LOC,PROPN,DET-PROPN-PROPN,compound,det-compound-pobj,NNP,DT-NNP-NNP,1,1
2,6.0,9,introduces,2,8,6,-2,7,2,-6,4,Roberto,Futurama,PER,MISC,PROPN,PROPN,appos,compound,NNP,NNP,2,1
0,0.0,36,is,7,16,20,4,15,15,-9,13,Fort Bend County,Texas,LOC-LOC-LOC,LOC,PROPN-PROPN-PROPN,PROPN,compound-compound-pobj,appos,NNP-NNP-NNP,NNP,2,1
1,0.0,36,is,7,16,22,6,15,13,-9,15,Fort Bend County,United States,LOC-LOC-LOC,LOC-LOC,PROPN-PROPN-PROPN,PROPN-PROPN,compound-compound-pobj,compound-appos,NNP-NNP-NNP,NNP-NNP,2,1
2,0.0,36,is,7,20,22,2,19,13,-13,15,Texas,United States,LOC,LOC-LOC,PROPN,PROPN-PROPN,appos,compound-appos,NNP,NNP-NNP,2,1
0,0.0,28,is,3,1,6,5,0,21,2,3,Karen Poole,English,PER-PER,LOC,PROPN-PROPN,ADJ,compound-nsubj,amod,NNP-NNP,JJ,3,1
1,0.0,28,is,3,1,19,18,0,8,2,16,Karen Poole,Shelly Poole,PER-PER,PER-PER,PROPN-PROPN,PROPN-PROPN,compound-nsubj,compound-appos,NNP-NNP,NNP-NNP,6,1
2,2.0,25,born,2,17,24,7,16,0,-15,22,Brian Poole,Tremeloes,PER-PER,ORG,PROPN-PROPN,PROPN,compound-appos,pobj,NNP-NNP,NNPS,5,1
0,0.0,33,Batman,0,1,19,18,0,13,-1,19,Batman : Arkham Origins Blackgate,Warner Bros. Interactive Entertainment,MISC-MISC-MISC-MISC-MISC,ORG-ORG-ORG-ORG,NOUN-PUNCT-PROPN-PROPN-PROPN,PROPN-PROPN-PROPN-PROPN,ROOT-punct-compound-compound-nsubj,compound-compound-compound-pobj,NN-:-NNP-NNP-NNP,NNP-NNP-NNP-NNP,8,1
1,4.0,38,announced,4,17,18,1,16,19,-13,14,Microsoft,Windows,ORG,MISC,PROPN,PROPN,compound,conj,NNP,NNP,1,1
0,0.0,42,"""",0,2,30,28,1,11,-2,30,The One with the Princess Leia Fantasy,Friends,MISC-MISC-MISC-MISC-MISC-MISC-MISC,MISC,DET-NUM-ADP-DET-PROPN-PROPN-PROPN,PROPN,det-nsubj-prep-det-compound-compound-pobj,pobj,DT-CD-IN-DT-NNP-NNP-NNP,NNP,10,1
1,0.0,42,"""",0,30,36,6,29,5,-30,36,Friends,NBC,MISC,ORG,PROPN,PROPN,pobj,pobj,NNP,NNP,3,1
2,1.0,19,has,2,4,6,2,3,12,-2,4,Ross,David Schwimmer,PER,PER-PER,PROPN,PROPN-PROPN,nsubj,compound-appos,NNP,NNP-NNP,1,1
3,1.0,19,has,2,11,13,2,10,5,-9,11,Rachel,Jennifer Aniston,PER,PER-PER,PROPN,PROPN-PROPN,dobj,compound-appos,NNP,NNP-NNP,1,1
4,2.0,41,tries,8,21,23,2,20,17,-13,15,Joey,Matt LeBlanc,PER,PER-PER,PROPN,PROPN-PROPN,nsubj,compound-appos,NNP,NNP-NNP,2,1
5,2.0,41,tries,8,30,33,3,29,7,-22,25,Chandler,Matthew Perry,PER,PER-PER,PROPN,PROPN-PROPN,poss,compound-pobj,NNP,NNP-NNP,2,1
0,0.0,18,is,6,13,17,4,12,0,-7,11,Friesland,Netherlands,LOC,LOC,PROPN,PROPN,pobj,pobj,NNP,NNP,4,1
0,0.0,39,is,7,1,5,4,0,33,6,-2,Etheostoma,Etowah,MISC,LOC,PROPN,PROPN,compound,compound,NNP,NNP,1,1
0,1.0,16,aired,2,5,8,3,4,7,-3,6,Comedy Central,the United States,ORG-ORG,LOC-LOC-LOC,PROPN-PROPN,DET-PROPN-PROPN,compound-pobj,det-compound-pobj,NNP-NNP,DT-NNP-NNP,3,1
1,7.0,61,was,22,8,13,5,7,47,14,-9,A Charlie Brown Christmas,1965,MISC-MISC-MISC-MISC,TIME,DET-PROPN-PROPN-PROPN,NUM,det-compound-compound-pobj,pobj,DT-NNP-NNP-NNP,CD,5,1
0,1.0,26,born,2,5,7,2,4,18,-3,5,Guilin,Guangxi,LOC,LOC,PROPN,PROPN,pobj,conj,NNP,NNP,3,1
1,1.0,26,born,2,5,9,4,4,16,-3,7,Guilin,China,LOC,LOC,PROPN,PROPN,pobj,conj,NNP,NNP,4,1
2,1.0,26,born,2,7,9,2,6,16,-5,7,Guangxi,China,LOC,LOC,PROPN,PROPN,conj,conj,NNP,NNP,5,1
0,0.0,35,was,13,2,6,4,1,28,11,-7,Ninian Martin Stephen,15 June 1923,PER-PER-PER,TIME-TIME-TIME,PROPN-PROPN-PROPN,NUM-PROPN-NUM,compound-compound-nsubj,nummod-appos-nummod,NNP-NNP-NNP,CD-NNP-CD,2,1
1,0.0,35,was,13,2,10,8,1,24,11,-3,Ninian Martin Stephen,29 October 2017,PER-PER-PER,TIME-TIME-TIME,PROPN-PROPN-PROPN,NUM-PROPN-NUM,compound-compound-nsubj,nummod-npadvmod-nummod,NNP-NNP-NNP,CD-NNP-CD,2,1
2,3.0,27,lived,4,9,13,4,8,13,-5,9,France,Scotland,LOC,LOC,PROPN,PROPN,pobj,conj,NNP,NNP,4,1
3,3.0,27,lived,4,11,13,2,10,13,-7,9,Germany,Scotland,LOC,LOC,PROPN,PROPN,conj,conj,NNP,NNP,3,1
4,4.0,20,served,1,1,5,4,0,14,0,4,Stephen,Australian Army,PER,ORG-ORG,PROPN,ADJ-PROPN,nsubj,compound-pobj,NNP,JJ-NNP,2,1
5,4.0,20,served,1,1,8,7,0,11,0,7,Stephen,World War II,PER,MISC-MISC-MISC,PROPN,PROPN-PROPN-PROPN,nsubj,compound-compound-pobj,NNP,NNP-NNP-NNP,3,1
6,4.0,20,served,1,5,8,3,4,11,-4,7,Australian Army,World War II,ORG-ORG,MISC-MISC-MISC,ADJ-PROPN,PROPN-PROPN-PROPN,compound-pobj,compound-compound-pobj,JJ-NNP,NNP-NNP-NNP,5,1
7,6.0,24,appointed,2,1,6,5,0,17,1,4,Stephen,Supreme Court of Victoria,PER,ORG-ORG-ORG-ORG,PROPN,PROPN-PROPN-ADP-PROPN,nsubjpass,compound-pobj-prep-pobj,NNP,NNP-NNP-IN-NNP,3,1
0,0.0,27,was,8,1,18,17,0,8,7,10,Garnet Crow,1999,ORG-ORG,TIME,PROPN-PROPN,NUM,compound-nsubj,pobj,NNP-NNP,CD,4,0
1,0.0,27,was,8,1,23,22,0,3,7,15,Garnet Crow,Giza Studio,ORG-ORG,ORG-ORG,PROPN-PROPN,PROPN-PROPN,compound-nsubj,compound-compound,NNP-NNP,NNP-NNP,7,0
0,0.0,24,was,15,1,8,7,0,15,14,-7,Ignaz Franz Werner Maria von Olfers,30 August 1793,PER-PER-PER-PER-PER-PER,TIME-TIME-TIME,PROPN-PROPN-PROPN-PROPN-PROPN-PROPN,NUM-PROPN-NUM,compound-compound-compound-compound-compound-nsubj,nummod-appos-nummod,NNP-NNP-NNP-NNP-NNP-NNP,CD-NNP-CD,3,1
1,0.0,24,was,15,1,12,11,0,11,14,-3,Ignaz Franz Werner Maria von Olfers,23 April 1871,PER-PER-PER-PER-PER-PER,TIME-TIME-TIME,PROPN-PROPN-PROPN-PROPN-PROPN-PROPN,NUM-PROPN-NUM,compound-compound-compound-compound-compound-nsubj,nummod-npadvmod-nummod,NNP-NNP-NNP-NNP-NNP-NNP,CD-NNP-CD,3,1
2,3.0,32,made,4,31,21,-10,30,10,-27,17,Berlin,Prussia,LOC,LOC,PROPN,PROPN,appos,pobj,NNP,NNP,3,1
3,4.0,29,developed,7,4,13,9,3,15,3,6,Friedrich August Stueler,Neues Museum,PER-PER-PER,LOC-LOC,PROPN-PROPN-PROPN,PROPN-PROPN,compound-compound-pobj,compound-pobj,NNP-NNP-NNP,NNP-NNP,5,1
4,6.0,21,described,1,10,15,5,9,5,-9,14,Wilhelm Ludwig von Eschwege,Journal von Brasilien,PER-PER-PER-PER,MISC-MISC-MISC,PROPN-PROPN-PROPN-PROPN,PROPN-PROPN-PROPN,compound-compound-compound-poss,compound-compound-pobj,NNP-NNP-NNP-NNP,NNP-NNP-NNP,3,1
0,0.0,30,is,22,17,19,2,16,10,5,-3,Ottawa,Ontario,LOC,LOC,PROPN,PROPN,pobj,conj,NNP,NNP,2,1
1,0.0,30,is,22,17,21,4,16,8,5,-1,Ottawa,Canada,LOC,LOC,PROPN,PROPN,pobj,appos,NNP,NNP,3,1
2,0.0,30,is,22,19,21,2,18,8,3,-1,Ontario,Canada,LOC,LOC,PROPN,PROPN,conj,appos,NNP,NNP,3,1
3,1.0,44,known,2,27,34,7,26,9,-25,32,Ann Arbor,US,LOC-LOC,LOC,PROPN-PROPN,PROPN,compound-appos,pobj,NNP-NNP,NNP,4,1
4,1.0,44,known,2,30,34,4,29,9,-28,32,Michigan,US,LOC,LOC,PROPN,PROPN,npadvmod,pobj,NNP,NNP,4,1
0,0.0,22,is,7,15,17,2,14,4,-8,10,Dublin,Ireland,LOC,LOC,PROPN,PROPN,pobj,appos,NNP,NNP,4,1
1,1.0,23,is,2,8,19,11,7,3,-6,17,Diageo,Grand Metropolitan,ORG,ORG-ORG,PROPN,PROPN-PROPN,pobj,compound-conj,NNP,NNP-NNP,8,1
2,1.0,23,is,2,8,22,14,7,0,-6,20,Diageo,1997,ORG,TIME,PROPN,NUM,pobj,pobj,NNP,CD,2,1
3,1.0,23,is,2,19,22,3,18,0,-17,20,Grand Metropolitan,1997,ORG-ORG,TIME,PROPN-PROPN,NUM,compound-conj,pobj,NNP-NNP,CD,8,1
0,0.0,22,was,11,1,8,7,0,13,10,-3,Owen Murphy,4 October 1895,PER-PER,TIME-TIME-TIME,PROPN-PROPN,NUM-PROPN-NUM,compound-nsubj,nummod-appos-nummod,NNP-NNP,CD-NNP-CD,3,1
1,0.0,22,was,11,1,14,13,0,7,10,3,Owen Murphy,Canadian,PER-PER,LOC,PROPN-PROPN,ADJ,compound-nsubj,amod,NNP-NNP,JJ,3,1
2,1.0,44,was,21,5,5,0,4,38,16,-16,Quebec City,Quebec City Council,LOC-LOC,ORG-ORG-ORG,PROPN-PROPN,PROPN-PROPN-PROPN,compound-pobj,compound-compound-pobj,NNP-NNP,NNP-NNP-NNP,0,1
0,0.0,39,was,9,1,4,3,0,34,8,-5,Nicolaus Mameranus,6 December 1500,PER-PER,TIME-TIME-TIME,PROPN-PROPN,NUM-PROPN-NUM,compound-nsubj,nummod-appos-nummod,NNP-NNP,CD-NNP-CD,1,1
1,0.0,39,was,9,1,12,11,0,26,8,3,Nicolaus Mameranus,Luxembourgian,PER-PER,LOC,PROPN-PROPN,ADJ,compound-nsubj,amod,NNP-NNP,JJ,2,1
2,2.0,11,born,2,1,5,4,0,5,1,3,Mameranus,Mamer,PER,LOC,PROPN,PROPN,nsubjpass,pobj,NNP,NNP,2,1
3,6.0,11,died,2,5,7,2,4,3,-3,5,Augsburg,Germany,LOC,LOC,PROPN,PROPN,pobj,appos,NNP,NNP,4,1
0,0.0,27,is,2,1,19,18,0,7,1,17,Dysfunktional Family,Eddie Griffin,MISC-MISC,PER-PER,PROPN-PROPN,PROPN-PROPN,compound-nsubj,compound-dobj,NNP-NNP,NNP-NNP,7,1
1,3.0,97,is,2,1,9,8,0,87,1,7,Dysfunktional Family,Eddie Griffin,MISC-MISC,PER-PER,PROPN-PROPN,PROPN-PROPN,compound-nsubj,compound-dobj,NNP-NNP,NNP-NNP,4,1
2,0.0,27,is,2,1,25,24,0,1,1,23,Dysfunktional Family,George Gallo,MISC-MISC,PER-PER,PROPN-PROPN,PROPN-PROPN,compound-nsubj,compound-pobj,NNP-NNP,NNP-NNP,4,1
3,3.0,97,is,2,1,34,33,0,62,1,32,Dysfunktional Family,Kansas City,MISC-MISC,LOC-LOC,PROPN-PROPN,PROPN-PROPN,compound-nsubj,compound-pobj,NNP-NNP,NNP-NNP,10,1
4,3.0,97,is,2,34,37,3,33,59,-32,35,Kansas City,Missouri,LOC-LOC,LOC,PROPN-PROPN,PROPN,compound-pobj,nsubj,NNP-NNP,NNP,5,1
5,3.0,97,is,2,15,19,4,14,77,-13,17,Star Plaza Theatre,Merrillville,LOC-LOC-LOC,LOC,PROPN-PROPN-PROPN,PROPN,compound-compound-pobj,pobj,NNP-NNP-NNP,NNP,4,1
0,0.0,16,born,4,1,6,5,0,9,3,2,Chiam See Tong,12 March 1935,PER-PER-PER,TIME-TIME-TIME,PROPN-PROPN-PROPN,NUM-PROPN-NUM,compound-compound-compound,nummod-npadvmod-nummod,NNP-NNP-NNP,CD-NNP-CD,2,1
0,0.0,18,is,9,1,12,11,0,5,8,3,Benjamin Gibbard,American,PER-PER,LOC,PROPN-PROPN,ADJ,compound-nsubj,amod,NNP-NNP,JJ,2,1
1,2.0,40,released,1,32,38,6,31,1,-31,37,Uncle Tupelo,Jay Farrar,PER-PER,PER-PER,PROPN-PROPN,PROPN-PROPN,compound-pobj,compound-conj,NNP-NNP,NNP-NNP,3,1
2,2.0,40,released,1,35,38,3,34,1,-34,37,Son Volt,Jay Farrar,ORG-ORG,PER-PER,PROPN-PROPN,PROPN-PROPN,compound-poss,compound-conj,NNP-NNP,NNP-NNP,3,1
3,2.0,40,released,1,8,12,4,7,27,-7,11,Former Lives,2012,MISC-MISC,TIME,ADJ-PROPN,NUM,amod-appos,pobj,JJ-NNPS,CD,3,1
4,3.0,33,recorded,9,23,17,-6,22,15,-14,8,You Can Play These Songs with Chords,Death Cab for Cutie,MISC-MISC-MISC-MISC-MISC-MISC-MISC,ORG-ORG-ORG-ORG,PRON-VERB-VERB-DET-NOUN-ADP-PROPN,PROPN-PROPN-ADP-PROPN,dobj-aux-ROOT-det-dobj-prep-pobj,compound-appos-prep-pobj,PRP-MD-VB-DT-NNS-IN-NNPS,NNP-NNP-IN-NNP,6,1
5,5.0,42,released,6,12,16,4,11,25,-6,10,Something About Airplanes,1998,MISC-MISC-MISC,TIME,NOUN-ADP-PROPN,NUM,appos-prep-pobj,appos,NN-IN-NNPS,CD,2,1
6,5.0,42,released,6,12,20,8,11,21,-6,14,Something About Airplanes,Barsuk Records,MISC-MISC-MISC,ORG-ORG,NOUN-ADP-PROPN,PROPN-PROPN,appos-prep-pobj,compound-pobj,NN-IN-NNPS,NNP-NNPS,5,1
7,5.0,42,released,6,30,30,0,29,11,-24,24,We Have the Facts,We 're Voting Yes,MISC-MISC-MISC-MISC,MISC-MISC-MISC-MISC,PRON-VERB-DET-NOUN,PRON-VERB-VERB-INTJ,nsubj-conj-det-dobj,nsubj-aux-conj-ROOT,PRP-VBP-DT-NNS,PRP-VBP-VBG-UH,0,1
0,1.0,95,reach,21,90,94,4,89,0,-69,73,Blue Mountain Ridge,Pennsylvania,LOC-LOC-LOC,LOC,PROPN-PROPN-PROPN,PROPN,compound-compound-pobj,appos,NNP-NNP-NNP,NNP,6,1
1,1.0,95,reach,21,20,33,13,19,61,1,12,Nesquehoning Creek,Lehigh River,LOC-LOC,LOC-LOC,PROPN-PROPN,PROPN-PROPN,compound-pobj,compound-pobj,NNP-NNP,NNP-NNP,8,1
2,2.0,26,in,0,8,14,6,7,11,-8,14,Nesquehoning Creek,Lehigh River,LOC-LOC,LOC-LOC,VERB-PROPN,PROPN-PROPN,compound-pobj,compound-pobj,VBG-NNP,NNP-NNP,6,1
3,2.0,26,in,0,21,24,3,20,1,-21,24,Pennsylvania,United States,LOC,LOC-LOC,PROPN,PROPN-PROPN,pobj,compound-pobj,NNP,NNP-NNP,1,1
4,2.0,26,in,0,18,24,6,17,1,-18,24,Poconos,United States,LOC,LOC-LOC,PROPN,PROPN-PROPN,pobj,compound-pobj,NNP,NNP-NNP,5,1
0,0.0,24,am,1,1,8,7,0,15,0,7,Herrsching am Ammersee,Upper Bavaria,LOC-LOC-LOC,LOC-LOC,VERB-VERB-PROPN,PROPN-PROPN,nsubj-ROOT-attr,compound-pobj,VBG-VBP-NNP,NNP-NNP,5,1
1,0.0,24,am,1,1,11,10,0,12,0,10,Herrsching am Ammersee,Germany,LOC-LOC-LOC,LOC,VERB-VERB-PROPN,PROPN,nsubj-ROOT-attr,appos,VBG-VBP-NNP,NNP,4,1
2,0.0,24,am,1,8,11,3,7,12,-7,10,Upper Bavaria,Germany,LOC-LOC,LOC,PROPN-PROPN,PROPN,compound-pobj,appos,NNP-NNP,NNP,3,1
3,0.0,24,am,1,8,23,15,7,0,-7,22,Upper Bavaria,Munich,LOC-LOC,LOC,PROPN-PROPN,PROPN,compound-pobj,pobj,NNP-NNP,NNP,4,1
0,5.0,50,signed,10,10,40,30,9,9,0,30,Obama,U.S.,PER,LOC,PROPN,PROPN,nsubj,compound,NNP,NNP,6,1
0,0.0,29,is,3,17,24,7,16,4,-14,21,Horatio Nelson,Battle of Trafalgar,PER-PER,MISC-MISC-MISC,PROPN-PROPN,PROPN-ADP-PROPN,compound-dobj,pobj-prep-pobj,NNP-NNP,NNP-IN-NNP,4,1
1,0.0,29,is,3,17,28,11,16,0,-14,25,Horatio Nelson,1805,PER-PER,TIME,PROPN-PROPN,NUM,compound-dobj,pobj,NNP-NNP,CD,5,1
2,0.0,29,is,3,24,28,4,23,0,-21,25,Battle of Trafalgar,1805,MISC-MISC-MISC,TIME,PROPN-ADP-PROPN,NUM,pobj-prep-pobj,pobj,NNP-IN-NNP,CD,9,1
0,0.0,11,"""",0,2,9,7,1,1,-2,9,Death Disco,Public Image Ltd.,MISC-MISC,ORG-ORG-ORG,NOUN-PROPN,PROPN-PROPN-PROPN,compound-nsubj,compound-subtok-pobj,NN-NNP,NNP-NNP-NNP,5,1
1,6.0,13,"""",0,10,12,2,9,0,-10,12,Select,1990,MISC,TIME,PROPN,NUM,dobj,pobj,NNP,CD,2,1
0,0.0,32,was,19,1,10,9,0,21,18,-9,Edmund Franciszek Maurycy Chojecki,15 October 1822,PER-PER-PER-PER,TIME-TIME-TIME,PROPN-PROPN-PROPN-PROPN,NUM-PROPN-NUM,compound-compound-compound-nsubj,nummod-appos-nummod,NNP-NNP-NNP-NNP,CD-NNP-CD,4,1
1,0.0,32,was,19,1,14,13,0,17,18,-5,Edmund Franciszek Maurycy Chojecki,1 December 1899,PER-PER-PER-PER,TIME-TIME-TIME,PROPN-PROPN-PROPN-PROPN,NUM-PROPN-NUM,compound-compound-compound-nsubj,nummod-npadvmod-nummod,NNP-NNP-NNP-NNP,CD-NNP-CD,3,1
2,0.0,32,was,19,1,18,17,0,13,18,-1,Edmund Franciszek Maurycy Chojecki,Paris,PER-PER-PER-PER,LOC,PROPN-PROPN-PROPN-PROPN,PROPN,compound-compound-compound-nsubj,appos,NNP-NNP-NNP-NNP,NNP,4,1
3,2.0,32,participated,4,16,14,-2,15,17,-12,10,Adam Mickiewicz,Polish,PER-PER,LOC,PROPN-PROPN,ADJ,compound-poss,amod,NNP-NNP,JJ,2,1
4,4.0,31,wrote,1,22,28,6,21,2,-21,27,Jan Potocki,The Saragossa Manuscript,PER-PER,MISC-MISC-MISC,PROPN-PROPN,DET-PROPN-PROPN,compound-poss,det-compound-appos,NNP-NNP,DT-NNP-NNP,3,1
0,0.0,60,is,12,24,26,2,23,33,-12,14,Florida,United States,LOC,LOC-LOC,PROPN,PROPN-PROPN,conj,compound-appos,NNP,NNP-NNP,2,1
0,1.0,18,released,8,17,12,-5,16,5,-9,4,Collection,US,MISC,LOC,PROPN,PROPN,oprd,pobj,NNP,NNP,2,1
0,1.0,40,"""",0,13,20,7,12,19,-13,20,Serbia,1918,LOC,TIME,PROPN,NUM,nsubj,pobj,NNP,CD,6,1
1,1.0,40,"""",0,11,16,5,10,23,-11,16,Principality of Serbia,Kingdom of Serbia,LOC-LOC-LOC,LOC-LOC-LOC,PROPN-ADP-PROPN,PROPN-ADP-PROPN,pobj-prep-pobj,conj-prep-pobj,NNP-IN-NNP,NNP-IN-NNP,3,1
2,1.0,40,"""",0,16,20,4,15,19,-16,20,Kingdom of Serbia,1918,LOC-LOC-LOC,TIME,PROPN-ADP-PROPN,NUM,conj-prep-pobj,pobj,NNP-IN-NNP,CD,7,1
0,0.0,38,is,2,1,35,34,0,2,1,33,Lake Capichigamau,Quebec,LOC-LOC,LOC,PROPN-PROPN,PROPN,compound-nsubj,pobj,NNP-NNP,NNP,6,1
1,0.0,38,is,2,1,37,36,0,0,1,35,Lake Capichigamau,Canada,LOC-LOC,LOC,PROPN-PROPN,PROPN,compound-nsubj,appos,NNP-NNP,NNP,2,1
2,0.0,38,is,2,13,37,24,12,0,-11,35,Eeyou Istchee James Bay,Canada,LOC-LOC-LOC-LOC,LOC,PROPN-PROPN-PROPN-PROPN,PROPN,compound-compound-compound-pobj,appos,NNP-NNP-NNP-NNP,NNP,7,1
3,0.0,38,is,2,35,37,2,34,0,-33,35,Quebec,Canada,LOC,LOC,PROPN,PROPN,pobj,appos,NNP,NNP,6,1
0,0.0,27,is,2,1,21,20,0,5,1,19,The Newsroom,HBO,MISC-MISC,ORG,DET-PROPN,PROPN,det-nsubj,appos,DT-NNP,NNP,7,1
0,0.0,16,Epic,0,1,11,10,0,4,-1,11,Epic And Other Hits,Faith No More,MISC-MISC-MISC-MISC,ORG-ORG-ORG,PROPN-CCONJ-PROPN-PROPN,PROPN-PROPN-ADJ,ROOT-cc-compound-nsubj,compound-subtok-pobj,NNP-CC-NNP-NNPS,NNP-NNP-JJR,6,1
1,0.0,16,Epic,0,1,15,14,0,0,-1,15,Epic And Other Hits,2005,MISC-MISC-MISC-MISC,TIME,PROPN-CCONJ-PROPN-PROPN,NUM,ROOT-cc-compound-nsubj,pobj,NNP-CC-NNP-NNPS,CD,3,1
0,0.0,15,is,2,1,10,9,0,4,1,8,Kid Galahad,Elvis Presley,MISC-MISC,PER-PER,PROPN-PROPN,PROPN-PROPN,compound-nsubj,compound-dobj,NNP-NNP,NNP-NNP,4,1
1,7.0,37,is,2,35,32,-3,34,4,-33,30,King Creole,Presley,MISC-MISC,PER,PROPN-PROPN,PROPN,compound-appos,nmod,NNP-NNP,NNP,2,1
0,0.0,45,Execution,2,38,43,5,37,1,-36,41,Hamster Theatre,Dave Willey,ORG-ORG,PER-PER,PROPN-PROPN,PROPN-PROPN,compound-appos,compound-pobj,NNP-NNP,NNP-NNP,6,1
1,1.0,55,released,2,48,5,-43,47,49,-46,3,Progman Cometh Festival,the United States,MISC-MISC-MISC,LOC-LOC-LOC,PROPN-PROPN-PROPN,DET-PROPN-PROPN,compound-compound-pobj,det-compound-pobj,NNP-NNP-NNP,DT-NNP-NNP,9,1
0,0.0,33,is,6,1,27,26,0,5,5,21,Script for a Jester 's Tear,13 March 1983,MISC-MISC-MISC-MISC-MISC-MISC,TIME-TIME-TIME,NOUN-ADP-DET-PROPN-PART-PROPN,NUM-PROPN-NUM,nsubj-prep-det-poss-case-pobj,nummod-pobj-nummod,NN-IN-DT-NNP-POS-NNP,CD-NNP-CD,6,1
1,0.0,33,is,6,1,31,30,0,1,5,25,Script for a Jester 's Tear,EMI Records,MISC-MISC-MISC-MISC-MISC-MISC,ORG-ORG,NOUN-ADP-DET-PROPN-PART-PROPN,PROPN-PROPN,nsubj-prep-det-poss-case-pobj,compound-pobj,NN-IN-DT-NNP-POS-NNP,NNP-NNPS,6,1
0,0.0,24,was,6,1,10,9,0,13,5,4,Fashizmi,Albanian Kingdom,ORG,LOC-LOC,PROPN,PROPN-PROPN,nsubj,compound-appos,NNP,NNP-NNP,5,0
0,4.0,28,were,18,9,14,5,8,13,9,-4,In My Life,1965,MISC-MISC-MISC,TIME,ADP-DET-NOUN,NUM,prep-poss-pobj,appos,IN-PRP$-NN,CD,5,1
1,5.0,37,exemplified,33,30,27,-3,29,9,3,-6,Walk Away Renée,1966,MISC-MISC-MISC,TIME,VERB-ADV-PROPN,NUM,conj-compound-dobj,nummod,VB-RB-NNP,CD,3,1
2,5.0,37,exemplified,33,30,13,-17,29,23,3,-20,Walk Away Renée,the Left Banke,MISC-MISC-MISC,ORG-ORG-ORG,VERB-ADV-PROPN,DET-PROPN-PROPN,conj-compound-dobj,det-compound-pobj,VB-RB-NNP,DT-NNP-NNP,4,1
0,2.0,23,authorized,8,1,5,4,0,17,7,-3,New York City,Fiorello H. La Guardia,LOC-LOC-LOC,PER-PER-PER-PER,PROPN-PROPN-PROPN,PROPN-PROPN-PROPN-PROPN,compound-compound-compound,compound-compound-compound-nsubj,NNP-NNP-NNP,NNP-NNP-NNP-NNP,4,1
0,0.0,31,Porter,2,1,5,4,0,25,1,3,James Madison Porter,"January 6 , 1793",PER-PER-PER,TIME-TIME-TIME-TIME,PROPN-PROPN-PROPN,PROPN-NUM-PUNCT-NUM,compound-compound-ROOT,appos-nummod-punct-nummod,NNP-NNP-NNP,"NNP-CD-,-CD",3,1
1,0.0,31,Porter,2,1,10,9,0,20,1,8,James Madison Porter,"November 11 , 1862",PER-PER-PER,TIME-TIME-TIME-TIME,PROPN-PROPN-PROPN,PROPN-NUM-PUNCT-NUM,compound-compound-ROOT,nsubj-nummod-punct-nummod,NNP-NNP-NNP,"NNP-CD-,-CD",3,1
2,0.0,31,Porter,2,1,19,18,0,11,1,17,James Madison Porter,United States,PER-PER-PER,LOC-LOC,PROPN-PROPN-PROPN,PROPN-PROPN,compound-compound-ROOT,compound-compound,NNP-NNP-NNP,NNP-NNP,5,1
3,2.0,20,admitted,2,16,19,3,15,0,-14,17,Northampton County,Pennsylvania,LOC-LOC,LOC,PROPN-PROPN,PROPN,compound-pobj,appos,NNP-NNP,NNP,6,1
0,0.0,83,rejected,75,21,50,29,20,32,54,-25,Sugar Baby Love,Polydor Records,MISC-MISC-MISC,ORG-ORG,PROPN-PROPN-PROPN,PROPN-PROPN,compound-compound-pobj,compound-pobj,NNP-NNP-NNP,NNP-NNPS,10,1
0,2.0,22,was,4,12,16,4,11,5,-8,12,1988 Summer Olympics,Seoul,MISC-MISC-MISC,LOC,NUM-PROPN-PROPN,PROPN,nummod-compound-pobj,pobj,CD-NNP-NNPS,NNP,3,1
0,0.0,24,was,17,1,4,3,0,19,16,-13,François Missoffe,13 October 1919,PER-PER,TIME-TIME-TIME,PROPN-PROPN,NUM-PROPN-NUM,compound-nsubj,nummod-appos-nummod,NNP-NNP,CD-NNP-CD,1,1
1,0.0,24,was,17,1,8,7,0,15,16,-9,François Missoffe,Toulon,PER-PER,LOC,PROPN-PROPN,PROPN,compound-nsubj,pobj,NNP-NNP,NNP,3,1
2,0.0,24,was,17,1,12,11,0,11,16,-5,François Missoffe,28 August 2003,PER-PER,TIME-TIME-TIME,PROPN-PROPN,NUM-PROPN-NUM,compound-nsubj,nummod-appos-nummod,NNP-NNP,CD-NNP-CD,1,1
3,0.0,24,was,17,1,16,15,0,7,16,-1,François Missoffe,Rouen,PER-PER,LOC,PROPN-PROPN,PROPN,compound-nsubj,pobj,NNP-NNP,NNP,1,1
4,0.0,24,was,17,8,10,2,7,13,9,-7,Toulon,France,LOC,LOC,PROPN,PROPN,pobj,compound,NNP,NNP,4,1
0,0.0,27,Neto,2,1,7,6,0,19,1,5,Mário Cravo Neto,"April 20 , 1947",PER-PER-PER,TIME-TIME-TIME-TIME,PROPN-PROPN-PROPN,PROPN-NUM-PUNCT-NUM,compound-compound-ROOT,npadvmod-nummod-punct-npadvmod,NNP-NNP-NNP,"NNP-CD-,-CD",4,1
1,0.0,27,Neto,2,1,14,13,0,12,1,12,Mário Cravo Neto,"August 9 , 2009",PER-PER-PER,TIME-TIME-TIME-TIME,PROPN-PROPN-PROPN,PROPN-NUM-PUNCT-NUM,compound-compound-ROOT,npadvmod-nummod-punct-nummod,NNP-NNP-NNP,"NNP-CD-,-CD",4,1
2,1.0,22,considered,12,1,1,0,0,20,11,-11,Mário Cravo,Mário Cravo Júnior,PER-PER,PER-PER-PER,PROPN-PROPN,PROPN-PROPN-PROPN,compound-nsubjpass,compound-compound-appos,NNP-NNP,NNP-NNP-NNP,0,1
0,0.0,41,John,1,33,39,6,32,1,-32,38,George V,Queen Mary,PER-PER,PER-PER,PROPN-PROPN,PROPN-PROPN,compound-pobj,compound-appos,NNP-NNP,NNP-NNP,2,1
1,1.0,31,was,10,25,29,4,24,1,-15,19,United Kingdom,Edward VII,LOC-LOC,PER-PER,PROPN-PROPN,PROPN-PROPN,compound-pobj,compound-appos,NNP-NNP,NNP-NNP,3,1
2,2.0,22,succeeded,4,10,2,-8,9,19,-6,-2,Edward,1910,PER,TIME,PROPN,NUM,poss,pobj,NNP,CD,5,1
3,6.0,23,died,2,1,7,6,0,15,1,5,Prince John,1919,PER-PER,TIME,PROPN-PROPN,NUM,compound-nsubj,pobj,NNP-NNP,CD,2,1
0,0.0,27,was,15,1,9,8,0,17,14,-6,David Francis Barrow,"November 14 , 1888",PER-PER-PER,TIME-TIME-TIME-TIME,PROPN-PROPN-PROPN,PROPN-NUM-PUNCT-NUM,compound-compound-nsubj,npadvmod-nummod-punct-nummod,NNP-NNP-NNP,"NNP-CD-,-CD",4,1
0,0.0,42,is,2,1,5,4,0,36,1,3,Jasun Martz,American,PER-PER,LOC,PROPN-PROPN,ADJ,compound-nsubj,amod,NNP-NNP,JJ,3,1
1,1.0,32,recorded,2,25,31,6,24,0,-23,29,We Built this City,Starship,MISC-MISC-MISC-MISC,ORG,PRON-VERB-DET-PROPN,PROPN,nsubj-ccomp-det-dobj,pobj,PRP-VBD-DT-NNP,NNP,1,1
0,0.0,27,was,15,1,18,17,0,8,14,3,Aigars Kriķis,Latvian,PER-PER,LOC,PROPN-PROPN,ADJ,compound-nsubj,amod,NNP-NNP,JJ,3,1
1,1.0,29,won,1,26,28,2,25,0,-25,27,Imst,Austria,LOC,LOC,PROPN,PROPN,pobj,appos,NNP,NNP,8,1
2,2.0,24,won,2,21,23,2,20,0,-19,21,Hammarstrand,Sweden,LOC,LOC,PROPN,PROPN,pobj,appos,NNP,NNP,6,1
3,3.0,18,finished,2,1,13,12,0,4,1,11,Kriķis,1976 Winter Olympics,PER,MISC-MISC-MISC,PROPN,NUM-PROPN-PROPN,nsubj,nummod-compound-pobj,NNP,CD-NNPS-NNPS,4,1
4,3.0,18,finished,2,13,17,4,12,0,-11,15,1976 Winter Olympics,Innsbruck,MISC-MISC-MISC,LOC,NUM-PROPN-PROPN,PROPN,nummod-compound-pobj,pobj,CD-NNPS-NNPS,NNP,4,1
0,0.0,36,"""",0,2,21,19,1,14,-2,21,On the Knocking at the Gate in Macbeth,Thomas De Quincey,MISC-MISC-MISC-MISC-MISC-MISC-MISC-MISC,PER-PER-PER,ADP-DET-PROPN-ADP-DET-PROPN-ADP-PROPN,PROPN-PROPN-PROPN,prep-det-pobj-prep-det-pobj-prep-pobj,compound-compound-appos,IN-DT-NNP-IN-DT-NNP-IN-NNP,NNP-NNP-NNP,10,1
1,0.0,36,"""",0,2,29,27,1,6,-2,29,On the Knocking at the Gate in Macbeth,October 1823,MISC-MISC-MISC-MISC-MISC-MISC-MISC-MISC,TIME-TIME,ADP-DET-PROPN-ADP-DET-PROPN-ADP-PROPN,PROPN-NUM,prep-det-pobj-prep-det-pobj-prep-pobj,nmod-nummod,IN-DT-NNP-IN-DT-NNP-IN-NNP,NNP-CD,8,1
2,3.0,40,scene,6,25,1,-24,24,38,-19,-5,Lady Macbeth,The Tragedy of Macbeth,PER-PER,MISC-MISC-MISC-MISC,PROPN-PROPN,DET-PROPN-ADP-PROPN,compound-conj,det-pobj-prep-pobj,NNP-NNP,DT-NNP-IN-NNP,6,1
3,3.0,40,scene,6,30,1,-29,29,38,-24,-5,Macduff,The Tragedy of Macbeth,PER,MISC-MISC-MISC-MISC,PROPN,DET-PROPN-ADP-PROPN,pobj,det-pobj-prep-pobj,NNP,DT-NNP-IN-NNP,6,1
4,3.0,40,scene,6,1,21,20,0,18,5,15,The Tragedy of Macbeth,Duncan,MISC-MISC-MISC-MISC,PER,DET-PROPN-ADP-PROPN,PROPN,det-pobj-prep-pobj,pobj,DT-NNP-IN-NNP,NNP,5,1
5,8.0,30,views,3,20,1,-19,19,28,-17,-2,On Murder Considered as one of the Fine Arts,De Quincey,MISC-MISC-MISC-MISC-MISC-MISC-MISC-MISC-MISC,PER-PER,ADP-NOUN-VERB-ADP-NUM-ADP-DET-PROPN-PROPN,PROPN-PROPN,prep-compound-pobj-prep-pobj-prep-det-compound-pobj,compound-nsubj,IN-NN-VBN-IN-CD-IN-DT-NNP-NNPS,NNP-NNP,4,1
0,0.0,20,is,8,5,18,13,4,1,3,10,Springfield,United States,LOC,LOC-LOC,PROPN,PROPN-PROPN,pobj,compound-conj,NNP,NNP-NNP,8,1
1,0.0,20,is,8,4,18,14,3,1,4,10,Illinois,United States,LOC,LOC-LOC,PROPN,PROPN-PROPN,conj,compound-conj,NNP,NNP-NNP,6,1
2,1.0,31,established,3,8,6,-2,7,24,-5,3,Sangamon State University,1969,ORG-ORG-ORG,TIME,PROPN-PROPN-PROPN,NUM,compound-compound-pobj,pobj,NNP-NNP-NNP,CD,2,1
0,0.0,22,was,10,2,5,3,1,16,8,-5,Shimon Sofer,1820,PER-PER,TIME,PROPN-PROPN,NUM,compound-nsubj,nummod,NNP-NNP,CD,2,1
1,0.0,22,was,10,2,7,5,1,14,8,-3,Shimon Sofer,1883,PER-PER,TIME,PROPN-PROPN,NUM,compound-nsubj,npadvmod,NNP-NNP,CD,1,1
2,1.0,16,was,1,6,8,2,5,7,-5,7,Kraków,Poland,LOC,LOC,PROPN,PROPN,pobj,appos,NNP,NNP,3,1
3,3.0,29,was,11,23,27,4,22,1,-12,16,Austria - Hungary,Franz Joseph I.,LOC-LOC-LOC,PER-PER-PER,PROPN-PUNCT-PROPN,PROPN-PROPN-PROPN,compound-punct-compound,compound-compound-appos,NNP-HYPH-NNP,NNP-NNP-NNP,11,1
0,0.0,33,was,10,1,4,3,0,28,9,-6,Milutin Nedić,26 October 1882,PER-PER,TIME-TIME-TIME,PROPN-PROPN,NUM-PROPN-NUM,compound-nsubj,nummod-npadvmod-nummod,NNP-NNP,CD-NNP-CD,2,1
1,0.0,33,was,10,1,9,8,0,23,9,-1,Milutin Nedić,1945,PER-PER,TIME,PROPN-PROPN,NUM,compound-nsubj,nummod,NNP-NNP,CD,3,1
2,0.0,33,was,10,1,22,21,0,10,9,12,Milutin Nedić,Royal Yugoslav Army,PER-PER,ORG-ORG-ORG,PROPN-PROPN,PROPN-PROPN-PROPN,compound-nsubj,compound-compound-pobj,NNP-NNP,NNP-NNP-NNP,8,1
3,1.0,31,replaced,2,28,20,-8,27,10,-26,18,World War II,Axis,MISC-MISC-MISC,ORG,PROPN-PROPN-PROPN,PROPN,compound-compound-pobj,compound,NNP-NNP-NNP,NNP,5,1
0,0.0,16,is,1,7,14,7,6,1,-6,13,uThungulu,South Africa,LOC,LOC-LOC,PROPN,PROPN-PROPN,compound,compound-npadvmod,NNP,NNP-NNP,3,1
1,1.0,30,is,1,23,26,3,22,3,-22,25,South Africa,Jacob Zuma,LOC-LOC,PER-PER,PROPN-PROPN,PROPN-PROPN,compound-pobj,compound-nsubjpass,NNP-NNP,NNP-NNP,7,1
0,4.0,19,known,2,1,13,12,0,5,1,11,Cassandra,Priam,PER,PER,PROPN,PROPN,nsubjpass,pobj,NNP,NNP,6,1
1,4.0,19,known,2,13,18,5,12,0,-11,16,Priam,Troy,PER,LOC,PROPN,PROPN,pobj,pobj,NNP,NNP,6,1
0,0.0,25,is,6,1,5,4,0,19,5,-1,Elyn Zimmerman,1945,PER-PER,TIME,PROPN-PROPN,NUM,compound-nsubj,npadvmod,NNP-NNP,CD,1,1
1,0.0,25,is,6,1,9,8,0,15,5,3,Elyn Zimmerman,American,PER-PER,LOC,PROPN-PROPN,ADJ,compound-nsubj,amod,NNP-NNP,JJ,2,1
2,4.0,52,presented,5,9,14,5,8,37,-4,9,Museum of Contemporary Art,Chicago,LOC-LOC-LOC-LOC,LOC,PROPN-ADP-PROPN-PROPN,PROPN,pobj-prep-compound-pobj,appos,NNP-IN-NNP-NNP,NNP,4,1
3,4.0,52,presented,5,22,26,4,21,25,-17,21,Walker Art Center,Minneapolis,LOC-LOC-LOC,LOC,PROPN-PROPN-PROPN,PROPN,compound-compound-conj,appos,NNP-NNP-NNP,NNP,2,1
4,4.0,52,presented,5,28,28,0,27,23,-23,23,Berkeley Art Museum,Berkeley,LOC-LOC-LOC,LOC,PROPN-PROPN-PROPN,PROPN,compound-compound-conj,conj,NNP-NNP-NNP,NNP,0,1
5,4.0,52,presented,5,34,34,0,33,17,-29,29,Los Angeles County Museum of Art,Los Angeles,LOC-LOC-LOC-LOC-LOC-LOC,LOC-LOC,PROPN-PROPN-PROPN-PROPN-ADP-PROPN,PROPN-PROPN,compound-compound-compound-appos-prep-pobj,compound-conj,NNP-NNP-NNP-NNP-IN-NNP,NNP-NNP,0,1
0,0.0,25,is,1,1,8,7,0,16,0,7,Spiritchaser,Dead Can Dance,MISC,ORG-ORG-ORG,NOUN,PROPN-VERB-VERB,nsubj,compound-compound-pobj,NN,NNP-MD-VB,4,1
1,0.0,25,is,1,8,16,8,7,8,-7,15,Dead Can Dance,Brendan Perry,ORG-ORG-ORG,PER-PER,PROPN-VERB-VERB,PROPN-PROPN,compound-compound-pobj,compound-nsubj,NNP-MD-VB,NNP-NNP,6,1
2,0.0,25,is,1,8,19,11,7,5,-7,18,Dead Can Dance,Lisa Gerrard,ORG-ORG-ORG,PER-PER,PROPN-VERB-VERB,PROPN-PROPN,compound-compound-pobj,compound-conj,NNP-MD-VB,NNP-NNP,7,1
3,2.0,14,dedicated,3,6,12,6,5,1,-3,9,Lisa Gerrard,Mark Gerrard,PER-PER,PER-PER,PROPN-PROPN,PROPN-PROPN,compound-poss,compound-appos,NNP-NNP,NNP-NNP,2,1
0,0.0,21,was,14,1,5,4,0,15,13,-9,Robert Tait Ervin,"May 27 , 1863",PER-PER-PER,TIME-TIME-TIME-TIME,PROPN-PROPN-PROPN,PROPN-NUM-PUNCT-NUM,compound-compound-nsubj,appos-nummod-punct-npadvmod,NNP-NNP-NNP,"NNP-CD-,-CD",3,1
1,0.0,21,was,14,1,10,9,0,10,13,-4,Robert Tait Ervin,"October 24 , 1949",PER-PER-PER,TIME-TIME-TIME-TIME,PROPN-PROPN-PROPN,PROPN-NUM-PUNCT-NUM,compound-compound-nsubj,appos-nummod-punct-nummod,NNP-NNP-NNP,"NNP-CD-,-CD",4,1
2,0.0,21,was,14,1,17,16,0,3,13,3,Robert Tait Ervin,United States,PER-PER-PER,LOC-LOC,PROPN-PROPN-PROPN,PROPN-PROPN,compound-compound-nsubj,nmod-nmod,NNP-NNP-NNP,NNP-NNP,4,1
3,1.0,11,received,8,3,6,3,2,4,5,-2,Wilcox County,Alabama,LOC-LOC,LOC,PROPN-PROPN,PROPN,compound-pobj,appos,NNP-NNP,NNP,4,1
0,0.0,23,is,4,1,22,21,0,0,3,18,Brabrand Lake,Denmark,LOC-LOC,LOC,PROPN-PROPN,PROPN,compound-nsubj,appos,NNP-NNP,NNP,1,1
1,0.0,23,is,4,1,22,21,0,0,3,18,Brabrand,Denmark,LOC,LOC,PROPN,PROPN,pobj,appos,NNP,NNP,1,1
2,0.0,23,is,4,14,22,8,13,0,-10,18,Gellerup,Denmark,LOC,LOC,PROPN,PROPN,appos,appos,NNP,NNP,9,1
3,0.0,23,is,4,19,22,3,18,0,-15,18,Aarhus,Denmark,LOC,LOC,PROPN,PROPN,compound,appos,NNP,NNP,4,1
0,0.0,54,is,23,20,44,24,19,9,3,21,Chakavian dialect,Croatian,MISC-MISC,LOC,ADJ-NOUN,ADJ,amod-pobj,amod,JJ-NN,JJ,12,1
1,1.0,31,extends,1,6,15,9,5,15,-5,14,Hvar,Adriatic Sea,LOC,LOC-LOC,PROPN,PROPN-PROPN,conj,compound-pobj,NNP,NNP-NNP,3,1
2,1.0,31,extends,1,21,15,-6,20,15,-20,14,Brač,Adriatic Sea,LOC,LOC-LOC,PROPN,PROPN-PROPN,pobj,compound-pobj,NNP,NNP-NNP,7,1
3,3.0,15,listed,5,1,14,13,0,0,4,9,Zlatni Rat,Europe,LOC-LOC,LOC,PROPN-PROPN,PROPN,compound-nsubjpass,pobj,NNP-NNP,NNP,2,1
0,0.0,21,is,13,1,6,5,0,14,12,-7,Ram Awana,Noida,PER-PER,LOC,PROPN-PROPN,PROPN,compound-nsubj,pobj,NNP-NNP,NNP,4,1
1,0.0,21,is,13,1,8,7,0,12,12,-5,Ram Awana,India,PER-PER,LOC,PROPN-PROPN,PROPN,compound-nsubj,npadvmod,NNP-NNP,NNP,2,1
2,0.0,21,is,13,6,8,2,5,12,7,-5,Noida,India,LOC,LOC,PROPN,PROPN,pobj,npadvmod,NNP,NNP,4,1
3,2.0,19,appeared,1,12,16,4,11,2,-11,15,Baaja,Apurba Kishore Bir,MISC,PER-PER-PER,PROPN,PROPN-PROPN-PROPN,conj,compound-compound-pobj,NNP,NNP-NNP-NNP,5,1
4,5.0,18,appeared,1,9,13,4,8,4,-8,12,Best Chance,Marcus H. Rosenmüller,MISC-MISC,PER-PER-PER,PROPN-PROPN,PROPN-PROPN-PROPN,compound-appos,compound-compound-pobj,NNP-NNP,NNP-NNP-NNP,6,1
0,0.0,42,was,12,1,5,4,0,36,11,-7,Paul Rand Dixon,29 September 1913,PER-PER-PER,TIME-TIME-TIME,PROPN-PROPN-PROPN,NUM-PROPN-NUM,compound-compound-nsubj,nummod-appos-appos,NNP-NNP-NNP,CD-NNP-CD,2,1
1,0.0,42,was,12,1,9,8,0,32,11,-3,Paul Rand Dixon,2 May 1996,PER-PER-PER,TIME-TIME-TIME,PROPN-PROPN-PROPN,NUM-PROPN-NUM,compound-compound-nsubj,nummod-appos-appos,NNP-NNP-NNP,CD-NNP-CD,3,1
2,0.0,42,was,12,1,31,30,0,10,11,19,Paul Rand Dixon,United States,PER-PER-PER,LOC-LOC,PROPN-PROPN-PROPN,PROPN-PROPN,compound-compound-nsubj,compound-pobj,NNP-NNP-NNP,NNP-NNP,8,1
3,4.0,11,served,1,1,5,4,0,5,0,4,Dixon,U.S. Navy,PER,ORG-ORG,PROPN,PROPN-PROPN,nsubj,compound-pobj,NNP,NNP-NNP,2,1
0,1.0,41,form,34,12,31,19,11,9,22,-3,Las Villas,Cuba,LOC-LOC,LOC,PROPN-PROPN,PROPN,compound-compound,pobj,NNP-NNP,NNP,7,1
1,1.0,41,form,34,19,31,12,18,9,15,-3,Villa Clara,Cuba,LOC-LOC,LOC,PROPN-PROPN,PROPN,compound-pobj,pobj,NNP-NNP,NNP,5,1
2,1.0,41,form,34,22,31,9,21,9,12,-3,Sancti Spíritus,Cuba,LOC-LOC,LOC,PROPN-PROPN,PROPN,compound-conj,pobj,NNP-NNP,NNP,6,1
3,1.0,41,form,34,25,31,6,24,9,9,-3,Ciego de Ávila,Cuba,LOC-LOC-LOC,LOC,PROPN-PROPN-PROPN,PROPN,compound-compound-compound,pobj,NNP-NNP-NNP,NNP,9,1
4,3.0,48,celebrated,4,13,47,34,12,0,-9,43,Vueltas,Cuba,LOC,LOC,PROPN,PROPN,pobj,pobj,NNP,NNP,7,1
5,3.0,48,celebrated,4,15,47,32,14,0,-11,43,Zulueta,Cuba,LOC,LOC,PROPN,PROPN,conj,pobj,NNP,NNP,8,1
6,3.0,48,celebrated,4,17,47,30,16,0,-13,43,Chambas,Cuba,LOC,LOC,PROPN,PROPN,conj,pobj,NNP,NNP,9,1
7,3.0,48,celebrated,4,19,47,28,18,0,-15,43,Guayos,Cuba,LOC,LOC,PROPN,PROPN,conj,pobj,NNP,NNP,10,1
8,3.0,48,celebrated,4,21,47,26,20,0,-17,43,El Santo,Cuba,LOC-LOC,LOC,PROPN-PROPN,PROPN,compound-conj,pobj,NNP-NNP,NNP,10,1
9,3.0,48,celebrated,4,24,47,23,23,0,-20,43,Taguayabón,Cuba,LOC,LOC,PROPN,PROPN,conj,pobj,NNP,NNP,11,1
10,3.0,48,celebrated,4,26,47,21,25,0,-22,43,Buenavista,Cuba,LOC,LOC,PROPN,PROPN,conj,pobj,NNP,NNP,12,1
11,3.0,48,celebrated,4,28,47,19,27,0,-24,43,Calabazar de Sagua,Cuba,LOC-LOC-LOC,LOC,PROPN-X-PROPN,PROPN,compound-compound-conj,pobj,NNP-FW-NNP,NNP,13,1
12,3.0,48,celebrated,4,32,47,15,31,0,-28,43,Zaza del Medio,Cuba,LOC-LOC-LOC,LOC,PROPN-PROPN-PROPN,PROPN,compound-compound-conj,pobj,NNP-NNP-NNP,NNP,14,1
13,3.0,48,celebrated,4,36,47,11,35,0,-32,43,Falcón,Cuba,LOC,LOC,PROPN,PROPN,conj,pobj,NNP,NNP,15,1
0,2.0,37,created,3,32,34,2,31,2,-29,31,Pawl,Gwynllyw,PER,PER,PROPN,PROPN,appos,conj,NNP,NNP,3,1
1,4.0,30,was,4,1,4,3,0,25,3,0,Pawl,Gwynllyw,PER,PER,PROPN,PROPN,poss,appos,NNP,NNP,3,1
2,2.0,37,created,3,32,36,4,31,0,-29,33,Pawl,Mechwyn,PER,PER,PROPN,PROPN,appos,conj,NNP,NNP,12,1
3,2.0,37,created,3,32,9,-23,31,27,-29,6,Pawl,Glywys,PER,PER,PROPN,PROPN,appos,pobj,NNP,NNP,16,1
4,2.0,37,created,3,34,36,2,33,0,-31,33,Gwynllyw,Mechwyn,PER,PER,PROPN,PROPN,conj,conj,NNP,NNP,13,1
5,2.0,37,created,3,34,9,-25,33,27,-31,6,Gwynllyw,Glywys,PER,PER,PROPN,PROPN,conj,pobj,NNP,NNP,17,1
0,9.0,22,passed,2,19,11,-8,18,10,-17,9,Pascual Ortiz Rubio,PNR,PER-PER-PER,ORG,PROPN-PROPN-PROPN,PROPN,compound-compound-npadvmod,pobj,NNP-NNP-NNP,NNP,5,1
0,0.0,27,Timasheff,2,1,7,6,0,19,1,5,Nicholas Sergeyevitch Timasheff,"November 9 , 1886",PER-PER-PER,TIME-TIME-TIME-TIME,PROPN-PROPN-PROPN,PROPN-NUM-PUNCT-NUM,compound-compound-ROOT,nmod-nummod-punct-nummod,NNP-NNP-NNP,"NNP-CD-,-CD",3,1
1,0.0,27,Timasheff,2,1,12,11,0,14,1,10,Nicholas Sergeyevitch Timasheff,"March 9 , 1970",PER-PER-PER,TIME-TIME-TIME-TIME,PROPN-PROPN-PROPN,PROPN-NUM-PUNCT-NUM,compound-compound-ROOT,nsubj-nummod-punct-nummod,NNP-NNP-NNP,"NNP-CD-,-CD",4,1
2,9.0,15,Buried,0,8,6,-2,7,8,-8,6,New York,Yonkers,LOC-LOC,LOC,PROPN-PROPN,PROPN,compound-npadvmod,appos,NNP-NNP,NNP,2,1
0,9.0,19,strays,2,6,8,2,5,10,-4,6,Arizona,the United States,LOC,LOC-LOC-LOC,PROPN,DET-PROPN-PROPN,dobj,det-compound-pobj,NNP,DT-NNP-NNP,2,1
0,0.0,43,carries,4,18,42,24,17,0,-14,38,US 30,Pennsylvania,LOC-LOC,LOC,PROPN-NUM,PROPN,appos-nummod,pobj,NNP-CD,NNP,4,1
1,5.0,61,see,11,36,34,-2,35,26,-25,23,Golden Triangle,Pittsburgh,LOC-LOC,LOC,PROPN-PROPN,PROPN,compound-pobj,poss,NNP-NNP,NNP,2,1
2,6.0,39,was,2,29,1,-28,28,37,-27,-1,Stephen Chbosky,The Perks of Being a Wallflower,PER-PER,MISC-MISC-MISC-MISC-MISC-MISC,PROPN-PROPN,DET-PROPN-ADP-VERB-DET-NOUN,compound-poss,det-appos-prep-pcomp-det-attr,NNP-NNP,DT-NNPS-IN-VBG-DT-NN,5,1
3,8.0,23,is,1,20,10,-10,19,12,-19,9,Squirrel Hill Tunnel,City of Pittsburgh,LOC-LOC-LOC,LOC-LOC-LOC,PROPN-PROPN-PROPN,PROPN-ADP-PROPN,compound-compound-conj,pobj-prep-pobj,NNP-NNP-NNP,NNP-IN-NNP,8,1
0,0.0,14,is,1,7,12,5,6,1,-6,11,Brooks County,United States,LOC-LOC,LOC-LOC,PROPN-PROPN,PROPN-PROPN,compound-pobj,compound-appos,NNP-NNP,NNP-NNP,2,1
1,0.0,14,is,1,10,12,2,9,1,-9,11,Georgia,United States,LOC,LOC-LOC,PROPN,PROPN-PROPN,appos,compound-appos,NNP,NNP-NNP,2,1
2,1.0,43,known,3,34,42,8,33,0,-31,39,Brooks County,1858,LOC-LOC,TIME,PROPN-PROPN,NUM,compound-pobj,pobj,NNP-NNP,CD,10,1
3,4.0,22,granted,6,4,14,10,3,7,2,8,Grooverville Historic Township,State of Georgia,MISC-MISC-MISC,LOC-LOC-LOC,PROPN-PROPN-PROPN,PROPN-ADP-PROPN,compound-compound-pobj,pobj-prep-pobj,NNP-NNP-NNP,NNP-IN-NNP,6,1
0,0.0,23,Hagan,2,1,5,4,0,17,1,3,Robert Emmet Hagan,"March 22 , 1921",PER-PER-PER,TIME-TIME-TIME-TIME,PROPN-PROPN-PROPN,PROPN-NUM-PUNCT-NUM,compound-compound-ROOT,appos-nummod-punct-nummod,NNP-NNP-NNP,"NNP-CD-,-CD",3,1
1,0.0,23,Hagan,2,1,17,16,0,5,1,15,Robert Emmet Hagan,American,PER-PER-PER,LOC,PROPN-PROPN-PROPN,ADJ,compound-compound-ROOT,amod,NNP-NNP-NNP,JJ,3,1
2,0.0,23,Hagan,2,1,21,20,0,1,1,19,Robert Emmet Hagan,Democratic Party,PER-PER-PER,ORG-ORG,PROPN-PROPN-PROPN,PROPN-PROPN,compound-compound-ROOT,compound-pobj,NNP-NNP-NNP,NNP-NNP,5,1
0,5.0,19,was,4,14,16,2,13,2,-10,12,Moscow,Russian Federation,LOC,LOC-LOC,PROPN,PROPN-PROPN,pobj,compound-appos,NNP,NNP-NNP,1,1
0,0.0,27,was,13,1,7,6,0,19,12,-6,Moshe Hirsch,1923,PER-PER,TIME,PROPN-PROPN,NUM,compound-nsubj,npadvmod,NNP-NNP,CD,3,1
1,0.0,27,was,13,19,26,7,18,0,-6,13,anti - Zionist Neturei Karta group,Jerusalem,ORG-ORG-ORG-ORG-ORG-ORG,LOC,ADJ-ADJ-ADJ-PROPN-PROPN-NOUN,PROPN,subtok-subtok-amod-compound-compound-pobj,pobj,JJ-JJ-JJ-NNP-NNP-NN,NNP,2,1
2,1.0,13,advised,1,3,6,3,2,6,-2,5,Yasser Arafat,Jewish,PER-PER,ORG,PROPN-PROPN,ADJ,compound-dobj,amod,NNP-NNP,JJ,3,1
3,2.0,39,included,7,27,10,-17,26,28,-20,3,Mahmoud Abbas,Fatah,PER-PER,ORG,PROPN-PROPN,PROPN,compound-pobj,compound,NNP-NNP,NNP,5,1
0,0.0,24,is,7,16,22,6,15,1,-9,15,NBCUniversal,NBC News,ORG,ORG-ORG,PROPN,PROPN-PROPN,pobj,compound-pobj,NNP,NNP-NNP,3,1
1,2.0,36,founded,3,14,35,21,13,0,-11,32,NBCUniversal,MSNBC,ORG,ORG,PROPN,PROPN,pobj,pobj,NNP,NNP,6,1
2,3.0,43,maintained,10,28,33,5,27,9,-18,23,Microsoft,Washington,ORG,LOC,PROPN,PROPN,compound,conj,NNP,NNP,4,1
0,0.0,21,is,7,2,20,18,1,0,5,13,Yorkton,Saskatchewan,LOC,LOC,PROPN,PROPN,pobj,appos,NNP,NNP,3,1
1,1.0,20,festival,4,1,18,17,0,1,3,14,Canada,North America,LOC,LOC-LOC,PROPN,PROPN-PROPN,poss,compound-pobj,NNP,NNP-NNP,7,1
0,4.0,20,elected,2,4,15,11,3,4,-2,13,Bertha Knight Landes,U.S.,PER-PER-PER,LOC,PROPN-PROPN-PROPN,PROPN,compound-compound-dobj,compound,NNP-NNP-NNP,NNP,4,1
0,0.0,24,was,15,1,4,3,0,19,14,-11,Noël Hallé,2 September 1711,PER-PER,TIME-TIME-TIME,PROPN-PROPN,NUM-PROPN-NUM,compound-nsubj,nummod-appos-nummod,NNP-NNP,CD-NNP-CD,1,1
1,0.0,24,was,15,1,10,9,0,13,14,-5,Noël Hallé,5 June 1781,PER-PER,TIME-TIME-TIME,PROPN-PROPN,NUM-PROPN-NUM,compound-nsubj,nummod-appos-nummod,NNP-NNP,CD-NNP-CD,2,1
2,0.0,24,was,15,1,18,17,0,5,14,3,Noël Hallé,French,PER-PER,LOC,PROPN-PROPN,ADJ,compound-nsubj,amod,NNP-NNP,JJ,2,1
3,2.0,9,took,1,1,4,3,0,4,0,3,Hallé,Prix de Rome,PER,MISC-MISC-MISC,PROPN,PROPN-PROPN-PROPN,nsubj,compound-compound-dobj,NNP,NNP-NNP-NNP,2,1
0,1.0,32,written,2,28,30,2,27,1,-26,28,8701,2001,MISC,TIME,NUM,NUM,appos,npadvmod,CD,CD,6,1
1,3.0,32,served,2,18,7,-11,17,24,-16,5,Pop Ya Collar,American,MISC-MISC-MISC,LOC,PROPN-PROPN-PROPN,ADJ,compound-compound-pobj,amod,NNP-NNP-NNP,JJ,7,1
0,0.0,16,is,4,1,13,12,0,2,3,9,The Tewantin National Park,Queensland,LOC-LOC-LOC-LOC,LOC,DET-PROPN-PROPN-PROPN,PROPN,det-compound-compound-nsubj,pobj,DT-NNP-NNP-NNP,NNP,6,1
1,0.0,16,is,4,1,15,14,0,0,3,11,The Tewantin National Park,Australia,LOC-LOC-LOC-LOC,LOC,DET-PROPN-PROPN-PROPN,PROPN,det-compound-compound-nsubj,appos,DT-NNP-NNP-NNP,NNP,3,1
2,0.0,16,is,4,13,15,2,12,0,-9,11,Queensland,Australia,LOC,LOC,PROPN,PROPN,pobj,appos,NNP,NNP,5,1
0,2.0,26,characterized,8,6,3,-3,5,22,2,-5,Surrealist,Dada,MISC,MISC,ADJ,PROPN,compound,compound,JJ,NNP,4,1
1,3.0,44,Soupault,1,1,10,9,0,33,0,9,Philippe Soupault,Les Champs Magnétiques,PER-PER,MISC-MISC-MISC,PROPN-PROPN,PROPN-PROPN-PROPN,compound-ROOT,compound-compound-nsubjpass,NNP-NNP,NNP-NNP-NNPS,2,1
2,3.0,44,Soupault,1,4,10,6,3,33,-3,9,André Breton,Les Champs Magnétiques,PER-PER,MISC-MISC-MISC,PROPN-PROPN,PROPN-PROPN-PROPN,compound-poss,compound-compound-nsubjpass,NNP-NNP,NNP-NNP-NNPS,3,1
3,3.0,44,Soupault,1,10,5,-5,9,38,-9,4,Les Champs Magnétiques,Breton,MISC-MISC-MISC,PER,PROPN-PROPN-PROPN,PROPN,compound-compound-nsubjpass,nsubj,NNP-NNP-NNPS,NNP,4,1
4,4.0,24,was,4,1,12,11,0,11,3,8,The Seashell and the Clergyman,1928,MISC-MISC-MISC-MISC-MISC,TIME,DET-PROPN-CCONJ-DET-PROPN,NUM,det-attr-cc-det-conj,pobj,DT-NNP-CC-DT-NNP,CD,3,1
5,4.0,24,was,4,1,16,15,0,7,3,12,The Seashell and the Clergyman,Germaine Dulac,MISC-MISC-MISC-MISC-MISC,PER-PER,DET-PROPN-CCONJ-DET-PROPN,PROPN-PROPN,det-attr-cc-det-conj,compound-pobj,DT-NNP-CC-DT-NNP,NNP-NNP,5,1
6,4.0,24,was,4,1,22,21,0,1,3,18,The Seashell and the Clergyman,Antonin Artaud,MISC-MISC-MISC-MISC-MISC,PER-PER,DET-PROPN-CCONJ-DET-PROPN,PROPN-PROPN,det-attr-cc-det-conj,compound-pobj,DT-NNP-CC-DT-NNP,NNP-NNP,7,1
0,6.0,16,is,2,8,1,-7,7,14,-6,-1,Raphael,The School of Athens,PER,MISC-MISC-MISC-MISC,PROPN,DET-PROPN-ADP-PROPN,compound,det-appos-prep-pobj,NNP,DT-NNP-IN-NNP,4,1
0,0.0,16,is,2,2,13,11,1,2,0,11,Am,Becoming the Archetype,MISC,ORG-ORG-ORG,VERB,VERB-DET-PROPN,nsubj,ROOT-det-dobj,VBP,VBG-DT-NNP,6,1
0,4.0,19,established,6,2,9,7,1,9,4,3,Mexican Federation of Football,23 August 1927,ORG-ORG-ORG-ORG,TIME-TIME-TIME,PROPN-PROPN-ADP-PROPN,NUM-PROPN-NUM,compound-nsubjpass-prep-pobj,nummod-pobj-nummod,NNP-NNP-IN-NNP,CD-NNP-CD,3,1
0,0.0,46,is,6,5,33,28,4,12,1,27,UNIX,Bell Labs,MISC,ORG-ORG,PROPN,PROPN-PROPN,pobj,compound-compound,NNP,NNP-NNPS,6,1
1,0.0,46,is,6,5,38,33,4,7,1,32,UNIX,Ken Thompson,MISC,PER-PER,PROPN,PROPN-PROPN,pobj,compound-pobj,NNP,NNP-NNP,7,1
2,0.0,46,is,6,5,41,36,4,4,1,35,UNIX,Dennis Ritchie,MISC,PER-PER,PROPN,PROPN-PROPN,pobj,compound-conj,NNP,NNP-NNP,8,1
3,4.0,17,is,12,14,16,2,13,0,-2,4,Apple,macOS,ORG,MISC,PROPN,NOUN,poss,attr,NNP,NN,4,1
0,0.0,28,was,10,1,9,8,0,18,9,-1,Sachen Kunga Nyingpo,1158,PER-PER-PER,TIME,PROPN-PROPN-PROPN,NUM,compound-compound-nsubj,nummod,NNP-NNP-NNP,CD,3,1
1,0.0,28,was,10,1,13,12,0,14,9,3,Sachen Kunga Nyingpo,Tibetan,PER-PER-PER,LOC,PROPN-PROPN-PROPN,ADJ,compound-compound-nsubj,amod,NNP-NNP-NNP,JJ,4,1
2,1.0,37,was,3,12,16,4,11,20,-9,13,Khon Konchok Gyalpo,1034,PER-PER-PER,TIME,PROPN-PROPN-PROPN,NUM,compound-compound-pobj,nummod,NNP-NNP-NNP,CD,2,1
3,14.0,16,passed,1,1,11,10,0,4,0,10,Sachen,Sonam Tsemo,PER,PER-PER,PROPN,PROPN-PROPN,nsubj,compound-appos,NNP,NNP-NNP,3,1
4,14.0,16,passed,1,1,14,13,0,1,0,13,Sachen,Drakpa Gyaltsen,PER,PER-PER,PROPN,PROPN-PROPN,nsubj,compound-conj,NNP,NNP-NNP,4,1
5,14.0,16,passed,1,11,14,3,10,1,-10,13,Sonam Tsemo,Drakpa Gyaltsen,PER-PER,PER-PER,PROPN-PROPN,PROPN-PROPN,compound-appos,compound-conj,NNP-NNP,NNP-NNP,1,1
0,0.0,48,was,14,42,47,5,41,0,-28,33,Pierre Klossowski,Balthus,PER-PER,PER,PROPN-PROPN,PROPN,compound-conj,conj,NNP-NNP,NNP,7,1
0,0.0,24,is,9,1,6,5,0,17,8,-3,Christine Kenneally,Melbourne,PER-PER,LOC,PROPN-PROPN,PROPN,compound-nsubj,pobj,NNP-NNP,NNP,4,1
1,0.0,24,is,9,6,8,2,5,15,3,-1,Melbourne,Australia,LOC,LOC,PROPN,PROPN,pobj,appos,NNP,NNP,4,1
2,0.0,24,is,9,6,12,6,5,11,3,3,Melbourne,Australian,LOC,LOC,PROPN,ADJ,pobj,amod,NNP,JJ,8,1
3,3.0,26,was,10,6,9,3,5,16,4,-1,First Word,2007,MISC-MISC,TIME,PROPN-PROPN,NUM,compound-appos,appos,NNP-NNP,CD,1,1
0,0.0,37,reigned,18,16,2,-14,15,34,2,-16,Chicago,the United States,LOC,LOC-LOC-LOC,PROPN,DET-PROPN-PROPN,npadvmod,det-compound-pobj,NNP,DT-NNP-NNP,3,1
1,0.0,37,reigned,18,18,2,-16,17,34,0,-16,Illinois,the United States,LOC,LOC-LOC-LOC,PROPN,DET-PROPN-PROPN,nsubj,det-compound-pobj,NNP,DT-NNP-NNP,2,1
0,0.0,20,"""",0,2,9,7,1,10,-2,9,The Father - Thing,1954,MISC-MISC-MISC-MISC,TIME,DET-PROPN-PUNCT-PROPN,NUM,det-compound-punct-nsubj,nummod,DT-NNP-HYPH-NNP,CD,5,1
1,0.0,20,"""",0,2,17,15,1,2,-2,17,The Father - Thing,Philip K. Dick,MISC-MISC-MISC-MISC,PER-PER-PER,DET-PROPN-PUNCT-PROPN,PROPN-PROPN-PROPN,det-compound-punct-nsubj,compound-compound-pobj,DT-NNP-HYPH-NNP,NNP-NNP-NNP,6,1
2,7.0,43,is,4,8,12,4,7,30,-4,8,Underwood - Miller,1987,ORG-ORG-ORG,TIME,PROPN-PUNCT-PROPN,NUM,compound-punct-nsubj,appos,NNP-HYPH-NNP,CD,2,1
0,0.0,34,is,12,15,32,17,14,1,-3,20,21-story,United States,NUM,LOC-LOC,ADJ,PROPN-PROPN,nummod,compound-appos,JJ,NNP-NNP,5,1
1,0.0,34,is,12,17,32,15,16,1,-5,20,363-foot,United States,NUM,LOC-LOC,NUM,PROPN-PROPN,nummod,compound-appos,CD,NNP-NNP,4,1
2,0.0,34,is,12,23,23,0,22,10,-11,11,Cleveland State University,Cleveland,ORG-ORG-ORG,LOC,PROPN-PROPN-PROPN,PROPN,compound-compound-pobj,pobj,NNP-NNP-NNP,NNP,0,1
3,0.0,34,is,12,23,30,7,22,3,-11,18,Cleveland State University,Ohio,ORG-ORG-ORG,LOC,PROPN-PROPN-PROPN,PROPN,compound-compound-pobj,appos,NNP-NNP-NNP,NNP,6,1
4,5.0,29,named,3,21,7,-14,20,21,-18,4,Cleveland State University,Ohio,ORG-ORG-ORG,LOC,PROPN-PROPN-PROPN,PROPN,compound-compound-dobj,compound,NNP-NNP-NNP,NNP,9,1
5,0.0,34,is,12,23,32,9,22,1,-11,20,Cleveland State University,United States,ORG-ORG-ORG,LOC-LOC,PROPN-PROPN-PROPN,PROPN-PROPN,compound-compound-pobj,compound-appos,NNP-NNP-NNP,NNP-NNP,2,1
6,0.0,34,is,12,23,32,9,22,1,-11,20,Cleveland,United States,LOC,LOC-LOC,PROPN,PROPN-PROPN,pobj,compound-appos,NNP,NNP-NNP,2,1
7,0.0,34,is,12,30,32,2,29,1,-18,20,Ohio,United States,LOC,LOC-LOC,PROPN,PROPN-PROPN,appos,compound-appos,NNP,NNP-NNP,6,1
8,4.0,24,is,1,14,8,-6,13,15,-13,7,Fenn Tower,Cleveland State,LOC-LOC,ORG-ORG,PROPN-PROPN,PROPN-PROPN,compound-pobj,compound-compound,NNP-NNP,NNP-NNP,6,1
9,4.0,24,is,1,14,23,9,13,0,-13,22,Fenn Tower,Ohio,LOC-LOC,LOC,PROPN-PROPN,PROPN,compound-pobj,pobj,NNP-NNP,NNP,5,1
0,0.0,27,"""",0,2,15,13,1,11,-2,15,Bootie Call,All Saints,MISC-MISC,ORG-ORG,NOUN-NOUN,DET-PROPN,compound-nsubj,det-dobj,NN-NN,DT-NNPS,6,1
1,2.0,22,"""",0,2,16,14,1,5,-2,16,Bootie Call,All Saints,MISC-MISC,ORG-ORG,NOUN-NOUN,DET-PROPN,compound-nsubjpass,det-poss,NN-NN,DT-NNPS,4,1
2,0.0,27,"""",0,15,25,10,14,1,-15,25,All Saints,1998,ORG-ORG,TIME,DET-PROPN,NUM,det-dobj,appos,DT-NNPS,CD,6,1
3,2.0,22,"""",0,2,13,11,1,8,-2,13,Bootie Call,London Records,MISC-MISC,ORG-ORG,NOUN-NOUN,PROPN-PROPN,compound-nsubjpass,compound-pobj,NN-NN,NNP-NNPS,3,1
4,2.0,22,"""",0,16,13,-3,15,8,-16,13,All Saints,London Records,ORG-ORG,ORG-ORG,DET-PROPN,PROPN-PROPN,det-poss,compound-pobj,DT-NNPS,NNP-NNPS,5,1
0,0.0,29,was,14,1,4,3,0,24,13,-10,Alexandru Borza,1887,PER-PER,TIME,PROPN-PROPN,NUM,compound-nsubj,appos,NNP-NNP,CD,1,1
1,0.0,29,was,14,1,6,5,0,22,13,-8,Alexandru Borza,Alba Iulia,PER-PER,LOC-LOC,PROPN-PROPN,PROPN-PROPN,compound-nsubj,compound-appos,NNP-NNP,NNP-NNP,4,1
2,3.0,20,founded,13,2,16,14,1,3,11,3,Retezat National Park,1935,LOC-LOC-LOC,TIME,PROPN-PROPN-PROPN,NUM,compound-compound-nsubjpass,pobj,NNP-NNP-NNP,CD,3,1
3,3.0,20,founded,13,2,11,9,1,8,11,-2,Retezat National Park,Romania,LOC-LOC-LOC,LOC,PROPN-PROPN-PROPN,PROPN,compound-compound-nsubjpass,pobj,NNP-NNP-NNP,NNP,3,1
0,3.0,39,announced,1,13,18,5,12,20,-12,17,Tehrik - i - Taliban,Pakistan,ORG-ORG-ORG-ORG-ORG,LOC,PROPN-PUNCT-PROPN-PUNCT-PROPN,PROPN,nmod-punct-dobj-punct-compound,compound,NNP-HYPH-NNP-:-NNP,NNP,4,1
1,3.0,39,announced,1,20,18,-2,19,20,-19,17,Hafiz Saeed Khan,Pakistan,PER-PER-PER,LOC,PROPN-PROPN-PROPN,PROPN,compound-compound-dobj,compound,NNP-NNP-NNP,NNP,2,1
2,4.0,24,killed,2,14,22,8,13,1,-12,20,Khan,July 2016,PER,TIME-TIME,PROPN,PROPN-NUM,nsubjpass,pobj-nummod,NNP,NNP-CD,4,1
0,0.0,16,was,4,2,11,9,1,4,2,7,House of York,English,ORG-ORG-ORG,LOC,PROPN-ADP-PROPN,ADJ,nsubj-prep-pobj,amod,NNP-IN-NNP,JJ,6,1
1,0.0,16,was,4,2,2,0,1,13,2,-2,House of York,House of Plantagenet,ORG-ORG-ORG,ORG-ORG-ORG,PROPN-ADP-PROPN,PROPN-ADP-PROPN,nsubj-prep-pobj,pobj-prep-pobj,NNP-IN-NNP,NNP-IN-NNP,0,1
2,5.0,23,ended,5,11,17,6,10,5,-6,12,Richard III,Battle of Bosworth Field,PER-PER,MISC-MISC-MISC-MISC,PROPN-PROPN,PROPN-ADP-PROPN-PROPN,compound-pobj,pobj-prep-compound-pobj,NNP-NNP,NNP-IN-NNP-NNP,5,1
3,5.0,23,ended,5,11,22,11,10,0,-6,17,Richard III,1485,PER-PER,TIME,PROPN-PROPN,NUM,compound-pobj,pobj,NNP-NNP,CD,5,1
4,5.0,23,ended,5,11,14,3,10,8,-6,9,Richard III,England,PER-PER,LOC,PROPN-PROPN,PROPN,compound-pobj,pobj,NNP-NNP,NNP,3,1
5,5.0,23,ended,5,17,22,5,16,0,-12,17,Battle of Bosworth Field,1485,MISC-MISC-MISC-MISC,TIME,PROPN-ADP-PROPN-PROPN,NUM,pobj-prep-compound-pobj,pobj,NNP-IN-NNP-NNP,CD,6,1
0,0.0,25,was,1,10,16,6,9,8,-9,15,Austin,Travis County,LOC,LOC-LOC,PROPN,PROPN-PROPN,pobj,compound-pobj,NNP,NNP-NNP,4,1
1,0.0,25,was,1,12,16,4,11,8,-11,15,Texas,Travis County,LOC,LOC-LOC,PROPN,PROPN-PROPN,appos,compound-pobj,NNP,NNP-NNP,4,1
2,1.0,68,proposed,24,67,49,-18,66,18,-43,25,Austin,Colorado River,LOC,LOC-LOC,PROPN,PROPN-PROPN,attr,compound-pobj,NNP,NNP-NNP,9,1
3,1.0,68,proposed,24,2,35,33,1,32,22,11,Republic of Texas,Houston,LOC-LOC-LOC,LOC,PROPN-ADP-PROPN,PROPN,nmod-prep-pobj,pobj,NNP-IN-NNP,NNP,7,1
0,0.0,22,was,13,1,6,5,0,15,12,-7,Georgi Valentinovich Plekhanov,29 November 1856,PER-PER-PER,TIME-TIME-TIME,PROPN-PROPN-PROPN,NUM-PROPN-NUM,compound-compound-compound,nummod-appos-nummod,NNP-NNP-NNP,CD-NNP-CD,4,1
1,0.0,22,was,13,1,10,9,0,11,12,-3,Georgi Valentinovich Plekhanov,30 May 1918,PER-PER-PER,TIME-TIME-TIME,PROPN-PROPN-PROPN,NUM-PROPN-NUM,compound-compound-compound,nummod-appos-nummod,NNP-NNP-NNP,CD-NNP-CD,5,1
2,1.0,27,was,1,12,19,7,11,7,-11,18,Russia,Russians,LOC,LOC,PROPN,PROPN,pobj,pobj,NNP,NNPS,4,1
3,3.0,46,rejected,22,5,19,14,4,26,17,-3,Bolshevik,1903,ORG,TIME,PROPN,NUM,compound,pobj,NNP,CD,3,1
4,3.0,46,rejected,22,9,19,10,8,26,13,-3,2nd Congress of the Russian Social Democratic Labour Party,1903,MISC-MISC-MISC-MISC-MISC-MISC-MISC-MISC-MISC,TIME,ADJ-PROPN-ADP-DET-ADJ-PROPN-PROPN-PROPN-PROPN,NUM,amod-pobj-prep-det-compound-compound-compound-compound-pobj,pobj,JJ-NNP-IN-DT-JJ-NNP-NNP-NNP-NNP,CD,4,1
0,0.0,18,was,12,1,5,4,0,12,11,-7,Rovshan Huseynov,17 December 1975,PER-PER,TIME-TIME-TIME,PROPN-PROPN,NUM-PROPN-NUM,compound-nsubj,nummod-npadvmod-nummod,NNP-NNP,CD-NNP-CD,2,1
1,0.0,18,was,12,1,9,8,0,8,11,-3,Rovshan Huseynov,Yeghegnadzor,PER-PER,LOC,PROPN-PROPN,PROPN,compound-nsubj,pobj,NNP-NNP,NNP,4,1
2,0.0,18,was,12,1,11,10,0,6,11,-1,Rovshan Huseynov,Armenia,PER-PER,LOC,PROPN-PROPN,PROPN,compound-nsubj,appos,NNP-NNP,NNP,2,1
3,0.0,18,was,12,1,15,14,0,2,11,3,Rovshan Huseynov,Azerbaijani,PER-PER,LOC,PROPN-PROPN,ADJ,compound-nsubj,compound,NNP-NNP,JJ,3,1
4,0.0,18,was,12,9,11,2,8,6,3,-1,Yeghegnadzor,Armenia,LOC,LOC,PROPN,PROPN,pobj,appos,NNP,NNP,4,1
5,3.0,27,qualified,1,1,16,15,0,10,0,15,Huseynov,1st AIBA European 2004 Olympic Qualifying Tournament,PER,MISC-MISC-MISC-MISC-MISC-MISC-MISC,PROPN,ADJ-PROPN-ADJ-NUM-ADJ-PROPN-PROPN,nsubj,amod-nmod-appos-nummod-compound-compound-pobj,NNP,JJ-NNP-JJ-CD-JJ-NNP-NNP,-1,1
6,3.0,27,qualified,1,24,26,2,23,0,-23,25,Plovdiv,Bulgaria,LOC,LOC,PROPN,PROPN,pobj,appos,NNP,NNP,5,1
7,4.0,18,lost,3,6,9,3,5,8,-3,6,Mario Kindelán,Cuba,PER-PER,LOC,PROPN-PROPN,PROPN,compound-pobj,pobj,NNP-NNP,NNP,1,1
8,5.0,16,recovered,3,1,14,13,0,1,2,11,Huseynov,2004 Olympics,PER,MISC-MISC,PROPN,NUM-PROPN,nsubj,nummod-pobj,NNP,CD-NNPS,4,1
0,0.0,33,is,10,1,13,12,0,19,9,3,Jeffrey Lane Hephner,American,PER-PER-PER,LOC,PROPN-PROPN-PROPN,ADJ,compound-compound-nsubj,amod,NNP-NNP-NNP,JJ,3,1
1,1.0,28,–,2,21,17,-4,20,10,-19,15,Easy Money,CW comedy - drama,MISC-MISC,MISC-MISC-MISC-MISC,PROPN-PROPN,PROPN-NOUN-PUNCT-NOUN,compound-pobj,compound-compound-punct-compound,NNP-NNP,NNP-NN-HYPH-NN,2,1
2,2.0,40,had,1,31,38,7,30,1,-30,37,Boss,Kelsey Grammer,MISC,PER-PER,PROPN,PROPN-PROPN,appos,compound-pobj,NNP,NNP-NNP,9,1
3,3.0,67,starred,4,36,45,9,35,21,-32,41,Chicago Fire,2013,MISC-MISC,TIME,PROPN-PROPN,NUM,compound-appos,pobj,NNP-NNP,CD,5,1
0,0.0,21,is,3,1,15,14,0,5,2,12,Duluth High School,Atlanta,ORG-ORG-ORG,LOC,PROPN-PROPN-PROPN,PROPN,compound-compound-nsubj,pobj,NNP-NNP-NNP,NNP,7,1
1,0.0,21,is,3,1,15,14,0,5,2,12,Duluth,Atlanta,LOC,LOC,PROPN,PROPN,pobj,pobj,NNP,NNP,7,1
2,2.0,21,built,3,11,19,8,10,1,-8,16,Berkeley Lake,Gwinnett County,LOC-LOC,LOC-LOC,PROPN-PROPN,PROPN-PROPN,compound-conj,compound-pobj,NNP-NNP,NNP-NNP,4,1
0,0.0,32,is,2,1,12,11,0,19,1,10,One Love,Blue,MISC-MISC,ORG,NUM-NOUN,PROPN,nummod-nsubj,pobj,CD-NN,NNP,3,1
1,0.0,32,is,2,1,16,15,0,15,1,14,One Love,4 November 2002,MISC-MISC,TIME-TIME-TIME,NUM-NOUN,NUM-PROPN-NUM,nummod-nsubj,nummod-pobj-nummod,CD-NN,CD-NNP-CD,5,1
2,0.0,32,is,2,1,25,24,0,6,1,23,One Love,21 October 2003,MISC-MISC,TIME-TIME-TIME,NUM-NOUN,NUM-PROPN-NUM,nummod-nsubj,nummod-pobj-nummod,CD-NN,CD-NNP-CD,6,1
0,3.0,41,is,1,18,18,0,17,22,-17,17,The People of Sparks,The Prophet of Yonwood,MISC-MISC-MISC-MISC,MISC-MISC-MISC-MISC,DET-PROPN-ADP-PROPN,DET-PROPN-ADP-PROPN,det-dobj-prep-pobj,det-appos-prep-pobj,DT-NNPS-IN-NNPS,DT-NNP-IN-NNP,0,1
1,3.0,41,is,1,18,18,0,17,22,-17,17,The Prophet of Yonwood,The Diamond of Darkhold,MISC-MISC-MISC-MISC,MISC-MISC-MISC-MISC,DET-PROPN-ADP-PROPN,DET-PROPN-ADP-PROPN,det-appos-prep-pobj,det-appos-prep-pobj,DT-NNP-IN-NNP,DT-NNP-IN-NNP,0,1
0,5.0,21,headed,3,12,20,8,11,0,-9,17,Badenweiler,Germany,LOC,LOC,PROPN,PROPN,pobj,pobj,NNP,NNP,3,1
0,0.0,25,is,7,1,19,18,0,5,6,12,Elliott Morris,UK,PER-PER,LOC,PROPN-PROPN,PROPN,compound-nsubj,nmod,NNP-NNP,NNP,5,1
1,0.0,25,is,7,4,19,15,3,5,3,12,West Ashby,UK,LOC-LOC,LOC,PROPN-PROPN,PROPN,compound-pobj,nmod,NNP-NNP,NNP,7,1
2,0.0,25,is,7,7,19,12,6,5,0,12,Lincolnshire,UK,LOC,LOC,PROPN,PROPN,pobj,nmod,NNP,NNP,4,1
3,3.0,36,completed,2,24,5,-19,23,30,-22,3,Glasgow Royal Concert Hall,UK,LOC-LOC-LOC-LOC,LOC,PROPN-PROPN-PROPN-PROPN,PROPN,compound-compound-compound-pobj,compound,NNP-NNP-NNP-NNP,NNP,5,1
4,3.0,36,completed,2,29,5,-24,28,30,-27,3,Sage,UK,LOC,LOC,PROPN,PROPN,conj,compound,NNP,NNP,6,1
5,3.0,36,completed,2,31,5,-26,30,30,-29,3,Gateshead,UK,LOC,LOC,PROPN,PROPN,conj,compound,NNP,NNP,7,1
6,3.0,36,completed,2,34,5,-29,33,30,-32,3,London Palladium,UK,LOC-LOC,LOC,PROPN-PROPN,PROPN,compound-conj,compound,NNP-NNP,NNP,7,1
0,0.0,15,is,2,1,10,9,0,4,1,8,Lago Lindo,Edmonton,LOC-LOC,LOC,PROPN-PROPN,PROPN,compound-nsubj,pobj,NNP-NNP,NNP,6,1
1,0.0,15,is,2,1,12,11,0,2,1,10,Lago Lindo,Alberta,LOC-LOC,LOC,PROPN-PROPN,PROPN,compound-nsubj,npadvmod,NNP-NNP,NNP,7,1
2,0.0,15,is,2,1,14,13,0,0,1,12,Lago Lindo,Canada,LOC-LOC,LOC,PROPN-PROPN,PROPN,compound-nsubj,appos,NNP-NNP,NNP,2,1
3,0.0,15,is,2,10,12,2,9,2,-8,10,Edmonton,Alberta,LOC,LOC,PROPN,PROPN,pobj,npadvmod,NNP,NNP,3,1
4,0.0,15,is,2,10,14,4,9,0,-8,12,Edmonton,Canada,LOC,LOC,PROPN,PROPN,pobj,appos,NNP,NNP,6,1
5,0.0,15,is,2,12,14,2,11,0,-10,12,Alberta,Canada,LOC,LOC,PROPN,PROPN,npadvmod,appos,NNP,NNP,7,1
0,0.0,21,is,5,1,17,16,0,3,4,12,Lambda Archives of San Diego,California,MISC-MISC-MISC-MISC-MISC,LOC,PROPN-PROPN-ADP-PROPN-PROPN,PROPN,compound-nsubj-prep-compound-pobj,conj,NNP-NNPS-IN-NNP-NNP,NNP,7,1
1,0.0,21,is,5,1,19,18,0,1,4,14,Lambda Archives of San Diego,United States,MISC-MISC-MISC-MISC-MISC,LOC-LOC,PROPN-PROPN-ADP-PROPN-PROPN,PROPN-PROPN,compound-nsubj-prep-compound-pobj,compound-appos,NNP-NNPS-IN-NNP-NNP,NNP-NNP,7,1
2,0.0,21,is,5,4,19,15,3,1,1,14,San Diego,United States,LOC-LOC,LOC-LOC,PROPN-PROPN,PROPN-PROPN,compound-pobj,compound-appos,NNP-NNP,NNP-NNP,9,1
3,0.0,21,is,5,17,19,2,16,1,-12,14,California,United States,LOC,LOC-LOC,PROPN,PROPN-PROPN,conj,compound-appos,NNP,NNP-NNP,2,1
4,2.0,34,is,4,26,31,5,25,2,-22,27,Tijuana,Mexico,LOC,LOC,PROPN,PROPN,nmod,nmod,NNP,NNP,3,1
5,2.0,34,is,4,28,31,3,27,2,-24,27,Baja California,Mexico,LOC-LOC,LOC,PROPN-PROPN,PROPN,compound-nmod,nmod,NNP-NNP,NNP,2,1
0,0.0,21,is,1,1,7,6,0,13,0,6,Howrah,City of Clarence,LOC,LOC-LOC-LOC,PROPN,PROPN-ADP-PROPN,nsubj,pobj-prep-pobj,NNP,NNP-IN-NNP,4,1
1,0.0,21,is,1,1,18,17,0,2,0,17,Howrah,Tasmania,LOC,LOC,PROPN,PROPN,nsubj,npadvmod,NNP,NNP,6,1
2,0.0,21,is,1,1,20,19,0,0,0,19,Howrah,Australia,LOC,LOC,PROPN,PROPN,nsubj,appos,NNP,NNP,1,1
3,0.0,21,is,1,7,18,11,6,2,-6,17,City of Clarence,Tasmania,LOC-LOC-LOC,LOC,PROPN-ADP-PROPN,PROPN,pobj-prep-pobj,npadvmod,NNP-IN-NNP,NNP,8,1
4,0.0,21,is,1,7,20,13,6,0,-6,19,City of Clarence,Australia,LOC-LOC-LOC,LOC,PROPN-ADP-PROPN,PROPN,pobj-prep-pobj,appos,NNP-IN-NNP,NNP,5,1
5,0.0,21,is,1,14,18,4,13,2,-13,17,greater Hobart area,Tasmania,LOC-LOC-LOC,LOC,ADJ-PROPN-NOUN,PROPN,amod-compound-pobj,npadvmod,JJR-NNP-NN,NNP,3,1
6,0.0,21,is,1,14,20,6,13,0,-13,19,greater Hobart area,Australia,LOC-LOC-LOC,LOC,ADJ-PROPN-NOUN,PROPN,amod-compound-pobj,appos,JJR-NNP-NN,NNP,6,1
7,0.0,21,is,1,18,20,2,17,0,-17,19,Tasmania,Australia,LOC,LOC,PROPN,PROPN,npadvmod,appos,NNP,NNP,7,1
8,5.0,27,thought,5,1,26,25,0,0,4,21,Clarence High School,Bellerive,ORG-ORG-ORG,LOC,PROPN-PROPN-PROPN,PROPN,compound-compound-nsubjpass,pobj,NNP-NNP-NNP,NNP,3,1
0,0.0,14,is,9,1,6,5,0,7,8,-3,Jon André Røyrane,12 December 1983,PER-PER-PER,TIME-TIME-TIME,PROPN-PROPN-PROPN,NUM-PROPN-NUM,compound-compound-nsubj,nummod-npadvmod-nummod,NNP-NNP-NNP,CD-NNP-CD,3,1
1,1.0,19,born,2,1,5,4,0,13,1,3,Røyrane,Norheimsund,PER,LOC,PROPN,PROPN,nsubjpass,pobj,NNP,NNP,2,1
2,1.0,19,born,2,1,5,4,0,13,1,3,Røyrane,Norheimsund IL,PER,ORG-ORG,PROPN,PROPN-PROPN,nsubjpass,compound-pobj,NNP,NNP-NNP,2,1
3,5.0,33,joined,12,12,24,12,11,8,0,12,Røyrane,Kristiansund,PER,ORG,PROPN,PROPN,nsubj,pobj,NNP,NNP,3,1
4,6.0,21,joined,7,9,19,10,8,1,-2,12,UMF Selfoss,Icelandic,ORG-ORG,LOC,PROPN-PROPN,ADJ,compound-dobj,compound,NNP-NNP,JJ,5,1
5,8.0,20,signed,1,1,4,3,0,15,0,3,Røyrane,Fram Reykjavik,PER,ORG-ORG,NOUN,PROPN-PROPN,nsubj,compound-pobj,NN,NNP-NNP,2,1
0,0.0,31,is,8,1,5,4,0,25,7,-3,Kristian Matsson,30 April 1983,PER-PER,TIME-TIME-TIME,PROPN-PROPN,NUM-PROPN-NUM,amod-nsubj,nummod-npadvmod-nummod,NNP-NNP,CD-NNP-CD,2,1
1,0.0,31,is,8,1,17,16,0,13,7,9,Kristian Matsson,Sweden,PER-PER,LOC,PROPN-PROPN,PROPN,amod-nsubj,appos,NNP-NNP,NNP,5,1
2,0.0,31,is,8,15,17,2,14,13,-7,9,Dalarna,Sweden,LOC,LOC,PROPN,PROPN,pobj,appos,NNP,NNP,2,1
0,0.0,36,"""",0,26,35,9,25,0,-26,35,Eurovision Song Contest 1990,Maywood,MISC-MISC-MISC-MISC,PER,PROPN-PROPN-PROPN-NUM,PROPN,compound-compound-pobj-nummod,pobj,NNP-NNP-NNP-CD,NNP,5,1
1,4.0,30,performed,3,25,21,-4,24,8,-22,18,Quand je te rêve,Céline Carzo,MISC-MISC-MISC-MISC,PER-PER,PROPN-X-PROPN-VERB,PROPN-PROPN,compound-compound-compound-pobj,compound-dobj,NNP-FW-NNP-VBZ,NNP-NNP,5,1
0,0.0,36,was,15,1,4,3,0,31,14,-11,Giovanni Gussone,8 February 1787,PER-PER,TIME-TIME-TIME,PROPN-PROPN,NUM-PROPN-NUM,compound-nsubj,nummod-appos-nummod,NNP-NNP,CD-NNP-CD,1,1
1,0.0,36,was,15,1,8,7,0,27,14,-7,Giovanni Gussone,Villamaina,PER-PER,LOC,PROPN-PROPN,PROPN,compound-nsubj,nmod,NNP-NNP,NNP,2,1
2,0.0,36,was,15,1,10,9,0,25,14,-5,Giovanni Gussone,14 January 1866,PER-PER,TIME-TIME-TIME,PROPN-PROPN,NUM-PROPN-NUM,compound-nsubj,nummod-appos-nummod,NNP-NNP,CD-NNP-CD,2,1
3,0.0,36,was,15,1,14,13,0,21,14,-1,Giovanni Gussone,Naples,PER-PER,LOC,PROPN-PROPN,PROPN,compound-nsubj,appos,NNP-NNP,NNP,1,1
4,0.0,36,was,15,1,18,17,0,17,14,3,Giovanni Gussone,Italian,PER-PER,LOC,PROPN-PROPN,ADJ,compound-nsubj,amod,NNP-NNP,JJ,2,1
5,2.0,25,worked,6,15,23,8,14,1,-9,17,Orto Botanico di Napoli,Naples,LOC-LOC-LOC-LOC,LOC,PROPN-PROPN-PROPN-PROPN,PROPN,nmod-nmod-nmod-pobj,pobj,NNP-NNP-NNP-NNP,NNP,6,1
0,0.0,28,was,9,1,6,5,0,21,8,-3,Frederick Newton,8 August 1986,PER-PER,TIME-TIME-TIME,PROPN-PROPN,NUM-PROPN-NUM,compound-nsubj,nummod-appos-nummod,NNP-NNP,CD-NNP-CD,1,1
0,0.0,31,is,9,1,12,11,0,18,8,3,Tamás László,Hungarian,PER-PER,LOC,PROPN-PROPN,ADJ,compound-nsubj,amod,NNP-NNP,JJ,2,1
1,0.0,31,is,9,1,26,25,0,4,8,17,Tamás László,Budapest,PER-PER,LOC,PROPN-PROPN,PROPN,compound-nsubj,pobj,NNP-NNP,NNP,4,1
2,0.0,31,is,9,12,26,14,11,4,-3,17,Hungarian,Budapest,LOC,LOC,ADJ,PROPN,amod,pobj,JJ,NNP,2,1
0,0.0,25,is,4,1,10,9,0,14,3,6,Aalborg County,Denmark,LOC-LOC,LOC,PROPN-PROPN,PROPN,compound-nsubj,pobj,NNP-NNP,NNP,5,1
0,0.0,32,was,15,1,5,4,0,26,14,-10,Dennis Carl Wilson,"December 28 , 1983",PER-PER-PER,TIME-TIME-TIME-TIME,PROPN-PROPN-PROPN,PROPN-NUM-PUNCT-NUM,compound-compound-nsubj,appos-nummod-punct-nummod,NNP-NNP-NNP,"NNP-CD-,-CD",3,1
1,0.0,32,was,15,1,18,17,0,13,14,3,Dennis Carl Wilson,American,PER-PER-PER,LOC,PROPN-PROPN-PROPN,ADJ,compound-compound-nsubj,amod,NNP-NNP-NNP,JJ,3,1
2,0.0,32,was,15,1,29,28,0,2,14,14,Dennis Carl Wilson,the Beach Boys,PER-PER-PER,ORG-ORG-ORG,PROPN-PROPN-PROPN,DET-PROPN-PROPN,compound-compound-nsubj,det-compound-dobj,NNP-NNP-NNP,DT-NNP-NNPS,5,1
3,1.0,19,remembered,3,15,17,2,14,1,-12,14,Brian,Carl Wilson,PER,PER-PER,PROPN,PROPN-PROPN,pobj,compound-conj,NNP,NNP-NNP,2,1
4,8.0,28,credit,4,15,27,12,14,0,-11,23,You Are So Beautiful,1974,MISC-MISC-MISC-MISC,TIME,PRON-VERB-ADV-ADJ,NUM,nsubj-ccomp-advmod-acomp,pobj,PRP-VBP-RB-JJ,CD,3,1
5,10.0,22,released,13,6,10,4,5,11,7,-3,Pacific Ocean Blue,1977,MISC-MISC-MISC,TIME,PROPN-PROPN-PROPN,NUM,compound-compound-appos,appos,NNP-NNP-NNP,CD,2,1
0,0.0,27,is,6,2,2,0,1,24,4,-4,South San Francisco Hillside Sign,South San Francisco,LOC-LOC-LOC-LOC-LOC,LOC-LOC-LOC,PROPN-PROPN-PROPN-PROPN-PROPN,PROPN-PROPN-PROPN,compound-compound-compound-compound-nsubj,compound-compound-pobj,NNP-NNP-NNP-NNP-NNP,NNP-NNP-NNP,0,1
1,0.0,27,is,6,2,3,1,1,23,4,-3,South San Francisco,San Mateo County,LOC-LOC-LOC,LOC-LOC-LOC,PROPN-PROPN-PROPN,PROPN-PROPN-PROPN,compound-compound-pobj,compound-compound-pobj,NNP-NNP-NNP,NNP-NNP-NNP,1,1
2,0.0,27,is,6,3,26,23,2,0,3,20,San Mateo County,California,LOC-LOC-LOC,LOC,PROPN-PROPN-PROPN,PROPN,compound-compound-pobj,appos,NNP-NNP-NNP,NNP,4,1
0,0.0,25,Height,0,1,5,4,0,19,-1,5,Height of Fashion,14 April 1979,MISC-MISC-MISC,TIME-TIME-TIME,PROPN-ADP-PROPN,NUM-PROPN-NUM,ROOT-prep-pobj,nummod-appos-nummod,NNP-IN-NNP,CD-NNP-CD,2,1
1,0.0,25,Height,0,1,9,8,0,15,-1,9,Height of Fashion,29 July 2000,MISC-MISC-MISC,TIME-TIME-TIME,PROPN-ADP-PROPN,NUM-PROPN-NUM,ROOT-prep-pobj,nummod-nsubj-nummod,NNP-IN-NNP,CD-NNP-CD,3,1
0,0.0,27,Mustard,2,1,6,5,0,20,1,4,James Fraser Mustard,"October 16 , 1927",PER-PER-PER,TIME-TIME-TIME-TIME,PROPN-PROPN-PROPN,PROPN-NUM-PUNCT-NUM,compound-compound-ROOT,appos-nummod-punct-nummod,NNP-NNP-NNP,"NNP-CD-,-CD",3,1
1,0.0,27,Mustard,2,1,11,10,0,15,1,9,James Fraser Mustard,"November 16 , 2011",PER-PER-PER,TIME-TIME-TIME-TIME,PROPN-PROPN-PROPN,PROPN-NUM-PUNCT-NUM,compound-compound-ROOT,nsubj-nummod-punct-nummod,NNP-NNP-NNP,"NNP-CD-,-CD",3,1
2,0.0,27,Mustard,2,1,18,17,0,8,1,16,James Fraser Mustard,Canadian,PER-PER-PER,LOC,PROPN-PROPN-PROPN,ADJ,compound-compound-ROOT,amod,NNP-NNP-NNP,JJ,3,1
3,1.0,45,began,11,11,7,-4,10,37,0,-4,Mustard,Toronto,PER,LOC,PROPN,PROPN,nsubj,pobj,NNP,NNP,6,1
4,1.0,45,began,11,11,21,10,10,23,0,10,Mustard,University of Toronto,PER,ORG-ORG-ORG,PROPN,PROPN-ADP-PROPN,nsubj,pobj-prep-pobj,NNP,NNP-IN-NNP,5,1
5,1.0,45,began,11,7,9,2,6,35,4,-2,Toronto,Ontario,LOC,LOC,PROPN,PROPN,pobj,appos,NNP,NNP,7,1
0,4.0,39,is,1,5,19,14,4,19,-4,18,the United Kingdom,Edward VIII,LOC-LOC-LOC,PER-PER,DET-PROPN-PROPN,PROPN-PROPN,det-compound-pobj,compound-pobj,DT-NNP-NNP,NNP-NNP,3,1
1,4.0,39,is,1,27,31,4,26,7,-26,30,Juan Carlos I,Spain,PER-PER-PER,LOC,PROPN-PROPN-PRON,PROPN,compound-conj-appos,pobj,NNP-NNP-PRP,NNP,1,1
2,4.0,39,is,1,35,38,3,34,0,-34,37,Umberto II,Italy,PER-PER,LOC,PROPN-PROPN,PROPN,compound-conj,pobj,NNP-NNP,NNP,7,1
3,5.0,15,is,1,13,10,-3,12,4,-12,9,Iberian Peninsula,Portugal,LOC-LOC,LOC,PROPN-PROPN,PROPN,compound-conj,pobj,NNP-NNP,NNP,2,1
0,0.0,26,McLaughlin,2,1,5,4,0,20,1,3,David Thomas McLaughlin,"March 16 , 1932",PER-PER-PER,TIME-TIME-TIME-TIME,PROPN-PROPN-PROPN,PROPN-NUM-PUNCT-NUM,compound-compound-ROOT,appos-nummod-punct-nummod,NNP-NNP-NNP,"NNP-CD-,-CD",3,1
1,0.0,26,McLaughlin,2,1,10,9,0,15,1,8,David Thomas McLaughlin,"August 25 , 2004",PER-PER-PER,TIME-TIME-TIME-TIME,PROPN-PROPN-PROPN,PROPN-NUM-PUNCT-NUM,compound-compound-ROOT,nsubj-nummod-punct-nummod,NNP-NNP-NNP,"NNP-CD-,-CD",3,1
0,5.0,39,expelled,10,12,12,0,11,26,-2,2,Fu Chong,Fu Deng,PER-PER,PER-PER,PROPN-PROPN,PROPN-PROPN,compound-conj,compound-poss,NNP-NNP,NNP-NNP,0,1
0,5.0,43,retired,8,13,24,11,12,18,-5,16,Norton A. Schwartz,U.S. Air Force,PER-PER-PER,ORG-ORG-ORG,PROPN-PROPN-PROPN,PROPN-PROPN-PROPN,compound-compound-nsubj,compound-compound-pobj,NNP-NNP-NNP,NNP-NNP-NNP,5,1
0,2.0,24,appeared,1,10,5,-5,9,18,-9,4,The New York Times,US,MISC-MISC-MISC-MISC,LOC,DET-PROPN-PROPN-PROPN,PROPN,det-compound-nmod-nmod,compound,DT-NNP-NNP-NNP,NNP,8,1
0,0.0,27,was,3,10,12,2,9,14,-7,9,Shinagawa,Tokyo,LOC,LOC,PROPN,PROPN,pobj,conj,NNP,NNP,3,1
1,0.0,27,was,3,10,14,4,9,12,-7,11,Shinagawa,Japan,LOC,LOC,PROPN,PROPN,pobj,conj,NNP,NNP,4,1
2,0.0,27,was,3,12,14,2,11,12,-9,11,Tokyo,Japan,LOC,LOC,PROPN,PROPN,conj,conj,NNP,NNP,5,1
0,0.0,21,was,15,1,8,7,0,12,14,-7,Louis Pierre Althusser,16 October 1918,PER-PER-PER,TIME-TIME-TIME,PROPN-PROPN-PROPN,NUM-PROPN-NUM,compound-compound-nsubj,nummod-appos-nummod,NNP-NNP-NNP,CD-NNP-CD,4,1
1,0.0,21,was,15,1,12,11,0,8,14,-3,Louis Pierre Althusser,22 October 1990,PER-PER-PER,TIME-TIME-TIME,PROPN-PROPN-PROPN,NUM-PROPN-NUM,compound-compound-nsubj,nummod-appos-nummod,NNP-NNP-NNP,CD-NNP-CD,4,1
2,0.0,21,was,15,1,18,17,0,2,14,3,Louis Pierre Althusser,French,PER-PER-PER,LOC,PROPN-PROPN-PROPN,ADJ,compound-compound-nsubj,amod,NNP-NNP-NNP,JJ,4,1
3,1.0,23,born,2,10,14,4,9,8,-8,12,École Normale Supérieure,Paris,ORG-ORG-ORG,LOC,PROPN-PROPN-PROPN,PROPN,compound-compound-pobj,pobj,NNP-NNP-NNP,NNP,4,1
4,2.0,18,was,1,1,15,14,0,2,0,14,Althusser,French Communist Party,PER,ORG-ORG-ORG,PROPN,PROPN-PROPN-PROPN,nsubj,compound-compound-pobj,NNP,NNP-NNP-NNP,4,1
0,3.0,23,went,17,5,9,4,4,13,12,-8,Lothair Udo III,1106,PER-PER-PER,TIME,PROPN-PROPN-PROPN,NUM,compound-compound-pobj,pobj,NNP-NNP-NNP,CD,6,1
1,3.0,23,went,17,5,22,17,4,0,12,5,Lothair Udo III,Rudolf I.,PER-PER-PER,PER-PER,PROPN-PROPN-PROPN,PROPN-PROPN,compound-compound-pobj,compound-appos,NNP-NNP-NNP,NNP-NNP,8,1
2,4.0,35,went,6,30,27,-3,29,7,-24,21,Henry,Lothar,PER,PER,PROPN,PROPN,appos,compound,NNP,NNP,6,1
0,5.0,38,was,21,29,37,8,28,0,-8,16,Louis,France,PER,LOC,PROPN,PROPN,ROOT,pobj,NNP,NNP,5,1
1,5.0,38,was,21,34,37,3,33,0,-13,16,Charles VI,France,PER-PER,LOC,PROPN-PROPN,PROPN,compound-pobj,pobj,NNP-NNP,NNP,7,1
0,0.0,29,is,4,2,28,26,1,0,2,24,Raz de Sein,France,LOC-LOC-LOC,LOC,PROPN-X-PROPN,PROPN,compound-compound-nsubj,pobj,NNP-FW-NNP,NNP,3,1
1,0.0,29,is,4,13,28,15,12,0,-9,24,Isle of Sein,France,LOC-LOC-LOC,LOC,PROPN-ADP-PROPN,PROPN,pobj-prep-pobj,pobj,NNP-IN-NNP,NNP,8,1
2,0.0,29,is,4,18,22,4,17,6,-14,18,Pointe du Raz,Finistère,LOC-LOC-LOC,LOC,PROPN-PROPN-PROPN,PROPN,compound-compound-conj,pobj,NNP-NNP-NNP,NNP,2,1
3,0.0,29,is,4,22,25,3,21,3,-18,21,Finistère,Brittany,LOC,LOC,PROPN,PROPN,pobj,compound,NNP,NNP,1,1
4,0.0,29,is,4,22,28,6,21,0,-18,24,Finistère,France,LOC,LOC,PROPN,PROPN,pobj,pobj,NNP,NNP,9,1
5,0.0,29,is,4,25,28,3,24,0,-21,24,Brittany,France,LOC,LOC,PROPN,PROPN,compound,pobj,NNP,NNP,10,1
0,12.0,14,Teo,10,7,3,-4,6,10,3,-7,Teoranta,Republic of Ireland,LOC,LOC-LOC-LOC,PROPN,PROPN-ADP-PROPN,pobj,nmod-prep-pobj,NNP,NNP-IN-NNP,4,1
0,0.0,32,is,2,1,19,18,0,12,1,17,Nicola Lake,British Columbia,LOC-LOC,LOC-LOC,PROPN-PROPN,PROPN-PROPN,compound-nsubj,compound-pobj,NNP-NNP,NNP-NNP,7,1
1,0.0,32,is,2,1,22,21,0,9,1,20,Nicola Lake,Canada,LOC-LOC,LOC,PROPN-PROPN,PROPN,compound-nsubj,conj,NNP-NNP,NNP,7,1
2,0.0,32,is,2,19,22,3,18,9,-17,20,British Columbia,Canada,LOC-LOC,LOC,PROPN-PROPN,PROPN,compound-pobj,conj,NNP-NNP,NNP,10,1
0,0.0,20,"""",0,2,10,8,1,9,-2,10,Do n't Ask Me Why,1989,MISC-MISC-MISC-MISC-MISC,TIME,VERB-ADV-VERB-PRON-ADV,NUM,aux-neg-ROOT-dobj-advmod,nummod,VB-RB-VB-PRP-WRB,CD,3,1
1,7.0,22,drew,9,16,20,4,15,1,-7,11,David Lynch,Blue Velvet,PER-PER,MISC-MISC,PROPN-PROPN,PROPN-PROPN,compound-poss,compound-appos,NNP-NNP,NNP-NNP,2,1
0,0.0,25,is,2,1,5,4,0,19,1,3,Maude Hirst,British,PER-PER,LOC,PROPN-PROPN,ADJ,compound-nsubj,amod,NNP-NNP,JJ,2,1
1,3.0,42,appeared,7,5,11,6,4,30,2,4,Maude Hirst,British,PER-PER,LOC,PROPN-PROPN,ADJ,compound-nsubj,amod,NNP-NNP,JJ,4,1
2,2.0,48,is,2,1,12,11,0,35,1,10,Maude Hirst,Michael Hirst,PER-PER,PER-PER,PROPN-PROPN,PROPN-PROPN,compound-nsubj,compound-conj,NNP-NNP,NNP-NNP,5,1
3,2.0,48,is,2,12,19,7,11,28,-10,17,Michael Hirst,Elizabeth,PER-PER,MISC,PROPN-PROPN,PROPN,compound-conj,appos,NNP-NNP,NNP,8,1
4,2.0,48,is,2,19,21,2,18,26,-17,19,Elizabeth,1998,MISC,TIME,PROPN,NUM,appos,appos,NNP,CD,2,1
5,3.0,42,appeared,7,31,33,2,30,8,-24,26,Nuryan,2009,MISC,TIME,PROPN,NUM,appos,appos,NNP,CD,2,1
0,0.0,21,was,13,1,6,5,0,14,12,-7,Thora Margraff Plitt Hardy,31 July 1902,PER-PER-PER-PER,TIME-TIME-TIME,PROPN-PROPN-PROPN-PROPN,NUM-PROPN-NUM,compound-compound-compound-nsubj,nummod-appos-nummod,NNP-NNP-NNP-NNP,CD-NNP-CD,2,1
1,0.0,21,was,13,1,10,9,0,10,12,-3,Thora Margraff Plitt Hardy,1 January 1993,PER-PER-PER-PER,TIME-TIME-TIME,PROPN-PROPN-PROPN-PROPN,NUM-PROPN-NUM,compound-compound-compound-nsubj,nummod-appos-nummod,NNP-NNP-NNP-NNP,CD-NNP-CD,2,1
2,0.0,21,was,13,1,16,15,0,4,12,3,Thora Margraff Plitt Hardy,US,PER-PER-PER-PER,LOC,PROPN-PROPN-PROPN-PROPN,PROPN,compound-compound-compound-nsubj,compound,NNP-NNP-NNP-NNP,NNP,3,1
3,0.0,21,was,13,1,20,19,0,0,12,7,Thora Margraff Plitt Hardy,Switzerland,PER-PER-PER-PER,LOC,PROPN-PROPN-PROPN-PROPN,PROPN,compound-compound-compound-nsubj,pobj,NNP-NNP-NNP-NNP,NNP,3,1
0,4.0,27,go,5,13,17,4,12,9,-8,12,Abraham Lincoln,The Bear Hunt,PER-PER,MISC-MISC-MISC,PROPN-PROPN,DET-PROPN-PROPN,compound-pobj,det-compound-npadvmod,NNP-NNP,DT-NNP-NNP,6,1
1,5.0,16,featured,5,8,12,4,7,3,-3,7,William Faulkner,Go Down Moses,PER-PER,MISC-MISC-MISC,PROPN-PROPN,VERB-ADP-PROPN,compound-pobj,amod-compound-dobj,NNP-NNP,VB-IN-NNP,3,1
0,2.0,41,Cetate,0,1,3,2,0,37,-1,3,Cetate,Dolj County,LOC,LOC-LOC,PROPN,PROPN-PROPN,ROOT,compound-pobj,NNP,NNP-NNP,2,1
1,2.0,41,Cetate,0,31,22,-9,30,18,-31,22,Ahmed Pasha,Crimean War,PER-PER,MISC-MISC,PROPN-PROPN,PROPN-PROPN,compound-pobj,compound-pobj,NNP-NNP,NNP-NNP,7,1
2,2.0,41,Cetate,0,15,22,7,14,18,-15,22,Battle of Cetate,Crimean War,MISC-MISC-MISC,MISC-MISC,PROPN-ADP-PROPN,PROPN-PROPN,pobj-prep-pobj,compound-pobj,NNP-IN-NNP,NNP-NNP,7,1
3,2.0,41,Cetate,0,22,28,6,21,12,-22,28,Crimean War,Ottoman,MISC-MISC,LOC,PROPN-PROPN,PROPN,compound-pobj,compound,NNP-NNP,NNP,5,1
4,5.0,28,Deva,5,9,16,7,8,11,-4,11,Romanian,Hunedoara County,LOC,LOC-LOC,ADJ,PROPN-PROPN,amod,compound-appos,JJ,NNP-NNP,4,1
5,5.0,28,Deva,5,2,16,14,1,11,3,11,Deva,Hunedoara County,LOC,LOC-LOC,PROPN,PROPN-PROPN,pobj,compound-appos,NNP,NNP-NNP,6,1
6,7.0,28,Synagogue,1,13,15,2,12,12,-12,14,Belváros,Hungarian,LOC,LOC,PROPN,PROPN,appos,pobj,NNP,NNP,2,1
0,0.0,29,was,11,1,4,3,0,24,10,-7,Alfred Jarry,8 September 1873,PER-PER,TIME-TIME-TIME,PROPN-PROPN,NUM-PROPN-NUM,compound-nsubj,nummod-npadvmod-nummod,NNP-NNP,CD-NNP-CD,2,1
1,0.0,29,was,11,1,8,7,0,20,10,-3,Alfred Jarry,1 November 1907,PER-PER,TIME-TIME-TIME,PROPN-PROPN,NUM-PROPN-NUM,compound-nsubj,nummod-appos-nummod,NNP-NNP,CD-NNP-CD,2,1
2,0.0,29,was,11,1,14,13,0,14,10,3,Alfred Jarry,French,PER-PER,LOC,PROPN-PROPN,ADJ,compound-nsubj,amod,NNP-NNP,JJ,4,1
3,0.0,29,was,11,24,27,3,23,1,-13,16,Ubu Roi,1896,MISC-MISC,TIME,PROPN-PROPN,NUM,compound-ROOT,appos,NNP-NNP,CD,1,1
4,2.0,17,born,2,1,5,4,0,11,1,3,Jarry,Laval,PER,LOC,PROPN,PROPN,nsubjpass,pobj,NNP,NNP,4,1
5,4.0,26,play,1,12,3,-9,11,22,-11,2,Dada,Ubu Roi,MISC,MISC-MISC,PROPN,PROPN-PROPN,pobj,compound-nsubjpass,NNP,NNP-NNP,2,1
0,0.0,17,is,1,1,9,8,0,7,0,8,Güsten,Salzlandkreis,LOC,LOC,PROPN,PROPN,nsubj,pobj,NNP,NNP,2,1
1,0.0,17,is,1,1,16,15,0,0,0,15,Güsten,Germany,LOC,LOC,PROPN,PROPN,nsubj,appos,NNP,NNP,1,1
2,0.0,17,is,1,9,16,7,8,0,-8,15,Salzlandkreis,Germany,LOC,LOC,PROPN,PROPN,pobj,appos,NNP,NNP,3,1
3,6.0,15,Siedentopf,1,1,4,3,0,10,0,3,Fritz Siedentopf,1908,PER-PER,TIME,PROPN-PROPN,NUM,compound-ROOT,nummod,NNP-NNP,CD,2,1
4,6.0,15,Siedentopf,1,1,6,5,0,8,0,5,Fritz Siedentopf,1944,PER-PER,TIME,PROPN-PROPN,NUM,compound-ROOT,nummod,NNP-NNP,CD,1,1
5,8.0,22,died,19,1,4,3,0,17,18,-15,Julius Kraaz,1822,PER-PER,TIME,PROPN-PROPN,NUM,compound-nsubj,npadvmod,NNP-NNP,CD,3,1
0,0.0,21,was,6,2,13,11,1,7,4,7,Devon and Cornwall County Division,British Army,ORG-ORG-ORG-ORG-ORG,ORG-ORG,PROPN-CCONJ-PROPN-PROPN-PROPN,PROPN-PROPN,nmod-cc-compound-compound-nsubj,compound-pobj,NNP-CC-NNP-NNP-NNP,NNP-NNP,6,1
1,0.0,21,was,6,2,18,16,1,2,4,12,Devon and Cornwall County Division,Second World War,ORG-ORG-ORG-ORG-ORG,MISC-MISC-MISC,PROPN-CCONJ-PROPN-PROPN-PROPN,PROPN-PROPN-PROPN,nmod-cc-compound-compound-nsubj,compound-compound-pobj,NNP-CC-NNP-NNP-NNP,NNP-NNP-NNP,8,1
2,0.0,21,was,6,13,18,5,12,2,-7,12,British Army,Second World War,ORG-ORG,MISC-MISC-MISC,PROPN-PROPN,PROPN-PROPN-PROPN,compound-pobj,compound-compound-pobj,NNP-NNP,NNP-NNP-NNP,6,1
0,1.0,39,ranked,18,5,10,5,4,28,13,-8,Group of 7,G8,ORG-ORG-ORG,ORG,PROPN-ADP-NUM,PROPN,pobj-prep-pobj,appos,NNP-IN-CD,NNP,3,1
0,2.0,50,wrote,2,22,26,4,21,23,-20,24,The Galactic Gourmet,1996,MISC-MISC-MISC,TIME,DET-PROPN-PROPN,NUM,det-compound-pobj,appos,DT-NNP-NNP,CD,2,1
0,0.0,33,were,10,19,21,2,18,11,-9,11,Anaheim,California,LOC,LOC,PROPN,PROPN,pobj,conj,NNP,NNP,6,1
1,3.0,27,played,2,13,24,11,12,2,-11,22,Anaheim Ducks,National Hockey League,ORG-ORG,ORG-ORG-ORG,PROPN-PROPN,PROPN-PROPN-PROPN,compound-pobj,compound-compound-pobj,NNP-NNPS,NNP-NNP-NNP,7,1
0,1.0,20,was,1,13,7,-6,12,12,-12,6,Cambodia,Norodom Sihamoni,LOC,PER-PER,PROPN,PROPN-PROPN,poss,compound-appos,NNP,NNP-NNP,5,1
1,2.0,7,born,2,1,5,4,0,1,1,3,Suramarit,Phnom Penh,PER,LOC-LOC,PROPN,PROPN-PROPN,nsubjpass,compound-pobj,NNP,NNP-NNP,3,1
0,0.0,24,is,2,1,5,4,0,18,1,3,Blade Runner,American,MISC-MISC,LOC,PROPN-PROPN,ADJ,compound-nsubj,amod,NNP-NNP,JJ,4,1
1,3.0,15,was,4,6,11,5,5,3,-2,7,Blade Runner,Ridley Scott,MISC-MISC,PER-PER,PROPN-PROPN,PROPN-PROPN,compound-attr,compound-pobj,NNP-NNP,NNP-NNP,3,1
2,3.0,15,was,4,6,14,8,5,0,-2,10,Blade Runner,1982,MISC-MISC,TIME,PROPN-PROPN,NUM,compound-attr,pobj,NNP-NNP,CD,2,1
3,7.0,16,released,12,5,5,0,4,10,7,-7,Blade Runner,Blade Runner 2049,MISC-MISC,MISC-MISC-MISC,PROPN-PROPN,PROPN-PROPN-NUM,compound-pobj,compound-appos-nummod,NNP-NNP,NNP-NNP-CD,0,1
4,8.0,45,released,43,7,7,0,6,37,36,-36,Blade Runner,Blade Runner 2049,MISC-MISC,MISC-MISC-MISC,PROPN-PROPN,PROPN-PROPN-NUM,compound-pobj,compound-pobj-appos,NNP-NNP,NNP-NNP-CD,0,1
5,7.0,16,released,12,5,15,10,4,0,7,3,Blade Runner 2049,2017,MISC-MISC-MISC,TIME,PROPN-PROPN-NUM,NUM,compound-appos-nummod,pobj,NNP-NNP-CD,CD,4,1
0,3.0,39,was,5,15,28,13,14,10,-10,23,1260 Ocean Avenue,United States,LOC-LOC-LOC,LOC-LOC,NUM-PROPN-PROPN,PROPN-PROPN,nummod-compound-pobj,compound-appos,CD-NNP-NNP,NNP-NNP,6,1
1,3.0,39,was,5,19,22,3,18,16,-14,17,Long Branch,Monmouth County,LOC-LOC,LOC-LOC,PROPN-PROPN,PROPN-PROPN,compound-pobj,compound-conj,NNP-NNP,NNP-NNP,1,1
2,3.0,39,was,5,19,28,9,18,10,-14,23,Long Branch,United States,LOC-LOC,LOC-LOC,PROPN-PROPN,PROPN-PROPN,compound-pobj,compound-appos,NNP-NNP,NNP-NNP,3,1
3,3.0,39,was,5,22,25,3,21,13,-17,20,Monmouth County,New Jersey,LOC-LOC,LOC-LOC,PROPN-PROPN,PROPN-PROPN,compound-conj,compound-conj,NNP-NNP,NNP-NNP,1,1
4,3.0,39,was,5,22,28,6,21,10,-17,23,Monmouth County,United States,LOC-LOC,LOC-LOC,PROPN-PROPN,PROPN-PROPN,compound-conj,compound-appos,NNP-NNP,NNP-NNP,2,1
5,3.0,39,was,5,25,28,3,24,10,-20,23,New Jersey,United States,LOC-LOC,LOC-LOC,PROPN-PROPN,PROPN-PROPN,compound-conj,compound-appos,NNP-NNP,NNP-NNP,1,1
6,3.0,39,was,5,37,28,-9,36,10,-32,23,Atlantic Ocean,United States,LOC-LOC,LOC-LOC,PROPN-PROPN,PROPN-PROPN,compound-pobj,compound-appos,NNP-NNP,NNP-NNP,13,1
0,2.0,24,influenced,6,19,5,-14,18,18,-13,-1,Robert Goffin,Belgium,PER-PER,LOC,PROPN-PROPN,PROPN,compound-conj,pobj,NNP-NNP,NNP,-1,1
1,3.0,33,yielded,4,20,2,-18,19,30,-16,-2,Toots Thielemans,Belgian,PER-PER,LOC,PROPN-PROPN,ADJ,compound-conj,amod,NNPS-NNPS,JJ,4,1
2,3.0,33,yielded,4,24,2,-22,23,30,-20,-2,Philip Catherine,Belgian,PER-PER,LOC,PROPN-PROPN,ADJ,compound-conj,amod,NNP-NNP,JJ,4,1
3,3.0,33,yielded,4,31,2,-29,30,30,-27,-2,Django Reinhardt,Belgian,PER-PER,LOC,PROPN-PROPN,ADJ,compound-appos,amod,NNP-NNP,JJ,3,1
0,0.0,29,is,5,2,27,25,1,1,3,22,Veleka,European,LOC,LOC,PROPN,PROPN,nsubj,compound,NNP,NNP,5,1
0,0.0,50,is,23,30,49,19,29,0,-7,26,South Australia,Ceduna,LOC-LOC,LOC,PROPN-PROPN,PROPN,compound-pobj,pobj,NNP-NNP,NNP,5,1
0,1.0,21,moved,9,4,7,3,3,13,5,-2,Kansas City,Missouri,LOC-LOC,LOC,PROPN-PROPN,PROPN,compound-pobj,conj,NNP-NNP,NNP,4,1
0,0.0,15,is,2,7,10,3,6,4,-5,8,Linares province,Maule Region,LOC-LOC,LOC-LOC,PROPN-NOUN,PROPN-PROPN,compound-pobj,compound-appos,NNP-NN,NNP-NNP,3,1
1,0.0,15,is,2,7,14,7,6,0,-5,12,Linares province,Chile,LOC-LOC,LOC,PROPN-NOUN,PROPN,compound-pobj,pobj,NNP-NN,NNP,4,1
2,0.0,15,is,2,10,14,4,9,0,-8,12,Maule Region,Chile,LOC-LOC,LOC,PROPN-PROPN,PROPN,compound-appos,pobj,NNP-NNP,NNP,3,1
3,3.0,63,flanked,7,37,48,11,36,14,-30,41,Longaví,Loncomilla,LOC,LOC,PROPN,PROPN,appos,appos,NNP,NNP,10,1
4,3.0,63,flanked,7,39,48,9,38,14,-32,41,Achibueno,Loncomilla,LOC,LOC,PROPN,PROPN,conj,appos,NNP,NNP,11,1
0,0.0,29,was,13,1,27,26,0,1,12,14,James Drewry Stewart,McMaster University,PER-PER-PER,ORG-ORG,PROPN-PROPN-PROPN,PROPN-PROPN,compound-compound-nsubj,compound-pobj,NNP-NNP-NNP,NNP-NNP,5,1
1,1.0,22,received,1,1,8,7,0,13,0,7,Stewart,Stanford University,PER,ORG-ORG,PROPN,PROPN-PROPN,nsubj,compound-pobj,NNP,NNP-NNP,2,1
2,1.0,22,received,1,1,9,8,0,12,0,8,Stewart,University of Toronto,PER,ORG-ORG-ORG,PROPN,PROPN-ADP-PROPN,nsubj,pobj-prep-pobj,NNP,NNP-IN-NNP,3,1
0,4.0,19,suggested,4,1,3,2,0,15,3,-1,Hezbollah,Hassan Nasrallah,ORG,PER-PER,PROPN,PROPN-PROPN,compound,compound-nsubj,NNP,NNP-NNP,1,1
0,0.0,25,was,7,1,4,3,0,20,6,-3,Ignazio Cerio,1841,PER-PER,TIME,PROPN-PROPN,NUM,compound-nsubj,nummod,NNP-NNP,CD,2,1
1,0.0,25,was,7,1,6,5,0,18,6,-1,Ignazio Cerio,1921,PER-PER,TIME,PROPN-PROPN,NUM,compound-nsubj,nummod,NNP-NNP,CD,2,1
2,0.0,25,was,7,1,24,23,0,0,6,17,Ignazio Cerio,Italy,PER-PER,LOC,PROPN-PROPN,PROPN,compound-nsubj,pobj,NNP-NNP,NNP,2,1
3,0.0,25,was,7,21,24,3,20,0,-14,17,Capri,Italy,LOC,LOC,PROPN,PROPN,pobj,pobj,NNP,NNP,3,1
0,6.0,25,is,3,16,22,6,15,2,-13,19,Subrahmanyan Chandrasekhar,India,PER-PER,LOC,PROPN-PROPN,PROPN,compound-pobj,pobj,NNP-NNP,NNP,2,1
0,0.0,25,pronounced,5,1,22,21,0,2,4,17,Jacques Brown,British,PER-PER,LOC,PROPN-PROPN,ADJ,compound-nsubj,amod,NNP-NNP,JJ,3,1
1,1.0,25,produced,1,17,23,6,16,1,-16,22,Beyond Our Ken,BBC Radio,MISC-MISC-MISC,ORG-ORG,ADP-DET-PROPN,PROPN-PROPN,dobj-poss-pobj,compound-pobj,IN-PRP$-NNP,NNP-NNP,5,1
0,0.0,23,encountered,2,11,14,3,10,8,-9,12,The Sun,1919,MISC-MISC,TIME,DET-PROPN,NUM,compound-pobj,appos,DT-NNP,CD,1,1
1,4.0,27,inspired,2,20,25,5,19,1,-18,23,He Done Her Wrong,1930,MISC-MISC-MISC-MISC,TIME,PRON-VERB-DET-NOUN,NUM,pobj-ROOT-poss-dobj,appos,PRP-VBD-PRP$-NN,CD,2,1
0,0.0,32,Club,4,28,31,3,27,0,-24,27,Port Said,Egypt,LOC-LOC,LOC,PROPN-PROPN,PROPN,compound-pobj,npadvmod,NNP-NNP,NNP,6,1
1,4.0,48,is,1,19,16,-3,18,31,-18,15,Al Ahly,Egypt,ORG-ORG,LOC,PROPN-PROPN,PROPN,compound-pobj,pobj,NNP-NNP,NNP,3,1
2,4.0,48,is,1,22,16,-6,21,31,-21,15,Zamalek,Egypt,ORG,LOC,PROPN,PROPN,conj,pobj,NNP,NNP,5,1
3,4.0,48,is,1,24,16,-8,23,31,-23,15,Ismaily,Egypt,ORG,LOC,PROPN,PROPN,conj,pobj,NNP,NNP,6,1
4,4.0,48,is,1,26,16,-10,25,31,-25,15,El Ittihad El Sakandary,Egypt,ORG-ORG-ORG-ORG,LOC,PROPN-PROPN-PROPN-PROPN,PROPN,compound-compound-compound-conj,pobj,NNP-NNP-NNP-NNP,NNP,7,1
0,0.0,34,is,6,2,29,27,1,4,4,23,Little Falls Township Public Schools,New Jersey,ORG-ORG-ORG-ORG-ORG,LOC-LOC,PROPN-PROPN-PROPN-PROPN-PROPN,PROPN-PROPN,compound-compound-compound-compound-nsubj,compound-conj,NNP-NNP-NNP-NNP-NNPS,NNP-NNP,8,1
1,0.0,34,is,6,2,32,30,1,1,4,26,Little Falls Township Public Schools,United States,ORG-ORG-ORG-ORG-ORG,LOC-LOC,PROPN-PROPN-PROPN-PROPN-PROPN,PROPN-PROPN,compound-compound-compound-compound-nsubj,compound-appos,NNP-NNP-NNP-NNP-NNPS,NNP-NNP,8,1
2,0.0,34,is,6,2,26,24,1,7,4,20,Little Falls,Passaic County,LOC-LOC,LOC-LOC,PROPN-PROPN,PROPN-PROPN,compound-pobj,compound-pobj,NNP-NNP,NNP-NNP,7,1
3,0.0,34,is,6,2,32,30,1,1,4,26,Little Falls,United States,LOC-LOC,LOC-LOC,PROPN-PROPN,PROPN-PROPN,compound-pobj,compound-appos,NNP-NNP,NNP-NNP,8,1
4,0.0,34,is,6,26,29,3,25,4,-20,23,Passaic County,New Jersey,LOC-LOC,LOC-LOC,PROPN-PROPN,PROPN-PROPN,compound-pobj,compound-conj,NNP-NNP,NNP-NNP,1,1
5,0.0,34,is,6,26,32,6,25,1,-20,26,Passaic County,United States,LOC-LOC,LOC-LOC,PROPN-PROPN,PROPN-PROPN,compound-pobj,compound-appos,NNP-NNP,NNP-NNP,1,1
6,0.0,34,is,6,29,32,3,28,1,-23,26,New Jersey,United States,LOC-LOC,LOC-LOC,PROPN-PROPN,PROPN-PROPN,compound-conj,compound-appos,NNP-NNP,NNP-NNP,2,1
0,1.0,40,is,1,11,20,9,10,19,-10,19,Institute for Palestine Studies,December 1963,ORG-ORG-ORG-ORG,TIME-TIME,PROPN-ADP-PROPN-PROPN,PROPN-NUM,pobj-prep-compound-pobj,pobj-nummod,NNP-IN-NNP-NNP,NNP-CD,7,1
0,0.0,37,was,12,32,34,2,31,2,-20,22,Shawinigan,Quebec,LOC,LOC,PROPN,PROPN,pobj,conj,NNP,NNP,3,1
1,0.0,37,was,12,32,36,4,31,0,-20,24,Shawinigan,Canada,LOC,LOC,PROPN,PROPN,pobj,appos,NNP,NNP,10,1
2,0.0,37,was,12,34,36,2,33,0,-22,24,Quebec,Canada,LOC,LOC,PROPN,PROPN,conj,appos,NNP,NNP,11,1
0,6.0,37,is,1,7,12,5,6,24,-6,11,Gulf Coast,Louisiana,LOC-LOC,LOC,PROPN-PROPN,PROPN,compound-appos,compound,NNP-NNP,NNP,3,1
0,6.0,17,was,1,5,15,10,4,1,-4,14,Eugène Manet,Édouard Manet,PER-PER,PER-PER,PROPN-PROPN,PROPN-PROPN,compound-pobj,compound-conj,NNP-NNP,NNP-NNP,4,1
0,0.0,23,is,13,1,4,3,0,18,12,-9,Miguel Zavaleta,Buenos Aires,PER-PER,LOC-LOC,PROPN-PROPN,PROPN-PROPN,compound-nsubj,compound-appos,NNP-NNP,NNP-NNP,1,1
1,0.0,23,is,13,1,7,6,0,15,12,-6,Miguel Zavaleta,Argentina,PER-PER,LOC,PROPN-PROPN,PROPN,compound-nsubj,conj,NNP-NNP,NNP,3,1
2,0.0,23,is,13,1,9,8,0,13,12,-4,Miguel Zavaleta,"February 16 , 1955",PER-PER,TIME-TIME-TIME-TIME,PROPN-PROPN,PROPN-NUM-PUNCT-NUM,compound-nsubj,npadvmod-nummod-punct-nummod,NNP-NNP,"NNP-CD-,-CD",3,1
3,0.0,23,is,13,4,7,3,3,15,9,-6,Buenos Aires,Argentina,LOC-LOC,LOC,PROPN-PROPN,PROPN,compound-appos,conj,NNP-NNP,NNP,2,1
4,1.0,18,led,1,11,15,4,10,2,-10,14,Suéter,1981,ORG,TIME,PROPN,NUM,appos,pobj,NNP,CD,4,1
5,7.0,37,had,1,16,22,6,15,14,-15,21,The Warrior and the Sorceress,1984,MISC-MISC-MISC-MISC-MISC,TIME,DET-PROPN-CCONJ-DET-PROPN,NUM,det-dobj-cc-det-conj,pobj,DT-NNP-CC-DT-NNP,CD,2,1
0,1.0,38,played,1,1,14,13,0,23,0,13,Raabe,Minnesota Twins,PER,ORG-ORG,PROPN,PROPN-PROPN,nsubj,compound-appos,NNP,NNP-NNPS,1,1
1,1.0,38,played,1,1,20,19,0,17,0,19,Raabe,Seattle Mariners,PER,ORG-ORG,PROPN,PROPN-PROPN,nsubj,compound-appos,NNP,NNP-NNP,2,1
2,2.0,23,purchased,8,16,20,4,15,2,-8,12,Seibu Lions,Japan Pacific League,ORG-ORG,ORG-ORG-ORG,PROPN-PROPN,PROPN-PROPN-PROPN,compound-pobj,compound-compound-pobj,NNP-NNPS,NNP-NNP-NNP,3,1
3,5.0,16,is,1,9,15,6,8,0,-8,14,Bethel University,Minnesota,ORG-ORG,LOC,PROPN-PROPN,PROPN,compound-pobj,appos,NNP-NNP,NNP,4,1
0,3.0,40,is,2,17,1,-16,16,38,-15,-1,The Hives,Swedish,ORG-ORG,LOC,DET-PROPN,ADJ,det-appos,amod,DT-NNPS,JJ,5,1
0,1.0,11,born,2,5,8,3,4,2,-3,6,Mostaganem,Algeria,LOC,LOC,PROPN,PROPN,pobj,pobj,NNP,NNP,2,1
1,4.0,20,writes,15,15,19,4,14,0,0,4,Tengour,French,PER,MISC,PROPN,PROPN,nsubj,pobj,NNP,NNP,1,1
0,0.0,17,is,11,1,5,4,0,11,10,-6,Victoria Rodríguez,22 April 1995,PER-PER,TIME-TIME-TIME,PROPN-PROPN,NUM-PROPN-NUM,compound-compound,nummod-npadvmod-nummod,NNP-NNP,CD-NNP-CD,3,1
1,0.0,17,is,11,1,9,8,0,7,10,-2,Victoria Rodríguez,Durango City,PER-PER,LOC-LOC,PROPN-PROPN,PROPN-PROPN,compound-compound,compound-pobj,NNP-NNP,NNP-NNP,4,1
2,0.0,17,is,11,1,14,13,0,2,10,3,Victoria Rodríguez,Mexican,PER-PER,LOC,PROPN-PROPN,ADJ,compound-compound,amod,NNP-NNP,JJ,-1,1
3,6.0,18,has,9,3,17,14,2,0,6,8,Mexico,5–6,LOC,NUM,PROPN,NUM,pobj,pobj,NNP,CD,3,1
0,0.0,33,is,17,24,27,3,23,5,-7,10,Georgetown,"Washington , D.C.",LOC,LOC-LOC-LOC,PROPN,PROPN-PUNCT-PROPN,compound,pobj-punct-appos,NNP,"NNP-,-NNP",3,1
1,0.0,33,is,17,24,31,7,23,1,-7,14,Georgetown,United States,LOC,LOC-LOC,PROPN,PROPN-PROPN,compound,compound-appos,NNP,NNP-NNP,3,1
2,3.0,28,is,2,25,9,-16,24,18,-23,7,Van Ness Mausoleum,Oak Hill Cemetery,LOC-LOC-LOC,LOC-LOC-LOC,PROPN-PROPN-PROPN,PROPN-PROPN-PROPN,compound-compound-attr,compound-compound-pobj,NNP-NNP-NNP,NNP-NNP-NNP,8,1
0,1.0,83,been,6,20,17,-3,19,65,-14,11,Turkey,Hatay Province,LOC,LOC-LOC,PROPN,PROPN-PROPN,pobj,compound-pobj,NNP,NNP-NNP,5,1
1,2.0,18,improved,1,11,9,-2,10,8,-10,8,Abdullah Öcalan,PKK,PER-PER,ORG,PROPN-PROPN,PROPN,compound-nsubjpass,compound,NNP-NNP,NNP,1,1
0,0.0,23,is,3,6,3,-3,5,19,-3,0,Brussels,Europe,LOC,LOC,PROPN,PROPN,npadvmod,pobj,NNP,NNP,3,1
0,0.0,22,is,1,1,7,6,0,14,0,6,Balhannah,Adelaide Hills,LOC,LOC-LOC,PROPN,PROPN-PROPN,nsubj,compound-pobj,NNP,NNP-NNP,3,1
1,0.0,22,is,1,1,20,19,0,1,0,19,Balhannah,South Australia,LOC,LOC-LOC,PROPN,PROPN-PROPN,nsubj,compound-pobj,NNP,NNP-NNP,7,1
2,0.0,22,is,1,7,20,13,6,1,-6,19,Adelaide Hills,South Australia,LOC-LOC,LOC-LOC,PROPN-PROPN,PROPN-PROPN,compound-pobj,compound-pobj,NNP-NNP,NNP-NNP,8,1
3,0.0,22,is,1,7,20,13,6,1,-6,19,Adelaide,South Australia,LOC,LOC-LOC,PROPN,PROPN-PROPN,pobj,compound-pobj,NNP,NNP-NNP,8,1
0,3.0,45,expressed,15,12,6,-6,11,38,3,-9,Iranian,Rouhani,LOC,PER,ADJ,PROPN,amod,pobj,JJ,NNP,6,1
1,3.0,45,expressed,15,12,14,2,11,30,3,-1,Iranian,Asghar Farhadi,LOC,PER-PER,ADJ,PROPN-PROPN,amod,compound-appos,JJ,NNP-NNP,1,1
0,0.0,47,was,9,18,24,6,17,22,-9,15,Nara Prefecture,Japan,LOC-LOC,LOC,PROPN-PROPN,PROPN,compound-pobj,appos,NNP-NNP,NNP,3,1
1,2.0,22,extended,2,6,10,4,5,11,-4,8,Matsusaka,Mie Prefecture,LOC,LOC-LOC,PROPN,PROPN-PROPN,pobj,compound-pobj,NNP,NNP-NNP,3,1
2,4.0,38,was,4,29,32,3,28,5,-25,28,Shinto,Japan,ORG,LOC,PROPN,PROPN,compound,pobj,NNP,NNP,1,1
0,0.0,14,is,9,1,6,5,0,7,8,-3,Dirk Van Tichelt,10 June 1984,PER-PER-PER,TIME-TIME-TIME,PROPN-PROPN-PROPN,NUM-PROPN-NUM,compound-compound-nsubj,nummod-npadvmod-nummod,NNP-NNP-NNP,CD-NNP-CD,3,1
1,0.0,14,is,9,1,12,11,0,1,8,3,Dirk Van Tichelt,Belgian,PER-PER-PER,LOC,PROPN-PROPN-PROPN,ADJ,compound-compound-nsubj,amod,NNP-NNP-NNP,JJ,3,1
2,6.0,16,won,8,7,3,-4,6,12,1,-5,Van Tichelt,2016 Summer Olympics,PER-PER,MISC-MISC-MISC,PROPN-PROPN,NUM-PROPN-PROPN,compound-nsubj,nummod-compound-pobj,NNP-NNP,CD-NNP-NNPS,4,1
0,0.0,29,is,9,1,6,5,0,22,8,-3,Abdoulaye Idrissa Maïga,11 March 1958,PER-PER-PER,TIME-TIME-TIME,PROPN-PROPN-PROPN,NUM-PROPN-NUM,compound-compound-nsubj,nummod-npadvmod-nummod,NNP-NNP-NNP,CD-NNP-CD,3,1
1,9.0,6,born,2,1,5,4,0,0,1,3,Maïga,Gao,PER,LOC,PROPN,PROPN,nsubjpass,pobj,NNP,NNP,2,1
0,0.0,18,is,6,2,16,14,1,1,4,10,Take a Look Around,Limp Bizkit,MISC-MISC-MISC-MISC,ORG-ORG,VERB-DET-NOUN-ADV,PROPN-PROPN,csubj-det-compound-dobj,compound-pobj,VB-DT-NN-RB,NNP-NNP,7,1
1,1.0,31,is,1,10,29,19,9,1,-9,28,Chocolate Starfish and the Hot Dog Flavored Water,July 2000,MISC-MISC-MISC-MISC-MISC-MISC-MISC-MISC,TIME-TIME,PROPN-PROPN-CCONJ-DET-PROPN-PROPN-PROPN-PROPN,PROPN-NUM,compound-appos-cc-det-compound-compound-compound-conj,pobj-nummod,NNP-NNP-CC-DT-NNP-NNP-NNP-NNP,NNP-CD,8,1
0,0.0,28,is,5,1,23,22,0,4,4,18,Quaudiophiliac,Barking Pumpkin Records,MISC,ORG-ORG-ORG,PROPN,PROPN-PROPN-PROPN,nsubj,compound-compound-pobj,NNP,NNP-NNP-NNPS,8,1
1,0.0,28,is,5,1,27,26,0,0,4,22,Quaudiophiliac,2004,MISC,TIME,PROPN,NUM,nsubj,pobj,NNP,CD,3,1
2,0.0,28,is,5,4,13,9,3,14,1,8,QuAUDIOPHILIAc,Frank Zappa,MISC,PER-PER,PROPN,PROPN-PROPN,dobj,compound-pobj,NNPS,NNP-NNP,7,1
3,0.0,28,is,5,4,23,19,3,4,1,18,QuAUDIOPHILIAc,Barking Pumpkin Records,MISC,ORG-ORG-ORG,PROPN,PROPN-PROPN-PROPN,dobj,compound-compound-pobj,NNPS,NNP-NNP-NNPS,8,1
4,0.0,28,is,5,4,27,23,3,0,1,22,QuAUDIOPHILIAc,2004,MISC,TIME,PROPN,NUM,dobj,pobj,NNPS,CD,3,1
5,2.0,41,prepared,1,23,28,5,22,12,-22,27,Apostrophe,1974,MISC,TIME,PROPN,NUM,conj,meta,NNP,CD,5,1
6,2.0,41,prepared,1,23,38,15,22,2,-22,37,Apostrophe,DiscReet Records,MISC,MISC-MISC,PROPN,PROPN-PROPN,conj,compound-compound,NNP,NNP-NNPS,8,1
7,3.0,23,includes,14,14,11,-3,13,11,0,-3,Quaudiophiliac,Dweezil Zappa,MISC,PER-PER,PROPN,PROPN-PROPN,nsubj,compound-appos,NNP,NNP-NNP,5,1
8,3.0,23,includes,14,11,3,-8,10,19,3,-11,Dweezil Zappa,Zappa,PER-PER,PER,PROPN-PROPN,PROPN,compound-appos,pobj,NNP-NNP,NNP,5,1
9,5.0,45,included,1,23,26,3,22,18,-22,25,Orchestral Favorites,1979,MISC-MISC,TIME,PROPN-PROPN,NUM,compound-attr,appos,NNP-NNPS,CD,1,1
0,0.0,31,was,15,1,4,3,0,26,14,-11,Mikheil Asatiani,10 May 1882,PER-PER,TIME-TIME-TIME,PROPN-PROPN,NUM-PROPN-NUM,compound-nsubj,nummod-appos-nummod,NNP-NNP,CD-NNP-CD,1,1
1,0.0,31,was,15,1,10,9,0,20,14,-5,Mikheil Asatiani,20 January 1938,PER-PER,TIME-TIME-TIME,PROPN-PROPN,NUM-PROPN-NUM,compound-nsubj,nummod-appos-nummod,NNP-NNP,CD-NNP-CD,1,1
2,0.0,31,was,15,1,30,29,0,0,14,15,Mikheil Asatiani,Georgia,PER-PER,LOC,PROPN-PROPN,PROPN,compound-nsubj,pobj,NNP-NNP,NNP,2,1
0,0.0,27,was,18,1,7,6,0,19,17,-11,Dorothea Christiane Erxleben née Leporin,13 November 1715,PER-PER-PER-PER-PER,TIME-TIME-TIME,PROPN-PROPN-PROPN-VERB-PROPN,NUM-PROPN-NUM,compound-compound-compound-compound-nsubj,nummod-appos-nummod,NNP-NNP-NNP-VBZ-NNP,CD-NNP-CD,3,1
1,0.0,27,was,18,1,7,6,0,19,17,-11,Dorothea Christiane Erxleben née Leporin,13 June 1762,PER-PER-PER-PER-PER,TIME-TIME-TIME,PROPN-PROPN-PROPN-VERB-PROPN,NUM-PROPN-NUM,compound-compound-compound-compound-nsubj,nummod-appos-nummod,NNP-NNP-NNP-VBZ-NNP,CD-NNP-CD,3,1
2,4.0,25,received,14,14,20,6,13,4,0,6,Erxleben,University of Halle,PER,ORG-ORG-ORG,PROPN,PROPN-ADP-PROPN,nsubj,pobj-prep-pobj,NNPS,NNP-IN-NNP,3,1
0,0.0,49,formed,23,2,11,9,1,37,21,-12,Committee of Public Safety,April 1793,ORG-ORG-ORG-ORG,TIME-TIME,PROPN-ADP-PROPN-PROPN,PROPN-NUM,nsubj-prep-compound-pobj,pobj-nummod,NNP-IN-NNP-NNP,NNP-CD,5,1
1,0.0,49,formed,23,2,31,29,1,17,21,8,Committee of Public Safety,France,ORG-ORG-ORG-ORG,LOC,PROPN-ADP-PROPN-PROPN,PROPN,nsubj-prep-compound-pobj,pobj,NNP-IN-NNP-NNP,NNP,3,1
2,0.0,49,formed,23,15,31,16,14,17,8,8,National Convention,France,ORG-ORG,LOC,PROPN-PROPN,PROPN,compound-pobj,pobj,NNP-NNP,NNP,5,1
3,0.0,49,formed,23,34,12,-22,33,36,-11,-11,Reign of Terror,1793,MISC-MISC-MISC,TIME,PROPN-ADP-PROPN,NUM,pobj-prep-pobj,nummod,NNP-IN-NNP,CD,6,1
4,0.0,49,formed,23,34,40,6,33,8,-11,17,Reign of Terror,1794,MISC-MISC-MISC,TIME,PROPN-ADP-PROPN,NUM,pobj-prep-pobj,nummod,NNP-IN-NNP,CD,2,1
5,0.0,49,formed,23,34,47,13,33,1,-11,24,Reign of Terror,French Revolution,MISC-MISC-MISC,MISC-MISC,PROPN-ADP-PROPN,PROPN-PROPN,pobj-prep-pobj,compound-pobj,NNP-IN-NNP,NNP-NNP,7,1
6,5.0,30,added,25,6,11,5,5,18,19,-14,Convention of the Girondins,July 1793,MISC-MISC-MISC-MISC,TIME-TIME,PROPN-ADP-DET-PROPN,PROPN-NUM,pobj-prep-det-pobj,pobj-nummod,NNP-IN-DT-NNPS,NNP-CD,6,1
7,8.0,18,represented,7,4,6,2,3,11,3,-1,Robespierre,July 1794,PER,TIME-TIME,PROPN,PROPN-NUM,pobj,pobj-nummod,NNP,NNP-CD,2,1
0,1.0,17,written,3,11,8,-3,10,8,-8,5,Barry,Bee Gees,PER,ORG-ORG,PROPN,PROPN-PROPN,appos,compound-pobj,NNP,NNP-NNPS,2,1
1,1.0,17,written,3,8,15,7,7,1,-5,12,Bee Gees,Maurice Gibb,ORG-ORG,PER-PER,PROPN-PROPN,PROPN-PROPN,compound-pobj,compound-conj,NNP-NNPS,NNP-NNP,3,1
0,0.0,22,is,5,2,19,17,1,2,3,14,Sheffield School of Architecture,University of Sheffield,ORG-ORG-ORG-ORG,ORG-ORG-ORG,PROPN-PROPN-ADP-PROPN,PROPN-ADP-PROPN,compound-nsubj-prep-pobj,pobj-prep-pobj,NNP-NNP-IN-NNP,NNP-IN-NNP,9,1
0,0.0,21,is,3,17,20,3,16,0,-14,17,Makerere University,Kampala,ORG-ORG,LOC,PROPN-PROPN,PROPN,compound-pobj,pobj,NNP-NNP,NNP,5,1
1,1.0,34,was,1,8,12,4,7,21,-7,11,United Nations,New York,ORG-ORG,LOC-LOC,PROPN-PROPN,PROPN-PROPN,compound-compound,compound-pobj,NNP-NNP,NNP-NNP,3,1
2,2.0,30,was,1,23,26,3,22,3,-22,25,United Nations,New York,ORG-ORG,LOC-LOC,PROPN-PROPN,PROPN-PROPN,compound-pobj,compound-pobj,NNP-NNP,NNP-NNP,2,1
3,4.0,18,worked,1,5,7,2,4,10,-4,6,Nairobi,Kenya,LOC,LOC,PROPN,PROPN,pobj,appos,NNP,NNP,5,1
4,5.0,23,worked,2,8,6,-2,7,16,-6,4,East Timor,UN,LOC-LOC,ORG,PROPN-PROPN,PROPN,compound-pobj,pobj,NNP-NNP,NNP,1,1
0,0.0,44,was,20,29,31,2,28,12,-9,11,Poland,Tadeusz Mazowiecki,LOC,PER-PER,PROPN,PROPN-PROPN,pobj,compound-appos,NNP,NNP-NNP,2,1
1,0.0,44,was,20,29,40,11,28,3,-9,20,Poland,Sejm,LOC,ORG,PROPN,PROPN,pobj,pobj,NNP,NNP,7,1
0,1.0,21,Take,3,4,13,9,3,7,-1,10,Take Over Control,Eva Simons,MISC-MISC-MISC,PER-PER,VERB-PROPN-NOUN,PROPN-PROPN,ROOT-prep-dobj,compound-dobj,VB-NNP-NN,NNP-NNP,4,1
1,4.0,42,contributed,2,8,16,8,7,25,-6,14,Run the World ( Girls ),Beyoncé,MISC-MISC-MISC-MISC-MISC-MISC,PER,VERB-DET-PROPN-PUNCT-PROPN-PUNCT,PROPN,nmod-det-pobj-punct-appos-punct,pobj,VB-DT-NNP--LRB--NNP--RRB-,NNP,9,1
0,0.0,20,was,9,1,6,5,0,13,8,-3,Marian Andrzej Dudziak,2 February 1941,PER-PER-PER,TIME-TIME-TIME,PROPN-PROPN-PROPN,NUM-PROPN-NUM,amod-compound-nsubj,nummod-npadvmod-nummod,NNP-NNP-NNP,CD-NNP-CD,3,1
0,1.0,52,"""",0,24,29,5,23,22,-24,29,Larry Niven,A World Out of Time,PER-PER,MISC-MISC-MISC-MISC-MISC,PROPN-PROPN,DET-NOUN-ADP-ADP-PROPN,compound-poss,det-ROOT-prep-prep-pobj,NNP-NNP,DT-NN-IN-IN-NNP,11,1
1,1.0,52,"""",0,24,39,15,23,12,-24,39,Larry Niven,Integral Trees,PER-PER,MISC-MISC,PROPN-PROPN,PROPN-PROPN,compound-poss,compound-conj,NNP-NNP,NNP-NNP,10,1
2,1.0,52,"""",0,29,35,6,28,16,-29,35,A World Out of Time,1976,MISC-MISC-MISC-MISC-MISC,TIME,DET-NOUN-ADP-ADP-PROPN,NUM,det-ROOT-prep-prep-pobj,appos,DT-NN-IN-IN-NNP,CD,2,1
3,1.0,52,"""",0,39,42,3,38,9,-39,42,Integral Trees,1984,MISC-MISC,TIME,PROPN-PROPN,NUM,compound-conj,appos,NNP-NNP,CD,1,1
4,3.0,24,announced,7,10,7,-3,9,16,-3,0,The Ringworld Throne,Niven,MISC-MISC-MISC,PER,DET-PROPN-PROPN,PROPN,det-compound-dobj,nsubj,DT-NNP-NNP,NNP,3,1
0,0.0,19,is,6,14,18,4,13,0,-8,12,Swedish,Europe,LOC,ORG,ADJ,PROPN,amod,appos,JJ,NNP,7,1
1,8.0,28,Rider,1,10,14,4,9,13,-9,13,Upplands Väsby,Swedish,LOC-LOC,LOC,PROPN-PROPN,ADJ,compound-pobj,amod,NNP-NNP,JJ,1,1
0,11.0,64,formed,2,39,2,-37,38,61,-37,0,Roman,Latin,LOC,MISC,ADJ,ADJ,amod,npadvmod,JJ,JJ,4,1
0,1.0,27,sat,10,10,5,-5,9,21,0,-5,Avnery,Irgun,PER,ORG,PROPN,PROPN,nsubj,pobj,NNP,NNP,2,1
1,3.0,33,became,1,10,15,5,9,17,-9,14,Siege of Beirut,Yassir Arafat,MISC-MISC-MISC,PER-PER,PROPN-ADP-PROPN,PROPN-PROPN,pobj-prep-pobj,compound-dobj,NNP-IN-NNP,NNP-NNP,5,1
0,0.0,17,Do,1,1,15,14,0,1,0,14,You Do Your Thing,Montgomery Gentry,MISC-MISC-MISC-MISC,ORG-ORG,PRON-VERB-DET-NOUN,PROPN-PROPN,nsubj-ROOT-poss-nsubj,compound-pobj,PRP-VBP-PRP$-NN,NNP-NNP,4,1
1,3.0,40,"""",0,36,29,-7,35,10,-36,29,Days of Our Lives,2004,MISC-MISC-MISC-MISC,TIME,NOUN-ADP-DET-NOUN,NUM,appos-prep-poss-pobj,pobj,NNS-IN-PRP$-NNS,CD,4,1
0,0.0,29,is,10,1,20,19,0,8,9,10,All I Want for Christmas Is a Real Good Tan,Kenny Chesney,MISC-MISC-MISC-MISC-MISC-MISC-MISC-MISC-MISC-MISC,PER-PER,DET-PRON-VERB-ADP-PROPN-VERB-DET-PROPN-PROPN-PROPN,PROPN-PROPN,nsubj-nsubj-relcl-prep-pobj-csubj-det-amod-compound-attr,compound-pobj,DT-PRP-VBP-IN-NNP-VBZ-DT-NNP-NNP-NNP,NNP-NNP,7,1
1,4.0,34,Thank,1,2,12,10,1,21,-1,11,Thank God for Kids,Oak Ridge Boys,MISC-MISC-MISC-MISC,ORG-ORG-ORG,VERB-PROPN-ADP-PROPN,PROPN-PROPN-PROPN,ROOT-dobj-prep-pobj,compound-compound-pobj,VBP-NNP-IN-NNPS,NNP-NNP-NNPS,5,1
0,0.0,17,studied,9,14,16,2,13,0,-5,7,KASK,Ghent,ORG,LOC,PROPN,PROPN,pobj,pobj,NNP,NNP,3,1
1,6.0,37,has,13,33,36,3,32,0,-20,23,Workers Party,Belgium,ORG-ORG,LOC,PROPN-PROPN,PROPN,compound-appos,pobj,NNP-NNP,NNP,6,1
0,0.0,26,is,5,2,2,0,1,23,3,-3,Spanish Navy,Spanish Armed Forces,ORG-ORG,ORG-ORG-ORG,ADJ-PROPN,ADJ-PROPN-PROPN,amod-nsubj,compound-compound-pobj,JJ-NNP,JJ-NNP-NNPS,0,1
0,0.0,32,concerned,7,6,30,24,5,1,1,23,Iraq,Saddam Hussein,LOC,PER-PER,PROPN,PROPN-PROPN,pobj,compound-pobj,NNP,NNP-NNP,5,1
1,1.0,34,contributed,2,24,27,3,23,6,-22,25,Tony Blair,Labour Party,PER-PER,ORG-ORG,PROPN-PROPN,PROPN-PROPN,compound-poss,compound-pobj,NNP-NNP,NNP-NNP,1,1
2,3.0,32,was,8,4,21,17,3,10,4,13,Gulf War,Saddam Hussein,MISC-MISC,PER-PER,PROPN-PROPN,PROPN-PROPN,compound-pobj,compound-poss,NNP-NNP,NNP-NNP,8,1
0,0.0,12,born,5,1,7,6,0,4,4,2,Qiu Xiaolong,Shanghai,PER-PER,LOC,PROPN-PROPN,PROPN,compound-nsubj,dobj,NNP-NNP,NNP,3,1
1,0.0,12,born,5,1,11,10,0,0,4,6,Qiu Xiaolong,1953,PER-PER,TIME,PROPN-PROPN,NUM,compound-nsubj,npadvmod,NNP-NNP,CD,2,1
2,1.0,30,is,0,26,29,3,25,0,-26,29,St. Louis,Missouri,LOC-LOC,LOC,PROPN-PROPN,PROPN,compound-pobj,appos,NNP-NNP,NNP,5,1
0,3.0,34,beatified,13,11,16,5,10,17,2,3,John Paul II,Joseph Vaz,PER-PER-PER,PER-PER,PROPN-PROPN-PROPN,PROPN-PROPN,compound-compound-nsubj,compound-dobj,NNP-NNP-NNP,NNP-NNP,3,1
1,5.0,18,canonized,2,8,13,5,7,4,-6,11,Galle Face Green,Colombo,LOC-LOC-LOC,LOC,PROPN-PROPN-PROPN,PROPN,compound-compound-pobj,pobj,NNP-NNP-NNP,NNP,5,1
0,0.0,46,is,7,21,24,3,20,21,-14,17,Lashkar Gah,Helmand Province,LOC-LOC,LOC-LOC,PROPN-PROPN,PROPN-PROPN,compound-pobj,compound-pobj,NNP-NNP,NNP-NNP,2,1
1,0.0,46,is,7,21,27,6,20,18,-14,20,Lashkar Gah,Afghanistan,LOC-LOC,LOC,PROPN-PROPN,PROPN,compound-pobj,appos,NNP-NNP,NNP,6,1
2,3.0,23,built,3,7,20,13,6,2,-4,17,British,Second World War,LOC,MISC-MISC-MISC,ADJ,PROPN-PROPN-PROPN,amod,compound-compound-pobj,JJ,NNP-NNP-NNP,8,1
0,0.0,20,is,1,1,8,7,0,11,0,7,Nakiska,Canada,LOC,LOC,PROPN,PROPN,nsubj,pobj,NNP,NNP,1,1
1,0.0,20,is,1,1,19,18,0,0,0,18,Nakiska,Alberta,LOC,LOC,PROPN,PROPN,nsubj,pobj,NNP,NNP,1,1
2,0.0,20,is,1,8,12,4,7,7,-7,11,Canada,Kananaskis Country,LOC,LOC-LOC,PROPN,PROPN-PROPN,pobj,compound-compound,NNP,NNP-NNP,4,1
3,0.0,20,is,1,8,19,11,7,0,-7,18,Canada,Alberta,LOC,LOC,PROPN,PROPN,pobj,pobj,NNP,NNP,2,1
4,0.0,20,is,1,12,19,7,11,0,-11,18,Kananaskis Country,Alberta,LOC-LOC,LOC,PROPN-PROPN,PROPN,compound-compound,pobj,NNP-NNP,NNP,4,1
0,3.0,30,took,9,9,22,13,8,7,0,13,Tameyoshi,Minamoto no Yoshitomo,PER,PER-PER-PER,PROPN,PROPN-DET-PROPN,nsubj,appos-det-appos,NNP,NNP-DT-NNP,5,1
0,0.0,33,was,14,1,5,4,0,27,13,-9,Beatrix A. Hamburg,"October 19 , 1923",PER-PER-PER,TIME-TIME-TIME-TIME,PROPN-NOUN-PROPN,PROPN-NUM-PUNCT-NUM,compound-compound-nsubj,appos-nummod-punct-nummod,NNP-NN-NNP,"NNP-CD-,-CD",3,1
1,0.0,33,was,14,1,10,9,0,22,13,-4,Beatrix A. Hamburg,"April 15 , 2018",PER-PER-PER,TIME-TIME-TIME-TIME,PROPN-NOUN-PROPN,PROPN-NUM-PUNCT-NUM,compound-compound-nsubj,appos-nummod-punct-nummod,NNP-NN-NNP,"NNP-CD-,-CD",3,1
2,1.0,27,was,1,1,10,9,0,16,0,9,Hamburg,Vassar College,PER,ORG-ORG,PROPN,PROPN-PROPN,nsubj,compound-dobj,NNP,NNP-NNP,3,1
3,1.0,27,was,1,1,24,23,0,2,0,23,Hamburg,Yale Medical School,PER,ORG-ORG-ORG,PROPN,PROPN-PROPN-PROPN,nsubj,compound-compound-dobj,NNP,NNP-NNP-NNP,5,1
4,2.0,9,held,1,1,5,4,0,3,0,4,Hamburg,Stanford,PER,ORG,PROPN,PROPN,nsubj,pobj,NNP,NNP,3,1
5,2.0,9,held,1,1,7,6,0,1,0,6,Hamburg,Harvard,PER,ORG,PROPN,PROPN,nsubj,npadvmod,NNP,NNP,4,1
0,0.0,32,is,1,1,16,15,0,15,0,15,Maple,United States,LOC,LOC-LOC,PROPN,PROPN-PROPN,nsubj,compound-conj,NNP,NNP-NNP,5,1
1,0.0,32,is,1,7,10,3,6,21,-6,9,Crawford Township,Currituck County,LOC-LOC,LOC-LOC,PROPN-PROPN,PROPN-PROPN,compound-pobj,compound-conj,NNP-NNP,NNP-NNP,1,1
2,0.0,32,is,1,7,13,6,6,18,-6,12,Crawford Township,North Carolina,LOC-LOC,LOC-LOC,PROPN-PROPN,PROPN-PROPN,compound-pobj,compound-conj,NNP-NNP,NNP-NNP,2,1
3,0.0,32,is,1,7,16,9,6,15,-6,15,Crawford Township,United States,LOC-LOC,LOC-LOC,PROPN-PROPN,PROPN-PROPN,compound-pobj,compound-conj,NNP-NNP,NNP-NNP,2,1
4,0.0,32,is,1,10,16,6,9,15,-9,15,Currituck County,United States,LOC-LOC,LOC-LOC,PROPN-PROPN,PROPN-PROPN,compound-conj,compound-conj,NNP-NNP,NNP-NNP,1,1
5,0.0,32,is,1,13,16,3,12,15,-12,15,North Carolina,United States,LOC-LOC,LOC-LOC,PROPN-PROPN,PROPN-PROPN,compound-conj,compound-conj,NNP-NNP,NNP-NNP,2,1
0,0.0,12,"""",0,2,11,9,1,0,-2,11,Himnusz,Hungary,MISC,LOC,PROPN,PROPN,nmod,pobj,NNP,NNP,3,1
0,0.0,40,was,17,1,10,9,0,29,16,-7,Khan Abdul Wali Khan,11 January 1917,PER-PER-PER-PER,TIME-TIME-TIME,PROPN-PROPN-PROPN-PROPN,NUM-PROPN-NUM,compound-compound-compound-nsubj,nummod-npadvmod-nummod,NNP-NNP-NNP-NNP,CD-NNP-CD,3,1
1,0.0,40,was,17,1,14,13,0,25,16,-3,Khan Abdul Wali Khan,26 January 2006,PER-PER-PER-PER,TIME-TIME-TIME,PROPN-PROPN-PROPN-PROPN,NUM-PROPN-NUM,compound-compound-compound-nsubj,nummod-appos-nummod,NNP-NNP-NNP-NNP,CD-NNP-CD,4,1
2,0.0,40,was,17,1,37,36,0,2,16,20,Khan Abdul Wali Khan,National Awami Party,PER-PER-PER-PER,ORG-ORG-ORG,PROPN-PROPN-PROPN-PROPN,PROPN-PROPN-PROPN,compound-compound-compound-nsubj,compound-compound-pobj,NNP-NNP-NNP-NNP,NNP-NNP-NNP,8,1
3,1.0,26,was,12,11,8,-3,10,17,1,-4,Wali Khan,Bacha Khan,PER-PER,PER-PER,PROPN-PROPN,PROPN-PROPN,compound-nsubj,compound-appos,NNP-NNP,NNP-NNP,5,1
0,0.0,18,is,6,1,14,13,0,3,5,8,Eijsden,Limburg,LOC,LOC,PROPN,PROPN,pobj,conj,NNP,NNP,7,1
1,0.0,18,is,6,14,17,3,13,0,-8,11,Limburg,Netherlands,LOC,LOC,PROPN,PROPN,conj,appos,NNP,NNP,6,1
2,2.0,22,located,4,11,15,4,10,6,-7,11,Liège - Guillemins,Belgium,LOC-LOC-LOC,LOC,PROPN-PUNCT-PROPN,PROPN,compound-punct-pobj,appos,NNP-HYPH-NNP,NNP,2,1
3,6.0,20,opened,4,13,15,2,12,4,-9,11,Visé,Belgium,LOC,LOC,PROPN,PROPN,nmod,pobj,NNP,NNP,2,1
0,1.0,45,is,0,8,42,34,7,2,-8,42,Agatha Christie,The Boomerang Clue,PER-PER,MISC-MISC-MISC,PROPN-PROPN,DET-PROPN-PROPN,compound-pobj,det-compound-pobj,NNP-NNP,DT-NNP-NNP,11,1
0,0.0,69,is,13,1,6,5,0,62,12,-7,Carole Emily Barrowman,20 April 1959,PER-PER-PER,TIME-TIME-TIME,PROPN-PROPN-PROPN,NUM-PROPN-NUM,compound-compound-nsubj,nummod-npadvmod-nummod,NNP-NNP-NNP,CD-NNP-CD,3,1
1,0.0,69,is,13,1,10,9,0,58,12,-3,Carole Emily Barrowman,Glasgow,PER-PER-PER,LOC,PROPN-PROPN-PROPN,PROPN,compound-compound-nsubj,pobj,NNP-NNP-NNP,NNP,5,1
2,0.0,69,is,13,10,12,2,9,56,3,-1,Glasgow,Scotland,LOC,LOC,PROPN,PROPN,pobj,appos,NNP,NNP,5,1
3,0.0,69,is,13,30,33,3,29,35,-17,20,Alverno College,Milwaukee,ORG-ORG,LOC,PROPN-PROPN,PROPN,compound-pobj,conj,NNP-NNP,NNP,2,1
0,0.0,38,was,10,24,28,4,23,9,-14,18,Daniel García Arteaga,"April 9 , 1926",PER-PER-PER,TIME-TIME-TIME-TIME,PROPN-PROPN-PROPN,PROPN-NUM-PUNCT-NUM,compound-compound-dobj,nmod-nummod-punct-nummod,NNP-NNP-NNP,"NNP-CD-,-CD",4,1
1,0.0,38,was,10,24,33,9,23,4,-14,23,Daniel García Arteaga,"October 31 , 2006",PER-PER-PER,TIME-TIME-TIME-TIME,PROPN-PROPN-PROPN,PROPN-NUM-PUNCT-NUM,compound-compound-dobj,appos-nummod-punct-nummod,NNP-NNP-NNP,"NNP-CD-,-CD",4,1
2,2.0,46,given,2,23,21,-2,22,24,-21,19,Huracán Ramírez,1952,MISC-MISC,TIME,PROPN-PROPN,NUM,compound-nsubj,nummod,NNP-NNP,CD,6,1
0,1.0,45,are,2,25,29,4,24,15,-23,27,Commonwealth,Australia,ORG,LOC,PROPN,PROPN,compound,pobj,NNP,NNP,3,1
0,1.0,25,created,8,11,2,-9,10,22,-3,-6,SCFD,1988,ORG,TIME,PROPN,NUM,dobj,pobj,NNP,CD,3,1
0,0.0,35,"""",0,2,12,10,1,22,-2,12,The Responsibility of Intellectuals,American,MISC-MISC-MISC-MISC,LOC,DET-PROPN-ADP-PROPN,ADJ,det-nsubj-prep-pobj,amod,DT-NNP-IN-NNPS,JJ,5,1
0,0.0,20,is,1,1,19,18,0,0,0,18,Wulsbüttel,Germany,LOC,LOC,PROPN,PROPN,nsubj,appos,NNP,NNP,1,1
1,0.0,20,is,1,13,16,3,12,3,-12,15,Cuxhaven,Lower Saxony,LOC,LOC-LOC,PROPN,PROPN-PROPN,pobj,compound-pobj,NNP,NNP-NNP,3,1
2,0.0,20,is,1,13,19,6,12,0,-12,18,Cuxhaven,Germany,LOC,LOC,PROPN,PROPN,pobj,appos,NNP,NNP,3,1
3,0.0,20,is,1,16,19,3,15,0,-15,18,Lower Saxony,Germany,LOC-LOC,LOC,PROPN-PROPN,PROPN,compound-pobj,appos,NNP-NNP,NNP,4,1
4,2.0,14,belonged,1,5,13,8,4,0,-4,12,Prince - Archbishopric,1180,LOC-LOC-LOC,TIME,PROPN-PUNCT-PROPN,NUM,compound-punct-pobj,pobj,NNP-HYPH-NNP,CD,4,1
5,3.0,46,transformed,7,11,2,-9,10,43,-4,-5,Duchy of Bremen,1648,LOC-LOC-LOC,TIME,PROPN-ADP-PROPN,NUM,pobj-prep-pobj,pobj,NNP-IN-NNP,CD,5,1
6,3.0,46,transformed,7,4,2,-2,3,43,3,-5,Prince - Archbishopric,1648,LOC-LOC-LOC,TIME,PROPN-PUNCT-PROPN,NUM,compound-punct-nsubjpass,pobj,NNP-HYPH-NNP,CD,2,1
7,5.0,52,restored,5,9,20,11,8,31,-4,15,Electorate of Hanover,Kingdom of Hanover,LOC-LOC-LOC,LOC-LOC-LOC,PROPN-ADP-PROPN,PROPN-ADP-PROPN,pobj-prep-pobj,pobj-prep-pobj,NNP-IN-NNP,NNP-IN-NNP,9,1
8,5.0,52,restored,5,9,24,15,8,27,-4,19,Electorate of Hanover,1814,LOC-LOC-LOC,TIME,PROPN-ADP-PROPN,NUM,pobj-prep-pobj,pobj,NNP-IN-NNP,CD,5,1
9,5.0,52,restored,5,20,24,4,19,27,-15,19,Kingdom of Hanover,1814,LOC-LOC-LOC,TIME,PROPN-ADP-PROPN,NUM,pobj-prep-pobj,pobj,NNP-IN-NNP,CD,6,1
0,0.0,17,is,10,1,5,4,0,11,9,-5,Kevin Twaddle,31 October 1971,PER-PER,TIME-TIME-TIME,PROPN-PROPN,NUM-PROPN-NUM,compound-nsubj,nummod-npadvmod-nummod,NNP-NNP,CD-NNP-CD,2,1
1,0.0,17,is,10,1,9,8,0,7,9,-1,Kevin Twaddle,Edinburgh,PER-PER,LOC,PROPN-PROPN,PROPN,compound-nsubj,pobj,NNP-NNP,NNP,1,1
2,0.0,17,is,10,9,13,4,8,3,1,3,Edinburgh,Scottish,LOC,LOC,PROPN,ADJ,pobj,amod,NNP,JJ,4,1
3,1.0,13,began,4,4,11,7,3,1,0,7,Twaddle,Dunbar United,PER,ORG-ORG,PROPN,PROPN-PROPN,nsubj,compound-pobj,NNP,NNP-NNP,3,1
4,8.0,17,signed,1,1,4,3,0,12,0,3,Twaddle,Hearts,PER,ORG,PROPN,PROPN,nsubj,pobj,NNP,NNPS,3,1
5,11.0,13,joined,1,1,6,5,0,6,0,5,Twaddle,Penicuik Athletic,PER,ORG-ORG,PROPN,PROPN-PROPN,nsubj,compound-dobj,NNP,NNP-NNP,1,1
0,0.0,43,is,15,1,26,25,0,16,14,11,Boom Blox Bash Party,EA Los Angeles,MISC-MISC-MISC-MISC,ORG-ORG-ORG,PROPN-PROPN-PROPN-PROPN,PROPN-PROPN-PROPN,compound-compound-compound-nsubj,compound-compound-pobj,NNP-NNP-NNP-NNP,NNP-NNP-NNP,7,1
1,0.0,43,is,15,1,30,29,0,12,14,15,Boom Blox Bash Party,Amblin Entertainment,MISC-MISC-MISC-MISC,ORG-ORG,PROPN-PROPN-PROPN-PROPN,PROPN-PROPN,compound-compound-compound-nsubj,compound-conj,NNP-NNP-NNP-NNP,NNP-NNP,7,1
2,0.0,43,is,15,1,35,34,0,7,14,20,Boom Blox Bash Party,Electronic Arts,MISC-MISC-MISC-MISC,ORG-ORG,PROPN-PROPN-PROPN-PROPN,PROPN-NOUN,compound-compound-compound-nsubj,compound-pobj,NNP-NNP-NNP-NNP,NNP-NNS,7,1
3,0.0,43,is,15,1,39,38,0,3,14,24,Boom Blox Bash Party,Wii,MISC-MISC-MISC-MISC,MISC,PROPN-PROPN-PROPN-PROPN,PROPN,compound-compound-compound-nsubj,compound,NNP-NNP-NNP-NNP,NNP,9,1
4,0.0,43,is,15,1,30,29,0,12,14,15,Boom Blox Smash Party,Amblin Entertainment,MISC-MISC-MISC-MISC,ORG-ORG,PROPN-PROPN-PROPN-PROPN,PROPN-PROPN,compound-compound-compound-appos,compound-conj,NNP-NNP-NNP-NNP,NNP-NNP,7,1
5,0.0,43,is,15,1,35,34,0,7,14,20,Boom Blox Smash Party,Electronic Arts,MISC-MISC-MISC-MISC,ORG-ORG,PROPN-PROPN-PROPN-PROPN,PROPN-NOUN,compound-compound-compound-appos,compound-pobj,NNP-NNP-NNP-NNP,NNP-NNS,7,1
6,0.0,43,is,15,1,39,38,0,3,14,24,Boom Blox Smash Party,Wii,MISC-MISC-MISC-MISC,MISC,PROPN-PROPN-PROPN-PROPN,PROPN,compound-compound-compound-appos,compound,NNP-NNP-NNP-NNP,NNP,9,1
7,1.0,26,is,1,6,23,17,5,2,-5,22,Boom Blox,29 May 2009,MISC-MISC,TIME-TIME-TIME,PROPN-PROPN,NUM-PROPN-NUM,compound-pobj,nummod-pobj-nummod,NNP-NNP,CD-NNP-CD,6,1
8,1.0,26,is,1,6,13,7,5,12,-5,12,Boom Blox,19 May 2009,MISC-MISC,TIME-TIME-TIME,PROPN-PROPN,NUM-PROPN-NUM,compound-pobj,nummod-pobj-nummod,NNP-NNP,CD-NNP-CD,6,1
0,0.0,20,was,11,1,4,3,0,15,10,-7,Anthony Newley,24 September 1931,PER-PER,TIME-TIME-TIME,PROPN-PROPN,NUM-PROPN-NUM,compound-nsubj,nummod-appos-nummod,NNP-NNP,CD-NNP-CD,1,1
1,0.0,20,was,11,1,8,7,0,11,10,-3,Anthony Newley,14 April 1999,PER-PER,TIME-TIME-TIME,PROPN-PROPN,NUM-PROPN-NUM,compound-nsubj,nummod-appos-nummod,NNP-NNP,CD-NNP-CD,1,1
2,0.0,20,was,11,1,14,13,0,5,10,3,Anthony Newley,English,PER-PER,LOC,PROPN-PROPN,ADJ,compound-nsubj,amod,NNP-NNP,JJ,2,1
3,3.0,44,penned,7,10,18,8,9,25,-3,11,Feeling Good,Nina Simone,MISC-MISC,PER-PER,VERB-ADJ,PROPN-PROPN,xcomp-acomp,compound-pobj,VBG-JJ,NNP-NNP,6,1
4,3.0,44,penned,7,37,41,4,36,2,-30,34,Goldfinger,John Barry,MISC,PER-PER,PROPN,PROPN-PROPN,pobj,compound-pobj,NNP,NNP-NNP,3,1
5,4.0,23,received,3,14,21,7,13,1,-11,18,Willy Wonka & the Chocolate Factory,1971,MISC-MISC-MISC-MISC-MISC-MISC,TIME,PROPN-PROPN-CCONJ-DET-PROPN-PROPN,NUM,compound-pobj-cc-det-compound-conj,appos,NNP-NNP-CC-DT-NNP-NNP,CD,6,1
6,6.0,12,inducted,2,1,6,5,0,5,1,4,Newley,Songwriters Hall of Fame,PER,ORG-ORG-ORG-ORG,PROPN,PROPN-PROPN-ADP-PROPN,nsubjpass,compound-pobj-prep-pobj,NNP,NNP-NNP-IN-NNP,3,1
0,4.0,46,Sorry,0,40,44,4,39,1,-40,44,Sticks and Stones,2011,MISC-MISC-MISC,TIME,PROPN-CCONJ-PROPN,NUM,appos-cc-conj,appos,NNPS-CC-NNPS,CD,2,1
1,4.0,46,Sorry,0,40,18,-22,39,27,-40,18,Sticks and Stones,Lloyd,MISC-MISC-MISC,PER,PROPN-CCONJ-PROPN,PROPN,appos-cc-conj,poss,NNPS-CC-NNPS,NNP,8,1
2,7.0,26,embarked,6,10,6,-4,9,19,-4,0,I Wish Tour,Lloyd,MISC-MISC-MISC,PER,PRON-VERB-PROPN,PROPN,nsubj-ROOT-dobj,nsubj,PRP-VBP-NNP,NNP,1,1
0,0.0,48,is,13,1,10,9,0,37,12,-3,Paul MacDermid,Chesley,PER-PER,LOC,PROPN-PROPN,PROPN,compound-nsubj,pobj,NNP-NNP,NNP,4,1
1,0.0,48,is,13,1,36,35,0,11,12,23,Paul MacDermid,Hartford Whalers,PER-PER,ORG-ORG,PROPN-PROPN,PROPN-PROPN,compound-nsubj,compound-pobj,NNP-NNP,NNP-NNP,5,1
2,0.0,48,is,13,1,39,38,0,8,12,26,Paul MacDermid,Winnipeg Jets,PER-PER,ORG-ORG,PROPN-PROPN,PROPN-PROPN,compound-nsubj,compound-conj,NNP-NNP,NNP-NNPS,6,1
3,0.0,48,is,13,1,42,41,0,5,12,29,Paul MacDermid,Washington Capitals,PER-PER,ORG-ORG,PROPN-PROPN,PROPN-PROPN,compound-nsubj,compound-conj,NNP-NNP,NNP-NNPS,7,1
4,0.0,48,is,13,1,46,45,0,1,12,33,Paul MacDermid,Quebec Nordiques,PER-PER,ORG-ORG,PROPN-PROPN,PROPN-PROPN,compound-nsubj,compound-conj,NNP-NNP,NNP-NNP,8,1
5,2.0,15,played,1,8,12,4,7,2,-7,11,Windsor Spitfires,Ontario Hockey League,ORG-ORG,ORG-ORG-ORG,PROPN-PROPN,PROPN-PROPN-PROPN,compound-pobj,compound-compound-pobj,NNP-NNPS,NNP-NNP-NNP,3,1
6,3.0,18,selected,6,5,10,5,4,7,1,4,Lane,Boston Bruins,PER,ORG-ORG,PROPN,PROPN-PROPN,nsubjpass,compound-pobj,NNP,NNP-NNP,3,1
0,0.0,22,is,2,1,5,4,0,16,1,3,Solid Rock,1972,MISC-MISC,TIME,PROPN-PROPN,NUM,compound-nsubj,nummod,NNP-NNP,CD,2,1
1,0.0,22,is,2,1,14,13,0,7,1,12,Solid Rock,Motown,MISC-MISC,ORG,PROPN-PROPN,PROPN,compound-nsubj,nmod,NNP-NNP,NNP,7,1
2,0.0,22,is,2,1,20,19,0,1,1,18,Solid Rock,Norman Whitfield,MISC-MISC,PER-PER,PROPN-PROPN,PROPN-PROPN,compound-nsubj,compound-pobj,NNP-NNP,NNP-NNP,9,1
3,2.0,50,quit,36,7,11,4,6,38,29,-25,Temptations,Melvin Franklin,ORG,PER-PER,PROPN,PROPN-PROPN,compound,compound-conj,NNPS,NNP-NNP,2,1
4,5.0,24,is,12,8,4,-4,7,19,4,-8,It 's Summer,Temptations,MISC-MISC-MISC,ORG,PRON-VERB-NOUN,PROPN,nsubj-ccomp-attr,compound,PRP-VBZ-NN,NNPS,2,1
0,0.0,35,is,4,1,17,16,0,17,3,13,The Shire of Livingstone,Queensland,LOC-LOC-LOC-LOC,LOC,DET-PROPN-ADP-PROPN,PROPN,det-nsubj-prep-pobj,conj,DT-NNP-IN-NNP,NNP,8,1
1,0.0,35,is,4,1,21,20,0,13,3,17,The Shire of Livingstone,Australia,LOC-LOC-LOC-LOC,LOC,DET-PROPN-ADP-PROPN,PROPN,det-nsubj-prep-pobj,appos,DT-NNP-IN-NNP,NNP,3,1
2,0.0,35,is,4,17,21,4,16,13,-13,17,Queensland,Australia,LOC,LOC,PROPN,PROPN,conj,appos,NNP,NNP,7,1
3,0.0,35,is,4,17,34,17,16,0,-13,30,Queensland,Rockhampton,LOC,LOC,PROPN,PROPN,conj,pobj,NNP,NNP,8,1
4,1.0,41,covers,11,1,25,24,0,15,10,14,The shire,1879,LOC-LOC,TIME,DET-NOUN,NUM,det-nsubj,pobj,DT-NN,CD,4,1
5,2.0,20,established,5,1,8,7,0,11,4,3,The Shire,1 January 2014,LOC-LOC,TIME-TIME-TIME,DET-PROPN,NUM-PROPN-NUM,det-nsubjpass,nummod-pobj-nummod,DT-NNP,CD-NNP-CD,4,1
0,3.0,30,Dolleman,4,1,7,6,0,22,3,3,Hendrik ( Henry ) Dolleman,1905,PER-PER-PER-PER-PER,TIME,PROPN-PUNCT-PROPN-PUNCT-PROPN,NUM,nmod-punct-nmod-punct-ROOT,npadvmod,NNP--LRB--NNP--RRB--NNP,CD,4,1
1,6.0,33,won,14,9,12,3,8,20,5,-2,Westover Field,Massachusetts,LOC-LOC,LOC,PROPN-PROPN,PROPN,compound-pobj,appos,NNP-NNP,NNP,4,1
0,0.0,37,is,9,2,32,30,1,4,7,23,Nuthin' but a ' G ' Thang,The Chronic,MISC-MISC-MISC-MISC-MISC-MISC-MISC,MISC-MISC,PUNCT-CCONJ-DET-PUNCT-NOUN-PUNCT-PROPN,DET-PROPN,nsubj-cc-det-punct-nmod-punct-conj,det-appos,",-CC-DT-``-NN-''-NNP",DT-NNP,10,1
1,2.0,65,wit,34,2,27,25,1,37,32,-7,Nuthin' but a ' G ' Thang,The Chronic,MISC-MISC-MISC-MISC-MISC-MISC-MISC,ORG-ORG,PUNCT-CCONJ-DET-PUNCT-NOUN-PUNCT-PROPN,DET-PROPN,nsubj-cc-det-punct-nmod-punct-conj,det-poss,",-CC-DT-``-NN-''-NNP",DT-NNP,5,1
2,0.0,37,is,9,2,35,33,1,1,7,26,Nuthin' but a ' G ' Thang,1992,MISC-MISC-MISC-MISC-MISC-MISC-MISC,TIME,PUNCT-CCONJ-DET-PUNCT-NOUN-PUNCT-PROPN,NUM,nsubj-cc-det-punct-nmod-punct-conj,appos,",-CC-DT-``-NN-''-NNP",CD,11,1
3,0.0,37,is,9,32,35,3,31,1,-23,26,The Chronic,1992,MISC-MISC,TIME,DET-PROPN,NUM,det-appos,appos,DT-NNP,CD,1,1
4,2.0,65,wit,34,55,27,-28,54,37,-21,-7,Let Me Ride,The Chronic,MISC-MISC-MISC,ORG-ORG,VERB-PRON-VERB,DET-PROPN,conj-compound-nsubj,det-poss,VB-PRP-VB,DT-NNP,8,1
5,2.0,65,wit,34,21,24,3,20,40,13,-10,Informer,Snow,MISC,PER,PROPN,PROPN,pobj,pobj,NNP,NNP,3,1
0,0.0,29,"""",0,2,13,11,1,15,-2,13,Cool Places,Sparks,MISC-MISC,ORG,PROPN-PROPN,PROPN,compound-nsubj,pobj,NNP-NNPS,NNPS,4,1
1,0.0,29,"""",0,2,27,25,1,1,-2,27,Cool Places,Jane Wiedlin,MISC-MISC,PER-PER,PROPN-PROPN,PROPN-PROPN,compound-nsubj,compound-dobj,NNP-NNPS,NNP-NNP,5,1
0,0.0,22,Parker,2,1,5,4,0,16,1,3,Isaac Charles Parker,"October 15 , 1838",PER-PER-PER,TIME-TIME-TIME-TIME,PROPN-PROPN-PROPN,PROPN-NUM-PUNCT-NUM,compound-compound-ROOT,appos-nummod-punct-npadvmod,NNP-NNP-NNP,"NNP-CD-,-CD",3,1
1,1.0,34,served,1,4,9,5,3,24,-3,8,the United States,Missouri,LOC-LOC-LOC,LOC,DET-PROPN-PROPN,PROPN,det-compound-compound,poss,DT-NNP-NNP,NNP,6,1
0,0.0,11,Blilie,2,1,5,4,0,5,1,3,Mathias Larsen Blilie,2 October 1854,PER-PER-PER,TIME-TIME-TIME,PROPN-PROPN-PROPN,NUM-PROPN-NUM,compound-compound-ROOT,nummod-appos-nummod,NNP-NNP-NNP,CD-NNP-CD,2,1
0,0.0,22,is,3,12,14,2,11,7,-9,11,London,England,LOC,LOC,PROPN,PROPN,pobj,npadvmod,NNP,NNP,3,1
0,0.0,23,is,2,1,12,11,0,10,1,10,Spare Parts,Status Quo,MISC-MISC,ORG-ORG,PROPN-PROPN,PROPN-PROPN,compound-nsubj,compound-pobj,NNP-NNPS,NNP-NNP,5,1
0,0.0,10,is,3,1,9,8,0,0,2,6,Culiacán,Mexico,LOC,LOC,PROPN,PROPN,nsubj,pobj,NNP,NNP,2,1
0,0.0,27,is,9,1,22,21,0,4,8,13,Charles Olmeus,1976 Olympic Games,PER-PER,MISC-MISC-MISC,PROPN-PROPN,NUM-PROPN-PROPN,compound-nsubj,nummod-compound-pobj,NNP-NNP,CD-NNP-NNPS,6,1
1,0.0,27,is,9,22,26,4,21,0,-13,17,1976 Olympic Games,Montreal,MISC-MISC-MISC,LOC,NUM-PROPN-PROPN,PROPN,nummod-compound-pobj,pobj,CD-NNP-NNPS,NNP,6,1
2,2.0,26,finished,1,17,20,3,16,5,-16,19,Chris McCubbins,Canada,PER-PER,LOC,PROPN-PROPN,PROPN,compound-pobj,pobj,NNP-NNP,NNP,2,1
3,2.0,26,finished,1,9,12,3,8,13,-8,11,Carlos Lopes,Portugal,PER-PER,LOC,PROPN-PROPN,PROPN,compound-appos,pobj,NNP-NNP,NNP,4,1
4,5.0,57,standing,54,26,12,-14,25,44,28,-42,Baby Doc Duvalier,Haitian,PER-PER-PER,LOC,PROPN-PROPN-PROPN,ADJ,compound-compound-compound,amod,NNP-NNP-NNP,JJ,8,1
0,0.0,28,Pole,3,14,14,0,13,13,-11,11,Tunisian,Tunisian Constituent Assembly,LOC,ORG-ORG-ORG,ADJ,ADJ-PROPN-PROPN,amod,compound-compound-compound,JJ,JJ-NNP-NNP,0,1
1,0.0,28,Pole,3,14,25,11,13,2,-11,22,Tunisian Constituent Assembly,23 October 2011,ORG-ORG-ORG,TIME-TIME-TIME,ADJ-PROPN-PROPN,NUM-PROPN-NUM,compound-compound-compound,nummod-pobj-nummod,JJ-NNP-NNP,CD-NNP-CD,6,1
2,9.0,35,became,22,30,34,4,29,0,-8,12,Union for Tunisia,2013,ORG-ORG-ORG,TIME,PROPN-ADP-PROPN,NUM,oprd-prep-pobj,pobj,NNP-IN-NNP,CD,6,1
0,0.0,12,is,1,9,11,2,8,0,-8,10,London,England,LOC,LOC,PROPN,PROPN,pobj,appos,NNP,NNP,5,1
1,1.0,27,forms,1,9,11,2,8,15,-8,10,Kingston,Thames,LOC,LOC,PROPN,PROPN,pobj,pobj,NNP,NNP,2,1
0,0.0,52,is,17,39,51,12,38,0,-22,34,Kafr Kanna,Israel,LOC-LOC,LOC,PROPN-PROPN,PROPN,compound-pobj,pobj,NNP-NNP,NNP,14,1
1,0.0,52,is,17,5,51,46,4,0,12,34,Cana,Israel,LOC,LOC,PROPN,PROPN,appos,pobj,NNP,NNP,3,1
2,0.0,52,is,17,47,51,4,46,0,-30,34,Lower Galilee,Israel,LOC-LOC,LOC,PROPN-PROPN,PROPN,compound-pobj,pobj,NNP-NNP,NNP,3,1
3,3.0,22,owned,3,7,16,9,6,5,-4,13,Custody of the Holy Land,Franciscan,ORG-ORG-ORG-ORG-ORG,ORG,PROPN-ADP-DET-PROPN-PROPN,ADJ,pobj-prep-det-compound-pobj,amod,NNP-IN-DT-NNP-NNP,JJ,4,1
0,0.0,23,is,9,2,22,20,1,0,7,13,Roman Catholic Metropolitan Archdiocese of Nanking,China,LOC-LOC-LOC-LOC-LOC-LOC,LOC,ADJ-PROPN-PROPN-PROPN-ADP-PROPN,PROPN,compound-compound-compound-nsubj-prep-pobj,pobj,JJ-NNP-NNP-NNP-IN-NNP,NNP,3,1
0,0.0,14,is,2,1,5,4,0,8,1,3,Aesop Rock,American,PER-PER,LOC,PROPN-PROPN,ADJ,compound-nsubj,amod,NNP-NNP,JJ,3,1
1,0.0,14,is,2,1,12,11,0,1,1,10,Aesop Rock,Rhymesayers Entertainment,PER-PER,ORG-ORG,PROPN-PROPN,PROPN-PROPN,compound-nsubj,compound-pobj,NNP-NNP,NNP-NNP,5,1
2,4.0,38,signed,5,4,14,10,3,23,1,9,Aesop Rock,Definitive Jux,PER-PER,ORG-ORG,PROPN-PROPN,PROPN-PROPN,compound-nsubj,compound-appos,NNP-NNP,NNP-NNP,3,1
3,4.0,38,signed,5,22,25,3,21,12,-17,20,Labor Days,2001,MISC-MISC,TIME,PROPN-PROPN,NUM,compound-dobj,pobj,NNP-NNPS,CD,3,1
4,4.0,38,signed,5,22,27,5,21,10,-17,22,Labor Days,Bazooka Tooth,MISC-MISC,MISC-MISC,PROPN-PROPN,PROPN-PROPN,compound-dobj,compound-npadvmod,NNP-NNPS,NNP-NNP,5,1
5,4.0,38,signed,5,27,30,3,26,7,-22,25,Bazooka Tooth,2003,MISC-MISC,TIME,PROPN-PROPN,NUM,compound-npadvmod,pobj,NNP-NNP,CD,2,1
6,4.0,38,signed,5,33,37,4,32,0,-28,32,None Shall Pass,2007,MISC-MISC-MISC,TIME,NOUN-PROPN-VERB,NUM,compound-compound-conj,pobj,NN-NNP-VB,CD,2,1
7,5.0,10,released,3,1,6,5,0,3,2,3,Skelethon,Rhymesayers Entertainment,MISC,ORG-ORG,PROPN,PROPN-PROPN,nsubjpass,compound-pobj,NNP,NNP-NNP,3,1
0,3.0,52,formed,1,14,18,4,13,33,-13,17,Los Gringos Locos,Eddie Guerrero,ORG-ORG-ORG,PER-PER,PROPN-PROPN-PROPN,PROPN-PROPN,compound-compound-dobj,compound-appos,NNP-NNP-NNP,NNP-NNP,2,1
0,0.0,25,"""",0,2,22,20,1,2,-2,22,I Saved the World Today,Peace,MISC-MISC-MISC-MISC-MISC,MISC,PRON-VERB-DET-PROPN-NOUN,PROPN,nsubj-ccomp-det-dobj-npadvmod,appos,PRP-VBD-DT-NNP-NN,NNP,4,1
1,0.0,25,"""",0,2,24,22,1,0,-2,24,I Saved the World Today,1999,MISC-MISC-MISC-MISC-MISC,TIME,PRON-VERB-DET-PROPN-NOUN,NUM,nsubj-ccomp-det-dobj-npadvmod,pobj,PRP-VBD-DT-NNP-NN,CD,2,1
2,0.0,25,"""",0,22,24,2,21,0,-22,24,Peace,1999,MISC,TIME,PROPN,NUM,appos,pobj,NNP,CD,4,1
0,0.0,26,Gett,0,1,21,20,0,4,-1,21,Gett : The Trial of Viviane Amsalem,Ronit Elkabetz,MISC-MISC-MISC-MISC-MISC-MISC-MISC,PER-PER,PROPN-PUNCT-DET-PROPN-ADP-PROPN-PROPN,PROPN-PROPN,ROOT-punct-det-nsubj-prep-compound-pobj,compound-pobj,NNP-:-DT-NNP-IN-NNP-NNP,NNP-NNP,6,1
1,0.0,26,Gett,0,1,24,23,0,1,-1,24,Gett : The Trial of Viviane Amsalem,Shlomi Elkabetz,MISC-MISC-MISC-MISC-MISC-MISC-MISC,PER-PER,PROPN-PUNCT-DET-PROPN-ADP-PROPN-PROPN,PROPN-PROPN,ROOT-punct-det-nsubj-prep-compound-pobj,compound-conj,NNP-:-DT-NNP-IN-NNP-NNP,NNP-NNP,7,1
0,5.0,10,premiered,1,1,4,3,0,5,0,3,Hydrozagadka,30 April 1971,MISC,TIME-TIME-TIME,PROPN,NUM-PROPN-NUM,nsubj,nummod-pobj-nummod,NNP,CD-NNP-CD,2,1
0,4.0,42,features,4,23,26,3,22,15,-19,22,Yale University,New Haven,ORG-ORG,LOC-LOC,PROPN-PROPN,PROPN-PROPN,compound-nsubj,compound-pobj,NNP-NNP,NNP-NNP,2,1
1,4.0,42,features,4,1,4,3,0,37,3,0,Oberlin College,Ohio,ORG-ORG,LOC,PROPN-PROPN,PROPN,compound-nsubj,pobj,NNP-NNP,NNP,1,1
0,0.0,21,is,5,1,17,16,0,3,4,12,Strathcona - Westmin Provincial Park,British Columbia,LOC-LOC-LOC-LOC-LOC,LOC-LOC,PROPN-PUNCT-PROPN-PROPN-PROPN,PROPN-PROPN,compound-punct-compound-compound-nsubj,compound-pobj,NNP-HYPH-NNP-NNP-NNP,NNP-NNP,8,1
1,0.0,21,is,5,1,20,19,0,0,4,15,Strathcona - Westmin Provincial Park,Canada,LOC-LOC-LOC-LOC-LOC,LOC,PROPN-PUNCT-PROPN-PROPN-PROPN,PROPN,compound-punct-compound-compound-nsubj,appos,NNP-HYPH-NNP-NNP-NNP,NNP,4,1
2,0.0,21,is,5,14,17,3,13,3,-9,12,Vancouver Island,British Columbia,LOC-LOC,LOC-LOC,PROPN-PROPN,PROPN-PROPN,compound-pobj,compound-pobj,NNP-NNP,NNP-NNP,2,1
3,0.0,21,is,5,14,20,6,13,0,-9,15,Vancouver Island,Canada,LOC-LOC,LOC,PROPN-PROPN,PROPN,compound-pobj,appos,NNP-NNP,NNP,4,1
4,0.0,21,is,5,17,20,3,16,0,-12,15,British Columbia,Canada,LOC-LOC,LOC,PROPN-PROPN,PROPN,compound-pobj,appos,NNP-NNP,NNP,6,1
0,0.0,26,was,13,1,6,5,0,19,12,-7,Raymond Claude Ferdinand Aron,14 March 1905,PER-PER-PER-PER,TIME-TIME-TIME,PROPN-PROPN-PROPN-PROPN,NUM-PROPN-NUM,compound-compound-compound-nsubj,nummod-npadvmod-nummod,NNP-NNP-NNP-NNP,CD-NNP-CD,3,1
1,0.0,26,was,13,1,10,9,0,15,12,-3,Raymond Claude Ferdinand Aron,17 October 1983,PER-PER-PER-PER,TIME-TIME-TIME,PROPN-PROPN-PROPN-PROPN,NUM-PROPN-NUM,compound-compound-compound-nsubj,nummod-npadvmod-nummod,NNP-NNP-NNP-NNP,CD-NNP-CD,4,1
2,1.0,49,known,3,33,20,-13,32,28,-30,17,Aron,Karl Marx,PER,PER-PER,PROPN,PROPN-PROPN,nsubj,compound-poss,NNP,NNP-NNP,3,1
0,0.0,15,is,7,1,1,0,0,13,6,-6,Beijing Institute of Fashion Technology,Beijing,ORG-ORG-ORG-ORG-ORG,LOC,PROPN-PROPN-ADP-PROPN-PROPN,PROPN,compound-nsubj-prep-compound-pobj,pobj,NNP-NNP-IN-NNP-NNP,NNP,0,1
1,0.0,15,is,7,1,14,13,0,0,6,7,Beijing Institute of Fashion Technology,China,ORG-ORG-ORG-ORG-ORG,LOC,PROPN-PROPN-ADP-PROPN-PROPN,PROPN,compound-nsubj-prep-compound-pobj,appos,NNP-NNP-IN-NNP-NNP,NNP,2,1
2,0.0,15,is,7,1,14,13,0,0,6,7,Beijing,China,LOC,LOC,PROPN,PROPN,pobj,appos,NNP,NNP,2,1
0,3.0,19,modelled,2,1,13,12,0,5,1,11,Surer,Marc Surer,PER,PER-PER,PROPN,PROPN-PROPN,nsubj,compound-pobj,NNP,NNP-NNP,5,1
0,0.0,16,was,9,1,14,13,0,1,8,5,Charles Abraham Chasselat,Pierre Chasselat,PER-PER-PER,PER-PER,PROPN-PROPN-PROPN,PROPN-PROPN,compound-compound-nsubj,compound-pobj,NNP-NNP-NNP,NNP-NNP,5,1
0,0.0,35,is,2,1,21,20,0,13,1,19,Analog Man,Joe Walsh,MISC-MISC,PER-PER,PROPN-PROPN,PROPN-PROPN,compound-nsubj,compound-pobj,NNP-NNP,NNP-NNP,3,1
1,0.0,35,is,2,21,34,13,20,0,-19,32,Joe Walsh,Eagles,PER-PER,ORG,PROPN-PROPN,PROPN,compound-pobj,pobj,NNP-NNP,NNPS,3,1
2,3.0,44,features,3,9,12,3,8,31,-6,9,Beatles,Ringo Starr,ORG,PER-PER,PROPN,PROPN-PROPN,compound,compound-appos,NNPS,NNP-NNP,1,1
0,0.0,15,is,10,1,5,4,0,9,9,-5,Miina Turunen,1973,PER-PER,TIME,PROPN-PROPN,NUM,compound-nsubj,npadvmod,NNP-NNP,CD,2,1
1,0.0,15,is,10,1,7,6,0,7,9,-3,Miina Turunen,Kouvola,PER-PER,LOC,PROPN-PROPN,PROPN,compound-nsubj,pobj,NNP-NNP,NNP,4,1
2,0.0,15,is,10,1,9,8,0,5,9,-1,Miina Turunen,Finland,PER-PER,LOC,PROPN-PROPN,PROPN,compound-nsubj,appos,NNP-NNP,NNP,1,1
3,0.0,15,is,10,7,9,2,6,5,3,-1,Kouvola,Finland,LOC,LOC,PROPN,PROPN,pobj,appos,NNP,NNP,5,1
4,2.0,40,began,1,13,7,-6,12,32,-12,6,Sirpaleita,1996,MISC,TIME,PROPN,NUM,appos,pobj,NNP,CD,2,1
5,2.0,40,began,1,21,26,5,20,13,-20,25,Sibelius,Timo Koivusalo,MISC,PER-PER,PROPN,PROPN-PROPN,pobj,compound-pobj,NNP,NNP-NNP,2,1
6,2.0,40,began,1,21,32,11,20,7,-20,31,Sibelius,Martti Suosalo,MISC,PER-PER,PROPN,PROPN-PROPN,pobj,compound-pobj,NNP,NNP-NNP,5,1
7,2.0,40,began,1,21,35,14,20,4,-20,34,Sibelius,Heikki Nousiainen,MISC,PER-PER,PROPN,PROPN-PROPN,pobj,compound-conj,NNP,NNP-NNP,6,1
8,2.0,40,began,1,21,38,17,20,1,-20,37,Sibelius,Seela Sella,MISC,PER-PER,PROPN,PROPN-PROPN,pobj,compound-conj,NNP,NNP-NNP,7,1
9,2.0,40,began,1,26,24,-2,25,15,-25,23,Timo Koivusalo,Finnish,PER-PER,LOC,PROPN-PROPN,ADJ,compound-pobj,amod,NNP-NNP,JJ,1,1
10,3.0,36,appeared,3,27,34,7,26,1,-24,31,A Tale of Love and Darkness,Amos Oz,MISC-MISC-MISC-MISC-MISC-MISC,PER-PER,DET-PROPN-ADP-PROPN-CCONJ-PROPN,PROPN-PROPN,det-pobj-prep-pobj-cc-conj,compound-pobj,DT-NNP-IN-NNP-CC-NNP,NNP-NNP,4,1
0,0.0,30,is,2,1,5,4,0,24,1,3,Stephanie McKay,American,PER-PER,LOC,PROPN-PROPN,ADJ,compound-nsubj,amod,NNP-NNP,JJ,3,1
1,0.0,30,is,2,12,14,2,11,15,-10,12,Bronx,New York,LOC,LOC-LOC,PROPN,PROPN-PROPN,pobj,compound-pobj,NNP,NNP-NNP,1,1
2,2.0,40,released,2,8,10,2,7,29,-6,8,McKay,2003,MISC,TIME,PROPN,NUM,appos,appos,NNP,CD,2,1
3,2.0,40,released,2,13,19,6,12,20,-11,17,Tell it Like it Is,2008,MISC-MISC-MISC-MISC-MISC,TIME,VERB-PRON-ADP-PRON-VERB,NUM,conj-dobj-mark-nsubj-ccomp,attr,VB-PRP-IN-PRP-VBZ,CD,3,1
0,0.0,44,was,11,1,8,7,0,35,10,-3,Thelma Scott,23 November 2006,PER-PER,TIME-TIME-TIME,PROPN-PROPN,NUM-PROPN-NUM,compound-nsubj,nummod-appos-nummod,NNP-NNP,CD-NNP-CD,1,1
0,0.0,25,is,10,1,5,4,0,19,9,-5,Thomas Köner,1965,PER-PER,TIME,PROPN-PROPN,NUM,compound-nsubj,npadvmod,NNP-NNP,CD,2,1
1,0.0,25,is,10,1,7,6,0,17,9,-3,Thomas Köner,Bochum,PER-PER,LOC,PROPN-PROPN,PROPN,compound-nsubj,pobj,NNP-NNP,NNP,4,1
2,0.0,25,is,10,7,9,2,6,15,3,-1,Bochum,Germany,LOC,LOC,PROPN,PROPN,pobj,appos,NNP,NNP,4,1
0,0.0,50,was,15,2,47,45,1,2,13,32,Hudson Bay expedition,French Royal Navy,MISC-MISC-MISC,ORG-ORG-ORG,PROPN-PROPN-NOUN,PROPN-PROPN-PROPN,compound-compound-nsubj,compound-compound-pobj,NNP-NNP-NN,NNP-NNP-NNP,8,1
1,0.0,50,was,15,6,47,41,5,2,9,32,"Jean - François de Galaup , comte de La Pérouse",French Royal Navy,PER-PER-PER-PER-PER-PER-PER-PER-PER-PER,ORG-ORG-ORG,PROPN-PUNCT-PROPN-PROPN-PROPN-PUNCT-NOUN-PROPN-PROPN-PROPN,PROPN-PROPN-PROPN,compound-punct-compound-compound-pobj-punct-compound-compound-compound-nsubj,compound-compound-pobj,"NNP-HYPH-NNP-NNP-NNP-,-NNS-NNP-NNP-NNP",NNP-NNP-NNP,10,1
2,2.0,38,sailed,17,7,11,4,6,26,10,-6,Marquis de Castries,France,PER-PER-PER,LOC,PROPN-PROPN-PROPN,PROPN,compound-nmod-pobj,poss,NNP-NNP-NNP,NNP,4,1
0,0.0,20,is,4,2,17,15,1,2,2,13,Hockhocking Adena Bikeway,the United States,LOC-LOC-LOC,LOC-LOC-LOC,PROPN-PROPN-PROPN,DET-PROPN-PROPN,compound-compound-nsubj,det-compound-pobj,NNP-NNP-NNP,DT-NNP-NNP,6,1
1,0.0,20,is,4,11,14,3,10,5,-7,10,Athens County,Ohio,LOC-LOC,LOC,PROPN-PROPN,PROPN,compound-pobj,appos,NNP-NNP,NNP,3,1
2,0.0,20,is,4,11,17,6,10,2,-7,13,Athens County,the United States,LOC-LOC,LOC-LOC-LOC,PROPN-PROPN,DET-PROPN-PROPN,compound-pobj,det-compound-pobj,NNP-NNP,DT-NNP-NNP,5,1
3,0.0,20,is,4,14,17,3,13,2,-10,13,Ohio,the United States,LOC,LOC-LOC-LOC,PROPN,DET-PROPN-PROPN,appos,det-compound-pobj,NNP,DT-NNP-NNP,4,1
0,6.0,51,joined,8,13,15,2,12,35,-5,7,Yardbirds,Keith Relf,ORG,PER-PER,PROPN,PROPN-PROPN,compound,compound-pobj,NNPS,NNP-NNP,1,1
0,1.0,25,is,1,5,7,2,4,17,-4,6,Florida,the United States,LOC,LOC-LOC-LOC,PROPN,DET-PROPN-PROPN,pobj,det-compound-pobj,NNP,DT-NNP-NNP,2,1
1,1.0,25,is,1,5,16,11,4,8,-4,15,Florida,Hillsborough,LOC,LOC,PROPN,PROPN,pobj,pobj,NNP,NNP,5,1
2,1.0,25,is,1,5,18,13,4,6,-4,17,Florida,Hardee,LOC,LOC,PROPN,PROPN,pobj,conj,NNP,NNP,6,1
3,1.0,25,is,1,5,20,15,4,4,-4,19,Florida,Manatee,LOC,LOC,PROPN,PROPN,pobj,conj,NNP,NNP,7,1
4,1.0,25,is,1,5,23,18,4,1,-4,22,Florida,Pinellas Counties,LOC,LOC-LOC,PROPN,PROPN-PROPN,pobj,compound-conj,NNP,NNP-NNPS,7,1
5,5.0,13,found,2,5,12,7,4,0,-3,10,Bell Creek Nature Preserve,Florida,LOC-LOC-LOC-LOC,LOC,PROPN-PROPN-PROPN-PROPN,PROPN,compound-compound-compound-pobj,appos,NNP-NNP-NNP-NNP,NNP,4,1
0,0.0,24,is,3,18,22,4,17,1,-15,19,Semitic,Afroasiatic,MISC,MISC,ADJ,ADJ,amod,amod,JJ,JJ,2,1
0,0.0,45,was,13,1,9,8,0,35,12,-4,David Joseph Marks,6 October 2017,PER-PER-PER,TIME-TIME-TIME,PROPN-PROPN-PROPN,NUM-PROPN-NUM,compound-compound-nsubj,nummod-npadvmod-nummod,NNP-NNP-NNP,CD-NNP-CD,3,1
1,1.0,31,born,3,1,19,18,0,11,2,16,David Marks,née Lovén,PER-PER,PER-PER,PROPN-PROPN,ADJ-PROPN,compound-nsubjpass,advmod-appos,NNP-NNP,JJ-NNP,5,1
2,1.0,31,born,3,10,12,2,9,18,-7,9,Stockholm,Sweden,LOC,LOC,PROPN,PROPN,pobj,conj,NNP,NNP,3,1
0,5.0,17,attempts,7,3,5,2,2,11,4,-2,Fauxlivia,Anna Torv,PER,PER-PER,PROPN,PROPN-PROPN,nsubj,compound-appos,NNP,NNP-NNP,1,1
0,0.0,25,is,1,1,11,10,0,13,0,10,Rust,Facepunch Studios,MISC,ORG-ORG,PROPN,PROPN-PROPN,nsubj,compound-pobj,NNP,NNP-NNPS,5,1
1,0.0,25,is,1,1,17,16,0,7,0,16,Rust,Microsoft Windows,MISC,MISC-MISC,PROPN,PROPN-PROPN,nsubj,compound-pobj,NNP,NNP-NNP,5,1
2,0.0,25,is,1,1,20,19,0,4,0,19,Rust,OS X,MISC,MISC-MISC,PROPN,PROPN-PROPN,nsubj,compound-conj,NNP,NNP-NNP,2,1
3,0.0,25,is,1,1,24,23,0,0,0,23,Rust,Linux,MISC,MISC,PROPN,PROPN,nsubj,conj,NNP,NNP,1,1
0,0.0,28,is,7,2,20,18,1,7,5,13,"Send in Stewie , Please",Family Guy,MISC-MISC-MISC-MISC-MISC,MISC-MISC,VERB-ADP-PROPN-PUNCT-INTJ,PROPN-PROPN,csubj-prep-pobj-punct-intj,compound-appos,"VB-IN-NNP-,-UH",NNP-NNP,8,1
1,1.0,37,aired,1,4,6,2,3,30,-3,5,Fox,the United States,ORG,LOC-LOC-LOC,PROPN,DET-PROPN-PROPN,pobj,det-compound-pobj,NNP,DT-NNP-NNP,2,1
0,0.0,19,is,1,1,15,14,0,3,0,14,Fairview,British Columbia,LOC,LOC-LOC,NOUN,PROPN-PROPN,nsubj,compound-conj,NN,NNP-NNP,8,1
1,0.0,19,is,1,1,18,17,0,0,0,17,Fairview,Canada,LOC,LOC,NOUN,PROPN,nsubj,appos,NN,NNP,1,1
2,0.0,19,is,1,13,18,5,12,0,-12,17,Vancouver,Canada,LOC,LOC,PROPN,PROPN,pobj,appos,NNP,NNP,9,1
3,0.0,19,is,1,15,18,3,14,0,-14,17,British Columbia,Canada,LOC-LOC,LOC,PROPN-PROPN,PROPN,compound-conj,appos,NNP-NNP,NNP,9,1
0,0.0,27,is,6,1,5,4,0,21,5,-1,Louis Hock,1948,PER-PER,TIME,PROPN-PROPN,NUM,compound-nsubj,npadvmod,NNP-NNP,CD,1,1
1,3.0,17,holds,3,1,11,10,0,5,2,8,Louis Hock,University of California - San Diego,PER-PER,ORG-ORG-ORG-ORG-ORG-ORG,PROPN-PROPN,PROPN-ADP-PROPN-PUNCT-PROPN-PROPN,compound-nsubj,nmod-prep-pobj-punct-compound-pobj,NNP-NNP,NNP-IN-NNP-HYPH-NNP-NNP,5,1
0,0.0,50,was,11,1,4,3,0,45,10,-7,Griffin Television Tower Oklahoma,Oklahoma,LOC-LOC-LOC-LOC,LOC,PROPN-PROPN-PROPN-PROPN,PROPN,compound-compound-compound-nsubj,conj,NNP-NNP-NNP-NNP,NNP,3,1
1,0.0,50,was,11,9,4,-5,8,45,2,-7,KWTV Mast,Oklahoma,LOC-LOC,LOC,PROPN-PROPN,PROPN,compound-pobj,conj,NNP-NNP,NNP,3,1
2,0.0,50,was,11,9,40,31,8,9,2,29,KWTV Mast,United States,LOC-LOC,LOC-LOC,PROPN-PROPN,PROPN-PROPN,compound-pobj,compound-conj,NNP-NNP,NNP-NNP,14,1
3,0.0,50,was,11,4,40,36,3,9,7,29,Oklahoma,United States,LOC,LOC-LOC,PROPN,PROPN-PROPN,conj,compound-conj,NNP,NNP-NNP,13,1
0,0.0,67,city,1,49,23,-26,48,43,-48,22,Attica,Greece,LOC,LOC,PROPN,PROPN,pobj,appos,NNP,NNP,17,1
0,0.0,29,is,12,19,28,9,18,0,-7,16,Góra Kalwaria,Poland,LOC-LOC,LOC,PROPN-PROPN,PROPN,compound-pobj,pobj,NNP-NNP,NNP,5,1
1,4.0,38,are,3,12,14,2,11,23,-9,11,Brooklyn,New York,LOC,LOC-LOC,PROPN,PROPN-PROPN,pobj,compound-conj,NNP,NNP-NNP,2,1
2,4.0,38,are,3,18,20,2,17,17,-15,17,London,UK,LOC,LOC,PROPN,PROPN,conj,conj,NNP,NNP,3,1
3,4.0,38,are,3,27,29,2,26,8,-24,26,Toronto,Ontario,LOC,LOC,PROPN,PROPN,pobj,conj,NNP,NNP,3,1
4,4.0,38,are,3,27,31,4,26,6,-24,28,Toronto,Canada,LOC,LOC,PROPN,PROPN,pobj,conj,NNP,NNP,4,1
5,4.0,38,are,3,29,31,2,28,6,-26,28,Ontario,Canada,LOC,LOC,PROPN,PROPN,conj,conj,NNP,NNP,3,1
0,0.0,26,was,7,1,15,14,0,10,6,8,Herzogenbusch,Vught,LOC,LOC,PROPN,PROPN,compound,pobj,NNP,NNP,5,1
1,0.0,26,was,7,1,25,24,0,0,6,18,Herzogenbusch,Netherlands,LOC,LOC,PROPN,PROPN,compound,pobj,NNP,NNP,3,1
2,0.0,26,was,7,15,25,10,14,0,-8,18,Vught,Netherlands,LOC,LOC,PROPN,PROPN,pobj,pobj,NNP,NNP,4,1
3,0.0,26,was,7,21,25,4,20,0,-14,18,s - Hertogenbosch,Netherlands,LOC-LOC-LOC,LOC,PROPN-PUNCT-PROPN,PROPN,compound-punct-nmod,pobj,NNP-:-NNP,NNP,8,1
4,1.0,26,was,1,10,23,13,9,2,-9,22,France,Europe,LOC,LOC,PROPN,PROPN,pobj,pobj,NNP,NNP,8,1
0,0.0,18,is,5,1,8,7,0,9,4,3,"Archie Comic Publications , Inc.",American,ORG-ORG-ORG-ORG-ORG,LOC,PROPN-PROPN-PROPN-PUNCT-PROPN,ADJ,compound-compound-dep-punct-nsubj,amod,"NNP-NNP-NNP-,-NNP",JJ,6,1
1,0.0,18,is,5,1,14,13,0,3,4,9,"Archie Comic Publications , Inc.",Pelham,ORG-ORG-ORG-ORG-ORG,LOC,PROPN-PROPN-PROPN-PUNCT-PROPN,PROPN,compound-compound-dep-punct-nsubj,pobj,"NNP-NNP-NNP-,-NNP",NNP,8,1
2,0.0,18,is,5,1,16,15,0,1,4,11,"Archie Comic Publications , Inc.",New York,ORG-ORG-ORG-ORG-ORG,LOC-LOC,PROPN-PROPN-PROPN-PUNCT-PROPN,PROPN-PROPN,compound-compound-dep-punct-nsubj,compound-npadvmod,"NNP-NNP-NNP-,-NNP",NNP-NNP,8,1
3,3.0,35,created,15,3,26,23,2,8,12,11,Archie,Bob Montana,MISC,PER-PER,PROPN,PROPN-PROPN,compound,compound-conj,NNP,NNP-NNP,4,1
4,3.0,35,created,15,3,33,30,2,1,12,18,Archie,Vic Bloom,MISC,PER-PER,PROPN,PROPN-PROPN,compound,compound-pobj,NNP,NNP-NNP,5,1
0,1.0,31,dealt,5,23,27,4,22,3,-18,22,Washington Park Subdivision,Chicago,LOC-LOC-LOC,LOC,PROPN-PROPN-PROPN,PROPN,compound-compound-pobj,poss,NNP-NNP-NNP,NNP,5,1
0,0.0,27,Enslin,2,1,5,4,0,21,1,3,Theodore Vernon Enslin,"March 25 , 1925",PER-PER-PER,TIME-TIME-TIME-TIME,PROPN-PROPN-PROPN,PROPN-NUM-PUNCT-NUM,compound-compound-ROOT,appos-nummod-punct-nummod,NNP-NNP-NNP,"NNP-CD-,-CD",3,1
1,2.0,8,born,2,1,5,4,0,2,1,3,Enslin,Chester,PER,LOC,PROPN,PROPN,nsubjpass,pobj,NNP,NNP,4,1
2,8.0,27,moved,1,4,11,7,3,15,-3,10,Maine,Washington County,LOC,LOC-LOC,PROPN,PROPN-PROPN,pobj,compound-pobj,NNP,NNP-NNP,4,1
0,0.0,20,is,1,1,9,8,0,10,0,8,Mosfellsbær,Iceland,LOC,LOC,PROPN,PROPN,nsubj,pobj,NNP,NNP,2,1
1,0.0,20,is,1,9,19,10,8,0,-8,18,Iceland,Reykjavík,LOC,LOC,PROPN,PROPN,pobj,appos,NNP,NNP,3,1
2,9.0,25,was,17,10,13,3,9,11,7,-4,Halldór Laxness,1902,PER-PER,TIME,PROPN-PROPN,NUM,compound-appos,nummod,NNP-NNP,CD,1,1
3,9.0,25,was,17,10,15,5,9,9,7,-2,Halldór Laxness,1998,PER-PER,TIME,PROPN-PROPN,NUM,compound-appos,nummod,NNP-NNP,CD,1,1
0,0.0,18,Ludovica,1,6,8,2,5,9,-5,7,Parolini,1931,PER,TIME,PROPN,NUM,nsubj,nummod,NNP,CD,2,1
1,3.0,23,appeared,5,17,21,4,16,1,-12,16,Chronique d'un été,1961,MISC-MISC-MISC,TIME,PROPN-PROPN-PROPN,NUM,dobj-nsubj-ROOT,npadvmod,NNP-NNP-NNP,CD,2,1
2,6.0,30,was,1,17,20,3,16,9,-16,19,L'amour fou,1969,MISC-MISC,TIME,DET-NOUN,NUM,amod-pobj,appos,PRP$-NN,CD,1,1
3,6.0,30,was,1,23,28,5,22,1,-22,27,Duelle,1976,MISC,TIME,PROPN,NUM,conj,appos,NNP,CD,3,1
4,6.0,30,was,1,25,28,3,24,1,-24,27,Noroît,1976,MISC,TIME,PROPN,NUM,conj,appos,NNP,CD,2,1
0,6.0,27,interpreted,4,1,16,15,0,10,3,12,Pop art,abstract expressionism,MISC-MISC,MISC-MISC,NOUN-NOUN,ADJ-NOUN,compound-nsubjpass,amod-pobj,NN-NN,JJ-NN,7,1
0,2.0,32,received,1,20,19,-1,19,12,-19,18,Ethelda Bleibtrey,American,PER-PER,LOC,PROPN-PROPN,PROPN,compound-pobj,compound,NNP-NNP,NNP,2,1
1,3.0,33,won,10,18,16,-2,17,16,-8,6,Bleibtrey,U.S.,PER,LOC,PROPN,PROPN,dobj,pobj,NNP,NNP,2,1
2,3.0,33,won,10,20,16,-4,19,16,-10,6,Frances Schroth,U.S.,PER-PER,LOC,PROPN-PROPN,PROPN,compound-conj,pobj,NNPS-NNP,NNP,2,1
3,3.0,33,won,10,23,16,-7,22,16,-13,6,Margaret Woodbridge,U.S.,PER-PER,LOC,PROPN-PROPN,PROPN,compound-conj,pobj,NNP-NNP,NNP,3,1
4,4.0,20,inducted,2,1,6,5,0,13,1,4,Guest,International Swimming Hall of Fame,PER,MISC-MISC-MISC-MISC-MISC,PROPN,PROPN-PROPN-PROPN-ADP-PROPN,nsubjpass,compound-compound-pobj-prep-pobj,NNP,NNP-NNP-NNP-IN-NNP,4,1
0,0.0,31,was,14,1,5,4,0,25,13,-9,George Charles Calnan,"January 18 , 1900",PER-PER-PER,TIME-TIME-TIME-TIME,PROPN-PROPN-PROPN,PROPN-NUM-PUNCT-NUM,compound-compound-nsubj,appos-nummod-punct-nummod,NNP-NNP-NNP,"NNP-CD-,-CD",3,1
1,0.0,31,was,14,1,10,9,0,20,13,-4,George Charles Calnan,"April 4 , 1933",PER-PER-PER,TIME-TIME-TIME-TIME,PROPN-PROPN-PROPN,PROPN-NUM-PUNCT-NUM,compound-compound-nsubj,appos-nummod-punct-nummod,NNP-NNP-NNP,"NNP-CD-,-CD",3,1
2,0.0,31,was,14,1,17,16,0,13,13,3,George Charles Calnan,United States Navy,PER-PER-PER,ORG-ORG-ORG,PROPN-PROPN-PROPN,PROPN-PROPN-PROPN,compound-compound-nsubj,compound-compound-compound,NNP-NNP-NNP,NNP-NNP-NNP,5,1
3,0.0,31,was,14,17,25,8,16,5,-3,11,United States Navy,the United States,ORG-ORG-ORG,LOC-LOC-LOC,PROPN-PROPN-PROPN,DET-PROPN-PROPN,compound-compound-compound,det-compound-pobj,NNP-NNP-NNP,DT-NNP-NNP,6,1
4,4.0,28,competed,5,5,12,7,4,15,0,7,Calnan,1924 Summer Olympics,PER,MISC-MISC-MISC,PROPN,NUM-PROPN-PROPN,nsubj,nummod-compound-pobj,NNP,CD-NNP-NNPS,3,1
5,4.0,28,competed,5,12,16,4,11,11,-7,11,1924 Summer Olympics,Paris,MISC-MISC-MISC,LOC,NUM-PROPN-PROPN,PROPN,nummod-compound-pobj,pobj,CD-NNP-NNPS,NNP,6,1
6,5.0,14,took,1,1,8,7,0,5,0,7,Calnan,1932 Summer Olympics,PER,MISC-MISC-MISC,PROPN,NUM-PROPN-PROPN,nsubj,nummod-compound-pobj,NNP,CD-NNP-NNPS,3,1
7,5.0,14,took,1,8,12,4,7,1,-7,11,1932 Summer Olympics,Los Angeles,MISC-MISC-MISC,LOC-LOC,NUM-PROPN-PROPN,PROPN-PROPN,nummod-compound-pobj,compound-pobj,CD-NNP-NNPS,NNP-NNP,3,1
0,0.0,11,Khosla,2,1,5,4,0,5,1,3,Ajudhia Nath Khosla,11 December 1892,PER-PER-PER,TIME-TIME-TIME,PROPN-PROPN-PROPN,NUM-PROPN-NUM,compound-compound-ROOT,nummod-nmod-nummod,NNP-NNP-NNP,CD-NNP-CD,4,1
1,0.0,11,Khosla,2,1,10,9,0,0,1,8,Ajudhia Nath Khosla,1984,PER-PER-PER,TIME,PROPN-PROPN-PROPN,NUM,compound-compound-ROOT,nummod,NNP-NNP-NNP,CD,2,1
2,3.0,22,born,2,1,5,4,0,16,1,3,Khosla,New Delhi,PER,LOC-LOC,PROPN,PROPN-PROPN,nsubjpass,compound-pobj,NNP,NNP-NNP,3,1
0,0.0,24,is,4,1,23,22,0,0,3,19,Lake Blouin,Canada,LOC-LOC,LOC,PROPN-PROPN,PROPN,compound-nsubj,appos,NNP-NNP,NNP,1,1
1,0.0,24,is,4,21,23,2,20,0,-17,19,Quebec,Canada,LOC,LOC,PROPN,PROPN,conj,appos,NNP,NNP,7,1
0,0.0,32,was,6,17,30,13,16,1,-11,24,Ustaše,Ante Pavelić,ORG,PER-PER,PROPN,PROPN-PROPN,pobj,compound-pobj,NNP,NNP-NNP,4,1
1,7.0,24,were,5,16,23,7,15,0,-11,18,Ustaša,1945,ORG,TIME,PROPN,NUM,compound,prep,NNP,CD,9,1
0,0.0,20,is,4,1,15,14,0,4,3,11,Les Belles de Tunis,1983,MISC-MISC-MISC-MISC,TIME,PROPN-PROPN-PROPN-PROPN,NUM,compound-compound-compound-nsubj,pobj,NNP-NNP-NNP-NNP,CD,4,1
0,0.0,19,is,4,2,12,10,1,6,2,8,Glasscock County Courthouse,Garden City,LOC-LOC-LOC,LOC-LOC,PROPN-PROPN-PROPN,PROPN-PROPN,compound-compound-nsubj,compound-pobj,NNP-NNP-NNP,NNP-NNP,6,1
1,0.0,19,is,4,2,18,16,1,0,2,14,Glasscock County Courthouse,Texas,LOC-LOC-LOC,LOC,PROPN-PROPN-PROPN,PROPN,compound-compound-nsubj,appos,NNP-NNP-NNP,NNP,3,1
2,0.0,19,is,4,12,2,-10,11,16,-8,-2,Garden City,Glasscock County,LOC-LOC,LOC-LOC,PROPN-PROPN,PROPN-PROPN,compound-pobj,compound-npadvmod,NNP-NNP,NNP-NNP,6,1
3,0.0,19,is,4,2,18,16,1,0,2,14,Glasscock County,Texas,LOC-LOC,LOC,PROPN-PROPN,PROPN,compound-npadvmod,appos,NNP-NNP,NNP,3,1
0,0.0,58,II,1,1,48,47,0,9,0,47,Dune,Westwood Studios,MISC,ORG-ORG,PROPN,PROPN-PROPN,compound,compound-pobj,NNP,NNP-NNPS,-1,1
1,0.0,58,II,1,1,53,52,0,4,0,52,Dune,Virgin Games,MISC,ORG-ORG,PROPN,PROPN-PROPN,compound,compound-pobj,NNP,NNP-NNPS,-1,1
2,1.0,25,based,2,10,8,-2,9,16,-8,6,Dune,1984,MISC,TIME,PROPN,NUM,appos,nummod,NNP,CD,1,1
3,1.0,25,based,2,10,15,5,9,9,-8,13,Dune,Frank Herbert,MISC,PER-PER,PROPN,PROPN-PROPN,appos,compound-poss,NNP,NNP-NNP,6,1
4,4.0,34,was,9,23,30,7,22,3,-14,21,Warcraft,RTS,MISC,MISC,PROPN,PROPN,conj,compound,NNP,NNP,7,1
5,4.0,34,was,9,25,30,5,24,3,-16,21,StarCraft,RTS,MISC,MISC,PROPN,PROPN,conj,compound,NNP,NNP,6,1
0,0.0,20,is,2,1,5,4,0,14,1,3,Trump Unauthorized,2005,MISC-MISC,TIME,NOUN-PROPN,NUM,compound-nsubj,nummod,NN-NNP,CD,3,1
1,0.0,20,is,2,16,18,2,15,1,-14,16,United States,Donald Trump,LOC-LOC,PER-PER,PROPN-PROPN,PROPN-PROPN,compound-compound,compound-pobj,NNP-NNP,NNP-NNP,1,1
2,2.0,20,chronicles,2,4,15,11,3,4,-2,13,Trump,Ivana Trump,PER,PER-PER,PROPN,PROPN-PROPN,poss,compound-pobj,NNP,NNP-NNP,6,1
3,2.0,20,chronicles,2,4,18,14,3,1,-2,16,Trump,Marla Maples,PER,PER-PER,PROPN,PROPN-PROPN,poss,compound-conj,NNP,NNP-NNPS,7,1
0,1.0,21,is,1,13,10,-3,12,10,-12,9,North Carolina,the United States,LOC-LOC,LOC-LOC-LOC,PROPN-PROPN,DET-PROPN-PROPN,compound-pobj,det-compound-pobj,NNP-NNP,DT-NNP-NNP,2,1
1,1.0,21,is,1,16,10,-6,15,10,-15,9,Tennessee,the United States,LOC,LOC-LOC-LOC,PROPN,DET-PROPN-PROPN,conj,det-compound-pobj,NNP,DT-NNP-NNP,3,1
2,12.0,32,is,1,7,12,5,6,19,-6,11,Avery,North Carolina,LOC,LOC-LOC,PROPN,PROPN-PROPN,pobj,compound-pobj,NNP,NNP-NNP,5,1
3,12.0,32,is,1,9,12,3,8,19,-8,11,Mitchell Counties,North Carolina,LOC-LOC,LOC-LOC,PROPN-PROPN,PROPN-PROPN,compound-conj,compound-pobj,NNP-NNPS,NNP-NNP,5,1
4,12.0,32,is,1,15,18,3,14,13,-14,17,Carter County,Tennessee,LOC-LOC,LOC,PROPN-PROPN,PROPN,compound-conj,appos,NNP-NNP,NNP,4,1
0,0.0,29,is,5,1,14,13,0,14,4,9,Cleft of the Rock Light,Pacific,LOC-LOC-LOC-LOC-LOC,LOC,VERB-ADP-DET-PROPN-PROPN,PROPN,nsubj-prep-det-compound-pobj,compound,VBN-IN-DT-NNP-NNP,NNP,6,1
1,0.0,29,is,5,1,18,17,0,10,4,13,Cleft of the Rock Light,U.S.,LOC-LOC-LOC-LOC-LOC,LOC,VERB-ADP-DET-PROPN-PROPN,PROPN,nsubj-prep-det-compound-pobj,compound,VBN-IN-DT-NNP-NNP,NNP,8,1
2,0.0,29,is,5,1,21,20,0,7,4,16,Cleft of the Rock Light,Oregon,LOC-LOC-LOC-LOC-LOC,LOC,VERB-ADP-DET-PROPN-PROPN,PROPN,nsubj-prep-det-compound-pobj,pobj,VBN-IN-DT-NNP-NNP,NNP,4,1
3,0.0,29,is,5,14,18,4,13,10,-9,13,Pacific,U.S.,LOC,LOC,PROPN,PROPN,compound,compound,NNP,NNP,2,1
4,0.0,29,is,5,18,21,3,17,7,-13,16,U.S.,Oregon,LOC,LOC,PROPN,PROPN,compound,pobj,NNP,NNP,6,1
5,2.0,35,designed,6,20,34,14,19,0,-14,28,Oak Bay,Canada,LOC-LOC,LOC,PROPN-PROPN,PROPN,compound-pobj,appos,NNP-NNP,NNP,6,1
0,0.0,45,was,20,6,32,26,5,12,14,12,York,United Kingdom,LOC,LOC-LOC,PROPN,PROPN-PROPN,pobj,compound-pobj,NNP,NNP-NNP,7,1
1,0.0,45,was,20,8,32,24,7,12,12,12,Albany,United Kingdom,LOC,LOC-LOC,PROPN,PROPN-PROPN,conj,compound-pobj,NNP,NNP-NNP,7,1
2,0.0,45,was,20,26,32,6,25,12,-6,12,George III,United Kingdom,PER-PER,LOC-LOC,PROPN-PROPN,PROPN-PROPN,compound-pobj,compound-pobj,NNP-NNP,NNP-NNP,5,1
3,3.0,50,thrust,2,6,37,31,5,12,-4,35,British Army,War of the First Coalition,ORG-ORG,MISC-MISC-MISC-MISC-MISC,ADJ-PROPN,PROPN-ADP-DET-PROPN-PROPN,compound-pobj,pobj-prep-det-compound-pobj,JJ-NNP,NNP-IN-DT-NNP-NNP,10,1
4,4.0,59,oversaw,14,20,11,-9,19,47,-6,-3,British Army,Napoleonic Wars,ORG-ORG,MISC-MISC,ADJ-PROPN,PROPN-PROPN,compound-pobj,compound-pobj,JJ-NNP,NNP-NNPS,7,1
0,0.0,15,is,4,3,3,0,2,11,1,-1,Yamaguchi City,Yamaguchi Prefecture,LOC-LOC,LOC-LOC,PROPN-PROPN,PROPN-PROPN,compound-pobj,compound-pobj,NNP-NNP,NNP-NNP,0,1
1,0.0,15,is,4,3,14,11,2,0,1,10,Yamaguchi City,Japan,LOC-LOC,LOC,PROPN-PROPN,PROPN,compound-pobj,appos,NNP-NNP,NNP,3,1
2,0.0,15,is,4,3,14,11,2,0,1,10,Yamaguchi Prefecture,Japan,LOC-LOC,LOC,PROPN-PROPN,PROPN,compound-pobj,appos,NNP-NNP,NNP,3,1
0,0.0,20,is,8,1,16,15,0,3,7,8,Fall River,Nova Scotia,LOC-LOC,LOC-LOC,PROPN-PROPN,PROPN-PROPN,compound-nsubj,compound-appos,NNP-NNP,NNP-NNP,5,1
1,0.0,20,is,8,1,19,18,0,0,7,11,Fall River,Canada,LOC-LOC,LOC,PROPN-PROPN,PROPN,compound-nsubj,appos,NNP-NNP,NNP,2,1
2,0.0,20,is,8,14,19,5,13,0,-6,11,Halifax,Canada,LOC,LOC,PROPN,PROPN,pobj,appos,NNP,NNP,5,1
3,0.0,20,is,8,16,19,3,15,0,-8,11,Nova Scotia,Canada,LOC-LOC,LOC,PROPN-PROPN,PROPN,compound-appos,appos,NNP-NNP,NNP,5,1
0,1.0,42,known,2,18,23,5,17,18,-16,21,The Trials of Life,1990,MISC-MISC-MISC-MISC,TIME,DET-PROPN-ADP-PROPN,NUM,det-pobj-prep-pobj,appos,DT-NNPS-IN-NNP,CD,1,1
1,3.0,44,nominated,3,18,22,4,17,21,-15,19,Great White Shark,1995,MISC-MISC-MISC,TIME,PROPN-PROPN-PROPN,NUM,compound-compound-pobj,appos,NNP-NNP-NNP,CD,2,1
2,3.0,44,nominated,3,29,35,6,28,8,-26,32,Hawaii : Strangers in Paradise,1991,MISC-MISC-MISC-MISC-MISC,TIME,PROPN-PUNCT-NOUN-ADP-PROPN,NUM,conj-punct-appos-prep-pobj,appos,NNP-:-NNS-IN-NNP,CD,5,1
3,4.0,47,formed,3,19,24,5,18,22,-16,21,The Tree of Life,2011,MISC-MISC-MISC-MISC,TIME,DET-PROPN-ADP-PROPN,NUM,det-pobj-prep-pobj,appos,DT-NNP-IN-NNP,CD,6,1
4,4.0,47,formed,3,41,45,4,40,1,-38,42,Voyage of Time,2016,MISC-MISC-MISC,TIME,PROPN-ADP-PROPN,NUM,pobj-prep-pobj,appos,NNP-IN-NNP,CD,5,1
0,8.0,15,features,3,13,11,-2,12,3,-10,8,Phantasm,Coscarelli,MISC,PER,PROPN,PROPN,compound,poss,NNP,NNP,2,1
0,3.0,76,captured,36,29,33,4,28,42,7,-3,Bass Strait,Tasman sea,LOC-LOC,LOC-LOC,PROPN-PROPN,PROPN-NOUN,compound-pobj,compound-pobj,NNP-NNP,NNP-NN,2,1
0,0.0,33,"""",0,21,30,9,20,2,-21,30,Eurovision Song Contest 1997,Anna Maria Jopek,MISC-MISC-MISC-MISC,PER-PER-PER,PROPN-PROPN-PROPN-NUM,PROPN-PROPN-PROPN,compound-compound-pobj-appos,compound-compound-pobj,NNP-NNP-NNP-CD,NNP-NNP-NNP,8,1
0,0.0,30,was,6,2,15,13,1,14,4,9,City of Thuringowa,North Queensland,LOC-LOC-LOC,LOC-LOC,PROPN-ADP-PROPN,PROPN-PROPN,nsubj-prep-pobj,compound-pobj,NNP-IN-NNP,NNP-NNP,5,1
1,0.0,30,was,6,2,18,16,1,11,4,12,City of Thuringowa,Australia,LOC-LOC-LOC,LOC,PROPN-ADP-PROPN,PROPN,nsubj-prep-pobj,nsubj,NNP-IN-NNP,NNP,5,1
2,0.0,30,was,6,15,18,3,14,11,-9,12,North Queensland,Australia,LOC-LOC,LOC,PROPN-PROPN,PROPN,compound-pobj,nsubj,NNP-NNP,NNP,4,1
0,0.0,27,is,11,1,10,9,0,16,10,-1,Ari Lohenoja,Helsinki,PER-PER,LOC,PROPN-PROPN,PROPN,compound-nsubj,pobj,NNP-NNP,NNP,2,1
1,0.0,27,is,11,1,14,13,0,12,10,3,Ari Lohenoja,Finnish,PER-PER,LOC,PROPN-PROPN,ADJ,compound-nsubj,amod,NNP-NNP,JJ,2,1
2,2.0,38,made,14,14,9,-5,13,28,0,-5,Lohenoja,Turku School of Economics,PER,ORG-ORG-ORG-ORG,PROPN,PROPN-PROPN-ADP-PROPN,nsubj,compound-pobj-prep-pobj,NNP,NNP-NNP-IN-NNP,5,1
3,5.0,30,directed,4,8,18,10,7,11,-4,14,Aaken ja Sakun kesäkeittiö,MTV3,MISC-MISC-MISC-MISC,ORG,PROPN-ADP-PROPN-NOUN,PROPN,compound-compound-compound-dobj,pobj,NNP-IN-NNP-NNS,NNP,3,1
0,0.0,38,is,16,10,28,18,9,9,6,12,Toronto,Ontario,LOC,LOC,PROPN,PROPN,pobj,conj,NNP,NNP,14,1
1,0.0,38,is,16,10,30,20,9,7,6,14,Toronto,Canada,LOC,LOC,PROPN,PROPN,pobj,conj,NNP,NNP,15,1
2,0.0,38,is,16,28,30,2,27,7,-12,14,Ontario,Canada,LOC,LOC,PROPN,PROPN,conj,conj,NNP,NNP,3,1
3,4.0,42,set,26,25,30,5,24,11,1,4,TPA,1999,ORG,TIME,PROPN,NUM,nsubjpass,pobj,NNP,CD,3,1
0,0.0,30,was,11,1,4,3,0,25,10,-7,Hideo Hatoyama,2 February 1884,PER-PER,TIME-TIME-TIME,PROPN-PROPN,NUM-PROPN-NUM,compound-nsubj,nummod-appos-nummod,NNP-NNP,CD-NNP-CD,1,1
1,0.0,30,was,11,1,8,7,0,21,10,-3,Hideo Hatoyama,29 January 1946,PER-PER,TIME-TIME-TIME,PROPN-PROPN,NUM-PROPN-NUM,compound-nsubj,nummod-appos-nummod,NNP-NNP,CD-NNP-CD,2,1
2,0.0,30,was,11,1,29,28,0,0,10,18,Hideo Hatoyama,Japan,PER-PER,LOC,PROPN-PROPN,PROPN,compound-nsubj,pobj,NNP-NNP,NNP,2,1
3,2.0,35,was,4,3,22,19,2,12,1,18,Kazuo Hatoyama,Ichirō Hatoyama,PER-PER,PER-PER,PROPN-PROPN,PROPN-PROPN,compound-appos,compound-appos,NNP-NNP,NNP-NNP,5,1
0,0.0,27,is,5,1,9,8,0,17,4,4,Manjil Virinja Pookkal,Indian,MISC-MISC-MISC,LOC,PROPN-PROPN-PROPN,PROPN,compound-compound-nsubj,amod,NNP-NNP-NNP,NNP,5,1
1,0.0,27,is,5,1,19,18,0,7,4,14,Manjil Virinja Pookkal,Navodaya Appachan,MISC-MISC-MISC,PER-PER,PROPN-PROPN-PROPN,PROPN-PROPN,compound-compound-nsubj,compound-pobj,NNP-NNP-NNP,NNP-NNP,6,1
2,0.0,27,is,5,1,26,25,0,0,4,21,Manjil Virinja Pookkal,Fazil,MISC-MISC-MISC,PER,PROPN-PROPN-PROPN,PROPN,compound-compound-nsubj,pobj,NNP-NNP-NNP,NNP,3,1
0,0.0,42,is,3,1,11,10,0,30,2,8,A Caribbean Mystery,Agatha Christie,MISC-MISC-MISC,PER-PER,DET-PROPN-PROPN,PROPN-PROPN,det-compound-nsubj,compound-pobj,DT-NNP-NNP,NNP-NNP,5,1
1,0.0,42,is,3,1,18,17,0,23,2,15,A Caribbean Mystery,UK,MISC-MISC-MISC,LOC,DET-PROPN-PROPN,PROPN,det-compound-nsubj,pobj,DT-NNP-NNP,NNP,4,1
2,0.0,42,is,3,1,21,20,0,20,2,18,A Caribbean Mystery,Collins Crime Club,MISC-MISC-MISC,ORG-ORG-ORG,DET-PROPN-PROPN,PROPN-PROPN-PROPN,det-compound-nsubj,compound-compound-pobj,DT-NNP-NNP,NNP-NNP-NNP,6,1
3,0.0,42,is,3,1,25,24,0,16,2,22,A Caribbean Mystery,16 November 1964,MISC-MISC-MISC,TIME-TIME-TIME,DET-PROPN-PROPN,NUM-PROPN-NUM,det-compound-nsubj,nummod-pobj-nummod,DT-NNP-NNP,CD-NNP-CD,5,1
4,0.0,42,is,3,1,34,33,0,7,2,31,A Caribbean Mystery,"Dodd , Mead and Company",MISC-MISC-MISC,ORG-ORG-ORG-ORG-ORG,DET-PROPN-PROPN,PROPN-PUNCT-PROPN-CCONJ-PROPN,det-compound-nsubj,pobj-punct-conj-cc-conj,DT-NNP-NNP,"NNP-,-NNP-CC-NNP",6,1
5,5.0,15,reappear,5,10,14,4,9,0,-5,9,Nemesis,1971,MISC,TIME,PROPN,NUM,pobj,pobj,NNP,CD,3,1
0,0.0,18,is,1,1,11,10,0,6,0,10,Puddletown,West Dorset,LOC,LOC-LOC,PROPN,PROPN-PROPN,nsubj,compound-compound,NNP,NNP-NNP,5,1
1,0.0,18,is,1,11,12,1,10,5,-10,11,West Dorset,Dorset,LOC-LOC,LOC,PROPN-PROPN,PROPN,compound-compound,pobj,NNP-NNP,NNP,1,1
0,0.0,36,was,13,1,9,8,0,26,12,-4,"Michael Duane "" Bo "" McLaughlin","October 23 , 1953",PER-PER-PER-PER-PER-PER,TIME-TIME-TIME-TIME,PROPN-PROPN-PUNCT-PROPN-PUNCT-PROPN,PROPN-NUM-PUNCT-NUM,compound-nsubj-punct-nmod-punct-appos,npadvmod-nummod-punct-nummod,NNP-NNP-''-NNP-``-NNP,"NNP-CD-,-CD",4,1
1,0.0,36,was,13,1,27,26,0,8,12,14,"Michael Duane "" Bo "" McLaughlin",Houston Astros,PER-PER-PER-PER-PER-PER,ORG-ORG,PROPN-PROPN-PUNCT-PROPN-PUNCT-PROPN,PROPN-PROPN,compound-nsubj-punct-nmod-punct-appos,compound-pobj,NNP-NNP-''-NNP-``-NNP,NNP-NNP,4,1
2,0.0,36,was,13,1,30,29,0,5,12,17,"Michael Duane "" Bo "" McLaughlin",Atlanta Braves,PER-PER-PER-PER-PER-PER,ORG-ORG,PROPN-PROPN-PUNCT-PROPN-PUNCT-PROPN,PROPN-PROPN,compound-nsubj-punct-nmod-punct-appos,compound-conj,NNP-NNP-''-NNP-``-NNP,NNP-NNPS,5,1
3,0.0,36,was,13,1,34,33,0,1,12,21,"Michael Duane "" Bo "" McLaughlin",Oakland Athletics,PER-PER-PER-PER-PER-PER,ORG-ORG,PROPN-PROPN-PUNCT-PROPN-PUNCT-PROPN,PROPN-PROPN,compound-nsubj-punct-nmod-punct-appos,compound-conj,NNP-NNP-''-NNP-``-NNP,NNP-NNP,6,1
0,2.0,62,worked,4,41,37,-4,40,24,-37,33,Etta James,American,PER-PER,LOC,PROPN-PROPN,ADJ,compound-pobj,amod,NNP-NNP,JJ,4,1
1,2.0,62,worked,4,44,37,-7,43,24,-40,33,Sam Cooke,American,PER-PER,LOC,PROPN-PROPN,ADJ,compound-conj,amod,NNP-NNP,JJ,5,1
2,2.0,62,worked,4,42,37,-5,41,24,-38,33,James Brown,American,PER-PER,LOC,PROPN-PROPN,ADJ,compound-conj,amod,NNP-NNP,JJ,5,1
3,2.0,62,worked,4,50,37,-13,49,24,-46,33,Earl Bostic,American,PER-PER,LOC,PROPN-PROPN,ADJ,compound-conj,amod,NNP-NNP,JJ,7,1
4,3.0,17,inducted,2,1,6,5,0,10,1,4,Bass,Rock and Roll Hall of Fame,PER,MISC-MISC-MISC-MISC-MISC-MISC,PROPN,PROPN-CCONJ-PROPN-PROPN-ADP-PROPN,nsubjpass,nmod-cc-conj-pobj-prep-pobj,NNP,NNP-CC-NNP-NNP-IN-NNP,5,1
0,0.0,17,is,1,1,12,11,0,4,0,11,Inchbonnie,New Zealand,LOC,LOC-LOC,PROPN,PROPN-PROPN,nsubj,compound-poss,NNP,NNP-NNP,6,1
1,0.0,17,is,1,8,12,4,7,4,-7,11,West Coast,New Zealand,LOC-LOC,LOC-LOC,PROPN-PROPN,PROPN-PROPN,compound-compound,compound-poss,NNP-NNP,NNP-NNP,4,1
2,0.0,17,is,1,8,15,7,7,1,-7,14,West Coast,South Island,LOC-LOC,LOC-LOC,PROPN-PROPN,PROPN-PROPN,compound-compound,compound-pobj,NNP-NNP,NNP-NNP,3,1
3,0.0,17,is,1,12,15,3,11,1,-11,14,New Zealand,South Island,LOC-LOC,LOC-LOC,PROPN-PROPN,PROPN-PROPN,compound-poss,compound-pobj,NNP-NNP,NNP-NNP,1,1
0,0.0,21,is,6,2,20,18,1,0,4,14,Great Hall of the People,Beijing,LOC-LOC-LOC-LOC-LOC,LOC,PROPN-PROPN-ADP-DET-PROPN,PROPN,compound-nsubj-prep-det-pobj,pobj,NNP-NNP-IN-DT-NNPS,NNP,2,1
1,0.0,21,is,6,17,20,3,16,0,-11,14,Tiananmen Square,Beijing,LOC-LOC,LOC,PROPN-PROPN,PROPN,compound-pobj,pobj,NNP-NNP,NNP,7,1
0,0.0,38,was,12,1,5,4,0,32,11,-7,Harold John Pye,27 November 1901,PER-PER-PER,TIME-TIME-TIME,PROPN-PROPN-PROPN,NUM-PROPN-NUM,compound-compound-nsubj,nummod-appos-nummod,NNP-NNP-NNP,CD-NNP-CD,2,1
1,0.0,38,was,12,1,9,8,0,28,11,-3,Harold John Pye,20 January 1986,PER-PER-PER,TIME-TIME-TIME,PROPN-PROPN-PROPN,NUM-PROPN-NUM,compound-compound-nsubj,nummod-appos-nummod,NNP-NNP-NNP,CD-NNP-CD,3,1
2,0.0,38,was,12,1,17,16,0,20,11,5,Harold John Pye,William George Pye,PER-PER-PER,PER-PER-PER,PROPN-PROPN-PROPN,PROPN-PROPN-PROPN,compound-compound-nsubj,compound-compound-pobj,NNP-NNP-NNP,NNP-NNP-NNP,6,1
0,0.0,16,is,2,1,1,0,0,14,1,-1,Tin Machine,Tin Machine,MISC-MISC,ORG-ORG,PROPN-PROPN,PROPN-PROPN,compound-nsubj,compound-pobj,NNP-NNP,NNP-NNP,0,1
0,0.0,22,was,2,1,10,9,0,11,1,8,Jacques Feldbau,22 October 1914,PER-PER,TIME-TIME-TIME,PROPN-PROPN,NUM-PROPN-NUM,compound-nsubj,nummod-pobj-nummod,NNP-NNP,CD-NNP-CD,5,1
1,0.0,22,was,2,1,14,13,0,7,1,12,Jacques Feldbau,Strasbourg,PER-PER,LOC,PROPN-PROPN,PROPN,compound-nsubj,pobj,NNP-NNP,NNP,4,1
2,1.0,21,died,1,9,20,11,8,0,-8,19,Ganacker Camp,Germany,LOC-LOC,LOC,PROPN-PROPN,PROPN,compound-pobj,pobj,NNP-NNP,NNP,3,1
3,1.0,21,died,1,18,20,2,17,0,-17,19,Flossenbürg,Germany,LOC,LOC,PROPN,PROPN,pobj,pobj,NNP,NNP,7,1
0,0.0,40,is,3,2,8,6,1,31,1,5,Armitage River,Chibougamau Lake,LOC-LOC,LOC-LOC,PROPN-PROPN,PROPN-PROPN,compound-nsubj,compound-pobj,NNP-NNP,NNP-NNP,4,1
1,2.0,50,connected,29,7,24,17,6,25,22,-5,Armitage River,Chibougamau Lake,LOC-LOC,LOC-LOC,PROPN-PROPN,PROPN-PROPN,compound-pobj,compound-pobj,NNP-NNP,NNP-NNP,12,1
2,0.0,40,is,3,2,36,34,1,3,1,33,Armitage River,Quebec,LOC-LOC,LOC,PROPN-PROPN,PROPN,compound-nsubj,pobj,NNP-NNP,NNP,5,1
3,0.0,40,is,3,2,39,37,1,0,1,36,Armitage River,Canada,LOC-LOC,LOC,PROPN-PROPN,PROPN,compound-nsubj,pobj,NNP-NNP,NNP,2,1
4,0.0,40,is,3,8,8,0,7,31,-5,5,Chibougamau Lake,Chibougamau,LOC-LOC,LOC,PROPN-PROPN,PROPN,compound-pobj,pobj,NNP-NNP,NNP,0,1
5,0.0,40,is,3,8,36,28,7,3,-5,33,Chibougamau Lake,Quebec,LOC-LOC,LOC,PROPN-PROPN,PROPN,compound-pobj,pobj,NNP-NNP,NNP,7,1
6,0.0,40,is,3,8,39,31,7,0,-5,36,Chibougamau Lake,Canada,LOC-LOC,LOC,PROPN-PROPN,PROPN,compound-pobj,pobj,NNP-NNP,NNP,4,1
7,0.0,40,is,3,8,19,11,7,20,-5,16,Chibougamau,Jamésie,LOC,LOC,PROPN,PROPN,pobj,pobj,NNP,NNP,6,1
8,0.0,40,is,3,8,39,31,7,0,-5,36,Chibougamau,Canada,LOC,LOC,PROPN,PROPN,pobj,pobj,NNP,NNP,4,1
9,0.0,40,is,3,19,39,20,18,0,-16,36,Jamésie,Canada,LOC,LOC,PROPN,PROPN,pobj,pobj,NNP,NNP,4,1
10,0.0,40,is,3,36,39,3,35,0,-33,36,Quebec,Canada,LOC,LOC,PROPN,PROPN,pobj,pobj,NNP,NNP,5,1
0,0.0,16,born,4,1,6,5,0,9,3,2,Tharman Shanmugaratnam,25 February 1957,PER-PER,TIME-TIME-TIME,PROPN-PROPN,NUM-PROPN-NUM,compound-compound,nummod-npadvmod-nummod,NNP-NNP,CD-NNP-CD,3,1
1,0.0,16,born,4,1,12,11,0,3,3,8,Tharman Shanmugaratnam,Singaporean,PER-PER,LOC,PROPN-PROPN,ADJ,compound-compound,amod,NNP-NNP,JJ,3,1
0,0.0,27,railway,2,24,26,2,23,0,-22,24,Xinjiang,China,LOC,LOC,PROPN,PROPN,pobj,appos,NNP,NNP,5,1
0,0.0,40,was,9,7,15,8,6,24,2,6,Japanese Revolution,Japan,MISC-MISC,LOC,PROPN-PROPN,PROPN,compound-pobj,pobj,NNP-NNP,NNP,4,1
1,0.0,40,was,9,7,19,12,6,20,2,10,Japanese Revolution,1868,MISC-MISC,TIME,PROPN-PROPN,NUM,compound-pobj,pobj,NNP-NNP,CD,5,1
2,0.0,40,was,9,7,27,20,6,12,2,18,Japanese Revolution,Tokugawa shogunate,MISC-MISC,ORG-ORG,PROPN-PROPN,PROPN-NOUN,compound-pobj,compound-pobj,NNP-NNP,NNP-NN,8,1
0,2.0,52,is,3,3,12,9,2,39,0,9,Congo,Africa,LOC,LOC,PROPN,PROPN,nsubj,pobj,NNP,NNP,1,1
1,2.0,52,is,3,3,30,27,2,21,0,27,Congo,Brazzaville,LOC,LOC,PROPN,PROPN,nsubj,pobj,NNP,NNP,4,1
0,5.0,36,originates,6,9,24,15,8,11,-3,18,the United States,Utah,LOC-LOC-LOC,LOC,DET-PROPN-PROPN,PROPN,det-compound-pobj,poss,DT-NNP-NNP,NNP,5,1
1,5.0,36,originates,6,18,22,4,17,13,-12,16,Salt Lake City,1847,LOC-LOC-LOC,TIME,PROPN-PROPN-PROPN,NUM,compound-compound-pobj,pobj,NNP-NNP-NNP,CD,8,1
0,0.0,27,"""",0,2,24,22,1,2,-2,24,Clyde Bruckman 's Final Repose,X - Files,MISC-MISC-MISC-MISC-MISC,MISC-MISC-MISC,PROPN-PROPN-PART-PROPN-PROPN,PROPN-PROPN-PROPN,compound-poss-case-compound-nsubj,compound-punct-ROOT,NNP-NNP-POS-NNP-NNP,NNP-NNP-NNP,9,1
1,5.0,34,centers,2,8,11,3,7,22,-6,9,Fox Mulder,David Duchovny,PER-PER,PER-PER,PROPN-PROPN,PROPN-PROPN,compound-appos,compound-appos,NNP-NNP,NNP-NNP,1,1
2,5.0,34,centers,2,15,18,3,14,15,-13,16,Dana Scully,Gillian Anderson,PER-PER,PER-PER,PROPN-PROPN,PROPN-PROPN,compound-appos,compound-appos,NNP-NNP,NNP-NNP,1,1
3,8.0,30,assisted,3,6,9,3,5,20,-3,6,Clyde Bruckman,Peter Boyle,PER-PER,PER-PER,PROPN-PROPN,PROPN-PROPN,compound-pobj,compound-appos,NNP-NNP,NNP-NNP,1,1
0,0.0,15,is,8,1,5,4,0,9,7,-3,Subin Bhattarai,5 November 1982,PER-PER,TIME-TIME-TIME,PROPN-PROPN,NUM-PROPN-NUM,compound-nsubj,nummod-npadvmod-nummod,NNP-NNP,CD-NNP-CD,2,1
1,0.0,15,is,8,1,11,10,0,3,7,3,Subin Bhattarai,Nepali,PER-PER,LOC,PROPN-PROPN,PROPN,compound-nsubj,amod,NNP-NNP,NNP,2,1
0,1.0,37,Wodehouse,0,14,17,3,13,19,-14,17,Herbert Jenkins,London,PER-PER,LOC,PROPN-PROPN,PROPN,compound-pobj,conj,NNP-NNP,NNP,3,1
1,2.0,34,serialised,5,10,14,4,9,19,-5,9,Strand Magazine,UK,ORG-ORG,LOC,PROPN-PROPN,PROPN,compound-pobj,pobj,NNP-NNP,NNP,3,1
2,2.0,34,serialised,5,27,25,-2,26,8,-22,20,Cosmopolitan Magazine,US,MISC-MISC,LOC,PROPN-PROPN,PROPN,compound-pobj,pobj,NNP-NNP,NNP,1,1
0,4.0,17,named,2,9,13,4,8,3,-7,11,Alexander Vasilyevich Alexandrov,1883,PER-PER-PER,TIME,PROPN-PROPN-PROPN,NUM,compound-compound-appos,nummod,NNP-NNP-NNP,CD,3,1
1,6.0,50,killed,20,10,36,26,9,13,10,16,Valery Khalilov,Black Sea,PER-PER,LOC-LOC,PROPN-PROPN,PROPN-PROPN,compound-appos,compound-pobj,NNP-NNP,NNP-NNP,4,1
2,6.0,50,killed,20,47,49,2,46,0,-27,29,Sochi,Russia,LOC,LOC,PROPN,PROPN,pobj,appos,NNP,NNP,8,1
0,10.0,7,called,4,1,6,5,0,0,3,2,Glazman,BlueGriffon,PER,MISC,PROPN,PROPN,poss,oprd,NNP,NNP,4,1
0,0.0,25,is,12,22,24,2,21,0,-10,12,Kelantan,Malaysia,LOC,LOC,PROPN,PROPN,pobj,appos,NNP,NNP,6,1
0,0.0,23,is,3,1,22,21,0,0,2,19,Chief Minister 's Office,India,ORG-ORG-ORG-ORG,LOC,PROPN-PROPN-PART-PROPN,PROPN,compound-poss-case-pobj,appos,NNP-NNP-POS-NNP,NNP,10,1
1,0.0,23,is,3,18,22,4,17,0,-15,19,Government of Maharashtra,India,ORG-ORG-ORG,LOC,PROPN-ADP-PROPN,PROPN,appos-prep-pobj,appos,NNP-IN-NNP,NNP,5,1
0,5.0,22,is,14,8,11,3,7,10,6,-3,Poe,Virginia Eliza Clemm Poe,PER,PER-PER-PER-PER,PROPN,PROPN-PROPN-PROPN-PROPN,poss,compound-compound-compound-appos,NNP,NNP-NNP-NNP-NNP,3,1
1,6.0,18,published,7,12,3,-9,11,14,-5,-4,Poe,1849,PER,TIME,PROPN,NUM,poss,pobj,NNP,CD,6,1
0,3.0,23,named,3,7,10,3,6,12,-4,7,U.S.,Pennsylvania,LOC,LOC,PROPN,PROPN,compound,pobj,NNP,NNP,1,1
0,0.0,18,is,4,1,9,8,0,8,3,5,John Galt,Ayn Rand,PER-PER,PER-PER,PROPN-PROPN,PROPN-PROPN,compound-nsubj,compound-poss,NNP-NNP,NNP-NNP,5,1
1,0.0,18,is,4,1,13,12,0,4,3,9,John Galt,Atlas Shrugged,PER-PER,MISC-MISC,PROPN-PROPN,PROPN-PROPN,compound-nsubj,compound-pobj,NNP-NNP,NNP-NNP,5,1
2,0.0,18,is,4,9,13,4,8,4,-5,9,Ayn Rand,Atlas Shrugged,PER-PER,MISC-MISC,PROPN-PROPN,PROPN-PROPN,compound-poss,compound-pobj,NNP-NNP,NNP-NNP,2,1
3,0.0,18,is,4,13,16,3,12,1,-9,12,Atlas Shrugged,1957,MISC-MISC,TIME,PROPN-PROPN,NUM,compound-pobj,appos,NNP-NNP,CD,1,1
0,0.0,6,served,3,1,6,5,0,-1,2,3,Nancy H. Rubin,U.S.,PER-PER-PER,LOC,PROPN-PROPN-PROPN,PROPN,compound-compound-nsubj,pobj,NNP-NNP-NNP,NNP,-1,1
0,0.0,19,is,6,1,14,13,0,4,5,8,St. Saviour 's Church,Latvia,LOC-LOC-LOC-LOC,LOC,PROPN-PROPN-PART-PROPN,PROPN,compound-poss-case-nsubj,npadvmod,NNP-NNP-POS-NNP,NNP,7,1
1,0.0,19,is,6,12,14,2,11,4,-6,8,Riga,Latvia,LOC,LOC,PROPN,PROPN,pobj,npadvmod,NNP,NNP,3,1
2,6.0,18,In,0,9,4,-5,8,13,-9,4,Juris Calitis,Latvian,PER-PER,LOC,PROPN-PROPN,PROPN,compound-nsubj,npadvmod,NNP-NNP,NNP,2,1
0,0.0,24,is,4,1,18,17,0,5,3,14,Northwestern Lehigh School District,Pennsylvania,LOC-LOC-LOC-LOC,LOC,PROPN-PROPN-PROPN-PROPN,PROPN,compound-compound-compound-nsubj,appos,NNP-NNP-NNP-NNP,NNP,5,1
1,0.0,24,is,4,1,11,10,0,12,3,7,Northwestern Lehigh School District,the United States,LOC-LOC-LOC-LOC,LOC-LOC-LOC,PROPN-PROPN-PROPN-PROPN,DET-PROPN-PROPN,compound-compound-compound-nsubj,det-compound-pobj,NNP-NNP-NNP-NNP,DT-NNP-NNP,7,1
2,0.0,24,is,4,2,18,16,1,5,2,14,Lehigh County,Pennsylvania,LOC-LOC,LOC,PROPN-PROPN,PROPN,compound-pobj,appos,NNP-NNP,NNP,4,1
3,0.0,24,is,4,2,11,9,1,12,2,7,Lehigh County,the United States,LOC-LOC,LOC-LOC-LOC,PROPN-PROPN,DET-PROPN-PROPN,compound-pobj,det-compound-pobj,NNP-NNP,DT-NNP-NNP,6,1
4,0.0,24,is,4,18,11,-7,17,12,-14,7,Pennsylvania,the United States,LOC,LOC-LOC-LOC,PROPN,DET-PROPN-PROPN,appos,det-compound-pobj,NNP,DT-NNP-NNP,4,1
0,0.0,22,was,14,1,5,4,0,16,13,-9,Ford Christopher Frick,"December 19 , 1894",PER-PER-PER,TIME-TIME-TIME-TIME,PROPN-PROPN-PROPN,PROPN-NUM-PUNCT-NUM,compound-compound-nsubj,nmod-nummod-punct-nummod,NNP-NNP-NNP,"NNP-CD-,-CD",3,1
1,0.0,22,was,14,1,10,9,0,11,13,-4,Ford Christopher Frick,"April 8 , 1978",PER-PER-PER,TIME-TIME-TIME-TIME,PROPN-PROPN-PROPN,PROPN-NUM-PUNCT-NUM,compound-compound-nsubj,appos-nummod-punct-nummod,NNP-NNP-NNP,"NNP-CD-,-CD",4,1
2,0.0,22,was,14,1,17,16,0,4,13,3,Ford Christopher Frick,American,PER-PER-PER,LOC,PROPN-PROPN-PROPN,ADJ,compound-compound-nsubj,amod,NNP-NNP-NNP,JJ,3,1
0,0.0,26,Meynert,2,1,5,4,0,20,1,3,Theodor Hermann Meynert,15 June 1833,PER-PER-PER,TIME-TIME-TIME,PROPN-PROPN-PROPN,NUM-PROPN-NUM,compound-compound-ROOT,nummod-nmod-nummod,NNP-NNP-NNP,CD-NNP-CD,2,1
1,0.0,26,Meynert,2,1,9,8,0,16,1,7,Theodor Hermann Meynert,31 May 1892,PER-PER-PER,TIME-TIME-TIME,PROPN-PROPN-PROPN,NUM-PROPN-NUM,compound-compound-ROOT,nummod-nsubj-nummod,NNP-NNP-NNP,CD-NNP-CD,3,1
2,0.0,26,Meynert,2,1,25,24,0,0,1,23,Theodor Hermann Meynert,Dresden,PER-PER-PER,LOC,PROPN-PROPN-PROPN,PROPN,compound-compound-ROOT,pobj,NNP-NNP-NNP,NNP,3,1
3,6.0,37,were,6,10,13,3,9,23,-4,7,Sergei Korsakoff,1854,PER-PER,TIME,PROPN-PROPN,NUM,compound-attr,nummod,NNP-NNP,CD,1,1
4,6.0,37,were,6,10,15,5,9,21,-4,9,Sergei Korsakoff,1900,PER-PER,TIME,PROPN-PROPN,NUM,compound-attr,nummod,NNP-NNP,CD,1,1
5,7.0,21,was,3,14,17,3,13,3,-11,14,Paul Flechsig,1847,PER-PER,TIME,PROPN-PROPN,NUM,compound-pobj,nummod,NNP-NNP,CD,1,1
6,7.0,21,was,3,14,19,5,13,1,-11,16,Paul Flechsig,1929,PER-PER,TIME,PROPN-PROPN,NUM,compound-pobj,nummod,NNP-NNP,CD,1,1
0,2.0,66,found,3,13,16,3,12,49,-10,13,La Venta,Colombia,LOC-LOC,LOC,PROPN-PROPN,PROPN,compound-pobj,pobj,NNP-NNP,NNP,1,1
0,0.0,38,is,5,1,4,3,0,33,4,-1,Germinie Lacerteux,1865,MISC-MISC,TIME,PROPN-PROPN,NUM,compound-nsubj,appos,NNP-NNP,CD,1,1
1,0.0,38,is,5,1,15,14,0,22,4,10,Germinie Lacerteux,Edmond,MISC-MISC,PER,PROPN-PROPN,PROPN,compound-nsubj,nmod,NNP-NNP,NNP,5,1
2,0.0,38,is,5,1,17,16,0,20,4,12,Germinie Lacerteux,Jules de Goncourt,MISC-MISC,PER-PER-PER,PROPN-PROPN,PROPN-PROPN-PROPN,compound-nsubj,conj-compound-pobj,NNP-NNP,NNP-NNP-NNP,6,1
0,0.0,21,spelled,7,16,20,4,15,0,-9,13,Aleppo Governorate,Syria,LOC-LOC,LOC,PROPN-PROPN,PROPN,compound-pobj,appos,NNP-NNP,NNP,4,1
1,1.0,47,located,17,43,46,3,42,0,-26,29,Turkish,Kilis,LOC,LOC,ADJ,PROPN,amod,pobj,JJ,NNP,6,1
0,0.0,17,is,8,14,16,2,13,0,-6,8,Leipzig,Germany,LOC,LOC,PROPN,PROPN,pobj,appos,NNP,NNP,5,1
1,1.0,44,associated,2,24,43,19,23,0,-22,41,Johann Sebastian Bach,1750,PER-PER-PER,TIME,PROPN-PROPN-PROPN,NUM,compound-compound-pobj,pobj,NNP-NNP-NNP,CD,4,1
0,3.0,32,makes,3,18,20,2,17,11,-15,17,TNG,Deep Space Nine,MISC,MISC-MISC-MISC,PROPN,PROPN-PROPN-PROPN,appos,compound-compound-conj,NNP,NNP-NNP-NNP,3,1
1,3.0,32,makes,3,20,25,5,19,6,-17,22,Deep Space Nine,Voyager,MISC-MISC-MISC,MISC,PROPN-PROPN-PROPN,PROPN,compound-compound-conj,conj,NNP-NNP-NNP,NNP,3,1
0,0.0,27,is,3,1,16,15,0,10,2,13,Surry Mountain Lake,New Hampshire,LOC-LOC-LOC,LOC-LOC,PROPN-PROPN-PROPN,PROPN-PROPN,compound-compound-nsubj,compound-pobj,NNP-NNP-NNP,NNP-NNP,5,1
1,0.0,27,is,3,1,19,18,0,7,2,16,Surry Mountain Lake,United States,LOC-LOC-LOC,LOC-LOC,PROPN-PROPN-PROPN,PROPN-PROPN,compound-compound-nsubj,compound-appos,NNP-NNP-NNP,NNP-NNP,6,1
2,0.0,27,is,3,9,16,7,8,10,-6,13,Ashuelot River,New Hampshire,LOC-LOC,LOC-LOC,PROPN-PROPN,PROPN-PROPN,compound-pobj,compound-pobj,NNP-NNP,NNP-NNP,4,1
3,0.0,27,is,3,9,19,10,8,7,-6,16,Ashuelot River,United States,LOC-LOC,LOC-LOC,PROPN-PROPN,PROPN-PROPN,compound-pobj,compound-appos,NNP-NNP,NNP-NNP,5,1
4,0.0,27,is,3,12,16,4,11,10,-9,13,Cheshire County,New Hampshire,LOC-LOC,LOC-LOC,PROPN-PROPN,PROPN-PROPN,compound-pobj,compound-pobj,NNP-NNP,NNP-NNP,6,1
5,0.0,27,is,3,12,19,7,11,7,-9,16,Cheshire County,United States,LOC-LOC,LOC-LOC,PROPN-PROPN,PROPN-PROPN,compound-pobj,compound-appos,NNP-NNP,NNP-NNP,7,1
6,0.0,27,is,3,12,1,-11,11,25,-9,-2,Cheshire County,Surry,LOC-LOC,LOC,PROPN-PROPN,PROPN,compound-pobj,pobj,NNP-NNP,NNP,7,1
7,0.0,27,is,3,16,19,3,15,7,-13,16,New Hampshire,United States,LOC-LOC,LOC-LOC,PROPN-PROPN,PROPN-PROPN,compound-pobj,compound-appos,NNP-NNP,NNP-NNP,1,1
0,0.0,41,is,13,4,10,6,3,30,9,-3,Bruce Reid Ferguson,14 July 1949,PER-PER-PER,TIME-TIME-TIME,PROPN-PROPN-PROPN,NUM-PROPN-NUM,compound-compound-nsubj,nummod-npadvmod-nummod,NNP-NNP-NNP,CD-NNP-CD,4,1
1,0.0,41,is,13,4,17,13,3,23,9,4,Bruce Reid Ferguson,Royal New Zealand Air Force,PER-PER-PER,ORG-ORG-ORG-ORG-ORG,PROPN-PROPN-PROPN,PROPN-PROPN-PROPN-PROPN-PROPN,compound-compound-nsubj,compound-compound-compound-compound-compound,NNP-NNP-NNP,NNP-NNP-NNP-NNP-NNP,7,1
0,1.0,29,compiled,3,11,14,3,10,14,-8,11,Magnús Ólafsson,c.1573,PER-PER,TIME,PROPN-PROPN,NOUN,compound-dobj,compound,NNP-NNP,NN,2,1
0,0.0,21,is,2,15,20,5,14,0,-13,18,George Town,Malaysia,LOC-LOC,LOC,PROPN-PROPN,PROPN,compound-pobj,appos,NNP-NNP,NNP,8,1
1,0.0,21,is,2,18,20,2,17,0,-16,18,Penang,Malaysia,LOC,LOC,PROPN,PROPN,pobj,appos,NNP,NNP,9,1
0,0.0,22,is,3,1,6,5,0,15,2,3,Samuel G. Freedman,American,PER-PER-PER,LOC,PROPN-PROPN-PROPN,ADJ,compound-compound-nsubj,amod,NNP-NNP-NNP,JJ,3,1
1,0.0,22,is,3,1,16,15,0,5,2,13,Samuel G. Freedman,Columbia University Graduate School of Journalism,PER-PER-PER,ORG-ORG-ORG-ORG-ORG-ORG,PROPN-PROPN-PROPN,PROPN-PROPN-PROPN-PROPN-ADP-PROPN,compound-compound-nsubj,compound-compound-compound-pobj-prep-pobj,NNP-NNP-NNP,NNP-NNP-NNP-NNP-IN-NNP,8,1
0,0.0,18,was,11,1,4,3,0,13,10,-7,Arthur Looss,16 March 1861,PER-PER,TIME-TIME-TIME,PROPN-PROPN,NUM-PROPN-NUM,compound-nsubj,nummod-nmod-nummod,NNP-NNP,CD-NNP-CD,1,1
1,1.0,19,born,2,1,5,4,0,13,1,3,Looss,1861,PER,TIME,PROPN,NUM,nsubjpass,pobj,NNP,CD,2,1
2,1.0,19,born,2,1,7,6,0,11,1,5,Looss,Chemnitz,PER,LOC,PROPN,PROPN,nsubjpass,pobj,NNP,NNP,2,1
3,1.0,19,born,2,16,18,2,15,0,-14,16,Łódź,Poland,LOC,LOC,PROPN,PROPN,pobj,appos,NNP,NNP,6,1
4,10.0,13,died,1,1,10,9,0,2,0,9,Looss,Gießen,PER,LOC,PROPN,PROPN,nsubj,pobj,NNP,NNP,3,1
5,10.0,13,died,1,10,12,2,9,0,-9,11,Gießen,Germany,LOC,LOC,PROPN,PROPN,pobj,appos,NNP,NNP,4,1
0,0.0,28,is,8,16,22,6,15,5,-8,14,Berlin S - Bahn,Germany,MISC-MISC-MISC-MISC,LOC,PROPN-PROPN-PUNCT-PROPN,PROPN,compound-compound-punct-compound,pobj,NNP-NNP-HYPH-NNP,NNP,5,1
0,0.0,15,is,2,1,10,9,0,4,1,8,Black House,Stephen King,MISC-MISC,PER-PER,PROPN-PROPN,PROPN-PROPN,compound-nsubj,compound-appos,NNP-NNP,NNP-NNP,5,1
1,0.0,15,is,2,1,13,12,0,1,1,11,Black House,Peter Straub,MISC-MISC,PER-PER,PROPN-PROPN,PROPN-PROPN,compound-nsubj,compound-conj,NNP-NNP,NNP-NNP,6,1
2,7.0,18,written,6,9,15,6,8,2,-3,9,Edgar Allan Poe,The Raven,PER-PER-PER,MISC-MISC,PROPN-PROPN-PROPN,PROPN-PROPN,compound-compound-poss,det-appos,NNP-NNP-NNP,NNP-NNP,3,1
0,0.0,41,was,13,1,4,3,0,36,12,-9,Dianne Jackson,"July 28 , 1941",PER-PER,TIME-TIME-TIME-TIME,PROPN-PROPN,PROPN-NUM-PUNCT-NUM,compound-nsubj,appos-nummod-punct-nummod,NNP-NNP,"NNP-CD-,-CD",2,1
1,0.0,41,was,13,1,23,22,0,17,12,10,Dianne Jackson,The Snowman,PER-PER,MISC-MISC,PROPN-PROPN,DET-PROPN,compound-nsubj,det-pobj,NNP-NNP,DT-NNP,5,1
2,0.0,41,was,13,23,28,5,22,12,-10,15,The Snowman,1982,MISC-MISC,TIME,DET-PROPN,NUM,det-pobj,pobj,DT-NNP,CD,5,1
3,1.0,23,had,1,19,22,3,18,0,-18,21,Yellow Submarine,1968,MISC-MISC,TIME,PROPN-PROPN,NUM,compound-pobj,pobj,NNP-NNP,CD,3,1
4,3.0,41,directed,2,4,6,2,3,34,-2,4,Granpa,John Burningham,MISC,PER-PER,PROPN,PROPN-PROPN,dobj,compound-pobj,NNP,NNP-NNP,1,1
5,3.0,41,directed,2,4,9,5,3,31,-2,7,Granpa,1989,MISC,TIME,PROPN,NUM,dobj,pobj,NNP,CD,2,1
0,0.0,19,is,2,1,17,16,0,1,1,15,West Cornwall,United Kingdom,LOC-LOC,LOC-LOC,PROPN-PROPN,PROPN-PROPN,compound-nsubj,compound-pobj,NNP-NNP,NNP-NNP,10,1
1,0.0,19,is,2,2,17,15,1,1,0,15,Cornwall,United Kingdom,LOC,LOC-LOC,PROPN,PROPN-PROPN,pobj,compound-pobj,NNP,NNP-NNP,9,1
2,6.0,11,located,4,1,7,6,0,3,3,3,West Cornwall Hospital,Penzance,LOC-LOC-LOC,LOC,PROPN-PROPN-PROPN,PROPN,compound-compound-nsubjpass,pobj,NNP-NNP-NNP,NNP,5,1
0,0.0,28,is,17,1,24,23,0,3,16,7,Ampato,Andes,LOC,LOC,PROPN,PROPN,nsubj,pobj,NNP,NNP,8,1
1,0.0,28,is,17,1,27,26,0,0,16,10,Ampato,Peru,LOC,LOC,PROPN,PROPN,nsubj,pobj,NNP,NNP,4,1
2,0.0,28,is,17,24,27,3,23,0,-7,10,Andes,Peru,LOC,LOC,PROPN,PROPN,pobj,pobj,NNP,NNP,6,1
0,4.0,26,include,5,5,25,20,4,0,0,20,Harvard,HBS,ORG,ORG,PROPN,PROPN,pobj,pobj,NNP,NNP,1,1
0,0.0,41,Lake,2,30,36,6,29,4,-28,34,Cascade Range,Oregon,LOC-LOC,LOC,PROPN-PROPN,PROPN,compound-pobj,pobj,NNP-NNP,NNP,5,1
1,0.0,41,Lake,2,30,29,-1,29,11,-28,27,Cascade Range,the United States,LOC-LOC,LOC-LOC-LOC,PROPN-PROPN,DET-PROPN-PROPN,compound-pobj,det-compound-pobj,NNP-NNP,DT-NNP-NNP,1,1
2,0.0,41,Lake,2,36,29,-7,35,11,-34,27,Oregon,the United States,LOC,LOC-LOC-LOC,PROPN,DET-PROPN-PROPN,pobj,det-compound-pobj,NNP,DT-NNP-NNP,6,1
0,5.0,22,known,3,10,15,5,9,6,-7,12,Monogenea,Platyhelminthes,MISC,MISC,PROPN,PROPN,pobj,pobj,NNP,NNP,3,1
0,0.0,48,IV,1,1,15,14,0,32,0,14,House IV,1992,MISC-MISC,TIME,PROPN-PROPN,NUM,compound-ROOT,nummod,NNP-NNP,CD,6,1
1,0.0,48,IV,1,1,26,25,0,21,0,25,House IV,Lewis Abernathy,MISC-MISC,PER-PER,PROPN-PROPN,PROPN-PROPN,compound-ROOT,compound-pobj,NNP-NNP,NNP-NNP,6,1
2,0.0,48,IV,1,1,31,30,0,16,0,30,House IV,Sean S. Cunningham,MISC-MISC,PER-PER-PER,PROPN-PROPN,PROPN-PROPN-PROPN,compound-ROOT,compound-compound-pobj,NNP-NNP,NNP-NNP-NNP,7,1
3,0.0,48,IV,1,1,43,42,0,4,0,42,House IV,Geoff Miller,MISC-MISC,PER-PER,PROPN-PROPN,PROPN-PROPN,compound-ROOT,compound-pobj,NNP-NNP,NNP-NNP,5,1
4,0.0,48,IV,1,1,46,45,0,1,0,45,House IV,Deidre Higgins,MISC-MISC,PER-PER,PROPN-PROPN,PROPN-PROPN,compound-ROOT,compound-conj,NNP-NNP,NNP-NNP,6,1
5,0.0,48,IV,1,1,15,14,0,32,0,14,House IV : The Reposession,1992,MISC-MISC-MISC-MISC-MISC,TIME,PROPN-PROPN-PUNCT-DET-PROPN,NUM,compound-pobj-punct-det-nsubj,nummod,NNP-NNP-:-DT-NNP,CD,6,1
6,0.0,48,IV,1,1,26,25,0,21,0,25,House IV : The Reposession,Lewis Abernathy,MISC-MISC-MISC-MISC-MISC,PER-PER,PROPN-PROPN-PUNCT-DET-PROPN,PROPN-PROPN,compound-pobj-punct-det-nsubj,compound-pobj,NNP-NNP-:-DT-NNP,NNP-NNP,6,1
7,0.0,48,IV,1,1,43,42,0,4,0,42,House IV : The Reposession,Geoff Miller,MISC-MISC-MISC-MISC-MISC,PER-PER,PROPN-PROPN-PUNCT-DET-PROPN,PROPN-PROPN,compound-pobj-punct-det-nsubj,compound-pobj,NNP-NNP-:-DT-NNP,NNP-NNP,5,1
8,0.0,48,IV,1,1,46,45,0,1,0,45,House IV : The Reposession,Deidre Higgins,MISC-MISC-MISC-MISC-MISC,PER-PER,PROPN-PROPN-PUNCT-DET-PROPN,PROPN-PROPN,compound-pobj-punct-det-nsubj,compound-conj,NNP-NNP-:-DT-NNP,NNP-NNP,6,1
0,0.0,20,is,6,1,15,14,0,4,5,9,Ou Reang Ov District,Tboung Khmum Province,LOC-LOC-LOC-LOC,LOC-LOC-LOC,PROPN-PROPN-PROPN-PROPN,PROPN-PROPN-PROPN,compound-compound-compound-nsubj,compound-compound-pobj,NNP-NNP-NNP-NNP,NNP-NNP-NNP,8,1
1,0.0,20,is,6,1,19,18,0,0,5,13,Ou Reang Ov District,Cambodia,LOC-LOC-LOC-LOC,LOC,PROPN-PROPN-PROPN-PROPN,PROPN,compound-compound-compound-nsubj,appos,NNP-NNP-NNP-NNP,NNP,2,1
2,0.0,20,is,6,15,19,4,14,0,-9,13,Tboung Khmum Province,Cambodia,LOC-LOC-LOC,LOC,PROPN-PROPN-PROPN,PROPN,compound-compound-pobj,appos,NNP-NNP-NNP,NNP,8,1
0,0.0,29,is,11,1,8,7,0,20,10,-3,Hassan Rahimpour Azghadi,1964,PER-PER-PER,TIME,PROPN-PROPN-PROPN,NUM,compound-compound-nsubj,npadvmod,NNP-NNP-NNP,CD,4,1
1,0.0,29,is,11,1,10,9,0,18,10,-1,Hassan Rahimpour Azghadi,1965,PER-PER-PER,TIME,PROPN-PROPN-PROPN,NUM,compound-compound-nsubj,conj,NNP-NNP-NNP,CD,3,1
2,0.0,29,is,11,1,14,13,0,14,10,3,Hassan Rahimpour Azghadi,Iranian,PER-PER-PER,LOC,PROPN-PROPN-PROPN,ADJ,compound-compound-nsubj,amod,NNP-NNP-NNP,JJ,3,1
3,0.0,29,is,11,1,21,20,0,7,10,10,Hassan Rahimpour Azghadi,Iran,PER-PER-PER,LOC,PROPN-PROPN-PROPN,PROPN,compound-compound-nsubj,poss,NNP-NNP-NNP,NNP,7,1
0,3.0,26,are,7,10,13,3,9,12,-3,6,South America,Brazil,LOC-LOC,LOC,PROPN-PROPN,PROPN,compound-pobj,appos,NNP-NNP,NNP,2,1
1,3.0,26,are,7,10,15,5,9,10,-3,8,South America,Argentina,LOC-LOC,LOC,PROPN-PROPN,PROPN,compound-pobj,npadvmod,NNP-NNP,NNP,2,1
2,4.0,22,discovered,8,18,15,-3,17,6,-10,7,Argentina,San Juan,LOC,LOC-LOC,PROPN,PROPN-PROPN,appos,compound-pobj,NNP,NNP-NNP,5,1
3,4.0,22,discovered,8,12,15,3,11,6,-4,7,Ischigualasto Formation,San Juan,LOC-LOC,LOC-LOC,PROPN-PROPN,PROPN-PROPN,compound-pobj,compound-pobj,NNP-NNP,NNP-NNP,2,1
0,0.0,23,is,8,13,16,3,12,6,-5,8,Union County,New Jersey,LOC-LOC,LOC-LOC,PROPN-PROPN,PROPN-PROPN,compound-pobj,compound-appos,NNP-NNP,NNP-NNP,1,1
1,0.0,23,is,8,13,20,7,12,2,-5,12,Union County,the United States,LOC-LOC,LOC-LOC-LOC,PROPN-PROPN,DET-PROPN-PROPN,compound-pobj,det-compound-pobj,NNP-NNP,DT-NNP-NNP,5,1
2,0.0,23,is,8,16,20,4,15,2,-8,12,New Jersey,the United States,LOC-LOC,LOC-LOC-LOC,PROPN-PROPN,DET-PROPN-PROPN,compound-appos,det-compound-pobj,NNP-NNP,DT-NNP-NNP,6,1
0,0.0,20,is,3,1,6,5,0,13,2,3,CBS Sports Network,American,ORG-ORG-ORG,LOC,PROPN-PROPN-PROPN,ADJ,compound-compound-nsubj,amod,NNP-NNPS-NNP,JJ,5,1
0,2.0,27,conceived,4,15,18,3,14,8,-11,14,Estefan,Emilio Estefan,PER,PER-PER,PROPN,PROPN-PROPN,poss,compound-nsubj,NNP,NNP-NNP,3,1
0,1.0,33,Recorded,0,19,27,8,18,5,-19,27,Wandering As Water,Return To Sender Records,MISC-MISC-MISC,ORG-ORG-ORG-ORG,VERB-ADP-PROPN,PROPN-ADP-PROPN-PROPN,compound-mark-nsubjpass,pobj-prep-compound-pobj,VBG-IN-NNP,NNP-IN-NNP-NNPS,2,1
1,1.0,33,Recorded,0,27,32,5,26,0,-27,32,Return To Sender Records,Germany,ORG-ORG-ORG-ORG,LOC,PROPN-ADP-PROPN-PROPN,PROPN,pobj-prep-compound-pobj,pobj,NNP-IN-NNP-NNPS,NNP,3,1
2,5.0,45,"""",0,31,43,12,30,1,-31,43,Embryonic Journey,Jefferson Airplane,MISC-MISC,ORG-ORG,ADJ-NOUN,PROPN-PROPN,compound-nsubjpass,compound-pobj,JJ-NN,NNP-NNP,7,1
0,0.0,40,was,15,1,4,3,0,35,14,-11,Hans Meiser,16 February 1881,PER-PER,TIME-TIME-TIME,PROPN-PROPN,NUM-PROPN-NUM,compound-nsubj,nummod-appos-nummod,NNP-NNP,CD-NNP-CD,1,1
1,0.0,40,was,15,1,8,7,0,31,14,-7,Hans Meiser,Nuremberg,PER-PER,LOC,PROPN-PROPN,PROPN,compound-nsubj,compound,NNP-NNP,NNP,3,1
2,0.0,40,was,15,1,10,9,0,29,14,-5,Hans Meiser,8 June 1956,PER-PER,TIME-TIME-TIME,PROPN-PROPN,NUM-PROPN-NUM,compound-nsubj,nummod-npadvmod-nummod,NNP-NNP,CD-NNP-CD,1,1
3,0.0,40,was,15,1,14,13,0,25,14,-1,Hans Meiser,Munich,PER-PER,LOC,PROPN-PROPN,PROPN,compound-nsubj,appos,NNP-NNP,NNP,2,1
4,0.0,40,was,15,18,19,1,17,20,-3,4,German,Protestant,LOC,ORG,ADJ,ADJ,amod,amod,JJ,JJ,1,1
0,0.0,21,is,3,2,17,15,1,3,1,14,Consideration,Anti,MISC,MISC,NOUN,PROPN,nsubj,appos,NN,NNP,4,1
1,0.0,21,is,3,2,19,17,1,1,1,16,Consideration,2016,MISC,TIME,NOUN,NUM,nsubj,appos,NN,CD,2,1
2,0.0,21,is,3,17,19,2,16,1,-14,16,Anti,2016,MISC,TIME,PROPN,NUM,appos,appos,NNP,CD,4,1
3,2.0,45,is,3,2,12,10,1,32,1,9,Consideration,R&B,MISC,MISC,NOUN,NOUN,nsubj,conj,NN,NN,3,1
0,0.0,28,is,3,1,17,16,0,10,2,14,Southwest National Park,Australia,LOC-LOC-LOC,LOC,PROPN-PROPN-PROPN,PROPN,compound-compound-nsubj,conj,NNP-NNP-NNP,NNP,5,1
1,0.0,28,is,3,15,17,2,14,10,-12,14,Tasmania,Australia,LOC,LOC,PROPN,PROPN,pobj,conj,NNP,NNP,6,1
0,0.0,23,"""",0,2,8,6,1,14,-2,8,Putting Holes in Happiness,Marilyn Manson,MISC-MISC-MISC-MISC,PER-PER,VERB-PROPN-ADP-NOUN,PROPN-PROPN,csubj-dobj-prep-pobj,compound-poss,VBG-NNP-IN-NN,NNP-NNP,4,1
1,2.0,46,released,7,36,27,-9,35,18,-29,20,Putting Holes in Happiness,Marilyn Manson,MISC-MISC-MISC-MISC,PER-PER,VERB-PROPN-ADP-PROPN,PROPN-PROPN,xcomp-dobj-prep-pobj,compound-nsubj,VBG-NNP-IN-NNP,NNP-NNP,3,1
2,1.0,82,set,15,34,39,5,33,42,-19,24,Manson,Interscope,PER,ORG,PROPN,PROPN,poss,conj,NNP,NNP,4,1
3,4.0,30,released,27,24,22,-2,23,7,3,-5,Philippe Grandrieux,French,PER-PER,LOC,PROPN-PROPN,ADJ,compound-appos,amod,NNP-NNP,JJ,1,1
0,0.0,14,is,7,1,6,5,0,7,6,-1,Joan Winifred Cribb,1930,PER-PER-PER,TIME,PROPN-PROPN-PROPN,NUM,compound-compound-compound,npadvmod,NNP-NNP-NNP,CD,3,1
1,1.0,15,born,2,5,7,2,4,7,-3,5,Brisbane,Queensland,LOC,LOC,PROPN,PROPN,pobj,conj,NNP,NNP,3,1
0,0.0,20,was,14,1,5,4,0,14,13,-9,Elizabeth Sterling Haynes,"December 7 , 1897",PER-PER-PER,TIME-TIME-TIME-TIME,PROPN-PROPN-PROPN,PROPN-NUM-PUNCT-NUM,compound-compound-nsubj,appos-nummod-punct-nummod,NNP-NNP-NNP,"NNP-CD-,-CD",3,1
1,0.0,20,was,14,1,10,9,0,9,13,-4,Elizabeth Sterling Haynes,"April 26 , 1957",PER-PER-PER,TIME-TIME-TIME-TIME,PROPN-PROPN-PROPN,PROPN-NUM-PUNCT-NUM,compound-compound-nsubj,appos-nummod-punct-nummod,NNP-NNP-NNP,"NNP-CD-,-CD",4,1
2,1.0,21,emigrated,13,5,8,3,4,12,8,-5,County Durham,England,LOC-LOC,LOC,PROPN-PROPN,PROPN,compound-conj,appos,NNP-NNP,NNP,2,1
3,1.0,21,emigrated,13,16,18,2,15,2,-3,5,Ontario,Canada,LOC,LOC,PROPN,PROPN,pobj,appos,NNP,NNP,4,1
0,0.0,58,called,45,9,11,2,8,46,36,-34,Linz,Austria,LOC,LOC,PROPN,PROPN,pobj,appos,NNP,NNP,2,1
1,1.0,28,performed,17,10,20,10,9,7,7,3,Gisela Forster,Roman Catholic,PER-PER,ORG-ORG,PROPN-PROPN,ADJ-ADJ,compound-pobj,compound-amod,NNP-NNP,JJ-JJ,7,1
0,0.0,38,is,15,1,8,7,0,29,14,-7,Cheb Sahraoui,Tlemcen,PER-PER,LOC,PROPN-PROPN,PROPN,compound-nsubj,conj,NNP-NNP,NNP,3,1
1,0.0,38,is,15,1,10,9,0,27,14,-5,Cheb Sahraoui,Algeria,PER-PER,LOC,PROPN-PROPN,PROPN,compound-nsubj,conj,NNP-NNP,NNP,2,1
2,0.0,38,is,15,1,12,11,0,25,14,-3,Cheb Sahraoui,1 April 1961,PER-PER,TIME-TIME-TIME,PROPN-PROPN,NUM-PROPN-NUM,compound-nsubj,nummod-appos-nummod,NNP-NNP,CD-NNP-CD,2,1
3,0.0,38,is,15,1,18,17,0,19,14,3,Cheb Sahraoui,Algerian,PER-PER,LOC,PROPN-PROPN,ADJ,compound-nsubj,amod,NNP-NNP,JJ,2,1
4,0.0,38,is,15,5,10,5,4,27,10,-5,Mohammed Sahraoui,Algeria,PER-PER,LOC,PROPN-PROPN,PROPN,compound-appos,conj,NNP-NNP,NNP,1,1
5,0.0,38,is,15,5,18,13,4,19,10,3,Mohammed Sahraoui,Algerian,PER-PER,LOC,PROPN-PROPN,ADJ,compound-appos,amod,NNP-NNP,JJ,3,1
6,0.0,38,is,15,8,10,2,7,27,7,-5,Tlemcen,Algeria,LOC,LOC,PROPN,PROPN,conj,conj,NNP,NNP,3,1
7,0.0,38,is,15,8,18,10,7,19,7,3,Tlemcen,Algerian,LOC,LOC,PROPN,ADJ,conj,amod,NNP,JJ,5,1
0,2.0,18,received,1,9,9,0,8,8,-8,8,University of Trinity College,University of Toronto,ORG-ORG-ORG-ORG,ORG-ORG-ORG,PROPN-ADP-PROPN-PROPN,PROPN-ADP-PROPN,nmod-prep-pobj-pobj,pobj-prep-pobj,NNP-IN-NNP-NNP,NNP-IN-NNP,0,1
0,0.0,28,is,3,1,6,5,0,21,2,3,The Great Garrick,1937,MISC-MISC-MISC,TIME,DET-PROPN-PROPN,NUM,det-compound-nsubj,nummod,DT-NNP-NNP,CD,4,1
1,0.0,28,is,3,1,13,12,0,14,2,10,The Great Garrick,James Whale,MISC-MISC-MISC,PER-PER,DET-PROPN-PROPN,PROPN-PROPN,det-compound-nsubj,compound-pobj,DT-NNP-NNP,NNP-NNP,6,1
2,0.0,28,is,3,1,17,16,0,10,2,14,The Great Garrick,Brian Aherne,MISC-MISC-MISC,PER-PER,DET-PROPN-PROPN,PROPN-PROPN,det-compound-nsubj,compound-dobj,DT-NNP-NNP,NNP-NNP,6,1
3,0.0,28,is,3,1,20,19,0,7,2,17,The Great Garrick,Olivia de Havilland,MISC-MISC-MISC,PER-PER-PER,DET-PROPN-PROPN,PROPN-PROPN-PROPN,det-compound-nsubj,compound-compound-conj,DT-NNP-NNP,NNP-NNP-NNP,8,1
4,0.0,28,is,3,1,25,24,0,2,2,22,The Great Garrick,Edward Everett Horton,MISC-MISC-MISC,PER-PER-PER,DET-PROPN-PROPN,PROPN-PROPN-PROPN,det-compound-nsubj,compound-compound-conj,DT-NNP-NNP,NNP-NNP-NNP,4,1
0,1.0,46,introduced,4,32,36,4,31,9,-28,32,Southeast Asia,Pacific Ocean,LOC-LOC,LOC-LOC,PROPN-PROPN,PROPN-PROPN,compound-pobj,compound-conj,NNP-NNP,NNP-NNP,1,1
1,3.0,28,has,7,17,15,-2,16,12,-10,8,New Guinea,Oceania,LOC-LOC,LOC,PROPN-PROPN,PROPN,compound-pobj,pobj,NNP-NNP,NNP,1,1
2,3.0,28,has,7,21,15,-6,20,12,-14,8,Indo - Malayan Archipelago,Oceania,LOC-LOC-LOC-LOC,LOC,PROPN-PUNCT-PROPN-PROPN,PROPN,compound-punct-compound-pobj,pobj,NNP-HYPH-NNP-NNP,NNP,5,1
3,3.0,28,has,7,27,15,-12,26,12,-20,8,Micronesia,Oceania,LOC,LOC,PROPN,PROPN,pobj,pobj,NNP,NNP,3,1
0,6.0,27,is,10,12,16,4,11,10,-2,6,Rajnath Singh,Bharatiya Janta Party,PER-PER,ORG-ORG-ORG,PROPN-PROPN,PROPN-PROPN-PROPN,compound-attr,compound-compound-pobj,NNP-NNP,NNP-NNP-NNP,3,1
1,6.0,27,is,10,12,10,-2,11,16,-2,0,Rajnath Singh,India,PER-PER,LOC,PROPN-PROPN,PROPN,compound-attr,pobj,NNP-NNP,NNP,1,1
2,6.0,27,is,10,16,10,-6,15,16,-6,0,Bharatiya Janta Party,India,ORG-ORG-ORG,LOC,PROPN-PROPN-PROPN,PROPN,compound-compound-pobj,pobj,NNP-NNP-NNP,NNP,4,1
3,6.0,27,is,10,25,10,-15,24,16,-15,0,Sushilkumar Shinde,India,PER-PER,LOC,PROPN-PROPN,PROPN,compound-pobj,pobj,NNP-NNP,NNP,4,1
0,1.0,41,was,11,32,39,7,31,1,-21,28,Battle of the Gulf of Riga,August 1915,MISC-MISC-MISC-MISC-MISC-MISC,TIME-TIME,PROPN-ADP-DET-PROPN-ADP-PROPN,PROPN-NUM,pobj-prep-det-pobj-prep-pobj,pobj-nummod,NNP-IN-DT-NNP-IN-NNP,NNP-CD,6,1
1,1.0,41,was,11,32,7,-25,31,33,-21,-4,Battle of the Gulf of Riga,World War I,MISC-MISC-MISC-MISC-MISC-MISC,MISC-MISC-MISC,PROPN-ADP-DET-PROPN-ADP-PROPN,PROPN-PROPN-PROPN,pobj-prep-det-pobj-prep-pobj,compound-compound-pobj,NNP-IN-DT-NNP-IN-NNP,NNP-NNP-NNP,9,1
2,3.0,23,damaged,12,3,8,5,2,14,9,-4,Battle of Moon Sound,1917,MISC-MISC-MISC-MISC,TIME,PROPN-ADP-PROPN-PROPN,NUM,pobj-prep-compound-pobj,pobj,NNP-IN-NNP-NNP,CD,4,1
0,0.0,13,is,2,1,11,10,0,1,1,9,Ter Heijde,South Holland,LOC-LOC,LOC-LOC,PROPN-PROPN,PROPN-PROPN,compound-nsubj,compound-pobj,NNP-NNP,NNP-NNP,6,1
1,0.0,13,is,2,8,11,3,7,1,-6,9,Dutch,South Holland,LOC,LOC-LOC,ADJ,PROPN-PROPN,amod,compound-pobj,JJ,NNP-NNP,2,1
0,4.0,29,served,2,11,14,3,10,14,-9,12,Discovery Expedition,1901,MISC-MISC,TIME,PROPN-PROPN,NUM,compound-pobj,nummod,NNP-NNP,CD,1,1
1,4.0,29,served,2,22,26,4,21,2,-20,24,British Antarctic Expedition,1907,ORG-ORG-ORG,TIME,ADJ-PROPN-PROPN,NUM,compound-compound-dobj,nummod,JJ-NNP-NNP,CD,4,1
2,4.0,29,served,2,22,1,-21,21,27,-20,-1,British Antarctic Expedition,Shackleton,ORG-ORG-ORG,PER,ADJ-PROPN-PROPN,PROPN,compound-compound-dobj,nsubj,JJ-NNP-NNP,NNP,4,1
3,8.0,28,required,2,7,9,2,6,18,-5,7,Endurance,Shackleton,ORG,PER,NOUN,PROPN,appos,pobj,NN,NNP,2,1
0,0.0,31,(;,2,1,4,3,0,26,1,2,Pauline Kael,"June 19 , 1919",PER-PER,TIME-TIME-TIME-TIME,PROPN-PROPN,PROPN-NUM-PUNCT-NUM,compound-compound,npadvmod-nummod-punct-nummod,NNP-NNP,"NNP-CD-,-CD",3,1
1,0.0,31,(;,2,1,10,9,0,20,1,8,Pauline Kael,"September 3 , 2001",PER-PER,TIME-TIME-TIME-TIME,PROPN-PROPN,PROPN-NUM-PUNCT-NUM,compound-compound,nsubj-nummod-punct-nummod,NNP-NNP,"NNP-CD-,-CD",4,1
0,0.0,26,was,11,1,4,3,0,21,10,-7,Bernhard Siebken,4 April 1910,PER-PER,TIME-TIME-TIME,PROPN-PROPN,NUM-PROPN-NUM,compound-nsubj,nummod-appos-nummod,NNP-NNP,CD-NNP-CD,1,1
1,0.0,26,was,11,1,14,13,0,11,10,3,Bernhard Siebken,German,PER-PER,LOC,PROPN-PROPN,ADJ,compound-nsubj,amod,NNP-NNP,JJ,3,1
2,0.0,26,was,11,1,18,17,0,7,10,7,Bernhard Siebken,World War II,PER-PER,MISC-MISC-MISC,PROPN-PROPN,PROPN-PROPN-PROPN,compound-nsubj,compound-compound-pobj,NNP-NNP,NNP-NNP-NNP,5,1
3,0.0,26,was,11,14,18,4,13,7,-3,7,German,World War II,LOC,MISC-MISC-MISC,ADJ,PROPN-PROPN-PROPN,amod,compound-compound-pobj,JJ,NNP-NNP-NNP,4,1
4,5.0,16,awarded,2,1,5,4,0,10,1,3,Siebken,Knight 's Cross of the Iron Cross,PER,MISC-MISC-MISC-MISC-MISC-MISC-MISC,PROPN,PROPN-PART-PROPN-ADP-DET-PROPN-PROPN,nsubjpass,poss-case-dobj-prep-det-compound-pobj,NNP,NNP-POS-NNP-IN-DT-NNP-NNP,4,1
0,0.0,37,was,19,1,5,4,0,31,18,-14,William English Walling,1877,PER-PER-PER,TIME,PROPN-PROPN-PROPN,NUM,compound-compound-nsubj,nummod,NNP-NNP-NNP,CD,2,1
1,0.0,37,was,19,1,7,6,0,29,18,-12,William English Walling,1936,PER-PER-PER,TIME,PROPN-PROPN-PROPN,NUM,compound-compound-nsubj,nummod,NNP-NNP-NNP,CD,2,1
2,0.0,37,was,19,1,22,21,0,14,18,3,William English Walling,American,PER-PER-PER,LOC,PROPN-PROPN-PROPN,ADJ,compound-compound-nsubj,amod,NNP-NNP-NNP,JJ,4,1
3,0.0,37,was,19,1,27,26,0,9,18,8,William English Walling,Republican,PER-PER-PER,ORG,PROPN-PROPN-PROPN,PROPN,compound-compound-nsubj,conj,NNP-NNP-NNP,NNP,4,1
4,0.0,37,was,19,22,36,14,21,0,-3,17,American,Kentucky,LOC,LOC,ADJ,PROPN,amod,appos,JJ,NNP,3,1
5,4.0,31,left,1,22,29,7,21,1,-21,28,Great War,Central Powers,MISC-MISC,ORG-ORG,PROPN-PROPN,PROPN-PROPN,compound-pobj,compound-dobj,NNP-NNP,NNP-NNPS,6,1
6,4.0,31,left,1,22,17,-5,21,13,-21,16,Great War,United States,MISC-MISC,LOC-LOC,PROPN-PROPN,PROPN-PROPN,compound-pobj,compound-compound,NNP-NNP,NNP-NNP,3,1
0,0.0,19,is,4,1,15,14,0,3,3,11,Zürich Seebach,Swiss,LOC-LOC,LOC,PROPN-PROPN,ADJ,compound-nsubj,amod,NNP-NNP,JJ,6,1
1,0.0,19,is,4,1,1,0,0,17,3,-3,Zürich Seebach,Zürich,LOC-LOC,LOC,PROPN-PROPN,PROPN,compound-nsubj,pobj,NNP-NNP,NNP,0,1
2,0.0,19,is,4,2,15,13,1,3,2,11,Seebach,Swiss,LOC,LOC,PROPN,ADJ,compound,amod,NNP,JJ,6,1
3,0.0,19,is,4,2,1,-1,1,17,2,-3,Seebach,Zürich,LOC,LOC,PROPN,PROPN,compound,pobj,NNP,NNP,2,1
4,0.0,19,is,4,15,1,-14,14,17,-11,-3,Swiss,Zürich,LOC,LOC,ADJ,PROPN,amod,pobj,JJ,NNP,6,1
0,0.0,63,was,1,26,29,3,25,33,-25,28,Joe Lally,Fugazi,PER-PER,ORG,PROPN-PROPN,PROPN,compound-conj,appos,NNP-NNP,NNP,2,1
1,1.0,30,wrote,1,19,25,6,18,4,-18,24,Automatic Writing,AW II,MISC-MISC,MISC-MISC,PROPN-PROPN,PROPN-PROPN,compound-appos,compound-conj,NNP-NNP,NNP-NNP,1,1
2,1.0,30,wrote,1,19,22,3,18,7,-18,21,Automatic Writing,2004,MISC-MISC,TIME,PROPN-PROPN,NUM,compound-appos,appos,NNP-NNP,CD,1,1
3,1.0,30,wrote,1,25,28,3,24,1,-24,27,AW II,2007,MISC-MISC,TIME,PROPN-PROPN,NUM,compound-conj,npadvmod,NNP-NNP,CD,1,1
0,1.0,33,was,6,18,24,6,17,8,-12,18,German Revolution,1918,MISC-MISC,TIME,PROPN-PROPN,NUM,compound-pobj,nummod,NNP-NNP,CD,4,1
1,2.0,21,took,1,6,20,14,5,0,-5,19,Berlin,Germany,LOC,LOC,PROPN,PROPN,pobj,appos,NNP,NNP,3,1
2,4.0,31,was,2,25,29,4,24,1,-23,27,Social Democratic,Friedrich Ebert,ORG-ORG,PER-PER,PROPN-ADJ,PROPN-PROPN,nmod-amod,compound-pobj,NNP-JJ,NNP-NNP,3,1
0,2.0,20,elevated,2,1,11,10,0,8,1,9,Joseph Stalin,Communist Party,PER-PER,ORG-ORG,PROPN-PROPN,PROPN-PROPN,compound-nsubj,compound-pobj,NNP-NNP,NNP-NNP,5,1
0,2.0,54,formed,3,37,41,4,36,12,-34,38,Fredrik Reinfeldt,Moderate Party,PER-PER,ORG-ORG,PROPN-PROPN,PROPN-PROPN,compound-nsubj,compound-pobj,NNP-NNP,NNP-NNP,2,1
0,0.0,30,is,4,1,7,6,0,22,3,3,The Hitch - Hiker,1953,MISC-MISC-MISC-MISC,TIME,DET-PROPN-PUNCT-PROPN,NUM,det-compound-punct-nsubj,nummod,DT-NNP-HYPH-NNP,CD,4,1
1,0.0,30,is,4,1,12,11,0,17,3,8,The Hitch - Hiker,Ida Lupino,MISC-MISC-MISC-MISC,PER-PER,DET-PROPN-PUNCT-PROPN,PROPN-PROPN,det-compound-punct-nsubj,compound-pobj,DT-NNP-HYPH-NNP,NNP-NNP,6,1
2,1.0,57,written,20,33,27,-6,32,29,-13,7,Collier Young,Lupino,PER-PER,PER,PROPN-PROPN,PROPN,compound-appos,conj,NNP-NNP,NNP,3,1
3,1.0,57,written,20,42,47,5,41,9,-22,27,Out of the Past,Daniel Mainwaring,MISC-MISC-MISC-MISC,PER-PER,ADP-ADP-DET-PROPN,PROPN-PROPN,advmod-prep-det-compound,compound-appos,IN-IN-DT-NNP,NNP-NNP,7,1
4,1.0,57,written,20,10,13,3,9,43,10,-7,Billy Cook,1928,PER-PER,TIME,PROPN-PROPN,NUM,compound-appos,nummod,NNP-NNP,CD,1,1
5,1.0,57,written,20,10,15,5,9,41,10,-5,Billy Cook,1952,PER-PER,TIME,PROPN-PROPN,NUM,compound-appos,appos,NNP-NNP,CD,1,1
0,0.0,27,is,13,1,10,9,0,16,12,-3,Renzo Andrés Reggiardo Barreto,1 July 1972,PER-PER-PER-PER,TIME-TIME-TIME,VERB-PROPN-PROPN-PROPN,NUM-PROPN-NUM,compound-compound-compound-nsubj,nummod-appos-nummod,VB-NNP-NNP-NNP,CD-NNP-CD,3,1
1,0.0,27,is,13,1,16,15,0,10,12,3,Renzo Andrés Reggiardo Barreto,Peruvian,PER-PER-PER-PER,LOC,VERB-PROPN-PROPN-PROPN,ADJ,compound-compound-compound-nsubj,amod,VB-NNP-NNP-NNP,JJ,3,1
2,1.0,17,is,2,1,15,14,0,1,1,13,Renzo Reggiardo,Andrés Reggiardo,PER-PER,PER-PER,PROPN-PROPN,PROPN-PROPN,compound-nsubj,compound-appos,NNP-NNP,NNP-NNP,5,1
0,0.0,15,Guess,1,1,12,11,0,2,0,11,The Guess Who,Winnipeg,ORG-ORG-ORG,LOC,DET-PROPN-PRON,PROPN,det-ROOT-nsubj,pobj,DT-NNP-WP,NNP,2,1
1,0.0,15,Guess,1,1,14,13,0,0,0,13,The Guess Who,1965,ORG-ORG-ORG,TIME,DET-PROPN-PRON,NUM,det-ROOT-nsubj,pobj,DT-NNP-WP,CD,1,1
2,4.0,14,inducted,3,8,7,-1,7,6,-5,4,Music Hall of Fame,Canadian,MISC-MISC-MISC-MISC,LOC,PROPN-PROPN-ADP-PROPN,PROPN,compound-pobj-prep-pobj,compound,NNP-NNP-IN-NNP,NNP,1,1
0,0.0,17,is,1,1,11,10,0,5,0,10,Gogglebox,Channel 4,MISC,MISC-MISC,PROPN,PROPN-NUM,nsubj,pobj-nummod,NNP,NNP-CD,5,1
1,6.0,20,diagnosed,2,1,17,16,0,2,1,15,Aherne,2 July 2016,PER,TIME-TIME-TIME,PROPN,NUM-PROPN-NUM,nsubjpass,nummod-pobj-nummod,NNP,CD-NNP-CD,6,1
0,0.0,17,was,12,1,5,4,0,11,11,-7,Hugh Raymond McCrae,4 October 1876,PER-PER-PER,TIME-TIME-TIME,PROPN-PROPN-PROPN,NUM-PROPN-NUM,compound-compound-nsubj,nummod-appos-nummod,NNP-NNP-NNP,CD-NNP-CD,2,1
1,0.0,17,was,12,1,9,8,0,7,11,-3,Hugh Raymond McCrae,17 February 1958,PER-PER-PER,TIME-TIME-TIME,PROPN-PROPN-PROPN,NUM-PROPN-NUM,compound-compound-nsubj,nummod-appos-nummod,NNP-NNP-NNP,CD-NNP-CD,2,1
2,1.0,16,born,2,1,5,4,0,10,1,3,McCrae,Melbourne,PER,LOC,PROPN,PROPN,nsubjpass,pobj,NNP,NNP,4,1
3,4.0,31,starred,1,1,30,29,0,0,0,29,McCrae,Melbourne,PER,LOC,PROPN,PROPN,nsubj,pobj,NNP,NNP,1,1
4,1.0,16,born,2,1,13,12,0,2,1,11,McCrae,George Gordon McCrae,PER,PER-PER-PER,PROPN,PROPN-PROPN-PROPN,nsubjpass,compound-compound-appos,NNP,NNP-NNP-NNP,8,1
5,12.0,34,set,15,9,12,3,8,21,6,-3,John Gough,1903,PER-PER,TIME,PROPN-PROPN,NUM,compound-nsubj,npadvmod,NNP-NNP,CD,3,1
0,0.0,28,"""",0,2,10,8,1,17,-2,10,Never Alone,Gary Burr,MISC-MISC,PER-PER,ADV-ADJ,PROPN-PROPN,neg-nsubj,compound-pobj,RB-JJ,NNP-NNP,5,1
1,0.0,28,"""",0,2,26,24,1,1,-2,26,Never Alone,Jim Brickman,MISC-MISC,PER-PER,ADV-ADJ,PROPN-PROPN,neg-nsubj,compound-conj,RB-JJ,NNP-NNP,7,1
2,8.0,70,match,39,49,55,6,48,14,-10,16,I Run to You,2009,MISC-MISC-MISC-MISC,TIME,PRON-VERB-ADP-PRON,NUM,nsubj-ccomp-prep-pobj,pobj,PRP-VBP-IN-PRP,CD,1,1
3,8.0,70,match,39,49,6,-43,48,63,-10,-33,I Run to You,Lady Antebellum,MISC-MISC-MISC-MISC,ORG-ORG,PRON-VERB-ADP-PRON,PROPN-PROPN,nsubj-ccomp-prep-pobj,compound-poss,PRP-VBP-IN-PRP,NNP-NNP,4,1
4,8.0,70,match,39,63,6,-57,62,63,-24,-33,Need You Now,Lady Antebellum,MISC-MISC-MISC,ORG-ORG,VERB-PRON-ADV,PROPN-PROPN,pcomp-dobj-advmod,compound-poss,VBP-PRP-RB,NNP-NNP,9,1
0,0.0,20,is,5,1,16,15,0,3,4,11,Sycamore Shoals State Historic Area,U.S.,LOC-LOC-LOC-LOC-LOC,LOC,PROPN-PROPN-PROPN-PROPN-PROPN,PROPN,compound-compound-compound-compound-nsubj,compound,NNP-NNPS-NNP-NNP-NNP,NNP,6,1
1,0.0,20,is,5,1,19,18,0,0,4,14,Sycamore Shoals State Historic Area,Tennessee,LOC-LOC-LOC-LOC-LOC,LOC,PROPN-PROPN-PROPN-PROPN-PROPN,PROPN,compound-compound-compound-compound-nsubj,pobj,NNP-NNPS-NNP-NNP-NNP,NNP,4,1
2,0.0,20,is,5,12,16,4,11,3,-7,11,Elizabethton,U.S.,LOC,LOC,PROPN,PROPN,pobj,compound,NNP,NNP,3,1
3,0.0,20,is,5,16,19,3,15,0,-11,14,U.S.,Tennessee,LOC,LOC,PROPN,PROPN,compound,pobj,NNP,NNP,4,1
4,4.0,31,arrived,5,13,30,17,12,0,-8,25,Watauga Association,1772,ORG-ORG,TIME,PROPN-PROPN,NUM,compound-dobj,pobj,NNP-NNP,CD,3,1
5,5.0,39,negotiated,5,8,13,5,7,25,-3,8,Treaty of Sycamore Shoals,1775,MISC-MISC-MISC-MISC,TIME,PROPN-ADP-PROPN-PROPN,NUM,dobj-prep-compound-pobj,pobj,NNP-IN-NNP-NNPS,CD,3,1
0,0.0,23,was,8,1,11,10,0,11,7,3,John Hancock,American Revolution,PER-PER,MISC-MISC,PROPN-PROPN,PROPN-PROPN,compound-nsubj,compound-pobj,NNP-NNP,NNP-NNP,2,1
1,8.0,23,was,1,18,22,4,17,0,-17,21,American Revolutionary War,1775,MISC-MISC-MISC,TIME,PROPN-PROPN-PROPN,NUM,compound-compound-pobj,pobj,NNP-NNP-NNP,CD,9,1
0,0.0,29,is,7,2,27,25,1,1,5,20,IUPUI Jaguars men 's basketball team,United States,ORG-ORG-ORG-ORG-ORG-ORG,LOC-LOC,PROPN-PROPN-NOUN-PART-NOUN-NOUN,PROPN-PROPN,compound-nmod-poss-case-compound-nsubj,compound-appos,NNP-NNP-NNS-POS-NN-NN,NNP-NNP,5,1
1,0.0,29,is,7,16,21,5,15,7,-9,14,Indiana University – Purdue University Indianapolis,Indianapolis,ORG-ORG-ORG-ORG-ORG-ORG,LOC,PROPN-PROPN-PUNCT-PROPN-PROPN-PROPN,PROPN,compound-compound-compound-compound-compound-dobj,pobj,NNP-NNP-HYPH-NNP-NNP-NNP,NNP,2,1
2,0.0,29,is,7,16,16,0,15,12,-9,9,Indiana University – Purdue University Indianapolis,Indiana,ORG-ORG-ORG-ORG-ORG-ORG,LOC,PROPN-PROPN-PUNCT-PROPN-PROPN-PROPN,PROPN,compound-compound-compound-compound-compound-dobj,conj,NNP-NNP-HYPH-NNP-NNP-NNP,NNP,0,1
3,0.0,29,is,7,16,27,11,15,1,-9,20,Indiana University – Purdue University Indianapolis,United States,ORG-ORG-ORG-ORG-ORG-ORG,LOC-LOC,PROPN-PROPN-PUNCT-PROPN-PROPN-PROPN,PROPN-PROPN,compound-compound-compound-compound-compound-dobj,compound-appos,NNP-NNP-HYPH-NNP-NNP-NNP,NNP-NNP,1,1
4,0.0,29,is,7,21,27,6,20,1,-14,20,Indianapolis,United States,LOC,LOC-LOC,PROPN,PROPN-PROPN,pobj,compound-appos,NNP,NNP-NNP,3,1
5,0.0,29,is,7,16,27,11,15,1,-9,20,Indiana,United States,LOC,LOC-LOC,PROPN,PROPN-PROPN,conj,compound-appos,NNP,NNP-NNP,1,1
6,2.0,21,was,6,5,8,3,4,12,1,2,IUPUI basketball,1971,ORG-ORG,TIME,PROPN-NOUN,NUM,compound-pobj,nummod,NNP-NN,CD,6,1
0,0.0,48,School,5,1,27,26,0,20,4,22,Wuxi Big Bridge Experimental High School,1993,ORG-ORG-ORG-ORG-ORG-ORG,TIME,PROPN-ADJ-PROPN-PROPN-PROPN-PROPN,NUM,compound-compound-compound-compound-compound-ROOT,pobj,NNP-JJ-NNP-NNP-NNP-NNP,CD,6,1
1,0.0,48,School,5,1,47,46,0,0,4,42,Wuxi Big Bridge Experimental High School,China,ORG-ORG-ORG-ORG-ORG-ORG,LOC,PROPN-ADJ-PROPN-PROPN-PROPN-PROPN,PROPN,compound-compound-compound-compound-compound-ROOT,appos,NNP-JJ-NNP-NNP-NNP-NNP,NNP,6,1
2,0.0,48,School,5,1,47,46,0,0,4,42,Wuxi Big Bridge Academy,China,ORG-ORG-ORG-ORG,LOC,PROPN-PROPN-PROPN-PROPN,PROPN,compound-compound-compound-appos,appos,NNP-NNP-NNP-NNP,NNP,6,1
3,0.0,48,School,5,39,1,-38,38,46,-34,-4,Xueqianjie,Wuxi,LOC,LOC,PROPN,PROPN,compound,pobj,NNP,NNP,8,1
4,0.0,48,School,5,39,47,8,38,0,-34,42,Xueqianjie,China,LOC,LOC,PROPN,PROPN,compound,appos,NNP,NNP,6,1
5,0.0,48,School,5,1,44,43,0,3,4,39,Wuxi,Jiangsu Province,LOC,LOC-LOC,PROPN,PROPN-PROPN,pobj,compound-conj,NNP,NNP-NNP,5,1
6,0.0,48,School,5,1,47,46,0,0,4,42,Wuxi,China,LOC,LOC,PROPN,PROPN,pobj,appos,NNP,NNP,6,1
7,0.0,48,School,5,44,47,3,43,0,-39,42,Jiangsu Province,China,LOC-LOC,LOC,PROPN-PROPN,PROPN,compound-conj,appos,NNP-NNP,NNP,3,1
8,3.0,52,went,6,31,36,5,30,15,-25,30,Fudan,China,ORG,LOC,PROPN,PROPN,conj,pobj,NNP,NNP,3,1
9,3.0,52,went,6,34,36,2,33,15,-28,30,Nanjing,China,ORG,LOC,PROPN,PROPN,conj,pobj,NNP,NNP,2,1
10,3.0,52,went,6,36,29,-7,35,22,-30,23,China,Peking,LOC,ORG,PROPN,PROPN,pobj,conj,NNP,NNP,4,1
11,5.0,26,offers,7,14,18,4,13,7,-7,11,Hwa Chong Institution,Singapore,ORG-ORG-ORG,LOC,PROPN-PROPN-PROPN,PROPN,compound-compound-pobj,npadvmod,NNP-NNP-NNP,NNP,7,1
0,3.0,18,"""",0,7,17,10,6,0,-7,17,Firehouse,Kiss,MISC,ORG,PROPN,PROPN,dobj,pobj,NNP,NNP,2,1
1,7.0,37,noted,18,31,36,5,30,0,-13,18,Olympic Studios,London,LOC-LOC,LOC,PROPN-PROPN,PROPN,compound-pobj,appos,NNP-NNPS,NNP,4,1
0,1.0,21,was,7,7,12,5,6,8,0,5,Ziesenis,Johann Georg Ziesenis,PER,PER-PER-PER,PROPN,PROPN-PROPN-PROPN,nsubj,compound-compound-pobj,NNP,NNP-NNP-NNP,4,1
1,2.0,24,married,3,5,9,4,4,14,-2,6,Johann Bodo Lampe,1738,PER-PER-PER,TIME,PROPN-PROPN-PROPN,NUM,compound-compound-dobj,nummod,NNP-NNP-NNP,CD,2,1
0,0.0,33,is,11,1,10,9,0,22,10,-1,Henrik Malmström,Kristianstad,PER-PER,LOC,PROPN-PROPN,PROPN,compound-nsubj,pobj,NNP-NNP,NNP,1,1
1,0.0,33,is,11,1,24,23,0,8,10,13,Henrik Malmström,Sparta Warriors,PER-PER,ORG-ORG,PROPN-PROPN,PROPN-PROPN,compound-nsubj,compound-pobj,NNP-NNP,NNP-NNPS,5,1
2,0.0,33,is,11,10,15,5,9,17,1,4,Kristianstad,Swedish,LOC,LOC,PROPN,ADJ,pobj,amod,NNP,JJ,4,1
3,0.0,33,is,11,24,32,8,23,0,-13,21,Sparta Warriors,Norway,ORG-ORG,LOC,PROPN-PROPN,PROPN,compound-pobj,pobj,NNP-NNPS,NNP,5,1
4,1.0,37,began,1,1,30,29,0,6,0,29,Malmström,Malmö Redhawks,PER,ORG-ORG,PROPN,PROPN-PROPN,nsubj,compound-pobj,NNP,NNP-NNP,5,1
5,1.0,37,began,1,1,22,21,0,14,0,21,Malmström,Kristianstads IK,PER,ORG-ORG,PROPN,PROPN-PROPN,nsubj,compound-appos,NNP,NNP-NNP,3,1
6,1.0,37,began,1,30,7,-23,29,29,-29,6,Malmö Redhawks,Swedish,ORG-ORG,LOC,PROPN-PROPN,PROPN,compound-pobj,amod,NNP-NNP,NNP,8,1
7,1.0,37,began,1,30,28,-2,29,8,-29,27,Malmö Redhawks,Elitserien,ORG-ORG,LOC,PROPN-PROPN,PROPN,compound-pobj,pobj,NNP-NNP,NNP,1,1
0,0.0,42,"""",0,2,13,11,1,28,-2,13,Not in Love at All,Barry Gibb,MISC-MISC-MISC-MISC-MISC,PER-PER,ADV-ADP-NOUN-ADP-ADV,PROPN-PROPN,neg-prep-pobj-advmod-advmod,compound-pobj,RB-IN-NN-IN-RB,NNP-NNP,5,1
1,0.0,42,"""",0,2,23,21,1,18,-2,23,Not in Love at All,Moonlight Madness,MISC-MISC-MISC-MISC-MISC,MISC-MISC,ADV-ADP-NOUN-ADP-ADV,PROPN-PROPN,neg-prep-pobj-advmod-advmod,compound-appos,RB-IN-NN-IN-RB,NNP-NNP,9,1
2,0.0,42,"""",0,2,34,32,1,7,-2,34,Not in Love at All,Hawks,MISC-MISC-MISC-MISC-MISC,MISC,ADV-ADP-NOUN-ADP-ADV,PROPN,neg-prep-pobj-advmod-advmod,appos,RB-IN-NN-IN-RB,NNPS,12,1
3,0.0,42,"""",0,2,39,37,1,2,-2,39,Not in Love at All,1988,MISC-MISC-MISC-MISC-MISC,TIME,ADV-ADP-NOUN-ADP-ADV,NUM,neg-prep-pobj-advmod-advmod,pobj,RB-IN-NN-IN-RB,CD,12,1
4,5.0,42,kept,11,4,7,3,3,34,7,-4,Now Voyager,1984,MISC-MISC,TIME,ADV-PROPN,NUM,compound-appos,appos,RB-NNP,CD,1,1
5,5.0,42,kept,11,4,10,6,3,31,7,-1,Now Voyager,Gibb,MISC-MISC,PER,ADV-PROPN,PROPN,compound-appos,nsubj,RB-NNP,NNP,3,1
6,5.0,42,kept,11,24,10,-14,23,31,-13,-1,Bee Gees,Gibb,ORG-ORG,PER,PROPN-PROPN,PROPN,compound-pobj,nsubj,NNP-NNPS,NNP,6,1
0,4.0,46,'s,19,41,44,3,40,1,-22,25,DC 9/11,2003,MISC-MISC,TIME,PROPN-NUM,NUM,compound-appos,appos,NNP-CD,CD,6,1
0,0.0,29,is,3,1,7,6,0,21,2,4,HitRecord on TV,American,MISC-MISC-MISC,LOC,PROPN-ADP-PROPN,ADJ,nsubj-prep-pobj,amod,NNP-IN-NNP,JJ,5,1
1,0.0,29,is,3,1,23,22,0,5,2,20,HitRecord on TV,Brian Graden,MISC-MISC-MISC,PER-PER,PROPN-ADP-PROPN,PROPN-PROPN,nsubj-prep-pobj,compound-conj,NNP-IN-NNP,NNP-NNP,8,1
2,0.0,29,is,3,1,27,26,0,1,2,24,HitRecord on TV,Belisa Balaban,MISC-MISC-MISC,PER-PER,PROPN-ADP-PROPN,PROPN-PROPN,nsubj-prep-pobj,compound-conj,NNP-IN-NNP,NNP-NNP,4,1
3,5.0,17,shown,5,8,13,5,7,3,-3,8,2014 Sundance Film Festival,"January 18 , 2014",MISC-MISC-MISC-MISC,TIME-TIME-TIME-TIME,NUM-PROPN-PROPN-PROPN,PROPN-NUM-PUNCT-NUM,nummod-compound-compound-pobj,pobj-nummod-punct-nummod,CD-NNP-NNP-NNP,"NNP-CD-,-CD",6,1
0,0.0,40,Passarell,2,1,5,4,0,34,1,3,Alan Lawrence Passarell,"April 22 , 1950",PER-PER-PER,TIME-TIME-TIME-TIME,PROPN-PROPN-PROPN,PROPN-NUM-PUNCT-NUM,compound-compound-ROOT,appos-nummod-punct-nummod,NNP-NNP-NNP,"NNP-CD-,-CD",3,1
1,0.0,40,Passarell,2,1,10,9,0,29,1,8,Alan Lawrence Passarell,"September 29 , 1986",PER-PER-PER,TIME-TIME-TIME-TIME,PROPN-PROPN-PROPN,PROPN-NUM-PUNCT-NUM,compound-compound-ROOT,nsubj-nummod-punct-nummod,NNP-NNP-NNP,"NNP-CD-,-CD",3,1
2,0.0,40,Passarell,2,1,17,16,0,22,1,15,Alan Lawrence Passarell,Canadian,PER-PER-PER,LOC,PROPN-PROPN-PROPN,ADJ,compound-compound-ROOT,amod,NNP-NNP-NNP,JJ,3,1
3,0.0,40,Passarell,2,17,26,9,16,13,-15,24,Canadian,Legislative Assembly of British Columbia,LOC,ORG-ORG-ORG-ORG-ORG,ADJ,PROPN-PROPN-ADP-PROPN-PROPN,amod,compound-pobj-prep-compound-pobj,JJ,NNP-NNP-IN-NNP-NNP,5,1
4,7.0,13,died,1,1,11,10,0,1,0,10,Passarell,Dease Lake,PER,LOC-LOC,PROPN,PROPN-PROPN,nsubj,compound-pobj,NNP,NNP-NNP,3,1
0,0.0,36,located,15,2,26,24,1,9,13,11,Barksdale Global Power Museum,Louisiana,LOC-LOC-LOC-LOC,LOC,PROPN-PROPN-PROPN-PROPN,PROPN,compound-compound-compound-nsubjpass,conj,NNP-NNP-NNP-NNP,NNP,4,1
1,0.0,36,located,15,10,26,16,9,9,5,11,Eighth Air Force Museum,Louisiana,LOC-LOC-LOC-LOC,LOC,PROPN-PROPN-PROPN-PROPN,PROPN,compound-compound-compound-appos,conj,NNP-NNP-NNP-NNP,NNP,5,1
2,0.0,36,located,15,2,26,24,1,9,13,11,Barksdale Air Force Base,Louisiana,LOC-LOC-LOC-LOC,LOC,PROPN-PROPN-PROPN-PROPN,PROPN,compound-compound-compound-pobj,conj,NNP-NNP-NNP-NNP,NNP,4,1
3,0.0,36,located,15,23,26,3,22,9,-8,11,Bossier City,Louisiana,LOC-LOC,LOC,PROPN-PROPN,PROPN,compound-pobj,conj,NNP-NNP,NNP,5,1
0,0.0,24,was,14,1,8,7,0,15,13,-6,"Ernest Julian "" Ernie "" Cole",1916,PER-PER-PER-PER-PER-PER,TIME,PROPN-PROPN-PUNCT-PROPN-PUNCT-PROPN,NUM,nmod-nmod-punct-nmod-punct-nsubj,nummod,NNP-NNP-''-NNP-''-NNP,CD,2,1
1,0.0,24,was,14,1,23,22,0,0,13,9,"Ernest Julian "" Ernie "" Cole",Canada,PER-PER-PER-PER-PER-PER,LOC,PROPN-PROPN-PUNCT-PROPN-PUNCT-PROPN,PROPN,nmod-nmod-punct-nmod-punct-nsubj,appos,NNP-NNP-''-NNP-''-NNP,NNP,3,1
2,0.0,24,was,14,21,23,2,20,0,-7,9,Saskatchewan,Canada,LOC,LOC,PROPN,PROPN,pobj,appos,NNP,NNP,5,1
3,5.0,12,served,1,1,5,4,0,6,0,4,Cole,Royal Canadian Engineers,PER,ORG-ORG-ORG,PROPN,PROPN-PROPN-PROPN,nsubj,compound-compound-pobj,NNP,NNP-NNP-NNPS,3,1
0,0.0,25,is,4,14,21,7,13,3,-10,17,Lake Superior,Michigan,LOC-LOC,LOC,PROPN-PROPN,PROPN,compound-pobj,pobj,NNP-NNP,NNP,1,1
1,0.0,25,is,4,14,23,9,13,1,-10,19,Lake Superior,United States,LOC-LOC,LOC-LOC,PROPN-PROPN,PROPN-PROPN,compound-pobj,compound-appos,NNP-NNP,NNP-NNP,1,1
2,0.0,25,is,4,18,21,3,17,3,-14,17,Upper Peninsula,Michigan,LOC-LOC,LOC,PROPN-PROPN,PROPN,compound-pobj,pobj,NNP-NNP,NNP,3,1
3,0.0,25,is,4,18,23,5,17,1,-14,19,Upper Peninsula,United States,LOC-LOC,LOC-LOC,PROPN-PROPN,PROPN-PROPN,compound-pobj,compound-appos,NNP-NNP,NNP-NNP,3,1
4,2.0,31,has,2,19,16,-3,18,14,-17,14,Michigan,Alger County,LOC,LOC-LOC,PROPN,PROPN-PROPN,appos,compound-pobj,NNP,NNP-NNP,3,1
5,2.0,31,has,2,11,16,5,10,14,-9,14,Munising,Alger County,LOC,LOC-LOC,PROPN,PROPN-PROPN,pobj,compound-pobj,NNP,NNP-NNP,3,1
6,2.0,31,has,2,13,16,3,12,14,-11,14,Grand Marais,Alger County,LOC-LOC,LOC-LOC,PROPN-PROPN,PROPN-PROPN,compound-conj,compound-pobj,NNP-NNP,NNP-NNP,3,1
0,0.0,25,is,2,1,24,23,0,0,1,22,Monumental Church,Virginia,LOC-LOC,LOC,PROPN-PROPN,PROPN,compound-nsubj,appos,NNP-NNP,NNP,2,1
1,0.0,25,is,2,11,24,13,10,0,-9,22,1224 E. Broad Street,Virginia,LOC-LOC-LOC-LOC,LOC,NUM-PROPN-PROPN-PROPN,PROPN,nummod-compound-compound-pobj,appos,CD-NNP-NNP-NNP,NNP,6,1
2,0.0,25,is,2,16,24,8,15,0,-14,22,N. 12th,Virginia,LOC-LOC,LOC,PROPN-NOUN,PROPN,compound-pobj,appos,NNP-NN,NNP,5,1
3,0.0,25,is,2,19,24,5,18,0,-17,22,College Streets,Virginia,LOC-LOC,LOC,PROPN-PROPN,PROPN,compound-conj,appos,NNP-NNPS,NNP,6,1
4,0.0,25,is,2,22,24,2,21,0,-20,22,Richmond,Virginia,LOC,LOC,PROPN,PROPN,pobj,appos,NNP,NNP,9,1
5,1.0,45,is,7,25,11,-14,24,33,-18,4,National Register of Historic Places,America,MISC-MISC-MISC-MISC-MISC,LOC,PROPN-PROPN-ADP-PROPN-PROPN,PROPN,compound-pobj-prep-compound-pobj,poss,NNP-NNP-IN-NNP-NNPS,NNP,8,1
6,1.0,45,is,7,25,11,-14,24,33,-18,4,National Historic Landmark,America,MISC-MISC-MISC,LOC,PROPN-PROPN-PROPN,PROPN,compound-compound-attr,poss,NNP-NNP-NNP,NNP,8,1
7,1.0,45,is,7,41,11,-30,40,33,-34,4,Court End,America,LOC-LOC,LOC,PROPN-PROPN,PROPN,compound-nmod,poss,NNP-NNP,NNP,10,1
0,0.0,16,is,3,2,8,6,1,7,1,5,Crestfallen,The Smashing Pumpkins,MISC,ORG-ORG-ORG,PROPN,DET-PROPN-PROPN,nsubj,det-compound-poss,NNP,DT-NNP-NNPS,6,1
1,0.0,16,is,3,2,12,10,1,3,1,9,Crestfallen,1998,MISC,TIME,PROPN,NUM,nsubj,nummod,NNP,CD,4,1
2,0.0,16,is,3,2,15,13,1,0,1,12,Crestfallen,Adore,MISC,MISC,PROPN,PROPN,nsubj,appos,NNP,NNP,2,1
0,0.0,27,is,1,6,9,3,5,17,-5,8,Carbon County,Utah,LOC-LOC,LOC,PROPN-PROPN,PROPN,compound-pobj,appos,NNP-NNP,NNP,1,1
0,0.0,22,is,3,2,7,5,1,14,1,4,Castro Theatre,San Francisco,LOC-LOC,LOC-LOC,PROPN-PROPN,PROPN-PROPN,compound-nsubj,compound-compound,NNP-NNP,NNP-NNP,3,1
0,0.0,28,is,2,1,16,15,0,11,1,14,Team Taranaki,New Zealand,ORG-ORG,LOC-LOC,PROPN-PROPN,PROPN-PROPN,compound-nsubj,compound-pobj,NNP-NNP,NNP-NNP,7,1
1,0.0,28,is,2,2,16,14,1,11,0,14,Taranaki,New Zealand,LOC,LOC-LOC,PROPN,PROPN-PROPN,compound,compound-pobj,NNP,NNP-NNP,6,1
2,1.0,16,contest,8,6,11,5,5,4,2,3,Team Taranaki,Central Premier League,ORG-ORG,ORG-ORG-ORG,PROPN-PROPN,PROPN-PROPN-PROPN,compound-nsubj,compound-compound-dobj,NNP-NNP,NNP-NNP-NNP,7,1
0,0.0,46,Mindszenty,2,24,35,11,23,10,-22,33,Esztergom,Hungary,LOC,LOC,PROPN,PROPN,pobj,pobj,NNP,NNP,2,1
1,5.0,36,freed,8,12,15,3,11,20,-4,7,Hungarian Revolution,1956,MISC-MISC,TIME,PROPN-PROPN,NUM,compound-pobj,pobj,NNP-NNP,CD,3,1
2,7.0,11,died,1,8,10,2,7,0,-7,9,Vienna,Austria,LOC,LOC,PROPN,PROPN,pobj,appos,NNP,NNP,4,1
0,0.0,16,is,1,1,8,7,0,7,0,7,Strawhead,Norman Mailer,MISC,PER-PER,ADV,PROPN-PROPN,nsubj,compound-pobj,RB,NNP-NNP,3,1
1,0.0,16,is,1,1,11,10,0,4,0,10,Strawhead,Richard Hannum,MISC,PER-PER,ADV,PROPN-PROPN,nsubj,compound-conj,RB,NNP-NNP,4,1
2,2.0,20,takes,1,14,18,4,13,1,-13,17,Monroe,August 1962,PER,TIME-TIME,PROPN,PROPN-NUM,poss,pobj-nummod,NNP,NNP-CD,9,1
0,6.0,36,changed,12,2,6,4,1,29,10,-6,Rhodesia,1965,LOC,TIME,PROPN,NUM,nsubj,pobj,NNP,CD,1,1
1,6.0,36,changed,12,2,31,29,1,4,10,19,Rhodesia,Zimbabwe,LOC,LOC,PROPN,PROPN,nsubj,nsubj,NNP,NNP,4,1
0,0.0,38,is,10,1,13,12,0,24,9,3,Arthur Betz Laffer,American,PER-PER-PER,LOC,PROPN-PROPN-PROPN,ADJ,compound-compound-compound,amod,NNP-NNP-NNP,JJ,-1,1
1,4.0,25,was,1,12,19,7,11,5,-11,18,Donald Trump,the United States,PER-PER,LOC-LOC-LOC,PROPN-PROPN,DET-PROPN-PROPN,compound-poss,det-compound-pobj,NNP-NNP,DT-NNP-NNP,3,1
0,0.0,20,is,9,1,12,11,0,7,8,3,Perry Watson,American,PER-PER,LOC,PROPN-PROPN,ADJ,compound-nsubj,amod,NNP-NNP,JJ,4,1
1,0.0,20,is,9,12,19,7,11,0,-3,10,American,Michigan,LOC,LOC,ADJ,PROPN,amod,appos,JJ,NNP,4,1
2,2.0,33,took,4,25,11,-14,24,21,-21,7,Jalen Rose,Detroit Southwestern High School,PER-PER,ORG-ORG-ORG-ORG,PROPN-PROPN,PROPN-PROPN-PROPN-PROPN,compound-conj,compound-compound-compound-pobj,NNP-NNP,NNP-NNP-NNP-NNP,7,1
3,2.0,33,took,4,28,11,-17,27,21,-24,7,Voshon Lenard,Detroit Southwestern High School,PER-PER,ORG-ORG-ORG-ORG,PROPN-PROPN,PROPN-PROPN-PROPN-PROPN,compound-conj,compound-compound-compound-pobj,NNP-NNP,NNP-NNP-NNP-NNP,8,1
0,4.0,26,elected,5,4,9,5,3,16,1,4,Harper,Democrat,PER,ORG,PROPN,PROPN,nsubjpass,pobj,NNP,NNP,2,1
0,0.0,21,is,3,1,10,9,0,10,2,7,A Little Princess,Frances Hodgson Burnett,MISC-MISC-MISC,PER-PER-PER,DET-PROPN-PROPN,PROPN-PROPN-PROPN,det-amod-nsubj,compound-compound-pobj,DT-NNP-NNP,NNP-NNP-NNP,6,1
1,0.0,21,is,3,1,20,19,0,0,2,17,A Little Princess,1905,MISC-MISC-MISC,TIME,DET-PROPN-PROPN,NUM,det-amod-nsubj,pobj,DT-NNP-NNP,CD,3,1
2,5.0,30,ranked,4,20,28,8,19,1,-16,24,School Library Journal,U.S.,ORG-ORG-ORG,LOC,PROPN-PROPN-PROPN,PROPN,compound-compound-pobj,compound,NNP-NNP-NNP,NNP,4,1
3,6.0,20,was,1,7,15,8,6,4,-6,14,Burnett,The Secret Garden,PER,MISC-MISC-MISC,PROPN,DET-PROPN-PROPN,compound,det-compound-compound,NNP,DT-NNP-NNP,7,1
0,0.0,38,is,6,2,21,19,1,16,4,15,Steuben Memorial State Historic Site,New York,LOC-LOC-LOC-LOC-LOC,LOC-LOC,PROPN-PROPN-PROPN-PROPN-PROPN,PROPN-PROPN,compound-compound-compound-compound-nsubj,compound-appos,NNP-NNP-NNP-NNP-NNP,NNP-NNP,6,1
1,0.0,38,is,6,2,18,16,1,19,4,12,Steuben,Oneida County,LOC,LOC-LOC,PROPN,PROPN-PROPN,pobj,compound-conj,NNP,NNP-NNP,5,1
2,0.0,38,is,6,18,21,3,17,16,-12,15,Oneida County,New York,LOC-LOC,LOC-LOC,PROPN-PROPN,PROPN-PROPN,compound-conj,compound-appos,NNP-NNP,NNP-NNP,1,1
3,1.0,26,was,8,7,23,16,6,2,1,15,Oneida County,the United States,LOC-LOC,LOC-LOC-LOC,PROPN-PROPN,DET-PROPN-PROPN,compound-pobj,det-compound-pobj,NNP-NNP,DT-NNP-NNP,14,1
0,2.0,17,"""",0,2,11,9,1,5,-2,11,Exile,BBC One,MISC,MISC-MISC,PROPN,PROPN-NUM,nsubj,compound-pobj,NNP,NNP-CD,4,1
1,11.0,28,seen,4,2,19,17,1,8,2,15,Exile,BBC One,MISC,MISC-MISC,PROPN,PROPN-NUM,nsubjpass,compound-pobj,NNP,NNP-CD,6,1
2,2.0,17,"""",0,11,14,3,10,2,-11,14,BBC One,the United Kingdom,MISC-MISC,LOC-LOC-LOC,PROPN-NUM,DET-PROPN-PROPN,compound-pobj,det-compound-pobj,NNP-CD,DT-NNP-NNP,3,1
3,3.0,48,sees,2,11,14,3,10,33,-9,12,Connie Beauchamp,Amanda Mealing,PER-PER,PER-PER,PROPN-PROPN,PROPN-PROPN,compound-conj,compound-appos,NNP-NNP,NNP-NNP,1,1
4,3.0,48,sees,2,25,27,2,24,20,-23,25,Louis,Gregory Foreman,PER,PER-PER,PROPN,PROPN-PROPN,appos,compound-appos,NNP,NNP-NNP,1,1
0,1.0,43,participated,9,13,17,4,12,25,-4,8,Battle of Kumanovo,"23 - October 24 , 1912",MISC-MISC-MISC,TIME-TIME-TIME-TIME-TIME-TIME,PROPN-ADP-PROPN,NUM-PUNCT-PROPN-NUM-PUNCT-NUM,pobj-prep-pobj,nummod-punct-appos-nummod-punct-nummod,NNP-IN-NNP,"CD-HYPH-NNP-CD-,-CD",5,1
1,4.0,22,fought,8,13,2,-11,12,19,-5,-6,Battles of Cer,World War I,MISC-MISC-MISC,MISC-MISC-MISC,PROPN-ADP-PROPN,PROPN-PROPN-PROPN,pobj-prep-pobj,compound-compound-pobj,NNPS-IN-NNP,NNP-NNP-NNP,6,1
2,4.0,22,fought,8,19,2,-17,18,19,-11,-6,Kolubra,World War I,LOC,MISC-MISC-MISC,PROPN,PROPN-PROPN-PROPN,conj,compound-compound-pobj,NNP,NNP-NNP-NNP,4,1
0,1.0,36,was,8,19,34,15,18,1,-11,26,Egyptian,Hosni Mubarak,LOC,PER-PER,ADJ,PROPN-PROPN,amod,compound-dobj,JJ,NNP-NNP,6,1
1,13.0,31,allowed,4,7,14,7,6,16,-3,10,Al Nour Party,May 2011,ORG-ORG-ORG,TIME-TIME,PROPN-PROPN-PROPN,PROPN-NUM,compound-compound-nsubjpass,pobj-nummod,NNP-NNP-NNP,NNP-CD,5,1
0,0.0,21,is,5,14,2,-12,13,18,-9,-3,Etobicoke,Toronto,LOC,LOC,PROPN,PROPN,pobj,pobj,NNP,NNP,7,1
1,0.0,21,is,5,14,18,4,13,2,-9,13,Etobicoke,Ontario,LOC,LOC,PROPN,PROPN,pobj,conj,NNP,NNP,3,1
2,0.0,21,is,5,14,20,6,13,0,-9,15,Etobicoke,Canada,LOC,LOC,PROPN,PROPN,pobj,appos,NNP,NNP,5,1
3,0.0,21,is,5,2,18,16,1,2,3,13,Toronto,Ontario,LOC,LOC,PROPN,PROPN,pobj,conj,NNP,NNP,10,1
4,0.0,21,is,5,18,20,2,17,0,-13,15,Ontario,Canada,LOC,LOC,PROPN,PROPN,conj,appos,NNP,NNP,8,1
5,2.0,25,built,2,10,24,14,9,0,-8,22,Mimico Correctional Centre,1887,ORG-ORG-ORG,TIME,PROPN-PROPN-PROPN,NUM,compound-compound-pobj,pobj,NNP-NNP-NNP,CD,6,1
6,4.0,22,being,18,16,13,-3,15,8,2,-5,Edmonton Remand Centre,Canada,LOC-LOC-LOC,LOC,PROPN-PROPN-PROPN,PROPN,compound-compound-nsubj,pobj,NNP-NNP-NNP,NNP,3,1
0,8.0,31,held,5,12,23,11,11,7,-7,18,Washington,Arthur B. Langlie,LOC,PER-PER-PER,PROPN,PROPN-PROPN-PROPN,pobj,compound-compound-nsubj,NNP,NNP-NNP-NNP,5,1
1,12.0,26,had,15,14,9,-5,13,16,1,-6,Washington,John Spellman,LOC,PER-PER,PROPN,PROPN-PROPN,nsubj,compound-attr,NNP,NNP-NNP,3,1
0,0.0,30,was,13,2,6,4,1,23,11,-7,William John Polson,6 June 1875,PER-PER-PER,TIME-TIME-TIME,PROPN-PROPN-PROPN,NUM-PROPN-NUM,compound-compound-nsubj,nummod-appos-nummod,NNP-NNP-NNP,CD-NNP-CD,2,1
1,0.0,30,was,13,2,10,8,1,19,11,-3,William John Polson,8 October 1960,PER-PER-PER,TIME-TIME-TIME,PROPN-PROPN-PROPN,NUM-PROPN-NUM,compound-compound-nsubj,nummod-npadvmod-nummod,NNP-NNP-NNP,CD-NNP-CD,2,1
2,0.0,30,was,13,2,16,14,1,13,11,3,William John Polson,New Zealand,PER-PER-PER,LOC-LOC,PROPN-PROPN-PROPN,PROPN-PROPN,compound-compound-nsubj,compound-compound,NNP-NNP-NNP,NNP-NNP,4,1
3,1.0,22,joined,1,4,10,6,3,11,-3,9,National Party,1936,ORG-ORG,TIME,PROPN-PROPN,NUM,compound-dobj,pobj,NNP-NNP,CD,2,1
4,5.0,36,married,3,20,35,15,19,0,-17,32,Arthur Grigg,1941,PER-PER,TIME,PROPN-PROPN,NUM,compound-nsubjpass,pobj,NNP-NNP,CD,4,1
0,0.0,16,is,8,1,5,4,0,10,7,-3,Nazzab Hidzan,24 March 1975,PER-PER,TIME-TIME-TIME,PROPN-PROPN,NUM-PROPN-NUM,compound-nsubj,nummod-npadvmod-nummod,NNP-NNP,CD-NNP-CD,2,1
1,0.0,16,is,8,1,11,10,0,4,7,3,Nazzab Hidzan,Malaysian,PER-PER,LOC,PROPN-PROPN,ADJ,compound-nsubj,amod,NNP-NNP,JJ,3,1
0,0.0,41,went,16,9,25,16,8,15,7,9,PNAC,U.S.,ORG,LOC,PROPN,PROPN,poss,compound,NNP,NNP,12,1
1,0.0,41,went,16,25,27,2,24,13,-9,11,U.S.,George W. Bush,LOC,PER-PER-PER,PROPN,PROPN-PROPN-PROPN,compound,compound-compound-pobj,NNP,NNP-NNP-NNP,2,1
2,3.0,38,replaced,15,25,37,12,24,0,-10,22,Foreign Policy Initiative,2009,MISC-MISC-MISC,TIME,PROPN-PROPN-PROPN,NUM,compound-compound-oprd,pobj,NNP-NNP-NNP,CD,6,1
0,1.0,23,Smuts,1,1,4,3,0,18,0,3,Jan Smuts,South African,PER-PER,LOC-LOC,PROPN-PROPN,ADJ-ADJ,compound-ROOT,amod-appos,NNP-NNP,JJ-JJ,2,1
1,5.0,23,Smuts,2,15,5,-10,14,17,-13,3,Jan Smuts,South African,PER-PER,LOC-LOC,PROPN-PROPN,PROPN-PROPN,compound-pobj,amod-npadvmod,NNP-NNP,NNP-NNP,5,1
2,1.0,23,Smuts,1,1,19,18,0,3,0,18,Jan Smuts,Union of South Africa,PER-PER,LOC-LOC-LOC-LOC,PROPN-PROPN,PROPN-ADP-PROPN-PROPN,compound-ROOT,pobj-prep-compound-pobj,NNP-NNP,NNP-IN-NNP-NNP,6,1
3,1.0,23,Smuts,1,4,7,3,3,15,-3,6,South African,British Commonwealth,LOC-LOC,ORG-ORG,ADJ-ADJ,PROPN-PROPN,amod-appos,conj-compound,JJ-JJ,NNP-NNP,1,1
4,6.0,20,Smuts,2,1,17,16,0,2,1,15,John Christopher Smuts,Liberal Party,PER-PER-PER,ORG-ORG,PROPN-PROPN-PROPN,PROPN-PROPN,compound-compound-ROOT,compound-compound,NNP-NNP-NNP,NNP-NNP,6,1
5,6.0,20,Smuts,2,2,17,15,1,2,0,15,Christopher Smuts,Liberal Party,PER-PER,ORG-ORG,PROPN-PROPN,PROPN-PROPN,compound-pobj,compound-compound,NNP-NNP,NNP-NNP,5,1
6,7.0,13,Smuts,1,1,4,3,0,8,0,3,Kelly Smuts,South African,PER-PER,LOC-LOC,PROPN-PROPN,ADJ-ADJ,compound-ROOT,amod-amod,NNP-NNP,JJ-JJ,2,1
7,7.0,13,Smuts,1,1,11,10,0,1,0,10,Kelly Smuts,JJ Smuts,PER-PER,PER-PER,PROPN-PROPN,PROPN-PROPN,compound-ROOT,compound-pobj,NNP-NNP,NNP-NNP,4,1
8,8.0,13,Smuts,1,1,8,7,0,4,0,7,Neil Smuts,World War I,PER-PER,MISC-MISC-MISC,PROPN-PROPN,PROPN-PROPN-PROPN,compound-ROOT,compound-appos-nsubj,NNP-NNP,NNP-NNP-NNP,1,1
9,8.0,13,Smuts,1,1,4,3,0,8,0,3,Neil Smuts,South African,PER-PER,LOC-LOC,PROPN-PROPN,ADJ-ADJ,compound-ROOT,amod-amod,NNP-NNP,JJ-JJ,2,1
10,9.0,12,Ngonyama,1,1,10,9,0,1,0,9,Smuts Ngonyama,African National Congress,PER-PER,ORG-ORG-ORG,PROPN-PROPN,PROPN-PROPN-PROPN,compound-ROOT,compound-compound-pobj,NNP-NNP,NNP-NNP-NNP,6,1
0,0.0,20,"""",0,2,14,12,1,5,-2,14,Yearning for Your Love,The Gap Band,MISC-MISC-MISC-MISC,ORG-ORG-ORG,VERB-ADP-DET-NOUN,DET-PROPN-PROPN,csubj-prep-poss-pobj,det-compound-pobj,VBG-IN-PRP$-NN,DT-NNP-NNP,8,1
1,0.0,20,"""",0,2,18,16,1,1,-2,18,Yearning for Your Love,Mercury Records,MISC-MISC-MISC-MISC,ORG-ORG,VERB-ADP-DET-NOUN,PROPN-PROPN,csubj-prep-poss-pobj,compound-pobj,VBG-IN-PRP$-NN,NNP-NNPS,7,1
2,0.0,20,"""",0,14,18,4,13,1,-14,18,The Gap Band,Mercury Records,ORG-ORG-ORG,ORG-ORG,DET-PROPN-PROPN,PROPN-PROPN,det-compound-pobj,compound-pobj,DT-NNP-NNP,NNP-NNPS,5,1
0,0.0,33,was,4,2,17,15,1,15,2,13,Bang Bang Club,South Africa,ORG-ORG-ORG,LOC-LOC,PROPN-PROPN-PROPN,PROPN-PROPN,compound-compound-nsubj,compound-pobj,NNP-NNP-NNP,NNP-NNP,10,1
0,0.0,14,is,1,11,13,2,10,0,-10,12,Lille,France,LOC,LOC,PROPN,PROPN,pobj,appos,NNP,NNP,8,1
1,15.0,15,known,3,10,12,2,9,2,-7,9,French,Charles De Gaulle,LOC,PER-PER-PER,ADJ,PROPN-PROPN-PROPN,amod,compound-compound-pobj,JJ,NNP-NNP-NNP,2,1
0,0.0,19,is,6,1,5,4,0,13,5,-1,Niko Nirvi,1961,PER-PER,TIME,PROPN-PROPN,NUM,compound-nsubj,npadvmod,NNP-NNP,CD,2,1
1,0.0,19,is,6,1,16,15,0,2,5,10,Niko Nirvi,Finnish,PER-PER,LOC,PROPN-PROPN,ADJ,compound-nsubj,amod,NNP-NNP,JJ,6,1
0,1.0,21,joined,7,7,4,-3,6,16,0,-3,Lee,Harvard University,PER,ORG-ORG,PROPN,PROPN-PROPN,nsubj,compound-pobj,NNP,NNP-NNP,4,1
0,0.0,33,is,7,29,32,3,28,0,-22,25,Sakha Republic,Russia,LOC-LOC,LOC,PROPN-PROPN,PROPN,compound-pobj,appos,NNP-NNP,NNP,7,1
0,0.0,19,was,1,8,10,2,7,8,-7,9,Japan,Aomori,LOC,LOC,PROPN,PROPN,pobj,pobj,NNP,NNP,1,1
1,0.0,19,was,1,8,18,10,7,0,-7,17,Japan,Hokkaido,LOC,LOC,PROPN,PROPN,pobj,pobj,NNP,NNP,3,1
2,0.0,19,was,1,10,10,0,9,8,-9,9,Aomori Station,Aomori,LOC-LOC,LOC,PROPN-PROPN,PROPN,compound-dobj,pobj,NNP-NNP,NNP,0,1
3,1.0,44,made,7,2,23,21,1,20,5,16,Tsugaru Line,East Japan Railway Company,LOC-LOC,ORG-ORG-ORG-ORG,PROPN-PROPN,PROPN-PROPN-PROPN-PROPN,compound-appos,compound-compound-compound-pobj,NNP-NNP,NNP-NNP-NNP-NNP,7,1
0,7.0,20,studied,4,11,15,4,10,4,-7,11,University of Texas,Austin,ORG-ORG-ORG,LOC,PROPN-ADP-PROPN,PROPN,pobj-prep-pobj,pobj,NNP-IN-NNP,NNP,4,1
0,0.0,30,Kealoha,2,1,5,4,0,24,1,3,Pua Kele Kealoha,"November 14 , 1902",PER-PER-PER,TIME-TIME-TIME-TIME,PROPN-PROPN-PROPN,PROPN-NUM-PUNCT-NUM,compound-compound-ROOT,appos-nummod-punct-nummod,NNP-NNP-NNP,"NNP-CD-,-CD",3,1
1,0.0,30,Kealoha,2,1,10,9,0,19,1,8,Pua Kele Kealoha,"August 29 , 1989",PER-PER-PER,TIME-TIME-TIME-TIME,PROPN-PROPN-PROPN,PROPN-NUM-PUNCT-NUM,compound-compound-ROOT,nsubj-nummod-punct-nummod,NNP-NNP-NNP,"NNP-CD-,-CD",3,1
2,2.0,20,represented,1,1,8,7,0,11,0,7,Kealoha,1920 Summer Olympics,PER,MISC-MISC-MISC,PROPN,NUM-PROPN-PROPN,nsubj,nummod-compound-pobj,NNP,CD-NNP-NNPS,3,1
3,2.0,20,represented,1,8,12,4,7,7,-7,11,1920 Summer Olympics,Antwerp,MISC-MISC-MISC,LOC,NUM-PROPN-PROPN,PROPN,nummod-compound-pobj,pobj,CD-NNP-NNPS,NNP,4,1
4,2.0,20,represented,1,12,14,2,11,5,-11,13,Antwerp,Belgium,LOC,LOC,PROPN,PROPN,pobj,appos,NNP,NNP,6,1
5,3.0,31,won,1,23,12,-11,22,18,-22,11,Perry McGillivray,U.S.,PER-PER,LOC,PROPN-PROPN,PROPN,compound-appos,compound,NNP-NNP,NNP,4,1
6,3.0,31,won,1,26,12,-14,25,18,-25,11,Norman Ross,U.S.,PER-PER,LOC,PROPN-PROPN,PROPN,compound-conj,compound,NNP-NNP,NNP,6,1
7,3.0,31,won,1,29,12,-17,28,18,-28,11,Duke Kahanamoku,U.S.,PER-PER,LOC,PROPN-PROPN,PROPN,compound-conj,compound,NNP-NNP,NNP,7,1
8,6.0,25,was,13,22,24,2,21,0,-9,11,Molokai,Oahu,LOC,LOC,PROPN,PROPN,pobj,pobj,NNP,NNP,4,1
9,7.0,22,tried,3,10,8,-2,9,13,-7,5,Molokai,Oahu,LOC,LOC,PROPN,PROPN,pobj,pobj,NNP,NNP,3,1
0,0.0,29,is,3,1,13,12,0,15,2,10,Mill Creek Mountain,Hampshire,LOC-LOC-LOC,LOC,PROPN-PROPN-PROPN,PROPN,compound-compound-nsubj,nmod,NNP-NNP-NNP,NNP,7,1
1,0.0,29,is,3,1,24,23,0,4,2,21,Mill Creek Mountain,U.S.,LOC-LOC-LOC,LOC,PROPN-PROPN-PROPN,PROPN,compound-compound-nsubj,compound,NNP-NNP-NNP,NNP,10,1
2,0.0,29,is,3,1,27,26,0,1,2,24,Mill Creek Mountain,West Virginia,LOC-LOC-LOC,LOC-LOC,PROPN-PROPN-PROPN,PROPN-PROPN,compound-compound-nsubj,compound-pobj,NNP-NNP-NNP,NNP-NNP,12,1
3,0.0,29,is,3,13,24,11,12,4,-10,21,Hampshire,U.S.,LOC,LOC,PROPN,PROPN,nmod,compound,NNP,NNP,7,1
4,0.0,29,is,3,13,27,14,12,1,-10,24,Hampshire,West Virginia,LOC,LOC-LOC,PROPN,PROPN-PROPN,nmod,compound-pobj,NNP,NNP-NNP,9,1
5,0.0,29,is,3,15,24,9,14,4,-12,21,Hardy,U.S.,LOC,LOC,ADJ,PROPN,conj,compound,JJ,NNP,4,1
6,0.0,29,is,3,15,27,12,14,1,-12,24,Hardy,West Virginia,LOC,LOC-LOC,ADJ,PROPN-PROPN,conj,compound-pobj,JJ,NNP-NNP,6,1
7,0.0,29,is,3,19,24,5,18,4,-16,21,Eastern Panhandle,U.S.,LOC-LOC,LOC,PROPN-PROPN,PROPN,compound-compound,compound,NNP-NNP,NNP,3,1
8,0.0,29,is,3,19,27,8,18,1,-16,24,Eastern Panhandle,West Virginia,LOC-LOC,LOC-LOC,PROPN-PROPN,PROPN-PROPN,compound-compound,compound-pobj,NNP-NNP,NNP-NNP,5,1
9,0.0,29,is,3,24,27,3,23,1,-21,24,U.S.,West Virginia,LOC,LOC-LOC,PROPN,PROPN-PROPN,compound,compound-pobj,NNP,NNP-NNP,2,1
0,0.0,24,is,13,2,22,20,1,1,11,9,Wigram Baronetcy,United Kingdom,MISC-MISC,LOC-LOC,PROPN-PROPN,PROPN-PROPN,compound-nsubj,compound-pobj,NNP-NNP,NNP-NNP,6,1
1,0.0,24,is,13,6,22,16,5,1,7,9,Walthamstow House,United Kingdom,LOC-LOC,LOC-LOC,PROPN-PROPN,PROPN-PROPN,compound-pobj,compound-pobj,NNP-NNP,NNP-NNP,8,1
2,0.0,24,is,13,10,22,12,9,1,3,9,County of Essex,United Kingdom,LOC-LOC-LOC,LOC-LOC,PROPN-ADP-PROPN,PROPN-PROPN,pobj-prep-pobj,compound-pobj,NNP-IN-NNP,NNP-NNP,11,1
3,5.0,25,was,3,3,16,13,2,8,0,13,Baronet,Conservative,MISC,ORG,PROPN,PROPN,nsubj,amod,NNP,NNP,3,1
4,6.0,28,gained,25,5,12,7,4,15,20,-13,James Wigram,Loftus Wigram,PER-PER,PER-PER,PROPN-PROPN,PROPN-PROPN,compound-appos,compound-conj,NNP-NNP,NNP-NNP,2,1
5,6.0,28,gained,25,5,15,10,4,12,20,-10,James Wigram,George Wigram,PER-PER,PER-PER,PROPN-PROPN,PROPN-PROPN,compound-appos,compound-conj,NNP-NNP,NNP-NNP,3,1
6,6.0,28,gained,25,12,15,3,11,12,13,-10,Loftus Wigram,George Wigram,PER-PER,PER-PER,PROPN-PROPN,PROPN-PROPN,compound-conj,compound-conj,NNP-NNP,NNP-NNP,1,1
0,3.0,34,is,17,7,5,-2,6,28,10,-12,Mehmed II,Ottoman,PER-PER,LOC,PROPN-PROPN,PROPN,compound-appos,pobj,NNP-NNP,NNP,1,1
0,0.0,19,is,9,1,6,5,0,12,8,-3,Helen Mary Southworth,13 November 1956,PER-PER-PER,TIME-TIME-TIME,PROPN-PROPN-PROPN,NUM-PROPN-NUM,compound-compound-nsubj,nummod-npadvmod-nummod,NNP-NNP-NNP,CD-NNP-CD,3,1
1,0.0,19,is,9,1,12,11,0,6,8,3,Helen Mary Southworth,Labour Party,PER-PER-PER,ORG-ORG,PROPN-PROPN-PROPN,PROPN-PROPN,compound-compound-nsubj,compound-compound,NNP-NNP-NNP,NNP-NNP,4,1
2,0.0,19,is,9,1,17,16,0,1,8,8,Helen Mary Southworth,United Kingdom,PER-PER-PER,LOC-LOC,PROPN-PROPN-PROPN,PROPN-PROPN,compound-compound-nsubj,compound-pobj,NNP-NNP-NNP,NNP-NNP,5,1
3,0.0,19,is,9,12,17,5,11,1,-3,8,Labour Party,United Kingdom,ORG-ORG,LOC-LOC,PROPN-PROPN,PROPN-PROPN,compound-compound,compound-pobj,NNP-NNP,NNP-NNP,3,1
4,5.0,31,was,1,19,18,-1,18,12,-18,17,David Mowat,Conservative,PER-PER,ORG,PROPN-PROPN,PROPN,compound-appos,compound,NNP-NNP,NNP,1,1
0,0.0,51,began,7,6,47,41,5,3,1,40,Vietnam War,South Vietnam,MISC-MISC,LOC-LOC,PROPN-PROPN,PROPN-PROPN,compound-pobj,compound-poss,NNP-NNP,NNP-NNP,13,1
1,2.0,35,remains,1,14,32,18,13,2,-13,31,Second World War,First World War,MISC-MISC-MISC,MISC-MISC-MISC,PROPN-PROPN-PROPN,PROPN-PROPN-PROPN,compound-compound-pobj,compound-compound-pobj,NNP-NNP-NNP,NNP-NNP-NNP,10,1
0,0.0,21,was,16,1,5,4,0,15,15,-11,Heinrich Alexander Pagenstecher,18 March 1825,PER-PER-PER,TIME-TIME-TIME,PROPN-PROPN-PROPN,NUM-PROPN-NUM,compound-compound-nsubj,nummod-appos-nummod,NNP-NNP-NNP,CD-NNP-CD,2,1
1,0.0,21,was,16,1,9,8,0,11,15,-7,Heinrich Alexander Pagenstecher,Elberfeld,PER-PER-PER,LOC,PROPN-PROPN-PROPN,PROPN,compound-compound-nsubj,compound,NNP-NNP-NNP,NNP,3,1
2,0.0,21,was,16,1,11,10,0,9,15,-5,Heinrich Alexander Pagenstecher,4 January 1889,PER-PER-PER,TIME-TIME-TIME,PROPN-PROPN-PROPN,NUM-PROPN-NUM,compound-compound-nsubj,nummod-appos-nummod,NNP-NNP-NNP,CD-NNP-CD,3,1
3,0.0,21,was,16,1,15,14,0,5,15,-1,Heinrich Alexander Pagenstecher,Hamburg,PER-PER-PER,LOC,PROPN-PROPN-PROPN,PROPN,compound-compound-nsubj,appos,NNP-NNP-NNP,NNP,3,1
0,0.0,34,is,5,1,8,7,0,25,4,3,Fudbalski klub Sarajevo,Bosnian,ORG-ORG-ORG,LOC,PROPN-NOUN-PROPN,ADJ,compound-compound-nsubj,amod,NNP-NN-NNP,JJ,4,1
1,0.0,34,is,5,8,3,-5,7,30,-3,-2,Bosnian,Sarajevo,LOC,LOC,ADJ,PROPN,amod,pobj,JJ,NNP,3,1
2,0.0,34,is,5,3,20,17,2,13,2,15,Sarajevo,Bosnia and Herzegovina,LOC,LOC-LOC-LOC,PROPN,PROPN-CCONJ-PROPN,pobj,pobj-cc-conj,NNP,NNP-CC-NNP,9,1
3,1.0,48,was,8,7,3,-4,6,44,1,-5,FK Sarajevo,24 October 1946,ORG-ORG,TIME-TIME-TIME,PROPN-PROPN,NUM-PROPN-NUM,compound-nsubj,nummod-pobj-nummod,NNP-NNP,CD-NNP-CD,4,1
4,1.0,48,was,8,15,19,4,14,28,-7,11,SR Bosnia,SFR Yugoslavia,LOC-LOC,LOC-LOC,PROPN-PROPN,PROPN-PROPN,compound-pobj,compound-pobj,NNP-NNP,NNP-NNP,4,1
5,6.0,36,is,4,3,26,23,2,9,1,22,FK Sarajevo,Bosnian championships,ORG-ORG,MISC-MISC,PROPN-PROPN,ADJ-NOUN,compound-nsubj,amod-dobj,NNP-NNP,JJ-NNS,6,1
6,12.0,23,run,7,5,21,16,4,1,2,14,FK Sarajevo,Vincent Tan,ORG-ORG,PER-PER,PROPN-PROPN,PROPN-PROPN,compound-nsubjpass,compound-appos,NNP-NNP,NNP-NNP,5,1
0,0.0,31,was,18,1,5,4,0,25,17,-13,Ernst Ludwig Gerber,29 September 1746,PER-PER-PER,TIME-TIME-TIME,PROPN-PROPN-PROPN,NUM-PROPN-NUM,compound-compound-nsubj,nummod-appos-nummod,NNP-NNP-NNP,CD-NNP-CD,2,1
1,0.0,31,was,18,1,13,12,0,17,17,-5,Ernst Ludwig Gerber,30 June 1819,PER-PER-PER,TIME-TIME-TIME,PROPN-PROPN-PROPN,NUM-PROPN-NUM,compound-compound-nsubj,nummod-appos-nummod,NNP-NNP-NNP,CD-NNP-CD,4,1
2,1.0,46,was,19,4,8,4,3,37,15,-11,Heinrich Nicolas Gerber,1702,PER-PER-PER,TIME,PROPN-PROPN-PROPN,NUM,compound-compound-appos,npadvmod,NNP-NNP-NNP,CD,4,1
0,1.0,24,dominates,15,4,12,8,3,11,11,-3,Swabian Alb,Germany,LOC-LOC,LOC,ADJ-PROPN,PROPN,amod-compound,pobj,JJ-NNP,NNP,5,1
1,4.0,28,was,11,6,27,21,5,0,5,16,World War II,Allies,MISC-MISC-MISC,ORG,PROPN-PROPN-PROPN,PROPN,compound-compound-pobj,pobj,NNP-NNP-NNP,NNPS,6,1
2,4.0,28,was,11,18,22,4,17,5,-7,11,Vichy French Government,France,ORG-ORG-ORG,LOC,PROPN-PROPN-PROPN,PROPN,compound-compound-pobj,nsubjpass,NNP-NNP-NNP,NNP,6,1
0,1.0,18,premièred,1,15,17,2,14,0,-14,16,Naples,Italy,LOC,LOC,PROPN,PROPN,pobj,appos,NNP,NNP,6,1
1,4.0,23,consider,5,13,19,6,12,3,-8,14,Guillaume Tell,Rossini,MISC-MISC,PER,PROPN-PROPN,PROPN,compound-pobj,poss,NNP-NNP,NNP,8,1
0,0.0,23,born,3,10,12,2,9,10,-7,9,Granada,Spain,LOC,LOC,PROPN,PROPN,dep,appos,NNP,NNP,6,1
0,0.0,14,is,9,1,6,5,0,7,8,-3,Erik Fosnes Hansen,6 June 1965,PER-PER-PER,TIME-TIME-TIME,PROPN-PROPN-PROPN,NUM-PROPN-NUM,compound-compound-nsubj,nummod-npadvmod-nummod,NNP-NNP-NNP,CD-NNP-CD,3,1
1,0.0,14,is,9,1,12,11,0,1,8,3,Erik Fosnes Hansen,Norwegian,PER-PER-PER,LOC,PROPN-PROPN-PROPN,ADJ,compound-compound-nsubj,amod,NNP-NNP-NNP,JJ,3,1
0,0.0,11,is,2,1,8,7,0,2,1,6,St Marys,Ontario,LOC-LOC,LOC,PROPN-PROPN,PROPN,compound-nsubj,pobj,NNP-NNP,NNP,5,1
1,9.0,32,opened,16,30,27,-3,29,4,-14,11,St Marys,Ontario,LOC-LOC,LOC,PROPN-PROPN,PROPN,compound-conj,conj,NNP-NNP,NNP,2,1
2,1.0,31,located,2,30,24,-6,29,6,-28,22,Ontario,Perth County,LOC,LOC-LOC,PROPN,PROPN-PROPN,appos,compound-pobj,NNP,NNP-NNP,4,1
3,1.0,31,located,2,22,24,2,21,6,-20,22,Township of Perth South,Perth County,LOC-LOC-LOC-LOC,LOC-LOC,PROPN-ADP-PROPN-PROPN,PROPN-PROPN,pobj-prep-compound-pobj,compound-pobj,NNP-IN-NNP-NNP,NNP-NNP,3,1
4,8.0,15,is,1,7,10,3,6,4,-6,9,Arthur Meighen,Canada,PER-PER,LOC,PROPN-PROPN,PROPN,compound-pobj,poss,NNP-NNP,NNP,3,1
5,9.0,32,opened,16,25,27,2,24,4,-9,11,Kirkton,Ontario,LOC,LOC,PROPN,PROPN,pobj,conj,NNP,NNP,3,1
0,0.0,16,is,9,1,6,5,0,9,8,-3,Hu Ge,20 September 1982,PER-PER,TIME-TIME-TIME,PROPN-PROPN,NUM-PROPN-NUM,compound-nsubj,nummod-npadvmod-nummod,NNP-NNP,CD-NNP-CD,2,1
0,0.0,13,"""",0,2,11,9,1,1,-2,11,Dirty Diana,Michael Jackson,MISC-MISC,PER-PER,ADJ-PROPN,PROPN-PROPN,compound-nsubj,compound-pobj,JJ-NNP,NNP-NNP,4,1
1,3.0,26,presents,1,14,16,2,13,9,-13,15,Thriller,1982,MISC,TIME,PROPN,NUM,pobj,appos,NNP,CD,2,1
2,4.0,19,"""",0,2,17,15,1,1,-2,17,Dirty Diana,Quincy Jones,MISC-MISC,PER-PER,ADJ-PROPN,PROPN-PROPN,compound-nsubjpass,compound-pobj,JJ-NNP,NNP-NNP,4,1
3,4.0,19,"""",0,2,12,10,1,6,-2,12,Dirty Diana,Jackson,MISC-MISC,PER,ADJ-PROPN,PROPN,compound-nsubjpass,pobj,JJ-NNP,NNP,2,1
0,0.0,27,Faustina,3,1,18,17,0,8,2,15,Annia Galeria Aurelia Faustina,Marcus Aurelius,PER-PER-PER-PER,PER-PER,PROPN-PROPN-PROPN-PROPN,PROPN-PROPN,compound-compound-compound-ROOT,compound-appos,NNP-NNP-NNP-NNP,NNP-NNP,6,1
1,0.0,27,Faustina,3,1,4,3,0,22,2,1,Annia Galeria Aurelia Faustina,Faustina the Younger,PER-PER-PER-PER,PER-PER-PER,PROPN-PROPN-PROPN-PROPN,PROPN-DET-PROPN,compound-compound-compound-ROOT,appos-det-appos,NNP-NNP-NNP-NNP,NNP-DT-NNP,3,1
2,0.0,27,Faustina,3,18,4,-14,17,22,-15,1,Marcus Aurelius,Faustina the Younger,PER-PER,PER-PER-PER,PROPN-PROPN,PROPN-DET-PROPN,compound-appos,appos-det-appos,NNP-NNP,NNP-DT-NNP,7,1
3,1.0,12,was,3,5,11,6,4,0,-2,8,Lucilla,Commodus,PER,PER,PROPN,PROPN,attr,attr,NNP,NNP,3,1
4,2.0,24,were,3,5,8,3,4,15,-2,5,Antoninus Pius,Faustina the Elder,PER-PER,PER-PER-PER,PROPN-PROPN,PROPN-DET-ADJ,compound-attr,conj-det-appos,NNP-NNP,NNP-DT-JJR,3,1
5,7.0,19,bore,1,3,8,5,2,10,-2,7,Claudius Severus,Tiberius Claudius Severus Proculus,PER-PER,PER-PER-PER-PER,PROPN-PROPN,PROPN-PROPN-PROPN-PROPN,compound-dobj,compound-compound-compound-appos,NNP-NNP,NNP-NNP-NNP-NNP,3,1
0,0.0,22,is,3,1,15,14,0,6,2,12,Dhangadhi,Kailali District,LOC,LOC-LOC,PROPN,PROPN-PROPN,nsubj,compound-pobj,NNP,NNP-NNP,5,1
1,0.0,22,is,3,1,21,20,0,0,2,18,Dhangadhi,Nepal,LOC,LOC,PROPN,PROPN,nsubj,pobj,NNP,NNP,3,1
2,0.0,22,is,3,15,18,3,14,3,-12,15,Kailali District,Sudurpashchim Pradesh,LOC-LOC,LOC-LOC,PROPN-PROPN,PROPN-PROPN,compound-pobj,compound-pobj,NNP-NNP,NNP-NNP,2,1
3,0.0,22,is,3,15,21,6,14,0,-12,18,Kailali District,Nepal,LOC-LOC,LOC,PROPN-PROPN,PROPN,compound-pobj,pobj,NNP-NNP,NNP,6,1
4,1.0,34,shares,1,6,9,3,5,24,-5,8,Uttar Pradesh,India,LOC-LOC,LOC,PROPN-PROPN,PROPN,compound-pobj,appos,NNP-NNP,NNP,2,1
0,0.0,28,is,9,18,21,3,17,6,-9,12,Hollywood,Los Angeles,LOC,LOC-LOC,PROPN,PROPN-PROPN,compound,compound-pobj,NNP,NNP-NNP,2,1
1,0.0,28,is,9,18,26,8,17,1,-9,17,Hollywood,United States,LOC,LOC-LOC,PROPN,PROPN-PROPN,compound,compound-appos,NNP,NNP-NNP,3,1
2,0.0,28,is,9,21,26,5,20,1,-12,17,Los Angeles,United States,LOC-LOC,LOC-LOC,PROPN-PROPN,PROPN-PROPN,compound-pobj,compound-appos,NNP-NNP,NNP-NNP,1,1
3,0.0,28,is,9,24,26,2,23,1,-15,17,California,United States,LOC,LOC-LOC,PROPN,PROPN-PROPN,conj,compound-appos,NNP,NNP-NNP,3,1
0,0.0,16,was,2,1,15,14,0,0,1,13,Sunday Best,BET,MISC-MISC,ORG,PROPN-PROPN,PROPN,npadvmod-nsubj,pobj,NNP-NNP,NNP,2,1
0,0.0,21,is,4,2,19,17,1,1,2,15,Seven Mile Bridge,United States,LOC-LOC-LOC,LOC-LOC,PROPN-PROPN-PROPN,PROPN-PROPN,compound-compound-nsubj,compound-appos,NNP-NNP-NNP,NNP-NNP,7,1
1,0.0,21,is,4,10,14,4,9,6,-6,10,Florida Keys,Monroe County,LOC-LOC,LOC-LOC,PROPN-PROPN,PROPN-PROPN,compound-pobj,compound-pobj,NNP-NNP,NNP-NNP,4,1
2,0.0,21,is,4,10,10,0,9,10,-6,6,Florida Keys,Florida,LOC-LOC,LOC,PROPN-PROPN,PROPN,compound-pobj,appos,NNP-NNP,NNP,0,1
3,0.0,21,is,4,10,19,9,9,1,-6,15,Florida Keys,United States,LOC-LOC,LOC-LOC,PROPN-PROPN,PROPN-PROPN,compound-pobj,compound-appos,NNP-NNP,NNP-NNP,6,1
4,0.0,21,is,4,14,10,-4,13,10,-10,6,Monroe County,Florida,LOC-LOC,LOC,PROPN-PROPN,PROPN,compound-pobj,appos,NNP-NNP,NNP,4,1
5,0.0,21,is,4,14,19,5,13,1,-10,15,Monroe County,United States,LOC-LOC,LOC-LOC,PROPN-PROPN,PROPN-PROPN,compound-pobj,compound-appos,NNP-NNP,NNP-NNP,2,1
6,0.0,21,is,4,10,19,9,9,1,-6,15,Florida,United States,LOC,LOC-LOC,PROPN,PROPN-PROPN,appos,compound-appos,NNP,NNP-NNP,6,1
7,1.0,28,connects,1,21,26,5,20,1,-20,25,Little Duck Key,Lower Keys,LOC-LOC-LOC,LOC-LOC,PROPN-PROPN-PROPN,PROPN-PROPN,compound-compound-pobj,compound-pobj,NNP-NNP-NNP,NNP-NNP,3,1
8,2.0,32,is,12,17,29,12,16,2,-5,17,Overseas Highway,U.S. Route 1,LOC-LOC,LOC-LOC-LOC,PROPN-PROPN,PROPN-PROPN-NUM,compound-pobj,compound-pobj-nummod,NNP-NNP,NNP-NNP-CD,5,1
0,0.0,15,is,10,1,7,6,0,7,9,-3,Linda Karen Reynolds,16 May 1965,PER-PER-PER,TIME-TIME-TIME,PROPN-PROPN-PROPN,NUM-PROPN-NUM,compound-compound-nsubj,nummod-npadvmod-nummod,NNP-NNP-NNP,CD-NNP-CD,3,1
1,4.0,32,was,1,1,20,19,0,11,0,19,Reynolds,Australian Army Reserve,PER,ORG-ORG-ORG,PROPN,PROPN-PROPN-PROPN,nsubj,compound-compound-pobj,NNP,NNP-NNP-NNP,4,1
2,4.0,32,was,1,1,8,7,0,23,0,7,Reynolds,Federal Liberal Party,PER,ORG-ORG-ORG,PROPN,PROPN-PROPN-PROPN,nsubj,compound-compound-pobj,NNP,NNP-NNP-NNP,4,1
0,0.0,29,is,3,2,2,0,1,26,1,-1,Bahamas Bowl,Bahamas,MISC-MISC,LOC,PROPN-PROPN,PROPN,compound-nsubj,appos,NNPS-NNP,NNP,0,1
1,1.0,47,was,8,44,46,2,43,0,-36,38,Havana,Cuba,LOC,LOC,PROPN,PROPN,pobj,appos,NNP,NNP,9,1
2,6.0,32,"Illinois—""home",4,1,7,6,0,24,3,3,Elk Grove Village,the United States,LOC-LOC-LOC,LOC-LOC-LOC,PROPN-PROPN-PROPN,DET-PROPN-PROPN,compound-compound-dep,det-compound-pobj,NNP-NNP-NNP,DT-NNP-NNP,5,1
0,0.0,32,is,19,25,1,-24,24,30,-6,-18,Turkey,Sivas Province,LOC,LOC-LOC,PROPN,PROPN-PROPN,pobj,compound-pobj,NNP,NNP-NNP,4,1
0,1.0,14,started,1,1,8,7,0,5,0,7,Oliver,Stanford University,PER,ORG-ORG,PROPN,PROPN-PROPN,nsubj,compound-dobj,NNP,NNP-NNP,3,1
1,4.0,23,moved,2,15,13,-2,14,9,-13,11,The Neighbors and STARZ 's Survivor 's Remorse,ABC,MISC-MISC-MISC-MISC-MISC-MISC-MISC-MISC,ORG,DET-PROPN-CCONJ-PROPN-PART-PROPN-PART-PROPN,PROPN,compound-pobj-cc-poss-case-poss-case-conj,poss,DT-NNPS-CC-NNP-POS-NNP-POS-NNP,NNP,2,1
2,5.0,51,teamed,4,31,34,3,30,16,-27,30,Girls Trip,2017,MISC-MISC,TIME,PROPN-PROPN,NUM,compound-conj,appos,NNP-NNP,CD,1,1
3,5.0,51,teamed,4,31,38,7,30,12,-27,34,Girls Trip,Queen Latifah,MISC-MISC,PER-PER,PROPN-PROPN,PROPN-PROPN,compound-conj,compound-dobj,NNP-NNP,NNP-NNP,6,1
4,5.0,51,teamed,4,31,41,10,30,9,-27,37,Girls Trip,Regina Hall,MISC-MISC,PER-PER,PROPN-PROPN,PROPN-PROPN,compound-conj,compound-conj,NNP-NNP,NNP-NNP,7,1
5,5.0,51,teamed,4,31,44,13,30,6,-27,40,Girls Trip,Jada Pinkett Smith,MISC-MISC,PER-PER-PER,PROPN-PROPN,PROPN-PROPN-PROPN,compound-conj,compound-compound-conj,NNP-NNP,NNP-NNP-NNP,9,1
6,5.0,51,teamed,4,31,49,18,30,1,-27,45,Girls Trip,Tiffany Haddish,MISC-MISC,PER-PER,PROPN-PROPN,PROPN-PROPN,compound-conj,compound-conj,NNP-NNP,NNP-NNP,9,1
0,1.0,22,Founded,0,13,21,8,12,0,-13,21,Chulalongkorn,Mongkut,PER,PER,PROPN,PROPN,pobj,appos,NNP,NNP,2,1
0,3.0,24,organized,4,22,17,-5,21,6,-18,13,United States,Oregon Territory,LOC-LOC,LOC-LOC,PROPN-PROPN,PROPN-PROPN,compound-pobj,compound-pobj,NNP-NNP,NNP-NNP,2,1
0,0.0,27,is,1,9,12,3,8,14,-8,11,Mexican,Baja California,LOC,LOC-LOC,ADJ,PROPN-PROPN,amod,compound-pobj,JJ,NNP-NNP,4,1
1,0.0,27,is,1,12,1,-11,11,25,-11,0,Baja California,Rosarito Beach Municipality,LOC-LOC,LOC-LOC-LOC,PROPN-PROPN,PROPN-PROPN-PROPN,compound-pobj,compound-compound-pobj,NNP-NNP,NNP-NNP-NNP,3,1
2,5.0,25,is,1,15,8,-7,14,16,-14,7,Tijuana,Mexico,LOC,LOC,PROPN,PROPN,dobj,pobj,NNP,NNP,2,1
0,7.0,52,known,38,34,16,-18,33,35,4,-22,Hapi,Horus,PER,PER,PROPN,PROPN,conj,pobj,NNP,NNP,7,1
1,7.0,52,known,38,36,16,-20,35,35,2,-22,Duamutef,Horus,PER,PER,PROPN,PROPN,conj,pobj,NNP,NNP,6,1
2,7.0,52,known,38,16,32,16,15,19,22,-6,Horus,Imset,PER,PER,PROPN,PROPN,pobj,attr,NNP,NNP,6,1
0,7.0,28,is,1,11,13,2,10,14,-10,12,Smithsonian,National Museum of American History,ORG,LOC-LOC-LOC-LOC-LOC,PROPN,PROPN-PROPN-ADP-PROPN-PROPN,poss,compound-pobj-prep-compound-pobj,NNP,NNP-NNP-IN-NNP-NNP,2,1
0,7.0,35,include,11,2,13,11,1,21,9,2,the United States,Vermont,LOC-LOC-LOC,LOC,DET-PROPN-PROPN,PROPN,det-compound-pobj,dobj,DT-NNP-NNP,NNP,5,1
1,7.0,35,include,11,2,15,13,1,19,9,4,the United States,California,LOC-LOC-LOC,LOC,DET-PROPN-PROPN,PROPN,det-compound-pobj,conj,DT-NNP-NNP,NNP,6,1
2,7.0,35,include,11,2,18,16,1,16,9,7,the United States,Wisconsin,LOC-LOC-LOC,LOC,DET-PROPN-PROPN,PROPN,det-compound-pobj,conj,DT-NNP-NNP,NNP,4,1
3,7.0,35,include,11,2,31,29,1,3,9,20,the United States,Georgia,LOC-LOC-LOC,LOC,DET-PROPN-PROPN,PROPN,det-compound-pobj,pobj,DT-NNP-NNP,NNP,5,1
0,0.0,13,is,8,1,5,4,0,7,7,-3,François Grin,14 September 1959,PER-PER,TIME-TIME-TIME,PROPN-PROPN,NUM-PROPN-NUM,compound-nsubj,nummod-npadvmod-nummod,NNP-NNP,CD-NNP-CD,2,1
1,0.0,13,is,8,1,11,10,0,1,7,3,François Grin,Swiss,PER-PER,LOC,PROPN-PROPN,ADJ,compound-nsubj,amod,NNP-NNP,JJ,2,1
2,3.0,40,was,2,31,37,6,30,2,-29,35,European Centre for Minority Issues,Flensburg,ORG-ORG-ORG-ORG-ORG,LOC,PROPN-PROPN-ADP-PROPN-PROPN,PROPN,compound-pobj-prep-compound-pobj,pobj,NNP-NNP-IN-NNP-NNPS,NNP,5,1
0,0.0,29,"""",0,2,13,11,1,15,-2,13,Dear Mr. President,Indigo Girls,MISC-MISC-MISC,ORG-ORG,ADJ-PROPN-PROPN,PROPN-PROPN,amod-compound-nsubj,compound-dobj,JJ-NNP-NNP,NNP-NNPS,5,1
1,0.0,29,"""",0,2,25,23,1,3,-2,25,Dear Mr. President,I 'm Not Dead,MISC-MISC-MISC,MISC-MISC-MISC-MISC,ADJ-PROPN-PROPN,PRON-VERB-ADV-ADJ,amod-compound-nsubj,nsubj-ROOT-neg-attr,JJ-NNP-NNP,PRP-VBP-RB-JJ,6,1
2,1.0,19,is,2,8,16,8,7,2,-6,14,the United States,George W. Bush,LOC-LOC-LOC,PER-PER-PER,DET-PROPN-PROPN,PROPN-PROPN-PROPN,det-compound-pobj,compound-compound-appos,DT-NNP-NNP,NNP-NNP-NNP,3,1
0,0.0,26,"""",0,2,22,20,1,3,-2,22,Desperate Souls,Once Upon a Time,MISC-MISC,MISC-MISC-MISC-MISC,ADJ-NOUN,ADV-ADP-DET-NOUN,compound-nsubj,ROOT-prep-det-pobj,JJ-NNS,RB-IN-DT-NN,3,1
1,5.0,28,runs,10,5,8,3,4,19,5,-2,Emma Swan,Jennifer Morrison,PER-PER,PER-PER,PROPN-PROPN,PROPN-PROPN,compound-nsubj,compound-appos,NNP-NNP,NNP-NNP,1,1
2,7.0,18,"""",0,2,12,10,1,5,-2,12,Desperate Souls,ABC,MISC-MISC,ORG,ADJ-NOUN,PROPN,compound-nsubj,pobj,JJ-NNS,NNP,2,1
0,0.0,33,was,11,1,4,3,0,28,10,-7,Mary Tudor,18 March 1496,PER-PER,TIME-TIME-TIME,PROPN-PROPN,NUM-PROPN-NUM,compound-nsubj,nummod-npadvmod-nummod,NNP-NNP,CD-NNP-CD,2,1
1,0.0,33,was,11,1,8,7,0,24,10,-3,Mary Tudor,25 June 1533,PER-PER,TIME-TIME-TIME,PROPN-PROPN,NUM-PROPN-NUM,compound-nsubj,nummod-npadvmod-nummod,NNP-NNP,CD-NNP-CD,4,1
2,1.0,34,became,17,23,26,3,22,7,-6,9,Louis XII,France,PER-PER,LOC,PROPN-PROPN,PROPN,compound-pobj,pobj,NNP-NNP,NNP,4,1
3,1.0,34,became,17,6,11,5,5,22,11,-6,Henry VII,England,PER-PER,LOC,PROPN-PROPN,PROPN,compound-pobj,pobj,NNP-NNP,NNP,4,1
0,0.0,29,is,5,1,4,3,0,24,4,-1,The Voice of Frank Sinatra,Frank Sinatra,MISC-MISC-MISC-MISC-MISC,PER-PER,DET-PROPN-ADP-PROPN-PROPN,PROPN-PROPN,det-nsubj-prep-compound-pobj,compound-pobj,DT-NNP-IN-NNP-NNP,NNP-NNP,2,1
1,0.0,29,is,5,1,19,18,0,9,4,14,The Voice of Frank Sinatra,Columbia Records,MISC-MISC-MISC-MISC-MISC,ORG-ORG,DET-PROPN-ADP-PROPN-PROPN,PROPN-PROPN,det-nsubj-prep-compound-pobj,compound-pobj,DT-NNP-IN-NNP-NNP,NNP-NNPS,5,1
2,0.0,29,is,5,1,25,24,0,3,4,20,The Voice of Frank Sinatra,"March 4 , 1946",MISC-MISC-MISC-MISC-MISC,TIME-TIME-TIME-TIME,DET-PROPN-ADP-PROPN-PROPN,PROPN-NUM-PUNCT-NUM,det-nsubj-prep-compound-pobj,npadvmod-nummod-punct-nummod,DT-NNP-IN-NNP-NNP,"NNP-CD-,-CD",8,1
3,0.0,29,is,5,4,19,15,3,9,1,14,Frank Sinatra,Columbia Records,PER-PER,ORG-ORG,PROPN-PROPN,PROPN-PROPN,compound-pobj,compound-pobj,NNP-NNP,NNP-NNPS,7,1
0,0.0,29,is,3,11,16,5,10,12,-8,13,Côte - Nord,Quebec,LOC-LOC-LOC,LOC,PROPN-PUNCT-PROPN,PROPN,compound-punct-compound,pobj,NNP-HYPH-NNP,NNP,5,1
1,0.0,29,is,3,11,18,7,10,10,-8,15,Côte - Nord,Canada,LOC-LOC-LOC,LOC,PROPN-PUNCT-PROPN,PROPN,compound-punct-compound,appos,NNP-HYPH-NNP,NNP,5,1
2,0.0,29,is,3,16,18,2,15,10,-13,15,Quebec,Canada,LOC,LOC,PROPN,PROPN,pobj,appos,NNP,NNP,6,1
3,0.0,29,is,3,16,25,9,15,3,-13,22,Quebec,National Assembly of Quebec,LOC,ORG-ORG-ORG-ORG,PROPN,PROPN-PROPN-ADP-PROPN,pobj,compound-pobj-prep-pobj,NNP,NNP-NNP-IN-NNP,8,1
0,0.0,21,is,3,12,19,7,11,1,-9,16,North Dakota,Burleigh County,LOC-LOC,LOC-LOC,PROPN-PROPN,PROPN-PROPN,compound-pobj,compound-pobj,NNP-NNP,NNP-NNP,3,1
0,0.0,13,is,2,1,11,10,0,1,1,9,Rocket Cottage,Steeleye Span,MISC-MISC,ORG-ORG,PROPN-PROPN,PROPN-PROPN,compound-nsubj,compound-pobj,NNP-NNP,NNP-NNP,4,1
1,3.0,70,was,4,3,56,53,2,13,1,52,Rocket Cottage,Steeleye Span,MISC-MISC,ORG-ORG,PROPN-PROPN,PROPN-PROPN,compound-nsubj,compound-pobj,NNP-NNP,NNP-NNP,5,1
2,12.0,49,agreed,32,24,31,7,23,17,8,-1,The King of Elfland 's Daughter,Chrysalis Records,MISC-MISC-MISC-MISC-MISC-MISC,ORG-ORG,DET-PROPN-ADP-PROPN-PART-PROPN,PROPN-PROPN,det-pobj-prep-poss-case-pobj,compound-nsubj,DT-NNP-IN-NNP-POS-NNP,NNP-NNPS,8,1
0,0.0,29,Kombat,1,1,15,14,0,13,0,14,Mortal Kombat : Deadly Alliance,Midway,MISC-MISC-MISC-MISC-MISC,ORG,ADJ-PROPN-PUNCT-PROPN-PROPN,PROPN,compound-ROOT-punct-amod-nsubj,pobj,JJ-NNP-:-NNP-NNP,NNP,7,1
1,0.0,29,Kombat,1,1,18,17,0,10,0,17,Mortal Kombat : Deadly Alliance,Xbox,MISC-MISC-MISC-MISC-MISC,MISC,ADJ-PROPN-PUNCT-PROPN-PROPN,PROPN,compound-ROOT-punct-amod-nsubj,nmod,JJ-NNP-:-NNP-NNP,NNP,2,1
2,0.0,29,Kombat,1,1,20,19,0,8,0,19,Mortal Kombat : Deadly Alliance,PlayStation 2,MISC-MISC-MISC-MISC-MISC,MISC-MISC,ADJ-PROPN-PUNCT-PROPN-PROPN,PROPN-NUM,compound-ROOT-punct-amod-nsubj,pobj-nummod,JJ-NNP-:-NNP-NNP,NNP-CD,3,1
3,0.0,29,Kombat,1,1,23,22,0,5,0,22,Mortal Kombat : Deadly Alliance,GameCube,MISC-MISC-MISC-MISC-MISC,MISC,ADJ-PROPN-PUNCT-PROPN-PROPN,PROPN,compound-ROOT-punct-amod-nsubj,conj,JJ-NNP-:-NNP-NNP,NNP,4,1
4,0.0,29,Kombat,1,1,26,25,0,2,0,25,Mortal Kombat : Deadly Alliance,Game Boy Advance,MISC-MISC-MISC-MISC-MISC,MISC-MISC-MISC,ADJ-PROPN-PUNCT-PROPN-PROPN,PROPN-PROPN-PROPN,compound-ROOT-punct-amod-nsubj,compound-compound-conj,JJ-NNP-:-NNP-NNP,NNP-NNP-NNP,5,1
0,0.0,30,is,5,10,29,19,9,0,-5,24,Belgian,Brussels,LOC,LOC,ADJ,PROPN,amod,conj,JJ,NNP,4,1
0,0.0,22,is,3,1,6,5,0,15,2,3,Crossing the Water,1971,MISC-MISC-MISC,TIME,VERB-DET-PROPN,NUM,csubj-det-dobj,nummod,VBG-DT-NNP,CD,5,1
1,4.0,52,"""",0,2,17,15,1,34,-2,17,Wuthering Heights,Yorkshire,MISC-MISC,LOC,VERB-NOUN,PROPN,advcl-dobj,compound,VBG-NNS,NNP,4,1
0,0.0,16,is,4,1,13,12,0,2,3,9,Tenglong Cave,Hubei,LOC-LOC,LOC,PROPN-PROPN,PROPN,compound-nsubj,npadvmod,NNP-NNP,NNP,7,1
1,0.0,16,is,4,1,15,14,0,0,3,11,Tenglong Cave,China,LOC-LOC,LOC,PROPN-PROPN,PROPN,compound-nsubj,appos,NNP-NNP,NNP,2,1
2,0.0,16,is,4,10,13,3,9,2,-6,9,Lichuan City,Hubei,LOC-LOC,LOC,PROPN-PROPN,PROPN,compound-pobj,npadvmod,NNP-NNP,NNP,2,1
3,0.0,16,is,4,10,15,5,9,0,-6,11,Lichuan City,China,LOC-LOC,LOC,PROPN-PROPN,PROPN,compound-pobj,appos,NNP-NNP,NNP,5,1
4,0.0,16,is,4,13,15,2,12,0,-9,11,Hubei,China,LOC,LOC,PROPN,PROPN,npadvmod,appos,NNP,NNP,7,1
0,0.0,37,involved,3,2,13,11,1,23,1,10,Mungana affair,Australia,MISC-MISC,LOC,PROPN-NOUN,PROPN,compound-nsubj,appos,NNP-NN,NNP,3,1
0,0.0,21,It,0,1,19,18,0,1,-1,19,It Wo n't Be Soon Before Long,Maroon 5,MISC-MISC-MISC-MISC-MISC-MISC-MISC,ORG-ORG,PRON-VERB-ADV-VERB-ADV-ADP-PROPN,PROPN-NUM,ROOT-aux-neg-ROOT-advmod-mark-nsubj,appos-nummod,PRP-MD-RB-VB-RB-IN-NNP,NNP-CD,7,1
1,1.0,28,released,2,22,26,4,21,1,-20,24,Songs About Jane,2002,MISC-MISC-MISC,TIME,PROPN-ADP-PROPN,NUM,appos-prep-pobj,appos,NNP-IN-NNP,CD,7,1
0,15.0,28,is,23,13,17,4,12,10,10,-6,State Water Register,Russia,MISC-MISC-MISC,LOC,PROPN-PROPN-PROPN,PROPN,compound-compound-pobj,pobj,NNP-NNP-NNP,NNP,4,1
0,5.0,33,presents,1,7,32,25,6,0,-6,31,the United States,Massachusetts,LOC-LOC-LOC,LOC,DET-PROPN-PROPN,PROPN,det-compound-pobj,appos,DT-NNP-NNP,NNP,6,1
0,1.0,48,led,14,44,12,-32,43,35,-30,-2,Seven Years ' War,US,MISC-MISC-MISC-MISC,LOC,PROPN-PROPN-PART-PROPN,PROPN,nummod-poss-case-pobj,compound,NNP-NNPS-POS-NNP,NNP,12,1
0,1.0,21,located,2,5,5,0,4,15,-3,3,Jervis Bay Village,Jervis Bay,LOC-LOC-LOC,LOC-LOC,PROPN-PROPN-PROPN,PROPN-PROPN,compound-compound-pobj,compound-pobj,NNP-NNP-NNP,NNP-NNP,0,1
1,1.0,21,located,2,5,5,0,4,15,-3,3,Jervis Bay Village,Jervis Bay Territory,LOC-LOC-LOC,LOC-LOC-LOC,PROPN-PROPN-PROPN,PROPN-PROPN-PROPN,compound-compound-pobj,compound-compound-pobj,NNP-NNP-NNP,NNP-NNP-NNP,0,1
2,1.0,21,located,2,9,5,-4,8,15,-7,3,Greenpatch,Jervis Bay,LOC,LOC-LOC,PROPN,PROPN-PROPN,conj,compound-pobj,NNP,NNP-NNP,4,1
3,1.0,21,located,2,9,5,-4,8,15,-7,3,Greenpatch,Jervis Bay Territory,LOC,LOC-LOC-LOC,PROPN,PROPN-PROPN-PROPN,conj,compound-compound-pobj,NNP,NNP-NNP-NNP,4,1
4,1.0,21,located,2,5,5,0,4,15,-3,3,Jervis Bay,Jervis Bay Territory,LOC-LOC,LOC-LOC-LOC,PROPN-PROPN,PROPN-PROPN-PROPN,compound-pobj,compound-compound-pobj,NNP-NNP,NNP-NNP-NNP,0,1
5,2.0,46,is,6,9,45,36,8,0,-3,39,Charles Huxtable,Australia,PER-PER,LOC,PROPN-PROPN,PROPN,compound-attr,pobj,NNP-NNP,NNP,2,1
6,2.0,46,is,6,9,12,3,8,33,-3,6,Charles Huxtable,RAN,PER-PER,ORG,PROPN-PROPN,PROPN,compound-attr,appos,NNP-NNP,NNP,2,1
7,2.0,46,is,6,20,45,25,19,0,-14,39,Naval Waters for Jervis Bay,Australia,ORG-ORG-ORG-ORG-ORG,LOC,PROPN-PROPN-ADP-PROPN-PROPN,PROPN,compound-pobj-prep-compound-pobj,pobj,NNP-NNP-IN-NNP-NNP,NNP,6,1
0,0.0,50,spelled,3,22,25,3,21,24,-19,22,Tashkent Province,Uzbekistan,LOC-LOC,LOC,PROPN-PROPN,PROPN,compound-pobj,appos,NNP-NNP,NNP,2,1
0,0.0,27,fought,5,1,21,20,0,5,4,16,The Battle of Cologne,Germany,MISC-MISC-MISC-MISC,LOC,DET-PROPN-ADP-PROPN,PROPN,det-nsubjpass-prep-pobj,pobj,DT-NNP-IN-NNP,NNP,-1,1
0,0.0,24,located,3,1,13,12,0,10,2,10,Klahhane Ridge,Washington,LOC-LOC,LOC,PROPN-PROPN,PROPN,compound-nsubjpass,conj,NNP-NNP,NNP,7,1
1,0.0,24,located,3,1,15,14,0,8,2,12,Klahhane Ridge,USA,LOC-LOC,LOC,PROPN-PROPN,PROPN,compound-nsubjpass,conj,NNP-NNP,NNP,8,1
2,0.0,24,located,3,10,15,5,9,8,-7,12,Port Angeles,USA,LOC-LOC,LOC,PROPN-PROPN,PROPN,compound-pobj,conj,NNP-NNP,NNP,3,1
3,0.0,24,located,3,13,15,2,12,8,-10,12,Washington,USA,LOC,LOC,PROPN,PROPN,conj,conj,NNP,NNP,3,1
0,0.0,33,is,3,1,10,9,0,22,2,7,Tango SA,Luxembourg,ORG-ORG,LOC,PROPN-PROPN,PROPN,compound-nsubj,pobj,NNP-NNP,NNP,2,1
1,1.0,45,focused,18,17,29,12,16,15,1,11,Tango,1998,ORG,TIME,PROPN,NUM,nsubjpass,pobj,NNP,CD,3,1
2,5.0,51,working,13,11,6,-5,10,44,2,-7,Tango,Proximus Group,ORG,ORG-ORG,PROPN,PROPN-PROPN,nsubj,compound-pobj,NNP,NNP-NNP,5,1
0,0.0,47,is,3,28,30,2,27,16,-25,27,Frank,Buster,PER,PER,PROPN,PROPN,appos,conj,NNP,NNP,6,1
1,3.0,42,aired,12,28,18,-10,27,23,-16,6,Playhouse Disney,United States,MISC-MISC,LOC-LOC,PROPN-PROPN,PROPN-PROPN,compound-conj,compound-pobj,NNP-NNP,NNP-NNP,6,1
0,0.0,31,was,11,1,10,9,0,20,10,-1,Jarmo Viinanen,Imatra,PER-PER,LOC,PROPN-PROPN,PROPN,compound-nsubj,appos,NNP-NNP,NNP,1,1
1,5.0,23,known,2,1,9,8,0,13,1,7,Viinanen,University of Turku,PER,ORG-ORG-ORG,PROPN,PROPN-ADP-PROPN,nsubjpass,pobj-prep-pobj,NNP,NNP-IN-NNP,5,1
0,0.0,32,"""",0,2,21,19,1,10,-2,21,Crème Fraîche,South Park,MISC-MISC,MISC-MISC,PROPN-PROPN,PROPN-PROPN,compound-nsubj,compound-pobj,NNP-NNP,NNP-NNP,6,1
1,1.0,16,aired,2,5,8,3,4,7,-3,6,Comedy Central,the United States,ORG-ORG,LOC-LOC-LOC,PROPN-PROPN,DET-PROPN-PROPN,compound-pobj,det-compound-pobj,NNP-NNP,DT-NNP-NNP,3,1
0,4.0,24,won,13,5,1,-4,4,22,8,-12,Ahí vamos,Gustavo Cerati,MISC-MISC,PER-PER,PROPN-NOUN,PROPN-PROPN,compound-compound,compound-poss,NNP-NNS,NNP-NNP,3,1
0,0.0,19,is,3,1,13,12,0,5,2,10,Memorial Management District,Houston,LOC-LOC-LOC,LOC,PROPN-PROPN-PROPN,PROPN,compound-compound-nsubj,pobj,NNP-NNP-NNP,NNP,8,1
1,0.0,19,is,3,1,17,16,0,1,2,14,Memorial Management District,United States,LOC-LOC-LOC,LOC-LOC,PROPN-PROPN-PROPN,PROPN-PROPN,compound-compound-nsubj,compound-appos,NNP-NNP-NNP,NNP-NNP,8,1
2,0.0,19,is,3,13,17,4,12,1,-10,14,Houston,United States,LOC,LOC-LOC,PROPN,PROPN-PROPN,pobj,compound-appos,NNP,NNP-NNP,2,1
3,0.0,19,is,3,15,17,2,14,1,-12,14,Texas,United States,LOC,LOC-LOC,PROPN,PROPN-PROPN,appos,compound-appos,NNP,NNP-NNP,2,1
0,1.0,46,obtained,1,1,20,19,0,25,0,19,Steinhaus,Jan Kazimierz University,PER,ORG-ORG-ORG,PROPN,PROPN-PROPN-PROPN,nsubj,compound-compound-pobj,NNP,NNP-NNP-NNP,5,1
1,1.0,46,obtained,1,24,29,5,23,16,-23,28,Lwów,Ukraine,LOC,LOC,PROPN,PROPN,pobj,appos,NNP,NNP,3,1
2,1.0,46,obtained,1,27,29,2,26,16,-26,28,Lviv,Ukraine,LOC,LOC,PROPN,PROPN,nmod,appos,NNP,NNP,2,1
3,1.0,46,obtained,1,6,9,3,5,36,-5,8,David Hilbert,Göttingen University,PER-PER,ORG-ORG,PROPN-PROPN,PROPN-PROPN,compound-pobj,compound-pobj,NNP-NNP,NNP-NNP,2,1
0,1.0,49,revolves,2,5,9,4,4,39,-3,7,George Costanza,Jason Alexander,PER-PER,PER-PER,PROPN-PROPN,PROPN-PROPN,compound-poss,compound-nmod,NNP-NNP,NNP-NNP,1,1
1,2.0,41,get,15,11,13,2,10,27,4,-2,Kramer,Michael Richards,PER,PER-PER,PROPN,PROPN-PROPN,appos,compound-appos,NNP,NNP-NNP,2,1
0,0.0,28,"""",0,2,20,18,1,7,-2,20,Do n't Let It End,1983,MISC-MISC-MISC-MISC-MISC,TIME,VERB-ADV-VERB-PRON-VERB,NUM,aux-neg-csubj-nsubj-ccomp,nummod,VB-RB-VB-PRP-VB,CD,6,1
1,0.0,28,"""",0,22,27,5,21,0,-22,27,Kilroy Was Here,Styx,MISC-MISC-MISC,ORG,PROPN-VERB-ADV,PROPN,nsubj-ROOT-advmod,pobj,NNP-VBD-RB,NNP,2,1
0,0.0,23,was,7,1,4,3,0,18,6,-3,Alexander Markey,1891,PER-PER,TIME,PROPN-PROPN,NUM,compound-nsubj,nummod,NNP-NNP,CD,2,1
1,0.0,23,was,7,1,6,5,0,16,6,-1,Alexander Markey,1958,PER-PER,TIME,PROPN-PROPN,NUM,compound-nsubj,nummod,NNP-NNP,CD,2,1
2,0.0,23,was,7,1,10,9,0,12,6,3,Alexander Markey,American,PER-PER,LOC,PROPN-PROPN,ADJ,compound-nsubj,amod,NNP-NNP,JJ,2,1
3,5.0,40,described,4,18,30,12,17,9,-14,26,Hei Tiki,1935,MISC-MISC,TIME,PROPN-PROPN,NUM,compound-pobj,pobj,NNP-NNP,CD,7,1
4,10.0,19,says,9,8,2,-6,7,16,1,-7,Hei Tiki,1935,MISC-MISC,TIME,PROPN-PROPN,NUM,compound-pobj,nummod,NNP-NNP,CD,5,1
0,2.0,45,is,15,11,7,-4,10,37,4,-8,Gateway Region,New Jersey,LOC-LOC,LOC-LOC,PROPN-PROPN,PROPN-PROPN,compound-conj,compound-pobj,NNP-NNP,NNP-NNP,1,1
0,0.0,16,is,3,1,11,10,0,4,2,8,Humphrey the Bear,Walt Disney,PER-PER-PER,ORG-ORG,PROPN-DET-PROPN,PROPN-PROPN,nsubj-det-dobj,compound-compound,NNP-DT-NNP,NNP-NNP,8,1
1,4.0,64,were,38,40,14,-26,39,49,-2,-24,Mickey Mouse,Disney,PER-PER,ORG,PROPN-PROPN,PROPN,compound-attr,compound,NNP-NNP,NNP,5,1
0,0.0,24,Macdonald,1,1,4,3,0,19,0,3,Peter Macdonald,"August 14 , 1835",PER-PER,TIME-TIME-TIME-TIME,PROPN-PROPN,PROPN-NUM-PUNCT-NUM,compound-ROOT,appos-nummod-punct-nummod,NNP-NNP,"NNP-CD-,-CD",2,1
1,0.0,24,Macdonald,1,1,9,8,0,14,0,8,Peter Macdonald,"March 24 , 1923",PER-PER,TIME-TIME-TIME-TIME,PROPN-PROPN,PROPN-NUM-PUNCT-NUM,compound-ROOT,nsubj-nummod-punct-nummod,NNP-NNP,"NNP-CD-,-CD",2,1
2,0.0,24,Macdonald,1,1,23,22,0,0,0,22,Peter Macdonald,Canada,PER-PER,LOC,PROPN-PROPN,PROPN,compound-ROOT,appos,NNP-NNP,NNP,2,1
3,0.0,24,Macdonald,1,21,23,2,20,0,-20,22,Ontario,Canada,LOC,LOC,PROPN,PROPN,pobj,appos,NNP,NNP,5,1
4,2.0,39,came,21,5,8,3,4,30,16,-13,Pictou County,Nova Scotia,LOC-LOC,LOC-LOC,PROPN-PROPN,PROPN-PROPN,compound-pobj,compound-conj,NNP-NNP,NNP-NNP,1,1
5,2.0,39,came,21,24,27,3,23,11,-3,6,Huron County,Canada,LOC-LOC,LOC,PROPN-PROPN,PROPN,compound-pobj,compound,NNP-NNP,NNP,1,1
0,0.0,28,is,2,1,1,0,0,26,1,-1,Google Sheets,Google Drive,MISC-MISC,MISC-MISC,PROPN-PROPN,PROPN-PROPN,compound-nsubj,compound-compound,NNP-NNP,NNP-NNP,0,1
1,3.0,10,is,2,6,7,1,5,2,-4,5,Microsoft,Excel,ORG,MISC,PROPN,PROPN,compound,compound,NNP,NNP,2,1
0,0.0,40,France,2,1,11,10,0,28,1,9,Diane de France,25 July 1538,PER-PER-PER,TIME-TIME-TIME,PROPN-ADP-PROPN,NUM-PROPN-NUM,compound-nmod-ROOT,nummod-nsubj-nummod,NNP-IN-NNP,CD-NNP-CD,3,1
1,0.0,40,France,2,1,27,26,0,12,1,25,Diane de France,Henry II,PER-PER-PER,PER-PER,PROPN-ADP-PROPN,PROPN-PROPN,compound-nmod-ROOT,compound-pobj,NNP-IN-NNP,NNP-NNP,5,1
2,0.0,40,France,2,1,38,37,0,1,1,36,Diane de France,Filippa Duci,PER-PER-PER,PER-PER,PROPN-ADP-PROPN,PROPN-PROPN,compound-nmod-ROOT,compound-appos,NNP-IN-NNP,NNP-NNP,4,1
3,0.0,40,France,2,27,3,-24,26,36,-25,1,Henry II,France,PER-PER,LOC,PROPN-PROPN,PROPN,compound-pobj,pobj,NNP-NNP,NNP,5,1
4,4.0,24,was,4,19,23,4,18,0,-15,19,Anne,France,PER,LOC,PROPN,PROPN,pobj,pobj,NNP,NNP,5,1
5,6.0,29,became,1,6,11,5,5,17,-5,10,Henry III,France,PER-PER,LOC,PROPN-PROPN,PROPN,compound-pobj,pobj,NNP-NNP,NNP,1,1
6,7.0,26,enjoyed,2,10,24,14,9,1,-8,22,Henry IV,Louis XIII,PER-PER,PER-PER,PROPN-PROPN,PROPN-PROPN,compound-pobj,compound-appos,NNP-NNP,NNP-NNP,9,1
7,7.0,26,enjoyed,2,10,15,5,9,10,-8,13,Henry IV,France,PER-PER,LOC,PROPN-PROPN,PROPN,compound-pobj,pobj,NNP-NNP,NNP,5,1
8,7.0,26,enjoyed,2,24,15,-9,23,10,-22,13,Louis XIII,France,PER-PER,LOC,PROPN-PROPN,PROPN,compound-appos,pobj,NNP-NNP,NNP,6,1
0,0.0,21,was,1,1,15,14,0,5,0,14,Adandozan,Benin,PER,LOC,PROPN,PROPN,nsubj,pobj,NNP,NNP,2,1
1,3.0,41,tried,19,14,17,3,13,23,5,-2,Agonglo,Kpengla,PER,PER,PROPN,PROPN,appos,conj,NNP,NNP,10,1
0,0.0,32,constructed,6,2,16,14,1,15,4,10,Connecticut River Walk,United States,LOC-LOC-LOC,LOC-LOC,PROPN-PROPN-PROPN,PROPN-PROPN,compound-compound-nsubjpass,compound-conj,NNP-NNP-NNP,NNP-NNP,6,1
1,0.0,32,constructed,6,12,16,4,11,15,-6,10,Springfield,United States,LOC,LOC-LOC,PROPN,PROPN-PROPN,pobj,compound-conj,NNP,NNP-NNP,3,1
2,0.0,32,constructed,6,14,16,2,13,15,-8,10,Massachusetts,United States,LOC,LOC-LOC,PROPN,PROPN-PROPN,conj,compound-conj,NNP,NNP-NNP,2,1
3,0.0,32,constructed,6,16,23,7,15,8,-10,17,United States,New England,LOC-LOC,LOC-LOC,PROPN-PROPN,PROPN-PROPN,compound-conj,compound-poss,NNP-NNP,NNP-NNP,9,1
0,1.0,25,played,1,1,5,4,0,19,0,4,Smith,Chicago Columbia Giants,PER,ORG-ORG-ORG,PROPN,PROPN-PROPN-PROPN,nsubj,compound-compound-pobj,NNP,NNP-NNP-NNPS,3,1
1,5.0,22,joined,5,19,12,-7,18,9,-14,7,Peoria,Illinois,LOC,LOC,PROPN,PROPN,pobj,appos,NNP,NNP,8,1
2,8.0,14,died,1,1,11,10,0,2,0,10,Smith,Saginaw,PER,LOC,PROPN,PROPN,nsubj,pobj,NNP,NNP,5,1
0,0.0,27,was,2,1,12,11,0,14,1,10,Hadsund Municipality,North Jutland County,LOC-LOC,LOC-LOC-LOC,PROPN-PROPN,PROPN-PROPN-PROPN,compound-nsubj,compound-compound-pobj,NNP-NNP,NNP-NNP-NNP,5,1
1,0.0,27,was,2,1,21,20,0,5,1,19,Hadsund Municipality,Denmark,LOC-LOC,LOC,PROPN-PROPN,PROPN,compound-nsubj,pobj,NNP-NNP,NNP,3,1
2,0.0,27,was,2,12,21,9,11,5,-10,19,North Jutland County,Denmark,LOC-LOC-LOC,LOC,PROPN-PROPN-PROPN,PROPN,compound-compound-pobj,pobj,NNP-NNP-NNP,NNP,4,1
3,0.0,27,was,2,13,21,8,12,5,-11,19,Jutland,Denmark,LOC,LOC,PROPN,PROPN,compound,pobj,NNP,NNP,3,1
4,5.0,26,merged,2,6,24,18,5,1,-4,22,Arden,Mariagerfjord Municipality,LOC,LOC-LOC,PROPN,PROPN-PROPN,nmod,compound-dobj,NNP,NNP-NNP,7,1
5,5.0,26,merged,2,8,24,16,7,1,-6,22,Hobro,Mariagerfjord Municipality,LOC,LOC-LOC,PROPN,PROPN-PROPN,conj,compound-dobj,NNP,NNP-NNP,5,1
0,0.0,47,Monkkonen,2,10,13,3,9,33,-8,11,Kansas City,Missouri,LOC-LOC,LOC,PROPN-PROPN,PROPN,compound-pobj,compound,NNP-NNP,NNP,2,1
0,8.0,18,become,4,14,9,-5,13,8,-10,5,The Disquieting Muses,Sylvia Plath,MISC-MISC-MISC,PER-PER,DET-PROPN-PROPN,PROPN-PROPN,det-compound-appos,compound-poss,DT-NNP-NNPS,NNP-NNP,3,1
0,1.0,24,marched,18,4,9,5,3,14,14,-9,Battle of Lake Trasimene,Italy,MISC-MISC-MISC-MISC,LOC,PROPN-ADP-PROPN-PROPN,PROPN,dobj-prep-compound-pobj,pobj,NNP-IN-NNP-NNP,NNP,3,1
0,0.0,23,is,4,15,10,-5,14,12,-11,6,Newport,the U.S.,LOC,LOC-LOC,PROPN,DET-PROPN,pobj,det-compound,NNP,DT-NNP,4,1
1,0.0,23,is,4,10,22,12,9,0,-6,18,the U.S.,Oregon,LOC-LOC,LOC,DET-PROPN,PROPN,det-compound,pobj,DT-NNP,NNP,6,1
0,0.0,33,was,24,1,8,7,0,24,23,-16,Ida Mett,20 July 1901,PER-PER,TIME-TIME-TIME,PROPN-PROPN,NUM-PROPN-NUM,compound-nsubj,nummod-appos-nummod,NNP-NNP,CD-NNP-CD,2,1
1,0.0,33,was,24,1,12,11,0,20,23,-12,Ida Mett,Smarhoń,PER-PER,LOC,PROPN-PROPN,PROPN,compound-nsubj,pobj,NNP-NNP,NNP,4,1
2,0.0,33,was,24,21,23,2,20,9,3,-1,Paris,France,LOC,LOC,PROPN,PROPN,pobj,appos,NNP,NNP,4,1
0,0.0,10,Olajos,1,1,5,4,0,4,0,4,Péter Olajos,18 April 1968,PER-PER,TIME-TIME-TIME,PROPN-PROPN,NUM-PROPN-NUM,compound-ROOT,nummod-npadvmod-nummod,NNP-NNP,CD-NNP-CD,2,1
1,0.0,10,Olajos,1,1,9,8,0,0,0,8,Péter Olajos,Budapest,PER-PER,LOC,PROPN-PROPN,PROPN,compound-ROOT,pobj,NNP-NNP,NNP,1,1
0,0.0,24,is,10,1,5,4,0,18,9,-5,Vasiliev Nini,1954,PER-PER,TIME,PROPN-PROPN,NUM,compound-nsubj,npadvmod,NNP-NNP,CD,2,1
1,0.0,24,is,10,1,7,6,0,16,9,-3,Vasiliev Nini,Gjirokastra,PER-PER,LOC,PROPN-PROPN,PROPN,compound-nsubj,pobj,NNP-NNP,NNP,4,1
2,1.0,23,graduated,4,20,22,2,19,0,-16,18,Tirana,Albania,LOC,LOC,PROPN,PROPN,pobj,appos,NNP,NNP,6,1
0,0.0,31,was,7,1,4,3,0,26,6,-3,Konstantin Dejanović,1365,PER-PER,TIME,PROPN-PROPN,NUM,compound-nsubj,npadvmod,NNP-NNP,CD,4,1
1,0.0,31,was,7,19,21,2,18,9,-12,14,Macedonia,Ottoman,LOC,LOC,PROPN,PROPN,pobj,compound,NNP,NNP,1,1
2,1.0,31,succeeded,1,17,21,4,16,9,-16,20,Battle of Maritsa,1371,MISC-MISC-MISC,TIME,PROPN-ADP-PROPN,NUM,pobj-prep-pobj,appos,NNP-IN-NNP,CD,2,1
3,4.0,29,fell,1,5,9,4,4,19,-4,8,Battle of Rovine,17 May 1395,MISC-MISC-MISC,TIME-TIME-TIME,PROPN-ADP-PROPN,NUM-PROPN-NUM,pobj-prep-pobj,nummod-appos-nummod,NNP-IN-NNP,CD-NNP-CD,4,1
0,0.0,28,is,11,17,21,4,16,6,-6,10,North Bethlehem Township,Washington County,LOC-LOC-LOC,LOC-LOC,PROPN-PROPN-PROPN,PROPN-PROPN,compound-compound-pobj,compound-pobj,NNP-NNP-NNP,NNP-NNP,3,1
1,0.0,28,is,11,17,26,9,16,1,-6,15,North Bethlehem Township,United States,LOC-LOC-LOC,LOC-LOC,PROPN-PROPN-PROPN,PROPN-PROPN,compound-compound-pobj,compound-appos,NNP-NNP-NNP,NNP-NNP,5,1
2,0.0,28,is,11,21,24,3,20,3,-10,13,Washington County,Pennsylvania,LOC-LOC,LOC,PROPN-PROPN,PROPN,compound-pobj,conj,NNP-NNP,NNP,2,1
3,0.0,28,is,11,21,26,5,20,1,-10,15,Washington County,United States,LOC-LOC,LOC-LOC,PROPN-PROPN,PROPN-PROPN,compound-pobj,compound-appos,NNP-NNP,NNP-NNP,2,1
4,0.0,28,is,11,24,26,2,23,1,-13,15,Pennsylvania,United States,LOC,LOC-LOC,PROPN,PROPN-PROPN,conj,compound-appos,NNP,NNP-NNP,2,1
5,4.0,32,was,1,31,3,-28,30,28,-30,2,Ohio,the U.S.,LOC,LOC-LOC,PROPN,DET-PROPN,pobj,det-pobj,NNP,DT-NNP,4,1
6,4.0,32,was,1,3,29,26,2,2,-2,28,the U.S.,Maryland,LOC-LOC,LOC,DET-PROPN,PROPN,det-pobj,pobj,DT-NNP,NNP,5,1
0,0.0,14,was,1,1,11,10,0,2,0,10,Humber,Ontario,LOC,LOC,PROPN,PROPN,nsubj,pobj,NNP,NNP,5,1
1,0.0,14,was,1,1,13,12,0,0,0,12,Humber,Canada,LOC,LOC,PROPN,PROPN,nsubj,appos,NNP,NNP,1,1
2,0.0,14,was,1,11,13,2,10,0,-10,12,Ontario,Canada,LOC,LOC,PROPN,PROPN,pobj,appos,NNP,NNP,6,1
0,0.0,19,is,3,6,18,12,5,0,-3,15,Swedish,Europe,LOC,LOC,ADJ,PROPN,amod,pobj,JJ,NNP,5,1
1,3.0,8,has,1,5,7,2,4,0,-4,6,Stockholm,Sweden,LOC,LOC,PROPN,PROPN,pobj,appos,NNP,NNP,5,1
0,0.0,18,is,7,14,16,2,13,1,-7,9,Nedlands,Western Australia,LOC,LOC-LOC,PROPN,PROPN-PROPN,pobj,compound-appos,NNP,NNP-NNP,2,1
0,0.0,21,"""",0,2,16,14,1,4,-2,16,Coming Down Again,1973,MISC-MISC-MISC,TIME,VERB-PART-ADV,NUM,csubj-advmod-advmod,nummod,VBG-RP-RB,CD,7,1
1,0.0,21,"""",0,2,18,16,1,2,-2,18,Coming Down Again,Goats Head Soup,MISC-MISC-MISC,MISC-MISC-MISC,VERB-PART-ADV,PROPN-PROPN-PROPN,csubj-advmod-advmod,compound-compound-appos,VBG-RP-RB,NNP-NNP-NNP,7,1
2,4.0,22,opens,2,20,5,-15,19,16,-18,3,Mick Taylor,Stones,PER-PER,ORG,PROPN-PROPN,PROPN,compound-pobj,compound,NNP-NNP,NNPS,8,1
3,4.0,22,opens,2,5,8,3,4,13,-3,6,Stones,Nicky Hopkins,ORG,PER-PER,PROPN,PROPN-PROPN,compound,compound-nsubj,NNPS,NNP-NNP,2,1
0,2.0,22,were,4,12,6,-6,11,15,-8,2,U.S.,Franklin D. Roosevelt,LOC,PER-PER-PER,PROPN,PROPN-PROPN-PROPN,compound,compound-compound-attr,NNP,NNP-NNP-NNP,3,1
1,2.0,22,were,4,16,21,5,15,0,-12,17,Thomas Watson,IBM,PER-PER,ORG,PROPN-PROPN,PROPN,compound-conj,pobj,NNP-NNP,NNP,3,1
0,8.0,26,created,6,9,14,5,8,11,-3,8,Robert A. Rescorla,University of Pennsylvania,PER-PER-PER,ORG-ORG-ORG,PROPN-PROPN-PROPN,PROPN-ADP-PROPN,compound-compound-pobj,pobj-prep-pobj,NNP-NNP-NNP,NNP-IN-NNP,4,1
1,8.0,26,created,6,18,22,4,17,3,-12,16,Allan R. Wagner,Yale University,PER-PER-PER,ORG-ORG,PROPN-PROPN-PROPN,PROPN-PROPN,compound-compound-conj,compound-pobj,NNP-NNP-NNP,NNP-NNP,3,1
0,0.0,21,"""",0,2,16,14,1,4,-2,16,Fall Dog Bombs the Moon,2003,MISC-MISC-MISC-MISC-MISC,TIME,VERB-PROPN-PROPN-DET-PROPN,NUM,compound-compound-nsubj-det-appos,pobj,VB-NNP-NNP-DT-NNP,CD,4,1
1,0.0,21,"""",0,2,20,18,1,0,-2,20,Fall Dog Bombs the Moon,Reality,MISC-MISC-MISC-MISC-MISC,MISC,VERB-PROPN-PROPN-DET-PROPN,NOUN,compound-compound-nsubj-det-appos,appos,VB-NNP-NNP-DT-NNP,NN,2,1
2,1.0,39,came,14,21,34,13,20,4,-7,20,Kellogg Brown & Root,Dick Cheney,ORG-ORG-ORG-ORG,PER-PER,PROPN-PROPN-CCONJ-PROPN,PROPN-PROPN,compound-pobj-cc-conj,compound-nsubj,NNP-NNP-CC-NNP,NNP-NNP,6,1
3,11.0,60,concludes,1,43,48,5,42,11,-42,47,Fantastic Voyage,Loving the Alien,MISC-MISC,MISC-MISC-MISC,ADJ-NOUN,VERB-DET-PROPN,compound-pobj,advcl-det-dobj,JJ-NN,VBG-DT-NNP,7,1
4,11.0,60,concludes,1,43,38,-5,42,21,-42,37,Fantastic Voyage,Bowie,MISC-MISC,PER,ADJ-NOUN,PROPN,compound-pobj,poss,JJ-NN,NNP,4,1
5,11.0,60,concludes,1,48,54,6,47,5,-47,53,Loving the Alien,I 'm Afraid of Americans,MISC-MISC-MISC,MISC-MISC-MISC-MISC-MISC,VERB-DET-PROPN,PRON-VERB-ADJ-ADP-PROPN,advcl-det-dobj,nsubj-conj-attr-prep-pobj,VBG-DT-NNP,PRP-VBP-JJ-IN-NNPS,4,1
6,11.0,60,concludes,1,48,38,-10,47,21,-47,37,Loving the Alien,Bowie,MISC-MISC-MISC,PER,VERB-DET-PROPN,PROPN,advcl-det-dobj,poss,VBG-DT-NNP,NNP,7,1
0,9.0,22,follows,1,3,16,13,2,5,-2,15,Rhine McLin,Democratic,PER-PER,ORG,PROPN-PROPN,ADJ,compound-dobj,amod,NNP-NNP,JJ,4,1
0,0.0,19,was,7,1,4,3,0,14,6,-3,Pierre Richardot,c.1575,PER-PER,TIME,PROPN-PROPN,PROPN,compound-nsubj,compound,NNP-NNP,NNP,2,1
1,6.0,32,made,7,24,28,4,23,3,-17,21,Flores epitaphii sanctorum,Luxembourg,MISC-MISC-MISC,LOC,NOUN-ADJ-NOUN,PROPN,compound-compound-pobj,appos,NNS-JJ-NN,NNP,3,1
0,0.0,23,is,1,1,11,10,0,11,0,10,Newmarket,Suffolk,LOC,LOC,PROPN,PROPN,nsubj,pobj,NNP,NNP,2,1
0,0.0,35,is,8,1,5,4,0,29,7,-3,Wouter Basson,6 July 1950,PER-PER,TIME-TIME-TIME,PROPN-PROPN,NUM-PROPN-NUM,compound-nsubj,nummod-npadvmod-nummod,NNP-NNP,CD-NNP-CD,2,1
1,0.0,35,is,8,1,11,10,0,23,7,3,Wouter Basson,South African,PER-PER,LOC-LOC,PROPN-PROPN,ADJ-ADJ,compound-nsubj,amod-amod,NNP-NNP,JJ-JJ,3,1
0,0.0,30,is,1,1,13,12,0,16,0,12,Overwatch,Blizzard Entertainment,MISC,ORG-ORG,NOUN,PROPN-PROPN,nsubj,compound-pobj,NN,NNP-NNP,4,1
1,0.0,30,is,1,1,25,24,0,4,0,24,Overwatch,Xbox One,MISC,MISC-MISC,NOUN,PROPN-PROPN,nsubj,conj-nummod,NN,NNP-NNP,1,1
2,0.0,30,is,1,1,28,27,0,1,0,27,Overwatch,June 2016,MISC,TIME-TIME,NOUN,PROPN-NUM,nsubj,pobj-nummod,NN,NNP-CD,4,1
3,4.0,29,started,4,26,10,-16,25,18,-22,6,Titan,Blizzard,MISC,ORG,PROPN,PROPN,appos,poss,NNP,NNP,4,1
0,1.0,30,intended,2,24,28,4,23,1,-22,26,Lancaster,United States,LOC,LOC-LOC,PROPN,PROPN-PROPN,pobj,compound-conj,NNP,NNP-NNP,3,1
0,0.0,25,is,2,1,14,13,0,10,1,12,Echo Summit,United States,LOC-LOC,LOC-LOC,PROPN-PROPN,PROPN-PROPN,compound-nsubj,compound-pobj,NNP-NNP,NNP-NNP,4,1
1,0.0,25,is,2,9,14,5,8,10,-7,12,Sierra Nevada,United States,LOC-LOC,LOC-LOC,PROPN-PROPN,PROPN-PROPN,compound-pobj,compound-pobj,NNP-NNP,NNP-NNP,4,1
2,0.0,25,is,2,9,24,15,8,0,-7,22,Sierra Nevada,California,LOC-LOC,LOC,PROPN-PROPN,PROPN,compound-pobj,appos,NNP-NNP,NNP,4,1
3,0.0,25,is,2,20,24,4,19,0,-18,22,El Dorado County,California,LOC-LOC-LOC,LOC,PROPN-PROPN-PROPN,PROPN,compound-compound-pobj,appos,NNP-NNP-NNP,NNP,8,1
4,2.0,37,routed,29,18,10,-8,17,26,11,-19,Lincoln Highway,the United States,LOC-LOC,LOC-LOC-LOC,PROPN-PROPN,DET-PROPN-PROPN,compound-pobj,det-compound-pobj,NNP-NNP,DT-NNP-NNP,3,1
5,2.0,37,routed,29,33,10,-23,32,26,-4,-19,Johnson Pass,the United States,LOC-LOC,LOC-LOC-LOC,PROPN-PROPN,DET-PROPN-PROPN,compound-pobj,det-compound-pobj,NNP-NNP,DT-NNP-NNP,5,1
0,0.0,16,is,3,1,11,10,0,4,2,8,Wade High School,New South Wales,ORG-ORG-ORG,LOC-LOC-LOC,PROPN-PROPN-PROPN,PROPN-PROPN-PROPN,compound-compound-nsubj,compound-compound-conj,NNP-NNP-NNP,NNP-NNP-NNP,7,1
1,0.0,16,is,3,1,15,14,0,0,2,12,Wade High School,Australia,ORG-ORG-ORG,LOC,PROPN-PROPN-PROPN,PROPN,compound-compound-nsubj,npadvmod,NNP-NNP-NNP,NNP,3,1
2,0.0,16,is,3,9,11,2,8,4,-6,8,Griffith,New South Wales,LOC,LOC-LOC-LOC,PROPN,PROPN-PROPN-PROPN,pobj,compound-compound-conj,NNP,NNP-NNP-NNP,3,1
3,0.0,16,is,3,9,15,6,8,0,-6,12,Griffith,Australia,LOC,LOC,PROPN,PROPN,pobj,npadvmod,NNP,NNP,5,1
4,0.0,16,is,3,11,15,4,10,0,-8,12,New South Wales,Australia,LOC-LOC-LOC,LOC,PROPN-PROPN-PROPN,PROPN,compound-compound-conj,npadvmod,NNP-NNP-NNP,NNP,6,1
5,1.0,14,established,4,1,7,6,0,6,3,3,Wade High School,1971,ORG-ORG-ORG,TIME,PROPN-PROPN-PROPN,NUM,compound-compound-nsubjpass,pobj,NNP-NNP-NNP,CD,3,1
0,0.0,30,"""",0,2,12,10,1,17,-2,12,Mighty Wings,Cheap Trick,MISC-MISC,ORG-ORG,PROPN-NOUN,PROPN-PROPN,compound-nsubj,compound-pobj,NNP-NNS,NNP-NNP,4,1
1,0.0,30,"""",0,2,17,15,1,12,-2,17,Mighty Wings,1986,MISC-MISC,TIME,PROPN-NOUN,NUM,compound-nsubj,pobj,NNP-NNS,CD,3,1
0,3.0,46,are,20,12,31,19,11,14,8,11,Montenegro,United Nations,LOC,ORG-ORG,PROPN,PROPN-PROPN,poss,compound-pobj,NNP,NNP-NNP,6,1
1,3.0,46,are,20,12,45,33,11,0,8,25,Montenegro,NATO,LOC,ORG,PROPN,PROPN,poss,pobj,NNP,NNP,5,1
2,4.0,26,gave,1,1,19,18,0,6,0,18,Russia,United Nations Security Council,LOC,ORG-ORG-ORG-ORG,PROPN,PROPN-PROPN-PROPN-PROPN,nsubj,compound-compound-compound-pobj,NNP,NNP-NNPS-NNP-NNP,5,1
3,7.0,29,recognised,20,13,8,-5,12,20,7,-12,France,United Nations Security Council,LOC,ORG-ORG-ORG-ORG,PROPN,PROPN-PROPN-PROPN-PROPN,conj,compound-compound-compound-pobj,NNP,NNP-NNPS-NNP-NNP,3,1
0,1.0,27,took,2,2,8,6,1,18,0,6,Classic,Rambler Six,MISC,MISC-MISC,PROPN,PROPN-PROPN,nsubj,compound-nmod,NNP,NNP-NNP,4,1
0,1.0,38,created,2,12,16,4,11,21,-10,14,Smack the Pony,Channel 4,MISC-MISC-MISC,MISC-MISC,PROPN-DET-PROPN,PROPN-NUM,nsubj-det-nmod,nmod-nummod,NNP-DT-NNP,NNP-CD,3,1
1,1.0,38,created,2,12,23,11,11,14,-10,21,Smack the Pony,Victoria Pile,MISC-MISC-MISC,PER-PER,PROPN-DET-PROPN,PROPN-PROPN,nsubj-det-nmod,compound-pobj,NNP-DT-NNP,NNP-NNP,5,1
0,0.0,45,is,29,23,42,19,22,2,6,13,Autonomous Operator of Parisian Transports,Paris,ORG-ORG-ORG-ORG-ORG,LOC,PROPN-PROPN-ADP-PROPN-PROPN,PROPN,compound-appos-prep-compound-pobj,pobj,NNP-NNP-IN-NNP-NNPS,NNP,10,1
1,0.0,45,is,29,23,44,21,22,0,6,15,Autonomous Operator of Parisian Transports,France,ORG-ORG-ORG-ORG-ORG,LOC,PROPN-PROPN-ADP-PROPN-PROPN,PROPN,compound-appos-prep-compound-pobj,appos,NNP-NNP-IN-NNP-NNPS,NNP,6,1
2,0.0,45,is,29,42,44,2,41,0,-13,15,Paris,France,LOC,LOC,PROPN,PROPN,pobj,appos,NNP,NNP,6,1
3,2.0,26,represents,2,16,11,-5,15,14,-14,9,Paris,Seine,LOC,LOC,PROPN,PROPN,compound,poss,NNP,NNP,4,1
4,3.0,47,is,3,14,14,0,13,32,-11,11,Paris Métro,Paris,ORG-ORG,LOC,PROPN-PROPN,PROPN,compound-pobj,pobj,NNP-NNP,NNP,0,1
0,0.0,60,is,6,3,21,18,2,38,3,15,Katyn massacre,1940,MISC-MISC,TIME,PROPN-NOUN,NUM,compound-pobj,nummod,NNP-NN,CD,8,1
1,0.0,60,is,6,32,47,15,31,12,-26,41,NKVD,Russian,ORG,ORG,PROPN,ADJ,pobj,amod,NNP,JJ,10,1
2,3.0,53,summarized,4,3,1,-2,2,51,1,-3,Andrzej Nowak,Polish,PER-PER,LOC,PROPN-PROPN,ADJ,compound-nsubj,amod,NNP-NNP,JJ,1,1
0,0.0,16,is,2,1,13,12,0,2,1,11,Collins Street,Victoria,LOC-LOC,LOC,PROPN-PROPN,PROPN,compound-nsubj,conj,NNP-NNP,NNP,8,1
1,0.0,16,is,2,1,15,14,0,0,1,13,Collins Street,Australia,LOC-LOC,LOC,PROPN-PROPN,PROPN,compound-nsubj,pobj,NNP-NNP,NNP,2,1
2,0.0,16,is,2,11,13,2,10,2,-9,11,Melbourne,Victoria,LOC,LOC,PROPN,PROPN,pobj,conj,NNP,NNP,3,1
3,0.0,16,is,2,11,15,4,10,0,-9,13,Melbourne,Australia,LOC,LOC,PROPN,PROPN,pobj,pobj,NNP,NNP,7,1
4,0.0,16,is,2,13,15,2,12,0,-11,13,Victoria,Australia,LOC,LOC,PROPN,PROPN,conj,pobj,NNP,NNP,8,1
0,0.0,22,is,10,1,16,15,0,5,9,6,Florian Skilang Temengil,Newman University,PER-PER-PER,ORG-ORG,PROPN-PROPN-PROPN,PROPN-PROPN,amod-compound-nsubj,compound-pobj,NNP-NNP-NNP,NNP-NNP,5,1
1,0.0,22,is,10,16,21,5,15,0,-6,11,Newman University,Kansas,ORG-ORG,LOC,PROPN-PROPN,PROPN,compound-pobj,appos,NNP-NNP,NNP,4,1
2,1.0,16,competed,1,1,5,4,0,10,0,4,Skilang,2008 Summer Olympics,PER,MISC-MISC-MISC,PROPN,NUM-PROPN-PROPN,nsubj,nummod-compound-pobj,NNP,CD-NNP-NNPS,3,1
3,1.0,16,competed,1,5,9,4,4,6,-4,8,2008 Summer Olympics,Beijing,MISC-MISC-MISC,LOC,NUM-PROPN-PROPN,PROPN,nummod-compound-pobj,pobj,CD-NNP-NNPS,NNP,2,1
4,1.0,16,competed,1,9,11,2,8,4,-8,10,Beijing,China,LOC,LOC,PROPN,PROPN,pobj,npadvmod,NNP,NNP,3,1
5,4.0,19,competed,1,7,11,4,6,7,-6,10,2016 Summer Olympics,Rio de Janeiro,MISC-MISC-MISC,LOC-LOC-LOC,NUM-PROPN-PROPN,PROPN-PROPN-PROPN,nummod-compound-pobj,compound-compound-pobj,CD-NNP-NNPS,NNP-NNP-NNP,4,1
0,0.0,26,was,8,1,7,6,0,18,7,-1,Guy,d.1075,PER,TIME,PROPN,NOUN,nsubj,appos,NNP,NN,2,1
1,0.0,26,was,8,5,25,20,4,0,3,17,Amiens,France,LOC,LOC,PROPN,PROPN,pobj,pobj,NNP,NNP,3,1
2,2.0,64,II,2,10,2,-8,9,61,-8,0,Hugh II,Enguerrand II,PER-PER,PER-PER,PROPN-PROPN,PROPN-PROPN,compound-appos,compound-ROOT,NNP-NNP,NNP-NNP,-1,1
0,10.0,23,created,6,17,21,4,16,1,-11,15,Oric,Tansoft,ORG,ORG,PROPN,PROPN,compound,npadvmod,NNP,NNP,5,1
1,10.0,23,created,6,9,11,2,8,11,-3,5,Orpheus,Paul Kaufman,ORG,PER-PER,PROPN,PROPN-PROPN,compound,compound-pobj,NNP,NNP-NNP,1,1
2,12.0,27,licensed,7,1,18,17,0,8,6,11,The Young Ones,Ben Elton,MISC-MISC-MISC,PER-PER,DET-PROPN-PROPN,PROPN-PROPN,det-compound-pobj,compound-appos,DT-NNP-NNPS,NNP-NNP,2,1
3,12.0,27,licensed,7,1,21,20,0,5,6,14,The Young Ones,Rik Mayall,MISC-MISC-MISC,PER-PER,DET-PROPN-PROPN,PROPN-PROPN,det-compound-pobj,compound-conj,DT-NNP-NNPS,NNP-NNP,3,1
0,0.0,25,is,5,2,17,15,1,7,3,12,Central Line,Sweden,LOC-LOC,LOC,PROPN-PROPN,PROPN,compound-nsubj,pobj,NNP-NNP,NNP,5,1
1,0.0,25,is,5,14,17,3,13,7,-9,12,Storlien,Sweden,LOC,LOC,PROPN,PROPN,conj,pobj,NNP,NNP,2,1
2,0.0,25,is,5,17,19,2,16,5,-12,14,Sweden,Västernorrland County,LOC,LOC-LOC,PROPN,PROPN-PROPN,pobj,compound-appos,NNP,NNP-NNP,2,1
3,0.0,25,is,5,17,22,5,16,2,-12,17,Sweden,Jämtland County,LOC,LOC-LOC,PROPN,PROPN-PROPN,pobj,compound-conj,NNP,NNP-NNP,3,1
4,1.0,17,continues,1,6,9,3,5,7,-5,8,Meråker Line,Norway,LOC-LOC,LOC,PROPN-NOUN,PROPN,compound-pobj,pobj,NNP-NN,NNP,1,1
0,0.0,17,was,9,1,4,3,0,12,8,-5,Konstantin Belikov,1909,PER-PER,TIME,PROPN-PROPN,NUM,compound-compound,nummod,NNP-NNP,CD,3,1
1,0.0,17,was,9,1,12,11,0,4,8,3,Konstantin Belikov,Soviet,PER-PER,LOC,PROPN-PROPN,ADJ,compound-compound,amod,NNP-NNP,JJ,4,1
2,2.0,6,born,2,1,5,4,0,0,1,3,Belikov,Zuyevo,PER,LOC,PROPN,PROPN,nsubjpass,pobj,NNP,NNP,2,1
3,7.0,38,went,7,6,17,11,5,20,1,10,Konstantin Belikov,Battle of Stalingrad,PER-PER,MISC-MISC-MISC,PROPN-PROPN,PROPN-ADP-PROPN,compound-pobj,pobj-prep-pobj,NNP-NNP,NNP-IN-NNP,6,1
4,7.0,38,went,7,3,17,14,2,20,4,10,Great Patriotic War,Battle of Stalingrad,MISC-MISC-MISC,MISC-MISC-MISC,PROPN-PROPN-PROPN,PROPN-ADP-PROPN,compound-compound-compound,pobj-prep-pobj,NNP-NNP-NNP,NNP-IN-NNP,9,1
0,2.0,34,gather,1,29,33,4,28,0,-28,32,Sky Sports,UK,ORG-ORG,LOC,PROPN-PROPN,PROPN,compound-pobj,pobj,NNP-NNPS,NNP,7,1
0,0.0,34,is,23,11,32,21,10,1,12,9,National Thought,South Korea,ORG-ORG,LOC-LOC,PROPN-PROPN,PROPN-PROPN,compound-appos,compound-pobj,NNP-NNP,NNP-NNP,6,1
0,0.0,24,is,19,16,18,2,15,5,3,-1,Paris,France,LOC,LOC,PROPN,PROPN,pobj,appos,NNP,NNP,4,1
0,0.0,14,is,1,6,13,7,5,0,-5,12,Rejang Lebong,Indonesia,LOC-LOC,LOC,PROPN-PROPN,PROPN,compound-compound,pobj,NNP-NNP,NNP,5,1
1,0.0,14,is,1,10,13,3,9,0,-9,12,Bengkulu,Indonesia,LOC,LOC,PROPN,PROPN,compound,pobj,NNP,NNP,5,1
0,0.0,21,is,3,9,12,3,8,8,-6,9,U.S.,Ohio,LOC,LOC,PROPN,PROPN,compound,pobj,NNP,NNP,1,1
1,6.0,26,is,2,16,22,6,15,3,-14,20,Middle Sister Island,Ontario,LOC-LOC-LOC,LOC,PROPN-PROPN-PROPN,PROPN,compound-compound-conj,pobj,NNP-NNP-NNP,NNP,6,1
2,6.0,26,is,2,16,24,8,15,1,-14,22,Middle Sister Island,Canada,LOC-LOC-LOC,LOC,PROPN-PROPN-PROPN,PROPN,compound-compound-conj,appos,NNP-NNP-NNP,NNP,3,1
3,6.0,26,is,2,22,24,2,21,1,-20,22,Ontario,Canada,LOC,LOC,PROPN,PROPN,pobj,appos,NNP,NNP,5,1
0,0.0,38,Gęsicka,1,1,4,3,0,33,0,3,Grażyna Gęsicka,13 December 1951,PER-PER,TIME-TIME-TIME,PROPN-PROPN,NUM-PROPN-NUM,compound-ROOT,nummod-appos-nummod,NNP-NNP,CD-NNP-CD,1,1
1,0.0,38,Gęsicka,1,14,31,17,13,6,-13,30,Polish,Marcinkiewicz,LOC,PER,ADJ,PROPN,amod,pobj,JJ,NNP,4,1
2,0.0,38,Gęsicka,1,14,34,20,13,3,-13,33,Polish,Jarosław Kaczyński,LOC,PER-PER,ADJ,PROPN-PROPN,amod,compound-poss,JJ,NNP-NNP,4,1
3,6.0,47,listed,2,22,23,1,21,23,-20,21,Poland,Lech Kaczyński,LOC,PER-PER,PROPN,PROPN-PROPN,compound,compound-pobj,NNP,NNP-NNP,1,1
4,6.0,47,listed,2,33,37,4,32,9,-31,35,Pechersk,Russia,LOC,LOC,PROPN,PROPN,pobj,appos,NNP,NNP,11,1
5,8.0,20,awarded,8,6,11,5,5,8,2,3,Gęsicka,Commander 's Cross of the Order of Polonia Restituta,PER,MISC-MISC-MISC-MISC-MISC-MISC-MISC-MISC-MISC,PROPN,PROPN-PART-PROPN-ADP-DET-NOUN-ADP-PROPN-PROPN,nsubjpass,poss-case-dobj-prep-det-pobj-prep-compound-pobj,NNP,NNP-POS-NNP-IN-DT-NN-IN-NNP-NNP,4,1
0,0.0,15,is,2,1,8,7,0,6,1,6,Caddo Gap,Montgomery County,LOC-LOC,LOC-LOC,PROPN-PROPN,PROPN-PROPN,compound-nsubj,compound-pobj,NNP-NNP,NNP-NNP,4,1
1,0.0,15,is,2,1,11,10,0,3,1,9,Caddo Gap,Arkansas,LOC-LOC,LOC,PROPN-PROPN,PROPN,compound-nsubj,appos,NNP-NNP,NNP,6,1
2,0.0,15,is,2,1,13,12,0,1,1,11,Caddo Gap,United States,LOC-LOC,LOC-LOC,PROPN-PROPN,PROPN-PROPN,compound-nsubj,compound-appos,NNP-NNP,NNP-NNP,6,1
3,0.0,15,is,2,8,11,3,7,3,-6,9,Montgomery County,Arkansas,LOC-LOC,LOC,PROPN-PROPN,PROPN,compound-pobj,appos,NNP-NNP,NNP,2,1
4,0.0,15,is,2,8,13,5,7,1,-6,11,Montgomery County,United States,LOC-LOC,LOC-LOC,PROPN-PROPN,PROPN-PROPN,compound-pobj,compound-appos,NNP-NNP,NNP-NNP,2,1
5,0.0,15,is,2,11,13,2,10,1,-9,11,Arkansas,United States,LOC,LOC-LOC,PROPN,PROPN-PROPN,appos,compound-appos,NNP,NNP-NNP,2,1
0,1.0,34,headquartered,2,5,8,3,4,25,-3,6,Union Station,"Washington , D.C.",LOC-LOC,LOC-LOC-LOC,PROPN-PROPN,PROPN-PUNCT-PROPN,compound-pobj,pobj-punct-appos,NNP-NNP,"NNP-,-NNP",3,1
0,0.0,28,is,11,1,10,9,0,17,10,-1,Oxana Yablonskaya,Moscow,PER-PER,LOC,PROPN-PROPN,PROPN,compound-compound,appos,NNP-NNP,NNP,3,1
0,0.0,16,is,1,1,15,14,0,0,0,14,Animositisomina,2003,MISC,TIME,PROPN,NUM,nsubj,pobj,NNP,CD,1,1
1,3.0,17,is,1,7,15,8,6,1,-6,14,Aoxomoxoa,Grateful Dead,MISC,MISC-MISC,PROPN,PROPN-PROPN,pobj,compound-pobj,NNP,NNP-NNP,5,1
2,6.0,41,"""",0,18,22,4,17,18,-18,22,Real Life,1978,MISC-MISC,TIME,ADJ-PROPN,NUM,compound-compound,pobj,JJ-NNP,CD,5,1
3,8.0,31,is,1,1,10,9,0,20,0,9,Animositisomina,Paul Barker,MISC,PER-PER,PROPN,PROPN-PROPN,nsubj,compound-pobj,NNP,NNP-NNP,6,1
4,9.0,38,is,4,34,12,-22,33,25,-30,8,Houses of the Molé,Ministry,MISC-MISC-MISC-MISC,ORG,PROPN-ADP-DET-PROPN,PROPN,appos-prep-det-pobj,dobj,NNP-IN-DT-NNP,NNP,9,1
0,0.0,36,is,9,2,28,26,1,7,7,19,Christmas ( Baby Please Come Home ),A Christmas Gift for You from Philles Records,MISC-MISC-MISC-MISC-MISC-MISC-MISC,MISC-MISC-MISC-MISC-MISC-MISC-MISC-MISC,PROPN-PUNCT-NOUN-INTJ-VERB-NOUN-PUNCT,DET-PROPN-PROPN-ADP-PRON-ADP-PROPN-PROPN,nsubj-punct-nsubj-intj-parataxis-dobj-punct,det-compound-appos-prep-pobj-prep-compound-pobj,NNP--LRB--NN-UH-VB-NN--RRB-,DT-NNP-NNP-IN-PRP-IN-NNP-NNPS,9,1
0,0.0,31,is,10,23,26,3,22,4,-13,16,Port Macquarie,New South Wales,LOC-LOC,LOC-LOC-LOC,PROPN-PROPN,PROPN-PROPN-PROPN,compound-pobj,compound-compound-conj,NNP-NNP,NNP-NNP-NNP,2,1
1,0.0,31,is,10,23,30,7,22,0,-13,20,Port Macquarie,Australia,LOC-LOC,LOC,PROPN-PROPN,PROPN,compound-pobj,npadvmod,NNP-NNP,NNP,6,1
2,0.0,31,is,10,26,30,4,25,0,-16,20,New South Wales,Australia,LOC-LOC-LOC,LOC,PROPN-PROPN-PROPN,PROPN,compound-compound-conj,npadvmod,NNP-NNP-NNP,NNP,8,1
3,1.0,71,expanded,22,20,3,-17,19,67,2,-19,ARPRA,1986,ORG,TIME,PROPN,NUM,nsubj,pobj,NNP,CD,3,1
0,0.0,24,"""",0,2,21,19,1,2,-2,21,Paper Hearts,X - Files,MISC-MISC,MISC-MISC-MISC,NOUN-PROPN,PROPN-PROPN-PROPN,compound-nsubj,compound-punct-ROOT,NN-NNPS,NNP-NNP-NNP,8,1
1,5.0,35,centers,2,8,11,3,7,23,-6,9,Fox Mulder,David Duchovny,PER-PER,PER-PER,PROPN-PROPN,PROPN-PROPN,compound-appos,compound-appos,NNP-NNP,NNP-NNP,1,1
2,5.0,35,centers,2,15,18,3,14,16,-13,16,Dana Scully,Gillian Anderson,PER-PER,PER-PER,PROPN-PROPN,PROPN-PROPN,compound-appos,compound-appos,NNP-NNP,NNP-NNP,1,1
0,0.0,22,is,6,1,1,0,0,20,5,-5,Bergen Airport,Bergen,LOC-LOC,LOC,PROPN-PROPN,PROPN,compound-nsubj,pobj,NNP-NNP,NNP,0,1
1,0.0,22,is,6,1,21,20,0,0,5,15,Bergen Airport,Norway,LOC-LOC,LOC,PROPN-PROPN,PROPN,compound-nsubj,appos,NNP-NNP,NNP,2,1
2,0.0,22,is,6,1,21,20,0,0,5,15,Bergen,Norway,LOC,LOC,PROPN,PROPN,pobj,appos,NNP,NNP,2,1
3,11.0,18,resumed,3,1,17,16,0,0,2,14,West Norway Airlines,1957,ORG-ORG-ORG,TIME,PROPN-PROPN-PROPN,NUM,compound-compound-nsubj,pobj,NNP-NNP-NNPS,CD,3,1
4,12.0,17,opened,4,1,4,3,0,12,3,0,Bergen Airport,Flesland,LOC-LOC,LOC,PROPN-PROPN,PROPN,compound-nsubj,appos,NNP-NNP,NNP,1,1
0,0.0,22,are,11,14,21,7,13,0,-3,10,Canadian,Manitoba,LOC,LOC,ADJ,PROPN,amod,appos,JJ,NNP,3,1
0,0.0,28,is,9,1,15,14,0,12,8,6,Słupsk,Pomeranian Voivodeship,LOC,LOC-LOC,PROPN,PROPN-PROPN,compound,compound-pobj,NNP,NNP-NNP,5,1
1,0.0,28,is,9,15,20,5,14,7,-6,11,Pomeranian Voivodeship,Poland,LOC-LOC,LOC,PROPN-PROPN,PROPN,compound-pobj,pobj,NNP-NNP,NNP,4,1
0,0.0,36,born,4,1,12,11,0,23,3,8,Sylvester John Hemleben,La Crosse,PER-PER-PER,LOC-LOC,PROPN-PROPN-PROPN,PROPN-PROPN,compound-compound-nsubjpass,compound-pobj,NNP-NNP-NNP,NNP-NNP,4,1
1,0.0,36,born,4,1,27,26,0,8,3,23,Sylvester John Hemleben,America,PER-PER-PER,LOC,PROPN-PROPN-PROPN,PROPN,compound-compound-nsubjpass,pobj,NNP-NNP-NNP,NNP,10,1
2,0.0,36,born,4,12,27,15,11,8,-8,23,La Crosse,America,LOC-LOC,LOC,PROPN-PROPN,PROPN,compound-pobj,pobj,NNP-NNP,NNP,6,1
3,1.0,47,received,1,1,27,26,0,19,0,26,Hemleben,Fordham University,PER,ORG-ORG,PROPN,PROPN-PROPN,nsubj,compound-pobj,NNP,NNP-NNP,7,1
4,1.0,47,received,1,1,14,13,0,32,0,13,Hemleben,University of Mississippi,PER,ORG-ORG-ORG,PROPN,PROPN-ADP-PROPN,nsubj,pobj-prep-pobj,NNP,NNP-IN-NNP,3,1
5,1.0,47,received,1,1,14,13,0,32,0,13,Hemleben,University of Iowa,PER,ORG-ORG-ORG,PROPN,PROPN-ADP-PROPN,nsubj,pobj-prep-pobj,NNP,NNP-IN-NNP,3,1
6,2.0,22,furthered,1,18,21,3,17,0,-17,20,Munich University,Germany,ORG-ORG,LOC,PROPN-PROPN,PROPN,compound-conj,appos,NNP-NNP,NNP,7,1
0,0.0,17,is,1,1,9,8,0,7,0,8,Gauze,Dir En Grey,MISC,ORG-ORG-ORG,PROPN,PROPN-PROPN-PROPN,nsubj,compound-compound-pobj,NNP,NNP-NNP-NNP,5,1
1,2.0,23,produced,3,6,11,5,5,11,-3,8,X Japan,Yoshiki Hayashi,ORG-ORG,PER-PER,PROPN-PROPN,PROPN-PROPN,nmod-nmod,compound-pobj,NNP-NNP,NNP-NNP,2,1
0,0.0,22,is,2,1,10,9,0,11,1,8,Family Affair,CBS,MISC-MISC,ORG,PROPN-PROPN,PROPN,compound-nsubj,pobj,NNP-NNP,NNP,4,1
1,0.0,22,is,2,1,12,11,0,9,1,10,Family Affair,"September 12 , 1966",MISC-MISC,TIME-TIME-TIME-TIME,PROPN-PROPN,PROPN-NUM-PUNCT-NUM,compound-nsubj,pobj-nummod-punct-nummod,NNP-NNP,"NNP-CD-,-CD",6,1
0,0.0,24,Left,1,1,21,20,0,2,0,20,"Turn Left , Turn Right",Taipei,MISC-MISC-MISC-MISC-MISC,LOC,VERB-PROPN-PUNCT-PROPN-PROPN,PROPN,compound-ROOT-punct-compound-appos,pobj,"VB-NNP-,-NNP-NNP",NNP,7,1
1,0.0,24,Left,1,21,23,2,20,0,-20,22,Taipei,Taiwan,LOC,LOC,PROPN,PROPN,pobj,appos,NNP,NNP,6,1
2,2.0,32,based,3,9,16,7,8,15,-6,13,A Chance of Sunshine,Jimmy Liao,MISC-MISC-MISC-MISC,PER-PER,DET-PROPN-ADP-PROPN,PROPN-PROPN,det-appos-prep-pobj,compound-pobj,DT-NNP-IN-NNP,NNP-NNP,2,1
0,0.0,29,is,14,20,25,5,19,3,-6,11,Southeast Fairbanks Census Area,Alaska,LOC-LOC-LOC-LOC,LOC,PROPN-PROPN-PROPN-PROPN,PROPN,compound-compound-compound-pobj,conj,NNP-NNPS-NNP-NNP,NNP,3,1
1,0.0,29,is,14,20,27,7,19,1,-6,13,Southeast Fairbanks Census Area,United States,LOC-LOC-LOC-LOC,LOC-LOC,PROPN-PROPN-PROPN-PROPN,PROPN-PROPN,compound-compound-compound-pobj,compound-conj,NNP-NNPS-NNP-NNP,NNP-NNP,3,1
2,0.0,29,is,14,25,27,2,24,1,-11,13,Alaska,United States,LOC,LOC-LOC,PROPN,PROPN-PROPN,conj,compound-conj,NNP,NNP-NNP,2,1
0,1.0,11,based,3,6,10,4,5,0,-3,7,Cincinnati,USA,LOC,LOC,PROPN,PROPN,pobj,appos,NNP,NNP,4,1
1,1.0,11,based,3,8,10,2,7,0,-5,7,Ohio,USA,LOC,LOC,PROPN,PROPN,appos,appos,NNP,NNP,5,1
0,0.0,48,was,19,2,12,10,1,35,17,-7,Elisabetta Sanna,23 April 1788,PER-PER,TIME-TIME-TIME,PROPN-PROPN,NUM-PROPN-NUM,compound-nsubj,nummod-nmod-nummod,NNP-NNP,CD-NNP-CD,1,1
1,0.0,48,was,19,2,16,14,1,31,17,-3,Elisabetta Sanna,17 February 1857,PER-PER,TIME-TIME-TIME,PROPN-PROPN,NUM-PROPN-NUM,compound-nsubj,nummod-appos-nummod,NNP-NNP,CD-NNP-CD,2,1
2,0.0,48,was,19,2,12,10,1,35,17,-7,Elisabetta Sanna Porcu,23 April 1788,PER-PER-PER,TIME-TIME-TIME,PROPN-PROPN-PROPN,NUM-PROPN-NUM,compound-compound-appos,nummod-nmod-nummod,NNP-NNP-NNP,CD-NNP-CD,1,1
0,2.0,32,reissued,8,4,2,-2,3,29,4,-6,A Christmas to Remember,2007,MISC-MISC-MISC-MISC,TIME,DET-PROPN-PART-VERB,NUM,det-nsubjpass-aux-relcl,pobj,DT-NNP-TO-VB,CD,3,1
1,2.0,32,reissued,8,20,22,2,19,9,-12,14,EMI,Sparrow Records,ORG,ORG-ORG,PROPN,PROPN-PROPN,nmod,compound-appos,NNP,NNP-NNPS,1,1
2,4.0,44,Because,0,18,23,5,17,20,-18,23,A Christmas to Remember,Behind the Eyes,MISC-MISC-MISC-MISC,MISC-MISC-MISC,DET-PROPN-PART-VERB,ADP-DET-PROPN,det-pobj-aux-acl,conj-det-pobj,DT-NNP-TO-VB,IN-DT-NNPS,5,1
3,4.0,44,Because,0,23,3,-20,22,40,-23,3,Behind the Eyes,Grant,MISC-MISC-MISC,PER,ADP-DET-PROPN,PROPN,conj-det-pobj,poss,IN-DT-NNPS,NNP,8,1
4,8.0,19,released,6,16,9,-7,15,9,-10,3,My Best Christmas,Amy Grants ',MISC-MISC-MISC,PER-PER-PER,DET-ADJ-PROPN,PROPN-PROPN-PART,poss-amod-appos,compound-poss-case,PRP$-JJ-NNP,NNP-NNPS-POS,3,1
0,0.0,30,was,11,1,4,3,0,25,10,-7,Osman Karabegović,7 September 1911,PER-PER,TIME-TIME-TIME,PROPN-PROPN,NUM-PROPN-NUM,compound-nsubj,nummod-appos-nummod,NNP-NNP,CD-NNP-CD,1,1
1,0.0,30,was,11,1,8,7,0,21,10,-3,Osman Karabegović,24 June 1996,PER-PER,TIME-TIME-TIME,PROPN-PROPN,NUM-PROPN-NUM,compound-nsubj,nummod-appos-appos,NNP-NNP,CD-NNP-CD,1,1
2,0.0,30,was,11,1,14,13,0,15,10,3,Osman Karabegović,Yugoslav,PER-PER,LOC,PROPN-PROPN,ADJ,compound-nsubj,amod,NNP-NNP,JJ,4,1
3,0.0,30,was,11,1,16,15,0,13,10,5,Osman Karabegović,Bosnian,PER-PER,LOC,PROPN-PROPN,ADJ,compound-nsubj,conj,NNP-NNP,JJ,3,1
4,4.0,53,expelled,21,13,35,22,12,17,8,14,Socialist Republic of Bosnia and Herzegovina,Yugoslav,LOC-LOC-LOC-LOC-LOC-LOC,LOC,PROPN-PROPN-ADP-PROPN-CCONJ-PROPN,ADJ,compound-pobj-prep-pobj-cc-conj,amod,NNP-NNP-IN-NNP-CC-NNP,JJ,8,1
5,5.0,22,was,1,21,7,-14,20,14,-20,6,Herzegovina,Slobodan Milošević,LOC,PER-PER,PROPN,PROPN-PROPN,conj,compound-pobj,NNP,NNP-NNPS,4,1
