,sent_index,sentence_length,root_word,root_index,entity_1_index,entity_2_index,entity_distance,no_words_before_entity_1,no_words_after_entity_2,entity_1_root_distance,entity_2_root_distance,entity 1 name,entity 2 name,entity_type_1,entity_type_2,entity_pos_1,entity_pos_2,entity_dep_1,entity_dep_2,entity_tag_1,entity_tag_2,shortest_distance,label
0,8.0,11,freed,6,5,4,-1,4,6,1,-2,Laura Silsby,missionary,PERSON-PERSON,TITLE,PROPN-PROPN,NOUN,compound-nsubj,compound,NNP-NNP,NN,1,1
1,10146.0,47,come,21,7,18,11,6,28,14,-3,Laura Silsby,missionary,PERSON-PERSON,TITLE,PROPN-PROPN,NOUN,compound-appos,pobj,NNP-NNP,NN,3,1
2,11357.0,25,convicted,4,8,7,-1,7,17,-4,3,Laura Silsby,missionary,PERSON-PERSON,TITLE,PROPN-PROPN,NOUN,compound-dobj,compound,NNP-NNP,NN,1,1
3,11.0,34,shares,1,22,16,-6,21,17,-21,15,her,journalist,PERSON,TITLE,DET,NOUN,poss,conj,PRP$,NN,8,1
4,13.0,35,said,21,1,17,16,0,17,20,-4,Ramon,captain,PERSON,TITLE,PROPN,NOUN,nsubjpass,pobj,NNP,NN,4,1
5,16.0,34,is,13,13,5,-8,12,28,0,-8,NRA,Cain,ORGANIZATION,PERSON,PROPN,PROPN,pobj,poss,NNP,NNP,5,1
6,21.0,40,said,38,9,6,-3,8,33,29,-32,Countrywide Financial,US,ORGANIZATION-ORGANIZATION,COUNTRY,PROPN-PROPN,PROPN,compound-pobj,compound,NNP-NNP,NNP,2,1
7,13297.0,40,said,38,9,6,-3,8,33,29,-32,Countrywide Financial,US,ORGANIZATION-ORGANIZATION,COUNTRY,PROPN-PROPN,PROPN,compound-pobj,compound,NNP-NNP,NNP,2,1
8,23.0,38,said,21,31,23,-8,30,14,-10,2,Corporate Library,Paul Hodgson,ORGANIZATION-ORGANIZATION,PERSON-PERSON,PROPN-PROPN,PROPN-PROPN,compound-pobj,compound-nsubj,NNP-NNP,NNP-NNP,5,1
9,344.0,30,said,18,8,1,-7,7,28,10,-17,Corporate Library,Paul Hodgson,ORGANIZATION-ORGANIZATION,PERSON-PERSON,PROPN-PROPN,PROPN-PROPN,compound-pobj,compound-nsubj,NNP-NNP,NNP-NNP,3,1
10,1424.0,40,said,27,38,29,-9,37,10,-11,2,Corporate Library,Paul Hodgson,ORGANIZATION-ORGANIZATION,PERSON-PERSON,PROPN-PROPN,PROPN-PROPN,compound-pobj,compound-nsubj,NNP-NNP,NNP-NNP,5,1
11,2331.0,39,said,21,32,23,-9,31,15,-11,2,Corporate Library,Paul Hodgson,ORGANIZATION-ORGANIZATION,PERSON-PERSON,PROPN-PROPN,PROPN-PROPN,compound-pobj,compound-nsubj,NNP-NNP,NNP-NNP,5,1
12,3199.0,50,said,27,37,29,-8,36,20,-10,2,Corporate Library,Paul Hodgson,ORGANIZATION-ORGANIZATION,PERSON-PERSON,PROPN-PROPN,PROPN-PROPN,compound-pobj,compound-nsubj,NNP-NNP,NNP-NNP,5,1
13,3394.0,39,said,16,26,18,-8,25,20,-10,2,Corporate Library,Paul Hodgson,ORGANIZATION-ORGANIZATION,PERSON-PERSON,PROPN-PROPN,PROPN-PROPN,compound-pobj,compound-nsubj,NNP-NNP,NNP-NNP,5,1
14,3675.0,49,said,37,47,39,-8,46,9,-10,2,Corporate Library,Paul Hodgson,ORGANIZATION-ORGANIZATION,PERSON-PERSON,PROPN-PROPN,PROPN-PROPN,compound-pobj,compound-nsubj,NNP-NNP,NNP-NNP,5,1
15,5563.0,29,said,17,23,19,-4,22,9,-6,2,Corporate Library,Paul Hodgson,ORGANIZATION-ORGANIZATION,PERSON-PERSON,PROPN-PROPN,PROPN-PROPN,compound-poss,compound-nsubj,NNP-NNP,NNP-NNP,2,1
16,8677.0,45,said,22,32,24,-8,31,20,-10,2,Corporate Library,Paul Hodgson,ORGANIZATION-ORGANIZATION,PERSON-PERSON,PROPN-PROPN,PROPN-PROPN,compound-pobj,compound-nsubj,NNP-NNP,NNP-NNP,5,1
17,8852.0,29,said,14,23,16,-7,22,12,-9,2,Corporate Library,Paul Hodgson,ORGANIZATION-ORGANIZATION,PERSON-PERSON,PROPN-PROPN,PROPN-PROPN,compound-pobj,compound-nsubj,NNP-NNP,NNP-NNP,5,1
18,9541.0,41,said,21,9,1,-8,8,39,12,-20,Corporate Library,Paul Hodgson,ORGANIZATION-ORGANIZATION,PERSON-PERSON,PROPN-PROPN,PROPN-PROPN,compound-pobj,compound-nsubj,NNP-NNP,NNP-NNP,3,1
19,10782.0,33,said,15,25,17,-8,24,15,-10,2,Corporate Library,Paul Hodgson,ORGANIZATION-ORGANIZATION,PERSON-PERSON,PROPN-PROPN,PROPN-PROPN,compound-pobj,compound-nsubj,NNP-NNP,NNP-NNP,5,1
20,12927.0,36,said,19,29,21,-8,28,14,-10,2,Corporate Library,Paul Hodgson,ORGANIZATION-ORGANIZATION,PERSON-PERSON,PROPN-PROPN,PROPN-PROPN,compound-pobj,compound-nsubj,NNP-NNP,NNP-NNP,5,1
21,13312.0,44,said,14,24,16,-8,23,27,-10,2,Corporate Library,Paul Hodgson,ORGANIZATION-ORGANIZATION,PERSON-PERSON,PROPN-PROPN,PROPN-PROPN,compound-pobj,compound-nsubj,NNP-NNP,NNP-NNP,5,1
22,13723.0,42,is,2,40,32,-8,39,9,-38,30,Corporate Library,Paul Hodgson,ORGANIZATION-ORGANIZATION,PERSON-PERSON,PROPN-PROPN,PROPN-PROPN,compound-pobj,compound-nsubj,NNP-NNP,NNP-NNP,5,1
23,13814.0,35,says,16,9,1,-8,8,33,7,-15,Corporate Library,Paul Hodgson,ORGANIZATION-ORGANIZATION,PERSON-PERSON,PROPN-PROPN,PROPN-PROPN,compound-pobj,compound-nsubj,NNP-NNP,NNP-NNP,3,1
24,14671.0,29,says,11,21,13,-8,20,15,-10,2,Corporate Library,Paul Hodgson,ORGANIZATION-ORGANIZATION,PERSON-PERSON,PROPN-PROPN,PROPN-PROPN,compound-pobj,compound-nsubj,NNP-NNP,NNP-NNP,5,1
25,24.0,42,said,32,18,34,16,17,7,14,2,ALICO,Fumiyasu Sato,ORGANIZATION,PERSON-PERSON,PROPN,PROPN-PROPN,compound,compound-nsubj,NNP,NNP-NNP,5,1
26,25.0,35,says,11,13,13,0,12,21,-2,2,Heloise,Heloise,PERSON,PERSON,PROPN,PROPN,nsubj,dobj,NNP,NNP,0,1
27,4001.0,35,says,11,13,13,0,12,21,-2,2,Heloise,Heloise,PERSON,PERSON,PROPN,PROPN,dobj,nsubj,NNP,NNP,0,1
28,37.0,27,described,1,4,3,-1,3,23,-3,2,George Sodini,48-year-old,PERSON-PERSON,NUMBER,PROPN-PROPN,PROPN,compound-dobj,dobj,NNP-NNP,NNP,1,1
29,595.0,30,says,7,14,11,-3,13,18,-7,4,George Sodini,48-year-old,PERSON-PERSON,NUMBER,PROPN-PROPN,NUM,compound-appos,amod,NNP-NNP,CD,2,1
30,5912.0,38,described,1,4,3,-1,3,34,-3,2,George Sodini,48-year-old,PERSON-PERSON,DURATION,PROPN-PROPN,PROPN,compound-dobj,dobj,NNP-NNP,NNP,1,1
31,14317.0,37,know,10,6,4,-2,5,32,4,-6,George Sodini,48-year-old,PERSON-PERSON,DURATION,PROPN-PROPN,NUM,compound-appos,amod,NNP-NNP,CD,3,1
32,14408.0,20,filed,8,18,17,-1,17,2,-10,9,George Sodini,48-year-old,PERSON-PERSON,NUMBER,PROPN-PROPN,PROPN,compound-pobj,amod,NNP-NNP,NNP,1,1
33,39.0,38,forced,23,21,18,-3,20,19,2,-5,Gross,US,PERSON,COUNTRY,PROPN,PROPN,nsubjpass,pobj,NNP,NNP,2,1
34,11052.0,41,said,39,9,1,-8,8,39,30,-38,Gross,US,PERSON,COUNTRY,PROPN,PROPN,dobj,compound,NNP,NNP,2,1
35,44.0,38,DENVER,0,35,13,-22,34,24,-35,13,National Urban League,Vernon Jordan,ORGANIZATION-ORGANIZATION-ORGANIZATION,PERSON-PERSON,PROPN-PROPN-PROPN,PROPN-PROPN,compound-compound-pobj,compound-nsubj,NNP-NNP-NNP,NNP-NNP,11,1
36,45.0,33,said,13,15,20,5,14,12,-2,7,Adela Dworin,president,PERSON-PERSON,TITLE,PROPN-PROPN,NOUN,compound-nsubj,appos,NNP-NNP,NN,2,1
37,3849.0,31,said,11,13,18,5,12,12,-2,7,Adela Dworin,president,PERSON-PERSON,TITLE,PROPN-PROPN,NOUN,compound-nsubj,appos,NNP-NNP,NN,3,1
38,7589.0,46,told,22,1,4,3,0,41,21,-18,Adela Dworin,president,PERSON-PERSON,TITLE,PROPN-PROPN,NOUN,compound-nsubj,appos,NNP-NNP,NN,2,1
39,9028.0,50,told,22,1,4,3,0,45,21,-18,Adela Dworin,president,PERSON-PERSON,TITLE,PROPN-PROPN,NOUN,compound-nsubj,appos,NNP-NNP,NN,2,1
40,11277.0,40,said,28,30,33,3,29,6,-2,5,Adela Dworin,president,PERSON-PERSON,TITLE,PROPN-PROPN,NOUN,compound-nsubj,appos,NNP-NNP,NN,2,1
41,13207.0,32,said,12,14,19,5,13,12,-2,7,Adela Dworin,president,PERSON-PERSON,TITLE,PROPN-PROPN,NOUN,compound-nsubj,appos,NNP-NNP,NN,3,1
42,14638.0,41,is,5,18,17,-1,17,23,-13,12,Adela Dworin,president,PERSON-PERSON,TITLE,PROPN-PROPN,NOUN,compound-nsubj,compound,NNP-NNP,NN,1,1
43,51.0,24,said,13,21,15,-6,20,8,-8,2,National Urban League,Marc Morial,ORGANIZATION-ORGANIZATION-ORGANIZATION,PERSON-PERSON,PROPN-PROPN-PROPN,PROPN-PROPN,compound-compound-pobj,compound-nsubj,NNP-NNP-NNP,NNP-NNP,5,1
44,491.0,32,said,6,1,5,4,0,26,5,-1,National Urban League,Marc Morial,ORGANIZATION-ORGANIZATION-ORGANIZATION,PERSON-PERSON,PROPN-PROPN-PROPN,PROPN-PROPN,compound-compound-compound,compound-nsubj,NNP-NNP-NNP,NNP-NNP,3,1
45,2526.0,45,plans,5,3,32,29,2,12,2,27,National Urban League,Marc Morial,ORGANIZATION-ORGANIZATION-ORGANIZATION,PERSON-PERSON,PROPN-PROPN-PROPN,PROPN-PROPN,compound-compound-compound,compound-conj,NNP-NNP-NNP,NNP-NNP,8,1
46,3021.0,19,called,11,8,1,-7,7,17,3,-10,National Urban League,Marc Morial,ORGANIZATION-ORGANIZATION-ORGANIZATION,PERSON-PERSON,PROPN-PROPN-PROPN,PROPN-PROPN,compound-compound-pobj,compound-nsubj,NNP-NNP-NNP,NNP-NNP,4,1
47,4543.0,31,Johnson,2,28,22,-6,27,8,-26,20,National Urban League,Marc Morial,ORGANIZATION-ORGANIZATION-ORGANIZATION,PERSON-PERSON,PROPN-PROPN-PROPN,PROPN-PROPN,compound-compound-pobj,compound-nsubj,NNP-NNP-NNP,NNP-NNP,3,1
48,5109.0,36,said,30,27,21,-6,26,14,3,-9,National Urban League,Marc Morial,ORGANIZATION-ORGANIZATION-ORGANIZATION,PERSON-PERSON,PROPN-PROPN-PROPN,PROPN-PROPN,compound-compound-pobj,compound-nsubj,NNP-NNP-NNP,NNP-NNP,5,1
49,6080.0,41,said,25,1,5,4,0,35,24,-20,National Urban League,Marc Morial,ORGANIZATION-ORGANIZATION-ORGANIZATION,PERSON-PERSON,PROPN-PROPN-PROPN,PROPN-PROPN,compound-compound-compound,compound-nsubj,NNP-NNP-NNP,NNP-NNP,3,1
50,6646.0,43,agreed,6,1,5,4,0,37,5,-1,National Urban League,Marc Morial,ORGANIZATION-ORGANIZATION-ORGANIZATION,PERSON-PERSON,PROPN-PROPN-PROPN,PROPN-PROPN,compound-compound-compound,compound-nsubj,NNP-NNP-NNP,NNP-NNP,3,1
51,7321.0,31,said,17,7,1,-6,6,29,10,-16,National Urban League,Marc Morial,ORGANIZATION-ORGANIZATION-ORGANIZATION,PERSON-PERSON,PROPN-PROPN-PROPN,PROPN-PROPN,compound-compound-pobj,compound-nsubj,NNP-NNP-NNP,NNP-NNP,4,1
52,7397.0,36,said,23,33,25,-8,32,10,-10,2,National Urban League,Marc Morial,ORGANIZATION-ORGANIZATION-ORGANIZATION,PERSON-PERSON,PROPN-PROPN-PROPN,PROPN-PROPN,compound-compound-pobj,compound-nsubj,NNP-NNP-NNP,NNP-NNP,5,1
53,11488.0,43,said,24,32,26,-6,31,16,-8,2,National Urban League,Marc Morial,ORGANIZATION-ORGANIZATION-ORGANIZATION,PERSON-PERSON,PROPN-PROPN-PROPN,PROPN-PROPN,compound-compound-pobj,compound-nsubj,NNP-NNP-NNP,NNP-NNP,5,1
54,12073.0,26,says,15,23,17,-6,22,8,-8,2,National Urban League,Marc Morial,ORGANIZATION-ORGANIZATION-ORGANIZATION,PERSON-PERSON,PROPN-PROPN-PROPN,PROPN-PROPN,compound-compound-pobj,compound-nsubj,NNP-NNP-NNP,NNP-NNP,5,1
55,12311.0,34,said,21,31,23,-8,30,10,-10,2,National Urban League,Marc Morial,ORGANIZATION-ORGANIZATION-ORGANIZATION,PERSON-PERSON,PROPN-PROPN-PROPN,PROPN-PROPN,compound-compound-pobj,compound-nsubj,NNP-NNP-NNP,NNP-NNP,5,1
56,13392.0,29,said,16,26,18,-8,25,10,-10,2,National Urban League,Marc Morial,ORGANIZATION-ORGANIZATION-ORGANIZATION,PERSON-PERSON,PROPN-PROPN-PROPN,PROPN-PROPN,compound-compound-pobj,compound-nsubj,NNP-NNP-NNP,NNP-NNP,5,1
57,13394.0,34,said,21,31,23,-8,30,10,-10,2,National Urban League,Marc Morial,ORGANIZATION-ORGANIZATION-ORGANIZATION,PERSON-PERSON,PROPN-PROPN-PROPN,PROPN-PROPN,compound-compound-pobj,compound-nsubj,NNP-NNP-NNP,NNP-NNP,5,1
58,58.0,36,include,1,3,11,8,2,24,-2,10,his,Jeff,PERSON,PERSON,DET,PROPN,poss,conj,PRP$,NNP,3,1
59,9815.0,36,include,1,3,11,8,2,24,-2,10,his,Jeff,PERSON,PERSON,DET,PROPN,poss,conj,PRP$,NNP,3,1
60,82.0,42,said,10,8,1,-7,7,40,2,-9,Youssoufou Bamba,Ivory Coast,PERSON-PERSON,COUNTRY-COUNTRY,PROPN-PROPN,PROPN-PROPN,compound-appos,compound-poss,NNP-NNP,NNP-NNP,2,1
61,1014.0,48,said,16,14,7,-7,13,40,2,-9,Youssoufou Bamba,Ivory Coast,PERSON-PERSON,COUNTRY-COUNTRY,PROPN-PROPN,PROPN-PROPN,compound-appos,compound-poss,NNP-NNP,NNP-NNP,2,1
62,6212.0,42,said,10,8,1,-7,7,40,2,-9,Youssoufou Bamba,Ivory Coast,PERSON-PERSON,COUNTRY-COUNTRY,PROPN-PROPN,PROPN-PROPN,compound-appos,compound-poss,NNP-NNP,NNP-NNP,2,1
63,10861.0,38,grave,2,17,9,-8,16,28,-15,7,Youssoufou Bamba,Ivory Coast,PERSON-PERSON,COUNTRY-COUNTRY,PROPN-PROPN,PROPN-PROPN,compound-appos,compound-compound,NNP-NNP,NNP-NNP,2,1
64,84.0,19,murdered,15,1,12,11,0,6,14,-3,Anna Mae Pictou Aquash,Canada,PERSON-PERSON-PERSON-PERSON,COUNTRY,PROPN-PROPN-PROPN-PROPN,PROPN,compound-compound-compound-nsubjpass,pobj,NNP-NNP-NNP-NNP,NNP,3,1
65,87.0,31,includes,4,1,21,20,0,9,3,17,PDA,Thom Hartmann,ORGANIZATION,PERSON-PERSON,PROPN,PROPN-PROPN,poss,compound-conj,NNP,NNP-NNP,9,1
66,90.0,4,was,1,1,3,2,0,0,0,2,She,61,PERSON,NUMBER,PRON,NUM,nsubj,attr,PRP,CD,1,1
67,95.0,44,said,5,19,35,16,18,8,-14,30,he,Patrick,PERSON,PERSON,PRON,PROPN,nsubj,appos,PRP,NNP,5,1
68,98.0,10,dead,7,6,5,-1,5,4,1,-2,Andrew Lange,physicist,PERSON-PERSON,TITLE,PROPN-PROPN,NOUN,compound-nsubj,compound,NNP-NNP,NN,1,1
69,8624.0,10,dead,7,6,5,-1,5,4,1,-2,Andrew Lange,physicist,PERSON-PERSON,TITLE,PROPN-PROPN,NOUN,compound-nsubj,compound,NNP-NNP,NN,1,1
70,9395.0,27,said,25,5,4,-1,4,22,20,-21,Andrew Lange,physicist,PERSON-PERSON,TITLE,PROPN-PROPN,NOUN,compound-nsubj,compound,NNP-NNP,NN,1,1
71,9795.0,28,says,5,8,7,-1,7,20,-3,2,Andrew Lange,physicist,PERSON-PERSON,TITLE,PROPN-PROPN,NOUN,compound-nsubj,compound,NNP-NNP,NN,1,1
72,103.0,20,4GL,0,12,7,-5,11,12,-12,7,ADF,Oracle Application Developer Framework,ORGANIZATION,ORGANIZATION-ORGANIZATION-ORGANIZATION-ORGANIZATION,PROPN,PROPN-PROPN-PROPN-PROPN,compound,compound-compound-compound-ROOT,NNP,NNP-NNP-NNP-NNP,3,1
73,109.0,33,kidnapped,5,1,3,2,0,29,4,-2,Vagni,62,PERSON,NUMBER,PROPN,NUM,nsubjpass,appos,NNP,CD,3,1
74,10879.0,45,kidnapped,5,1,3,2,0,41,4,-2,Vagni,62,PERSON,NUMBER,PROPN,NUM,nsubjpass,appos,NNP,CD,3,1
75,110.0,41,said,14,4,3,-1,3,37,10,-11,Sarah Kunstler,attorney,PERSON-PERSON,TITLE,PROPN-PROPN,NOUN,compound-conj,compound,NNP-NNP,NN,1,1
76,3819.0,27,says,15,17,26,9,16,0,-2,11,Sarah Kunstler,attorney,PERSON-PERSON,TITLE,PROPN-PROPN,NOUN,compound-nsubj,attr,NNP-NNP,NN,3,1
77,4446.0,24,said,12,14,20,6,13,3,-2,8,Sarah Kunstler,attorney,PERSON-PERSON,TITLE,PROPN-PROPN,NOUN,compound-nsubj,appos,NNP-NNP,NN,2,1
78,113.0,53,Listen,0,26,34,8,25,18,-26,34,Nir Rosen,author,PERSON-PERSON,TITLE,PROPN-PROPN,NOUN,compound-nsubj,conj,NNP-NNP,NN,7,1
79,3197.0,27,Rosen,1,1,8,7,0,18,0,7,Nir Rosen,author,PERSON-PERSON,TITLE,PROPN-PROPN,NOUN,compound-ROOT,conj,NNP-NNP,NN,3,1
80,4068.0,32,is,2,1,13,12,0,18,1,11,Nir Rosen,author,PERSON-PERSON,TITLE,PROPN-PROPN,NOUN,compound-nsubj,conj,NNP-NNP,NN,4,1
81,6414.0,29,GOODMAN,1,4,12,8,3,16,-3,11,Nir Rosen,author,PERSON-PERSON,TITLE,PROPN-PROPN,NOUN,compound-nsubj,conj,NNP-NNP,NN,4,1
82,114.0,37,reported,33,15,29,14,14,7,18,-4,he,rape,PERSON,CRIMINAL_CHARGE,PRON,NOUN,nsubj,pobj,PRP,NN,4,1
83,4200.0,29,justify,27,25,15,-10,24,13,2,-12,he,rape,PERSON,CRIMINAL_CHARGE,PRON,NOUN,nsubj,conj,PRP,NN,7,1
84,115.0,26,hung,9,9,25,16,8,0,0,16,she,Honolulu,PERSON,CITY,PRON,PROPN,nsubj,pobj,PRP,NNP,2,1
85,116.0,22,mocking,12,8,10,2,7,11,4,-2,Countrywide,Angelo Mozilo,ORGANIZATION,PERSON-PERSON,PROPN,PROPN-PROPN,compound,compound-nsubj,NNP,NNP-NNP,1,1
86,12054.0,32,reported,30,8,14,6,7,17,22,-16,Countrywide,Angelo Mozilo,ORGANIZATION,PERSON-PERSON,PROPN,PROPN-PROPN,nsubj,compound-appos,NNP,NNP-NNP,2,1
87,117.0,29,charged,11,1,9,8,0,19,10,-2,Graham,Canada,PERSON,COUNTRY,PROPN,PROPN,nsubjpass,pobj,NNP,NNP,2,1
88,6265.0,30,told,1,12,23,11,11,6,-11,22,Graham,Canada,PERSON,COUNTRY,PROPN,PROPN,pobj,pobj,NNP,NNP,6,1
89,6882.0,19,charged,11,1,9,8,0,9,10,-2,Graham,Canada,PERSON,COUNTRY,PROPN,PROPN,nsubjpass,pobj,NNP,NNP,2,1
90,7610.0,39,took,1,13,21,8,12,17,-12,20,Graham,Canada,PERSON,COUNTRY,PROPN,PROPN,pobj,pobj,NNP,NNP,3,1
91,8344.0,39,charged,21,11,19,8,10,19,10,-2,Graham,Canada,PERSON,COUNTRY,PROPN,PROPN,dobj,pobj,NNP,NNP,6,1
92,9098.0,27,said,25,12,20,8,11,6,13,-5,Graham,Canada,PERSON,COUNTRY,PROPN,PROPN,dobj,pobj,NNP,NNP,3,1
93,9994.0,30,told,1,12,23,11,11,6,-11,22,Graham,Canada,PERSON,COUNTRY,PROPN,PROPN,nsubj,pobj,NNP,NNP,6,1
94,11415.0,30,told,1,12,23,11,11,6,-11,22,Graham,Canada,PERSON,COUNTRY,PROPN,PROPN,nsubj,pobj,NNP,NNP,6,1
95,12904.0,30,told,1,12,23,11,11,6,-11,22,Graham,Canada,PERSON,COUNTRY,PROPN,PROPN,pobj,pobj,NNP,NNP,6,1
96,119.0,41,is,5,18,12,-6,17,28,-13,7,Adela Dworin,Cuba,PERSON-PERSON,COUNTRY,PROPN-PROPN,PROPN,compound-nsubj,pobj,NNP-NNP,NNP,4,1
97,3307.0,40,said,28,30,39,9,29,0,-2,11,Adela Dworin,Cuba,PERSON-PERSON,COUNTRY,PROPN-PROPN,PROPN,compound-nsubj,pobj,NNP-NNP,NNP,6,1
98,14933.0,55,Posted,1,32,26,-6,31,28,-31,25,Adela Dworin,Cuba,PERSON-PERSON,COUNTRY,PROPN-PROPN,PROPN,compound-nsubj,pobj,NNP-NNP,NNP,3,1
99,120.0,22,did,1,11,6,-5,10,15,-10,5,Thai Petrochemical Industry,Prachai,ORGANIZATION-ORGANIZATION-ORGANIZATION,PERSON,PROPN-PROPN-PROPN,PROPN,compound-compound-pobj,pobj,NNP-NNP-NNP,NNP,5,1
100,125.0,27,said,24,4,3,-1,3,23,20,-21,lawmaker,Pakistani,PERSON,NATIONALITY,NOUN,ADJ,nsubjpass,amod,NN,JJ,2,1
101,126.0,36,said,1,18,27,9,17,8,-17,26,ALICO,United States,ORGANIZATION,COUNTRY-COUNTRY,PROPN,PROPN-PROPN,appos,compound-pobj,NNP,NNP-NNP,6,1
102,129.0,32,questioned,15,1,11,10,0,20,14,-4,Michael Lomax,United Negro College Fund,PERSON-PERSON,ORGANIZATION-ORGANIZATION-ORGANIZATION-ORGANIZATION,PROPN-PROPN,PROPN-PROPN-PROPN-PROPN,compound-nsubj,compound-compound-compound-pobj,NNP-NNP,NNP-NNP-NNP-NNP,4,1
103,376.0,53,Work,5,35,41,6,34,11,-30,36,Michael Lomax,United Negro College Fund,PERSON-PERSON,ORGANIZATION-ORGANIZATION-ORGANIZATION-ORGANIZATION,PROPN-PROPN,PROPN-PROPN-PROPN-PROPN,compound-pobj,compound-compound-compound-pobj,NNP-NNP,NNP-NNP-NNP-NNP,3,1
104,4015.0,35,said,19,21,27,6,20,7,-2,8,Michael Lomax,United Negro College Fund,PERSON-PERSON,ORGANIZATION-ORGANIZATION-ORGANIZATION-ORGANIZATION,PROPN-PROPN,PROPN-PROPN-PROPN-PROPN,compound-nsubj,compound-compound-compound-pobj,NNP-NNP,NNP-NNP-NNP-NNP,5,1
105,5822.0,26,came,5,8,14,6,7,11,-3,9,Michael Lomax,United Negro College Fund,PERSON-PERSON,ORGANIZATION-ORGANIZATION-ORGANIZATION-ORGANIZATION,PROPN-PROPN,PROPN-PROPN-PROPN-PROPN,compound-pobj,compound-compound-compound-pobj,NNP-NNP,NNP-NNP-NNP-NNP,4,1
106,14803.0,45,are,6,17,23,6,16,21,-11,17,Michael Lomax,United Negro College Fund,PERSON-PERSON,ORGANIZATION-ORGANIZATION-ORGANIZATION-ORGANIZATION,PROPN-PROPN,PROPN-PROPN-PROPN-PROPN,compound-conj,compound-compound-compound-pobj,NNP-NNP,NNP-NNP-NNP-NNP,4,1
107,130.0,41,said,14,4,1,-3,3,39,10,-13,Sarah Kunstler,Filmmaker,PERSON-PERSON,TITLE,PROPN-PROPN,NOUN,compound-conj,nsubj,NNP-NNP,NN,2,1
108,132.0,42,said,10,8,6,-2,7,35,2,-4,Youssoufou Bamba,ambassador,PERSON-PERSON,TITLE,PROPN-PROPN,NOUN,compound-appos,nsubj,NNP-NNP,NN,2,1
109,851.0,31,gave,12,11,10,-1,10,20,1,-2,Youssoufou Bamba,ambassador,PERSON-PERSON,TITLE,PROPN-PROPN,NOUN,compound-appos,nsubj,NNP-NNP,NN,1,1
110,3609.0,42,said,10,8,6,-2,7,35,2,-4,Youssoufou Bamba,ambassador,PERSON-PERSON,TITLE,PROPN-PROPN,NOUN,compound-appos,nsubj,NNP-NNP,NN,2,1
111,9076.0,41,turned,9,7,6,-1,6,34,2,-3,Youssoufou Bamba,ambassador,PERSON-PERSON,TITLE,PROPN-PROPN,NOUN,compound-nsubj,compound,NNP-NNP,NN,1,1
112,9134.0,48,said,16,14,12,-2,13,35,2,-4,Youssoufou Bamba,ambassador,PERSON-PERSON,TITLE,PROPN-PROPN,NOUN,compound-appos,nsubj,NNP-NNP,NN,2,1
113,13747.0,24,gave,9,7,6,-1,6,17,2,-3,Youssoufou Bamba,ambassador,PERSON-PERSON,TITLE,PROPN-PROPN,NOUN,compound-nsubj,compound,NNP-NNP,NN,1,1
114,146.0,35,used,13,15,34,19,14,0,-2,21,Scrapblog,England,PERSON,COUNTRY,PROPN,PROPN,dobj,pobj,NNP,NNP,7,1
115,147.0,32,comes,2,12,18,6,11,13,-10,16,Wen Qiang,rape,PERSON-PERSON,CRIMINAL_CHARGE,PROPN-PROPN,NOUN,compound-appos,pobj,NNP-NNP,NN,2,1
116,1164.0,46,accused,16,1,22,21,0,23,15,6,Wen Qiang,rape,PERSON-PERSON,CRIMINAL_CHARGE,PROPN-PROPN,NOUN,compound-nsubjpass,conj,NNP-NNP,NN,6,1
117,2130.0,44,rejected,7,12,34,22,11,9,-5,27,Wen Qiang,rape,PERSON-PERSON,CRIMINAL_CHARGE,PROPN-PROPN,NOUN,compound-pobj,conj,NNP-NNP,NN,5,1
118,2612.0,48,accused,17,1,20,19,0,27,16,3,Wen Qiang,rape,PERSON-PERSON,CRIMINAL_CHARGE,PROPN-PROPN,NOUN,compound-nsubjpass,pobj,NNP-NNP,NN,2,1
119,3242.0,28,executed,4,6,20,14,5,7,-2,16,Wen Qiang,rape,PERSON-PERSON,CRIMINAL_CHARGE,PROPN-PROPN,NOUN,compound-dobj,pobj,NNP-NNP,NN,4,1
120,3478.0,43,convicted,14,9,33,24,8,9,5,19,Wen Qiang,rape,PERSON-PERSON,CRIMINAL_CHARGE,PROPN-PROPN,NOUN,compound-pobj,conj,NNP-NNP,NN,6,1
121,5293.0,40,convicted,19,1,29,28,0,10,18,10,Wen Qiang,rape,PERSON-PERSON,CRIMINAL_CHARGE,PROPN-PROPN,NOUN,compound-nsubjpass,conj,NNP-NNP,NN,7,1
122,11254.0,45,sentences,1,15,38,23,14,6,-14,37,Wen Qiang,rape,PERSON-PERSON,CRIMINAL_CHARGE,PROPN-PROPN,NOUN,compound-pobj,pobj,NNP-NNP,NN,6,1
123,153.0,28,survived,3,1,22,21,0,5,2,19,He,Adam Lange,PERSON,PERSON-PERSON,PRON,PROPN-PROPN,nsubjpass,compound-appos,PRP,NNP-NNP,5,1
124,168.0,36,details,11,19,19,0,18,16,-8,8,Anna Mae,Anna Mae Pictou,PERSON-PERSON,PERSON-PERSON-PERSON,PROPN-PROPN,PROPN-PROPN-PROPN,compound-pobj,compound-compound-pobj,NNP-NNP,NNP-NNP-NNP,0,1
125,174.0,44,said,3,30,27,-3,29,16,-27,24,ADF,Democratic Republic of Congo,ORGANIZATION,LOCATION-LOCATION-LOCATION-LOCATION,PROPN,PROPN-PROPN-ADP-PROPN,compound,compound-nmod-prep-pobj,NNP,NNP-NNP-IN-NNP,10,1
126,6585.0,39,is,2,2,35,33,1,3,0,33,ADF,Democratic Republic of Congo,ORGANIZATION,COUNTRY-COUNTRY-COUNTRY-COUNTRY,PROPN,PROPN-PROPN-ADP-PROPN,nsubj,compound-pobj-prep-pobj,NNP,NNP-NNP-IN-NNP,6,1
127,181.0,43,raises,3,8,16,8,7,26,-5,13,National Congress of American Indians,"Washington , DC",ORGANIZATION-ORGANIZATION-ORGANIZATION-ORGANIZATION-ORGANIZATION,COUNTRY-COUNTRY-COUNTRY,PROPN-PROPN-ADP-PROPN-PROPN,PROPN-PUNCT-PROPN,compound-nsubj-prep-compound-pobj,pobj-punct-appos,NNP-NNP-IN-NNP-NNPS,"NNP-,-NNP",4,1
128,188.0,27,filed,4,4,12,8,3,14,0,8,she,Rio,PERSON,LOCATION,PRON,PROPN,nsubj,pobj,PRP,NNP,1,1
129,192.0,22,said,6,1,4,3,0,17,5,-2,Knox,22,PERSON,NUMBER,PROPN,NUM,nsubj,appos,NNP,CD,4,1
130,1375.0,42,convicted,5,1,3,2,0,38,4,-2,Knox,22,PERSON,NUMBER,PROPN,NUM,nsubjpass,appos,NNP,CD,3,1
131,10642.0,25,maintained,11,1,3,2,0,21,10,-8,Knox,22,PERSON,NUMBER,PROPN,NUM,nsubj,appos,NNP,CD,2,1
132,201.0,42,said,10,8,5,-3,7,36,2,-5,Youssoufou Bamba,U.N.,PERSON-PERSON,ORGANIZATION,PROPN-PROPN,PROPN,compound-appos,compound,NNP-NNP,NNP,1,1
133,3484.0,48,said,16,14,11,-3,13,36,2,-5,Youssoufou Bamba,U.N.,PERSON-PERSON,ORGANIZATION,PROPN-PROPN,PROPN,compound-appos,compound,NNP-NNP,NNP,1,1
134,12218.0,45,said,13,11,8,-3,10,36,2,-5,Youssoufou Bamba,U.N.,PERSON-PERSON,ORGANIZATION,PROPN-PROPN,PROPN,compound-appos,compound,NNP-NNP,NNP,1,1
135,211.0,34,International,2,1,5,4,0,28,1,3,Helen Keller International,http://wwwhkiorg/,ORGANIZATION-ORGANIZATION-ORGANIZATION,URL,PROPN-PROPN-PROPN,VERB,compound-compound-ROOT,ROOT,NNP-NNP-NNP,VB,-1,1
136,4168.0,45,International,2,1,5,4,0,39,1,3,Helen Keller International,http://wwwhkiorg/,ORGANIZATION-ORGANIZATION-ORGANIZATION,URL,PROPN-PROPN-PROPN,PROPN,compound-nmod-amod,ROOT,NNP-NNP-NNP,NNP,4,1
137,10539.0,45,International,2,1,5,4,0,39,1,3,Helen Keller International,http://wwwhkiorg/,ORGANIZATION-ORGANIZATION-ORGANIZATION,URL,PROPN-PROPN-PROPN,PROPN,compound-compound-ROOT,ROOT,NNP-NNP-NNP,NNP,4,1
138,217.0,22,By,0,5,9,4,4,12,-5,9,American Free Press,http://www.americanfreepress.net/,ORGANIZATION-ORGANIZATION-ORGANIZATION,URL,PROPN-PROPN-PROPN,PROPN,compound-compound-pobj,appos,NNP-NNP-NNP,NNP,-1,1
139,225.0,35,pronounced,13,1,6,5,0,28,12,-7,Vladimir Ladyzhenskiy,wrestler,PERSON-PERSON,TITLE,PROPN-PROPN,NOUN,compound-nsubjpass,appos,NNP-NNP,NN,3,1
140,229.0,27,do,17,7,10,3,6,16,10,-7,BestPartyEvercom,Joshua Strebel,ORGANIZATION,PERSON-PERSON,PROPN,PROPN-PROPN,pobj,compound-conj,NNP,NNP-NNP,4,1
141,230.0,42,are,12,19,25,6,18,16,-7,13,Laura Silsby,Americans,PERSON-PERSON,NATIONALITY,PROPN-PROPN,PROPN,compound-nsubj,pobj,NNP-NNP,NNPS,4,1
142,9241.0,18,began,14,2,11,9,1,6,12,-3,Laura Silsby,Americans,PERSON-PERSON,NATIONALITY,PROPN-PROPN,PROPN,compound-pobj,pobj,NNP-NNP,NNPS,3,1
143,233.0,44,says,4,8,6,-2,7,37,-4,2,Countrywide,Mozilo,ORGANIZATION,PERSON,PROPN,PROPN,poss,nsubj,NNP,NNP,3,1
144,584.0,28,accused,9,14,11,-3,13,16,-5,2,Countrywide,Mozilo,ORGANIZATION,PERSON,PROPN,PROPN,poss,dobj,NNP,NNP,4,1
145,2185.0,35,designed,5,10,34,24,9,0,-5,29,Countrywide,Mozilo,ORGANIZATION,PERSON,PROPN,PROPN,compound,pobj,NNP,NNP,3,1
146,15134.0,44,built,24,10,8,-2,9,35,14,-16,Countrywide,Mozilo,ORGANIZATION,PERSON,PROPN,PROPN,dobj,nsubj,NNP,NNP,1,1
147,234.0,34,discovered,1,3,8,5,2,25,-2,7,Piedra,Scientologists,PERSON,MISC,PROPN,PROPN,poss,pobj,NNP,NNPS,5,1
148,238.0,46,says,29,11,20,9,10,25,18,-9,William Kunstler,her,PERSON-PERSON,PERSON,PROPN-PROPN,DET,compound-appos,poss,NNP-NNP,PRP$,5,1
149,241.0,32,shows,11,14,13,-1,13,18,-3,2,Mario Gonzalez,attorney,PERSON-PERSON,TITLE,PROPN-PROPN,NOUN,compound-nsubj,compound,NNP-NNP,NN,1,1
150,8999.0,38,was,1,11,10,-1,10,27,-10,9,Mario Gonzalez,attorney,PERSON-PERSON,TITLE,PROPN-PROPN,NOUN,compound-dobj,compound,NNP-NNP,NN,1,1
151,244.0,25,wrote,6,2,12,10,1,12,4,6,National Congress of American Indians,David Cameron,ORGANIZATION-ORGANIZATION-ORGANIZATION-ORGANIZATION-ORGANIZATION,PERSON-PERSON,PROPN-PROPN-ADP-PROPN-PROPN,PROPN-PROPN,compound-nsubj-prep-compound-pobj,compound-pobj,NNP-NNP-IN-NNP-NNPS,NNP-NNP,3,1
152,250.0,43,say,1,27,42,15,26,0,-26,41,Matteo Messina Denaro,Sicily,PERSON-PERSON-PERSON,LOCATION,PROPN-PROPN-PROPN,PROPN,compound-compound-appos,pobj,NNP-NNP-NNP,NNP,4,1
153,4885.0,39,said,9,20,29,9,19,9,-11,20,Matteo Messina Denaro,Sicily,PERSON-PERSON-PERSON,LOCATION,PROPN-PROPN-PROPN,PROPN,compound-compound-appos,pobj,NNP-NNP-NNP,NNP,4,1
154,7373.0,32,say,1,9,25,16,8,6,-8,24,Matteo Messina Denaro,Sicily,PERSON-PERSON-PERSON,LOCATION,PROPN-PROPN-PROPN,PROPN,compound-compound-pobj,pobj,NNP-NNP-NNP,NNP,6,1
155,12018.0,29,considered,10,14,28,14,13,0,-4,18,Matteo Messina Denaro,Sicily,PERSON-PERSON-PERSON,LOCATION,PROPN-PROPN-PROPN,PROPN,compound-compound-attr,pobj,NNP-NNP-NNP,NNP,6,1
156,12371.0,42,said,10,23,32,9,22,9,-13,22,Matteo Messina Denaro,Sicily,PERSON-PERSON-PERSON,LOCATION,PROPN-PROPN-PROPN,PROPN,compound-compound-appos,pobj,NNP-NNP-NNP,NNP,4,1
157,13146.0,27,considered,8,12,26,14,11,0,-4,18,Matteo Messina Denaro,Sicily,PERSON-PERSON-PERSON,NATIONALITY,PROPN-PROPN-PROPN,PROPN,compound-compound-attr,pobj,NNP-NNP-NNP,NNP,4,1
158,14017.0,23,cooperating,3,6,22,16,5,0,-3,19,Matteo Messina Denaro,Sicily,PERSON-PERSON-PERSON,LOCATION,PROPN-PROPN-PROPN,PROPN,compound-compound-pobj,pobj,NNP-NNP-NNP,NNP,4,1
159,256.0,54,said,46,38,44,6,37,9,8,-2,National Development and Reform Commission,NDRC,ORGANIZATION-ORGANIZATION-ORGANIZATION-ORGANIZATION-ORGANIZATION,ORGANIZATION,PROPN-PROPN-CCONJ-PROPN-PROPN,PROPN,nmod-nmod-cc-conj-pobj,compound,NNP-NNP-CC-NNP-NNP,NNP,1,1
160,995.0,68,said,35,52,66,14,51,1,-17,31,National Development and Reform Commission,NDRC,ORGANIZATION-ORGANIZATION-ORGANIZATION-ORGANIZATION-ORGANIZATION,ORGANIZATION,PROPN-PROPN-CCONJ-PROPN-PROPN,PROPN,nmod-nmod-cc-conj-conj,compound,NNP-NNP-CC-NNP-NNP,NNP,-1,1
161,1688.0,61,enjoy,6,39,45,6,38,15,-33,39,National Development and Reform Commission,NDRC,ORGANIZATION-ORGANIZATION-ORGANIZATION-ORGANIZATION-ORGANIZATION,ORGANIZATION,PROPN-PROPN-CCONJ-PROPN-PROPN,PROPN,nmod-nmod-cc-conj-pobj,compound,NNP-NNP-CC-NNP-NNP,NNP,7,1
162,2933.0,57,BEIJING,0,49,55,6,48,1,-49,55,National Development and Reform Commission,NDRC,ORGANIZATION-ORGANIZATION-ORGANIZATION-ORGANIZATION-ORGANIZATION,ORGANIZATION,PROPN-PROPN-CCONJ-PROPN-PROPN,PROPN,nmod-nmod-cc-conj-pobj,compound,NNP-NNP-CC-NNP-NNP,NNP,6,1
163,6331.0,46,strengthen,3,38,44,6,37,1,-35,41,National Development and Reform Commission,NDRC,ORGANIZATION-ORGANIZATION-ORGANIZATION-ORGANIZATION-ORGANIZATION,ORGANIZATION,PROPN-PROPN-CCONJ-PROPN-PROPN,PROPN,nmod-nmod-cc-conj-pobj,compound,NNP-NNP-CC-NNP-NNP,NNP,5,1
164,7480.0,46,strengthen,2,38,44,6,37,1,-36,42,National Development and Reform Commission,NDRC,ORGANIZATION-ORGANIZATION-ORGANIZATION-ORGANIZATION-ORGANIZATION,ORGANIZATION,PROPN-PROPN-CCONJ-PROPN-PROPN,PROPN,nmod-nmod-cc-conj-pobj,compound,NNP-NNP-CC-NNP-NNP,NNP,5,1
165,9855.0,32,said,15,7,13,6,6,18,8,-2,National Development and Reform Commission,NDRC,ORGANIZATION-ORGANIZATION-ORGANIZATION-ORGANIZATION-ORGANIZATION,ORGANIZATION,PROPN-PROPN-CCONJ-PROPN-PROPN,PROPN,nmod-nmod-cc-conj-pobj,compound,NNP-NNP-CC-NNP-NNP,NNP,5,1
166,10729.0,45,Commission,5,2,8,6,1,36,3,3,National Development and Reform Commission,NDRC,ORGANIZATION-ORGANIZATION-ORGANIZATION-ORGANIZATION-ORGANIZATION,ORGANIZATION,PROPN-PROPN-CCONJ-PROPN-PROPN,PROPN,nmod-nmod-cc-conj-ROOT,compound,NNP-NNP-CC-NNP-NNP,NNP,2,1
167,13349.0,47,said,25,7,13,6,6,33,18,-12,National Development and Reform Commission,NDRC,ORGANIZATION-ORGANIZATION-ORGANIZATION-ORGANIZATION-ORGANIZATION,ORGANIZATION,PROPN-PROPN-CCONJ-PROPN-PROPN,PROPN,nmod-nmod-cc-conj-pobj,compound,NNP-NNP-CC-NNP-NNP,NNP,4,1
168,14345.0,41,BEIJING,0,11,17,6,10,23,-11,17,National Development and Reform Commission,NDRC,ORGANIZATION-ORGANIZATION-ORGANIZATION-ORGANIZATION-ORGANIZATION,ORGANIZATION,PROPN-PROPN-CCONJ-PROPN-PROPN,PROPN,nmod-nmod-cc-conj-ROOT,compound,NNP-NNP-CC-NNP-NNP,NNP,2,1
169,14418.0,47,said,43,28,34,6,27,12,15,-9,National Development and Reform Commission,NDRC,ORGANIZATION-ORGANIZATION-ORGANIZATION-ORGANIZATION-ORGANIZATION,ORGANIZATION,PROPN-PROPN-CCONJ-PROPN-PROPN,PROPN,nmod-nmod-cc-conj-pobj,compound,NNP-NNP-CC-NNP-NNP,NNP,4,1
170,14835.0,30,said,13,6,12,6,5,17,7,-1,National Development and Reform Commission,NDRC,ORGANIZATION-ORGANIZATION-ORGANIZATION-ORGANIZATION-ORGANIZATION,ORGANIZATION,PROPN-PROPN-CCONJ-PROPN-PROPN,PROPN,nmod-nmod-cc-conj-pobj,compound,NNP-NNP-CC-NNP-NNP,NNP,5,1
171,14990.0,52,said,25,17,23,6,16,28,8,-2,National Development and Reform Commission,NDRC,ORGANIZATION-ORGANIZATION-ORGANIZATION-ORGANIZATION-ORGANIZATION,ORGANIZATION,PROPN-PROPN-CCONJ-PROPN-PROPN,PROPN,nmod-nmod-cc-conj-pobj,compound,NNP-NNP-CC-NNP-NNP,NNP,9,1
172,268.0,30,came,13,2,7,5,1,22,11,-6,Pacific Asia Travel Association,PATA,ORGANIZATION-ORGANIZATION-ORGANIZATION-ORGANIZATION,ORGANIZATION,PROPN-PROPN-PROPN-PROPN,PROPN,compound-compound-compound-nsubj,compound,NNP-NNP-NNP-NNP,NNP,-1,1
173,1906.0,36,predicted,22,7,12,5,6,23,15,-10,Pacific Asia Travel Association,PATA,ORGANIZATION-ORGANIZATION-ORGANIZATION-ORGANIZATION,ORGANIZATION,PROPN-PROPN-PROPN-PROPN,PROPN,compound-compound-compound-pobj,compound,NNP-NNP-NNP-NNP,NNP,7,1
174,2474.0,36,told,22,26,31,5,25,4,-4,9,Pacific Asia Travel Association,PATA,ORGANIZATION-ORGANIZATION-ORGANIZATION-ORGANIZATION,ORGANIZATION,PROPN-PROPN-PROPN-PROPN,PROPN,compound-compound-compound-dobj,compound,NNP-NNP-NNP-NNP,NNP,5,1
175,3593.0,30,said,16,9,14,5,8,15,7,-2,Pacific Asia Travel Association,PATA,ORGANIZATION-ORGANIZATION-ORGANIZATION-ORGANIZATION,ORGANIZATION,PROPN-PROPN-PROPN-PROPN,PROPN,compound-compound-compound-pobj,compound,NNP-NNP-NNP-NNP,NNP,5,1
176,5006.0,54,declined,13,30,35,5,29,18,-17,22,Pacific Asia Travel Association,PATA,ORGANIZATION-ORGANIZATION-ORGANIZATION-ORGANIZATION,ORGANIZATION,PROPN-PROPN-PROPN-PROPN,PROPN,compound-compound-compound-nsubj,compound,NNP-NNP-NNP-NNP,NNP,-1,1
177,5714.0,22,came,2,6,11,5,5,10,-4,9,Pacific Asia Travel Association,PATA,ORGANIZATION-ORGANIZATION-ORGANIZATION-ORGANIZATION,ORGANIZATION,PROPN-PROPN-PROPN-PROPN,PROPN,compound-compound-compound-pobj,compound,NNP-NNP-NNP-NNP,NNP,-1,1
178,5952.0,35,President,0,7,5,-2,6,29,-7,5,Pacific Asia Travel Association,PATA,ORGANIZATION-ORGANIZATION-ORGANIZATION-ORGANIZATION,ORGANIZATION,PROPN-PROPN-PROPN-PROPN,PROPN,compound-compound-compound-pobj,compound,NNP-NNP-NNP-NNP,NNP,-1,1
179,6535.0,40,said,18,11,16,5,10,23,7,-2,Pacific Asia Travel Association,PATA,ORGANIZATION-ORGANIZATION-ORGANIZATION-ORGANIZATION,ORGANIZATION,PROPN-PROPN-PROPN-PROPN,PROPN,compound-compound-compound-appos,compound,NNP-NNP-NNP-NNP,NNP,-1,1
180,6818.0,38,surveyed,16,10,15,5,9,22,6,-1,Pacific Asia Travel Association,PATA,ORGANIZATION-ORGANIZATION-ORGANIZATION-ORGANIZATION,ORGANIZATION,PROPN-PROPN-PROPN-PROPN,PROPN,compound-compound-compound-conj,compound,NNP-NNP-NNP-NNP,NNP,-1,1
181,7134.0,61,information,1,42,47,5,41,13,-41,46,Pacific Asia Travel Association,PATA,ORGANIZATION-ORGANIZATION-ORGANIZATION-ORGANIZATION,ORGANIZATION,PROPN-PROPN-PROPN-PROPN,PROPN,compound-compound-compound-pobj,compound,NNP-NNP-NNP-NNP,NNP,3,1
182,7147.0,39,said,37,31,36,5,30,2,6,-1,Pacific Asia Travel Association,PATA,ORGANIZATION-ORGANIZATION-ORGANIZATION-ORGANIZATION,ORGANIZATION,PROPN-PROPN-PROPN-PROPN,PROPN,compound-compound-compound-appos,compound,NNP-NNP-NNP-NNP,NNP,-1,1
183,7854.0,29,concluded,25,19,1,-18,18,27,6,-24,Pacific Asia Travel Association,PATA,ORGANIZATION-ORGANIZATION-ORGANIZATION-ORGANIZATION,ORGANIZATION,PROPN-PROPN-PROPN-PROPN,PROPN,compound-compound-compound-pobj,compound,NNP-NNP-NNP-NNP,NNP,7,1
184,8586.0,61,continue,2,40,45,5,39,15,-38,43,Pacific Asia Travel Association,PATA,ORGANIZATION-ORGANIZATION-ORGANIZATION-ORGANIZATION,ORGANIZATION,PROPN-PROPN-PROPN-PROPN,PROPN,compound-compound-compound-appos,compound,NNP-NNP-NNP-NNP,NNP,-1,1
185,10389.0,28,unveil,12,4,2,-2,3,25,8,-10,Pacific Asia Travel Association,PATA,ORGANIZATION-ORGANIZATION-ORGANIZATION-ORGANIZATION,ORGANIZATION,PROPN-PROPN-PROPN-PROPN,PROPN,compound-compound-compound-compound,compound,NNP-NNP-NNP-NNP,NNP,-1,1
186,10822.0,37,said,19,12,17,5,11,19,7,-2,Pacific Asia Travel Association,PATA,ORGANIZATION-ORGANIZATION-ORGANIZATION-ORGANIZATION,ORGANIZATION,PROPN-PROPN-PROPN-PROPN,PROPN,compound-compound-compound-pobj,compound,NNP-NNP-NNP-NNP,NNP,-1,1
187,12242.0,41,PATA,22,18,23,5,17,17,4,1,Pacific Asia Travel Association,PATA,ORGANIZATION-ORGANIZATION-ORGANIZATION-ORGANIZATION,ORGANIZATION,PROPN-PROPN-PROPN-PROPN,PROPN,compound-compound-compound-pobj,ROOT,NNP-NNP-NNP-NNP,NNP,-1,1
188,13584.0,34,surpass,8,25,30,5,24,3,-17,22,Pacific Asia Travel Association,PATA,ORGANIZATION-ORGANIZATION-ORGANIZATION-ORGANIZATION,ORGANIZATION,PROPN-PROPN-PROPN-PROPN,PROPN,compound-compound-compound-pobj,ROOT,NNP-NNP-NNP-NNP,NNP,-1,1
189,14252.0,46,attracted,2,39,44,5,38,1,-37,42,Pacific Asia Travel Association,PATA,ORGANIZATION-ORGANIZATION-ORGANIZATION-ORGANIZATION,ORGANIZATION,PROPN-PROPN-PROPN-PROPN,PROPN,compound-compound-compound-conj,compound,NNP-NNP-NNP-NNP,NNP,-1,1
190,14354.0,55,According,0,20,25,5,19,29,-20,25,Pacific Asia Travel Association,PATA,ORGANIZATION-ORGANIZATION-ORGANIZATION-ORGANIZATION,ORGANIZATION,PROPN-PROPN-PROPN-PROPN,PROPN,compound-compound-compound-conj,compound,NNP-NNP-NNP-NNP,NNP,5,1
191,274.0,41,says,2,4,9,5,3,31,-2,7,he,Jewish,PERSON,RELIGION,PRON,ADJ,nsubj,amod,PRP,JJ,4,1
192,13464.0,40,began,2,28,14,-14,27,25,-26,12,he,Jewish,PERSON,RELIGION,PRON,ADJ,nsubjpass,amod,PRP,JJ,7,1
193,281.0,18,is,1,14,16,2,13,1,-13,15,Countrywide,Stanford Kurland,ORGANIZATION,PERSON-PERSON,PROPN,PROPN-PROPN,compound,compound-pobj,NNP,NNP-NNP,1,1
194,288.0,19,put,1,4,1,-3,3,17,-3,0,her,Hagemo,PERSON,PERSON,DET,PROPN,poss,nsubj,PRP$,NNP,1,1
195,6063.0,10,said,1,3,1,-2,2,8,-2,0,her,Hagemo,PERSON,PERSON,DET,PROPN,poss,nsubj,PRP$,NNP,2,1
196,7863.0,11,flew,1,8,1,-7,7,9,-7,0,her,Hagemo,PERSON,PERSON,DET,PROPN,poss,nsubj,PRP$,NNP,2,1
197,290.0,12,ordered,2,10,9,-1,9,2,-8,7,Eliza Samudio,25-year-old,PERSON-PERSON,NUMBER,PROPN-PROPN,NUM,compound-pobj,amod,NNP-NNP,CD,1,1
198,6467.0,44,is,1,11,10,-1,10,33,-10,9,Eliza Samudio,25-year-old,PERSON-PERSON,NUMBER,PROPN-PROPN,NUM,compound-pobj,amod,NNP-NNP,CD,1,1
199,12610.0,22,accused,2,10,9,-1,9,12,-8,7,Eliza Samudio,25-year-old,PERSON-PERSON,DURATION,PROPN-PROPN,NUM,compound-pobj,amod,NNP-NNP,CD,1,1
200,12741.0,24,JANEIRO,2,22,21,-1,21,2,-20,19,Eliza Samudio,25-year-old,PERSON-PERSON,NUMBER,PROPN-PROPN,NUM,compound-pobj,amod,NNP-NNP,CD,2,1
201,15158.0,25,said,2,23,22,-1,22,2,-21,20,Eliza Samudio,25-year-old,PERSON-PERSON,DURATION,PROPN-PROPN,NUM,compound-appos,compound,NNP-NNP,CD,1,1
202,296.0,29,said,19,28,21,-7,27,7,-9,2,ShopperTrak,Bill Martin,ORGANIZATION,PERSON-PERSON,PROPN,PROPN-PROPN,pobj,compound-nsubj,NNP,NNP-NNP,3,1
203,1352.0,29,was,4,8,22,14,7,6,-4,18,ShopperTrak,Bill Martin,ORGANIZATION,PERSON-PERSON,PROPN,PROPN-PROPN,attr,compound-pobj,NNP,NNP-NNP,4,1
204,1364.0,24,said,7,4,1,-3,3,22,3,-6,ShopperTrak,Bill Martin,ORGANIZATION,PERSON-PERSON,PROPN,PROPN-PROPN,poss,compound-nsubj,NNP,NNP-NNP,3,1
205,2034.0,50,said,11,19,13,-6,18,36,-8,2,ShopperTrak,Bill Martin,ORGANIZATION,PERSON-PERSON,PROPN,PROPN-PROPN,pobj,compound-nsubj,NNP,NNP-NNP,4,1
206,2540.0,20,said,11,19,13,-6,18,6,-8,2,ShopperTrak,Bill Martin,ORGANIZATION,PERSON-PERSON,PROPN,PROPN-PROPN,pobj,compound-nsubj,NNP,NNP-NNP,2,1
207,3209.0,19,said,13,15,17,2,14,1,-2,4,ShopperTrak,Bill Martin,ORGANIZATION,PERSON-PERSON,PROPN,PROPN-PROPN,compound,compound-nsubj,NNP,NNP-NNP,3,1
208,4724.0,52,said,42,51,44,-7,50,7,-9,2,ShopperTrak,Bill Martin,ORGANIZATION,PERSON-PERSON,PROPN,PROPN-PROPN,pobj,compound-nsubj,NNP,NNP-NNP,2,1
209,4740.0,46,said,30,27,29,2,26,16,3,-1,ShopperTrak,Bill Martin,ORGANIZATION,PERSON-PERSON,PROPN,PROPN-PROPN,compound,compound-nsubj,NNP,NNP-NNP,1,1
210,4897.0,42,said,34,41,36,-5,40,5,-7,2,ShopperTrak,Bill Martin,ORGANIZATION,PERSON-PERSON,PROPN,PROPN-PROPN,pobj,compound-nsubj,NNP,NNP-NNP,2,1
211,5749.0,25,...,0,21,16,-5,20,8,-21,16,ShopperTrak,Bill Martin,ORGANIZATION,PERSON-PERSON,PROPN,PROPN-PROPN,pobj,compound-nsubj,NNP,NNP-NNP,2,1
212,6233.0,37,said,31,33,35,2,32,1,-2,4,ShopperTrak,Bill Martin,ORGANIZATION,PERSON-PERSON,PROPN,PROPN-PROPN,compound,compound-nsubj,NNP,NNP-NNP,3,1
213,6542.0,32,cautioned,7,6,1,-5,5,30,1,-6,ShopperTrak,Bill Martin,ORGANIZATION,PERSON-PERSON,PROPN,PROPN-PROPN,pobj,compound-nsubj,NNP,NNP-NNP,2,1
214,7585.0,25,said,20,17,19,2,16,5,3,-1,ShopperTrak,Bill Martin,ORGANIZATION,PERSON-PERSON,PROPN,PROPN-PROPN,compound,compound-nsubj,NNP,NNP-NNP,3,1
215,7734.0,36,said,15,26,17,-9,25,18,-11,2,ShopperTrak,Bill Martin,ORGANIZATION,PERSON-PERSON,PROPN,PROPN-PROPN,pobj,compound-nsubj,NNP,NNP-NNP,3,1
216,10900.0,41,said,33,40,35,-5,39,5,-7,2,ShopperTrak,Bill Martin,ORGANIZATION,PERSON-PERSON,PROPN,PROPN-PROPN,pobj,compound-nsubj,NNP,NNP-NNP,2,1
217,11819.0,20,said,12,19,14,-5,18,5,-7,2,ShopperTrak,Bill Martin,ORGANIZATION,PERSON-PERSON,PROPN,PROPN-PROPN,pobj,compound-nsubj,NNP,NNP-NNP,2,1
218,13917.0,25,said,13,20,15,-5,19,9,-7,2,ShopperTrak,Bill Martin,ORGANIZATION,PERSON-PERSON,PROPN,PROPN-PROPN,pobj,compound-nsubj,NNP,NNP-NNP,2,1
219,14592.0,38,see,2,36,33,-3,35,4,-34,31,ShopperTrak,Bill Martin,ORGANIZATION,PERSON-PERSON,PROPN,PROPN-PROPN,compound,compound-nsubj,NNP,NNP-NNP,3,1
220,15368.0,46,said,41,38,40,2,37,5,3,-1,ShopperTrak,Bill Martin,ORGANIZATION,PERSON-PERSON,PROPN,PROPN-PROPN,compound,compound-nsubj,NNP,NNP-NNP,3,1
221,300.0,27,is,2,1,9,8,0,17,1,7,Benjamin Chertoff,Popular Mechanics,PERSON-PERSON,ORGANIZATION-ORGANIZATION,PROPN-PROPN,PROPN-PROPN,compound-nsubj,compound-compound,NNP-NNP,NNP-NNP,7,1
222,7131.0,30,had,1,7,10,3,6,19,-6,9,Benjamin Chertoff,Popular Mechanics,PERSON-PERSON,ORGANIZATION-ORGANIZATION,PROPN-PROPN,PROPN-PROPN,compound-pobj,compound-pobj,NNP-NNP,NNP-NNPS,2,1
223,12579.0,42,made,7,26,29,3,25,12,-19,22,Benjamin Chertoff,Popular Mechanics,PERSON-PERSON,ORGANIZATION-ORGANIZATION,PROPN-PROPN,PROPN-PROPN,compound-nsubj,compound-pobj,NNP-NNP,NNP-NNP,2,1
224,301.0,26,was,7,1,4,3,0,21,6,-3,Bamba,60-year-old,PERSON,NUMBER,PROPN,NUM,nsubj,amod,NNP,CD,5,1
225,302.0,50,formed,1,1,27,26,0,22,0,26,He,Motorola,PERSON,ORGANIZATION,PRON,PROPN,nsubj,compound,PRP,NNP,1,1
226,306.0,35,ordered,4,31,34,3,30,0,-27,30,Eliza Samudio,25,PERSON-PERSON,NUMBER,PROPN-PROPN,NUM,compound-pobj,npadvmod,NNP-NNP,CD,8,1
227,2650.0,62,said,20,52,40,-12,51,21,-32,20,Eliza Samudio,25,PERSON-PERSON,NUMBER,PROPN-PROPN,NUM,compound-pobj,appos,NNP-NNP,CD,5,1
228,5768.0,62,said,20,52,40,-12,51,21,-32,20,Eliza Samudio,25,PERSON-PERSON,NUMBER,PROPN-PROPN,NUM,compound-pobj,appos,NNP-NNP,CD,5,1
229,309.0,31,accused,10,14,29,15,13,1,-4,19,Aquash,South Dakota,PERSON,STATE_OR_PROVINCE-STATE_OR_PROVINCE,PROPN,PROPN-PROPN,dobj,compound-pobj,NNP,NNP-NNP,7,1
230,312.0,11,sold,1,3,5,2,2,5,-2,4,ALICO,MetLife Inc,ORGANIZATION,ORGANIZATION-ORGANIZATION,PROPN,PROPN-PROPN,dobj,compound-pobj,NNP,NNP-NNP,1,1
231,422.0,32,says,1,27,30,3,26,1,-26,29,ALICO,MetLife Inc,ORGANIZATION,ORGANIZATION-ORGANIZATION,PROPN,PROPN-PROPN,compound,compound-pobj,NNP,NNP-NNP,3,1
232,316.0,31,urged,14,11,9,-2,10,21,3,-5,Charles Ble Goude,lieutenant,PERSON-PERSON-PERSON,TITLE,PROPN-PROPN-PROPN,NOUN,compound-compound-appos,nsubj,NNP-NNP-NNP,NN,3,1
233,5695.0,47,digs,4,23,22,-1,22,24,-19,18,Charles Ble Goude,lieutenant,PERSON-PERSON-PERSON,TITLE,PROPN-PROPN-PROPN,NOUN,compound-compound-appos,nsubj,NNP-NNP-NNP,NN,2,1
234,11605.0,38,is,4,19,14,-5,18,23,-15,10,Charles Ble Goude,lieutenant,PERSON-PERSON-PERSON,TITLE,PROPN-PROPN-PROPN,NOUN,compound-compound-pobj,attr,NNP-NNP-NNP,NN,5,1
235,12357.0,34,urged,19,14,9,-5,13,24,5,-10,Charles Ble Goude,lieutenant,PERSON-PERSON-PERSON,TITLE,PROPN-PROPN-PROPN,NOUN,compound-compound-pobj,nsubj,NNP-NNP-NNP,NN,5,1
236,12365.0,35,holding,17,12,7,-5,11,27,5,-10,Charles Ble Goude,lieutenant,PERSON-PERSON-PERSON,TITLE,PROPN-PROPN-PROPN,NOUN,compound-compound-pobj,nsubj,NNP-NNP-NNP,NN,3,1
237,15189.0,30,urged,11,9,8,-1,8,21,2,-3,Charles Ble Goude,lieutenant,PERSON-PERSON-PERSON,TITLE,PROPN-PROPN-PROPN,NOUN,compound-compound-appos,nsubj,NNP-NNP-NNP,NN,2,1
238,327.0,54,wrote,38,40,47,7,39,6,-2,9,Ahmed Rashid,author,PERSON-PERSON,TITLE,PROPN-PROPN,NOUN,compound-nsubj,conj,NNP-NNP,NN,3,1
239,1170.0,49,received,6,31,42,11,30,6,-25,36,Ahmed Rashid,author,PERSON-PERSON,TITLE,PROPN-PROPN,NOUN,compound-pobj,conj,NNP-NNP,NN,4,1
240,1245.0,47,accuses,4,3,2,-1,2,44,1,-2,Ahmed Rashid,author,PERSON-PERSON,TITLE,PROPN-PROPN,NOUN,compound-nsubj,compound,NNP-NNP,NN,1,1
241,1717.0,36,said,15,14,13,-1,13,22,1,-2,Ahmed Rashid,author,PERSON-PERSON,TITLE,PROPN-PROPN,NOUN,compound-conj,compound,NNP-NNP,NN,1,1
242,3054.0,29,speculated,12,9,8,-1,8,20,3,-4,Ahmed Rashid,author,PERSON-PERSON,TITLE,PROPN-PROPN,NOUN,compound-pobj,compound,NNP-NNP,NN,1,1
243,7077.0,34,is,7,1,10,9,0,23,6,3,Ahmed Rashid,author,PERSON-PERSON,TITLE,PROPN-PROPN,NOUN,compound-nsubj,attr,NNP-NNP,NN,3,1
244,8325.0,64,include,7,42,12,-30,41,51,-35,5,Ahmed Rashid,author,PERSON-PERSON,TITLE,PROPN-PROPN,NOUN,compound-conj,appos,NNP-NNP,NN,6,1
245,8968.0,15,is,7,1,10,9,0,4,6,3,Ahmed Rashid,author,PERSON-PERSON,TITLE,PROPN-PROPN,NOUN,compound-nsubj,attr,NNP-NNP,NN,3,1
246,9325.0,44,said,28,30,34,4,29,9,-2,6,Ahmed Rashid,author,PERSON-PERSON,TITLE,PROPN-PROPN,NOUN,compound-nsubj,appos,NNP-NNP,NN,2,1
247,9640.0,30,said,22,11,16,5,10,13,11,-6,Ahmed Rashid,author,PERSON-PERSON,TITLE,PROPN-PROPN,NOUN,compound-nsubj,appos,NNP-NNP,NN,2,1
248,9837.0,36,took,11,34,33,-1,33,2,-23,22,Ahmed Rashid,author,PERSON-PERSON,TITLE,PROPN-PROPN,NOUN,compound-pobj,compound,NNP-NNP,NN,1,1
249,10552.0,36,said,5,4,3,-1,3,32,1,-2,Ahmed Rashid,author,PERSON-PERSON,TITLE,PROPN-PROPN,NOUN,compound-nsubj,compound,NNP-NNP,NN,1,1
250,10954.0,33,said,17,1,5,4,0,27,16,-12,Ahmed Rashid,author,PERSON-PERSON,TITLE,PROPN-PROPN,NOUN,compound-nsubj,appos,NNP-NNP,NN,2,1
251,12026.0,40,said,22,4,15,11,3,24,18,-7,Ahmed Rashid,author,PERSON-PERSON,TITLE,PROPN-PROPN,NOUN,compound-conj,conj,NNP-NNP,NN,3,1
252,12828.0,47,is,17,1,22,21,0,24,16,5,Ahmed Rashid,author,PERSON-PERSON,TITLE,PROPN-PROPN,NOUN,compound-nsubj,attr,NNP-NNP,NN,3,1
253,13005.0,18,said,11,16,15,-1,15,2,-5,4,Ahmed Rashid,author,PERSON-PERSON,TITLE,PROPN-PROPN,NOUN,compound-conj,compound,NNP-NNP,NN,2,1
254,15028.0,60,said,29,31,42,11,30,17,-2,13,Ahmed Rashid,author,PERSON-PERSON,TITLE,PROPN-PROPN,NOUN,compound-nsubj,conj,NNP-NNP,NN,3,1
255,330.0,28,testified,1,1,17,16,0,10,0,16,She,FBI,PERSON,ORGANIZATION,PRON,PROPN,nsubj,compound,PRP,NNP,7,1
256,333.0,37,said,34,23,27,4,22,9,11,-7,National Energy Administration,New Energy Department,ORGANIZATION-ORGANIZATION-ORGANIZATION,ORGANIZATION-ORGANIZATION-ORGANIZATION,PROPN-PROPN-PROPN,PROPN-PROPN-PROPN,compound-compound-poss,compound-compound-pobj,NNP-NNP-NNP,NNP-NNP-NNP,3,1
257,334.0,28,accused,3,5,8,3,4,19,-2,5,Alan Gross,espionage,PERSON-PERSON,CRIMINAL_CHARGE,PROPN-PROPN,NOUN,compound-dobj,pobj,NNP-NNP,NN,2,1
258,12812.0,27,said,19,3,11,8,2,15,16,-8,Alan Gross,espionage,PERSON-PERSON,CRIMINAL_CHARGE,PROPN-PROPN,NOUN,compound-nsubj,compound,NNP-NNP,NN,3,1
259,347.0,47,said,27,36,44,8,35,2,-9,17,Tribeca Enterprises,Sundance Film Festival,ORGANIZATION-ORGANIZATION,ORGANIZATION-ORGANIZATION-ORGANIZATION,PROPN-PROPN,PROPN-PROPN-PROPN,compound-pobj,compound-compound-pobj,NNP-NNPS,NNP-NNP-NNP,5,1
260,358.0,34,announced,3,19,24,5,18,9,-16,21,Lange,chairman,PERSON,TITLE,PROPN,NOUN,nsubj,attr,NNP,NN,1,1
261,363.0,23,served,5,1,4,3,0,18,4,-1,Her,Wen,PERSON,PERSON,DET,PROPN,poss,appos,PRP$,NNP,2,1
262,368.0,41,At,0,15,8,-7,14,32,-15,8,National Energy Administration,Liu Qi,ORGANIZATION-ORGANIZATION-ORGANIZATION,PERSON-PERSON,PROPN-PROPN-PROPN,PROPN-PROPN,compound-compound-pobj,compound-pobj,NNP-NNP-NNP,NNP-NNP,4,1
263,1370.0,73,calls,2,22,12,-10,21,60,-20,10,National Energy Administration,Liu Qi,ORGANIZATION-ORGANIZATION-ORGANIZATION,PERSON-PERSON,PROPN-PROPN-PROPN,PROPN-PROPN,compound-compound-pobj,compound-pobj,NNP-NNP-NNP,NNP-NNP,5,1
264,6152.0,47,said,44,39,32,-7,38,14,5,-12,National Energy Administration,Liu Qi,ORGANIZATION-ORGANIZATION-ORGANIZATION,PERSON-PERSON,PROPN-PROPN-PROPN,PROPN-PROPN,compound-compound-pobj,compound-nsubj,NNP-NNP-NNP,NNP-NNP,4,1
265,9332.0,37,said,18,27,20,-7,26,16,-9,2,National Energy Administration,Liu Qi,ORGANIZATION-ORGANIZATION-ORGANIZATION,PERSON-PERSON,PROPN-PROPN-PROPN,PROPN-PROPN,compound-compound-pobj,compound-nsubj,NNP-NNP-NNP,NNP-NNP,4,1
266,13365.0,48,KHARTOUM,0,22,25,3,21,22,-22,25,National Energy Administration,Liu Qi,ORGANIZATION-ORGANIZATION-ORGANIZATION,PERSON-PERSON,PROPN-PROPN-PROPN,PROPN-PROPN,compound-compound-compound,compound-pobj,NNP-NNP-NNP,NNP-NNP,2,1
267,371.0,29,hired,6,4,9,5,3,19,2,3,Pauliina Miettinen,Sky Blue,PERSON-PERSON,ORGANIZATION-ORGANIZATION,PROPN-PROPN,PROPN-PROPN,compound-nsubjpass,compound-pobj,NNP-NNP,NNP-NNP,3,1
268,379.0,49,urged,16,1,3,2,0,45,15,-13,Chiafari,53,PERSON,NUMBER,PROPN,NUM,nsubj,appos,NNP,CD,2,1
269,383.0,10,reviews,3,1,5,4,0,4,2,2,National Energy Administration,China,ORGANIZATION-ORGANIZATION-ORGANIZATION,COUNTRY,PROPN-PROPN-PROPN,PROPN,compound-compound-nsubj,poss,NNP-NNP-NNP,NNP,5,1
270,3047.0,42,said,19,16,14,-2,15,27,3,-5,National Energy Administration,China,ORGANIZATION-ORGANIZATION-ORGANIZATION,COUNTRY,PROPN-PROPN-PROPN,PROPN,compound-compound-pobj,poss,NNP-NNP-NNP,NNP,3,1
271,4092.0,30,said,17,27,25,-2,26,4,-10,8,National Energy Administration,China,ORGANIZATION-ORGANIZATION-ORGANIZATION,COUNTRY,PROPN-PROPN-PROPN,PROPN,compound-compound-pobj,poss,NNP-NNP-NNP,NNP,3,1
272,4438.0,24,seen,3,21,9,-12,20,14,-18,6,National Energy Administration,China,ORGANIZATION-ORGANIZATION-ORGANIZATION,COUNTRY,PROPN-PROPN-PROPN,PROPN,compound-compound-dobj,poss,NNP-NNP-NNP,NNP,7,1
273,4516.0,56,said,39,33,9,-24,32,46,6,-30,National Energy Administration,China,ORGANIZATION-ORGANIZATION-ORGANIZATION,COUNTRY,PROPN-PROPN-PROPN,PROPN,compound-compound-pobj,nsubj,NNP-NNP-NNP,NNP,7,1
274,7754.0,40,BEIJING,0,35,8,-27,34,31,-35,8,National Energy Administration,China,ORGANIZATION-ORGANIZATION-ORGANIZATION,COUNTRY,PROPN-PROPN-PROPN,PROPN,compound-compound-pobj,nsubj,NNP-NNP-NNP,NNP,7,1
275,7948.0,50,said,47,42,1,-41,41,48,5,-46,National Energy Administration,China,ORGANIZATION-ORGANIZATION-ORGANIZATION,COUNTRY,PROPN-PROPN-PROPN,PROPN,compound-compound-compound,pobj,NNP-NNP-NNP,NNP,8,1
276,8763.0,33,make,2,25,1,-24,24,31,-23,-1,National Energy Administration,China,ORGANIZATION-ORGANIZATION-ORGANIZATION,COUNTRY,PROPN-PROPN-PROPN,PROPN,compound-compound-pobj,nsubj,NNP-NNP-NNP,NNP,6,1
277,10192.0,66,plays,12,39,36,-3,38,29,-27,24,National Energy Administration,China,ORGANIZATION-ORGANIZATION-ORGANIZATION,COUNTRY,PROPN-PROPN-PROPN,PROPN,compound-compound-compound,pobj,NNP-NNP-NNP,NNP,-1,1
278,12038.0,22,expected,14,8,6,-2,7,15,6,-8,National Energy Administration,China,ORGANIZATION-ORGANIZATION-ORGANIZATION,COUNTRY,PROPN-PROPN-PROPN,PROPN,compound-compound-pobj,poss,NNP-NNP-NNP,NNP,3,1
279,12262.0,24,said,12,9,7,-2,8,16,3,-5,National Energy Administration,China,ORGANIZATION-ORGANIZATION-ORGANIZATION,COUNTRY,PROPN-PROPN-PROPN,PROPN,compound-compound-pobj,nsubj,NNP-NNP-NNP,NNP,3,1
280,12363.0,39,BEIJING,0,16,25,9,15,13,-16,25,National Energy Administration,China,ORGANIZATION-ORGANIZATION-ORGANIZATION,COUNTRY,PROPN-PROPN-PROPN,PROPN,compound-compound-pobj,nsubj,NNP-NNP-NNP,NNP,6,1
281,12589.0,41,Administration,4,3,1,-2,2,39,1,-3,National Energy Administration,China,ORGANIZATION-ORGANIZATION-ORGANIZATION,COUNTRY,PROPN-PROPN-PROPN,PROPN,compound-compound-ROOT,poss,NNP-NNP-NNP,NNP,3,1
282,13294.0,40,BEIJING,0,19,17,-2,18,22,-19,17,National Energy Administration,China,ORGANIZATION-ORGANIZATION-ORGANIZATION,COUNTRY,PROPN-PROPN-PROPN,PROPN,compound-compound-pobj,poss,NNP-NNP-NNP,NNP,2,1
283,13425.0,31,said,28,26,1,-25,25,29,2,-27,National Energy Administration,China,ORGANIZATION-ORGANIZATION-ORGANIZATION,COUNTRY,PROPN-PROPN-PROPN,PROPN,compound-compound-nsubj,poss,NNP-NNP-NNP,NNP,6,1
284,13795.0,30,said,10,7,16,9,6,13,3,6,National Energy Administration,China,ORGANIZATION-ORGANIZATION-ORGANIZATION,COUNTRY,PROPN-PROPN-PROPN,PROPN,compound-compound-pobj,nsubj,NNP-NNP-NNP,NNP,6,1
285,14320.0,38,BEIJING,0,32,8,-24,31,29,-32,8,National Energy Administration,China,ORGANIZATION-ORGANIZATION-ORGANIZATION,COUNTRY,PROPN-PROPN-PROPN,PROPN,compound-compound-pobj,poss,NNP-NNP-NNP,NNP,9,1
286,14854.0,42,BEIJING,0,37,8,-29,36,33,-37,8,National Energy Administration,China,ORGANIZATION-ORGANIZATION-ORGANIZATION,COUNTRY,PROPN-PROPN-PROPN,PROPN,compound-compound-nsubj,poss,NNP-NNP-NNP,NNP,6,1
287,15017.0,25,had,1,22,1,-21,21,23,-21,0,National Energy Administration,China,ORGANIZATION-ORGANIZATION-ORGANIZATION,COUNTRY,PROPN-PROPN-PROPN,PROPN,compound-compound-pobj,poss,NNP-NNP-NNP,NNP,4,1
288,384.0,40,snatched,2,4,12,8,3,27,-2,10,Vagni,International Committee,PERSON,ORGANIZATION-ORGANIZATION,PROPN,PROPN-PROPN,dobj,compound-pobj,NNP,NNP-NNP,4,1
289,388.0,18,denied,14,6,1,-5,5,16,8,-13,ADF,Ismael Rukwago,ORGANIZATION,PERSON-PERSON,PROPN,PROPN-PROPN,compound,compound-nsubj,NNP,NNP-NNP,1,1
290,908.0,19,denied,15,7,2,-5,6,16,8,-13,ADF,Ismael Rukwago,ORGANIZATION,PERSON-PERSON,PROPN,PROPN-PROPN,compound,compound-nsubj,NNP,NNP-NNP,1,1
291,5111.0,19,denied,15,6,1,-5,5,17,9,-14,ADF,Ismael Rukwago,ORGANIZATION,PERSON-PERSON,PROPN,PROPN-PROPN,compound,compound-nsubj,NNP,NNP-NNP,1,1
292,389.0,17,flown,3,10,7,-3,9,9,-7,4,he,Manila,PERSON,CITY,PRON,PROPN,nsubjpass,pobj,PRP,NNP,3,1
293,396.0,30,reached,26,13,1,-12,12,28,13,-25,Countrywide Financial Corp.,Bank of America Corp.,ORGANIZATION-ORGANIZATION-ORGANIZATION,ORGANIZATION-ORGANIZATION-ORGANIZATION-ORGANIZATION,PROPN-PROPN-PROPN,PROPN-ADP-PROPN-PROPN,compound-compound-pobj,nsubj-prep-compound-pobj,NNP-NNP-NNP,NNP-IN-NNP-NNP,6,1
294,1915.0,28,failed,14,18,24,6,17,3,-4,10,Countrywide Financial Corp.,Bank of America Corp.,ORGANIZATION-ORGANIZATION-ORGANIZATION,ORGANIZATION-ORGANIZATION-ORGANIZATION-ORGANIZATION,PROPN-PROPN-PROPN,PROPN-ADP-PROPN-PROPN,compound-compound-nsubjpass,pobj-prep-compound-pobj,NNP-NNP-NNP,NNP-IN-NNP-NNP,5,1
295,4772.0,41,scheduled,3,30,37,7,29,3,-27,34,Countrywide Financial Corp.,Bank of America Corp.,ORGANIZATION-ORGANIZATION-ORGANIZATION,ORGANIZATION-ORGANIZATION-ORGANIZATION-ORGANIZATION,PROPN-PROPN-PROPN,PROPN-ADP-PROPN-PROPN,compound-compound-pobj,pobj-prep-compound-pobj,NNP-NNP-NNP,NNP-IN-NNP-NNP,6,1
296,397.0,45,died,34,1,44,43,0,0,33,10,Norris Church Mailer,NY,PERSON-PERSON-PERSON,STATE_OR_PROVINCE,PROPN-PROPN-PROPN,PROPN,compound-compound-nsubj,appos,NNP-NNP-NNP,NNP,7,1
297,400.0,37,seen,14,1,5,4,0,31,13,-9,Joseph Cerniglia,39-year-old,PERSON-PERSON,NUMBER,PROPN-PROPN,NUM,compound-nsubjpass,nummod,NNP-NNP,CD,4,1
298,752.0,26,ruled,8,14,13,-1,13,12,-6,5,Joseph Cerniglia,39-year-old,PERSON-PERSON,NUMBER,PROPN-PROPN,NUM,compound-pobj,nummod,NNP-NNP,CD,1,1
299,1228.0,25,found,17,5,4,-1,4,20,12,-13,Joseph Cerniglia,39-year-old,PERSON-PERSON,NUMBER,PROPN-PROPN,NUM,compound-pobj,compound,NNP-NNP,CD,1,1
300,6578.0,21,say,4,10,9,-1,9,11,-6,5,Joseph Cerniglia,39-year-old,PERSON-PERSON,NUMBER,PROPN-PROPN,NUM,compound-pobj,compound,NNP-NNP,CD,1,1
301,401.0,42,set,4,28,20,-8,27,21,-24,16,Charles Ble Goude,Ivory Coast,PERSON-PERSON-PERSON,COUNTRY-COUNTRY,PROPN-PROPN-PROPN,PROPN-PROPN,compound-compound-appos,compound-poss,NNP-NNP-NNP,NNP-NNP,10,1
302,513.0,38,brought,8,35,6,-29,34,31,-27,-2,Charles Ble Goude,Ivory Coast,PERSON-PERSON-PERSON,NATIONALITY-NATIONALITY,PROPN-PROPN-PROPN,PROPN-PROPN,compound-compound-dobj,compound-pobj,NNP-NNP-NNP,NNP-NNP,6,1
303,14013.0,40,said,2,25,18,-7,24,21,-23,16,Charles Ble Goude,Ivory Coast,PERSON-PERSON-PERSON,NATIONALITY-NATIONALITY,PROPN-PROPN-PROPN,PROPN-PROPN,compound-compound-dobj,compound-pobj,NNP-NNP-NNP,NNP-NNP,9,1
304,403.0,31,went,10,8,1,-7,7,29,2,-9,Corporate Library,Nell Minow,ORGANIZATION-ORGANIZATION,PERSON-PERSON,PROPN-PROPN,PROPN-PROPN,compound-pobj,compound-nsubj,NNP-NNP,NNP-NNP,4,1
305,836.0,28,said,8,16,10,-6,15,17,-8,2,Corporate Library,Nell Minow,ORGANIZATION-ORGANIZATION,PERSON-PERSON,PROPN-PROPN,PROPN-PROPN,compound-pobj,compound-nsubj,NNP-NNP,NNP-NNP,5,1
306,1712.0,35,offered,19,9,1,-8,8,33,10,-18,Corporate Library,Nell Minow,ORGANIZATION-ORGANIZATION,PERSON-PERSON,PROPN-PROPN,PROPN-PROPN,compound-pobj,compound-nsubj,NNP-NNP,NNP-NNP,5,1
307,2069.0,55,says,17,10,1,-9,9,53,7,-16,Corporate Library,Nell Minow,ORGANIZATION-ORGANIZATION,PERSON-PERSON,PROPN-PROPN,PROPN-PROPN,compound-conj,compound-nsubj,NNP-NNP,NNP-NNP,6,1
308,2437.0,28,said,19,7,1,-6,6,26,12,-18,Corporate Library,Nell Minow,ORGANIZATION-ORGANIZATION,PERSON-PERSON,PROPN-PROPN,PROPN-PROPN,compound-pobj,compound-nsubj,NNP-NNP,NNP-NNP,3,1
309,2993.0,33,said,14,22,16,-6,21,16,-8,2,Corporate Library,Nell Minow,ORGANIZATION-ORGANIZATION,PERSON-PERSON,PROPN-PROPN,PROPN-PROPN,compound-pobj,compound-nsubj,NNP-NNP,NNP-NNP,3,1
310,3073.0,21,interviewed,2,14,5,-9,13,15,-12,3,Corporate Library,Nell Minow,ORGANIZATION-ORGANIZATION,PERSON-PERSON,PROPN-PROPN,PROPN-PROPN,compound-appos,compound-pobj,NNP-NNP,NNP-NNP,6,1
311,3597.0,35,countered,17,7,1,-6,6,33,10,-16,Corporate Library,Nell Minow,ORGANIZATION-ORGANIZATION,PERSON-PERSON,PROPN-PROPN,PROPN-PROPN,compound-pobj,compound-nsubj,NNP-NNP,NNP-NNP,4,1
312,5232.0,34,Said,0,9,2,-7,8,31,-9,2,Corporate Library,Nell Minow,ORGANIZATION-ORGANIZATION,PERSON-PERSON,PROPN-PROPN,PROPN-PROPN,compound-pobj,compound-nsubj,NNP-NNP,NNP-NNP,3,1
313,5477.0,38,said,21,29,23,-6,28,14,-8,2,Corporate Library,Nell Minow,ORGANIZATION-ORGANIZATION,PERSON-PERSON,PROPN-PROPN,PROPN-PROPN,compound-pobj,compound-nsubj,NNP-NNP,NNP-NNP,3,1
314,5480.0,32,said,17,8,1,-7,7,30,9,-16,Corporate Library,Nell Minow,ORGANIZATION-ORGANIZATION,PERSON-PERSON,PROPN-PROPN,PROPN-PROPN,compound-pobj,compound-nsubj,NNP-NNP,NNP-NNP,3,1
315,5486.0,46,said,23,31,25,-6,30,20,-8,2,Corporate Library,Nell Minow,ORGANIZATION-ORGANIZATION,PERSON-PERSON,PROPN-PROPN,PROPN-PROPN,compound-pobj,compound-nsubj,NNP-NNP,NNP-NNP,5,1
316,6451.0,60,said,14,22,16,-6,21,43,-8,2,Corporate Library,Nell Minow,ORGANIZATION-ORGANIZATION,PERSON-PERSON,PROPN-PROPN,PROPN-PROPN,compound-pobj,compound-nsubj,NNP-NNP,NNP-NNP,3,1
317,7270.0,29,said,19,27,21,-6,26,7,-8,2,Corporate Library,Nell Minow,ORGANIZATION-ORGANIZATION,PERSON-PERSON,PROPN-PROPN,PROPN-PROPN,compound-pobj,compound-nsubj,NNP-NNP,NNP-NNP,3,1
318,8275.0,52,said,18,7,1,-6,6,50,11,-17,Corporate Library,Nell Minow,ORGANIZATION-ORGANIZATION,PERSON-PERSON,PROPN-PROPN,PROPN-PROPN,compound-pobj,compound-nsubj,NNP-NNP,NNP-NNP,3,1
319,8629.0,51,says,18,7,1,-6,6,49,11,-17,Corporate Library,Nell Minow,ORGANIZATION-ORGANIZATION,PERSON-PERSON,PROPN-PROPN,PROPN-PROPN,compound-pobj,compound-nsubj,NNP-NNP,NNP-NNP,3,1
320,8707.0,29,said,12,20,14,-6,19,14,-8,2,Corporate Library,Nell Minow,ORGANIZATION-ORGANIZATION,PERSON-PERSON,PROPN-PROPN,PROPN-PROPN,compound-pobj,compound-nsubj,NNP-NNP,NNP-NNP,3,1
321,8923.0,19,said,8,17,10,-7,16,8,-9,2,Corporate Library,Nell Minow,ORGANIZATION-ORGANIZATION,PERSON-PERSON,PROPN-PROPN,PROPN-PROPN,compound-pobj,compound-nsubj,NNP-NNP,NNP-NNP,3,1
322,9767.0,27,think,21,8,1,-7,7,25,13,-20,Corporate Library,Nell Minow,ORGANIZATION-ORGANIZATION,PERSON-PERSON,PROPN-PROPN,PROPN-PROPN,compound-pobj,compound-nsubj,NNP-NNP,NNP-NNP,4,1
323,10199.0,45,said,30,38,32,-6,37,12,-8,2,Corporate Library,Nell Minow,ORGANIZATION-ORGANIZATION,PERSON-PERSON,PROPN-PROPN,PROPN-PROPN,compound-pobj,compound-nsubj,NNP-NNP,NNP-NNP,3,1
324,10665.0,37,said,26,35,28,-7,34,8,-9,2,Corporate Library,Nell Minow,ORGANIZATION-ORGANIZATION,PERSON-PERSON,PROPN-PROPN,PROPN-PROPN,compound-pobj,compound-nsubj,NNP-NNP,NNP-NNP,5,1
325,11543.0,45,said,37,26,20,-6,25,24,11,-17,Corporate Library,Nell Minow,ORGANIZATION-ORGANIZATION,PERSON-PERSON,PROPN-PROPN,PROPN-PROPN,compound-pobj,compound-nsubj,NNP-NNP,NNP-NNP,5,1
326,12892.0,37,said,17,25,19,-6,24,17,-8,2,Corporate Library,Nell Minow,ORGANIZATION-ORGANIZATION,PERSON-PERSON,PROPN-PROPN,PROPN-PROPN,compound-pobj,compound-nsubj,NNP-NNP,NNP-NNP,5,1
327,13141.0,45,said,27,35,29,-6,34,15,-8,2,Corporate Library,Nell Minow,ORGANIZATION-ORGANIZATION,PERSON-PERSON,PROPN-PROPN,PROPN-PROPN,compound-pobj,compound-nsubj,NNP-NNP,NNP-NNP,5,1
328,13290.0,60,said,14,22,16,-6,21,43,-8,2,Corporate Library,Nell Minow,ORGANIZATION-ORGANIZATION,PERSON-PERSON,PROPN-PROPN,PROPN-PROPN,compound-pobj,compound-nsubj,NNP-NNP,NNP-NNP,3,1
329,13806.0,26,said,11,19,13,-6,18,12,-8,2,Corporate Library,Nell Minow,ORGANIZATION-ORGANIZATION,PERSON-PERSON,PROPN-PROPN,PROPN-PROPN,compound-pobj,compound-nsubj,NNP-NNP,NNP-NNP,5,1
330,14222.0,44,is,3,36,28,-8,35,15,-33,25,Corporate Library,Nell Minow,ORGANIZATION-ORGANIZATION,PERSON-PERSON,PROPN-PROPN,PROPN-PROPN,compound-appos,compound-nsubj,NNP-NNP,NNP-NNP,5,1
331,411.0,44,accused,15,1,8,7,0,35,14,-7,Wen Qiang,Chongqing,PERSON-PERSON,CITY,PROPN-PROPN,PROPN,compound-nsubjpass,poss,NNP-NNP,NNP,5,1
332,1140.0,28,was,1,6,16,10,5,11,-5,15,Wen Qiang,Chongqing,PERSON-PERSON,CITY,PROPN-PROPN,PROPN,compound-pobj,compound,NNP-NNP,NNP,7,1
333,1277.0,36,said,34,1,15,14,0,20,33,-19,Wen Qiang,Chongqing,PERSON-PERSON,CITY,PROPN-PROPN,PROPN,compound-nsubj,pobj,NNP-NNP,NNP,1,1
334,1658.0,44,verdict,1,4,11,7,3,32,-3,10,Wen Qiang,Chongqing,PERSON-PERSON,CITY,PROPN-PROPN,PROPN,compound-pobj,poss,NNP-NNP,NNP,5,1
335,2353.0,29,found,14,1,8,7,0,20,13,-6,Wen Qiang,Chongqing,PERSON-PERSON,CITY,PROPN-PROPN,PROPN,compound-nsubjpass,poss,NNP-NNP,NNP,5,1
336,3709.0,37,include,1,3,8,5,2,28,-2,7,Wen Qiang,Chongqing,PERSON-PERSON,CITY,PROPN-PROPN,PROPN,compound-dobj,poss,NNP-NNP,NNP,4,1
337,4239.0,51,said,10,12,4,-8,11,46,-2,-6,Wen Qiang,Chongqing,PERSON-PERSON,CITY,PROPN-PROPN,PROPN,compound-nsubj,nmod,NNP-NNP,NNP,7,1
338,4539.0,12,Qiang,1,1,11,10,0,0,0,10,Wen Qiang,Chongqing,PERSON-PERSON,ORGANIZATION,PROPN-PROPN,PROPN,compound-ROOT,pobj,NNP-NNP,NNP,3,1
339,4556.0,32,announced,22,7,19,12,6,12,15,-3,Wen Qiang,Chongqing,PERSON-PERSON,NATIONALITY,PROPN-PROPN,PROPN,compound-pobj,pobj,NNP-NNP,NNP,6,1
340,4841.0,41,sentenced,24,1,15,14,0,25,23,-9,Wen Qiang,Chongqing,PERSON-PERSON,CITY,PROPN-PROPN,PROPN,compound-nsubjpass,compound,NNP-NNP,NNP,5,1
341,4866.0,45,sentences,1,15,22,7,14,22,-14,21,Wen Qiang,Chongqing,PERSON-PERSON,ORGANIZATION,PROPN-PROPN,PROPN,compound-pobj,poss,NNP-NNP,NNP,5,1
342,5831.0,36,reported,32,14,12,-2,13,23,18,-20,Wen Qiang,Chongqing,PERSON-PERSON,ORGANIZATION,PROPN-PROPN,PROPN,compound-appos,pobj,NNP-NNP,NNP,2,1
343,6435.0,36,was,1,6,13,7,5,22,-5,12,Wen Qiang,Chongqing,PERSON-PERSON,CITY,PROPN-PROPN,PROPN,compound-pobj,poss,NNP-NNP,NNP,5,1
344,8280.0,46,said,44,1,10,9,0,35,43,-34,Wen Qiang,Chongqing,PERSON-PERSON,CITY,PROPN-PROPN,PROPN,compound-nsubjpass,compound,NNP-NNP,NNP,3,1
345,8368.0,40,accused,16,1,10,9,0,29,15,-6,Wen Qiang,Chongqing,PERSON-PERSON,CITY,PROPN-PROPN,PROPN,compound-nsubjpass,compound,NNP-NNP,NNP,4,1
346,8515.0,21,stood,16,1,15,14,0,5,15,-1,Wen Qiang,Chongqing,PERSON-PERSON,CITY,PROPN-PROPN,PROPN,compound-nsubj,pobj,NNP-NNP,NNP,2,1
347,12827.0,25,is,1,14,10,-4,13,14,-13,9,Wen Qiang,Chongqing,PERSON-PERSON,CITY,PROPN-PROPN,PROPN,compound-appos,poss,NNP-NNP,NNP,5,1
348,425.0,9,writes,2,1,6,5,0,2,1,4,Mark Fisher,Dayton Daily News,PERSON-PERSON,ORGANIZATION-ORGANIZATION-ORGANIZATION,PROPN-PROPN,PROPN-PROPN-PROPN,compound-nsubj,compound-compound-pobj,NNP-NNP,NNP-NNP-NNP,4,1
349,8642.0,7,Fisher,1,1,4,3,0,2,0,3,Mark Fisher,Dayton Daily News,PERSON-PERSON,ORGANIZATION-ORGANIZATION-ORGANIZATION,PROPN-PROPN,PROPN-PROPN-PROPN,compound-ROOT,compound-compound-appos,NNP-NNP,NNP-NNP-NNP,2,1
350,426.0,30,said,8,4,6,2,3,23,4,-2,Countrywide,Rick Simon,ORGANIZATION,PERSON-PERSON,PROPN,PROPN-PROPN,pobj,compound-appos,NNP,NNP-NNP,2,1
351,433.0,26,delivered,3,19,9,-10,18,16,-16,6,Chen Tao,Chongqing,PERSON-PERSON,CITY,PROPN-PROPN,PROPN,compound-conj,compound,NNP-NNP,NNP,4,1
352,2363.0,28,delivered,4,14,20,6,13,7,-10,16,Chen Tao,Chongqing,PERSON-PERSON,CITY,PROPN-PROPN,PROPN,compound-conj,compound,NNP-NNP,NNP,2,1
353,5338.0,32,included,11,30,21,-9,29,10,-19,10,Chen Tao,Chongqing,PERSON-PERSON,CITY,PROPN-PROPN,PROPN,compound-conj,compound,NNP-NNP,NNP,7,1
354,7891.0,33,receive,23,19,9,-10,18,23,4,-14,Chen Tao,Chongqing,PERSON-PERSON,CITY,PROPN-PROPN,PROPN,compound-conj,compound,NNP-NNP,NNP,6,1
355,434.0,27,sentenced,3,1,13,12,0,13,2,10,Asia Bibi,Punjab,PERSON-PERSON,STATE_OR_PROVINCE,PROPN-PROPN,PROPN,compound-nsubjpass,pobj,NNP-NNP,NNP,4,1
356,2055.0,26,sentenced,3,1,13,12,0,12,2,10,Asia Bibi,Punjab,PERSON-PERSON,STATE_OR_PROVINCE,PROPN-PROPN,PROPN,compound-nsubjpass,pobj,NNP-NNP,NNP,4,1
357,3971.0,50,LAHORE,0,12,32,20,11,17,-12,32,Asia Bibi,Punjab,PERSON-PERSON,STATE_OR_PROVINCE,PROPN-PROPN,PROPN,compound-nsubjpass,appos,NNP-NNP,NNP,2,1
358,436.0,14,remained,10,6,9,3,5,4,4,-1,Laura Silsby,40,PERSON-PERSON,NUMBER,PROPN-PROPN,NUM,compound-appos,appos,NNP-NNP,CD,3,1
359,3701.0,41,said,3,31,34,3,30,6,-28,31,Laura Silsby,40,PERSON-PERSON,NUMBER,PROPN-PROPN,NUM,compound-dobj,appos,NNP-NNP,CD,1,1
360,7173.0,44,released,2,13,16,3,12,27,-11,14,Laura Silsby,40,PERSON-PERSON,NUMBER,PROPN-PROPN,NUM,compound-nsubj,appos,NNP-NNP,CD,1,1
361,10775.0,19,is,13,12,15,3,11,3,1,2,Laura Silsby,40,PERSON-PERSON,NUMBER,PROPN-PROPN,NUM,compound-appos,attr,NNP-NNP,CD,4,1
362,439.0,13,Nemours,3,9,1,-8,8,11,-6,-2,biologist,du Pont de Nemours,PERSON,ORGANIZATION-ORGANIZATION-ORGANIZATION-ORGANIZATION,NOUN,PROPN-PROPN-PROPN-PROPN,pobj,compound-compound-compound-ROOT,NN,NNP-NNP-NNP-NNP,4,1
363,446.0,23,cousin,4,1,4,3,0,18,3,0,Benjamin Chertoff,25-year-old,PERSON-PERSON,DURATION,PROPN-PROPN,NUM,compound-compound,amod,NNP-NNP,CD,4,1
364,6403.0,23,cousin,4,1,4,3,0,18,3,0,Benjamin Chertoff,25-year-old,PERSON-PERSON,DURATION,PROPN-PROPN,NUM,compound-nmod,amod,NNP-NNP,CD,4,1
365,448.0,51,made,9,12,19,7,11,31,-3,10,Alan P. Gross,Potomac,PERSON-PERSON-PERSON,CITY,PROPN-PROPN-PROPN,PROPN,compound-compound-pobj,pobj,NNP-NNP-NNP,NNP,5,1
366,464.0,29,speculated,12,9,7,-2,8,21,3,-5,Ahmed Rashid,Pakistani,PERSON-PERSON,NATIONALITY,PROPN-PROPN,ADJ,compound-pobj,amod,NNP-NNP,JJ,1,1
367,927.0,36,said,15,14,10,-4,13,25,1,-5,Ahmed Rashid,Pakistani,PERSON-PERSON,NATIONALITY,PROPN-PROPN,ADJ,compound-conj,amod,NNP-NNP,JJ,1,1
368,1551.0,36,took,11,34,32,-2,33,3,-23,21,Ahmed Rashid,Pakistani,PERSON-PERSON,NATIONALITY,PROPN-PROPN,ADJ,compound-pobj,amod,NNP-NNP,JJ,1,1
369,2969.0,25,said,10,12,16,4,11,8,-2,6,Ahmed Rashid,Pakistani,PERSON-PERSON,NATIONALITY,PROPN-PROPN,ADJ,compound-nsubj,amod,NNP-NNP,JJ,3,1
370,4573.0,22,said,0,2,17,15,1,4,-2,17,Ahmed Rashid,Pakistani,PERSON-PERSON,NATIONALITY,PROPN-PROPN,ADJ,compound-nsubj,nmod,NNP-NNP,JJ,6,1
371,5122.0,46,were,18,16,14,-2,15,31,2,-4,Ahmed Rashid,Pakistani,PERSON-PERSON,NATIONALITY,PROPN-PROPN,ADJ,compound-conj,compound,NNP-NNP,JJ,1,1
372,5171.0,27,paid,11,9,1,-8,8,25,2,-10,Ahmed Rashid,Pakistani,PERSON-PERSON,NATIONALITY,PROPN-PROPN,ADJ,compound-appos,amod,NNP-NNP,JJ,1,1
373,5746.0,30,said,19,21,25,4,20,4,-2,6,Ahmed Rashid,Pakistani,PERSON-PERSON,NATIONALITY,PROPN-PROPN,ADJ,compound-nsubj,amod,NNP-NNP,JJ,3,1
374,6597.0,27,said,16,18,22,4,17,4,-2,6,Ahmed Rashid,Pakistani,PERSON-PERSON,NATIONALITY,PROPN-PROPN,ADJ,compound-nsubj,amod,NNP-NNP,JJ,3,1
375,8970.0,27,said,11,13,17,4,12,9,-2,6,Ahmed Rashid,Pakistani,PERSON-PERSON,NATIONALITY,PROPN-PROPN,ADJ,compound-nsubj,amod,NNP-NNP,JJ,3,1
376,9868.0,52,added,1,15,12,-3,14,39,-14,11,Ahmed Rashid,Pakistani,PERSON-PERSON,NATIONALITY,PROPN-PROPN,ADJ,compound-nsubj,compound,NNP-NNP,JJ,4,1
377,11424.0,50,noted,6,4,2,-2,3,47,2,-4,Ahmed Rashid,Pakistani,PERSON-PERSON,NATIONALITY,PROPN-PROPN,ADJ,compound-nsubj,amod,NNP-NNP,JJ,1,1
378,11523.0,36,took,11,34,32,-2,33,3,-23,21,Ahmed Rashid,Pakistani,PERSON-PERSON,NATIONALITY,PROPN-PROPN,ADJ,compound-pobj,amod,NNP-NNP,JJ,1,1
379,13433.0,24,said,9,11,16,5,10,7,-2,7,Ahmed Rashid,Pakistani,PERSON-PERSON,NATIONALITY,PROPN-PROPN,ADJ,compound-nsubj,amod,NNP-NNP,JJ,3,1
380,13834.0,96,noted,6,4,2,-2,3,93,2,-4,Ahmed Rashid,Pakistani,PERSON-PERSON,NATIONALITY,PROPN-PROPN,ADJ,compound-nsubj,amod,NNP-NNP,JJ,1,1
381,14616.0,30,said,16,18,22,4,17,7,-2,6,Ahmed Rashid,Pakistani,PERSON-PERSON,NATIONALITY,PROPN-PROPN,ADJ,compound-nsubj,amod,NNP-NNP,JJ,3,1
382,15279.0,49,says,12,1,5,4,0,43,11,-7,Ahmed Rashid,Pakistani,PERSON-PERSON,NATIONALITY,PROPN-PROPN,ADJ,compound-nsubj,amod,NNP-NNP,JJ,1,1
383,469.0,45,said,4,10,42,32,9,2,-6,38,Ruben van Assouw,Enzo,PERSON-PERSON-PERSON,PERSON,PROPN-PROPN-PROPN,PROPN,compound-compound-attr,appos,NNP-NNP-NNP,NNP,7,1
384,6369.0,47,said,1,3,11,8,2,35,-2,10,Ruben van Assouw,Enzo,PERSON-PERSON-PERSON,PERSON,PROPN-PROPN-PROPN,PROPN,compound-compound-nsubj,appos,NNP-NNP-NNP,NNP,6,1
385,7069.0,32,said,28,1,14,13,0,17,27,-14,Ruben van Assouw,Enzo,PERSON-PERSON-PERSON,PERSON,PROPN-PROPN-PROPN,PROPN,compound-compound-nsubj,appos,NNP-NNP-NNP,NNP,6,1
386,14371.0,49,posted,6,24,46,22,23,2,-18,40,Ruben van Assouw,Enzo,PERSON-PERSON-PERSON,PERSON,PROPN-PROPN-PROPN,PROPN,compound-compound-pobj,conj,NNP-NNP-NNP,NNP,6,1
387,471.0,45,died,34,1,25,24,0,19,33,-9,Norris Church Mailer,painter,PERSON-PERSON-PERSON,TITLE,PROPN-PROPN-PROPN,NOUN,compound-compound-nsubj,conj,NNP-NNP-NNP,NN,6,1
388,473.0,33,said,6,8,4,-4,7,28,-2,-2,Daniels,Charlesetta Dunlap,PERSON,PERSON-PERSON,PROPN,PROPN-PROPN,nsubj,compound-appos,NNP,NNP-NNP,3,1
389,480.0,26,told,20,19,18,-1,18,7,1,-2,Mark Fisher,lawmaker,PERSON-PERSON,TITLE,PROPN-PROPN,NOUN,compound-nsubj,compound,NNP-NNP,NN,2,1
390,484.0,62,said,40,51,25,-26,50,36,-11,-15,TPI,China,ORGANIZATION,COUNTRY,PROPN,PROPN,pobj,conj,NNP,NNP,12,1
391,530.0,43,told,14,4,34,30,3,8,10,20,National Development and Reform Commission,Ministry of Housing and Urban-Rural Development,ORGANIZATION-ORGANIZATION-ORGANIZATION-ORGANIZATION-ORGANIZATION,ORGANIZATION-ORGANIZATION-ORGANIZATION-ORGANIZATION-ORGANIZATION-ORGANIZATION,PROPN-PROPN-CCONJ-PROPN-PROPN,PROPN-ADP-PROPN-CCONJ-PROPN-PROPN,nmod-nmod-cc-conj-appos,conj-prep-pobj-cc-amod-conj,NNP-NNP-CC-NNP-NNP,NNP-IN-NNP-CC-NNP-NNP,-1,1
392,535.0,25,survived,1,21,20,-1,20,4,-20,19,Chen Tao,32-year-old,PERSON-PERSON,DURATION,PROPN-PROPN,NUM,compound-npadvmod,dobj,NNP-NNP,CD,1,1
393,538.0,17,confronting,11,2,8,6,1,8,9,-3,Urban League,Colman School,ORGANIZATION-ORGANIZATION,ORGANIZATION-ORGANIZATION,PROPN-PROPN,PROPN-PROPN,compound-nsubj,compound-dobj,NNP-NNP,NNP-NNP,2,1
394,542.0,36,ROME,0,9,12,3,8,23,-9,12,Amanda Knox,22,PERSON-PERSON,NUMBER,PROPN-PROPN,NUM,compound-appos,appos,NNP-NNP,CD,1,1
395,4883.0,65,FOUND,2,12,15,3,11,49,-10,13,Amanda Knox,22,PERSON-PERSON,NUMBER,PROPN-PROPN,NUM,compound-dobj,appos,NNP-NNP,CD,1,1
396,6677.0,49,seemed,40,21,24,3,20,24,19,-16,Amanda Knox,22,PERSON-PERSON,NUMBER,PROPN-PROPN,NUM,compound-pobj,appos,NNP-NNP,CD,1,1
397,10325.0,39,expected,10,18,21,3,17,17,-8,11,Amanda Knox,22,PERSON-PERSON,NUMBER,PROPN-PROPN,NUM,compound-nsubj,appos,NNP-NNP,CD,2,1
398,546.0,60,said,42,52,2,-50,51,57,-10,-40,National Development and Reform Commission,China,ORGANIZATION-ORGANIZATION-ORGANIZATION-ORGANIZATION-ORGANIZATION,COUNTRY,PROPN-PROPN-CCONJ-PROPN-PROPN,PROPN,nmod-nmod-cc-conj-pobj,nsubj,NNP-NNP-CC-NNP-NNP,NNP,8,1
399,2230.0,40,hopes,25,10,25,15,9,14,15,0,National Development and Reform Commission,China,ORGANIZATION-ORGANIZATION-ORGANIZATION-ORGANIZATION-ORGANIZATION,COUNTRY,PROPN-PROPN-CCONJ-PROPN-PROPN,PROPN,nmod-nmod-cc-conj-pobj,nsubj,NNP-NNP-CC-NNP-NNP,NNP,4,1
400,3500.0,44,reported,21,32,1,-31,31,42,-11,-20,National Development and Reform Commission,China,ORGANIZATION-ORGANIZATION-ORGANIZATION-ORGANIZATION-ORGANIZATION,COUNTRY,PROPN-PROPN-CCONJ-PROPN-PROPN,PROPN,nmod-nmod-cc-conj-pobj,nsubj,NNP-NNP-CC-NNP-NNP,NNP,7,1
401,4295.0,37,quoted,20,29,9,-20,28,27,-9,-11,National Development and Reform Commission,China,ORGANIZATION-ORGANIZATION-ORGANIZATION-ORGANIZATION-ORGANIZATION,COUNTRY,PROPN-PROPN-CCONJ-PROPN-PROPN,PROPN,nmod-nmod-cc-conj-pobj,poss,NNP-NNP-CC-NNP-NNP,NNP,10,1
402,5628.0,22,said,6,2,11,9,1,10,4,5,National Development and Reform Commission,China,ORGANIZATION-ORGANIZATION-ORGANIZATION-ORGANIZATION-ORGANIZATION,COUNTRY,PROPN-PROPN-CCONJ-PROPN-PROPN,PROPN,nmod-nmod-cc-conj-nsubj,poss,NNP-NNP-CC-NNP-NNP,NNP,6,1
403,8836.0,48,BEIJING,0,38,9,-29,37,38,-38,9,National Development and Reform Commission,China,ORGANIZATION-ORGANIZATION-ORGANIZATION-ORGANIZATION-ORGANIZATION,COUNTRY,PROPN-PROPN-CCONJ-PROPN-PROPN,PROPN,nmod-nmod-cc-conj-pobj,nsubj,NNP-NNP-CC-NNP-NNP,NNP,3,1
404,10455.0,36,said,32,17,1,-16,16,34,15,-31,National Development and Reform Commission,China,ORGANIZATION-ORGANIZATION-ORGANIZATION-ORGANIZATION-ORGANIZATION,COUNTRY,PROPN-PROPN-CCONJ-PROPN-PROPN,PROPN,nmod-nmod-cc-conj-pobj,nsubj,NNP-NNP-CC-NNP-NNP,NNP,5,1
405,10666.0,33,released,17,9,1,-8,8,31,8,-16,National Development and Reform Commission,China,ORGANIZATION-ORGANIZATION-ORGANIZATION-ORGANIZATION-ORGANIZATION,COUNTRY,PROPN-PROPN-CCONJ-PROPN-PROPN,PROPN,nmod-nmod-cc-conj-appos,poss,NNP-NNP-CC-NNP-NNP,NNP,4,1
406,10918.0,43,said,37,2,8,6,1,34,35,-29,National Development and Reform Commission,China,ORGANIZATION-ORGANIZATION-ORGANIZATION-ORGANIZATION-ORGANIZATION,COUNTRY,PROPN-PROPN-CCONJ-PROPN-PROPN,PROPN,nmod-nmod-cc-conj-nsubj,poss,NNP-NNP-CC-NNP-NNP,NNP,4,1
407,11299.0,32,Zhenhua,1,10,19,9,9,12,-9,18,National Development and Reform Commission,China,ORGANIZATION-ORGANIZATION-ORGANIZATION-ORGANIZATION-ORGANIZATION,COUNTRY,PROPN-PROPN-CCONJ-PROPN-PROPN,PROPN,nmod-nmod-cc-conj-pobj,poss,NNP-NNP-CC-NNP-NNP,NNP,9,1
408,549.0,34,won,17,2,32,30,1,1,15,15,event,United States,ORGANIZATION,COUNTRY-COUNTRY,NOUN,PROPN-PROPN,nsubjpass,compound-appos,NN,NNP-NNP,10,1
409,555.0,35,served,1,29,8,-21,28,26,-28,7,he,Chongqing Municipal Judicial Bureau,PERSON,ORGANIZATION-ORGANIZATION-ORGANIZATION-ORGANIZATION,PRON,PROPN-PROPN-PROPN-PROPN,nsubjpass,compound-compound-compound-pobj,PRP,NNP-NNP-NNP-NNP,7,1
410,5788.0,37,accused,2,22,33,11,21,3,-20,31,he,Chongqing Municipal Judicial Bureau,PERSON,ORGANIZATION-ORGANIZATION-ORGANIZATION-ORGANIZATION,PRON,PROPN-PROPN-PROPN-PROPN,nsubj,compound-compound-compound-pobj,PRP,NNP-NNP-NNP-NNP,5,1
411,13150.0,42,accused,1,21,32,11,20,9,-20,31,he,Chongqing Municipal Judicial Bureau,PERSON,ORGANIZATION-ORGANIZATION-ORGANIZATION-ORGANIZATION,PRON,PROPN-PROPN-PROPN-PROPN,nsubj,compound-compound-compound-pobj,PRP,NNP-NNP-NNP-NNP,5,1
412,562.0,34,met,14,10,12,2,9,21,4,-2,association,Dawn Sweeney,ORGANIZATION,PERSON-PERSON,NOUN,PROPN-PROPN,pobj,compound-appos,NN,NNP-NNP,2,1
413,568.0,37,followed,2,24,34,10,23,2,-22,32,Bibi,hanging,PERSON,CAUSE_OF_DEATH,PROPN,VERB,nsubjpass,pcomp,NNP,VBG,16,1
414,574.0,27,says,15,17,20,3,16,6,-2,5,Sarah Kunstler,33,PERSON-PERSON,NUMBER,PROPN-PROPN,NUM,compound-nsubj,appos,NNP-NNP,CD,2,1
415,576.0,36,said,10,7,1,-6,6,34,3,-9,National Energy Administration,Zhang Guobao,ORGANIZATION-ORGANIZATION-ORGANIZATION,PERSON-PERSON,PROPN-PROPN-PROPN,PROPN-PROPN,compound-compound-pobj,compound-nsubj,NNP-NNP-NNP,NNP-NNP,4,1
416,694.0,36,said,18,28,20,-8,27,15,-10,2,National Energy Administration,Zhang Guobao,ORGANIZATION-ORGANIZATION-ORGANIZATION,PERSON-PERSON,PROPN-PROPN-PROPN,PROPN-PROPN,compound-compound-pobj,compound-nsubj,NNP-NNP-NNP,NNP-NNP,5,1
417,706.0,31,said,26,21,25,4,20,5,5,-1,National Energy Administration,Zhang Guobao,ORGANIZATION-ORGANIZATION-ORGANIZATION,PERSON-PERSON,PROPN-PROPN-PROPN,PROPN-PROPN,compound-compound-compound,compound-nsubj,NNP-NNP-NNP,NNP-NNP,3,1
418,1947.0,25,said,11,8,2,-6,7,22,3,-9,National Energy Administration,Zhang Guobao,ORGANIZATION-ORGANIZATION-ORGANIZATION,PERSON-PERSON,PROPN-PROPN-PROPN,PROPN-PROPN,compound-compound-pobj,compound-nsubj,NNP-NNP-NNP,NNP-NNP,4,1
419,2814.0,56,said,39,33,26,-7,32,29,6,-13,National Energy Administration,Zhang Guobao,ORGANIZATION-ORGANIZATION-ORGANIZATION,PERSON-PERSON,PROPN-PROPN-PROPN,PROPN-PROPN,compound-compound-pobj,compound-nsubj,NNP-NNP-NNP,NNP-NNP,5,1
420,3626.0,40,BEIJING,0,35,29,-6,34,10,-35,29,National Energy Administration,Zhang Guobao,ORGANIZATION-ORGANIZATION-ORGANIZATION,PERSON-PERSON,PROPN-PROPN-PROPN,PROPN-PROPN,compound-compound-pobj,compound-nsubj,NNP-NNP-NNP,NNP-NNP,5,1
421,6186.0,54,BEIJING,0,41,35,-6,40,18,-41,35,National Energy Administration,Zhang Guobao,ORGANIZATION-ORGANIZATION-ORGANIZATION,PERSON-PERSON,PROPN-PROPN-PROPN,PROPN-PROPN,compound-compound-pobj,compound-nsubj,NNP-NNP-NNP,NNP-NNP,4,1
422,6267.0,37,said,34,31,25,-6,30,11,3,-9,National Energy Administration,Zhang Guobao,ORGANIZATION-ORGANIZATION-ORGANIZATION,PERSON-PERSON,PROPN-PROPN-PROPN,PROPN-PROPN,compound-compound-pobj,compound-nsubj,NNP-NNP-NNP,NNP-NNP,4,1
423,6934.0,43,said,11,8,1,-7,7,41,3,-10,National Energy Administration,Zhang Guobao,ORGANIZATION-ORGANIZATION-ORGANIZATION,PERSON-PERSON,PROPN-PROPN-PROPN,PROPN-PROPN,compound-compound-pobj,compound-nsubj,NNP-NNP-NNP,NNP-NNP,4,1
424,6983.0,47,report,10,12,16,4,11,30,-2,6,National Energy Administration,Zhang Guobao,ORGANIZATION-ORGANIZATION-ORGANIZATION,PERSON-PERSON,PROPN-PROPN-PROPN,PROPN-PROPN,compound-compound-compound,compound-nsubj,NNP-NNP-NNP,NNP-NNP,3,1
425,7370.0,44,said,22,30,24,-6,29,19,-8,2,National Energy Administration,Zhang Guobao,ORGANIZATION-ORGANIZATION-ORGANIZATION,PERSON-PERSON,PROPN-PROPN-PROPN,PROPN-PROPN,compound-compound-pobj,compound-nsubj,NNP-NNP-NNP,NNP-NNP,8,1
426,10971.0,27,told,24,21,15,-6,20,11,3,-9,National Energy Administration,Zhang Guobao,ORGANIZATION-ORGANIZATION-ORGANIZATION,PERSON-PERSON,PROPN-PROPN-PROPN,PROPN-PROPN,compound-compound-pobj,compound-nsubj,NNP-NNP-NNP,NNP-NNP,4,1
427,11220.0,30,said,10,7,1,-6,6,28,3,-9,National Energy Administration,Zhang Guobao,ORGANIZATION-ORGANIZATION-ORGANIZATION,PERSON-PERSON,PROPN-PROPN-PROPN,PROPN-PROPN,compound-compound-pobj,compound-nsubj,NNP-NNP-NNP,NNP-NNP,4,1
428,11688.0,39,BEIJING,0,16,10,-6,15,28,-16,10,National Energy Administration,Zhang Guobao,ORGANIZATION-ORGANIZATION-ORGANIZATION,PERSON-PERSON,PROPN-PROPN-PROPN,PROPN-PROPN,compound-compound-pobj,compound-nsubj,NNP-NNP-NNP,NNP-NNP,4,1
429,11737.0,39,quoted,30,24,18,-6,23,20,6,-12,National Energy Administration,Zhang Guobao,ORGANIZATION-ORGANIZATION-ORGANIZATION,PERSON-PERSON,PROPN-PROPN-PROPN,PROPN-PROPN,compound-compound-pobj,compound-nsubjpass,NNP-NNP-NNP,NNP-NNP,4,1
430,12296.0,55,Ld-Writethru,1,19,13,-6,18,41,-18,12,National Energy Administration,Zhang Guobao,ORGANIZATION-ORGANIZATION-ORGANIZATION,PERSON-PERSON,PROPN-PROPN-PROPN,PROPN-PROPN,compound-compound-pobj,compound-nsubj,NNP-NNP-NNP,NNP-NNP,5,1
431,12457.0,56,told,13,7,1,-6,6,54,6,-12,National Energy Administration,Zhang Guobao,ORGANIZATION-ORGANIZATION-ORGANIZATION,PERSON-PERSON,PROPN-PROPN-PROPN,PROPN-PROPN,compound-compound-pobj,compound-nsubj,NNP-NNP-NNP,NNP-NNP,4,1
432,12715.0,37,said,11,20,13,-7,19,23,-9,2,National Energy Administration,Zhang Guobao,ORGANIZATION-ORGANIZATION-ORGANIZATION,PERSON-PERSON,PROPN-PROPN-PROPN,PROPN-PROPN,compound-compound-pobj,compound-nsubj,NNP-NNP-NNP,NNP-NNP,4,1
433,14157.0,43,said,15,24,17,-7,23,25,-9,2,National Energy Administration,Zhang Guobao,ORGANIZATION-ORGANIZATION-ORGANIZATION,PERSON-PERSON,PROPN-PROPN-PROPN,PROPN-PROPN,compound-compound-pobj,compound-nsubj,NNP-NNP-NNP,NNP-NNP,4,1
434,593.0,28,said,23,9,8,-1,8,19,14,-15,Alan Gross,contractor,PERSON-PERSON,TITLE,PROPN-PROPN,NOUN,compound-dobj,compound,NNP-NNP,NN,1,1
435,4819.0,38,HAVANA,0,25,24,-1,24,13,-25,24,Alan Gross,contractor,PERSON-PERSON,TITLE,PROPN-PROPN,NOUN,compound-pobj,compound,NNP-NNP,NN,1,1
436,7966.0,39,said,21,10,9,-1,9,29,11,-12,Alan Gross,contractor,PERSON-PERSON,TITLE,PROPN-PROPN,NOUN,compound-pobj,compound,NNP-NNP,NN,1,1
437,9374.0,51,arrested,20,15,13,-2,14,37,5,-7,Alan Gross,contractor,PERSON-PERSON,TITLE,PROPN-PROPN,NOUN,compound-appos,pobj,NNP-NNP,NN,4,1
438,13008.0,27,said,19,3,2,-1,2,24,16,-17,Alan Gross,contractor,PERSON-PERSON,TITLE,PROPN-PROPN,NOUN,compound-nsubj,compound,NNP-NNP,NN,1,1
439,598.0,51,says,16,5,39,34,4,11,11,23,Mario Gonzalez,liaison,PERSON-PERSON,TITLE,PROPN-PROPN,NOUN,compound-nsubj,pobj,NNP-NNP,NN,6,1
440,601.0,21,said,7,9,16,7,8,4,-2,9,his,she,PERSON,PERSON,DET,PRON,poss,nsubj,PRP$,PRP,5,1
441,602.0,35,issue,2,14,32,18,13,2,-12,30,Coastal Conservation League,he,ORGANIZATION-ORGANIZATION-ORGANIZATION,PERSON,PROPN-PROPN-PROPN,PRON,compound-compound-poss,nsubj,NNP-NNP-NNP,PRP,8,1
442,604.0,37,formed,18,1,20,19,0,16,17,2,Pluribus Capital Management,e5,ORGANIZATION-ORGANIZATION-ORGANIZATION,ORGANIZATION,PROPN-PROPN-PROPN,NOUN,compound-compound-nsubj,nsubj,NNP-NNP-NNP,NNS,3,1
443,605.0,41,said,39,2,18,16,1,22,37,-21,Pauliina,coach,PERSON,TITLE,PROPN,NOUN,nsubj,conj,NNP,NN,4,1
444,620.0,30,said,5,10,5,-5,9,24,-5,0,ALICO,AIG,ORGANIZATION,ORGANIZATION,PROPN,PROPN,dobj,nsubj,NNP,NNP,3,1
445,1116.0,21,ALICO,0,1,7,6,0,13,-1,7,ALICO,AIG,ORGANIZATION,ORGANIZATION,PROPN,PROPN,ROOT,pobj,NNP,NNP,3,1
446,2734.0,11,says,1,7,5,-2,6,5,-6,4,ALICO,AIG,ORGANIZATION,ORGANIZATION,PROPN,PROPN,dobj,compound,NNP,NNP,3,1
447,5740.0,25,said,1,7,1,-6,6,23,-6,0,ALICO,AIG,ORGANIZATION,ORGANIZATION,PROPN,PROPN,dobj,nsubj,NNP,NNP,2,1
448,5742.0,5,SELLS,1,3,1,-2,2,3,-2,0,ALICO,AIG,ORGANIZATION,ORGANIZATION,PROPN,PROPN,dobj,nsubj,NNP,NNP,2,1
449,6696.0,8,MOVES,1,7,1,-6,6,6,-6,0,ALICO,AIG,ORGANIZATION,ORGANIZATION,PROPN,PROPN,compound,nsubj,NNP,NNP,5,1
450,7757.0,34,said,32,25,14,-11,24,19,7,-18,ALICO,AIG,ORGANIZATION,ORGANIZATION,PROPN,PROPN,pobj,compound,NNP,NNP,5,1
451,7930.0,28,approved,6,4,16,12,3,11,2,10,ALICO,AIG,ORGANIZATION,ORGANIZATION,PROPN,PROPN,pobj,conj,NNP,NNP,2,1
452,12022.0,8,sold,1,3,1,-2,2,6,-2,0,ALICO,AIG,ORGANIZATION,ORGANIZATION,PROPN,PROPN,dobj,nsubj,NNP,NNP,1,1
453,12498.0,32,raised,18,11,18,7,10,13,7,0,ALICO,AIG,ORGANIZATION,ORGANIZATION,PROPN,PROPN,compound,nsubj,NNP,NNP,2,1
454,12505.0,13,says,3,9,7,-2,8,5,-6,4,ALICO,AIG,ORGANIZATION,ORGANIZATION,PROPN,PROPN,dobj,compound,NNP,NNP,2,1
455,13510.0,12,LONDON,0,7,5,-2,6,6,-7,5,ALICO,AIG,ORGANIZATION,ORGANIZATION,PROPN,PROPN,dobj,nsubj,NNP,NNP,6,1
456,13800.0,21,remain,4,3,10,7,2,10,1,6,ALICO,AIG,ORGANIZATION,ORGANIZATION,PROPN,PROPN,conj,pobj,NNP,NNP,2,1
457,14373.0,36,said,1,18,1,-17,17,34,-17,0,ALICO,AIG,ORGANIZATION,ORGANIZATION,PROPN,PROPN,appos,nsubj,NNP,NNP,6,1
458,15171.0,39,said,37,29,9,-20,28,29,8,-28,ALICO,AIG,ORGANIZATION,ORGANIZATION,PROPN,PROPN,pobj,nsubj,NNP,NNP,9,1
459,623.0,42,said,22,11,7,-4,10,34,11,-15,Bibi,Punjab,PERSON,STATE_OR_PROVINCE,PROPN,PROPN,nsubjpass,compound,NNP,NNP,2,1
460,7145.0,24,been,8,7,16,9,6,7,1,8,Bibi,Punjab,PERSON,COUNTRY,PROPN,PROPN,pobj,compound,NNP,NNP,5,1
461,10960.0,14,jailed,3,1,6,5,0,7,2,3,Bibi,Punjab,PERSON,STATE_OR_PROVINCE,PROPN,PROPN,nsubjpass,compound,NNP,NNP,3,1
462,625.0,26,said,24,5,10,5,4,15,19,-14,Moore,homicide,PERSON,CAUSE_OF_DEATH,PROPN,NOUN,poss,attr,NNP,NN,4,1
463,628.0,33,called,24,17,14,-3,16,18,7,-10,Silsby,Idaho,PERSON,STATE_OR_PROVINCE,PROPN,PROPN,nsubj,appos,NNP,NNP,6,1
464,12566.0,28,prompted,4,8,10,2,7,17,-4,6,Silsby,Idaho,PERSON,STATE_OR_PROVINCE,PROPN,PROPN,pobj,pobj,NNP,NNP,3,1
465,637.0,38,charged,8,5,20,15,4,17,3,12,Xie Caiping,illegal gambling,PERSON-PERSON,CRIMINAL_CHARGE-CRIMINAL_CHARGE,PROPN-PROPN,ADJ-NOUN,compound-appos,amod-compound,NNP-NNP,JJ-NN,5,1
466,3955.0,26,sentenced,9,7,20,13,6,5,2,11,Xie Caiping,illegal gambling,PERSON-PERSON,CRIMINAL_CHARGE-CRIMINAL_CHARGE,PROPN-PROPN,ADJ-NOUN,compound-nsubjpass,amod-compound,NNP-NNP,JJ-NN,4,1
467,6173.0,29,sentenced,12,7,23,16,6,5,5,11,Xie Caiping,illegal gambling,PERSON-PERSON,CRIMINAL_CHARGE-CRIMINAL_CHARGE,PROPN-PROPN,ADJ-NOUN,compound-appos,amod-compound,NNP-NNP,JJ-NN,4,1
468,13812.0,46,said,44,4,12,8,3,33,40,-32,Xie Caiping,illegal gambling,PERSON-PERSON,CRIMINAL_CHARGE-CRIMINAL_CHARGE,PROPN-PROPN,ADJ-NOUN,compound-nsubj,amod-compound,NNP-NNP,JJ-NN,5,1
469,643.0,38,said,36,5,16,11,4,21,31,-20,Eugenio Vagni,Sulu,PERSON-PERSON,LOCATION,PROPN-PROPN,PROPN,compound-nsubjpass,pobj,NNP-NNP,NNP,3,1
470,645.0,28,told,14,11,3,-8,10,24,3,-11,Third Guard Division,Leng Jiesong,ORGANIZATION-ORGANIZATION-ORGANIZATION,PERSON-PERSON,PROPN-PROPN-PROPN,PROPN-PROPN,compound-compound-pobj,compound-nsubj,NNP-NNP-NNP,NNP-NNP,4,1
471,3672.0,27,told,14,11,3,-8,10,23,3,-11,Third Guard Division,Leng Jiesong,ORGANIZATION-ORGANIZATION-ORGANIZATION,PERSON-PERSON,PROPN-PROPN-PROPN,PROPN-PROPN,compound-compound-pobj,compound-nsubj,NNP-NNP-NNP,NNP-NNP,4,1
472,662.0,26,became,9,16,24,8,15,1,-7,15,Organization of Asia - Pacific News Agencies,OANA,ORGANIZATION-ORGANIZATION-ORGANIZATION-ORGANIZATION-ORGANIZATION-ORGANIZATION-ORGANIZATION,ORGANIZATION,PROPN-ADP-PROPN-PUNCT-PROPN-PROPN-PROPN,PROPN,pobj-prep-compound-punct-compound-compound-pobj,compound,NNP-IN-NNP-HYPH-NNP-NNP-NNPS,NNP,5,1
473,5051.0,30,summit,3,15,23,8,14,6,-12,20,Organization of Asia - Pacific News Agencies,OANA,ORGANIZATION-ORGANIZATION-ORGANIZATION-ORGANIZATION-ORGANIZATION-ORGANIZATION-ORGANIZATION,ORGANIZATION,PROPN-ADP-PROPN-PUNCT-PROPN-PROPN-PROPN,PROPN,conj-prep-compound-punct-compound-compound-pobj,compound,NNP-IN-NNP-HYPH-NNP-NNP-NNPS,NNP,6,1
474,669.0,30,charged,2,1,13,12,0,16,1,11,Graham,kidnapping,PERSON,CRIMINAL_CHARGE,PROPN,NOUN,nsubjpass,pobj,NNP,NN,2,1
475,673.0,24,carried,5,22,14,-8,21,9,-17,9,Messina Denaro,Western Sicily,PERSON-PERSON,LOCATION-LOCATION,PROPN-PROPN,PROPN-PROPN,compound-pobj,compound-pobj,NNP-NNP,NNP-NNP,9,1
476,679.0,34,says,16,13,2,-11,12,31,3,-14,National Restaurant Association,Sheila Weiss,ORGANIZATION-ORGANIZATION-ORGANIZATION,PERSON-PERSON,PROPN-PROPN-PROPN,PROPN-PROPN,compound-compound-pobj,compound-nsubj,NNP-NNP-NNP,NNP-NNP,4,1
477,686.0,43,gave,14,5,11,6,4,31,9,-3,Hollister Inc.,85,ORGANIZATION-ORGANIZATION,NUMBER,PROPN-PROPN,NUM,compound-nsubj,nummod,NNP-NNP,CD,4,1
478,698.0,41,Anymore,11,16,15,-1,15,25,-5,4,Nir Rosen,Journalist,PERSON-PERSON,TITLE,PROPN-PROPN,PROPN,compound-ROOT,compound,NNP-NNP,NNP,2,1
479,2415.0,28,Rosen,2,2,1,-1,1,26,0,-1,Nir Rosen,Journalist,PERSON-PERSON,TITLE,PROPN-PROPN,PROPN,compound-ROOT,compound,NNP-NNP,NNP,1,1
480,2618.0,35,Anymore,5,10,9,-1,9,25,-5,4,Nir Rosen,Journalist,PERSON-PERSON,TITLE,PROPN-PROPN,PROPN,compound-ROOT,compound,NNP-NNP,NNP,2,1
481,12010.0,43,lived,3,2,1,-1,1,41,1,-2,Nir Rosen,Journalist,PERSON-PERSON,TITLE,PROPN-PROPN,PROPN,compound-nsubj,compound,NNP-NNP,NNP,1,1
482,13060.0,21,Anymore,11,16,15,-1,15,5,-5,4,Nir Rosen,Journalist,PERSON-PERSON,TITLE,PROPN-PROPN,PROPN,compound-ROOT,compound,NNP-NNP,NNP,2,1
483,699.0,45,plans,5,3,25,22,2,19,2,20,National Urban League,Arne Duncan,ORGANIZATION-ORGANIZATION-ORGANIZATION,PERSON-PERSON,PROPN-PROPN-PROPN,PROPN-PROPN,compound-compound-compound,compound-dobj,NNP-NNP-NNP,NNP-NNP,6,1
484,701.0,15,is,3,1,5,4,0,9,2,2,Michael L Lomax,president,PERSON-PERSON-PERSON,TITLE,PROPN-PROPN-PROPN,NOUN,compound-compound-nsubj,attr,NNP-NNP-NNP,NN,4,1
485,714.0,26,sells,9,5,6,1,4,19,4,-3,Baldino,founded,PERSON,TITLE,PROPN,VERB,nsubj,relcl,NNP,VBD,1,1
486,725.0,33,said,31,9,8,-1,8,24,22,-23,Eugenio Vagni,63-year-old,PERSON-PERSON,DURATION,PROPN-PROPN,NUM,compound-dobj,amod,NNP-NNP,CD,1,1
487,727.0,21,said,1,11,1,-10,10,19,-10,0,her,Lomax,PERSON,PERSON,DET,PROPN,poss,nsubj,PRP$,NNP,4,1
488,728.0,14,identified,5,11,8,-3,10,5,-6,3,Tamaihia Lynae Moore,infant,PERSON-PERSON-PERSON,NUMBER,PROPN-PROPN-PROPN,NOUN,compound-compound-pobj,dobj,NNP-NNP-NNP,NN,4,1
489,730.0,33,held,17,4,2,-2,3,30,13,-15,Shah Abdul Aziz,mediator,PERSON-PERSON-PERSON,TITLE,PROPN-PROPN-PROPN,NOUN,compound-compound-appos,nsubj,NNP-NNP-NNP,NN,3,1
490,737.0,43,ABIDJAN,0,23,20,-3,22,22,-23,20,Charles Ble Goude,Minister for Youth,PERSON-PERSON-PERSON,TITLE-TITLE-TITLE,PROPN-PROPN-PROPN,PROPN-ADP-PROPN,compound-compound-pobj,appos-prep-compound,NNP-NNP-NNP,NNP-IN-NNP,2,1
491,7674.0,28,NATIONS,1,16,13,-3,15,14,-15,12,Charles Ble Goude,Minister for Youth,PERSON-PERSON-PERSON,TITLE-TITLE-TITLE,PROPN-PROPN-PROPN,PROPN-ADP-PROPN,compound-compound-pobj,nsubj-prep-compound,NNP-NNP-NNP,NNP-IN-NNP,-1,1
492,740.0,40,collapsed,17,6,9,3,5,30,11,-8,Vladimir Ladyzhenskiy,Russia,PERSON-PERSON,COUNTRY,PROPN-PROPN,PROPN,compound-appos,pobj,NNP-NNP,NNP,1,1
493,1609.0,47,fall,2,24,27,3,23,19,-22,25,Vladimir Ladyzhenskiy,Russia,PERSON-PERSON,COUNTRY,PROPN-PROPN,PROPN,compound-conj,pobj,NNP-NNP,NNP,6,1
494,3429.0,30,died,4,1,4,3,0,25,3,0,Vladimir Ladyzhenskiy,Russia,PERSON-PERSON,COUNTRY,PROPN-PROPN,PROPN,compound-nsubj,pobj,NNP-NNP,NNP,1,1
495,3448.0,32,endured,13,9,12,3,8,19,4,-1,Vladimir Ladyzhenskiy,Russia,PERSON-PERSON,COUNTRY,PROPN-PROPN,PROPN,compound-conj,pobj,NNP-NNP,NNP,4,1
496,743.0,40,NTSO,5,1,9,8,0,30,4,4,National Taiwan Symphony Orchestra,Liu Suan-yung,ORGANIZATION-ORGANIZATION-ORGANIZATION-ORGANIZATION,PERSON-PERSON,PROPN-PROPN-PROPN-PROPN,PROPN-PROPN,compound-compound-compound-compound,compound-nsubj,NNP-NNP-NNP-NNP,NNP-NNP,4,1
497,7118.0,57,Taipei,0,18,26,8,17,30,-18,26,National Taiwan Symphony Orchestra,Liu Suan-yung,ORGANIZATION-ORGANIZATION-ORGANIZATION-ORGANIZATION,PERSON-PERSON,PROPN-PROPN-PROPN-PROPN,PROPN-PROPN,compound-compound-compound-compound,compound-nsubj,NNP-NNP-NNP-NNP,NNP-NNP,-1,1
498,753.0,50,make,19,6,6,0,5,43,13,-13,Tribeca Enterprises,Tribeca Film,ORGANIZATION-ORGANIZATION,ORGANIZATION-ORGANIZATION,PROPN-PROPN,PROPN-PROPN,compound-pobj,compound-appos,NNP-NNPS,NNP-NNP,0,1
499,775.0,38,said,18,36,35,-1,35,2,-18,17,Assaf Ramon,Lieutenant,PERSON-PERSON,TITLE,PROPN-PROPN,PROPN,compound-pobj,compound,NNP-NNP,NNP,2,1
500,6247.0,35,named,2,8,7,-1,7,27,-6,5,Assaf Ramon,Lieutenant,PERSON-PERSON,TITLE,PROPN-PROPN,PROPN,compound-pobj,compound,NNP-NNP,NNP,1,1
501,7499.0,32,named,2,8,7,-1,7,24,-6,5,Assaf Ramon,Lieutenant,PERSON-PERSON,TITLE,PROPN-PROPN,PROPN,compound-pobj,compound,NNP-NNP,NNP,1,1
502,9799.0,34,named,2,8,7,-1,7,26,-6,5,Assaf Ramon,Lieutenant,PERSON-PERSON,TITLE,PROPN-PROPN,PROPN,compound-pobj,compound,NNP-NNP,NNP,1,1
503,777.0,33,featured,7,14,31,17,13,1,-7,24,American Free Press,Willis Carto,ORGANIZATION-ORGANIZATION-ORGANIZATION,PERSON-PERSON,PROPN-PROPN-PROPN,PROPN-PROPN,compound-compound-pobj,compound-appos,NNP-NNP-NNP,NNP-NNP,3,1
504,10144.0,26,is,3,17,11,-6,16,14,-14,8,American Free Press,Willis Carto,ORGANIZATION-ORGANIZATION-ORGANIZATION,PERSON-PERSON,PROPN-PROPN-PROPN,PROPN-PROPN,compound-compound-dobj,compound-pobj,NNP-NNP-NNP,NNP-NNP,3,1
505,791.0,24,identified,3,12,7,-5,11,16,-9,4,Ruben van Assouw,Dutch,PERSON-PERSON-PERSON,NATIONALITY,PROPN-PROPN-PROPN,ADJ,compound-compound-pobj,amod,NNP-NNP-NNP,JJ,4,1
506,8130.0,35,Nine-year-old,0,4,2,-2,3,32,-4,2,Ruben van Assouw,Dutch,PERSON-PERSON-PERSON,NATIONALITY,PROPN-PROPN-PROPN,ADJ,compound-compound-nsubj,amod,NNP-NNP-NNP,JJ,1,1
507,8906.0,44,AFP,7,13,11,-2,12,32,-6,4,Ruben van Assouw,Dutch,PERSON-PERSON-PERSON,NATIONALITY,PROPN-PROPN-PROPN,ADJ,compound-compound-nsubj,amod,NNP-NNP-NNP,JJ,1,1
508,10458.0,45,said,43,14,12,-2,13,32,29,-31,Ruben van Assouw,Dutch,PERSON-PERSON-PERSON,NATIONALITY,PROPN-PROPN-PROPN,ADJ,compound-compound-nsubj,amod,NNP-NNP-NNP,JJ,1,1
509,12332.0,61,Writethru,2,27,5,-22,26,55,-25,3,Ruben van Assouw,Dutch,PERSON-PERSON-PERSON,NATIONALITY,PROPN-PROPN-PROPN,ADJ,compound-compound-pobj,amod,NNP-NNP-NNP,JJ,-1,1
510,794.0,32,declined,3,11,14,3,10,17,-8,11,Bibi,Christian,PERSON,RELIGION,PROPN,PROPN,nsubj,appos,NNP,NNP,3,1
511,7902.0,27,say,25,1,4,3,0,22,24,-21,Bibi,Christian,PERSON,RELIGION,PROPN,PROPN,nsubjpass,appos,NNP,NNP,3,1
512,804.0,41,is,5,25,17,-8,24,23,-20,12,she,president,PERSON,TITLE,PRON,NOUN,nsubj,compound,PRP,NN,3,1
513,813.0,29,kill,25,11,2,-9,10,26,14,-23,Gay Men 's Health Crisis,Rodger McFarlane,ORGANIZATION-ORGANIZATION-ORGANIZATION-ORGANIZATION-ORGANIZATION,PERSON-PERSON,PROPN-PROPN-PART-PROPN-PROPN,PROPN-PROPN,compound-poss-case-compound-pobj,compound-pobj,NNP-NNPS-POS-NNP-NNP,NNP-NNP,4,1
514,820.0,33,was,12,1,9,8,0,23,11,-3,Sarah Kunstler,co-filmmaker,PERSON-PERSON,TITLE,PROPN-PROPN,NOUN,compound-nsubj,conj,NNP-NNP,NN,3,1
515,821.0,42,said,22,11,7,-4,10,34,11,-15,Bibi,Punjab province,PERSON,LOCATION-LOCATION,PROPN,PROPN-NOUN,nsubjpass,compound-pobj,NNP,NNP-NN,2,1
516,825.0,17,said,3,11,14,3,10,2,-8,11,George Sodini,Carnegie,PERSON-PERSON,CITY,PROPN-PROPN,PROPN,compound-pobj,pobj,NNP-NNP,NNP,1,1
517,11398.0,30,says,10,15,20,5,14,9,-5,10,George Sodini,Carnegie,PERSON-PERSON,CITY,PROPN-PROPN,PROPN,compound-attr,pobj,NNP-NNP,NNP,2,1
518,827.0,38,http://www.opednews.com/maxwrite/link.php?id=53740,5,2,11,9,1,26,3,6,Jamie Leigh Jones,Halliburton,PERSON-PERSON-PERSON,ORGANIZATION,PROPN-PROPN-PROPN,PROPN,compound-compound-pobj,dobj,NNP-NNP-NNP,NNP,3,1
519,12545.0,38,http://www.opednews.com/maxwrite/link.php?id=53740,5,2,11,9,1,26,3,6,Jamie Leigh Jones,Halliburton,PERSON-PERSON-PERSON,ORGANIZATION,PROPN-PROPN-PROPN,PROPN,compound-compound-nsubj,dobj,NNP-NNP-NNP,NNP,3,1
520,830.0,41,attempting,13,25,8,-17,24,32,-12,-5,Countrywide Financial Group,Pacific Investment Management Co,ORGANIZATION-ORGANIZATION-ORGANIZATION,PERSON-PERSON-PERSON-PERSON,PROPN-PROPN-PROPN,PROPN-PROPN-PROPN-PROPN,compound-compound-pobj,compound-compound-compound-conj,NNP-NNP-NNP,NNP-NNP-NNP-NNP,15,1
521,832.0,36,include,1,3,27,24,2,8,-2,26,his,Sally,PERSON,PERSON,DET,PROPN,poss,conj,PRP$,NNP,4,1
522,8653.0,36,include,1,3,27,24,2,8,-2,26,his,Sally,PERSON,PERSON,DET,PROPN,poss,conj,PRP$,NNP,4,1
523,839.0,28,was,1,25,1,-24,24,26,-24,0,he,Xie,PERSON,PERSON,PRON,PROPN,nsubjpass,nsubj,PRP,NNP,12,1
524,844.0,19,shaking,6,1,4,3,0,14,5,-2,Knox,Edda Mellas,PERSON,PERSON-PERSON,PROPN,PROPN-PROPN,poss,compound-appos,NNP,NNP-NNP,3,1
525,5525.0,18,was,13,7,11,4,6,6,6,-2,Knox,Edda Mellas,PERSON,PERSON-PERSON,PROPN,PROPN-PROPN,poss,compound-appos,NNP,NNP-NNP,7,1
526,14573.0,50,are,3,38,42,4,37,7,-35,39,Knox,Edda Mellas,PERSON,PERSON-PERSON,PROPN,PROPN-PROPN,poss,compound-appos,NNP,NNP-NNP,3,1
527,14904.0,20,said,7,4,1,-3,3,18,3,-6,Knox,Edda Mellas,PERSON,PERSON-PERSON,PROPN,PROPN-PROPN,poss,compound-nsubj,NNP,NNP-NNP,3,1
528,859.0,28,attended,1,1,27,26,0,0,0,26,He,professor,PERSON,TITLE,PRON,NOUN,nsubj,pobj,PRP,NN,1,1
529,965.0,21,appointed,2,1,6,5,0,14,1,4,He,professor,PERSON,TITLE,PRON,NOUN,nsubjpass,oprd,PRP,NN,2,1
530,5339.0,28,attended,1,1,27,26,0,0,0,26,He,professor,PERSON,TITLE,PRON,NOUN,nsubj,pobj,PRP,NN,1,1
531,14565.0,28,said,14,2,22,20,1,5,12,8,He,professor,PERSON,TITLE,PRON,NOUN,nsubj,attr,PRP,NN,5,1
532,14905.0,21,appointed,2,1,6,5,0,14,1,4,He,professor,PERSON,TITLE,PRON,NOUN,nsubjpass,oprd,PRP,NN,2,1
533,867.0,27,reign,2,7,10,3,6,16,-5,8,Xie Caiping,46,PERSON-PERSON,NUMBER,PROPN-PROPN,NUM,compound-nsubjpass,appos,NNP-NNP,CD,2,1
534,1730.0,29,accused,2,14,17,3,13,11,-12,15,Xie Caiping,46,PERSON-PERSON,NUMBER,PROPN-PROPN,NUM,compound-npadvmod,appos,NNP-NNP,CD,4,1
535,2123.0,29,sentenced,12,7,10,3,6,18,5,-2,Xie Caiping,46,PERSON-PERSON,NUMBER,PROPN-PROPN,NUM,compound-appos,appos,NNP-NNP,CD,3,1
536,4899.0,33,detained,2,18,21,3,17,11,-16,19,Xie Caiping,46,PERSON-PERSON,NUMBER,PROPN-PROPN,NUM,compound-npadvmod,appos,NNP-NNP,CD,4,1
537,5572.0,33,detained,2,18,21,3,17,11,-16,19,Xie Caiping,46,PERSON-PERSON,NUMBER,PROPN-PROPN,NUM,compound-npadvmod,appos,NNP-NNP,CD,4,1
538,6616.0,30,said,28,1,4,3,0,25,27,-24,Xie Caiping,46,PERSON-PERSON,NUMBER,PROPN-PROPN,NUM,compound-nsubjpass,appos,NNP-NNP,CD,2,1
539,7218.0,36,accused,10,21,24,3,20,11,-11,14,Xie Caiping,46,PERSON-PERSON,NUMBER,PROPN-PROPN,NUM,compound-npadvmod,appos,NNP-NNP,CD,4,1
540,7380.0,46,said,44,4,7,3,3,38,40,-37,Xie Caiping,46,PERSON-PERSON,NUMBER,PROPN-PROPN,NUM,compound-nsubj,appos,NNP-NNP,CD,2,1
541,8135.0,30,sentenced,12,7,10,3,6,19,5,-2,Xie Caiping,46,PERSON-PERSON,NUMBER,PROPN-PROPN,NUM,compound-appos,appos,NNP-NNP,CD,3,1
542,13850.0,34,detained,3,19,22,3,18,11,-16,19,Xie Caiping,46,PERSON-PERSON,NUMBER,PROPN-PROPN,NUM,compound-npadvmod,appos,NNP-NNP,CD,4,1
543,868.0,35,pronounced,13,19,6,-13,18,28,-6,-7,he,wrestler,PERSON,TITLE,PRON,NOUN,nsubj,appos,PRP,NN,5,1
544,873.0,25,convicted,4,8,6,-2,7,18,-4,2,Laura Silsby,American,PERSON-PERSON,NATIONALITY,PROPN-PROPN,ADJ,compound-dobj,amod,NNP-NNP,JJ,1,1
545,7587.0,24,says,3,7,5,-2,6,18,-4,2,Laura Silsby,American,PERSON-PERSON,NATIONALITY,PROPN-PROPN,ADJ,compound-nsubj,amod,NNP-NNP,JJ,1,1
546,9988.0,37,appeared,28,4,12,8,3,24,24,-16,Laura Silsby,American,PERSON-PERSON,NATIONALITY,PROPN-PROPN,ADJ,compound-nsubj,amod,NNP-NNP,JJ,6,1
547,881.0,29,found,14,1,5,4,0,23,13,-9,Wen Qiang,deputy director,PERSON-PERSON,TITLE-TITLE,PROPN-PROPN,NOUN-NOUN,compound-nsubjpass,compound-appos,NNP-NNP,NN-NN,1,1
548,3141.0,40,said,38,7,12,5,6,27,31,-26,Wen Qiang,deputy director,PERSON-PERSON,TITLE-TITLE,PROPN-PROPN,NOUN-NOUN,compound-nsubjpass,compound-appos,NNP-NNP,NN-NN,1,1
549,3383.0,44,accused,15,1,5,4,0,38,14,-10,Wen Qiang,deputy director,PERSON-PERSON,TITLE-TITLE,PROPN-PROPN,NOUN-NOUN,compound-nsubjpass,compound-appos,NNP-NNP,NN-NN,1,1
550,11707.0,41,said,39,7,12,5,6,28,32,-27,Wen Qiang,deputy director,PERSON-PERSON,TITLE-TITLE,PROPN-PROPN,NOUN-NOUN,compound-nsubjpass,compound-appos,NNP-NNP,NN-NN,1,1
551,12541.0,36,detained,30,7,12,5,6,23,23,-18,Wen Qiang,deputy director,PERSON-PERSON,TITLE-TITLE,PROPN-PROPN,NOUN-NOUN,compound-nsubjpass,compound-appos,NNP-NNP,NN-NN,1,1
552,13449.0,44,accused,15,1,5,4,0,38,14,-10,Wen Qiang,deputy director,PERSON-PERSON,TITLE-TITLE,PROPN-PROPN,NOUN-NOUN,compound-nsubjpass,compound-appos,NNP-NNP,NN-NN,1,1
553,15253.0,48,said,46,14,19,5,13,28,32,-27,Wen Qiang,deputy director,PERSON-PERSON,TITLE-TITLE,PROPN-PROPN,NOUN-NOUN,compound-nsubjpass,compound-appos,NNP-NNP,NN-NN,1,1
554,897.0,44,said,28,14,43,29,13,0,14,15,Koch Foods Inc.,Michigan,ORGANIZATION-ORGANIZATION-ORGANIZATION,STATE_OR_PROVINCE,PROPN-PROPN-PROPN,PROPN,compound-compound-poss,conj,NNP-NNP-NNP,NNP,14,1
555,898.0,22,says,6,11,17,6,10,4,-5,11,Natalie Hagemo,Shelby,PERSON-PERSON,PERSON,PROPN-PROPN,PROPN,compound-pobj,compound,NNP-NNP,NNP,2,1
556,902.0,39,given,3,17,21,4,16,17,-14,18,Jamie Leigh Jones,Conroe,PERSON-PERSON-PERSON,CITY,PROPN-PROPN-PROPN,PROPN,compound-compound-pobj,pobj,NNP-NNP-NNP,NNP,4,1
557,906.0,26,ruled,8,15,2,-13,14,23,-7,-6,Cerniglia,New York City,PERSON,CITY-CITY-CITY,PROPN,PROPN-PROPN-PROPN,nsubj,compound-nmod-nmod,NNP,NNP-NNP-NNP,8,1
558,3868.0,31,found,7,4,25,21,3,5,3,18,Cerniglia,New York City,PERSON,CITY-CITY-CITY,PROPN,PROPN-PROPN-PROPN,poss,compound-compound-dobj,NNP,NNP-NNP-NNP,9,1
559,6660.0,27,said,15,22,8,-14,21,18,-7,-7,Cerniglia,New York City,PERSON,CITY-CITY-CITY,PROPN,PROPN-PROPN-PROPN,poss,compound-nmod-nmod,NNP,NNP-NNP-NNP,11,1
560,12184.0,26,said,15,21,8,-13,20,17,-6,-7,Cerniglia,New York City,PERSON,CITY-CITY-CITY,PROPN,PROPN-PROPN-PROPN,poss,compound-nmod-nmod,NNP,NNP-NNP-NNP,11,1
561,910.0,20,was,14,1,12,11,0,7,13,-2,Aquash,Nova Scotia,PERSON,STATE_OR_PROVINCE-STATE_OR_PROVINCE,PROPN,PROPN-PROPN,nsubj,compound-pobj,NNP,NNP-NNP,6,1
562,11590.0,23,was,14,1,12,11,0,10,13,-2,Aquash,Nova Scotia,PERSON,STATE_OR_PROVINCE-STATE_OR_PROVINCE,PROPN,PROPN-PROPN,nsubj,compound-pobj,NNP,NNP-NNP,6,1
563,913.0,24,says,10,7,1,-6,6,22,3,-9,Aquash,Denise Maloney Pictou,PERSON,PERSON-PERSON-PERSON,PROPN,PROPN-PROPN-PROPN,poss,compound-compound-nsubj,NNP,NNP-NNP-NNP,6,1
564,8964.0,13,testified,10,1,6,5,0,6,9,-4,Aquash,Denise Maloney Pictou,PERSON,PERSON-PERSON-PERSON,PROPN,PROPN-PROPN-PROPN,poss,compound-compound-appos,NNP,NNP-NNP-NNP,4,1
565,12937.0,18,embraced,13,1,5,4,0,12,12,-8,Aquash,Denise Maloney Pictou,PERSON,PERSON-PERSON-PERSON,PROPN,PROPN-PROPN-PROPN,poss,compound-compound-appos,NNP,NNP-NNP-NNP,4,1
566,915.0,26,sentenced,9,7,24,17,6,1,2,15,Xie Caiping,drug dealing,PERSON-PERSON,CRIMINAL_CHARGE-CRIMINAL_CHARGE,PROPN-PROPN,NOUN-NOUN,compound-nsubjpass,compound-conj,NNP-NNP,NN-NN,8,1
567,2489.0,29,sentenced,12,7,27,20,6,1,5,15,Xie Caiping,drug dealing,PERSON-PERSON,CRIMINAL_CHARGE-CRIMINAL_CHARGE,PROPN-PROPN,NOUN-NOUN,compound-appos,compound-conj,NNP-NNP,NN-NN,8,1
568,4076.0,26,sentenced,9,7,24,17,6,1,2,15,Xie Caiping,drug dealing,PERSON-PERSON,CRIMINAL_CHARGE-CRIMINAL_CHARGE,PROPN-PROPN,NOUN-NOUN,compound-nsubjpass,compound-conj,NNP-NNP,NN-NN,8,1
569,10162.0,30,sentenced,12,7,28,21,6,1,5,16,Xie Caiping,drug dealing,PERSON-PERSON,CRIMINAL_CHARGE-CRIMINAL_CHARGE,PROPN-PROPN,NOUN-NOUN,compound-appos,compound-pobj,NNP-NNP,NN-NN,9,1
570,923.0,25,split,6,11,9,-2,10,15,-5,3,Alico,AIA,ORGANIZATION,ORGANIZATION,PROPN,PROPN,conj,dobj,NNP,NNP,3,1
571,6002.0,46,signaled,2,14,12,-2,13,33,-12,10,Alico,AIA,ORGANIZATION,ORGANIZATION,PROPN,PROPN,conj,pobj,NNP,NNP,5,1
572,931.0,37,kidnapped,6,1,4,3,0,32,5,-2,Gonzalez,attorney,PERSON,TITLE,PROPN,NOUN,nsubjpass,appos,NNP,NN,3,1
573,4762.0,18,------,0,2,4,2,1,13,-2,4,Gonzalez,attorney,PERSON,TITLE,PROPN,NOUN,nsubj,compound,NNP,NN,1,1
574,6055.0,17,was,1,1,3,2,0,13,0,2,Gonzalez,attorney,PERSON,TITLE,PROPN,NOUN,nsubj,compound,NNP,NN,1,1
575,12933.0,38,kidnapped,6,1,4,3,0,33,5,-2,Gonzalez,attorney,PERSON,TITLE,PROPN,NOUN,nsubjpass,appos,NNP,NN,3,1
576,13116.0,38,kidnapped,6,1,4,3,0,33,5,-2,Gonzalez,attorney,PERSON,TITLE,PROPN,NOUN,nsubjpass,appos,NNP,NN,3,1
577,933.0,42,accused,27,4,10,6,3,31,23,-17,Amanda Knox,Seattle,PERSON-PERSON,CITY,PROPN-PROPN,PROPN,compound-appos,pobj,NNP-NNP,NNP,2,1
578,12200.0,24,say,1,12,15,3,11,8,-11,14,Amanda Knox,Seattle,PERSON-PERSON,CITY,PROPN-PROPN,PROPN,compound-ROOT,pobj,NNP-NNP,NNP,3,1
579,13753.0,34,is,9,1,8,7,0,25,8,-1,Amanda Knox,Seattle,PERSON-PERSON,CITY,PROPN-PROPN,PROPN,compound-nsubj,pobj,NNP-NNP,NNP,2,1
580,14920.0,35,told,6,1,4,3,0,30,5,-2,Amanda Knox,Seattle,PERSON-PERSON,CITY,PROPN-PROPN,PROPN,compound-nsubj,pobj,NNP-NNP,NNP,2,1
581,14948.0,17,crossed-examined,13,8,11,3,7,5,5,-2,Amanda Knox,Seattle,PERSON-PERSON,CITY,PROPN-PROPN,PROPN,compound-nsubjpass,pobj,NNP-NNP,NNP,2,1
582,947.0,29,62-year-old,1,3,2,-1,2,26,-2,1,Vagni,62-year-old,PERSON,NUMBER,PROPN,NUM,nsubj,ROOT,NNP,CD,1,1
583,948.0,30,graduated,1,1,21,20,0,8,0,20,Sodini,systems analyst,PERSON,TITLE-TITLE,PROPN,NOUN-NOUN,nsubj,compound-pobj,NNP,NNS-NN,3,1
584,951.0,39,said,23,36,25,-11,35,13,-13,2,National Restaurant Association,John Gay,ORGANIZATION-ORGANIZATION-ORGANIZATION,PERSON-PERSON,PROPN-PROPN-PROPN,PROPN-PROPN,compound-compound-pobj,compound-nsubj,NNP-NNP-NNP,NNP-NNP,7,1
585,8132.0,41,said,32,38,34,-4,37,6,-6,2,National Restaurant Association,John Gay,ORGANIZATION-ORGANIZATION-ORGANIZATION,PERSON-PERSON,PROPN-PROPN-PROPN,PROPN-PROPN,compound-compound-pobj,compound-nsubj,NNP-NNP-NNP,NNP-NNP,4,1
586,8769.0,29,said,16,26,18,-8,25,10,-10,2,National Restaurant Association,John Gay,ORGANIZATION-ORGANIZATION-ORGANIZATION,PERSON-PERSON,PROPN-PROPN-PROPN,PROPN-PROPN,compound-compound-pobj,compound-nsubj,NNP-NNP-NNP,NNP-NNP,5,1
587,12317.0,12,said,0,9,2,-7,8,9,-9,2,National Restaurant Association,John Gay,ORGANIZATION-ORGANIZATION-ORGANIZATION,PERSON-PERSON,PROPN-PROPN-PROPN,PROPN-PROPN,compound-compound-pobj,compound-nsubj,NNP-NNP-NNP,NNP-NNP,4,1
588,12996.0,56,said,31,40,33,-7,39,22,-9,2,National Restaurant Association,John Gay,ORGANIZATION-ORGANIZATION-ORGANIZATION,PERSON-PERSON,PROPN-PROPN-PROPN,PROPN-PROPN,compound-compound-pobj,compound-nsubj,NNP-NNP-NNP,NNP-NNP,5,1
589,14240.0,70,said,17,3,16,13,2,53,14,-1,National Restaurant Association,John Gay,ORGANIZATION-ORGANIZATION-ORGANIZATION,PERSON-PERSON,PROPN-PROPN-PROPN,PROPN-PROPN,compound-compound-compound,compound-nsubj,NNP-NNP-NNP,NNP-NNP,5,1
590,952.0,25,Known,0,3,7,4,2,17,-3,7,ALICO,American Life Insurance Co.,ORGANIZATION,ORGANIZATION-ORGANIZATION-ORGANIZATION-ORGANIZATION,PROPN,PROPN-PROPN-PROPN-PROPN,pobj,compound-compound-compound-conj,NNP,NNP-NNP-NNP-NNP,3,1
591,2758.0,30,include,1,23,8,-15,22,21,-22,7,ALICO,American Life Insurance Co.,ORGANIZATION,ORGANIZATION-ORGANIZATION-ORGANIZATION-ORGANIZATION,PROPN,PROPN-PROPN-PROPN-PROPN,conj,compound-compound-compound-conj,NNP,NNP-NNP-NNP-NNP,5,1
592,6320.0,35,was,13,12,5,-7,11,29,1,-8,ALICO,American Life Insurance Co.,ORGANIZATION,ORGANIZATION-ORGANIZATION-ORGANIZATION-ORGANIZATION,PROPN,PROPN-PROPN-PROPN-PROPN,pobj,compound-compound-compound-pobj,NNP,NNP-NNP-NNP-NNP,5,1
593,6343.0,18,closed,1,14,8,-6,13,9,-13,7,ALICO,American Life Insurance Co.,ORGANIZATION,ORGANIZATION-ORGANIZATION-ORGANIZATION-ORGANIZATION,PROPN,PROPN-PROPN-PROPN-PROPN,conj,compound-compound-compound-pobj,NNP,NNP-NNP-NNP-NNP,4,1
594,10253.0,39,said,37,29,22,-7,28,16,8,-15,ALICO,American Life Insurance Co.,ORGANIZATION,ORGANIZATION-ORGANIZATION-ORGANIZATION-ORGANIZATION,PROPN,PROPN-PROPN-PROPN-PROPN,pobj,compound-compound-compound-appos,NNP,NNP-NNP-NNP-NNP,3,1
595,12411.0,31,shedding,3,22,5,-17,21,25,-19,2,ALICO,American Life Insurance Co.,ORGANIZATION,ORGANIZATION-ORGANIZATION-ORGANIZATION-ORGANIZATION,PROPN,PROPN-PROPN-PROPN-PROPN,pobj,compound-compound-compound-conj,NNP,NNP-NNP-NNP-NNP,4,1
596,960.0,43,convicted,14,9,5,-4,8,37,5,-9,Wen Qiang,Chongqing Municipal Judicial Bureau,PERSON-PERSON,ORGANIZATION-ORGANIZATION-ORGANIZATION-ORGANIZATION,PROPN-PROPN,PROPN-PROPN-PROPN-PROPN,compound-pobj,compound-compound-compound-compound,NNP-NNP,NNP-NNP-NNP-NNP,2,1
597,1883.0,40,deliver,9,14,2,-12,13,37,-5,-7,Wen Qiang,Chongqing Municipal Judicial Bureau,PERSON-PERSON,ORGANIZATION-ORGANIZATION-ORGANIZATION-ORGANIZATION,PROPN-PROPN,PROPN-PROPN-PROPN-PROPN,compound-pobj,compound-compound-compound-pobj,NNP-NNP,NNP-NNP-NNP-NNP,6,1
598,2919.0,23,convicted,15,1,10,9,0,12,14,-5,Wen Qiang,Chongqing Municipal Judicial Bureau,PERSON-PERSON,ORGANIZATION-ORGANIZATION-ORGANIZATION-ORGANIZATION,PROPN-PROPN,PROPN-PROPN-PROPN-PROPN,compound-nsubjpass,compound-compound-compound-pobj,NNP-NNP,NNP-NNP-NNP-NNP,4,1
599,3550.0,37,deliver,6,11,18,7,10,18,-5,12,Wen Qiang,Chongqing Municipal Judicial Bureau,PERSON-PERSON,ORGANIZATION-ORGANIZATION-ORGANIZATION-ORGANIZATION,PROPN-PROPN,PROPN-PROPN-PROPN-PROPN,compound-pobj,compound-compound-compound-pobj,NNP-NNP,NNP-NNP-NNP-NNP,4,1
600,3901.0,40,accused,16,1,10,9,0,29,15,-6,Wen Qiang,Chongqing Municipal Judicial Bureau,PERSON-PERSON,ORGANIZATION-ORGANIZATION-ORGANIZATION-ORGANIZATION,PROPN-PROPN,PROPN-PROPN-PROPN-PROPN,compound-nsubjpass,compound-compound-compound-pobj,NNP-NNP,NNP-NNP-NNP-NNP,4,1
601,6884.0,32,executed,5,7,16,9,6,15,-2,11,Wen Qiang,Chongqing Municipal Judicial Bureau,PERSON-PERSON,ORGANIZATION-ORGANIZATION-ORGANIZATION-ORGANIZATION,PROPN-PROPN,PROPN-PROPN-PROPN-PROPN,compound-dobj,compound-compound-compound-pobj,NNP-NNP,NNP-NNP-NNP-NNP,4,1
602,8842.0,46,said,5,7,35,28,6,10,-2,30,Wen Qiang,Chongqing Municipal Judicial Bureau,PERSON-PERSON,ORGANIZATION-ORGANIZATION-ORGANIZATION-ORGANIZATION,PROPN-PROPN,PROPN-PROPN-PROPN-PROPN,compound-nsubj,compound-compound-compound-pobj,NNP-NNP,NNP-NNP-NNP-NNP,7,1
603,9256.0,33,executed,18,15,10,-5,14,22,3,-8,Wen Qiang,Chongqing Municipal Judicial Bureau,PERSON-PERSON,ORGANIZATION-ORGANIZATION-ORGANIZATION-ORGANIZATION,PROPN-PROPN,PROPN-PROPN-PROPN-PROPN,compound-appos,compound-compound-compound-pobj,NNP-NNP,NNP-NNP-NNP-NNP,4,1
604,10033.0,46,accused,16,1,10,9,0,35,15,-6,Wen Qiang,Chongqing Municipal Judicial Bureau,PERSON-PERSON,ORGANIZATION-ORGANIZATION-ORGANIZATION-ORGANIZATION,PROPN-PROPN,PROPN-PROPN-PROPN-PROPN,compound-nsubjpass,compound-compound-compound-pobj,NNP-NNP,NNP-NNP-NNP-NNP,4,1
605,12514.0,39,executed,12,14,23,9,13,15,-2,11,Wen Qiang,Chongqing Municipal Judicial Bureau,PERSON-PERSON,ORGANIZATION-ORGANIZATION-ORGANIZATION-ORGANIZATION,PROPN-PROPN,PROPN-PROPN-PROPN-PROPN,compound-dobj,compound-compound-compound-pobj,NNP-NNP,NNP-NNP-NNP-NNP,4,1
606,13189.0,58,were,11,35,42,7,34,15,-24,31,Wen Qiang,Chongqing Municipal Judicial Bureau,PERSON-PERSON,ORGANIZATION-ORGANIZATION-ORGANIZATION-ORGANIZATION,PROPN-PROPN,PROPN-PROPN-PROPN-PROPN,compound-conj,compound-compound-compound-pobj,NNP-NNP,NNP-NNP-NNP-NNP,4,1
607,964.0,32,said,15,3,2,-1,2,29,12,-13,Chen Tao,Professor,PERSON-PERSON,TITLE,PROPN-PROPN,PROPN,compound-nsubj,compound,NNP-NNP,NNP,1,1
608,967.0,32,comes,2,12,11,-1,11,20,-10,9,Wen Qiang,chief,PERSON-PERSON,TITLE,PROPN-PROPN,NOUN,compound-appos,nsubj,NNP-NNP,NN,1,1
609,968.0,36,accused,10,21,34,13,20,1,-11,24,Xie Caiping,Chinese,PERSON-PERSON,NATIONALITY,PROPN-PROPN,ADJ,compound-npadvmod,amod,NNP-NNP,JJ,6,1
610,5601.0,33,detained,2,18,31,13,17,1,-16,29,Xie Caiping,Chinese,PERSON-PERSON,NATIONALITY,PROPN-PROPN,ADJ,compound-npadvmod,amod,NNP-NNP,JJ,6,1
611,970.0,40,is,12,8,12,4,7,27,4,0,New Fabris,France,ORGANIZATION-ORGANIZATION,COUNTRY,PROPN-PROPN,PROPN,compound-pobj,pobj,NNP-NNP,NNP,5,1
612,3800.0,32,linked,2,16,20,4,15,11,-14,18,New Fabris,France,ORGANIZATION-ORGANIZATION,COUNTRY,PROPN-PROPN,PROPN,compound-appos,pobj,NNP-NNP,NNP,4,1
613,10171.0,65,threat,3,34,42,8,33,22,-31,39,New Fabris,France,ORGANIZATION-ORGANIZATION,COUNTRY,PROPN-PROPN,PROPN,compound-compound,poss,NNP-NNP,NNP,6,1
614,975.0,33,said,6,15,18,3,14,14,-9,12,Sandra Herold,Stamford,PERSON-PERSON,CITY,PROPN-PROPN,PROPN,compound-nsubj,pobj,NNP-NNP,NNP,1,1
615,5791.0,19,said,5,14,18,4,13,0,-9,13,Sandra Herold,Stamford,PERSON-PERSON,CITY,PROPN-PROPN,PROPN,compound-pobj,pobj,NNP-NNP,NNP,4,1
616,7561.0,24,said,5,12,15,3,11,8,-7,10,Sandra Herold,Stamford,PERSON-PERSON,CITY,PROPN-PROPN,PROPN,compound-nsubj,pobj,NNP-NNP,NNP,2,1
617,9752.0,32,went,8,17,31,14,16,0,-9,23,Sandra Herold,Stamford,PERSON-PERSON,CITY,PROPN-PROPN,PROPN,compound-appos,pobj,NNP-NNP,NNP,8,1
618,10278.0,32,affect,5,21,24,3,20,7,-16,19,Sandra Herold,Stamford,PERSON-PERSON,CITY,PROPN-PROPN,PROPN,compound-appos,pobj,NNP-NNP,NNP,3,1
619,14504.0,40,occurred,4,16,37,21,15,2,-12,33,Sandra Herold,Stamford,PERSON-PERSON,CITY,PROPN-PROPN,PROPN,compound-appos,pobj,NNP-NNP,NNP,9,1
620,976.0,34,urged,19,14,11,-3,13,22,5,-8,Charles Ble Goude,Minister,PERSON-PERSON-PERSON,TITLE,PROPN-PROPN-PROPN,PROPN,compound-compound-pobj,appos,NNP-NNP-NNP,NNP,2,1
621,5261.0,37,urged,6,4,1,-3,3,35,2,-5,Charles Ble Goude,Minister,PERSON-PERSON-PERSON,TITLE,PROPN-PROPN-PROPN,PROPN,compound-compound-pobj,nsubj,NNP-NNP-NNP,NNP,2,1
622,6955.0,41,urged,17,12,9,-3,11,31,5,-8,Charles Ble Goude,Minister,PERSON-PERSON-PERSON,TITLE,PROPN-PROPN-PROPN,PROPN,compound-compound-pobj,nsubj,NNP-NNP-NNP,NNP,3,1
623,9150.0,18,urged,9,6,3,-3,5,14,3,-6,Charles Ble Goude,Minister,PERSON-PERSON-PERSON,TITLE,PROPN-PROPN-PROPN,PROPN,compound-compound-pobj,nsubj,NNP-NNP-NNP,NNP,-1,1
624,10254.0,35,holding,17,12,9,-3,11,25,5,-8,Charles Ble Goude,Minister,PERSON-PERSON-PERSON,TITLE,PROPN-PROPN-PROPN,PROPN,compound-compound-pobj,appos,NNP-NNP-NNP,NNP,2,1
625,10478.0,41,said,4,23,20,-3,22,20,-19,16,Charles Ble Goude,Minister,PERSON-PERSON-PERSON,TITLE,PROPN-PROPN-PROPN,PROPN,compound-compound-pobj,appos,NNP-NNP-NNP,NNP,2,1
626,13488.0,36,was,1,20,19,-1,19,16,-19,18,Charles Ble Goude,Minister,PERSON-PERSON-PERSON,TITLE,PROPN-PROPN-PROPN,PROPN,compound-compound-appos,compound,NNP-NNP-NNP,NNP,2,1
627,985.0,39,said,1,8,15,7,7,23,-7,14,ALICO,Prudential,ORGANIZATION,ORGANIZATION,PROPN,PROPN,pobj,pobj,NNP,NNP,6,1
628,996.0,58,held,5,18,24,6,17,33,-13,19,National Taiwan Symphony Orchestra,NTSO,ORGANIZATION-ORGANIZATION-ORGANIZATION-ORGANIZATION,ORGANIZATION,PROPN-PROPN-PROPN-PROPN,PROPN,compound-compound-compound-poss,poss,NNP-NNP-NNP-NNP,NNP,3,1
629,1538.0,58,held,5,18,24,6,17,33,-13,19,National Taiwan Symphony Orchestra,NTSO,ORGANIZATION-ORGANIZATION-ORGANIZATION-ORGANIZATION,ORGANIZATION,PROPN-PROPN-PROPN-PROPN,PROPN,compound-compound-compound-poss,poss,NNP-NNP-NNP-NNP,NNP,3,1
630,2893.0,40,NTSO,5,1,6,5,0,33,4,1,National Taiwan Symphony Orchestra,NTSO,ORGANIZATION-ORGANIZATION-ORGANIZATION-ORGANIZATION,ORGANIZATION,PROPN-PROPN-PROPN-PROPN,PROPN,compound-compound-compound-compound,ROOT,NNP-NNP-NNP-NNP,NNP,3,1
631,4467.0,31,Festival,4,8,13,5,7,17,-4,9,National Taiwan Symphony Orchestra,NTSO,ORGANIZATION-ORGANIZATION-ORGANIZATION-ORGANIZATION,ORGANIZATION,PROPN-PROPN-PROPN-PROPN,PROPN,compound-compound-compound-pobj,compound,NNP-NNP-NNP-NNP,NNP,-1,1
632,12774.0,31,Festival,4,8,13,5,7,17,-4,9,National Taiwan Symphony Orchestra,NTSO,ORGANIZATION-ORGANIZATION-ORGANIZATION-ORGANIZATION,ORGANIZATION,PROPN-PROPN-PROPN-PROPN,PROPN,compound-compound-compound-pobj,compound,NNP-NNP-NNP-NNP,NNP,-1,1
633,1001.0,11,born,2,1,4,3,0,6,1,2,Lange,"July 23 , 1957",PERSON,DATE-DATE-DATE-DATE,PROPN,PROPN-NUM-PUNCT-NUM,nsubjpass,npadvmod-nummod-punct-nummod,NNP,"NNP-CD-,-CD",3,1
634,1002.0,24,gave,9,15,20,5,14,3,-6,11,he,UN,PERSON,ORGANIZATION,PRON,PROPN,nsubj,nmod,PRP,NNP,3,1
635,1005.0,58,became,31,2,6,4,1,51,29,-25,his,British,PERSON,NATIONALITY,DET,ADJ,poss,conj,PRP$,JJ,1,1
636,1008.0,39,is,4,1,10,9,0,28,3,6,Sycamore Valley Ranch Co.,Jackson,ORGANIZATION-ORGANIZATION-ORGANIZATION-ORGANIZATION,PERSON,PROPN-PROPN-PROPN-PROPN,PROPN,compound-compound-compound-nsubj,pobj,NNP-NNP-NNP-NNP,NNP,6,1
637,1009.0,47,says,3,45,37,-8,44,9,-42,34,his,Judy,PERSON,PERSON,DET,PROPN,poss,appos,PRP$,NNP,4,1
638,1012.0,20,charged,4,16,10,-6,15,9,-12,6,Meredith Kercher,violence,PERSON-PERSON,CAUSE_OF_DEATH,PROPN-PROPN,NOUN,compound-pobj,pobj,NNP-NNP,NN,3,1
639,1023.0,53,said,38,40,45,5,39,7,-2,7,Ahmed Rashid,journalist,PERSON-PERSON,TITLE,PROPN-PROPN,NOUN,compound-nsubj,appos,NNP-NNP,NN,2,1
640,1899.0,42,consisted,3,37,17,-20,36,24,-34,14,Ahmed Rashid,journalist,PERSON-PERSON,TITLE,PROPN-PROPN,NOUN,compound-conj,pobj,NNP-NNP,NN,6,1
641,2339.0,36,said,15,14,11,-3,13,24,1,-4,Ahmed Rashid,journalist,PERSON-PERSON,TITLE,PROPN-PROPN,NOUN,compound-conj,dobj,NNP-NNP,NN,2,1
642,5707.0,27,paid,11,9,2,-7,8,24,2,-9,Ahmed Rashid,journalist,PERSON-PERSON,TITLE,PROPN-PROPN,NOUN,compound-appos,nsubj,NNP-NNP,NN,2,1
643,6008.0,37,said,19,1,5,4,0,31,18,-14,Ahmed Rashid,journalist,PERSON-PERSON,TITLE,PROPN-PROPN,NOUN,compound-nsubj,appos,NNP-NNP,NN,2,1
644,6151.0,47,is,17,1,6,5,0,40,16,-11,Ahmed Rashid,journalist,PERSON-PERSON,TITLE,PROPN-PROPN,NOUN,compound-nsubj,appos,NNP-NNP,NN,2,1
645,8441.0,42,is,17,1,6,5,0,35,16,-11,Ahmed Rashid,journalist,PERSON-PERSON,TITLE,PROPN-PROPN,NOUN,compound-nsubj,appos,NNP-NNP,NN,2,1
646,8458.0,15,is,7,1,6,5,0,8,6,-1,Ahmed Rashid,journalist,PERSON-PERSON,TITLE,PROPN-PROPN,NOUN,compound-nsubj,appos,NNP-NNP,NN,2,1
647,9077.0,49,says,12,1,6,5,0,42,11,-6,Ahmed Rashid,journalist,PERSON-PERSON,TITLE,PROPN-PROPN,NOUN,compound-nsubj,appos,NNP-NNP,NN,3,1
648,10373.0,42,is,17,1,6,5,0,35,16,-11,Ahmed Rashid,journalist,PERSON-PERSON,TITLE,PROPN-PROPN,NOUN,compound-nsubj,appos,NNP-NNP,NN,2,1
649,10558.0,54,wrote,38,40,45,5,39,8,-2,7,Ahmed Rashid,journalist,PERSON-PERSON,TITLE,PROPN-PROPN,NOUN,compound-nsubj,appos,NNP-NNP,NN,2,1
650,10628.0,33,support,15,8,7,-1,7,25,7,-8,Ahmed Rashid,journalist,PERSON-PERSON,TITLE,PROPN-PROPN,NOUN,compound-pobj,compound,NNP-NNP,NN,1,1
651,11529.0,40,said,22,4,8,4,3,31,18,-14,Ahmed Rashid,journalist,PERSON-PERSON,TITLE,PROPN-PROPN,NOUN,compound-conj,appos,NNP-NNP,NN,2,1
652,12705.0,23,said,16,21,18,-3,20,4,-5,2,Ahmed Rashid,journalist,PERSON-PERSON,TITLE,PROPN-PROPN,NOUN,compound-conj,nsubj,NNP-NNP,NN,2,1
653,12963.0,49,noted,6,4,3,-1,3,45,2,-3,Ahmed Rashid,journalist,PERSON-PERSON,TITLE,PROPN-PROPN,NOUN,compound-nsubj,compound,NNP-NNP,NN,1,1
654,14745.0,42,said,19,1,6,5,0,35,18,-13,Ahmed Rashid,journalist,PERSON-PERSON,TITLE,PROPN-PROPN,NOUN,compound-nsubj,appos,NNP-NNP,NN,2,1
655,1030.0,33,be,13,18,26,8,17,6,-5,13,Ruben van Assouw,Netherlands,PERSON-PERSON-PERSON,COUNTRY,PROPN-PROPN-PROPN,PROPN,compound-compound-attr,pobj,NNP-NNP-NNP,NNP,4,1
656,5409.0,28,returned,12,6,11,5,5,16,6,-1,Ruben van Assouw,Netherlands,PERSON-PERSON-PERSON,COUNTRY,PROPN-PROPN-PROPN,PROPN,compound-compound-appos,pobj,NNP-NNP-NNP,NNP,2,1
657,8589.0,44,said,4,10,18,8,9,25,-6,14,Ruben van Assouw,Netherlands,PERSON-PERSON-PERSON,COUNTRY,PROPN-PROPN-PROPN,PROPN,compound-compound-attr,pobj,NNP-NNP-NNP,NNP,3,1
658,9531.0,37,thlead,2,6,23,17,5,13,-4,21,Ruben van Assouw,Netherlands,PERSON-PERSON-PERSON,NATIONALITY,PROPN-PROPN-PROPN,PROPN,compound-compound-nsubj,pobj,NNP-NNP-NNP,NNP,5,1
659,10780.0,30,arrived,12,9,18,9,8,11,3,6,Ruben van Assouw,Netherlands,PERSON-PERSON-PERSON,COUNTRY,PROPN-PROPN-PROPN,PROPN,compound-compound-appos,pobj,NNP-NNP-NNP,NNP,5,1
660,11954.0,41,said,39,2,20,18,1,20,37,-19,Ruben van Assouw,Netherlands,PERSON-PERSON-PERSON,COUNTRY,PROPN-PROPN-PROPN,PROPN,compound-compound-nsubj,pobj,NNP-NNP-NNP,NNP,4,1
661,12688.0,46,said,4,11,19,8,10,26,-7,15,Ruben van Assouw,Netherlands,PERSON-PERSON-PERSON,COUNTRY,PROPN-PROPN-PROPN,PROPN,compound-compound-attr,pobj,NNP-NNP-NNP,NNP,3,1
662,13514.0,31,TRIPOLI/THE,0,4,22,18,3,8,-4,22,Ruben van Assouw,Netherlands,PERSON-PERSON-PERSON,COUNTRY,PROPN-PROPN-PROPN,PROPN,compound-compound-nsubj,pobj,NNP-NNP-NNP,NNP,-1,1
663,14043.0,47,said,4,11,19,8,10,27,-7,15,Ruben van Assouw,Netherlands,PERSON-PERSON-PERSON,COUNTRY,PROPN-PROPN-PROPN,PROPN,compound-compound-attr,pobj,NNP-NNP-NNP,NNP,3,1
664,1048.0,40,miles,3,14,18,4,13,21,-11,15,his,Cuban,PERSON,NATIONALITY,DET,ADJ,poss,amod,PRP$,JJ,4,1
665,1050.0,15,is,1,1,14,13,0,0,0,13,Cerniglia,suicide,PERSON,CAUSE_OF_DEATH,PROPN,NOUN,nsubj,dobj,NNP,NN,1,1
666,6073.0,14,is,1,1,13,12,0,0,0,12,Cerniglia,suicide,PERSON,CAUSE_OF_DEATH,PROPN,NOUN,nsubj,dobj,NNP,NN,1,1
667,7330.0,27,said,15,22,26,4,21,0,-7,11,Cerniglia,suicide,PERSON,CAUSE_OF_DEATH,PROPN,NOUN,poss,oprd,NNP,NN,5,1
668,8316.0,26,said,15,21,25,4,20,0,-6,10,Cerniglia,suicide,PERSON,CAUSE_OF_DEATH,PROPN,NOUN,poss,oprd,NNP,NN,5,1
669,13888.0,22,reported,20,1,15,14,0,6,19,-5,Cerniglia,suicide,PERSON,CAUSE_OF_DEATH,PROPN,NOUN,nsubj,dobj,NNP,NN,2,1
670,15208.0,32,YORK,1,11,25,14,10,6,-10,24,Cerniglia,suicide,PERSON,CAUSE_OF_DEATH,PROPN,NOUN,nsubj,dobj,NNP,NN,2,1
671,1051.0,37,said,19,30,21,-9,29,15,-11,2,Huntington Library,Sue Hodson,ORGANIZATION-ORGANIZATION,PERSON-PERSON,PROPN-PROPN,PROPN-PROPN,compound-pobj,compound-nsubj,NNP-NNP,NNP-NNP,14,1
672,1054.0,40,congratulates,2,36,31,-5,35,8,-34,29,PATA,Asia-Pacific,ORGANIZATION,LOCATION,PROPN,PROPN,compound,pobj,NNP,NNP,5,1
673,1056.0,45,said,4,10,25,15,9,19,-6,21,Ruben van Assouw,South Africa,PERSON-PERSON-PERSON,COUNTRY-COUNTRY,PROPN-PROPN-PROPN,PROPN-PROPN,compound-compound-attr,compound-pobj,NNP-NNP-NNP,NNP-NNP,4,1
674,5629.0,44,said,4,10,25,15,9,18,-6,21,Ruben van Assouw,South Africa,PERSON-PERSON-PERSON,COUNTRY-COUNTRY,PROPN-PROPN-PROPN,PROPN-PROPN,compound-compound-attr,compound-pobj,NNP-NNP-NNP,NNP-NNP,4,1
675,1060.0,34,http://wwwchroncom/disp/storympl/metropolitan/5045808html,0,4,3,-1,3,30,-4,3,High Point Church,"5,000-member",ORGANIZATION-ORGANIZATION-ORGANIZATION,NUMBER,PROPN-PROPN-PROPN,NUM,compound-compound-nsubjpass,nummod,NNP-NNP-NNP,CD,1,1
676,1061.0,39,recalls,1,12,20,8,11,18,-11,19,him,Los Angeles,PERSON,CITY-CITY,PRON,PROPN-PROPN,dobj,compound-pobj,PRP,NNP-NNP,4,1
677,1063.0,72,partnered,11,53,4,-49,52,67,-42,-7,NCAI,National Congress of American Indians,ORGANIZATION,ORGANIZATION-ORGANIZATION-ORGANIZATION-ORGANIZATION-ORGANIZATION,PROPN,PROPN-PROPN-ADP-PROPN-PROPN,compound,compound-conj-prep-compound-pobj,NNP,NNP-NNP-IN-NNP-NNPS,-1,1
678,1070.0,39,describes,3,3,2,-1,2,36,0,-1,lawyer,41-year-old,PERSON,NUMBER,NOUN,NUM,nsubj,amod,NN,CD,1,1
679,1078.0,37,said,25,22,28,6,21,8,3,3,"Democratic Party , '' said Norman",Solomon,ORGANIZATION-ORGANIZATION-ORGANIZATION-ORGANIZATION-ORGANIZATION-ORGANIZATION,PERSON,PROPN-PROPN-PUNCT-PUNCT-VERB-PROPN,PROPN,compound-pobj-punct-punct-ROOT-compound,nsubj,"NNP-NNP-,-''-VBD-NNP",NNP,7,1
680,1082.0,40,had,10,3,8,5,2,31,7,-2,his,Anita Pandey,PERSON,PERSON-PERSON,DET,PROPN-PROPN,poss,compound-appos,PRP$,NNP-NNP,1,1
681,1100.0,37,is,12,1,6,5,0,30,11,-6,Wen,Chongqing,PERSON,ORGANIZATION,PROPN,PROPN,nsubj,poss,NNP,NNP,5,1
682,15049.0,41,stands,19,1,5,4,0,35,18,-14,Wen,Chongqing,PERSON,CITY,PROPN,PROPN,nsubj,poss,NNP,NNP,5,1
683,1109.0,43,cited,1,11,6,-5,10,36,-10,5,Alan Gross,Agency for International Development,PERSON-PERSON,ORGANIZATION-ORGANIZATION-ORGANIZATION-ORGANIZATION,PROPN-PROPN,PROPN-ADP-PROPN-PROPN,compound-pobj,pobj-prep-compound-compound,NNP-NNP,NNP-IN-NNP-NNP,1,1
684,1120.0,16,said,1,1,6,5,0,9,0,5,Alessi,Catholic,PERSON,RELIGION,PROPN,ADJ,nsubj,acomp,NNP,JJ,2,1
685,1121.0,33,mentioned,20,22,13,-9,21,19,-2,-7,her,columnist,PERSON,TITLE,DET,NOUN,poss,appos,PRP$,NN,5,1
686,6028.0,28,keep,17,25,15,-10,24,12,-8,-2,her,columnist,PERSON,TITLE,DET,NOUN,poss,conj,PRP$,NN,4,1
687,1126.0,27,is,2,1,22,21,0,4,1,20,Benjamin Chertoff,Homeland Security,PERSON-PERSON,ORGANIZATION-ORGANIZATION,PROPN-PROPN,PROPN-PROPN,compound-nsubj,compound-pobj,NNP-NNP,NNP-NNP,7,1
688,1127.0,35,committed,1,1,3,2,0,31,0,2,Sodini,suicide,PERSON,CAUSE_OF_DEATH,NOUN,NOUN,nsubj,dobj,NNS,NN,1,1
689,6172.0,44,committed,10,10,12,2,9,31,0,2,Sodini,suicide,PERSON,CAUSE_OF_DEATH,PROPN,NOUN,nsubj,dobj,NNP,NN,1,1
690,1133.0,26,sued,21,8,1,-7,7,24,13,-20,Countrywide,David Sambol,ORGANIZATION,PERSON-PERSON,PROPN,PROPN-PROPN,pobj,compound-nsubjpass,NNP,NNP-NNP,2,1
691,4260.0,38,told,6,28,25,-3,27,12,-22,19,Countrywide,David Sambol,ORGANIZATION,PERSON-PERSON,PROPN,PROPN-PROPN,poss,compound-pobj,NNP,NNP-NNP,6,1
692,1142.0,48,BEIJING,0,44,40,-4,43,7,-44,40,NEA,National Energy Administration,ORGANIZATION,ORGANIZATION-ORGANIZATION-ORGANIZATION,PROPN,PROPN-PROPN-PROPN,compound,compound-compound-pobj,NNP,NNP-NNP-NNP,3,1
693,13267.0,27,become,2,23,19,-4,22,7,-21,17,NEA,National Energy Administration,ORGANIZATION,ORGANIZATION-ORGANIZATION-ORGANIZATION,PROPN,PROPN-PROPN-PROPN,compound,compound-compound-pobj,NNP,NNP-NNP-NNP,5,1
694,1143.0,40,made,16,8,1,-7,7,38,8,-15,National Development and Reform Commission,Chen Deming,ORGANIZATION-ORGANIZATION-ORGANIZATION-ORGANIZATION-ORGANIZATION,PERSON-PERSON,PROPN-PROPN-CCONJ-PROPN-PROPN,PROPN-PROPN,nmod-nmod-cc-conj-pobj,compound-nsubj,NNP-NNP-CC-NNP-NNP,NNP-NNP,4,1
695,1144.0,26,said,10,2,6,4,1,19,8,-4,Hollister Inc,Boston,ORGANIZATION-ORGANIZATION,CITY,PROPN-PROPN,PROPN,compound-pobj,compound,NNP-NNP,NNP,2,1
696,1150.0,45,said,16,30,25,-5,29,19,-14,9,National Development and Reform Commission,Industrial Policy Department,ORGANIZATION-ORGANIZATION-ORGANIZATION-ORGANIZATION-ORGANIZATION,ORGANIZATION-ORGANIZATION-ORGANIZATION,PROPN-PROPN-CCONJ-PROPN-PROPN,PROPN-PROPN-PROPN,nmod-nmod-cc-conj-pobj,compound-compound-pobj,NNP-NNP-CC-NNP-NNP,NNP-NNP-NNP,4,1
697,1154.0,37,advocated,14,2,10,8,1,26,12,-4,National Congress of American Indians,Washington,ORGANIZATION-ORGANIZATION-ORGANIZATION-ORGANIZATION-ORGANIZATION,STATE_OR_PROVINCE,PROPN-PROPN-ADP-PROPN-PROPN,PROPN,compound-nsubj-prep-compound-pobj,pobj,NNP-NNP-IN-NNP-NNPS,NNP,4,1
698,11043.0,37,said,13,8,16,8,7,20,5,3,National Congress of American Indians,Washington,ORGANIZATION-ORGANIZATION-ORGANIZATION-ORGANIZATION-ORGANIZATION,STATE_OR_PROVINCE,PROPN-PROPN-ADP-PROPN-PROPN,PROPN,compound-pobj-prep-compound-pobj,nmod,NNP-NNP-IN-NNP-NNPS,NNP,6,1
699,1161.0,30,approved,9,19,1,-18,18,28,-10,-8,NDRC,China,ORGANIZATION,COUNTRY,PROPN,PROPN,compound,poss,NNP,NNP,5,1
700,4898.0,28,released,13,9,1,-8,8,26,4,-12,NDRC,China,ORGANIZATION,COUNTRY,PROPN,PROPN,compound,poss,NNP,NNP,4,1
701,11351.0,30,Commission,6,9,1,-8,8,28,-3,-5,NDRC,China,ORGANIZATION,COUNTRY,PROPN,PROPN,compound,poss,NNP,NNP,3,1
702,12326.0,39,said,36,28,13,-15,27,25,8,-23,NDRC,China,ORGANIZATION,COUNTRY,PROPN,PROPN,compound,poss,NNP,NNP,3,1
703,14644.0,33,agreed,12,6,32,26,5,0,6,20,NDRC,China,ORGANIZATION,COUNTRY,PROPN,PROPN,nsubj,pobj,NNP,NNP,3,1
704,1167.0,30,taken,14,4,26,22,3,3,10,12,Baldino,chairman,PERSON,TITLE,PROPN,NOUN,nsubj,pobj,NNP,NN,7,1
705,1923.0,30,taken,14,4,26,22,3,3,10,12,Baldino,chairman,PERSON,TITLE,PROPN,NOUN,nsubj,pobj,NNP,NN,7,1
706,1168.0,17,born,2,1,13,12,0,3,1,11,Baldino,New Jersey,PERSON,STATE_OR_PROVINCE-STATE_OR_PROVINCE,PROPN,PROPN-PROPN,nsubjpass,compound-pobj,NNP,NNP-NNP,4,1
707,1169.0,27,been,12,4,25,21,3,1,8,13,Aquash,the 1970s,PERSON,DATE-DATE,PROPN,DET-NOUN,pobj,det-pobj,NNP,DT-NNS,3,1
708,1182.0,33,detained,2,18,1,-17,17,31,-16,-1,Xie Caiping,Wen,PERSON-PERSON,PERSON,PROPN-PROPN,PROPN,compound-npadvmod,nsubjpass,NNP-NNP,NNP,10,1
709,1443.0,26,sentenced,9,7,4,-3,6,21,2,-5,Xie Caiping,Wen,PERSON-PERSON,PERSON,PROPN-PROPN,PROPN,compound-nsubjpass,poss,NNP-NNP,NNP,3,1
710,3918.0,24,sentenced,11,8,1,-7,7,22,3,-10,Xie Caiping,Wen,PERSON-PERSON,PERSON,PROPN-PROPN,PROPN,compound-appos,poss,NNP-NNP,NNP,5,1
711,4296.0,46,reported,44,5,1,-4,4,44,39,-43,Xie Caiping,Wen,PERSON-PERSON,PERSON,PROPN-PROPN,PROPN,compound-appos,poss,NNP-NNP,NNP,4,1
712,6015.0,29,sentenced,12,7,4,-3,6,24,5,-8,Xie Caiping,Wen,PERSON-PERSON,PERSON,PROPN-PROPN,PROPN,compound-appos,poss,NNP-NNP,NNP,3,1
713,6363.0,30,sentenced,12,7,4,-3,6,25,5,-8,Xie Caiping,Wen,PERSON-PERSON,PERSON,PROPN-PROPN,PROPN,compound-appos,poss,NNP-NNP,NNP,3,1
714,7155.0,45,sentenced,8,5,1,-4,4,43,3,-7,Xie Caiping,Wen,PERSON-PERSON,PERSON,PROPN-PROPN,PROPN,compound-appos,poss,NNP-NNP,NNP,4,1
715,9021.0,36,accused,10,21,1,-20,20,34,-11,-9,Xie Caiping,Wen,PERSON-PERSON,PERSON,PROPN-PROPN,PROPN,compound-npadvmod,nsubjpass,NNP-NNP,NNP,10,1
716,14147.0,33,detained,2,18,1,-17,17,31,-16,-1,Xie Caiping,Wen,PERSON-PERSON,PERSON,PROPN-PROPN,PROPN,compound-npadvmod,nsubjpass,NNP-NNP,NNP,10,1
717,1188.0,40,released,7,17,23,6,16,16,-10,16,Silsby,New Life Children 's Refuge,PERSON,ORGANIZATION-ORGANIZATION-ORGANIZATION-ORGANIZATION-ORGANIZATION,PROPN,PROPN-PROPN-PROPN-PART-PROPN,nsubj,compound-compound-poss-case-compound,NNP,NNP-NNP-NNP-POS-NNP,6,1
718,1195.0,37,kidnapped,27,21,18,-3,20,18,6,-9,Italy,Eugenio Vagni,PERSON,COUNTRY-COUNTRY,PROPN,PROPN-PROPN,pobj,compound-conj,NNP,NNP-NNP,3,1
719,1207.0,41,turned,9,7,4,-3,6,36,2,-5,Youssoufou Bamba,United Nations,PERSON-PERSON,ORGANIZATION-ORGANIZATION,PROPN-PROPN,PROPN-PROPN,compound-nsubj,compound-compound,NNP-NNP,NNP-NNP,2,1
720,4139.0,24,gave,9,7,4,-3,6,19,2,-5,Youssoufou Bamba,United Nations,PERSON-PERSON,ORGANIZATION-ORGANIZATION,PROPN-PROPN,PROPN-PROPN,compound-nsubj,compound-compound,NNP-NNP,NNP-NNP,2,1
721,5609.0,27,made,6,4,19,15,3,7,2,13,Youssoufou Bamba,United Nations,PERSON-PERSON,ORGANIZATION-ORGANIZATION,PROPN-PROPN,PROPN-PROPN,compound-appos,compound-pobj,NNP-NNP,NNP-NNP,6,1
722,6329.0,31,gave,12,11,8,-3,10,22,1,-4,Youssoufou Bamba,United Nations,PERSON-PERSON,ORGANIZATION-ORGANIZATION,PROPN-PROPN,PROPN-PROPN,compound-appos,compound-compound,NNP-NNP,NNP-NNP,2,1
723,6381.0,38,grave,2,17,14,-3,16,23,-15,12,Youssoufou Bamba,United Nations,PERSON-PERSON,ORGANIZATION-ORGANIZATION,PROPN-PROPN,PROPN-PROPN,compound-appos,compound-pobj,NNP-NNP,NNP-NNP,3,1
724,1208.0,45,said,13,11,8,-3,10,36,2,-5,Youssoufou Bamba,UN,PERSON-PERSON,ORGANIZATION,PROPN-PROPN,PROPN,compound-appos,compound,NNP-NNP,NNP,1,1
725,1400.0,27,made,6,4,22,18,3,4,2,16,Youssoufou Bamba,UN,PERSON-PERSON,ORGANIZATION,PROPN-PROPN,PROPN,compound-appos,compound,NNP-NNP,NNP,8,1
726,5062.0,48,said,16,14,11,-3,13,36,2,-5,Youssoufou Bamba,UN,PERSON-PERSON,ORGANIZATION,PROPN-PROPN,PROPN,compound-appos,compound,NNP-NNP,NNP,1,1
727,7798.0,20,presented,6,3,13,10,2,6,3,7,Youssoufou Bamba,UN,PERSON-PERSON,ORGANIZATION,PROPN-PROPN,PROPN,compound-nsubj,compound,NNP-NNP,NNP,5,1
728,7969.0,38,grave,2,17,5,-12,16,32,-15,3,Youssoufou Bamba,UN,PERSON-PERSON,ORGANIZATION,PROPN-PROPN,PROPN,compound-appos,appos,NNP-NNP,NNP,3,1
729,10693.0,42,said,10,8,5,-3,7,36,2,-5,Youssoufou Bamba,UN,PERSON-PERSON,ORGANIZATION,PROPN-PROPN,PROPN,compound-appos,compound,NNP-NNP,NNP,1,1
730,1218.0,51,dismissed,31,8,14,6,7,36,23,-17,John Graham,Office of Information and Regulatory Affairs,PERSON-PERSON,ORGANIZATION-ORGANIZATION-ORGANIZATION-ORGANIZATION-ORGANIZATION-ORGANIZATION,PROPN-PROPN,PROPN-ADP-PROPN-CCONJ-PROPN-PROPN,compound-appos,pobj-prep-pobj-cc-compound-conj,NNP-NNP,NNP-IN-NNP-CC-NNP-NNPS,4,1
731,1238.0,39,executed,12,14,35,21,13,3,-2,23,Wen Qiang,extortion,PERSON-PERSON,CRIMINAL_CHARGE,PROPN-PROPN,NOUN,compound-dobj,conj,NNP-NNP,NN,8,1
732,2389.0,34,led,2,17,30,13,16,3,-15,28,Wen Qiang,extortion,PERSON-PERSON,CRIMINAL_CHARGE,PROPN-PROPN,NOUN,compound-appos,conj,NNP-NNP,NN,8,1
733,12578.0,32,executed,5,7,28,21,6,3,-2,23,Wen Qiang,extortion,PERSON-PERSON,CRIMINAL_CHARGE,PROPN-PROPN,NOUN,compound-dobj,conj,NNP-NNP,NN,8,1
734,1243.0,23,executed,4,6,5,-1,5,17,-2,1,Wen Qiang,executed,PERSON-PERSON,CAUSE_OF_DEATH,PROPN-PROPN,VERB,compound-dobj,ROOT,NNP-NNP,VBD,1,1
735,7419.0,58,were,11,35,49,14,34,8,-24,38,Wen Qiang,executed,PERSON-PERSON,CAUSE_OF_DEATH,PROPN-PROPN,VERB,compound-conj,relcl,NNP-NNP,VBN,5,1
736,15380.0,28,executed,4,6,5,-1,5,22,-2,1,Wen Qiang,executed,PERSON-PERSON,CAUSE_OF_DEATH,PROPN-PROPN,VERB,compound-dobj,ROOT,NNP-NNP,VBD,1,1
737,1248.0,58,COUNTRYWIDE,0,20,25,5,19,32,-20,25,Countrywide Financial Corp,Angelo Mozilo,ORGANIZATION-ORGANIZATION-ORGANIZATION,PERSON-PERSON,PROPN-PROPN-PROPN,PROPN-PROPN,compound-nmod-nmod,compound-appos,NNP-NNP-NNP,NNP-NNP,1,1
738,1257.0,50,agreed,37,14,23,9,13,26,23,-14,Countrywide Financial,Eric Sieracki,ORGANIZATION-ORGANIZATION,PERSON-PERSON,PROPN-PROPN,PROPN-PROPN,compound-pobj,compound-appos,NNP-NNP,NNP-NNP,3,1
739,1259.0,41,returned,25,1,5,4,0,35,24,-20,Laura Silsby,organizer,PERSON-PERSON,TITLE,PROPN-PROPN,NOUN,compound-nsubj,appos,NNP-NNP,NN,2,1
740,8437.0,41,returned,24,1,5,4,0,35,23,-19,Laura Silsby,organizer,PERSON-PERSON,TITLE,PROPN-PROPN,NOUN,compound-nsubj,appos,NNP-NNP,NN,2,1
741,12386.0,22,told,10,9,8,-1,8,13,1,-2,Laura Silsby,organizer,PERSON-PERSON,TITLE,PROPN-PROPN,NOUN,compound-nsubj,compound,NNP-NNP,NN,1,1
742,15157.0,23,told,11,10,9,-1,9,13,1,-2,Laura Silsby,organizer,PERSON-PERSON,TITLE,PROPN-PROPN,NOUN,compound-nsubj,compound,NNP-NNP,NN,1,1
743,1266.0,29,founded,2,16,1,-15,15,27,-14,-1,Countrywide,IndyMac,ORGANIZATION,ORGANIZATION,PROPN,PROPN,dobj,nsubjpass,NNP,NNP,4,1
744,1275.0,43,made,12,1,11,10,0,31,11,-1,Alessi,murder,PERSON,CRIMINAL_CHARGE,PROPN,NOUN,nsubj,pobj,NNP,NN,3,1
745,1288.0,31,gave,12,21,29,8,20,1,-9,17,his,New York,PERSON,STATE_OR_PROVINCE-STATE_OR_PROVINCE,DET,PROPN-PROPN,poss,compound-pobj,PRP$,NNP-NNP,4,1
746,2467.0,31,jumped,14,17,26,9,16,4,-3,12,his,New York,PERSON,CITY-CITY,DET,PROPN-PROPN,poss,compound-dobj,PRP$,NNP-NNP,8,1
747,1291.0,40,told,35,4,16,12,3,23,31,-19,Mario Gonzalez,Chihuahua,PERSON-PERSON,STATE_OR_PROVINCE,PROPN-PROPN,PROPN,compound-pobj,compound,NNP-NNP,NNP,8,1
748,3038.0,28,says,5,10,26,16,9,1,-5,21,Mario Gonzalez,Chihuahua,PERSON-PERSON,STATE_OR_PROVINCE,PROPN-PROPN,PROPN,compound-pobj,compound,NNP-NNP,NNP,9,1
749,1297.0,29,versatility,2,10,14,4,9,14,-8,12,her,coach,PERSON,TITLE,DET,NOUN,poss,pobj,PRP$,NN,3,1
750,1310.0,92,organized,5,29,23,-6,28,68,-24,18,National Urban League,Whitney Young,ORGANIZATION-ORGANIZATION-ORGANIZATION,PERSON-PERSON,PROPN-PROPN-PROPN,PROPN-PROPN,compound-compound-compound,compound-compound,NNP-NNP-NNP,NNP-NNP,4,1
751,3149.0,29,YOUNG,3,22,15,-7,21,13,-19,12,National Urban League,Whitney Young,ORGANIZATION-ORGANIZATION-ORGANIZATION,PERSON-PERSON,PROPN-PROPN-PROPN,PROPN-PROPN,compound-compound-pobj,compound-nsubj,NNP-NNP-NNP,NNP-NNP,5,1
752,1315.0,16,found,7,5,15,10,4,0,2,8,Joseph Cerniglia,Friday,PERSON-PERSON,DATE,PROPN-PROPN,PROPN,compound-pobj,pobj,NNP-NNP,NNP,9,1
753,14380.0,25,found,17,5,24,19,4,0,12,7,Joseph Cerniglia,Friday,PERSON-PERSON,DATE,PROPN-PROPN,PROPN,compound-pobj,pobj,NNP-NNP,NNP,9,1
754,1316.0,59,published,16,11,13,2,10,45,5,-3,Rashid,59,PERSON,NUMBER,PROPN,NUM,appos,appos,NNP,CD,6,1
755,1318.0,38,hunting,5,17,13,-4,16,24,-12,8,Eugenio Vagni,62-year-old,PERSON-PERSON,NUMBER,PROPN-PROPN,NUM,compound-nsubj,ROOT,NNP-NNP,CD,5,1
756,4985.0,32,holding,4,6,10,4,5,21,-2,6,Eugenio Vagni,62-year-old,PERSON-PERSON,NUMBER,PROPN-PROPN,NUM,compound-dobj,nmod,NNP-NNP,CD,4,1
757,9875.0,35,said,27,19,18,-1,18,16,8,-9,Eugenio Vagni,62-year-old,PERSON-PERSON,NUMBER,PROPN-PROPN,NUM,compound-dobj,compound,NNP-NNP,CD,1,1
758,1319.0,28,said,11,8,1,-7,7,26,3,-10,National Restaurant Association,Michael C. Gibbons,ORGANIZATION-ORGANIZATION-ORGANIZATION,PERSON-PERSON-PERSON,PROPN-PROPN-PROPN,PROPN-PROPN-PROPN,compound-compound-pobj,compound-compound-nsubj,NNP-NNP-NNP,NNP-NNP-NNP,5,1
759,1323.0,36,said,34,21,34,13,20,1,13,0,he,she,PERSON,PERSON,PRON,PRON,nsubjpass,nsubj,PRP,PRP,8,1
760,1331.0,54,TURKEY-VENDOR,0,12,3,-9,11,50,-12,3,Greenberg Smoked Turkey,Tyler,ORGANIZATION-ORGANIZATION-ORGANIZATION,CITY,PROPN-PROPN-PROPN,PROPN,compound-compound-dobj,conj,NNP-NNP-NNP,NNP,-1,1
761,1332.0,87,slams,5,4,3,-1,3,83,1,-2,Richard Gage,Architect,PERSON-PERSON,TITLE,PROPN-PROPN,PROPN,compound-nsubj,compound,NNP-NNP,NNP,1,1
762,5433.0,30,about,1,23,22,-1,22,7,-22,21,Richard Gage,Architect,PERSON-PERSON,TITLE,PROPN-PROPN,PROPN,compound-appos,compound,NNP-NNP,NNP,1,1
763,1349.0,36,detained,6,1,22,21,0,13,5,16,Alan Gross,US Agency for International Development,PERSON-PERSON,ORGANIZATION-ORGANIZATION-ORGANIZATION-ORGANIZATION-ORGANIZATION,PROPN-PROPN,PROPN-PROPN-ADP-PROPN-PROPN,compound-nsubjpass,compound-pobj-prep-compound-pobj,NNP-NNP,NNP-NNP-IN-NNP-NNP,9,1
764,13929.0,19,working,7,5,14,9,4,4,2,7,Alan Gross,US Agency for International Development,PERSON-PERSON,ORGANIZATION-ORGANIZATION-ORGANIZATION-ORGANIZATION-ORGANIZATION,PROPN-PROPN,PROPN-PROPN-ADP-PROPN-PROPN,compound-nsubj,compound-pobj-prep-compound-pobj,NNP-NNP,NNP-NNP-IN-NNP-NNP,5,1
765,1377.0,34,discovered,1,3,10,7,2,23,-2,9,Piedra,Scientology,PERSON,RELIGION,PROPN,PROPN,poss,compound,NNP,NNP,4,1
766,3302.0,14,infused,4,1,10,9,0,3,3,6,Piedra,Scientology,PERSON,RELIGION,PROPN,PROPN,nsubj,poss,NNP,NNP,7,1
767,7795.0,34,discovered,1,3,10,7,2,23,-2,9,Piedra,Scientology,PERSON,RELIGION,PROPN,VERB,poss,conj,NNP,VB,4,1
768,8508.0,24,reported,1,1,13,12,0,10,0,12,Piedra,Scientology,PERSON,RELIGION,PROPN,PROPN,nsubj,compound,NNP,NNP,3,1
769,1379.0,29,believed,13,5,28,23,4,0,8,15,Sarah Kunstler,Salaam,PERSON-PERSON,PERSON,PROPN-PROPN,PROPN,compound-nsubj,dobj,NNP-NNP,NNP,2,1
770,1381.0,33,said,18,15,1,-14,14,31,3,-17,National Energy Administration,Gu Jun,ORGANIZATION-ORGANIZATION-ORGANIZATION,PERSON-PERSON,PROPN-PROPN-PROPN,PROPN-PROPN,compound-compound-pobj,compound-nsubj,NNP-NNP-NNP,NNP-NNP,6,1
771,3821.0,33,made,14,8,1,-7,7,31,6,-13,National Energy Administration,Gu Jun,ORGANIZATION-ORGANIZATION-ORGANIZATION,PERSON-PERSON,PROPN-PROPN-PROPN,PROPN-PROPN,compound-compound-poss,compound-nsubj,NNP-NNP-NNP,NNP-NNP,5,1
772,12024.0,37,BEIJING,0,19,5,-14,18,31,-19,5,National Energy Administration,Gu Jun,ORGANIZATION-ORGANIZATION-ORGANIZATION,PERSON-PERSON,PROPN-PROPN-PROPN,PROPN-PROPN,compound-compound-pobj,compound-nsubj,NNP-NNP-NNP,NNP-NNP,8,1
773,14857.0,46,said,31,40,33,-7,39,12,-9,2,National Energy Administration,Gu Jun,ORGANIZATION-ORGANIZATION-ORGANIZATION,PERSON-PERSON,PROPN-PROPN-PROPN,PROPN-PROPN,compound-compound-poss,compound-nsubj,NNP-NNP-NNP,NNP-NNP,5,1
774,1385.0,39,According,0,8,14,6,7,24,-8,14,American Association of University Women,AAUW,ORGANIZATION-ORGANIZATION-ORGANIZATION-ORGANIZATION-ORGANIZATION,ORGANIZATION,PROPN-PROPN-ADP-PROPN-PROPN,PROPN,compound-pobj-prep-compound-compound,compound,NNP-NNP-IN-NNP-NNPS,NNP,5,1
775,1764.0,42,com,0,13,7,-6,12,34,-13,7,American Association of University Women,AAUW,ORGANIZATION-ORGANIZATION-ORGANIZATION-ORGANIZATION-ORGANIZATION,ORGANIZATION,PROPN-PROPN-ADP-PROPN-PROPN,PROPN,compound-nsubj-prep-compound-compound,compound,NNP-NNP-IN-NNP-NNP,NNP,3,1
776,1394.0,38,speak,12,2,7,5,1,30,10,-5,Alessi,Italian,PERSON,NATIONALITY,PROPN,ADJ,appos,amod,NNP,JJ,5,1
777,1397.0,37,said,20,32,22,-10,31,14,-12,2,National Restaurant Association,Hudson Riehle,ORGANIZATION-ORGANIZATION-ORGANIZATION,PERSON-PERSON,PROPN-PROPN-PROPN,PROPN-PROPN,compound-compound-pobj,compound-nsubj,NNP-NNP-NNP,NNP-NNP,6,1
778,4283.0,29,were,3,26,16,-10,25,12,-23,13,National Restaurant Association,Hudson Riehle,ORGANIZATION-ORGANIZATION-ORGANIZATION,PERSON-PERSON,PROPN-PROPN-PROPN,PROPN-PROPN,compound-compound-pobj,compound-pobj,NNP-NNP-NNP,NNP-NNP,9,1
779,10984.0,29,were,3,26,16,-10,25,12,-23,13,National Restaurant Association,Hudson Riehle,ORGANIZATION-ORGANIZATION-ORGANIZATION,PERSON-PERSON,PROPN-PROPN-PROPN,PROPN-PROPN,compound-compound-pobj,compound-pobj,NNP-NNP-NNP,NNP-NNP,9,1
780,13231.0,39,said,27,36,29,-7,35,9,-9,2,National Restaurant Association,Hudson Riehle,ORGANIZATION-ORGANIZATION-ORGANIZATION,PERSON-PERSON,PROPN-PROPN-PROPN,PROPN-PROPN,compound-compound-pobj,compound-nsubj,NNP-NNP-NNP,NNP-NNP,5,1
781,13981.0,33,WASHINGTON,0,30,20,-10,29,12,-30,20,National Restaurant Association,Hudson Riehle,ORGANIZATION-ORGANIZATION-ORGANIZATION,PERSON-PERSON,PROPN-PROPN-PROPN,PROPN-PROPN,compound-compound-pobj,compound-nsubj,NNP-NNP-NNP,NNP-NNP,9,1
782,1398.0,35,is,20,34,16,-18,33,18,-14,-4,him,plane crash,PERSON,CAUSE_OF_DEATH-CAUSE_OF_DEATH,PRON,NOUN-NOUN,pobj,compound-pobj,PRP,NN-NN,12,1
783,1403.0,28,urges,1,13,5,-8,12,22,-12,4,Asia Bibi,Pakistani,PERSON-PERSON,NATIONALITY,PROPN-PROPN,PROPN,compound-pobj,compound,NNP-NNP,NNP,8,1
784,1405.0,43,said,5,26,37,11,25,5,-21,32,his,kidnapping,PERSON,CRIMINAL_CHARGE,DET,NOUN,poss,compound,PRP$,NN,5,1
785,1416.0,28,attended,1,1,4,3,0,23,0,3,He,University of California,PERSON,ORGANIZATION-ORGANIZATION-ORGANIZATION,PRON,PROPN-ADP-PROPN,nsubj,conj-prep-pobj,PRP,NNP-IN-NNP,1,1
786,10241.0,28,attended,1,1,4,3,0,23,0,3,He,University of California,PERSON,ORGANIZATION-ORGANIZATION-ORGANIZATION,PRON,PROPN-ADP-PROPN,nsubj,conj-prep-pobj,PRP,NNP-IN-NNP,1,1
787,1417.0,24,freed,2,12,15,3,11,8,-10,13,Eugenio Vagni,Italy,PERSON-PERSON,COUNTRY,PROPN-PROPN,PROPN,compound-nsubjpass,pobj,NNP-NNP,NNP,2,1
788,4463.0,42,snatched,7,9,12,3,8,29,-2,5,Eugenio Vagni,Italy,PERSON-PERSON,COUNTRY,PROPN-PROPN,PROPN,compound-dobj,pobj,NNP-NNP,NNP,1,1
789,7228.0,37,kidnapped,27,18,21,3,17,15,9,-6,Eugenio Vagni,Italy,PERSON-PERSON,NATIONALITY,PROPN-PROPN,PROPN,compound-conj,pobj,NNP-NNP,NNP,3,1
790,13518.0,34,snatched,7,11,14,3,10,19,-4,7,Eugenio Vagni,Italy,PERSON-PERSON,COUNTRY,PROPN-PROPN,PROPN,compound-appos,pobj,NNP-NNP,NNP,1,1
791,1419.0,24,Club,1,16,23,7,15,0,-15,22,he,suicide,PERSON,CAUSE_OF_DEATH,PRON,NOUN,nsubj,dobj,PRP,NN,1,1
792,1422.0,36,testified,8,19,18,-1,18,17,-11,10,Annie Mae Aquash,shooting,PERSON-PERSON-PERSON,CAUSE_OF_DEATH,PROPN-PROPN-PROPN,VERB,compound-compound-dobj,pcomp,NNP-NNP-NNP,VBG,2,1
793,3896.0,42,charged,3,7,6,-1,6,35,-4,3,Annie Mae Aquash,shooting,PERSON-PERSON-PERSON,CAUSE_OF_DEATH,PROPN-PROPN-PROPN,VERB,compound-compound-dobj,pcomp,NNP-NNP-NNP,VBG,1,1
794,5267.0,40,testified,8,19,18,-1,18,21,-11,10,Annie Mae Aquash,shooting,PERSON-PERSON-PERSON,CAUSE_OF_DEATH,PROPN-PROPN-PROPN,VERB,compound-compound-dobj,pcomp,NNP-NNP-NNP,VBG,2,1
795,1426.0,32,said,13,9,1,-8,8,30,4,-12,Pacific Asia Travel Association,Wong,ORGANIZATION-ORGANIZATION-ORGANIZATION-ORGANIZATION,PERSON,PROPN-PROPN-PROPN-PROPN,PROPN,compound-compound-compound-pobj,nsubj,NNP-NNP-NNP-NNP,NNP,6,1
796,1432.0,42,WASHINGTON,0,5,3,-2,4,38,-5,3,Alan P Gross,contractor,PERSON-PERSON-PERSON,TITLE,PROPN-PROPN-PROPN,NOUN,compound-compound-appos,nsubj,NNP-NNP-NNP,NN,3,1
797,14952.0,37,said,22,10,8,-2,9,28,12,-14,Alan P Gross,contractor,PERSON-PERSON-PERSON,TITLE,PROPN-PROPN-PROPN,NOUN,compound-compound-appos,conj,NNP-NNP-NNP,NN,3,1
798,1440.0,24,was,3,1,20,19,0,3,2,17,Jamie Leigh Jones,administrative assistant,PERSON-PERSON-PERSON,TITLE-TITLE,PROPN-PROPN-PROPN,ADJ-NOUN,compound-compound-nsubj,amod-pobj,NNP-NNP-NNP,JJ-NN,6,1
799,1446.0,49,am,1,5,40,35,4,8,-4,39,Norris Church Mailer,Nov. 21,PERSON-PERSON-PERSON,DATE-DATE,PROPN-PROPN-PROPN,PROPN-NUM,compound-compound-nsubj,npadvmod-nummod,NNP-NNP-NNP,NNP-CD,-1,1
800,1449.0,38,named,1,5,20,15,4,17,-4,19,Shah Abdul Aziz,parliament,PERSON-PERSON-PERSON,ORGANIZATION,PROPN-PROPN-PROPN,NOUN,compound-compound-pobj,poss,NNP-NNP-NNP,NN,6,1
801,3682.0,24,named,1,5,18,13,4,5,-4,17,Shah Abdul Aziz,parliament,PERSON-PERSON-PERSON,ORGANIZATION,PROPN-PROPN-PROPN,NOUN,compound-compound-pobj,poss,NNP-NNP-NNP,NN,6,1
802,1452.0,36,include,1,3,13,10,2,22,-2,12,his,James,PERSON,PERSON,DET,PROPN,poss,conj,PRP$,NNP,4,1
803,4555.0,36,include,1,3,13,10,2,22,-2,12,his,James,PERSON,PERSON,DET,PROPN,poss,conj,PRP$,NNP,4,1
804,1453.0,39,stands,19,1,17,16,0,21,18,-2,Wen Qiang,southwest,PERSON-PERSON,ORGANIZATION,PROPN-PROPN,ADJ,compound-nsubj,amod,NNP-NNP,JJS,4,1
805,1466.0,31,said,25,1,14,13,0,16,24,-11,Wen Qiang,Chongqing Municipality,PERSON-PERSON,ORGANIZATION-ORGANIZATION,PROPN-PROPN,PROPN-PROPN,compound-nsubjpass,compound-pobj,NNP-NNP,NNP-NNP,3,1
806,8943.0,27,investigated,20,5,16,11,4,10,15,-4,Wen Qiang,Chongqing Municipality,PERSON-PERSON,ORGANIZATION-ORGANIZATION,PROPN-PROPN,PROPN-PROPN,compound-nsubjpass,compound-pobj,NNP-NNP,NNP-NNP,5,1
807,12881.0,48,said,45,12,26,14,11,21,33,-19,Wen Qiang,Chongqing Municipality,PERSON-PERSON,ORGANIZATION-ORGANIZATION,PROPN-PROPN,PROPN-PROPN,compound-pobj,compound-pobj,NNP-NNP,NNP-NNP,3,1
808,1467.0,37,said,26,14,14,0,13,22,12,-12,Koch Foods,Koch Foods Inc.,ORGANIZATION-ORGANIZATION,ORGANIZATION-ORGANIZATION-ORGANIZATION,PROPN-PROPN,PROPN-PROPN-PROPN,compound-compound,compound-compound-poss,NNP-NNP,NNP-NNP-NNP,0,1
809,4235.0,44,said,28,14,14,0,13,29,14,-14,Koch Foods,Koch Foods Inc.,ORGANIZATION-ORGANIZATION,ORGANIZATION-ORGANIZATION-ORGANIZATION,PROPN-PROPN,PROPN-PROPN-PROPN,compound-compound,compound-compound-poss,NNP-NNP,NNP-NNP-NNP,0,1
810,12954.0,43,said,26,14,14,0,13,28,12,-12,Koch Foods,Koch Foods Inc.,ORGANIZATION-ORGANIZATION,ORGANIZATION-ORGANIZATION-ORGANIZATION,PROPN-PROPN,PROPN-PROPN-PROPN,compound-compound,compound-compound-poss,NNP-NNP,NNP-NNP-NNP,0,1
811,1473.0,44,said,36,17,41,24,16,2,19,5,he,Superintendent,PERSON,TITLE,PRON,PROPN,nsubj,compound,PRP,NNP,7,1
812,1479.0,18,died,14,1,17,16,0,0,13,3,Tamaihia,Monday,PERSON,DATE,PROPN,PROPN,nsubj,pobj,NNP,NNP,3,1
813,9557.0,23,*,0,6,22,16,5,0,-6,22,Tamaihia,Monday,PERSON,DATE,PROPN,PROPN,pobj,pobj,NNP,NNP,4,1
814,1481.0,29,'s,19,1,10,9,0,18,18,-9,Rosen,U.S.,PERSON,COUNTRY,PROPN,PROPN,nsubj,compound,NNP,NNP,2,1
815,1485.0,28,explained,8,8,26,18,7,1,0,18,Dworin,Jewish,PERSON,RELIGION,PROPN,ADJ,nsubj,amod,NNP,JJ,6,1
816,4359.0,15,stands,9,2,7,5,1,7,7,-2,Dworin,Jewish,PERSON,RELIGION,PROPN,ADJ,poss,amod,NNP,JJ,5,1
817,1488.0,41,organized,3,7,23,16,6,17,-4,20,China Charity Federation,CCF,ORGANIZATION-ORGANIZATION-ORGANIZATION,ORGANIZATION,PROPN-PROPN-PROPN,PROPN,compound-compound-compound,compound,NNP-NNP-NNP,NNP,4,1
818,6170.0,37,donated,9,2,6,4,1,30,7,-3,China Charity Federation,CCF,ORGANIZATION-ORGANIZATION-ORGANIZATION,ORGANIZATION,PROPN-PROPN-PROPN,PROPN,compound-compound-compound,compound,NNP-NNP-NNP,NNP,3,1
819,7604.0,33,Federation,2,1,5,4,0,27,1,3,China Charity Federation,CCF,ORGANIZATION-ORGANIZATION-ORGANIZATION,ORGANIZATION,PROPN-PROPN-PROPN,PROPN,compound-compound-ROOT,compound,NNP-NNP-NNP,NNP,3,1
820,12112.0,25,launched,7,2,6,4,1,18,5,-1,China Charity Federation,CCF,ORGANIZATION-ORGANIZATION-ORGANIZATION,ORGANIZATION,PROPN-PROPN-PROPN,PROPN,compound-compound-compound,compound,NNP-NNP-NNP,NNP,3,1
821,1489.0,20,said,13,9,12,3,8,7,4,-1,Esther-Ethy Mamane,26,PERSON-PERSON,NUMBER,PROPN-PROPN,NUM,compound-nsubj,appos,NNP-NNP,CD,2,1
822,1496.0,40,nominated,21,8,11,3,7,28,13,-10,Mark Fisher,designer,PERSON-PERSON,TITLE,PROPN-PROPN,NOUN,compound-nsubj,appos,NNP-NNP,NN,3,1
823,15181.0,64,Oscar,0,22,21,-1,21,42,-22,21,Mark Fisher,designer,PERSON-PERSON,TITLE,PROPN-PROPN,NOUN,compound-pobj,compound,NNP-NNP,NN,1,1
824,1499.0,28,say,1,3,6,3,2,21,-2,5,Vladimir Ladyzhenskiy,late Saturday,PERSON-PERSON,DATE-DATE,PROPN-PROPN,ADJ-PROPN,compound-nsubj,amod-npadvmod,NNP-NNP,JJ-NNP,2,1
825,8490.0,35,pronounced,13,1,16,15,0,18,12,3,Vladimir Ladyzhenskiy,late Saturday,PERSON-PERSON,DATE-DATE,PROPN-PROPN,ADJ-PROPN,compound-nsubjpass,amod-npadvmod,NNP-NNP,JJ-NNP,2,1
826,10966.0,21,pronounced,3,1,6,5,0,14,2,3,Vladimir Ladyzhenskiy,late Saturday,PERSON-PERSON,DATE-DATE,PROPN-PROPN,ADJ-PROPN,compound-nsubjpass,amod-npadvmod,NNP-NNP,JJ-NNP,2,1
827,14798.0,26,say,1,3,6,3,2,19,-2,5,Vladimir Ladyzhenskiy,late Saturday,PERSON-PERSON,DATE-DATE,PROPN-PROPN,ADJ-PROPN,compound-nsubj,amod-npadvmod,NNP-NNP,JJ-NNP,2,1
828,1503.0,25,wrote,2,12,1,-11,11,23,-10,-1,Alan Gross,Judy Gross,PERSON-PERSON,PERSON-PERSON,PROPN-PROPN,PROPN-PROPN,compound-appos,compound-nsubj,NNP-NNP,NNP-NNP,6,1
829,6225.0,16,arrested,7,5,1,-4,4,14,2,-6,Alan Gross,Judy Gross,PERSON-PERSON,PERSON-PERSON,PROPN-PROPN,PROPN-PROPN,compound-nsubjpass,compound-poss,NNP-NNP,NNP-NNP,2,1
830,1505.0,63,Poverty,0,40,1,-39,39,61,-40,1,PSIA,Poverty and Social Impact Analysis of Reforms,ORGANIZATION,ORGANIZATION-ORGANIZATION-ORGANIZATION-ORGANIZATION-ORGANIZATION-ORGANIZATION-ORGANIZATION,NOUN,PROPN-CCONJ-PROPN-PROPN-PROPN-ADP-PROPN,nsubjpass,conj-cc-compound-conj-nsubj-prep-pobj,NNS,NNP-CC-NNP-NNP-NNP-IN-NNP,-1,1
831,11217.0,63,Poverty,0,40,1,-39,39,61,-40,1,PSIA,Poverty and Social Impact Analysis of Reforms,ORGANIZATION,ORGANIZATION-ORGANIZATION-ORGANIZATION-ORGANIZATION-ORGANIZATION-ORGANIZATION-ORGANIZATION,PROPN,PROPN-CCONJ-PROPN-PROPN-PROPN-ADP-PROPN,pobj,conj-cc-compound-conj-nsubj-prep-pobj,NNP,NNP-CC-NNP-NNP-NNP-IN-NNP,-1,1
832,1514.0,24,came,2,15,5,-10,14,18,-13,3,ADF,Islamist,ORGANIZATION,RELIGION,PROPN,ADJ,compound,amod,NNP,JJ,3,1
833,1515.0,19,live,4,14,18,4,13,0,-10,14,Menil Collection,Houston,ORGANIZATION-ORGANIZATION,CITY,PROPN-PROPN,PROPN,compound-compound,pobj,NNP-NNP,NNP,5,1
834,2582.0,33,born,2,16,19,3,15,13,-14,17,Menil Collection,Houston,ORGANIZATION-ORGANIZATION,CITY,PROPN-PROPN,PROPN,compound-dobj,pobj,NNP-NNP,NNP,1,1
835,4329.0,33,born,2,16,19,3,15,13,-14,17,Menil Collection,Houston,ORGANIZATION-ORGANIZATION,CITY,PROPN-PROPN,PROPN,compound-dobj,pobj,NNP-NNP,NNP,1,1
836,5869.0,22,are,6,10,6,-4,9,15,-4,0,Menil Collection,Houston,ORGANIZATION-ORGANIZATION,CITY,PROPN-PROPN,PROPN,compound-pobj,pobj,NNP-NNP,NNP,2,1
837,10359.0,21,inspired,17,3,8,5,2,12,14,-9,Menil Collection,Houston,ORGANIZATION-ORGANIZATION,CITY,PROPN-PROPN,PROPN,compound-compound,pobj,NNP-NNP,NNP,3,1
838,11937.0,50,featured,32,46,49,3,45,0,-14,17,Menil Collection,Houston,ORGANIZATION-ORGANIZATION,CITY,PROPN-PROPN,PROPN,compound-pobj,pobj,NNP-NNP,NNP,2,1
839,12503.0,18,involved,6,14,17,3,13,0,-8,11,Menil Collection,Houston,ORGANIZATION-ORGANIZATION,CITY,PROPN-PROPN,PROPN,compound-conj,pobj,NNP-NNP,NNP,4,1
840,14850.0,48,named,34,40,47,7,39,0,-6,13,Menil Collection,Houston,ORGANIZATION-ORGANIZATION,CITY,PROPN-PROPN,PROPN,compound-poss,pobj,NNP-NNP,NNP,5,1
841,1517.0,39,told,28,25,2,-23,24,36,3,-26,Charles Ble Goude,African,PERSON-PERSON-PERSON,NATIONALITY,PROPN-PROPN-PROPN,ADJ,compound-compound-appos,amod,NNP-NNP-NNP,JJ,5,1
842,1521.0,46,died,37,1,13,12,0,32,36,-24,Norris Church Mailer,Arkansas,PERSON-PERSON-PERSON,STATE_OR_PROVINCE,PROPN-PROPN-PROPN,PROPN,compound-compound-nsubj,pobj,NNP-NNP-NNP,NNP,6,1
843,1525.0,20,served,5,5,16,11,4,3,0,11,he,president,PERSON,TITLE,PRON,NOUN,nsubj,pobj,PRP,NN,3,1
844,1527.0,20,charged,3,1,6,5,0,13,2,3,Graham,South Dakota,PERSON,STATE_OR_PROVINCE-STATE_OR_PROVINCE,PROPN,PROPN-PROPN,nsubjpass,compound-compound,NNP,NNP-NNP,4,1
845,13177.0,30,testified,3,7,19,12,6,10,-4,16,Graham,South Dakota,PERSON,STATE_OR_PROVINCE-STATE_OR_PROVINCE,PROPN,PROPN-PROPN,nsubj,compound-poss,NNP,NNP-NNP,8,1
846,1532.0,48,wrote,43,10,14,4,9,33,33,-29,his,systems analyst,PERSON,TITLE-TITLE,DET,NOUN-NOUN,poss,compound-pobj,PRP$,NNS-NN,4,1
847,4596.0,48,wrote,43,10,14,4,9,33,33,-29,his,systems analyst,PERSON,TITLE-TITLE,DET,NOUN-NOUN,poss,compound-pobj,PRP$,NNS-NN,4,1
848,1537.0,29,testified,11,1,8,7,0,20,10,-3,Looking Cloud,murder,PERSON-PERSON,CRIMINAL_CHARGE,VERB-PROPN,NOUN,compound-nsubj,pobj,VBG-NNP,NN,2,1
849,1545.0,17,closed,2,1,10,9,0,6,1,8,New Fabris,366,ORGANIZATION-ORGANIZATION,NUMBER,PROPN-PROPN,NUM,compound-nsubj,nummod,NNP-NNP,CD,3,1
850,15371.0,32,linked,2,16,30,14,15,1,-14,28,New Fabris,366,ORGANIZATION-ORGANIZATION,NUMBER,PROPN-PROPN,NUM,compound-appos,nummod,NNP-NNP,CD,8,1
851,1548.0,29,is,1,1,6,5,0,22,0,5,Gonzalez,Patricia Gonzalez,PERSON,PERSON-PERSON,PROPN,PROPN-PROPN,nsubj,compound-pobj,NNP,NNP-NNP,3,1
852,4640.0,38,kidnapped,6,1,22,21,0,15,5,16,Gonzalez,Patricia Gonzalez,PERSON,PERSON-PERSON,PROPN,PROPN-PROPN,nsubjpass,compound-appos,NNP,NNP-NNP,5,1
853,8717.0,38,kidnapped,6,1,22,21,0,15,5,16,Gonzalez,Patricia Gonzalez,PERSON,PERSON-PERSON,PROPN,PROPN-PROPN,nsubjpass,compound-appos,NNP,NNP-NNP,5,1
854,12443.0,23,is,1,1,6,5,0,16,0,5,Gonzalez,Patricia Gonzalez,PERSON,PERSON-PERSON,PROPN,PROPN-PROPN,nsubj,compound-pobj,NNP,NNP-NNP,3,1
855,1560.0,62,said,41,15,48,33,14,13,26,7,National Restaurant Association,IHOP Corp.,ORGANIZATION-ORGANIZATION-ORGANIZATION,ORGANIZATION-ORGANIZATION,PROPN-PROPN-PROPN,PROPN-PROPN,compound-compound-poss,compound-pobj,NNP-NNP-NNP,NNP-NNP,10,1
856,1561.0,9,denies,3,9,8,-1,8,0,-6,5,contractor,US,PERSON,COUNTRY,NOUN,PROPN,pobj,compound,NN,NNP,-1,1
857,1569.0,46,updated,7,23,45,22,22,0,-16,38,he,8/4/2009,PERSON,DATE,PRON,NUM,nsubj,intj,PRP,CD,3,1
858,1576.0,38,served,4,1,11,10,0,26,3,7,Wen,Chongqing Municipal Judicial Bureau,PERSON,ORGANIZATION-ORGANIZATION-ORGANIZATION-ORGANIZATION,PROPN,PROPN-PROPN-PROPN-PROPN,nsubj,compound-compound-compound-pobj,NNP,NNP-NNP-NNP-NNP,7,1
859,1589.0,40,moved,5,5,29,24,4,10,0,24,he,detective,PERSON,TITLE,PRON,NOUN,nsubj,pobj,PRP,NN,3,1
860,1591.0,32,reprint,2,18,29,11,17,2,-16,27,American Free Press,Washington,ORGANIZATION-ORGANIZATION-ORGANIZATION,STATE_OR_PROVINCE,PROPN-PROPN-PROPN,PROPN,compound-compound-pobj,appos,NNP-NNP-NNP,NNP,6,1
861,1600.0,23,got,1,1,6,5,0,16,0,5,She,EPF,PERSON,ORGANIZATION,PRON,PROPN,nsubj,compound,PRP,NNP,2,1
862,1603.0,29,confirmed,7,6,2,-4,5,26,1,-5,ADF,Australian Defense Force,ORGANIZATION,ORGANIZATION-ORGANIZATION-ORGANIZATION,PROPN,PROPN-PROPN-PROPN,compound,compound-compound-nsubj,NNP,NNP-NNP-NNP,3,1
863,2543.0,38,said,8,25,21,-4,24,16,-17,13,ADF,Australian Defense Force,ORGANIZATION,ORGANIZATION-ORGANIZATION-ORGANIZATION,PROPN,PROPN-PROPN-PROPN,compound,compound-compound-compound,NNP,NNP-NNP-NNP,3,1
864,3372.0,34,by,0,29,25,-4,28,8,-29,25,ADF,Australian Defense Force,ORGANIZATION,ORGANIZATION-ORGANIZATION-ORGANIZATION,PROPN,PROPN-PROPN-PROPN,compound,compound-compound-pobj,NNP,NNP-NNP-NNP,7,1
865,8030.0,48,Australia,0,12,14,2,11,33,-12,14,ADF,Australian Defense Force,ORGANIZATION,ORGANIZATION-ORGANIZATION-ORGANIZATION,PROPN,PROPN-PROPN-PROPN,compound,compound-compound-compound,NNP,NNP-NNP-NNP,-1,1
866,10709.0,34,Force,2,5,1,-4,4,32,-3,-1,ADF,Australian Defense Force,ORGANIZATION,ORGANIZATION-ORGANIZATION-ORGANIZATION,PROPN,PROPN-PROPN-PROPN,compound,amod-compound-ROOT,NNP,NNP-NNP-NNP,3,1
867,1610.0,32,left,27,22,9,-13,21,22,5,-18,Eliza Samudio,Bruno,PERSON-PERSON,PERSON,PROPN-PROPN,PROPN,compound-appos,appos,NNP-NNP,NNPS,6,1
868,5643.0,38,dismissed,6,36,5,-31,35,32,-30,-1,Eliza Samudio,Bruno,PERSON-PERSON,PERSON,PROPN-PROPN,PROPN,compound-appos,appos,NNP-NNP,NNP,9,1
869,1616.0,48,said,31,12,45,33,11,2,19,14,OANA,Ahmad Mukhlis Yusuf,ORGANIZATION,PERSON-PERSON-PERSON,PROPN,PROPN-PROPN-PROPN,compound,compound-compound-appos,NNP,NNP-NNP-NNP,7,1
870,6822.0,68,discuss,3,47,49,2,46,18,-44,46,OANA,Ahmad Mukhlis Yusuf,ORGANIZATION,PERSON-PERSON-PERSON,PROPN,PROPN-PROPN-PROPN,compound,compound-compound-nsubj,NNP,NNP-NNP-NNP,4,1
871,13187.0,50,President,2,2,14,12,1,35,0,12,OANA,Ahmad Mukhlis Yusuf,ORGANIZATION,PERSON-PERSON-PERSON,PROPN,PROPN-PROPN-PROPN,compound,compound-compound-appos,NNP,NNP-NNP-NNP,5,1
872,13671.0,48,said,31,12,45,33,11,2,19,14,OANA,Ahmad Mukhlis Yusuf,ORGANIZATION,PERSON-PERSON-PERSON,PROPN,PROPN-PROPN-PROPN,compound,compound-compound-appos,NNP,NNP-NNP-NNP,7,1
873,1622.0,29,...,0,5,9,4,4,19,-5,9,Wayne,65,PERSON,NUMBER,PROPN,NUM,appos,nummod,NNP,CD,5,1
874,1633.0,24,was,1,1,4,3,0,19,0,3,Miettinen,assistant,PERSON,TITLE,PROPN,NOUN,nsubj,attr,NNP,NN,2,1
875,1638.0,33,said,22,2,20,18,1,12,20,-2,"Amanda like the rest is extremely disappointed , upset about the decision , '' Knox",Edda Mellas,PERSON-PERSON-PERSON-PERSON-PERSON-PERSON-PERSON-PERSON-PERSON-PERSON-PERSON-PERSON-PERSON-PERSON-PERSON,PERSON-PERSON,X-ADP-DET-NOUN-VERB-ADV-ADJ-PUNCT-ADJ-ADP-DET-NOUN-PUNCT-PUNCT-PROPN,PROPN-PROPN,nsubj-prep-det-pobj-ccomp-advmod-acomp-punct-acomp-prep-det-pobj-punct-punct-poss,compound-appos,"FW-IN-DT-NN-VBZ-RB-JJ-,-JJ-IN-DT-NN-,-''-NNP",NNP-NNP,5,1
876,1654.0,57,told,30,28,26,-2,27,30,2,-4,Laura Silsby,spokeswoman,PERSON-PERSON,TITLE,PROPN-PROPN,NOUN,compound-appos,nsubj,NNP-NNP,NN,2,1
877,2483.0,56,told,29,27,25,-2,26,30,2,-4,Laura Silsby,spokeswoman,PERSON-PERSON,TITLE,PROPN-PROPN,NOUN,compound-appos,nsubj,NNP-NNP,NN,2,1
878,1669.0,20,was,14,1,16,15,0,3,13,2,Aquash,30,PERSON,NUMBER,PROPN,NUM,nsubj,attr,NNP,CD,4,1
879,11175.0,23,was,14,1,16,15,0,6,13,2,Aquash,30,PERSON,NUMBER,PROPN,NUM,nsubj,attr,NNP,CD,4,1
880,1670.0,24,refuses,2,19,16,-3,18,7,-17,14,Eliza Samudio,murder,PERSON-PERSON,CAUSE_OF_DEATH,PROPN-PROPN,NOUN,compound-pobj,conj,NNP-NNP,NN,3,1
881,8931.0,25,said,2,23,16,-7,22,8,-21,14,Eliza Samudio,murder,PERSON-PERSON,CAUSE_OF_DEATH,PROPN-PROPN,NOUN,compound-appos,conj,NNP-NNP,NN,7,1
882,14779.0,38,JANEIRO,2,36,33,-3,35,4,-34,31,Eliza Samudio,murder,PERSON-PERSON,CAUSE_OF_DEATH,PROPN-PROPN,NOUN,compound-pobj,conj,NNP-NNP,NN,3,1
883,1673.0,64,deserve,61,29,1,-28,28,62,32,-60,she,Iraq,PERSON,COUNTRY,PRON,PROPN,nsubj,nmod,PRP,NNP,4,1
884,5154.0,13,transferred,7,6,12,6,5,0,1,5,she,Iraq,PERSON,COUNTRY,PRON,PROPN,nsubjpass,pobj,PRP,NNP,2,1
885,13827.0,43,says,5,7,14,7,6,28,-2,9,she,Iraq,PERSON,COUNTRY,PRON,PROPN,nsubjpass,pobj,PRP,NNP,2,1
886,1678.0,25,raised,5,17,19,2,16,5,-12,14,ALICO,MetLife,ORGANIZATION,ORGANIZATION,PROPN,PROPN,pobj,pobj,NNP,NNP,2,1
887,1742.0,31,said,29,10,1,-9,9,29,19,-28,ALICO,MetLife,ORGANIZATION,ORGANIZATION,PROPN,PROPN,compound,compound,NNP,NNP,4,1
888,2784.0,32,said,30,11,1,-10,10,30,19,-29,ALICO,MetLife,ORGANIZATION,ORGANIZATION,PROPN,PROPN,compound,compound,NNP,NNP,4,1
889,4927.0,11,says,1,7,1,-6,6,9,-6,0,ALICO,MetLife,ORGANIZATION,ORGANIZATION,PROPN,PROPN,dobj,nsubj,NNP,NNP,2,1
890,5080.0,25,raised,5,17,19,2,16,5,-12,14,ALICO,MetLife,ORGANIZATION,ORGANIZATION,PROPN,PROPN,pobj,pobj,NNP,NNP,2,1
891,7808.0,11,carries,8,5,7,2,4,3,3,-1,ALICO,MetLife,ORGANIZATION,ORGANIZATION,PROPN,PROPN,pobj,pobj,NNP,NNP,3,1
892,10313.0,30,said,5,21,5,-16,20,24,-16,0,ALICO,MetLife,ORGANIZATION,ORGANIZATION,PROPN,PROPN,compound,nsubj,NNP,NNP,3,1
893,10713.0,31,said,29,10,1,-9,9,29,19,-28,ALICO,MetLife,ORGANIZATION,ORGANIZATION,PROPN,PROPN,compound,poss,NNP,NNP,4,1
894,11039.0,37,said,32,10,1,-9,9,35,22,-31,ALICO,MetLife,ORGANIZATION,ORGANIZATION,PROPN,PROPN,compound,nsubj,NNP,NNP,2,1
895,13704.0,13,says,3,9,3,-6,8,9,-6,0,ALICO,MetLife,ORGANIZATION,ORGANIZATION,PROPN,PROPN,dobj,nsubj,NNP,NNP,3,1
896,13820.0,37,said,32,10,1,-9,9,35,22,-31,ALICO,MetLife,ORGANIZATION,ORGANIZATION,PROPN,PROPN,compound,compound,NNP,NNP,2,1
897,1680.0,30,provided,2,16,27,11,15,2,-14,25,he,Thailand,PERSON,COUNTRY,PRON,PROPN,nsubj,pobj,PRP,NNP,1,1
898,1687.0,41,were,2,20,24,4,19,16,-18,22,Wen Qiang,director,PERSON-PERSON,TITLE,PROPN-PROPN,NOUN,compound-conj,appos,NNP-NNP,NN,2,1
899,2089.0,47,said,45,12,31,19,11,15,33,-14,Wen Qiang,director,PERSON-PERSON,TITLE,PROPN-PROPN,NOUN,compound-pobj,attr,NNP-NNP,NN,6,1
900,3360.0,43,convicted,14,9,2,-7,8,40,5,-12,Wen Qiang,director,PERSON-PERSON,TITLE,PROPN-PROPN,NOUN,compound-pobj,nsubjpass,NNP-NNP,NN,1,1
901,3582.0,26,was,3,5,8,3,4,17,-2,5,Wen Qiang,director,PERSON-PERSON,TITLE,PROPN-PROPN,NOUN,compound-nsubj,appos,NNP-NNP,NN,2,1
902,6280.0,36,suspected,14,1,6,5,0,29,13,-8,Wen Qiang,director,PERSON-PERSON,TITLE,PROPN-PROPN,NOUN,compound-nsubjpass,appos,NNP-NNP,NN,3,1
903,6604.0,32,announced,22,7,13,6,6,18,15,-9,Wen Qiang,director,PERSON-PERSON,TITLE,PROPN-PROPN,NOUN,compound-pobj,appos,NNP-NNP,NN,2,1
904,6920.0,30,attracted,3,12,15,3,11,14,-9,12,Wen Qiang,director,PERSON-PERSON,TITLE,PROPN-PROPN,NOUN,compound-dobj,appos,NNP-NNP,NN,2,1
905,7013.0,19,convicted,14,9,2,-7,8,16,5,-12,Wen Qiang,director,PERSON-PERSON,TITLE,PROPN-PROPN,NOUN,compound-pobj,nsubjpass,NNP-NNP,NN,1,1
906,8113.0,26,was,1,5,18,13,4,7,-4,17,Wen Qiang,director,PERSON-PERSON,TITLE,PROPN-PROPN,NOUN,compound-pobj,conj,NNP-NNP,NN,10,1
907,8607.0,40,deliver,9,14,18,4,13,21,-5,9,Wen Qiang,director,PERSON-PERSON,TITLE,PROPN-PROPN,NOUN,compound-pobj,appos,NNP-NNP,NN,2,1
908,11442.0,51,said,10,12,37,25,11,13,-2,27,Wen Qiang,director,PERSON-PERSON,TITLE,PROPN-PROPN,NOUN,compound-nsubj,attr,NNP-NNP,NN,5,1
909,1690.0,33,said,1,13,11,-2,12,21,-12,10,Nuclear Decommissioning Authority,Britain,ORGANIZATION-ORGANIZATION-ORGANIZATION,COUNTRY,PROPN-PROPN-PROPN,PROPN,compound-compound-compound,poss,NNP-NNP-NNP,NNP,3,1
910,1692.0,34,said,14,16,22,6,15,11,-2,8,Ahmed Rashid,analyst,PERSON-PERSON,TITLE,PROPN-PROPN,NOUN,compound-nsubj,appos,NNP-NNP,NN,2,1
911,2221.0,33,told,28,27,26,-1,26,6,1,-2,Ahmed Rashid,analyst,PERSON-PERSON,TITLE,PROPN-PROPN,NOUN,compound-nsubj,compound,NNP-NNP,NN,1,1
912,2249.0,27,said,11,13,18,5,12,8,-2,7,Ahmed Rashid,analyst,PERSON-PERSON,TITLE,PROPN-PROPN,NOUN,compound-nsubj,appos,NNP-NNP,NN,2,1
913,1697.0,49,embroiled,3,35,1,-34,34,47,-32,-2,Cheng,China,PERSON,COUNTRY,PROPN,PROPN,nsubj,poss,NNP,NNP,6,1
914,1698.0,36,include,1,3,17,14,2,18,-2,16,his,Harris,PERSON,PERSON,DET,PROPN,poss,conj,PRP$,NNP,2,1
915,10646.0,36,include,1,3,17,14,2,18,-2,16,his,Harris,PERSON,PERSON,DET,PROPN,poss,conj,PRP$,NNP,2,1
916,1720.0,33,said,31,4,11,7,3,21,27,-20,New Fabris,Chatellerault,ORGANIZATION-ORGANIZATION,CITY,PROPN-PROPN,PROPN,compound-pobj,pobj,NNP-NNP,NNP,5,1
917,2271.0,35,took,3,18,27,9,17,7,-15,24,New Fabris,Chatellerault,ORGANIZATION-ORGANIZATION,CITY,PROPN-PROPN,PROPN,compound-pobj,pobj,NNP-NNP,NNP,10,1
918,7789.0,22,was,3,10,21,11,9,0,-7,18,New Fabris,Chatellerault,ORGANIZATION-ORGANIZATION,CITY,PROPN-PROPN,PROPN,compound-pobj,pobj,NNP-NNP,NNP,6,1
919,15054.0,38,demanding,17,6,14,8,5,23,11,-3,New Fabris,Chatellerault,ORGANIZATION-ORGANIZATION,CITY,PROPN-PROPN,PROPN,compound-compound,pobj,NNP-NNP,NNP,5,1
920,1726.0,47,love,3,27,37,10,26,9,-24,34,Benjamin Chertoff,Michael Chertoff.thats,PERSON-PERSON,PERSON-PERSON,PROPN-PROPN,PROPN-PROPN,compound-attr,compound-appos,NNP-NNP,NNP-NNP,5,1
921,1734.0,43,lived,3,11,18,7,10,24,-8,15,his,REPORTER,PERSON,TITLE,DET,NOUN,poss,poss,PRP$,NN,-1,1
922,1747.0,43,is,3,31,29,-2,30,13,-28,26,TPI,his,ORGANIZATION,PERSON,PROPN,DET,dep,poss,NNP,PRP$,2,1
923,1759.0,27,includes,4,1,18,17,0,8,3,14,PDA,Medea Benjamin,ORGANIZATION,PERSON-PERSON,PROPN,PROPN-PROPN,poss,compound-conj,NNP,NNP-NNP,8,1
924,1763.0,33,acknowledge,2,5,7,2,4,25,-3,5,Gross,Cuba,PERSON,COUNTRY,PROPN,PROPN,nsubj,dobj,NNP,NNP,1,1
925,4316.0,19,sent,12,1,15,14,0,3,11,3,Gross,Cuba,PERSON,COUNTRY,PROPN,PROPN,nsubjpass,pobj,NNP,NNP,3,1
926,14498.0,47,says,3,5,8,3,4,38,-2,5,Gross,Cuba,PERSON,COUNTRY,PROPN,PROPN,nsubj,pobj,NNP,NNP,1,1
927,1776.0,8,officer,4,1,7,6,0,0,3,3,Alico,Christopher J,ORGANIZATION,PERSON-PERSON,PROPN,PROPN-PROPN,poss,compound-appos,NNP,NNP-NNP,3,1
928,1777.0,25,said,23,17,7,-10,16,17,6,-16,he,health club,PERSON,ORGANIZATION-ORGANIZATION,PRON,NOUN-NOUN,nsubj,compound-pobj,PRP,NN-NN,5,1
929,1781.0,39,released,2,11,10,-1,10,28,-9,8,Carol Daniels,61-year-old,PERSON-PERSON,NUMBER,PROPN-PROPN,NUM,compound-pobj,amod,NNP-NNP,CD,1,1
930,9190.0,17,includes,2,8,7,-1,7,9,-6,5,Carol Daniels,61-year-old,PERSON-PERSON,NUMBER,PROPN-PROPN,NUM,compound-nsubj,amod,NNP-NNP,CD,1,1
931,9844.0,33,is,9,20,19,-1,19,13,-11,10,Carol Daniels,61-year-old,PERSON-PERSON,NUMBER,PROPN-PROPN,NUM,compound-pobj,amod,NNP-NNP,CD,1,1
932,9898.0,36,released,2,11,10,-1,10,25,-9,8,Carol Daniels,61-year-old,PERSON-PERSON,DURATION,PROPN-PROPN,NUM,compound-pobj,amod,NNP-NNP,CD,1,1
933,13904.0,17,be,6,4,3,-1,3,13,2,-3,Carol Daniels,61-year-old,PERSON-PERSON,DURATION,PROPN-PROPN,NUM,compound-pobj,amod,NNP-NNP,CD,1,1
934,14766.0,42,ANADARKO,0,17,16,-1,16,25,-17,16,Carol Daniels,61-year-old,PERSON-PERSON,NUMBER,PROPN-PROPN,NUM,compound-pobj,amod,NNP-NNP,CD,1,1
935,1789.0,83,include,2,1,25,24,0,57,1,23,OANA,ANTARA,ORGANIZATION,ORGANIZATION,PROPN,PROPN,compound,conj,NNP,NNP,6,1
936,1790.0,30,was,7,5,14,9,4,15,2,7,Jamie Leigh Jones,Iraq,PERSON-PERSON-PERSON,COUNTRY,PROPN-PROPN-PROPN,PROPN,compound-compound-appos,pobj,NNP-NNP-NNP,NNP,4,1
937,3961.0,58,says,7,1,46,45,0,11,6,39,Jamie Leigh Jones,Iraq,PERSON-PERSON-PERSON,CITY,PROPN-PROPN-PROPN,PROPN,compound-compound-nsubj,dobj,NNP-NNP-NNP,NNP,7,1
938,5058.0,41,was,4,6,30,24,5,10,-2,26,Jamie Leigh Jones,Iraq,PERSON-PERSON-PERSON,COUNTRY,PROPN-PROPN-PROPN,PROPN,compound-compound-nsubj,pobj,NNP-NNP-NNP,NNP,7,1
939,1791.0,37,said,32,10,5,-5,9,31,22,-27,ALICO,American Life Insurance Company,ORGANIZATION,ORGANIZATION-ORGANIZATION-ORGANIZATION-ORGANIZATION,PROPN,PROPN-PROPN-PROPN-PROPN,compound,compound-compound-compound-dobj,NNP,NNP-NNP-NNP-NNP,3,1
940,2482.0,32,said,30,11,6,-5,10,25,19,-24,ALICO,American Life Insurance Company,ORGANIZATION,ORGANIZATION-ORGANIZATION-ORGANIZATION-ORGANIZATION,PROPN,PROPN-PROPN-PROPN-PROPN,compound,compound-compound-compound-pobj,NNP,NNP-NNP-NNP-NNP,6,1
941,5559.0,21,raised,3,16,11,-5,15,9,-13,8,ALICO,American Life Insurance Company,ORGANIZATION,ORGANIZATION-ORGANIZATION-ORGANIZATION-ORGANIZATION,PROPN,PROPN-PROPN-PROPN-PROPN,compound,compound-compound-compound-dobj,NNP,NNP-NNP-NNP-NNP,4,1
942,5650.0,44,said,39,6,12,6,5,31,33,-27,ALICO,American Life Insurance Company,ORGANIZATION,ORGANIZATION-ORGANIZATION-ORGANIZATION-ORGANIZATION,PROPN,PROPN-PROPN-PROPN-PROPN,compound,compound-compound-compound-dobj,NNP,NNP-NNP-NNP-NNP,4,1
943,7185.0,32,raised,18,11,6,-5,10,25,7,-12,ALICO,American Life Insurance Company,ORGANIZATION,ORGANIZATION-ORGANIZATION-ORGANIZATION-ORGANIZATION,PROPN,PROPN-PROPN-PROPN-PROPN,compound,compound-compound-compound-pobj,NNP,NNP-NNP-NNP-NNP,6,1
944,8400.0,38,said,36,17,12,-5,16,25,19,-24,ALICO,American Life Insurance Company,ORGANIZATION,ORGANIZATION-ORGANIZATION-ORGANIZATION-ORGANIZATION,PROPN,PROPN-PROPN-PROPN-PROPN,compound,compound-compound-compound-pobj,NNP,NNP-NNP-NNP-NNP,8,1
945,11009.0,48,YORK,1,38,11,-27,37,36,-37,10,ALICO,American Life Insurance Company,ORGANIZATION,ORGANIZATION-ORGANIZATION-ORGANIZATION-ORGANIZATION,PROPN,PROPN-PROPN-PROPN-PROPN,compound,compound-compound-compound-appos,NNP,NNP-NNP-NNP-NNP,6,1
946,11227.0,32,raised,18,11,6,-5,10,25,7,-12,ALICO,American Life Insurance Company,ORGANIZATION,ORGANIZATION-ORGANIZATION-ORGANIZATION-ORGANIZATION,PROPN,PROPN-PROPN-PROPN-PROPN,compound,compound-compound-compound-pobj,NNP,NNP-NNP-NNP-NNP,6,1
947,11728.0,8,-LRB-,1,1,3,2,0,4,0,2,ALICO,American Life Insurance Company,ORGANIZATION,ORGANIZATION-ORGANIZATION-ORGANIZATION-ORGANIZATION,PROPN,PROPN-PROPN-PROPN-PROPN,compound,compound-compound-compound-compound,NNP,NNP-NNP-NNP-NNP,4,1
948,12936.0,42,YORK,1,17,12,-5,16,29,-16,11,ALICO,American Life Insurance Company,ORGANIZATION,ORGANIZATION-ORGANIZATION-ORGANIZATION-ORGANIZATION,PROPN,PROPN-PROPN-PROPN-PROPN,compound,compound-compound-compound-pobj,NNP,NNP-NNP-NNP-NNP,6,1
949,1793.0,15,Collection,3,3,14,11,2,0,0,11,Menil Collection,menil.org,ORGANIZATION-ORGANIZATION,URL,PROPN-PROPN,X,compound-ROOT,appos,NNP-NNP,ADD,3,1
950,1798.0,31,are,2,5,10,5,4,20,-3,8,Progressive Democrats of America,PDA,ORGANIZATION-ORGANIZATION-ORGANIZATION-ORGANIZATION,ORGANIZATION,PROPN-PROPN-ADP-PROPN,PROPN,compound-attr-prep-pobj,compound,NNP-NNPS-IN-NNP,NNP,3,1
951,7204.0,17,works,8,4,1,-3,3,15,4,-7,Progressive Democrats of America,PDA,ORGANIZATION-ORGANIZATION-ORGANIZATION-ORGANIZATION,ORGANIZATION,PROPN-PROPN-ADP-PROPN,PROPN,compound-appos-prep-pobj,nsubj,NNP-NNPS-IN-NNP,NNP,2,1
952,8462.0,32,hope,1,12,17,5,11,14,-11,16,Progressive Democrats of America,PDA,ORGANIZATION-ORGANIZATION-ORGANIZATION-ORGANIZATION,ORGANIZATION,PROPN-PROPN-ADP-PROPN,PROPN,compound-pobj-prep-pobj,compound,NNP-NNPS-IN-NNP,NNP,-1,1
953,10789.0,37,wrote,2,20,16,-4,19,20,-18,14,Progressive Democrats of America,PDA,ORGANIZATION-ORGANIZATION-ORGANIZATION-ORGANIZATION,ORGANIZATION,PROPN-PROPN-ADP-PROPN,PROPN,compound-conj-prep-compound,compound,NNP-NNPS-IN-NNP,NNP,2,1
954,11079.0,52,WASHIINGTON,0,35,40,5,34,11,-35,40,Progressive Democrats of America,PDA,ORGANIZATION-ORGANIZATION-ORGANIZATION-ORGANIZATION,ORGANIZATION,PROPN-PROPN-ADP-PROPN,PROPN,compound-pobj-prep-pobj,compound,NNP-NNPS-IN-NNP,NNP,-1,1
955,1801.0,26,sells,9,5,8,3,4,17,4,-1,Baldino,1987,PERSON,DATE,PROPN,NUM,nsubj,pobj,NNP,CD,3,1
956,1802.0,28,say,1,3,15,12,2,12,-2,14,Vladimir Ladyzhenskiy,Finland,PERSON-PERSON,COUNTRY,PROPN-PROPN,PROPN,compound-nsubj,pobj,NNP-NNP,NNP,2,1
957,1900.0,26,say,1,3,13,10,2,12,-2,12,Vladimir Ladyzhenskiy,Finland,PERSON-PERSON,COUNTRY,PROPN-PROPN,PROPN,compound-nsubj,pobj,NNP-NNP,NNP,2,1
958,1809.0,50,began,4,44,49,5,43,0,-40,45,Koch Foods,Ohio,ORGANIZATION-ORGANIZATION,STATE_OR_PROVINCE,PROPN-PROPN,PROPN,compound-pobj,appos,NNP-NNP,NNP,5,1
959,4789.0,44,said,28,14,19,5,13,24,14,-9,Koch Foods,Ohio,ORGANIZATION-ORGANIZATION,STATE_OR_PROVINCE,PROPN-PROPN,PROPN,compound-compound,pobj,NNP-NNP,NNP,6,1
960,1811.0,40,told,6,13,2,-11,12,37,-7,-4,her,Ashiq Masih,PERSON,PERSON-PERSON,DET,PROPN-PROPN,poss,compound-nsubj,PRP$,NNP-NNP,4,1
961,1814.0,21,sees,3,18,11,-7,17,9,-15,8,his,U.S.,PERSON,COUNTRY,DET,PROPN,poss,pobj,PRP$,NNP,6,1
962,1816.0,24,said,1,8,12,4,7,11,-7,11,Pluribus,George Green,ORGANIZATION,PERSON-PERSON,PROPN,PROPN-PROPN,dobj,compound-pobj,NNP,NNP-NNP,4,1
963,1819.0,37,advocated,14,2,12,10,1,24,12,-2,National Congress of American Indians,D.C.,ORGANIZATION-ORGANIZATION-ORGANIZATION-ORGANIZATION-ORGANIZATION,LOCATION,PROPN-PROPN-ADP-PROPN-PROPN,PROPN,compound-nsubj-prep-compound-pobj,appos,NNP-NNP-IN-NNP-NNPS,NNP,2,1
964,1821.0,36,identifies,1,6,9,3,5,26,-5,8,George Sodini,48,PERSON-PERSON,NUMBER,PROPN-PROPN,NUM,compound-pobj,appos,NNP-NNP,CD,1,1
965,3172.0,17,bought,5,1,4,3,0,12,4,-1,George Sodini,48,PERSON-PERSON,NUMBER,PROPN-PROPN,NUM,compound-nsubj,appos,NNP-NNP,CD,2,1
966,5128.0,38,confirmed,4,11,14,3,10,23,-7,10,George Sodini,48,PERSON-PERSON,NUMBER,PROPN-PROPN,NUM,compound-attr,appos,NNP-NNP,CD,1,1
967,13171.0,29,confirmed,4,11,14,3,10,14,-7,10,George Sodini,48,PERSON-PERSON,NUMBER,PROPN-PROPN,NUM,compound-attr,appos,NNP-NNP,CD,1,1
968,1822.0,37,working,11,1,4,3,0,32,10,-7,Gross,60-year-old,PERSON,NUMBER,PROPN,NUM,nsubj,amod,NNP,CD,5,1
969,1830.0,33,is,9,20,31,11,19,1,-11,22,Carol Daniels,Oklahoma City,PERSON-PERSON,CITY-CITY,PROPN-PROPN,PROPN-PROPN,compound-pobj,compound-pobj,NNP-NNP,NNP-NNP,10,1
970,2588.0,17,be,6,4,15,11,3,1,2,9,Carol Daniels,Oklahoma City,PERSON-PERSON,CITY-CITY,PROPN-PROPN,PROPN-PROPN,compound-pobj,compound-pobj,NNP-NNP,NNP-NNP,8,1
971,1838.0,16,SOMERSET,0,8,13,5,7,2,-8,13,Miettinen,Finnish Premier League,PERSON,ORGANIZATION-ORGANIZATION-ORGANIZATION,PROPN,PROPN-PROPN-PROPN,nsubj,amod-compound-pobj,NNP,NNP-NNP-NNP,4,1
972,1847.0,48,included,4,33,32,-1,32,15,-29,28,Richard Gage,architect,PERSON-PERSON,TITLE,PROPN-PROPN,NOUN,compound-ROOT,compound,NNP-NNP,NN,2,1
973,5215.0,48,included,4,33,32,-1,32,15,-29,28,Richard Gage,architect,PERSON-PERSON,TITLE,PROPN-PROPN,NOUN,compound-ROOT,compound,NNP-NNP,NN,2,1
974,8772.0,41,hit,8,19,18,-1,18,22,-11,10,Richard Gage,architect,PERSON-PERSON,TITLE,PROPN-PROPN,NOUN,compound-pobj,compound,NNP-NNP,NN,1,1
975,9756.0,27,is,10,3,17,14,2,9,7,7,Richard Gage,architect,PERSON-PERSON,TITLE,PROPN-PROPN,NOUN,compound-nsubj,attr,NNP-NNP,NN,2,1
976,11323.0,42,have,7,1,41,40,0,0,6,34,Richard Gage,architect,PERSON-PERSON,TITLE,PROPN-PROPN,NOUN,compound-nsubj,pobj,NNP-NNP,NN,11,1
977,12668.0,63,FRANCISCO,1,13,12,-1,12,50,-12,11,Richard Gage,architect,PERSON-PERSON,TITLE,PROPN-PROPN,NOUN,compound-appos,compound,NNP-NNP,NN,1,1
978,14441.0,72,DO,3,22,21,-1,21,50,-19,18,Richard Gage,architect,PERSON-PERSON,TITLE,PROPN-PROPN,NOUN,compound-appos,compound,NNP-NNP,NN,1,1
979,1850.0,26,ruled,8,14,2,-12,13,23,-6,-6,Joseph Cerniglia,New York City,PERSON-PERSON,CITY-CITY-CITY,PROPN-PROPN,PROPN-PROPN-PROPN,compound-pobj,compound-nmod-nmod,NNP-NNP,NNP-NNP-NNP,8,1
980,1852.0,51,made,9,12,17,5,11,33,-3,8,Alan P. Gross,American,PERSON-PERSON-PERSON,NATIONALITY,PROPN-PROPN-PROPN,PROPN,compound-compound-pobj,appos,NNP-NNP-NNP,NNP,3,1
981,1853.0,36,include,1,3,22,19,2,13,-2,21,his,Leslie,PERSON,PERSON,DET,PROPN,poss,conj,PRP$,NNP,3,1
982,6873.0,36,include,1,3,22,19,2,13,-2,21,his,Leslie,PERSON,PERSON,DET,PROPN,poss,conj,PRP$,NNP,3,1
983,1859.0,26,became,9,16,4,-12,15,21,-7,-5,Organization of Asia - Pacific News Agencies,Azerbaijani wire service,ORGANIZATION-ORGANIZATION-ORGANIZATION-ORGANIZATION-ORGANIZATION-ORGANIZATION-ORGANIZATION,ORGANIZATION-ORGANIZATION-ORGANIZATION,PROPN-ADP-PROPN-PUNCT-PROPN-PROPN-PROPN,ADJ-NOUN-NOUN,pobj-prep-compound-punct-compound-compound-pobj,compound-compound-appos,NNP-IN-NNP-HYPH-NNP-NNP-NNPS,JJ-NN-NN,7,1
984,1860.0,55,According,0,20,5,-15,19,49,-20,5,Pacific Asia Travel Association,travel trade association,ORGANIZATION-ORGANIZATION-ORGANIZATION-ORGANIZATION,ORGANIZATION-ORGANIZATION-ORGANIZATION,PROPN-PROPN-PROPN-PROPN,NOUN-NOUN-NOUN,compound-compound-compound-conj,compound-compound-appos,NNP-NNP-NNP-NNP,NN-NN-NN,6,1
985,1861.0,35,said,33,1,8,7,0,26,32,-25,Wen Qiang,justice department,PERSON-PERSON,ORGANIZATION-ORGANIZATION,PROPN-PROPN,NOUN-NOUN,compound-nsubj,compound-pobj,NNP-NNP,NN-NN,3,1
986,2406.0,36,said,34,1,8,7,0,27,33,-26,Wen Qiang,justice department,PERSON-PERSON,ORGANIZATION-ORGANIZATION,PROPN-PROPN,NOUN-NOUN,compound-nsubj,compound-pobj,NNP-NNP,NN-NN,3,1
987,4689.0,32,announced,22,7,11,4,6,20,15,-11,Wen Qiang,justice department,PERSON-PERSON,ORGANIZATION-ORGANIZATION,PROPN-PROPN,NOUN-NOUN,compound-pobj,compound-compound,NNP-NNP,NN-NN,2,1
988,6400.0,36,is,12,1,8,7,0,27,11,-4,Wen Qiang,justice department,PERSON-PERSON,ORGANIZATION-ORGANIZATION,PROPN-PROPN,NOUN-NOUN,compound-nsubj,compound-pobj,NNP-NNP,NN-NN,3,1
989,1863.0,40,NTSO,5,6,9,3,5,30,-1,4,NTSO,Liu Suan-yung,ORGANIZATION,PERSON-PERSON,PROPN,PROPN-PROPN,ROOT,compound-nsubj,NNP,NNP-NNP,3,1
990,1864.0,24,Conference,6,14,5,-9,13,18,-8,-1,Pacific Asia Travel Association,Responsible Tourism Conference,ORGANIZATION-ORGANIZATION-ORGANIZATION-ORGANIZATION,ORGANIZATION-ORGANIZATION-ORGANIZATION,PROPN-PROPN-PROPN-PROPN,PROPN-PROPN-PROPN,compound-compound-compound-pobj,conj-compound-ROOT,NNP-NNP-NNP-NNP,NNP-NNP-NNP,6,1
991,1867.0,24,detained,4,11,7,-4,10,16,-7,3,Alan Gross,US,PERSON-PERSON,COUNTRY,PROPN-PROPN,PROPN,compound-appos,compound,NNP-NNP,NNP,2,1
992,3913.0,38,HAVANA,0,25,23,-2,24,14,-25,23,Alan Gross,US,PERSON-PERSON,ORGANIZATION,PROPN-PROPN,PROPN,compound-pobj,compound,NNP-NNP,NNP,1,1
993,7696.0,39,identified,4,9,2,-7,8,36,-5,-2,Alan Gross,US,PERSON-PERSON,COUNTRY,PROPN-PROPN,PROPN,compound-pobj,compound,NNP-NNP,NNP,3,1
994,9902.0,19,working,7,5,14,9,4,4,2,7,Alan Gross,US,PERSON-PERSON,NATIONALITY,PROPN-PROPN,PROPN,compound-nsubj,compound,NNP-NNP,NNP,5,1
995,10450.0,28,said,23,9,7,-2,8,20,14,-16,Alan Gross,US,PERSON-PERSON,COUNTRY,PROPN-PROPN,PROPN,compound-dobj,compound,NNP-NNP,NNP,1,1
996,11906.0,36,said,23,10,14,4,9,21,13,-9,Alan Gross,US,PERSON-PERSON,COUNTRY,PROPN-PROPN,PROPN,compound-pobj,compound,NNP-NNP,NNP,7,1
997,1869.0,28,is,19,26,9,-17,25,18,-7,-10,LIHOP,MIHOP,ORGANIZATION,ORGANIZATION,PROPN,PROPN,compound,compound,NNP,NNP,4,1
998,1878.0,36,testified,8,19,25,6,18,10,-11,17,Annie Mae Aquash,Canadian,PERSON-PERSON-PERSON,NATIONALITY,PROPN-PROPN-PROPN,ADJ,compound-compound-dobj,amod,NNP-NNP-NNP,JJ,4,1
999,1881.0,18,says,7,5,1,-4,4,16,2,-6,National Restaurant Association,Sue Hensley,ORGANIZATION-ORGANIZATION-ORGANIZATION,PERSON-PERSON,PROPN-PROPN-PROPN,PROPN-PROPN,compound-compound-pobj,compound-nsubj,NNP-NNP-NNP,NNP-NNP,3,1
1000,8910.0,21,said,12,17,14,-3,16,6,-5,2,National Restaurant Association,Sue Hensley,ORGANIZATION-ORGANIZATION-ORGANIZATION,PERSON-PERSON,PROPN-PROPN-PROPN,PROPN-PROPN,compound-compound-compound,compound-nsubj,NNP-NNP-NNP,NNP-NNP,4,1
1001,14490.0,45,said,41,38,31,-7,37,13,3,-10,National Restaurant Association,Sue Hensley,ORGANIZATION-ORGANIZATION-ORGANIZATION,PERSON-PERSON,PROPN-PROPN-PROPN,PROPN-PROPN,compound-compound-pobj,compound-nsubj,NNP-NNP-NNP,NNP-NNP,5,1
1002,1886.0,27,convicted,2,6,21,15,5,5,-4,19,Tao,false imprisonment,PERSON,CRIMINAL_CHARGE-CRIMINAL_CHARGE,PROPN,ADJ-NOUN,conj,amod-conj,NNP,JJ-NN,8,1
1003,1890.0,5,Authority,2,1,5,4,0,-1,1,3,Nuclear Decommissioning Authority,http://www.nda.gov.uk,ORGANIZATION-ORGANIZATION-ORGANIZATION,URL,PROPN-PROPN-PROPN,VERB,compound-compound-ROOT,npadvmod,NNP-NNP-NNP,VBZ,-1,1
1004,1891.0,45,died,13,4,10,6,3,34,9,-3,Russian man,60,PERSON-PERSON,NUMBER,ADJ-NOUN,NUM,amod-nsubj,nummod,JJ-NN,CD,3,1
1005,1901.0,38,said,4,2,2,0,1,35,2,-2,China Charity Federation,China,ORGANIZATION-ORGANIZATION-ORGANIZATION,COUNTRY,PROPN-PROPN-PROPN,PROPN,compound-compound-nsubj,poss,NNP-NNP-NNP,NNP,0,1
1006,1950.0,39,monitored,2,28,28,0,27,10,-26,26,China Charity Federation,China,ORGANIZATION-ORGANIZATION-ORGANIZATION,COUNTRY,PROPN-PROPN-PROPN,PROPN,compound-compound-conj,pobj,NNP-NNP-NNP,NNP,0,1
1007,3820.0,49,is,8,8,8,0,7,40,0,0,China Charity Federation,China,ORGANIZATION-ORGANIZATION-ORGANIZATION,COUNTRY,PROPN-PROPN-PROPN,PROPN,compound-compound-appos,pobj,NNP-NNP-NNP,NNP,0,1
1008,4400.0,49,is,8,8,8,0,7,40,0,0,China Charity Federation,China,ORGANIZATION-ORGANIZATION-ORGANIZATION,COUNTRY,PROPN-PROPN-PROPN,PROPN,compound-compound-appos,poss,NNP-NNP-NNP,NNP,0,1
1009,4857.0,49,is,8,8,8,0,7,40,0,0,China Charity Federation,China,ORGANIZATION-ORGANIZATION-ORGANIZATION,COUNTRY,PROPN-PROPN-PROPN,PROPN,compound-compound-appos,pobj,NNP-NNP-NNP,NNP,0,1
1010,5140.0,31,was,1,17,17,0,16,13,-16,16,China Charity Federation,China,ORGANIZATION-ORGANIZATION-ORGANIZATION,COUNTRY,PROPN-PROPN-PROPN,PROPN,compound-compound-conj,pobj,NNP-NNP-NNP,NNP,0,1
1011,5481.0,18,awarded,5,10,10,0,9,7,-5,5,China Charity Federation,China,ORGANIZATION-ORGANIZATION-ORGANIZATION,COUNTRY,PROPN-PROPN-PROPN,PROPN,compound-compound-pobj,compound,NNP-NNP-NNP,NNP,0,1
1012,8779.0,26,donated,13,10,10,0,9,15,3,-3,China Charity Federation,China,ORGANIZATION-ORGANIZATION-ORGANIZATION,COUNTRY,PROPN-PROPN-PROPN,PROPN,compound-compound-pobj,poss,NNP-NNP-NNP,NNP,0,1
1013,8940.0,52,PLEDGE,2,11,11,0,10,40,-9,9,China Charity Federation,China,ORGANIZATION-ORGANIZATION-ORGANIZATION,COUNTRY,PROPN-PROPN-PROPN,PROPN,compound-compound-appos,pobj,NNP-NNP-NNP,NNP,0,1
1014,11996.0,49,is,8,8,8,0,7,40,0,0,China Charity Federation,China,ORGANIZATION-ORGANIZATION-ORGANIZATION,COUNTRY,PROPN-PROPN-PROPN,PROPN,compound-compound-appos,poss,NNP-NNP-NNP,NNP,0,1
1015,12169.0,47,said,5,32,32,0,31,14,-27,27,China Charity Federation,China,ORGANIZATION-ORGANIZATION-ORGANIZATION,COUNTRY,PROPN-PROPN-PROPN,PROPN,compound-compound-conj,pobj,NNP-NNP-NNP,NNP,0,1
1016,12985.0,38,Ld-Writethru,1,11,11,0,10,26,-10,10,China Charity Federation,China,ORGANIZATION-ORGANIZATION-ORGANIZATION,COUNTRY,PROPN-PROPN-PROPN,PROPN,compound-compound-pobj,compound,NNP-NNP-NNP,NNP,0,1
1017,14433.0,39,made,4,22,22,0,21,16,-18,18,China Charity Federation,China,ORGANIZATION-ORGANIZATION-ORGANIZATION,COUNTRY,PROPN-PROPN-PROPN,PROPN,compound-compound-conj,pobj,NNP-NNP-NNP,NNP,0,1
1018,1909.0,17,1,0,14,4,-10,13,12,-14,4,his,US,PERSON,COUNTRY,DET,PROPN,poss,appos,PRP$,NNP,7,1
1019,1918.0,42,said,6,1,5,4,0,36,5,-1,New Fabris,Pierre Reau,ORGANIZATION-ORGANIZATION,PERSON-PERSON,PROPN-PROPN,PROPN-PROPN,compound-compound,compound-nsubj,NNP-NNP,NNP-NNP,2,1
1020,12925.0,51,said,15,10,14,4,9,36,5,-1,New Fabris,Pierre Reau,ORGANIZATION-ORGANIZATION,PERSON-PERSON,PROPN-PROPN,PROPN-PROPN,compound-compound,compound-nsubj,NNP-NNP,NNP-NNP,2,1
1021,1920.0,24,founded,7,2,10,8,1,13,5,3,National Congress of American Indians,1944,ORGANIZATION-ORGANIZATION-ORGANIZATION-ORGANIZATION-ORGANIZATION,DATE,PROPN-PROPN-ADP-PROPN-PROPN,NUM,compound-nsubjpass-prep-compound-pobj,pobj,NNP-NNP-IN-NNP-NNPS,CD,2,1
1022,1922.0,50,agreed,37,14,35,21,13,14,23,-2,Countrywide Financial,David Sambol,ORGANIZATION-ORGANIZATION,PERSON-PERSON,PROPN-PROPN,PROPN-PROPN,compound-pobj,compound-appos,NNP-NNP,NNP-NNP,5,1
1023,1930.0,39,alleged,2,31,20,-11,30,18,-29,18,her,21,PERSON,NUMBER,PRON,NUM,dobj,appos,PRP,CD,6,1
1024,1943.0,31,accused,10,1,8,7,0,22,9,-2,John Graham,Canada,PERSON-PERSON,COUNTRY,PROPN-PROPN,PROPN,compound-nsubjpass,pobj,NNP-NNP,NNP,2,1
1025,4189.0,52,forward,1,6,22,16,5,29,-5,21,John Graham,Canada,PERSON-PERSON,COUNTRY,PROPN-PROPN,PROPN,compound-nsubjpass,conj,NNP-NNP,NNP,5,1
1026,1946.0,40,found,31,1,38,37,0,1,30,7,Andrew Lange,Los Angeles,PERSON-PERSON,CITY-CITY,PROPN-PROPN,PROPN-PROPN,compound-nsubj,compound-pobj,NNP-NNP,NNP-NNP,2,1
1027,3110.0,40,found,31,1,38,37,0,1,30,7,Andrew Lange,Los Angeles,PERSON-PERSON,CITY-CITY,PROPN-PROPN,PROPN-PROPN,compound-nsubj,compound-pobj,NNP-NNP,NNP-NNP,2,1
1028,1954.0,23,told,6,1,5,4,0,17,5,-1,Esther-Ethy Mamane,Paris,PERSON-PERSON,CITY,PROPN-PROPN,PROPN,compound-nsubj,pobj,NNP-NNP,NNP,3,1
1029,3431.0,20,said,13,9,7,-2,8,12,4,-6,Esther-Ethy Mamane,Paris,PERSON-PERSON,CITY,PROPN-PROPN,PROPN,compound-nsubj,compound,NNP-NNP,NNP,4,1
1030,8432.0,16,told,10,9,7,-2,8,8,1,-3,Esther-Ethy Mamane,Paris,PERSON-PERSON,CITY,PROPN-PROPN,PROPN,compound-nsubj,compound,NNP-NNP,NNP,3,1
1031,1960.0,25,said,13,20,24,4,19,0,-7,11,ShopperTrak,Chicago,ORGANIZATION,CITY,PROPN,PROPN,pobj,pobj,NNP,NNP,3,1
1032,10242.0,48,said,18,1,7,6,0,40,17,-11,ShopperTrak,Chicago,ORGANIZATION,CITY,PROPN,PROPN,nsubj,pobj,NNP,NNP,3,1
1033,12166.0,32,is,1,25,31,6,24,0,-24,30,ShopperTrak,Chicago,ORGANIZATION,CITY,PROPN,PROPN,pobj,pobj,NNP,NNP,5,1
1034,12768.0,23,fell,3,22,19,-3,21,3,-19,16,ShopperTrak,Chicago,ORGANIZATION,CITY,PROPN,PROPN,pobj,nmod,NNP,NNP,7,1
1035,13961.0,36,said,15,26,29,3,25,6,-11,14,ShopperTrak,Chicago,ORGANIZATION,CITY,PROPN,PROPN,pobj,compound,NNP,NNP,5,1
1036,14383.0,23,fell,3,22,19,-3,21,3,-19,16,ShopperTrak,Chicago,ORGANIZATION,CITY,PROPN,PROPN,pobj,nmod,NNP,NNP,7,1
1037,14994.0,32,is,1,25,31,6,24,0,-24,30,ShopperTrak,Chicago,ORGANIZATION,CITY,PROPN,PROPN,pobj,pobj,NNP,NNP,5,1
1038,1963.0,35,include,9,11,22,11,10,12,-2,13,her,Michael,PERSON,PERSON,DET,PROPN,poss,conj,PRP$,NNP,6,1
1039,1968.0,34,said,20,11,25,14,10,8,9,5,her,Dieulifanne Desilien,PERSON,PERSON-PERSON,PRON,PROPN-PROPN,dobj,compound-appos,PRP,NNP-NNP,6,1
1040,1969.0,34,opened,3,12,25,13,11,8,-9,22,Terry Jupp,England,PERSON-PERSON,COUNTRY,PROPN-PROPN,PROPN,compound-pobj,poss,NNP-NNP,NNP,5,1
1041,3444.0,47,found,26,7,17,10,6,29,19,-9,Terry Jupp,England,PERSON-PERSON,COUNTRY,PROPN-PROPN,PROPN,compound-pobj,poss,NNP-NNP,NNP,5,1
1042,3828.0,36,open,4,12,32,20,11,3,-8,28,Terry Jupp,England,PERSON-PERSON,COUNTRY,PROPN-PROPN,PROPN,compound-pobj,poss,NNP-NNP,NNP,12,1
1043,1970.0,38,traded,2,30,8,-22,29,29,-28,6,Countrywide Financial Corp.,Dow Jones,ORGANIZATION-ORGANIZATION-ORGANIZATION,MISC-MISC,PROPN-PROPN-PROPN,PROPN-PROPN,compound-compound-pobj,nmod-nmod,NNP-NNP-NNP,NNP-NNP,10,1
1044,1976.0,29,is,5,14,25,11,13,3,-9,20,Mark Fisher,Texas Parks and Wildlife,PERSON-PERSON,ORGANIZATION-ORGANIZATION-ORGANIZATION-ORGANIZATION,PROPN-PROPN,PROPN-PROPN-CCONJ-PROPN,compound-pobj,compound-pobj-cc-conj,NNP-NNP,NNP-NNP-CC-NNP,5,1
1045,1983.0,47,said,45,29,31,2,28,15,16,-14,he,director,PERSON,TITLE,PRON,NOUN,nsubj,attr,PRP,NN,2,1
1046,7544.0,42,accused,1,21,29,8,20,12,-20,28,he,director,PERSON,TITLE,PRON,NOUN,nsubj,attr,PRP,NN,3,1
1047,1986.0,12,puts,1,3,9,6,2,2,-2,8,him,Benton K. Partin,PERSON,PERSON-PERSON-PERSON,PRON,PROPN-PROPN-PROPN,dobj,compound-compound-pobj,PRP,NNP-NNP-NNP,4,1
1048,1988.0,38,said,25,31,33,2,30,4,-6,8,NDRC,International Economic Research Institute,ORGANIZATION,ORGANIZATION-ORGANIZATION-ORGANIZATION-ORGANIZATION,PROPN,PROPN-PROPN-PROPN-PROPN,poss,compound-compound-compound-compound,NNP,NNP-NNP-NNP-NNP,2,1
1049,1990.0,27,said,1,6,10,4,5,16,-5,9,Central American Parliament,Jacinto Suarez Espinoza,ORGANIZATION-ORGANIZATION-ORGANIZATION,PERSON-PERSON-PERSON,ADJ-PROPN-PROPN,PROPN-PROPN-PROPN,amod-compound-compound,compound-compound-pobj,JJ-NNP-NNP,NNP-NNP-NNP,4,1
1050,1996.0,34,included,1,16,14,-2,15,19,-15,13,Charles Ble Goude,minister,PERSON-PERSON-PERSON,TITLE,PROPN-PROPN-PROPN,NOUN,compound-compound-conj,pobj,NNP-NNP-NNP,NN,3,1
1051,3438.0,10,is,3,1,7,6,0,2,2,4,Charles Ble Goude,minister,PERSON-PERSON-PERSON,TITLE,PROPN-PROPN-PROPN,NOUN,compound-compound-nsubj,attr,NNP-NNP-NNP,NN,4,1
1052,4962.0,16,called,10,1,7,6,0,8,9,-3,Charles Ble Goude,minister,PERSON-PERSON-PERSON,TITLE,PROPN-PROPN-PROPN,NOUN,compound-compound-nsubj,appos,NNP-NNP-NNP,NN,3,1
1053,7078.0,29,told,26,14,18,4,13,10,12,-8,Charles Ble Goude,minister,PERSON-PERSON-PERSON,TITLE,PROPN-PROPN-PROPN,NOUN,compound-compound-nsubj,appos,NNP-NNP-NNP,NN,2,1
1054,11372.0,43,vows,34,8,2,-6,7,40,26,-32,Charles Ble Goude,minister,PERSON-PERSON-PERSON,TITLE,PROPN-PROPN-PROPN,NOUN,compound-compound-appos,nsubj,NNP-NNP-NNP,NN,3,1
1055,13410.0,42,vowed,33,8,2,-6,7,39,25,-31,Charles Ble Goude,minister,PERSON-PERSON-PERSON,TITLE,PROPN-PROPN-PROPN,NOUN,compound-compound-appos,nsubj,NNP-NNP-NNP,NN,3,1
1056,15372.0,45,turned,32,8,34,26,7,10,24,2,Charles Ble Goude,minister,PERSON-PERSON-PERSON,TITLE,PROPN-PROPN-PROPN,NOUN,compound-compound-appos,attr,NNP-NNP-NNP,NN,5,1
1057,1998.0,36,said,12,6,10,4,5,25,6,-2,Knox,Curt Knox,PERSON,PERSON-PERSON,PROPN,PROPN-PROPN,poss,compound-appos,NNP,NNP-NNP,3,1
1058,3756.0,41,convicted,1,1,15,14,0,25,0,14,Knox,Curt Knox,PERSON,PERSON-PERSON,PROPN,PROPN-PROPN,nsubj,compound-appos,NNP,NNP-NNP,-1,1
1059,12692.0,21,said,7,1,5,4,0,15,6,-2,Knox,Curt Knox,PERSON,PERSON-PERSON,PROPN,PROPN-PROPN,poss,compound-appos,NNP,NNP-NNP,3,1
1060,14620.0,28,told,7,1,5,4,0,22,6,-2,Knox,Curt Knox,PERSON,PERSON-PERSON,PROPN,PROPN-PROPN,poss,compound-appos,NNP,NNP-NNP,3,1
1061,2001.0,25,traveled,13,8,11,3,7,13,5,-2,Silsby,John Sander,PERSON,PERSON-PERSON,PROPN,PROPN-PROPN,poss,compound-appos,NNP,NNP-NNP,3,1
1062,2003.0,18,keeps,1,10,1,-9,9,16,-9,0,TPI,He,ORGANIZATION,PERSON,PROPN,PRON,pobj,nsubj,NNP,PRP,4,1
1063,2013.0,23,cousin,4,1,12,11,0,10,3,8,Benjamin Chertoff,researcher,PERSON-PERSON,TITLE,PROPN-PROPN,NOUN,compound-compound,appos,NNP-NNP,NN,2,1
1064,6854.0,23,cousin,4,1,12,11,0,10,3,8,Benjamin Chertoff,researcher,PERSON-PERSON,TITLE,PROPN-PROPN,NOUN,compound-nmod,appos,NNP-NNP,NN,2,1
1065,2023.0,37,said,26,14,23,9,13,13,12,-3,Koch Foods Inc.,Chicago,ORGANIZATION-ORGANIZATION-ORGANIZATION,CITY,PROPN-PROPN-PROPN,PROPN,compound-compound-poss,compound,NNP-NNP-NNP,NNP,7,1
1066,3552.0,43,said,26,14,23,9,13,19,12,-3,Koch Foods Inc.,Chicago,ORGANIZATION-ORGANIZATION-ORGANIZATION,CITY,PROPN-PROPN-PROPN,PROPN,compound-compound-poss,compound,NNP-NNP-NNP,NNP,7,1
1067,2028.0,35,survives,1,24,1,-23,23,33,-23,0,his,Arnold,PERSON,PERSON,DET,PROPN,poss,nsubj,PRP$,NNP,5,1
1068,2029.0,28,survived,3,6,12,6,5,15,-3,9,his,Karen Lange,PERSON,PERSON-PERSON,DET,PROPN-PROPN,poss,compound-appos,PRP$,NNP-NNP,2,1
1069,2035.0,26,initiated,4,23,20,-3,22,5,-19,16,Jamie Leigh Jones,Texas,PERSON-PERSON-PERSON,STATE_OR_PROVINCE,PROPN-PROPN-PROPN,PROPN,compound-compound-appos,compound,NNP-NNP-NNP,NNP,4,1
1070,4378.0,25,sued,7,1,6,5,0,18,6,-1,Jamie Leigh Jones,Texas,PERSON-PERSON-PERSON,STATE_OR_PROVINCE,PROPN-PROPN-PROPN,PROPN,compound-compound-nsubj,pobj,NNP-NNP-NNP,NNP,3,1
1071,2037.0,32,said,1,20,25,5,19,6,-19,24,Tribeca Enterprises,Robert De Niro,ORGANIZATION-ORGANIZATION,PERSON-PERSON-PERSON,PROPN-PROPN,PROPN-PROPN-PROPN,compound-pobj,compound-compound-poss,NNP-NNPS,NNP-NNP-NNP,4,1
1072,2040.0,17,was,1,1,15,14,0,1,0,14,Gonzalez,Chihuahua,PERSON,CITY,PROPN,PROPN,nsubj,compound,NNP,NNP,6,1
1073,2044.0,42,remained,1,23,17,-6,22,24,-22,16,Professional Ski Instructors of America,John,ORGANIZATION-ORGANIZATION-ORGANIZATION-ORGANIZATION-ORGANIZATION,PERSON,PROPN-PROPN-PROPN-ADP-PROPN,PROPN,compound-compound-pobj-prep-pobj,compound,NNP-NNP-NNP-IN-NNP,NNP,4,1
1074,2094.0,36,echoed,6,32,27,-5,31,8,-26,21,National Restaurant Association,Chicago,ORGANIZATION-ORGANIZATION-ORGANIZATION,CITY,PROPN-PROPN-PROPN,PROPN,compound-compound-compound,pobj,NNP-NNP-NNP,NNP,5,1
1075,2596.0,36,said,14,5,13,8,4,22,9,-1,National Restaurant Association,Chicago,ORGANIZATION-ORGANIZATION-ORGANIZATION,CITY,PROPN-PROPN-PROPN,PROPN,compound-compound-dobj,pobj,NNP-NNP-NNP,NNP,4,1
1076,11032.0,30,is,16,9,13,4,8,16,7,-3,National Restaurant Association,Chicago,ORGANIZATION-ORGANIZATION-ORGANIZATION,CITY,PROPN-PROPN-PROPN,PROPN,compound-compound-pobj,pobj,NNP-NNP-NNP,NNP,4,1
1077,2095.0,30,died,4,7,20,13,6,9,-3,16,she,Heinola,PERSON,CITY,PRON,PROPN,nsubj,pobj,PRP,NNP,7,1
1078,2098.0,39,is,1,5,18,13,4,20,-4,17,Rashid,author,PERSON,TITLE,PROPN,NOUN,nsubj,conj,NNP,NN,7,1
1079,15007.0,34,said,12,14,18,4,13,15,-2,6,Rashid,author,PERSON,TITLE,PROPN,NOUN,nsubj,appos,NNP,NN,1,1
1080,2106.0,27,closing,8,3,1,-2,2,25,5,-7,President,Joe Eman,ORGANIZATION,PERSON-PERSON,PROPN,PROPN-PROPN,nsubj,compound-compound,NNP,NNP-NNP,2,1
1081,2113.0,53,year,1,12,25,13,11,27,-11,24,His,Development,PERSON,ORGANIZATION,DET,PROPN,poss,pobj,PRP$,NNP,5,1
1082,2116.0,47,said,12,20,9,-11,19,37,-8,-3,his,University of Chicago,PERSON,ORGANIZATION-ORGANIZATION-ORGANIZATION,DET,PROPN-ADP-PROPN,poss,pobj-prep-pobj,PRP$,NNP-IN-NNP,9,1
1083,2119.0,45,2,3,12,9,-3,11,35,-9,6,Countrywide,Calabasas,ORGANIZATION,CITY,PROPN,PROPN,nsubj,npadvmod,NNP,NNP,3,1
1084,14398.0,8,based,2,1,5,4,0,2,1,3,Countrywide,Calabasas,ORGANIZATION,CITY,PROPN,PROPN,nsubjpass,pobj,NNP,NNP,4,1
1085,2138.0,31,became,4,4,7,3,3,23,0,3,he,senior research scientist,PERSON,TITLE-TITLE-TITLE,PRON,ADJ-NOUN-NOUN,nsubj,amod-compound-attr,PRP,JJ-NN-NN,2,1
1086,2142.0,20,said,1,14,1,-13,13,18,-13,0,his,Nash,PERSON,PERSON,DET,PROPN,poss,nsubj,PRP$,NNP,7,1
1087,2148.0,35,rallied,4,20,12,-8,19,22,-16,8,Bibi,Multan,PERSON,CITY,PROPN,PROPN,pobj,pobj,NNP,NNP,3,1
1088,2156.0,39,League,2,1,5,4,0,33,1,3,National Urban League,http://wwwnulorg/,ORGANIZATION-ORGANIZATION-ORGANIZATION,URL,PROPN-PROPN-PROPN,PROPN,compound-compound-ROOT,compound,NNP-NNP-NNP,NNP,3,1
1089,2162.0,47,founded,2,1,5,4,0,41,1,3,UASR,1989,ORGANIZATION,DATE,PROPN,NUM,nsubjpass,pobj,NNP,CD,2,1
1090,11080.0,47,founded,2,1,5,4,0,41,1,3,UASR,1989,ORGANIZATION,DATE,PROPN,NUM,nsubjpass,pobj,NNP,CD,2,1
1091,2176.0,42,said,28,30,36,6,29,5,-2,8,Michael Lomax,United Negro,PERSON-PERSON,ORGANIZATION-ORGANIZATION,PROPN-PROPN,PROPN-PROPN,compound-nsubj,compound-pobj,NNP-NNP,NNP-NNP,4,1
1092,5538.0,21,said,12,14,20,6,13,0,-2,8,Michael Lomax,United Negro,PERSON-PERSON,ORGANIZATION-ORGANIZATION,PROPN-PROPN,PROPN-PROPN,compound-nsubj,compound-pobj,NNP-NNP,NNP-NNP,3,1
1093,2179.0,36,offered,15,25,30,5,24,5,-10,15,Asia Bibi,Christian,ORGANIZATION-ORGANIZATION,RELIGION,PROPN-PROPN,ADJ,compound-dobj,amod,NNP-NNP,JJ,3,1
1094,4659.0,27,received,5,13,17,4,12,9,-8,12,Asia Bibi,Christian,PERSON-PERSON,RELIGION,PROPN-PROPN,ADJ,compound-pobj,amod,NNP-NNP,JJ,5,1
1095,7276.0,30,criticized,6,16,20,4,15,9,-10,14,Asia Bibi,Christian,PERSON-PERSON,RELIGION,PROPN-PROPN,ADJ,compound-pobj,amod,NNP-NNP,JJ,6,1
1096,8405.0,34,mentions,13,18,22,4,17,11,-5,9,Asia Bibi,Christian,PERSON-PERSON,RELIGION,PROPN-PROPN,PROPN,compound-pobj,amod,NNP-NNP,NNP,1,1
1097,11064.0,39,is,3,13,17,4,12,21,-10,14,Asia Bibi,Christian,PERSON-PERSON,RELIGION,PROPN-PROPN,ADJ,compound-pobj,amod,NNP-NNP,JJ,1,1
1098,14308.0,32,called,4,10,14,4,9,17,-6,10,Asia Bibi,Christian,PERSON-PERSON,RELIGION,PROPN-PROPN,ADJ,compound-pobj,amod,NNP-NNP,JJ,1,1
1099,2182.0,39,YANGON,0,32,9,-23,31,29,-32,9,MEF,Myanmar Equestrian Federation,ORGANIZATION,ORGANIZATION-ORGANIZATION-ORGANIZATION,PROPN,PROPN-PROPN-PROPN,compound,compound-compound-pobj,NNP,NNP-NNP-NNP,3,1
1100,2190.0,55,released,6,1,4,3,0,50,5,-2,Eugenio Vagni,62,PERSON-PERSON,NUMBER,PROPN-PROPN,NUM,compound-nsubjpass,appos,NNP-NNP,CD,2,1
1101,3805.0,19,said,5,1,4,3,0,14,4,-1,Eugenio Vagni,62,PERSON-PERSON,NUMBER,PROPN-PROPN,NUM,compound-nsubj,appos,NNP-NNP,CD,2,1
1102,7296.0,56,said,54,16,19,3,15,36,38,-35,Eugenio Vagni,62,PERSON-PERSON,NUMBER,PROPN-PROPN,NUM,compound-nsubj,appos,NNP-NNP,CD,2,1
1103,12072.0,44,said,1,33,36,3,32,7,-32,35,Eugenio Vagni,62,PERSON-PERSON,NUMBER,PROPN-PROPN,NUM,compound-dobj,appos,NNP-NNP,CD,2,1
1104,13819.0,33,said,31,8,11,3,7,21,23,-20,Eugenio Vagni,62,PERSON-PERSON,NUMBER,PROPN-PROPN,NUM,compound-nsubj,appos,NNP-NNP,CD,2,1
1105,2192.0,38,blogged,18,1,11,10,0,26,17,-7,A man,Pennsylvania,PERSON-PERSON,STATE_OR_PROVINCE,DET-NOUN,PROPN,det-nsubj,compound,DT-NN,NNP,5,1
1106,2198.0,38,was,1,1,9,8,0,28,0,8,Vagni,International Committee of the Red Cross,PERSON,ORGANIZATION-ORGANIZATION-ORGANIZATION-ORGANIZATION-ORGANIZATION-ORGANIZATION,PROPN,PROPN-PROPN-ADP-DET-PROPN-PROPN,nsubj,compound-pobj-prep-det-compound-pobj,NNP,NNP-NNP-IN-DT-NNP-NNP,5,1
1107,14258.0,34,was,1,1,6,5,0,27,0,5,Vagni,International Committee of the Red Cross,PERSON,ORGANIZATION-ORGANIZATION-ORGANIZATION-ORGANIZATION-ORGANIZATION-ORGANIZATION,PROPN,PROPN-PROPN-ADP-DET-PROPN-PROPN,nsubj,compound-pobj-prep-det-compound-compound,NNP,NNP-NNP-IN-DT-NNP-NNP,3,1
1108,15139.0,20,kidnapped,13,1,5,4,0,14,12,-8,Vagni,International Committee of the Red Cross,PERSON,ORGANIZATION-ORGANIZATION-ORGANIZATION-ORGANIZATION-ORGANIZATION-ORGANIZATION,PROPN,PROPN-PROPN-ADP-DET-PROPN-PROPN,nsubjpass,compound-conj-prep-det-compound-compound,NNP,NNP-NNP-IN-DT-NNP-NNP,2,1
1109,2202.0,28,said,14,23,16,-7,22,11,-9,2,National Congress of American Indians,Jacqueline Johnson,ORGANIZATION-ORGANIZATION-ORGANIZATION-ORGANIZATION-ORGANIZATION,PERSON-PERSON,PROPN-PROPN-ADP-PROPN-PROPN,PROPN-PROPN,compound-pobj-prep-compound-pobj,compound-nsubj,NNP-NNP-IN-NNP-NNPS,NNP-NNP,3,1
1110,6339.0,19,defended,13,8,1,-7,7,17,5,-12,National Congress of American Indians,Jacqueline Johnson,ORGANIZATION-ORGANIZATION-ORGANIZATION-ORGANIZATION-ORGANIZATION,PERSON-PERSON,PROPN-PROPN-ADP-PROPN-PROPN,PROPN-PROPN,compound-pobj-prep-compound-pobj,compound-nsubj,NNP-NNP-IN-NNP-NNPS,NNP-NNP,3,1
1111,10885.0,51,said,24,34,26,-8,33,24,-10,2,National Congress of American Indians,Jacqueline Johnson,ORGANIZATION-ORGANIZATION-ORGANIZATION-ORGANIZATION-ORGANIZATION,PERSON-PERSON,PROPN-PROPN-ADP-PROPN-PROPN,PROPN-PROPN,compound-pobj-prep-compound-pobj,compound-nsubj,NNP-NNP-IN-NNP-NNPS,NNP-NNP,5,1
1112,2211.0,27,convicted,2,6,18,12,5,8,-4,16,Tao,organising prostitution,PERSON,CRIMINAL_CHARGE-CRIMINAL_CHARGE,PROPN,VERB-NOUN,conj,pcomp-dobj,NNP,VBG-NN,7,1
1113,2215.0,33,said,9,1,2,1,0,30,8,-7,Kip Hollister,Hollister Inc.,PERSON-PERSON,ORGANIZATION-ORGANIZATION,PROPN-PROPN,PROPN-PROPN,compound-nsubj,compound-pobj,NNP-NNP,NNP-NNP,1,1
1114,2226.0,32,declined,3,11,26,15,10,5,-8,23,Bibi,Ashiq Masih,PERSON,PERSON-PERSON,PROPN,PROPN-PROPN,nsubj,compound-appos,NNP,NNP-NNP,6,1
1115,3513.0,29,declined,3,11,24,13,10,4,-8,21,Bibi,Ashiq Masih,PERSON,PERSON-PERSON,PROPN,PROPN-PROPN,nsubj,compound-appos,NNP,NNP-NNP,7,1
1116,4376.0,30,said,7,1,5,4,0,24,6,-2,Bibi,Ashiq Masih,PERSON,PERSON-PERSON,PROPN,PROPN-PROPN,poss,compound-appos,NNP,NNP-NNP,3,1
1117,7946.0,19,says,7,1,5,4,0,13,6,-2,Bibi,Ashiq Masih,PERSON,PERSON-PERSON,PROPN,PROPN-PROPN,poss,compound-appos,NNP,NNP-NNP,3,1
1118,10582.0,23,told,16,7,11,4,6,11,9,-5,Bibi,Ashiq Masih,PERSON,PERSON-PERSON,PROPN,PROPN-PROPN,poss,compound-appos,NNP,NNP-NNP,3,1
1119,2228.0,60,has,1,21,24,3,20,35,-20,23,Christopher Bollyn,American Free Press,PERSON-PERSON,ORGANIZATION-ORGANIZATION-ORGANIZATION,PROPN-PROPN,PROPN-PROPN-PROPN,compound-compound,compound-compound-pobj,NNP-NNP,NNP-NNP-NNP,2,1
1120,2241.0,41,branded,5,3,28,25,2,12,2,23,Ble Goude,Abidjan,PERSON-PERSON,CITY,PROPN-PROPN,PROPN,compound-pobj,pobj,NNP-NNP,NNP,6,1
1121,5425.0,36,known,4,1,28,27,0,7,3,24,Ble Goude,Abidjan,PERSON-PERSON,CITY,PROPN-PROPN,PROPN,compound-nsubjpass,pobj,NNP-NNP,NNP,10,1
1122,2246.0,41,Italy,0,19,16,-3,18,24,-19,16,Matteo Messina Denaro,Sicilian,PERSON-PERSON-PERSON,NATIONALITY,PROPN-PROPN-PROPN,PROPN,compound-compound-pobj,compound,NNP-NNP-NNP,NNP,3,1
1123,2252.0,37,working,11,1,7,6,0,29,10,-4,Gross,"Potomac , Maryland",PERSON,NATIONALITY-NATIONALITY-NATIONALITY,PROPN,PROPN-PUNCT-PROPN,nsubj,pobj-punct-appos,NNP,"NNP-,-NNP",3,1
1124,2256.0,29,is,1,6,1,-5,5,27,-5,0,Patricia Gonzalez,Gonzalez,PERSON-PERSON,PERSON,PROPN-PROPN,PROPN,compound-pobj,nsubj,NNP-NNP,NNP,3,1
1125,2267.0,39,YANGON,0,9,32,23,8,6,-9,32,Myanmar Equestrian Federation,MEF,ORGANIZATION-ORGANIZATION-ORGANIZATION,ORGANIZATION,PROPN-PROPN-PROPN,PROPN,compound-compound-pobj,compound,NNP-NNP-NNP,NNP,3,1
1126,2929.0,42,held,25,13,17,4,12,24,12,-8,Myanmar Equestrian Federation,MEF,ORGANIZATION-ORGANIZATION-ORGANIZATION,ORGANIZATION,PROPN-PROPN-PROPN,PROPN,compound-compound-pobj,pobj,NNP-NNP-NNP,NNP,3,1
1127,6056.0,42,held,25,13,17,4,12,24,12,-8,Myanmar Equestrian Federation,MEF,ORGANIZATION-ORGANIZATION-ORGANIZATION,ORGANIZATION,PROPN-PROPN-PROPN,PROPN,compound-compound-pobj,compound,NNP-NNP-NNP,NNP,3,1
1128,9111.0,47,Myanmar,0,1,40,39,0,6,-1,40,Myanmar Equestrian Federation,MEF,ORGANIZATION-ORGANIZATION-ORGANIZATION,ORGANIZATION,PROPN-PROPN-PROPN,PROPN,compound-compound-pobj,compound,NNP-NNP-NNP,NNP,-1,1
1129,2284.0,28,convicted,4,9,6,-3,8,21,-5,2,Amanda Knox,American,PERSON-PERSON,NATIONALITY,PROPN-PROPN,ADJ,compound-dobj,amod,NNP-NNP,JJ,2,1
1130,5359.0,27,PERUGIA,0,8,5,-3,7,21,-8,5,Amanda Knox,American,PERSON-PERSON,NATIONALITY,PROPN-PROPN,ADJ,compound-nsubj,amod,NNP-NNP,JJ,2,1
1131,6177.0,34,wrote,26,5,4,-1,4,29,21,-22,Amanda Knox,American,PERSON-PERSON,NATIONALITY,PROPN-PROPN,PROPN,compound-pobj,compound,NNP-NNP,NNP,1,1
1132,7759.0,27,indicted,6,3,1,-2,2,25,3,-5,Amanda Knox,American,PERSON-PERSON,NATIONALITY,PROPN-PROPN,ADJ,compound-nsubjpass,amod,NNP-NNP,JJ,1,1
1133,8352.0,33,stuck,13,21,20,-1,20,12,-8,7,Amanda Knox,American,PERSON-PERSON,NATIONALITY,PROPN-PROPN,PROPN,compound-nsubj,compound,NNP-NNP,NNP,1,1
1134,8682.0,51,Entertainment-US-Ireland-film-Sheridan,3,20,19,-1,19,31,-17,16,Amanda Knox,American,PERSON-PERSON,NATIONALITY,PROPN-PROPN,PROPN,compound-pobj,compound,NNP-NNP,NNP,1,1
1135,9339.0,30,made,21,5,4,-1,4,25,16,-17,Amanda Knox,American,PERSON-PERSON,NATIONALITY,PROPN-PROPN,PROPN,compound-dobj,compound,NNP-NNP,NNP,1,1
1136,11393.0,48,convicted,1,23,20,-3,22,27,-22,19,Amanda Knox,American,PERSON-PERSON,NATIONALITY,PROPN-PROPN,ADJ,compound-dobj,amod,NNP-NNP,JJ,4,1
1137,11980.0,39,found,6,21,19,-2,20,19,-15,13,Amanda Knox,American,PERSON-PERSON,NATIONALITY,PROPN-PROPN,ADJ,compound-pobj,amod,NNP-NNP,JJ,1,1
1138,2287.0,35,said,24,26,34,8,25,0,-2,10,Shah Abdul Aziz,Parliament,PERSON-PERSON-PERSON,ORGANIZATION,PROPN-PROPN-PROPN,PROPN,compound-compound-nsubj,pobj,NNP-NNP-NNP,NNP,4,1
1139,2296.0,12,was,7,4,3,-1,3,8,3,-4,Pauliina Miettinen,coach,PERSON-PERSON,TITLE,PROPN-PROPN,NOUN,compound-nsubj,nsubj,NNP-NNP,NN,1,1
1140,5685.0,29,hired,6,4,16,12,3,12,2,10,Pauliina Miettinen,coach,PERSON-PERSON,TITLE,PROPN-PROPN,NOUN,compound-nsubjpass,npadvmod,NNP-NNP,NN,3,1
1141,10298.0,27,named,11,1,17,16,0,9,10,6,Pauliina Miettinen,coach,PERSON-PERSON,TITLE,PROPN-PROPN,NOUN,compound-nsubjpass,pobj,NNP-NNP,NN,4,1
1142,2305.0,34,began,1,19,12,-7,18,21,-18,11,Mark Fisher,Upper East Side of Manhattan,PERSON-PERSON,LOCATION-LOCATION-LOCATION-LOCATION-LOCATION,PROPN-PROPN,PROPN-PROPN-PROPN-ADP-PROPN,compound-nsubj,compound-compound-pobj-prep-pobj,NNP-NNP,NNP-NNP-NNP-IN-NNP,3,1
1143,2308.0,35,selling,5,23,11,-12,22,23,-18,6,Pluribus Capital Management,Global Media LLC,ORGANIZATION-ORGANIZATION-ORGANIZATION,ORGANIZATION-ORGANIZATION-ORGANIZATION,PROPN-PROPN-PROPN,PROPN-PROPN-PROPN,compound-compound-pobj,compound-compound-pobj,NNP-NNP-NNP,NNP-NNP-NNP,6,1
1144,2309.0,46,died,37,1,39,38,0,6,36,2,Norris Church Mailer,Sunday,PERSON-PERSON-PERSON,DATE,PROPN-PROPN-PROPN,PROPN,compound-compound-nsubj,npadvmod,NNP-NNP-NNP,NNP,4,1
1145,2328.0,57,said,13,1,12,11,0,44,12,-1,Chen Tao,Taiwan,PERSON-PERSON,COUNTRY,PROPN-PROPN,PROPN,compound-nsubj,pobj,NNP-NNP,NNP,2,1
1146,3731.0,57,said,13,1,12,11,0,44,12,-1,Chen Tao,Taiwan,PERSON-PERSON,COUNTRY,PROPN-PROPN,PROPN,compound-nsubj,pobj,NNP-NNP,NNP,2,1
1147,2333.0,22,called,5,7,5,-2,6,16,-2,0,Alessi,Guede,PERSON,PERSON,PROPN,PROPN,dobj,nsubj,NNP,NNP,2,1
1148,2334.0,34,gather,3,8,14,6,7,19,-5,11,National Congress of American Indians,http://wwwncaiorg/,ORGANIZATION-ORGANIZATION-ORGANIZATION-ORGANIZATION-ORGANIZATION,URL,PROPN-PROPN-ADP-PROPN-PROPN,PROPN,compound-dobj-prep-compound-pobj,npadvmod,NNP-NNP-IN-NNP-NNPS,NNP,4,1
1149,2349.0,42,born,4,1,7,6,0,34,3,3,Andrew E. Lange,Urbana,PERSON-PERSON-PERSON,CITY,PROPN-PROPN-PROPN,PROPN,compound-compound-nsubjpass,pobj,NNP-NNP-NNP,NNP,5,1
1150,2352.0,48,was,7,16,21,5,15,26,-9,14,Mark Fisher,Fairfield University,PERSON-PERSON,ORGANIZATION-ORGANIZATION,PROPN-PROPN,PROPN-PROPN,compound-dobj,compound-compound,NNP-NNP,NNP-NNP,3,1
1151,2359.0,57,created,13,12,18,6,11,38,1,5,ADF,Christian,ORGANIZATION,RELIGION,PROPN,ADJ,poss,amod,NNP,JJ,4,1
1152,2369.0,35,Nine-year-old,0,4,1,-3,3,33,-4,1,Ruben van Assouw,Nine-year-old,PERSON-PERSON-PERSON,DURATION,PROPN-PROPN-PROPN,PROPN,compound-compound-nsubj,ROOT,NNP-NNP-NNP,NNP,2,1
1153,6459.0,44,AFP,7,13,10,-3,12,33,-6,3,Ruben van Assouw,Nine-year-old,PERSON-PERSON-PERSON,NUMBER,PROPN-PROPN-PROPN,PROPN,compound-compound-nsubj,ROOT,NNP-NNP-NNP,NNP,2,1
1154,8048.0,28,Nine-year-old,0,2,1,-1,1,26,-2,1,Ruben van Assouw,Nine-year-old,PERSON-PERSON-PERSON,DURATION,PROPN-PROPN-PROPN,PROPN,compound-compound-poss,ROOT,NNP-NNP-NNP,NNP,1,1
1155,2373.0,40,moved,5,10,8,-2,9,31,-5,3,his,Connecticut,PERSON,STATE_OR_PROVINCE,DET,PROPN,poss,pobj,PRP$,NNP,2,1
1156,2393.0,39,said,4,11,10,-1,10,28,-7,6,Shah Abdul Aziz,lawmaker,PERSON-PERSON-PERSON,TITLE,PROPN-PROPN-PROPN,NOUN,compound-compound-dobj,compound,NNP-NNP-NNP,NN,2,1
1157,3530.0,33,expected,5,20,25,5,19,7,-15,20,Shah Abdul Aziz,lawmaker,PERSON-PERSON-PERSON,TITLE,PROPN-PROPN-PROPN,NOUN,compound-compound-pobj,appos,NNP-NNP-NNP,NN,4,1
1158,3794.0,33,held,17,4,9,5,3,23,13,-8,Shah Abdul Aziz,lawmaker,PERSON-PERSON-PERSON,TITLE,PROPN-PROPN-PROPN,NOUN,compound-compound-appos,appos,NNP-NNP-NNP,NN,3,1
1159,3939.0,39,heard,3,26,31,5,25,7,-23,28,Shah Abdul Aziz,lawmaker,PERSON-PERSON-PERSON,TITLE,PROPN-PROPN-PROPN,NOUN,compound-compound-pobj,appos,NNP-NNP-NNP,NN,4,1
1160,5126.0,27,said,15,19,18,-1,18,8,-4,3,Shah Abdul Aziz,lawmaker,PERSON-PERSON-PERSON,TITLE,PROPN-PROPN-PROPN,NOUN,compound-compound-nsubj,compound,NNP-NNP-NNP,NN,2,1
1161,8621.0,37,said,18,1,6,5,0,30,17,-12,Shah Abdul Aziz,lawmaker,PERSON-PERSON-PERSON,TITLE,PROPN-PROPN-PROPN,NOUN,compound-compound-nsubj,appos,NNP-NNP-NNP,NN,3,1
1162,8743.0,41,said,4,11,10,-1,10,30,-7,6,Shah Abdul Aziz,lawmaker,PERSON-PERSON-PERSON,TITLE,PROPN-PROPN-PROPN,NOUN,compound-compound-dobj,compound,NNP-NNP-NNP,NN,2,1
1163,12154.0,39,heard,3,26,31,5,25,7,-23,28,Shah Abdul Aziz,lawmaker,PERSON-PERSON-PERSON,TITLE,PROPN-PROPN-PROPN,NOUN,compound-compound-pobj,appos,NNP-NNP-NNP,NN,4,1
1164,13145.0,39,emerged,19,1,6,5,0,32,18,-13,Shah Abdul Aziz,lawmaker,PERSON-PERSON-PERSON,TITLE,PROPN-PROPN-PROPN,NOUN,compound-compound-nsubj,appos,NNP-NNP-NNP,NN,3,1
1165,13941.0,50,said,38,42,41,-1,41,8,-4,3,Shah Abdul Aziz,lawmaker,PERSON-PERSON-PERSON,TITLE,PROPN-PROPN-PROPN,NOUN,compound-compound-nsubj,compound,NNP-NNP-NNP,NN,2,1
1166,2395.0,37,vowed,28,18,11,-7,17,25,10,-17,China Charity Federation,Liu Guolin,ORGANIZATION-ORGANIZATION-ORGANIZATION,PERSON-PERSON,PROPN-PROPN-PROPN,PROPN-PROPN,compound-compound-pobj,compound-conj,NNP-NNP-NNP,NNP-NNP,4,1
1167,7507.0,38,said,18,24,20,-4,23,17,-6,2,China Charity Federation,Liu Guolin,ORGANIZATION-ORGANIZATION-ORGANIZATION,PERSON-PERSON,PROPN-PROPN-PROPN,PROPN-PROPN,compound-compound-pobj,compound-nsubj,NNP-NNP-NNP,NNP-NNP,4,1
1168,13567.0,27,said,16,24,18,-6,23,8,-8,2,China Charity Federation,Liu Guolin,ORGANIZATION-ORGANIZATION-ORGANIZATION,PERSON-PERSON,PROPN-PROPN-PROPN,PROPN-PROPN,compound-compound-pobj,compound-nsubj,NNP-NNP-NNP,NNP-NNP,3,1
1169,15106.0,34,CHENGDU,0,31,25,-6,30,8,-31,25,China Charity Federation,Liu Guolin,ORGANIZATION-ORGANIZATION-ORGANIZATION,PERSON-PERSON,PROPN-PROPN-PROPN,PROPN-PROPN,compound-compound-pobj,compound-nsubj,NNP-NNP-NNP,NNP-NNP,3,1
1170,2396.0,42,said,28,30,33,3,29,8,-2,5,Michael Lomax,president,PERSON-PERSON,TITLE,PROPN-PROPN,NOUN,compound-nsubj,appos,NNP-NNP,NN,2,1
1171,3261.0,45,are,6,17,20,3,16,24,-11,14,Michael Lomax,president,PERSON-PERSON,TITLE,PROPN-PROPN,NOUN,compound-conj,appos,NNP-NNP,NN,2,1
1172,6895.0,35,said,19,21,24,3,20,10,-2,5,Michael Lomax,president,PERSON-PERSON,TITLE,PROPN-PROPN,NOUN,compound-nsubj,appos,NNP-NNP,NN,2,1
1173,10403.0,21,said,12,14,17,3,13,3,-2,5,Michael Lomax,president,PERSON-PERSON,TITLE,PROPN-PROPN,NOUN,compound-nsubj,appos,NNP-NNP,NN,2,1
1174,14339.0,26,came,5,8,11,3,7,14,-3,6,Michael Lomax,president,PERSON-PERSON,TITLE,PROPN-PROPN,NOUN,compound-pobj,appos,NNP-NNP,NN,2,1
1175,15186.0,32,questioned,15,1,4,3,0,27,14,-11,Michael Lomax,president,PERSON-PERSON,TITLE,PROPN-PROPN,NOUN,compound-nsubj,appos,NNP-NNP,NN,2,1
1176,2414.0,53,joined,21,2,27,25,1,25,19,6,Tribeca Enterprises,Jane Rosenthal,ORGANIZATION-ORGANIZATION,PERSON-PERSON,PROPN-PROPN,PROPN-PROPN,compound-pobj,compound-appos,NNP-NNPS,NNP-NNP,4,1
1177,2428.0,44,said,38,1,4,3,0,39,37,-34,Alan Gross,60,PERSON-PERSON,NUMBER,PROPN-PROPN,NUM,compound-nsubjpass,appos,NNP-NNP,CD,1,1
1178,10911.0,39,said,1,12,15,3,11,23,-11,14,Alan Gross,60,PERSON-PERSON,NUMBER,PROPN-PROPN,NUM,compound-pobj,appos,NNP-NNP,CD,6,1
1179,14820.0,20,working,6,1,4,3,0,15,5,-2,Alan Gross,60,PERSON-PERSON,NUMBER,PROPN-PROPN,NUM,compound-nsubj,appos,NNP-NNP,CD,2,1
1180,2430.0,43,said,18,13,17,4,12,25,5,-1,National Urban League,NUL,ORGANIZATION-ORGANIZATION-ORGANIZATION,ORGANIZATION,PROPN-PROPN-PROPN,PROPN,compound-compound-nsubj,compound,NNP-NNP-NNP,NNP,3,1
1181,2434.0,38,speak,12,2,4,2,1,33,10,-8,Alessi,president,PERSON,TITLE,PROPN,NOUN,appos,appos,NNP,NN,3,1
1182,2438.0,48,said,31,6,12,6,5,35,25,-19,Organisation of Asia-Pacific News Agencies,OANA,ORGANIZATION-ORGANIZATION-ORGANIZATION-ORGANIZATION-ORGANIZATION,ORGANIZATION,PROPN-ADP-PROPN-PROPN-PROPN,PROPN,pobj-prep-compound-compound-pobj,compound,NNP-IN-NNP-NNP-NNPS,NNP,4,1
1183,6514.0,48,said,31,6,12,6,5,35,25,-19,Organisation of Asia-Pacific News Agencies,OANA,ORGANIZATION-ORGANIZATION-ORGANIZATION-ORGANIZATION-ORGANIZATION,ORGANIZATION,PROPN-ADP-PROPN-PROPN-PROPN,PROPN,pobj-prep-compound-compound-pobj,compound,NNP-IN-NNP-NNP-NNPS,NNP,4,1
1184,2440.0,43,cited,1,11,18,7,10,24,-10,17,Alan Gross,Cuba,PERSON-PERSON,COUNTRY,PROPN-PROPN,PROPN,compound-pobj,pobj,NNP-NNP,NNP,2,1
1185,3758.0,42,says,11,2,6,4,1,35,9,-5,Alan Gross,Cuba,PERSON-PERSON,COUNTRY,PROPN-PROPN,PROPN,compound-nsubj,pobj,NNP-NNP,NNP,3,1
1186,4577.0,31,denied,6,18,6,-12,17,24,-12,0,Alan Gross,Cuba,PERSON-PERSON,COUNTRY,PROPN-PROPN,PROPN,compound-pobj,pobj,NNP-NNP,NNP,4,1
1187,5892.0,40,was,1,16,8,-8,15,31,-15,7,Alan Gross,Cuba,PERSON-PERSON,COUNTRY,PROPN-PROPN,PROPN,compound-pobj,pobj,NNP-NNP,NNP,4,1
1188,7947.0,31,told,28,8,11,3,7,19,20,-17,Alan Gross,Cuba,PERSON-PERSON,COUNTRY,PROPN-PROPN,PROPN,compound-pobj,pobj,NNP-NNP,NNP,3,1
1189,10763.0,24,detained,4,11,4,-7,10,19,-7,0,Alan Gross,Cuba,PERSON-PERSON,COUNTRY,PROPN-PROPN,PROPN,compound-appos,nsubj,NNP-NNP,NNP,2,1
1190,11263.0,27,pressed,9,14,11,-3,13,15,-5,2,Alan Gross,Cuba,PERSON-PERSON,COUNTRY,PROPN-PROPN,PROPN,compound-dobj,dobj,NNP-NNP,NNP,2,1
1191,11274.0,39,said,37,15,23,8,14,15,22,-14,Alan Gross,Cuba,PERSON-PERSON,COUNTRY,PROPN-PROPN,PROPN,compound-pobj,pobj,NNP-NNP,NNP,3,1
1192,11471.0,43,cited,1,11,18,7,10,24,-10,17,Alan Gross,Cuba,PERSON-PERSON,COUNTRY,PROPN-PROPN,PROPN,compound-pobj,pobj,NNP-NNP,NNP,2,1
1193,14304.0,16,continues,1,9,1,-8,8,14,-8,0,Alan Gross,Cuba,PERSON-PERSON,COUNTRY,PROPN-PROPN,PROPN,compound-appos,nsubj,NNP-NNP,NNP,3,1
1194,2444.0,36,identifies,1,6,4,-2,5,31,-5,3,George Sodini,writer,PERSON-PERSON,TITLE,PROPN-PROPN,NOUN,compound-pobj,dobj,NNP-NNP,NN,1,1
1195,2446.0,40,said,9,18,11,-7,17,28,-9,2,National Congress of American Indians,John Dossett,ORGANIZATION-ORGANIZATION-ORGANIZATION-ORGANIZATION-ORGANIZATION,PERSON-PERSON,PROPN-PROPN-ADP-PROPN-PROPN,PROPN-PROPN,compound-pobj-prep-compound-pobj,compound-nsubj,NNP-NNP-IN-NNP-NNPS,NNP-NNP,5,1
1196,2449.0,23,is,4,20,2,-18,19,20,-16,-2,National Urban League,Black Leadership Forum,ORGANIZATION-ORGANIZATION-ORGANIZATION,ORGANIZATION-ORGANIZATION-ORGANIZATION,PROPN-PROPN-PROPN,PROPN-PROPN-PROPN,compound-compound-conj,compound-compound-nsubj,NNP-NNP-NNP,NNP-NNP-NNP,9,1
1197,2456.0,22,say,9,16,8,-8,15,13,-7,-1,Alan Gross,Jewish,PERSON-PERSON,RELIGION,PROPN-PROPN,ADJ,compound-pobj,acomp,NNP-NNP,JJ,6,1
1198,9864.0,22,say,9,16,8,-8,15,13,-7,-1,Alan Gross,Jewish,PERSON-PERSON,RELIGION,PROPN-PROPN,ADJ,compound-pobj,amod,NNP-NNP,JJ,6,1
1199,2460.0,54,told,48,43,3,-40,42,50,5,-45,Professional Ski Instructors of America,he,ORGANIZATION-ORGANIZATION-ORGANIZATION-ORGANIZATION-ORGANIZATION,PERSON,PROPN-PROPN-PROPN-ADP-PROPN,PRON,compound-compound-pobj-prep-pobj,nsubj,NNP-NNP-NNP-IN-NNP,PRP,9,1
1200,2485.0,21,said,9,17,11,-6,16,9,-8,2,Progressive Democrats of America,Tim Carpenter,ORGANIZATION-ORGANIZATION-ORGANIZATION-ORGANIZATION,PERSON-PERSON,PROPN-PROPN-ADP-PROPN,PROPN-PROPN,compound-pobj-prep-pobj,compound-nsubj,NNP-NNPS-IN-NNP,NNP-NNP,3,1
1201,2493.0,48,CHONGQING,0,16,31,15,15,16,-16,31,gang `` Godmother '',running gambling dens,PERSON-PERSON-PERSON-PERSON,CRIMINAL_CHARGE-CRIMINAL_CHARGE-CRIMINAL_CHARGE,NOUN-PUNCT-PROPN-PUNCT,VERB-NOUN-NOUN,pobj-punct-appos-punct,conj-compound-dobj,NN-``-NNP-'',VBG-NN-NNS,-1,1
1202,2494.0,36,open,4,12,18,6,11,17,-8,14,Terry Jupp,2002,PERSON-PERSON,DATE,PROPN-PROPN,NUM,compound-pobj,pobj,NNP-NNP,CD,2,1
1203,2496.0,26,told,1,7,16,9,6,9,-6,15,John Graham,activist,PERSON-PERSON,TITLE,PROPN-PROPN,ADJ,compound-appos,compound,NNP-NNP,JJ,6,1
1204,2510.0,38,said,25,30,35,5,29,2,-5,10,the National Energy Administration,NEA,ORGANIZATION-ORGANIZATION-ORGANIZATION-ORGANIZATION,ORGANIZATION,DET-PROPN-PROPN-PROPN,PROPN,det-compound-compound-pobj,compound,DT-NNP-NNP-NNP,NNP,5,1
1205,2531.0,37,starts,1,1,7,6,0,29,0,6,Heloise,Texas State,PERSON,ORGANIZATION-ORGANIZATION,PROPN,PROPN-PROPN,nsubj,compound-pobj,NNP,NNP-NNP,2,1
1206,2536.0,33,founded,6,3,11,8,2,21,3,5,High Point Church,Simons,ORGANIZATION-ORGANIZATION-ORGANIZATION,PERSON,PROPN-PROPN-PROPN,PROPN,compound-compound-nsubjpass,pobj,NNP-NNP-NNP,NNPS,3,1
1207,3256.0,34,http://wwwchroncom/disp/storympl/metropolitan/5045808html,0,4,12,8,3,21,-4,12,High Point Church,Simons,ORGANIZATION-ORGANIZATION-ORGANIZATION,PERSON,PROPN-PROPN-PROPN,PROPN,compound-compound-nsubjpass,pobj,NNP-NNP-NNP,NNPS,-1,1
1208,2538.0,7,suspects,1,3,6,3,2,0,-2,5,Gross,spy,PERSON,TITLE,PROPN,NOUN,nsubj,attr,NNP,NN,2,1
1209,7317.0,25,WASHINGTON,0,12,24,12,11,0,-12,24,Gross,spy,PERSON,TITLE,PROPN,NOUN,nsubj,attr,NNP,NN,4,1
1210,8365.0,43,slammed,2,21,8,-13,20,34,-19,6,Gross,spy,PERSON,TITLE,PROPN,NOUN,nsubj,pobj,NNP,NN,6,1
1211,8766.0,16,believes,1,3,15,12,2,0,-2,14,Gross,spy,PERSON,TITLE,PROPN,NOUN,nsubj,attr,NNP,NN,4,1
1212,9624.0,19,sent,12,1,18,17,0,0,11,6,Gross,spy,PERSON,TITLE,PROPN,NOUN,nsubjpass,pobj,NNP,NN,3,1
1213,10333.0,23,insists,1,4,7,3,3,15,-3,6,Gross,spy,PERSON,TITLE,PROPN,NOUN,nsubj,attr,NNP,NN,3,1
1214,14900.0,35,insists,13,16,19,3,15,15,-3,6,Gross,spy,PERSON,TITLE,PROPN,NOUN,nsubj,attr,NNP,NN,2,1
1215,2551.0,34,told,29,1,5,4,0,28,28,-24,Ruben van Assouw,9,PERSON-PERSON-PERSON,NUMBER,PROPN-PROPN-PROPN,NUM,compound-compound-nsubj,appos,NNP-NNP-NNP,CD,2,1
1216,11077.0,16,treated,8,1,5,4,0,10,7,-3,Ruben van Assouw,9,PERSON-PERSON-PERSON,NUMBER,PROPN-PROPN-PROPN,NUM,compound-compound-nsubjpass,appos,NNP-NNP-NNP,CD,3,1
1217,2554.0,28,executed,4,6,2,-4,5,25,-2,-2,Wen Qiang,July,PERSON-PERSON,DATE,PROPN-PROPN,PROPN,compound-dobj,pobj,NNP-NNP,NNP,2,1
1218,2567.0,39,were,7,4,1,-3,3,37,3,-6,Chiafari,Police Officer,PERSON,TITLE-TITLE,PROPN,PROPN-PROPN,nsubj,compound-compound,NNP,NNP-NNP,2,1
1219,2568.0,48,said,45,12,19,7,11,28,33,-26,Wen Qiang,judicial administrative bureau,PERSON-PERSON,ORGANIZATION-ORGANIZATION-ORGANIZATION,PROPN-PROPN,ADJ-ADJ-NOUN,compound-pobj,amod-amod-pobj,NNP-NNP,JJ-JJ-NN,4,1
1220,11221.0,37,said,34,1,8,7,0,28,33,-26,Wen Qiang,judicial administrative bureau,PERSON-PERSON,ORGANIZATION-ORGANIZATION-ORGANIZATION,PROPN-PROPN,ADJ-ADJ-NOUN,compound-nsubjpass,amod-amod-pobj,NNP-NNP,JJ-JJ-NN,4,1
1221,2572.0,51,is,1,26,33,7,25,17,-25,32,Mark Fisher,New Jersey,PERSON-PERSON,STATE_OR_PROVINCE-STATE_OR_PROVINCE,PROPN-PROPN,PROPN-PROPN,compound-pobj,compound-pobj,NNP-NNP,NNP-NNP,3,1
1222,2577.0,21,said,19,6,3,-3,5,17,13,-16,Gonzalez,the day,PERSON,DATE-DATE,PROPN,DET-NOUN,nsubjpass,det-npadvmod,NNP,DT-NN,4,1
1223,2586.0,15,told,1,1,7,6,0,7,0,6,She,He,PERSON,PERSON,PRON,PRON,nsubj,nsubj,PRP,PRP,2,1
1224,2589.0,61,said,12,7,1,-6,6,59,5,-11,National Congress of American Indians,Jefferson Keel,ORGANIZATION-ORGANIZATION-ORGANIZATION-ORGANIZATION-ORGANIZATION,PERSON-PERSON,PROPN-PROPN-ADP-PROPN-PROPN,PROPN-PROPN,compound-pobj-prep-compound-pobj,compound-nsubj,NNP-NNP-IN-NNP-NNPS,NNP-NNP,3,1
1225,5005.0,40,said,27,35,29,-6,34,10,-8,2,National Congress of American Indians,Jefferson Keel,ORGANIZATION-ORGANIZATION-ORGANIZATION-ORGANIZATION-ORGANIZATION,PERSON-PERSON,PROPN-PROPN-ADP-PROPN-PROPN,PROPN-PROPN,compound-pobj-prep-compound-pobj,compound-nsubj,NNP-NNP-IN-NNP-NNPS,NNP-NNP,5,1
1226,7188.0,14,says,1,9,3,-6,8,10,-8,2,National Congress of American Indians,Jefferson Keel,ORGANIZATION-ORGANIZATION-ORGANIZATION-ORGANIZATION-ORGANIZATION,PERSON-PERSON,PROPN-PROPN-ADP-PROPN-PROPN,PROPN-PROPN,compound-pobj-prep-compound-pobj,compound-nsubj,NNP-NNP-IN-NNP-NNPS,NNP-NNP,3,1
1227,2595.0,43,said,30,39,25,-14,38,17,-9,-5,Pacific Asia Travel Association,Vietnam,ORGANIZATION-ORGANIZATION-ORGANIZATION-ORGANIZATION,COUNTRY,PROPN-PROPN-PROPN-PROPN,PROPN,compound-compound-compound-pobj,conj,NNP-NNP-NNP-NNP,NNP,9,1
1228,2605.0,49,am,1,5,46,41,4,2,-4,45,Norris Church Mailer,Brooklyn,PERSON-PERSON-PERSON,CITY,PROPN-PROPN-PROPN,PROPN,compound-compound-nsubj,pobj,NNP-NNP-NNP,NNP,-1,1
1229,2614.0,42,said,5,32,18,-14,31,23,-27,13,Ruben,Netherlands,PERSON,NATIONALITY,PROPN,PROPN,nsubj,compound,NNP,NNP,8,1
1230,4005.0,41,said,5,7,15,8,6,25,-2,10,Ruben,Netherlands,PERSON,NATIONALITY,PROPN,PROPN,nsubj,pobj,NNP,NNP,1,1
1231,6105.0,43,said,5,7,15,8,6,27,-2,10,Ruben,Netherlands,PERSON,COUNTRY,PROPN,PROPN,nsubj,pobj,NNP,NNP,1,1
1232,2620.0,29,GOODMAN,1,4,9,5,3,19,-3,8,Nir Rosen,journalist,PERSON-PERSON,TITLE,PROPN-PROPN,NOUN,compound-nsubj,attr,NNP-NNP,NN,3,1
1233,3089.0,30,noted,5,4,3,-1,3,26,1,-2,Nir Rosen,journalist,PERSON-PERSON,TITLE,PROPN-PROPN,NOUN,compound-nsubj,compound,NNP-NNP,NN,1,1
1234,4531.0,39,reports,9,7,6,-1,6,32,2,-3,Nir Rosen,journalist,PERSON-PERSON,TITLE,PROPN-PROPN,NOUN,compound-pobj,compound,NNP-NNP,NN,2,1
1235,6272.0,31,Erroll,0,5,4,-1,4,26,-5,4,Nir Rosen,journalist,PERSON-PERSON,TITLE,PROPN-PROPN,NOUN,compound-nsubj,compound,NNP-NNP,NN,1,1
1236,6311.0,31,lets,15,3,2,-1,2,28,12,-13,Nir Rosen,journalist,PERSON-PERSON,TITLE,PROPN-PROPN,NOUN,compound-nsubj,compound,NNP-NNP,NN,1,1
1237,6407.0,30,¯,2,7,11,4,6,18,-5,9,Nir Rosen,journalist,PERSON-PERSON,TITLE,PROPN-PROPN,NOUN,compound-pobj,appos,NNP-NNP,NN,6,1
1238,6736.0,26,is,2,1,7,6,0,18,1,5,Nir Rosen,journalist,PERSON-PERSON,TITLE,PROPN-PROPN,NOUN,compound-nsubj,attr,NNP-NNP,NN,4,1
1239,6972.0,53,Listen,0,26,31,5,25,21,-26,31,Nir Rosen,journalist,PERSON-PERSON,TITLE,PROPN-PROPN,NOUN,compound-nsubj,attr,NNP-NNP,NN,6,1
1240,9017.0,27,Rosen,1,1,5,4,0,21,0,4,Nir Rosen,journalist,PERSON-PERSON,TITLE,PROPN-PROPN,NOUN,compound-ROOT,appos,NNP-NNP,NN,2,1
1241,10860.0,23,turned,17,5,4,-1,4,18,12,-13,Nir Rosen,journalist,PERSON-PERSON,TITLE,PROPN-PROPN,NOUN,compound-nsubj,compound,NNP-NNP,NN,1,1
1242,2627.0,38,speak,12,2,1,-1,1,36,10,-11,Alessi,Alberto Alessi,ORGANIZATION,PERSON-PERSON,PROPN,PROPN-PROPN,appos,compound-nsubj,NNP,NNP-NNP,1,1
1243,15020.0,38,speak,12,2,1,-1,1,36,10,-11,Alessi,Alberto Alessi,ORGANIZATION,PERSON-PERSON,PROPN,PROPN-PROPN,appos,compound-nsubj,NNP,NNP-NNP,1,1
1244,2632.0,13,busted,7,4,10,6,3,2,3,3,Korey Rowe,selling heroin,PERSON-PERSON,CRIMINAL_CHARGE-CRIMINAL_CHARGE,PROPN-PROPN,VERB-NOUN,compound-appos,pcomp-dobj,NNP-NNP,VBG-NN,5,1
1245,2634.0,33,killed,24,11,1,-10,10,31,13,-23,young pilot,Israel,PERSON-PERSON,NATIONALITY,ADJ-NOUN,PROPN,amod-dobj,nsubj,JJ-NN,NNP,5,1
1246,2641.0,23,worked,1,17,21,4,16,1,-16,20,National Urban League,New York,ORGANIZATION-ORGANIZATION-ORGANIZATION,STATE_OR_PROVINCE-STATE_OR_PROVINCE,PROPN-PROPN-PROPN,PROPN-PROPN,compound-compound-dobj,compound-pobj,NNP-NNP-NNP,NNP-NNP,3,1
1247,2648.0,24,is,5,5,3,-2,4,20,0,-2,PATA,1951,ORGANIZATION,DATE,PROPN,NUM,nsubj,pobj,NNP,CD,1,1
1248,2651.0,36,Francisco,1,23,15,-8,22,20,-22,14,Sarah Kunstler,rape,PERSON-PERSON,CRIMINAL_CHARGE,PROPN-PROPN,NOUN,compound-nsubj,compound,NNP-NNP,NN,7,1
1249,2652.0,24,named,1,5,20,15,4,3,-4,19,Shah Abdul Aziz,lower house,PERSON-PERSON-PERSON,ORGANIZATION-ORGANIZATION,PROPN-PROPN-PROPN,ADJ-NOUN,compound-compound-pobj,amod-pobj,NNP-NNP-NNP,JJR-NN,9,1
1250,13115.0,38,named,1,5,22,17,4,15,-4,21,Shah Abdul Aziz,lower house,PERSON-PERSON-PERSON,ORGANIZATION-ORGANIZATION,PROPN-PROPN-PROPN,ADJ-NOUN,compound-compound-pobj,amod-pobj,NNP-NNP-NNP,JJR-NN,9,1
1251,2655.0,18,moved,1,1,4,3,0,13,0,3,She,Sao Paulo,PERSON,CITY-CITY,PRON,PROPN-PROPN,nsubj,compound-pobj,PRP,NNP-NNP,2,1
1252,2661.0,15,indicted,4,3,7,4,2,7,1,3,Amanda Knox,slandering police,PERSON-PERSON,CRIMINAL_CHARGE-CRIMINAL_CHARGE,PROPN-PROPN,VERB-NOUN,compound-nsubj,pcomp-dobj,NNP-NNP,VBG-NNS,4,1
1253,2663.0,47,JOLO,0,12,19,7,11,27,-12,19,Vagni,ICRC,PERSON,ORGANIZATION,PROPN,PROPN,nsubjpass,compound,NNP,NNP,4,1
1254,2665.0,20,studied,2,1,10,9,0,9,1,8,Dworin,librarian,PERSON,TITLE,PROPN,NOUN,nsubj,attr,NNP,NN,5,1
1255,2686.0,35,said,32,7,5,-2,6,29,25,-27,Amanda Knox,US,PERSON-PERSON,COUNTRY,PROPN-PROPN,PROPN,compound-pobj,compound,NNP-NNP,NNP,1,1
1256,6568.0,43,convicted,1,14,18,4,13,24,-13,17,Amanda Knox,US,PERSON-PERSON,COUNTRY,PROPN-PROPN,PROPN,compound-nsubj,compound,NNP-NNP,NNP,1,1
1257,6705.0,45,ROME,0,10,14,4,9,30,-10,14,Amanda Knox,US,PERSON-PERSON,COUNTRY,PROPN-PROPN,PROPN,compound-nsubjpass,compound,NNP-NNP,NNP,1,1
1258,8083.0,30,dates,1,18,16,-2,17,13,-17,15,Amanda Knox,US,PERSON-PERSON,COUNTRY,PROPN-PROPN,PROPN,compound-dobj,compound,NNP-NNP,NNP,1,1
1259,11324.0,49,said,47,14,12,-2,13,36,33,-35,Amanda Knox,US,PERSON-PERSON,COUNTRY,PROPN-PROPN,PROPN,compound-pobj,compound,NNP-NNP,NNP,1,1
1260,14577.0,26,says,2,11,9,-2,10,16,-9,7,Amanda Knox,US,PERSON-PERSON,COUNTRY,PROPN-PROPN,PROPN,compound-dobj,compound,NNP-NNP,NNP,1,1
1261,15133.0,42,said,7,6,4,-2,5,37,1,-3,Amanda Knox,US,PERSON-PERSON,COUNTRY,PROPN-PROPN,PROPN,compound-pobj,compound,NNP-NNP,NNP,1,1
1262,15501.0,34,accused,8,7,4,-3,6,29,1,-4,Amanda Knox,US,PERSON-PERSON,COUNTRY,PROPN-PROPN,PROPN,compound-pobj,compound,NNP-NNP,NNP,2,1
1263,2714.0,27,do,17,7,2,-5,6,24,10,-15,BestPartyEvercom,Sally Strebel,ORGANIZATION,PERSON-PERSON,PROPN,PROPN-PROPN,pobj,compound-nsubj,NNP,NNP-NNP,3,1
1264,4247.0,8,appear,5,1,3,2,0,4,4,-2,BestPartyEvercom,Sally Strebel,ORGANIZATION,PERSON-PERSON,ADJ,PROPN-PROPN,compound,compound-nsubj,JJ,NNP-NNP,1,1
1265,2716.0,47,_,0,40,35,-5,39,11,-40,35,United Solutions and Services,Alaska,ORGANIZATION-ORGANIZATION-ORGANIZATION-ORGANIZATION,STATE_OR_PROVINCE,PROPN-PROPN-CCONJ-PROPN,PROPN,compound-appos-cc-compound,nmod,NNP-NNPS-CC-NNPS,NNP,3,1
1266,2717.0,32,serves,1,12,1,-11,11,30,-11,0,Progressive Democrats of America,Hayden,ORGANIZATION-ORGANIZATION-ORGANIZATION-ORGANIZATION,PERSON,PROPN-PROPN-ADP-PROPN,PROPN,compound-pobj-prep-pobj,nsubj,NNP-NNPS-IN-NNP,NNP,6,1
1267,2727.0,48,come,22,7,29,22,6,18,15,7,Laura Silsby,Idaho,PERSON-PERSON,STATE_OR_PROVINCE,PROPN-PROPN,PROPN,compound-appos,pobj,NNP-NNP,NNP,5,1
1268,4631.0,63,ordered,5,39,37,-2,38,25,-34,32,Laura Silsby,Idaho,PERSON-PERSON,STATE_OR_PROVINCE,PROPN-PROPN,PROPN,compound-appos,compound,NNP-NNP,NNP,1,1
1269,6023.0,22,said,1,10,15,5,9,6,-9,14,Laura Silsby,Idaho,PERSON-PERSON,STATE_OR_PROVINCE,PROPN-PROPN,PROPN,compound-appos,appos,NNP-NNP,NNP,3,1
1270,9733.0,36,detained,18,1,16,15,0,19,17,-2,Laura Silsby,Idaho,PERSON-PERSON,STATE_OR_PROVINCE,PROPN-PROPN,PROPN,compound-nsubjpass,pobj,NNP-NNP,NNP,2,1
1271,14492.0,33,arrested,9,1,8,7,0,24,8,-1,Laura Silsby,Idaho,PERSON-PERSON,STATE_OR_PROVINCE,PROPN-PROPN,PROPN,compound-nsubjpass,pobj,NNP-NNP,NNP,2,1
1272,14783.0,28,told,13,7,12,5,6,15,6,-1,Laura Silsby,Idaho,PERSON-PERSON,STATE_OR_PROVINCE,PROPN-PROPN,PROPN,compound-nsubj,appos,NNP-NNP,NNP,2,1
1273,2728.0,41,said,31,5,33,28,4,7,26,2,ALICO,Rodney Martin,ORGANIZATION,PERSON-PERSON,PROPN,PROPN-PROPN,compound,compound-nsubj,NNP,NNP-NNP,5,1
1274,12915.0,41,said,31,5,33,28,4,7,26,2,ALICO,Rodney Martin,ORGANIZATION,PERSON-PERSON,PROPN,PROPN-PROPN,dobj,compound-nsubj,NNP,NNP-NNP,5,1
1275,2729.0,54,MANILA,0,27,11,-16,26,42,-27,11,Eugenio Vagni,the International Committee of the Red Cross,PERSON-PERSON,ORGANIZATION-ORGANIZATION-ORGANIZATION-ORGANIZATION-ORGANIZATION-ORGANIZATION-ORGANIZATION,PROPN-PROPN,DET-PROPN-PROPN-ADP-DET-PROPN-PROPN,compound-conj,det-compound-pobj-prep-det-compound-pobj,NNP-NNP,DT-NNP-NNP-IN-DT-NNP-NNP,-1,1
1276,2744.0,51,is,1,26,31,5,25,19,-25,30,Mark Fisher,student,PERSON-PERSON,TITLE,PROPN-PROPN,NOUN,compound-pobj,appos,NNP-NNP,NN,2,1
1277,4825.0,48,was,7,16,23,7,15,24,-9,16,Mark Fisher,student,PERSON-PERSON,TITLE,PROPN-PROPN,NOUN,compound-dobj,appos,NNP-NNP,NN,2,1
1278,13362.0,42,convicted,2,9,17,8,8,24,-7,15,Mark Fisher,student,PERSON-PERSON,TITLE,PROPN-PROPN,NOUN,compound-pobj,appos,NNP-NNP,NN,4,1
1279,2750.0,34,kidnapped,5,11,7,-4,10,26,-6,2,Eugenio Vagni,Italian,PERSON-PERSON,NATIONALITY,PROPN-PROPN,PROPN,compound-nsubj,amod,NNP-NNP,NNP,3,1
1280,5021.0,32,released,24,1,5,4,0,26,23,-19,Eugenio Vagni,Italian,PERSON-PERSON,NATIONALITY,PROPN-PROPN,ADJ,compound-nsubjpass,amod,NNP-NNP,JJ,1,1
1281,8177.0,26,freed,3,12,11,-1,11,14,-9,8,Eugenio Vagni,Italian,PERSON-PERSON,NATIONALITY,PROPN-PROPN,ADJ,compound-nsubjpass,compound,NNP-NNP,JJ,1,1
1282,9086.0,24,been,4,20,17,-3,19,6,-16,13,Eugenio Vagni,Italian,PERSON-PERSON,NATIONALITY,PROPN-PROPN,ADJ,compound-dobj,amod,NNP-NNP,JJ,2,1
1283,9965.0,30,freed,14,7,6,-1,6,23,7,-8,Eugenio Vagni,Italian,PERSON-PERSON,NATIONALITY,PROPN-PROPN,PROPN,compound-conj,compound,NNP-NNP,NNP,1,1
1284,11331.0,42,was,1,11,16,5,10,25,-10,15,Eugenio Vagni,Italian,PERSON-PERSON,NATIONALITY,PROPN-PROPN,PROPN,compound-pobj,appos,NNP-NNP,NNP,7,1
1285,11985.0,23,said,21,5,1,-4,4,21,16,-20,Eugenio Vagni,Italian,PERSON-PERSON,NATIONALITY,PROPN-PROPN,PROPN,compound-nsubjpass,amod,NNP-NNP,NNP,3,1
1286,13725.0,40,kidnapped,5,11,7,-4,10,32,-6,2,Eugenio Vagni,Italian,PERSON-PERSON,NATIONALITY,PROPN-PROPN,PROPN,compound-nsubj,amod,NNP-NNP,NNP,3,1
1287,14257.0,37,said,35,5,1,-4,4,35,30,-34,Eugenio Vagni,Italian,PERSON-PERSON,NATIONALITY,PROPN-PROPN,PROPN,compound-nsubjpass,amod,NNP-NNP,NNP,3,1
1288,15355.0,34,Gaunt,0,9,6,-3,8,27,-9,6,Eugenio Vagni,Italian,PERSON-PERSON,NATIONALITY,PROPN-PROPN,ADJ,compound-nsubj,amod,NNP-NNP,JJ,2,1
1289,15474.0,26,is,14,7,2,-5,6,23,7,-12,Eugenio Vagni,Italian,PERSON-PERSON,NATIONALITY,PROPN-PROPN,ADJ,compound-appos,amod,NNP-NNP,JJ,3,1
1290,2757.0,41,absconded,2,22,18,-4,21,22,-20,16,Wen Qiang,deputy,PERSON-PERSON,TITLE,PROPN-PROPN,NOUN,compound-pobj,compound,NNP-NNP,NN,3,1
1291,2762.0,38,served,4,1,7,6,0,30,3,3,Wen,vice director,PERSON,TITLE-TITLE,PROPN,NOUN-NOUN,nsubj,compound-pobj,NNP,NN-NN,4,1
1292,9234.0,37,served,3,3,6,3,2,30,0,3,Wen,vice director,PERSON,TITLE-TITLE,PROPN,NOUN-NOUN,nsubj,compound-pobj,NNP,NN-NN,2,1
1293,13874.0,35,served,1,1,4,3,0,30,0,3,Wen,vice director,PERSON,TITLE-TITLE,PROPN,NOUN-NOUN,nsubj,compound-pobj,NNP,NN-NN,2,1
1294,2768.0,20,notified,3,16,19,3,15,0,-13,16,his,Friday,PERSON,DATE,DET,PROPN,poss,npadvmod,PRP$,NNP,1,1
1295,5070.0,20,notified,4,15,19,4,14,0,-11,15,his,Friday,PERSON,DATE,DET,PROPN,poss,pobj,PRP$,NNP,3,1
1296,2770.0,23,returned,11,7,9,2,6,13,4,-2,Silsby,40,PERSON,NUMBER,PROPN,NUM,appos,appos,NNP,CD,4,1
1297,4806.0,37,asked,10,1,3,2,0,33,9,-7,Silsby,40,PERSON,NUMBER,PROPN,NUM,nsubjpass,appos,NNP,CD,2,1
1298,2772.0,26,was,7,1,9,8,0,16,6,2,Bamba,Ivory Coast,PERSON,COUNTRY-COUNTRY,PROPN,PROPN-PROPN,nsubj,compound-poss,NNP,NNP-NNP,2,1
1299,14512.0,32,said,15,18,9,-9,17,22,-3,-6,Bamba,Ivory Coast,PERSON,COUNTRY-COUNTRY,PROPN,PROPN-PROPN,nsubj,compound-nsubj,NNP,NNP-NNP,5,1
1300,2774.0,24,born,9,8,12,4,7,11,1,3,she,Washington,PERSON,STATE_OR_PROVINCE,PRON,PROPN,nsubjpass,compound,PRP,NNP,3,1
1301,2778.0,34,been,2,17,20,3,16,13,-15,18,her,Eloise Bowles,PERSON,PERSON-PERSON,DET,PROPN-PROPN,poss,compound-appos,PRP$,NNP-NNP,1,1
1302,2787.0,53,makes,9,44,34,-10,43,18,-35,25,Christopher Bollyn,AFP,PERSON-PERSON,ORGANIZATION,PROPN-PROPN,PROPN,compound-conj,pobj,NNP-NNP,NNP,4,1
1303,2802.0,36,Silsby,3,3,34,31,2,1,0,31,Laura Silsby,kidnapping,PERSON-PERSON,CRIMINAL_CHARGE,PROPN-PROPN,NOUN,compound-ROOT,compound,NNP-NNP,NN,3,1
1304,8822.0,37,appeared,28,4,35,31,3,1,24,7,Laura Silsby,kidnapping,PERSON-PERSON,CRIMINAL_CHARGE,PROPN-PROPN,NOUN,compound-nsubj,compound,NNP-NNP,NN,4,1
1305,11607.0,39,said,14,8,5,-3,7,33,6,-9,Laura Silsby,kidnapping,PERSON-PERSON,CRIMINAL_CHARGE,PROPN-PROPN,NOUN,compound-pobj,xcomp,NNP-NNP,NN,2,1
1306,2807.0,47,said,5,32,32,0,31,14,-27,27,China,China Charity Federation,ORGANIZATION,COUNTRY-COUNTRY-COUNTRY,PROPN,PROPN-PROPN-PROPN,pobj,compound-compound-conj,NNP,NNP-NNP-NNP,0,1
1307,2813.0,28,went,5,27,12,-15,26,15,-22,7,his,Souza,PERSON,PERSON,DET,PROPN,attr,dobj,PRP$,NNP,3,1
1308,2821.0,46,scheduled,5,25,27,2,24,18,-20,22,Countrywide,1969,ORGANIZATION,DATE,PROPN,NUM,dobj,pobj,NNP,CD,2,1
1309,2824.0,29,transferred,12,10,28,18,9,0,2,16,Piedra,Clearwater,ORGANIZATION,CITY,PROPN,PROPN,poss,pobj,NNP,NNP,4,1
1310,2827.0,24,was,14,19,2,-17,18,21,-5,-12,Frank Baldino Jr.,CEO,PERSON-PERSON-PERSON,TITLE,PROPN-PROPN-PROPN,NOUN,compound-compound-attr,nsubj,NNP-NNP-NNP,NN,6,1
1311,2836.0,31,worked,4,1,3,2,0,27,3,-1,Jupp,46,PERSON,NUMBER,PROPN,NUM,nsubj,appos,NNP,CD,3,1
1312,3260.0,31,worked,4,1,3,2,0,27,3,-1,Jupp,46,PERSON,NUMBER,PROPN,NUM,nsubj,appos,NNP,CD,3,1
1313,7540.0,29,worked,4,1,3,2,0,25,3,-1,Jupp,46,PERSON,NUMBER,PROPN,NUM,nsubj,appos,NNP,CD,3,1
1314,8918.0,29,worked,4,1,3,2,0,25,3,-1,Jupp,46,PERSON,NUMBER,PROPN,NUM,nsubj,appos,NNP,CD,3,1
1315,2838.0,29,grabbed,9,1,7,6,0,21,8,-2,MEF,1991,ORGANIZATION,DATE,PROPN,NUM,nsubj,pobj,NNP,CD,3,1
1316,2840.0,29,opens,6,21,3,-18,20,25,-15,-3,her,student,PERSON,TITLE,PRON,NOUN,dobj,poss,PRP,NN,9,1
1317,13838.0,26,finished,20,12,10,-2,11,15,8,-10,her,student,PERSON,TITLE,DET,NOUN,poss,pobj,PRP$,NN,3,1
1318,2844.0,26,accused,12,7,3,-4,6,22,5,-9,his,54,PERSON,NUMBER,DET,NUM,poss,appos,PRP$,CD,5,1
1319,2846.0,32,said,28,1,19,18,0,12,27,-9,Ruben van Assouw,Trudy,PERSON-PERSON-PERSON,PERSON,PROPN-PROPN-PROPN,PROPN,compound-compound-nsubj,appos,NNP-NNP-NNP,NNP,6,1
1320,4072.0,47,said,1,3,16,13,2,30,-2,15,Ruben van Assouw,Trudy,PERSON-PERSON-PERSON,PERSON,PROPN-PROPN-PROPN,PROPN,compound-compound-nsubj,appos,NNP-NNP-NNP,NNP,6,1
1321,4275.0,46,said,4,11,31,20,10,14,-7,27,Ruben van Assouw,Trudy,PERSON-PERSON-PERSON,PERSON,PROPN-PROPN-PROPN,PROPN,compound-compound-attr,appos,NNP-NNP-NNP,NNP,4,1
1322,6606.0,44,said,4,10,30,20,9,13,-6,26,Ruben van Assouw,Trudy,PERSON-PERSON-PERSON,PERSON,PROPN-PROPN-PROPN,PROPN,compound-compound-attr,appos,NNP-NNP-NNP,NNP,6,1
1323,7437.0,52,TUNIS,0,18,31,13,17,20,-18,31,Ruben van Assouw,Trudy,PERSON-PERSON-PERSON,PERSON,PROPN-PROPN-PROPN,PROPN,compound-compound-pobj,appos,NNP-NNP-NNP,NNP,7,1
1324,7743.0,45,said,4,10,30,20,9,14,-6,26,Ruben van Assouw,Trudy,PERSON-PERSON-PERSON,PERSON,PROPN-PROPN-PROPN,PROPN,compound-compound-attr,appos,NNP-NNP-NNP,NNP,6,1
1325,10282.0,45,identified,3,11,24,13,10,20,-8,21,Ruben van Assouw,Trudy,PERSON-PERSON-PERSON,PERSON,PROPN-PROPN-PROPN,PROPN,compound-compound-pobj,appos,NNP-NNP-NNP,NNP,7,1
1326,2850.0,38,said,4,10,35,25,9,2,-6,31,Eugenio Vagni,Philippines,PERSON-PERSON,COUNTRY,PROPN-PROPN,PROPN,compound-pobj,dobj,NNP-NNP,NNP,9,1
1327,3099.0,35,Gaunt,0,9,26,17,8,8,-9,26,Eugenio Vagni,Philippines,PERSON-PERSON,COUNTRY,PROPN-PROPN,PROPN,compound-nsubj,pobj,NNP-NNP,NNP,2,1
1328,5225.0,34,kidnapped,5,11,23,12,10,10,-6,18,Eugenio Vagni,Philippines,PERSON-PERSON,COUNTRY,PROPN-PROPN,PROPN,compound-nsubj,pobj,NNP-NNP,NNP,3,1
1329,7619.0,35,Gaunt,0,9,26,17,8,8,-9,26,Eugenio Vagni,Philippines,PERSON-PERSON,COUNTRY,PROPN-PROPN,PROPN,compound-nsubj,pobj,NNP-NNP,NNP,2,1
1330,2851.0,48,ROME,0,10,14,4,9,33,-10,14,Amanda Knox,23-year-old,PERSON-PERSON,NUMBER,PROPN-PROPN,NUM,compound-nsubjpass,amod,NNP-NNP,CD,4,1
1331,2854.0,42,planning,28,18,38,20,17,3,10,10,Chen Tao,FIFA,PERSON-PERSON,ORGANIZATION,PROPN-PROPN,PROPN,compound-conj,appos,NNP-NNP,NNP,5,1
1332,2863.0,41,said,23,30,25,-5,29,15,-7,2,TPI,Dennis McGuire,ORGANIZATION,PERSON-PERSON,PROPN,PROPN-PROPN,pobj,compound-nsubj,NNP,NNP-NNP,4,1
1333,7008.0,39,said,23,30,25,-5,29,13,-7,2,TPI,Dennis McGuire,ORGANIZATION,PERSON-PERSON,PROPN,PROPN-PROPN,pobj,compound-nsubj,NNP,NNP-NNP,4,1
1334,2882.0,27,been,12,4,9,5,3,17,8,-3,Aquash,Canadian,PERSON,NATIONALITY,PROPN,ADJ,pobj,acomp,NNP,JJ,3,1
1335,2884.0,30,launched,7,5,23,18,4,6,2,16,National Restaurant Association,"375,000",ORGANIZATION-ORGANIZATION-ORGANIZATION,NUMBER,PROPN-PROPN-PROPN,NUM,compound-compound-nsubj,nummod,NNP-NNP-NNP,CD,6,1
1336,2897.0,20,presented,6,3,2,-1,2,17,3,-4,Youssoufou Bamba,diplomat,PERSON-PERSON,TITLE,PROPN-PROPN,NOUN,compound-nsubj,compound,NNP-NNP,NN,1,1
1337,8506.0,32,said,4,3,2,-1,2,29,1,-2,Youssoufou Bamba,diplomat,PERSON-PERSON,TITLE,PROPN-PROPN,NOUN,compound-nsubj,compound,NNP-NNP,NN,1,1
1338,9479.0,20,presented,6,3,2,-1,2,17,3,-4,Youssoufou Bamba,diplomat,PERSON-PERSON,TITLE,PROPN-PROPN,NOUN,compound-nsubj,compound,NNP-NNP,NN,1,1
1339,10297.0,37,says,9,8,7,-1,7,29,1,-2,Youssoufou Bamba,diplomat,PERSON-PERSON,TITLE,PROPN-PROPN,NOUN,compound-nsubj,compound,NNP-NNP,NN,3,1
1340,10385.0,32,says,4,3,2,-1,2,29,1,-2,Youssoufou Bamba,diplomat,PERSON-PERSON,TITLE,PROPN-PROPN,NOUN,compound-nsubj,compound,NNP-NNP,NN,1,1
1341,2903.0,40,appealed,8,14,18,4,13,21,-6,10,Asia Bibi,45-year-old,PERSON-PERSON,NUMBER,PROPN-PROPN,ADJ,compound-pobj,amod,NNP-NNP,JJ,3,1
1342,2909.0,21,tours,4,6,8,2,5,12,-2,4,his,Pittsburgh,PERSON,CITY,DET,PROPN,poss,compound,PRP$,NNP,2,1
1343,2918.0,46,says,29,12,3,-9,11,42,17,-26,Kunstler,33-year-old,PERSON,NUMBER,PROPN,NUM,appos,amod,NNP,CD,7,1
1344,2920.0,47,said,1,8,42,34,7,4,-7,41,his,Public Security Bureau,PERSON,ORGANIZATION-ORGANIZATION-ORGANIZATION,DET,PROPN-PROPN-PROPN,poss,compound-compound-pobj,PRP$,NNP-NNP-NNP,10,1
1345,2934.0,42,charged,3,7,18,11,6,23,-4,15,Annie Mae Aquash,South Dakota,PERSON-PERSON-PERSON,STATE_OR_PROVINCE-STATE_OR_PROVINCE,PROPN-PROPN-PROPN,PROPN-PROPN,compound-compound-dobj,compound-poss,NNP-NNP-NNP,NNP-NNP,7,1
1346,4185.0,36,recounted,6,26,1,-25,25,34,-20,-5,Annie Mae Aquash,South Dakota,PERSON-PERSON-PERSON,STATE_OR_PROVINCE-STATE_OR_PROVINCE,PROPN-PROPN-PROPN,PROPN-PROPN,compound-compound-pobj,compound-compound,NNP-NNP-NNP,NNP-NNP,8,1
1347,7725.0,40,testified,8,19,34,15,18,5,-11,26,Annie Mae Aquash,South Dakota,PERSON-PERSON-PERSON,STATE_OR_PROVINCE-STATE_OR_PROVINCE,PROPN-PROPN-PROPN,PROPN-PROPN,compound-compound-dobj,compound-poss,NNP-NNP-NNP,NNP-NNP,7,1
1348,2935.0,28,say,1,18,15,-3,17,12,-17,14,his,Finland,PERSON,COUNTRY,DET,PROPN,poss,pobj,PRP$,NNP,4,1
1349,2942.0,33,In,0,6,19,13,5,13,-6,19,National Urban League,Florida,ORGANIZATION-ORGANIZATION-ORGANIZATION,STATE_OR_PROVINCE,PROPN-PROPN-PROPN,PROPN,compound-compound-nsubj,appos,NNP-NNP-NNP,NNP,6,1
1350,2944.0,45,said,4,28,42,14,27,2,-24,38,his,Enzo,PERSON,PERSON,DET,PROPN,poss,appos,PRP$,NNP,3,1
1351,13729.0,45,said,4,28,42,14,27,2,-24,38,his,Enzo,PERSON,PERSON,DET,PROPN,poss,appos,PRP$,NNP,3,1
1352,14780.0,44,said,4,28,41,13,27,2,-24,37,his,Enzo,PERSON,PERSON,DET,PROPN,poss,conj,PRP$,NNP,3,1
1353,2947.0,31,is,4,10,8,-2,9,22,-6,4,Matteo Messina Denaro,mobster,PERSON-PERSON-PERSON,TITLE,PROPN-PROPN-PROPN,NOUN,compound-compound-appos,attr,NNP-NNP-NNP,NN,3,1
1354,14544.0,33,said,31,15,13,-2,14,19,16,-18,Matteo Messina Denaro,mobster,PERSON-PERSON-PERSON,TITLE,PROPN-PROPN-PROPN,NOUN,compound-compound-appos,pobj,NNP-NNP-NNP,NN,3,1
1355,2950.0,28,jumped,17,2,1,-1,1,26,15,-16,Joseph Cerniglia,Chef,PERSON-PERSON,TITLE,PROPN-PROPN,PROPN,compound-nsubj,compound,NNP-NNP,NNP,1,1
1356,2960.0,20,urged,6,4,3,-1,3,16,2,-3,Shah Abdul Aziz,MP,PERSON-PERSON-PERSON,TITLE,PROPN-PROPN-PROPN,PROPN,compound-compound-nsubj,compound,NNP-NNP-NNP,NNP,2,1
1357,2968.0,50,says,5,1,4,3,0,45,4,-1,Jones,23,PERSON,NUMBER,PROPN,NUM,nsubj,appos,NNP,CD,4,1
1358,2970.0,21,testified,1,1,15,14,0,5,0,14,Piedra,Tufts University School of Dental Medicine,PERSON,ORGANIZATION-ORGANIZATION-ORGANIZATION-ORGANIZATION-ORGANIZATION-ORGANIZATION,PROPN,PROPN-PROPN-PROPN-ADP-PROPN-PROPN,nsubj,compound-compound-pobj-prep-compound-pobj,NNP,NNP-NNP-NNP-IN-NNP-NNP,8,1
1359,2973.0,43,was,5,1,12,11,0,30,4,7,Assaf Ramon,Ilan Ramon,PERSON-PERSON,PERSON-PERSON,PROPN-PROPN,PROPN-PROPN,compound-nsubj,compound-pobj,NNP-NNP,NNP-NNP,4,1
1360,3521.0,59,SON,0,13,25,12,12,33,-13,25,Assaf Ramon,Ilan Ramon,PERSON-PERSON,PERSON-PERSON,PROPN-PROPN,PROPN-PROPN,compound-nsubjpass,compound-appos,NNP-NNP,NNP-NNP,1,1
1361,14155.0,35,named,2,8,18,10,7,16,-6,16,Assaf Ramon,Ilan Ramon,PERSON-PERSON,PERSON-PERSON,PROPN-PROPN,PROPN-PROPN,compound-pobj,compound-pobj,NNP-NNP,NNP-NNP,3,1
1362,2977.0,25,said,14,3,7,4,2,17,11,-7,National Urban League,Orlando,ORGANIZATION-ORGANIZATION-ORGANIZATION,CITY,PROPN-PROPN-PROPN,PROPN,compound-compound-dobj,pobj,NNP-NNP-NNP,NNP,4,1
1363,2978.0,19,is,7,1,6,5,0,12,6,-1,The Federation,1994,ORGANIZATION-ORGANIZATION,DATE,DET-PROPN,NUM,det-nsubj,pobj,DT-NNP,CD,2,1
1364,2987.0,31,ordered,5,7,13,6,6,17,-2,8,Amanda Knox,slander,PERSON-PERSON,CRIMINAL_CHARGE,PROPN-PROPN,NOUN,compound-dobj,amod,NNP-NNP,NN,4,1
1365,4893.0,36,reported,34,1,23,22,0,12,33,-11,Amanda Knox,slander,PERSON-PERSON,CRIMINAL_CHARGE,PROPN-PROPN,NOUN,compound-nsubjpass,pobj,NNP-NNP,NN,4,1
1366,8101.0,48,WASHINGTON,3,13,35,22,12,12,-10,32,Amanda Knox,slander,PERSON-PERSON,CRIMINAL_CHARGE,PROPN-PROPN,NOUN,compound-nsubjpass,pobj,NNP-NNP,NN,-1,1
1367,9558.0,27,indicted,6,3,9,6,2,17,3,3,Amanda Knox,slander,PERSON-PERSON,CRIMINAL_CHARGE,PROPN-PROPN,NOUN,compound-nsubjpass,amod,NNP-NNP,NN,3,1
1368,3007.0,18,awarded,5,10,4,-6,9,13,-5,-1,China Charity Federation,she,ORGANIZATION-ORGANIZATION-ORGANIZATION,PERSON,PROPN-PROPN-PROPN,PRON,compound-compound-pobj,nsubjpass,NNP-NNP-NNP,PRP,5,1
1369,3009.0,11,was,1,1,7,6,0,3,0,6,Lange,California Institute of Technology,PERSON,ORGANIZATION-ORGANIZATION-ORGANIZATION-ORGANIZATION,PROPN,PROPN-PROPN-ADP-PROPN,nsubj,compound-pobj-prep-pobj,NNP,NNP-NNP-IN-NNP,3,1
1370,3010.0,34,lost,1,11,20,9,10,13,-10,19,Frank Baldino Jr,chief executive officer,PERSON-PERSON-PERSON,TITLE-TITLE-TITLE,PROPN-PROPN-PROPN,ADJ-ADJ-NOUN,compound-compound-dobj,amod-amod-conj,NNP-NNP-NNP,JJ-JJ-NN,4,1
1371,3014.0,38,said,4,10,1,-9,9,36,-6,-3,Eugenio Vagni,Defense,PERSON-PERSON,ORGANIZATION,PROPN-PROPN,PROPN,compound-pobj,compound,NNP-NNP,NNP,8,1
1372,3020.0,28,went,5,27,9,-18,26,18,-22,4,his,Rio,PERSON,LOCATION,DET,PROPN,attr,pobj,PRP$,NNP,3,1
1373,3024.0,32,said,1,3,16,13,2,15,-2,15,Aziz,parliament 's lower house,PERSON,ORGANIZATION-ORGANIZATION-ORGANIZATION-ORGANIZATION,PROPN,NOUN-PART-ADJ-NOUN,nsubjpass,poss-case-amod-pobj,NNP,NN-POS-JJR-NN,6,1
1374,3025.0,35,President,0,5,7,2,4,27,-5,7,PATA,Pacific Asia Travel Association,ORGANIZATION,ORGANIZATION-ORGANIZATION-ORGANIZATION-ORGANIZATION,PROPN,PROPN-PROPN-PROPN-PROPN,compound,compound-compound-compound-pobj,NNP,NNP-NNP-NNP-NNP,-1,1
1375,4037.0,38,percent,1,14,12,-2,13,25,-13,11,PATA,Pacific Asia Travel Association,ORGANIZATION,ORGANIZATION-ORGANIZATION-ORGANIZATION-ORGANIZATION,PROPN,PROPN-PROPN-PROPN-PROPN,conj,compound-compound-compound-appos,NNP,NNP-NNP-NNP-NNP,2,1
1376,4681.0,41,PATA,22,23,18,-5,22,22,-1,-4,PATA,Pacific Asia Travel Association,ORGANIZATION,ORGANIZATION-ORGANIZATION-ORGANIZATION-ORGANIZATION,PROPN,PROPN-PROPN-PROPN-PROPN,ROOT,compound-compound-compound-pobj,NNP,NNP-NNP-NNP-NNP,-1,1
1377,5825.0,30,said,16,14,9,-5,13,20,2,-7,PATA,Pacific Asia Travel Association,ORGANIZATION,ORGANIZATION-ORGANIZATION-ORGANIZATION-ORGANIZATION,PROPN,PROPN-PROPN-PROPN-PROPN,compound,compound-compound-compound-pobj,NNP,NNP-NNP-NNP-NNP,5,1
1378,9045.0,36,told,22,31,26,-5,30,9,-9,4,PATA,Pacific Asia Travel Association,ORGANIZATION,ORGANIZATION-ORGANIZATION-ORGANIZATION-ORGANIZATION,PROPN,PROPN-PROPN-PROPN-PROPN,compound,compound-compound-compound-dobj,NNP,NNP-NNP-NNP-NNP,5,1
1379,9159.0,39,said,37,36,31,-5,35,7,1,-6,PATA,Pacific Asia Travel Association,ORGANIZATION,ORGANIZATION-ORGANIZATION-ORGANIZATION-ORGANIZATION,PROPN,PROPN-PROPN-PROPN-PROPN,compound,compound-compound-compound-appos,NNP,NNP-NNP-NNP-NNP,-1,1
1380,9755.0,61,continue,2,45,40,-5,44,20,-43,38,PATA,Pacific Asia Travel Association,ORGANIZATION,ORGANIZATION-ORGANIZATION-ORGANIZATION-ORGANIZATION,PROPN,PROPN-PROPN-PROPN-PROPN,compound,compound-compound-compound-appos,NNP,NNP-NNP-NNP-NNP,-1,1
1381,10087.0,22,came,2,11,6,-5,10,15,-9,4,PATA,Pacific Asia Travel Association,ORGANIZATION,ORGANIZATION-ORGANIZATION-ORGANIZATION-ORGANIZATION,PROPN,PROPN-PROPN-PROPN-PROPN,compound,compound-compound-compound-pobj,NNP,NNP-NNP-NNP-NNP,-1,1
1382,11648.0,38,surveyed,16,15,10,-5,14,27,1,-6,PATA,Pacific Asia Travel Association,ORGANIZATION,ORGANIZATION-ORGANIZATION-ORGANIZATION-ORGANIZATION,PROPN,PROPN-PROPN-PROPN-PROPN,compound,compound-compound-compound-conj,NNP,NNP-NNP-NNP-NNP,-1,1
1383,12041.0,43,enhanced,3,26,21,-5,25,21,-23,18,PATA,Pacific Asia Travel Association,ORGANIZATION,ORGANIZATION-ORGANIZATION-ORGANIZATION-ORGANIZATION,PROPN,PROPN-PROPN-PROPN-PROPN,ccomp,compound-compound-compound-conj,NNP,NNP-NNP-NNP-NNP,-1,1
1384,14382.0,49,identified,19,13,8,-5,12,40,6,-11,PATA,Pacific Asia Travel Association,ORGANIZATION,ORGANIZATION-ORGANIZATION-ORGANIZATION-ORGANIZATION,PROPN,PROPN-PROPN-PROPN-PROPN,compound,compound-compound-compound-pobj,NNP,NNP-NNP-NNP-NNP,5,1
1385,3030.0,37,working,11,1,7,6,0,29,10,-4,Gross,Potomac,PERSON,CITY,PROPN,PROPN,nsubj,pobj,NNP,NNP,3,1
1386,4191.0,26,working,10,1,6,5,0,19,9,-4,Gross,Potomac,PERSON,CITY,PROPN,PROPN,nsubj,pobj,NNP,NNP,5,1
1387,7197.0,32,------,0,2,7,5,1,24,-2,7,Gross,Potomac,PERSON,CITY,PROPN,PROPN,nsubj,pobj,NNP,NNP,5,1
1388,3035.0,34,lost,1,11,20,9,10,13,-10,19,Frank Baldino Jr.,chief executive officer,PERSON-PERSON-PERSON,TITLE-TITLE-TITLE,PROPN-PROPN-PROPN,ADJ-ADJ-NOUN,compound-compound-nsubj,amod-amod-conj,NNP-NNP-NNP,JJ-JJ-NN,4,1
1389,3050.0,45,said,4,28,35,7,27,9,-24,31,his,Patrick,PERSON,PERSON,DET,PROPN,poss,appos,PRP$,NNP,2,1
1390,3055.0,38,stands,17,9,12,3,8,25,8,-5,Menil Collection,Josef Helfenstein,ORGANIZATION-ORGANIZATION,PERSON-PERSON,PROPN-PROPN,PROPN-PROPN,compound-compound,compound-nsubj,NNP-NNP,NNP-NNP,4,1
1391,12117.0,20,said,12,17,14,-3,16,5,-5,2,Menil Collection,Josef Helfenstein,ORGANIZATION-ORGANIZATION,PERSON-PERSON,PROPN-PROPN,PROPN-PROPN,compound-compound,compound-nsubj,NNP-NNP,NNP-NNP,4,1
1392,3056.0,32,included,11,13,15,2,12,16,-2,4,his,Zhou Xiaoya,PERSON,PERSON-PERSON,DET,PROPN-PROPN,poss,compound-appos,PRP$,NNP-NNP,1,1
1393,3585.0,47,said,1,8,24,16,7,22,-7,23,his,Zhou Xiaoya,PERSON,PERSON-PERSON,DET,PROPN-PROPN,poss,compound-appos,PRP$,NNP-NNP,7,1
1394,6562.0,42,accused,10,5,7,2,4,34,5,-3,his,Zhou Xiaoya,PERSON,PERSON-PERSON,DET,PROPN-PROPN,poss,compound-appos,PRP$,NNP-NNP,1,1
1395,12646.0,29,tried,2,5,8,3,4,20,-3,6,his,Zhou Xiaoya,PERSON,PERSON-PERSON,DET,PROPN-PROPN,poss,compound-appos,PRP$,NNP-NNP,1,1
1396,15155.0,26,tried,2,5,8,3,4,17,-3,6,his,Zhou Xiaoya,PERSON,PERSON-PERSON,DET,PROPN-PROPN,poss,compound-appos,PRP$,NNP-NNP,1,1
1397,3068.0,19,shaking,6,1,13,12,0,5,5,7,Knox,Cassandra Knox,PERSON,PERSON-PERSON,PROPN,PROPN-PROPN,poss,compound-appos,NNP,NNP-NNP,6,1
1398,3077.0,34,detained,3,19,1,-18,18,32,-16,-2,Xie Caiping,Wen Qiang,PERSON-PERSON,PERSON-PERSON,PROPN-PROPN,PROPN-PROPN,compound-npadvmod,compound-nsubjpass,NNP-NNP,NNP-NNP,10,1
1399,3082.0,27,filed,4,17,17,0,16,9,-13,13,her,her,PERSON,PERSON,PRON,PRON,dobj,dobj,PRP,PRP,0,1
1400,9057.0,33,charged,1,16,16,0,15,16,-15,15,her,her,PERSON,PERSON,PRON,PRON,dobj,dobj,PRP,PRP,0,1
1401,3085.0,48,said,5,34,39,5,33,8,-29,34,Eugenio Vagni,engineer,PERSON-PERSON,TITLE,PROPN-PROPN,NOUN,compound-pobj,appos,NNP-NNP,NN,3,1
1402,5961.0,14,released,10,7,6,-1,6,7,3,-4,Eugenio Vagni,engineer,PERSON-PERSON,TITLE,PROPN-PROPN,NOUN,compound-appos,compound,NNP-NNP,NN,1,1
1403,3091.0,37,said,13,8,16,8,7,20,5,3,National Congress of American Indians,"Washington , DC-based",ORGANIZATION-ORGANIZATION-ORGANIZATION-ORGANIZATION-ORGANIZATION,STATE_OR_PROVINCE-STATE_OR_PROVINCE-STATE_OR_PROVINCE,PROPN-PROPN-ADP-PROPN-PROPN,PROPN-PUNCT-PROPN,compound-pobj-prep-compound-pobj,nsubj-punct-det,NNP-NNP-IN-NNP-NNPS,"NNP-,-NNP",8,1
1404,3092.0,24,upheld,10,18,6,-12,17,17,-8,-4,Xie Caiping,China,PERSON-PERSON,COUNTRY,PROPN-PROPN,PROPN,compound-pobj,poss,NNP-NNP,NNP,8,1
1405,12083.0,37,CHONGQING,0,12,25,13,11,11,-12,25,Xie Caiping,China,PERSON-PERSON,COUNTRY,PROPN-PROPN,PROPN,compound-appos,poss,NNP-NNP,NNP,5,1
1406,3100.0,18,died,14,1,10,9,0,7,13,-4,Tamaihia,Sacramento,PERSON,CITY,PROPN,PROPN,nsubj,compound,NNP,NNP,4,1
1407,14420.0,23,*,0,6,15,9,5,7,-6,15,Tamaihia,Sacramento,PERSON,CITY,PROPN,PROPN,pobj,compound,NNP,NNP,4,1
1408,3104.0,28,survived,3,1,12,11,0,15,2,9,He,Karen Lange,PERSON,PERSON-PERSON,PRON,PROPN-PROPN,nsubjpass,compound-appos,PRP,NNP-NNP,5,1
1409,3105.0,24,gave,9,17,4,-13,16,19,-8,-5,his,United Nations,PERSON,ORGANIZATION-ORGANIZATION,DET,PROPN-PROPN,poss,compound-compound,PRP$,NNP-NNP,5,1
1410,4760.0,31,gave,12,21,8,-13,20,22,-9,-4,his,United Nations,PERSON,ORGANIZATION-ORGANIZATION,DET,PROPN-PROPN,poss,compound-compound,PRP$,NNP-NNP,5,1
1411,3121.0,41,is,5,21,12,-9,20,28,-16,7,her,Cuba,PERSON,COUNTRY,DET,PROPN,poss,pobj,PRP$,NNP,4,1
1412,3122.0,30,teaches,16,1,7,6,0,22,15,-9,Wayne A. Holst,Ontario,PERSON-PERSON-PERSON,STATE_OR_PROVINCE,PROPN-PROPN-PROPN,PROPN,compound-compound-nsubj,pobj,NNP-NNP-NNP,NNP,4,1
1413,3130.0,17,predicted,14,12,6,-6,11,10,2,-8,National Restaurant Association,Mike Gibbons,ORGANIZATION-ORGANIZATION-ORGANIZATION,PERSON-PERSON,PROPN-PROPN-PROPN,PROPN-PROPN,compound-compound-pobj,compound-nsubj,NNP-NNP-NNP,NNP-NNP,4,1
1414,3144.0,42,born,4,1,41,40,0,0,3,37,Andrew E Lange,Conn,PERSON-PERSON-PERSON,STATE_OR_PROVINCE,PROPN-PROPN-PROPN,PROPN,compound-compound-nsubjpass,appos,NNP-NNP-NNP,NNP,3,1
1415,3153.0,30,arrested,2,1,27,26,0,2,1,25,He,Northwest Frontier Province,PERSON,LOCATION-LOCATION-LOCATION,PRON,PROPN-PROPN-PROPN,nsubjpass,compound-compound-pobj,PRP,NNP-NNP-NNP,6,1
1416,3157.0,41,said,23,30,36,6,29,4,-7,13,TPI,Texas,ORGANIZATION,STATE_OR_PROVINCE,PROPN,PROPN,pobj,pobj,NNP,NNP,4,1
1417,3162.0,48,said,12,1,11,10,0,36,11,-1,Youssoufou Bamba,envoy,PERSON-PERSON,TITLE,PROPN-PROPN,NOUN,compound-nsubj,appos,NNP-NNP,NN,2,1
1418,9185.0,27,made,6,4,2,-2,3,24,2,-4,Youssoufou Bamba,envoy,PERSON-PERSON,TITLE,PROPN-PROPN,NOUN,compound-appos,pobj,NNP-NNP,NN,2,1
1419,9516.0,45,said,13,11,9,-2,10,35,2,-4,Youssoufou Bamba,envoy,PERSON-PERSON,TITLE,PROPN-PROPN,NOUN,compound-appos,nsubj,NNP-NNP,NN,2,1
1420,10614.0,20,presented,6,3,14,11,2,5,3,8,Youssoufou Bamba,envoy,PERSON-PERSON,TITLE,PROPN-PROPN,NOUN,compound-nsubj,pobj,NNP-NNP,NN,6,1
1421,3169.0,25,sparked,14,7,11,4,6,13,7,-3,Knox,Seattle,PERSON,CITY,PROPN,PROPN,poss,pobj,NNP,NNP,5,1
1422,3884.0,17,sparked,3,10,14,4,9,2,-7,11,Knox,Seattle,PERSON,CITY,PROPN,PROPN,poss,pobj,NNP,NNP,5,1
1423,6067.0,27,is,16,9,15,6,8,11,7,-1,Knox,Seattle,PERSON,CITY,PROPN,PROPN,pobj,pobj,NNP,NNP,4,1
1424,7180.0,31,convicted,8,1,6,5,0,24,7,-2,Knox,Seattle,PERSON,CITY,PROPN,PROPN,nsubjpass,pobj,NNP,NNP,3,1
1425,12014.0,44,convicted,21,12,17,5,11,26,9,-4,Knox,Seattle,PERSON,CITY,PROPN,PROPN,dobj,pobj,NNP,NNP,2,1
1426,12950.0,21,hopes,16,7,14,7,6,6,9,-2,Knox,Seattle,PERSON,CITY,PROPN,PROPN,poss,pobj,NNP,NNP,4,1
1427,13108.0,35,was,8,1,7,6,0,27,7,-1,Knox,Seattle,PERSON,CITY,PROPN,PROPN,nsubj,pobj,NNP,NNP,3,1
1428,14640.0,26,was,7,25,23,-2,24,2,-18,16,Knox,Seattle,PERSON,CITY,PROPN,PROPN,pobj,nmod,NNP,NNP,2,1
1429,3170.0,40,Beijing,0,14,30,16,13,9,-14,30,Wen,raping,PERSON,CRIMINAL_CHARGE,PROPN,VERB,nsubjpass,conj,NNP,VBG,6,1
1430,3181.0,41,says,39,9,15,6,8,25,30,-24,Michael Lomax,Fulton County Commission,PERSON-PERSON,ORGANIZATION-ORGANIZATION-ORGANIZATION,PROPN-PROPN,PROPN-PROPN-PROPN,compound-pobj,compound-compound-pobj,NNP-NNP,NNP-NNP-NNP,5,1
1431,3182.0,34,said,13,5,11,6,4,22,8,-2,National Restaurant Association,Dawn Sweeney,ORGANIZATION-ORGANIZATION-ORGANIZATION,PERSON-PERSON,PROPN-PROPN-PROPN,PROPN-PROPN,compound-compound-poss,compound-appos,NNP-NNP-NNP,NNP-NNP,3,1
1432,3192.0,46,Ld-Writethru,1,14,17,3,13,28,-13,16,Wen,Zhou Xiaoya,PERSON,PERSON-PERSON,PROPN,PROPN-PROPN,poss,compound-appos,NNP,NNP-NNP,1,1
1433,4699.0,26,tried,2,1,8,7,0,17,1,6,Wen,Zhou Xiaoya,PERSON,PERSON-PERSON,PROPN,PROPN-PROPN,nsubjpass,compound-appos,NNP,NNP-NNP,4,1
1434,4811.0,33,receive,23,1,4,3,0,28,22,-19,Wen,Zhou Xiaoya,PERSON,PERSON-PERSON,PROPN,PROPN-PROPN,poss,compound-appos,NNP,NNP-NNP,3,1
1435,4909.0,39,CHONGQING,0,8,11,3,7,27,-8,11,Wen,Zhou Xiaoya,PERSON,PERSON-PERSON,PROPN,PROPN-PROPN,poss,compound-appos,NNP,NNP-NNP,3,1
1436,7819.0,29,tried,2,1,8,7,0,20,1,6,Wen,Zhou Xiaoya,PERSON,PERSON-PERSON,PROPN,PROPN-PROPN,nsubjpass,compound-appos,NNP,NNP-NNP,4,1
1437,10649.0,41,given,13,7,10,3,6,30,6,-3,Wen,Zhou Xiaoya,PERSON,PERSON-PERSON,PROPN,PROPN-PROPN,poss,compound-appos,NNP,NNP-NNP,3,1
1438,3196.0,38,kidnapped,6,22,4,-18,21,33,-16,-2,Patricia Gonzalez,attorney general,PERSON-PERSON,TITLE-TITLE,PROPN-PROPN,NOUN-NOUN,compound-appos,compound-pobj,NNP-NNP,NN-NN,4,1
1439,3561.0,37,kidnapped,6,21,4,-17,20,32,-15,-2,Patricia Gonzalez,attorney general,PERSON-PERSON,TITLE-TITLE,PROPN-PROPN,NOUN-NOUN,compound-appos,compound-pobj,NNP-NNP,NN-NN,4,1
1440,4443.0,29,is,1,6,15,9,5,13,-5,14,Patricia Gonzalez,attorney general,PERSON-PERSON,TITLE-TITLE,PROPN-PROPN,NOUN-NOUN,compound-pobj,compound-pobj,NNP-NNP,NN-NN,5,1
1441,10275.0,39,describes,3,13,19,6,12,19,-10,16,Patricia Gonzalez,attorney general,PERSON-PERSON,TITLE-TITLE,PROPN-PROPN,NOUN-NOUN,compound-appos,compound-appos,NNP-NNP,NN-NN,5,1
1442,13762.0,29,said,16,18,24,6,17,4,-2,8,Patricia Gonzalez,attorney general,PERSON-PERSON,TITLE-TITLE,PROPN-PROPN,NOUN-NOUN,compound-nsubj,compound-pobj,NNP-NNP,NN-NN,6,1
1443,14618.0,23,is,1,6,15,9,5,7,-5,14,Patricia Gonzalez,attorney general,PERSON-PERSON,TITLE-TITLE,PROPN-PROPN,NOUN-NOUN,compound-pobj,compound-pobj,NNP-NNP,NN-NN,5,1
1444,3201.0,71,said,13,1,5,4,0,65,12,-8,Laura Silsby,director,PERSON-PERSON,TITLE,PROPN-PROPN,NOUN,compound-nsubj,appos,NNP-NNP,NN,2,1
1445,3202.0,45,died,34,1,29,28,0,15,33,-5,Norris Church Mailer,author,PERSON-PERSON-PERSON,TITLE,PROPN-PROPN-PROPN,NOUN,compound-compound-nsubj,conj,NNP-NNP-NNP,NN,7,1
1446,3204.0,67,said,48,62,56,-6,61,10,-14,8,National Development and Reform Commission,International Economic Research Institute,ORGANIZATION-ORGANIZATION-ORGANIZATION-ORGANIZATION-ORGANIZATION,ORGANIZATION-ORGANIZATION-ORGANIZATION-ORGANIZATION,PROPN-PROPN-CCONJ-PROPN-PROPN,PROPN-PROPN-PROPN-PROPN,nmod-nmod-cc-conj-pobj,compound-compound-compound-pobj,NNP-NNP-CC-NNP-NNP,NNP-NNP-NNP-NNP,5,1
1447,3207.0,24,Court,4,20,7,-13,19,16,-16,3,his,accepting bribes,PERSON,CRIMINAL_CHARGE-CRIMINAL_CHARGE,DET,VERB-NOUN,poss,pcomp-dobj,PRP$,VBG-NNS,10,1
1448,3208.0,16,arrested,7,5,11,6,4,4,2,4,Alan Gross,Havana,PERSON-PERSON,LOCATION,PROPN-PROPN,PROPN,compound-nsubjpass,compound,NNP-NNP,NNP,3,1
1449,3220.0,32,graduated,1,1,4,3,0,27,0,3,He,Princeton University,PERSON,ORGANIZATION-ORGANIZATION,PRON,PROPN-PROPN,nsubj,compound-pobj,PRP,NNP-NNP,2,1
1450,7443.0,28,attended,1,1,3,2,0,24,0,2,He,Princeton University,PERSON,ORGANIZATION-ORGANIZATION,PRON,PROPN-PROPN,nsubj,compound-dobj,PRP,NNP-NNP,1,1
1451,8449.0,32,graduated,1,1,4,3,0,27,0,3,He,Princeton University,PERSON,ORGANIZATION-ORGANIZATION,PRON,PROPN-PROPN,nsubj,compound-pobj,PRP,NNP-NNP,2,1
1452,3234.0,27,UTC,5,9,8,-1,8,18,-4,3,Silsby,40-year-old,PERSON,NUMBER,PROPN,NUM,nsubj,compound,NNP,CD,1,1
1453,3236.0,25,poised,1,6,13,7,5,11,-5,12,Central American Parliament,1991,ORGANIZATION-ORGANIZATION-ORGANIZATION,DATE,ADJ-PROPN-PROPN,NUM,amod-compound-compound,pobj,JJ-NNP-NNP,CD,7,1
1454,3237.0,12,Qiang,1,1,4,3,0,7,0,3,Wen Qiang,55,PERSON-PERSON,NUMBER,PROPN-PROPN,NUM,compound-ROOT,appos,NNP-NNP,CD,1,1
1455,8187.0,43,convicted,14,9,12,3,8,30,5,-2,Wen Qiang,55,PERSON-PERSON,NUMBER,PROPN-PROPN,NUM,compound-pobj,appos,NNP-NNP,CD,4,1
1456,9560.0,47,said,45,12,15,3,11,31,33,-30,Wen Qiang,55,PERSON-PERSON,NUMBER,PROPN-PROPN,NUM,compound-pobj,appos,NNP-NNP,CD,1,1
1457,9585.0,40,accused,16,1,4,3,0,35,15,-12,Wen Qiang,55,PERSON-PERSON,NUMBER,PROPN-PROPN,NUM,compound-nsubjpass,appos,NNP-NNP,CD,1,1
1458,10839.0,19,convicted,14,9,12,3,8,6,5,-2,Wen Qiang,55,PERSON-PERSON,NUMBER,PROPN-PROPN,NUM,compound-pobj,appos,NNP-NNP,CD,4,1
1459,3245.0,33,EXP-COUNTRYWIDE-FRAUD,0,22,10,-12,21,22,-22,10,Countrywide Financial,Angelo R Mozilo,ORGANIZATION-ORGANIZATION,PERSON-PERSON-PERSON,PROPN-PROPN,PROPN-PROPN-PROPN,compound-pobj,compound-compound-dobj,NNP-NNP,NNP-NNP-NNP,6,1
1460,8319.0,30,COUNTRYWIDE-MOZILO,0,13,6,-7,12,23,-13,6,Countrywide Financial,Angelo R Mozilo,ORGANIZATION-ORGANIZATION,PERSON-PERSON-PERSON,PROPN-PROPN,PROPN-PROPN-PROPN,compound-pobj,compound-compound-nsubj,NNP-NNP,NNP-NNP-NNP,-1,1
1461,12807.0,48,charged,29,13,1,-12,12,46,16,-28,Countrywide Financial,Angelo R Mozilo,ORGANIZATION-ORGANIZATION,PERSON-PERSON-PERSON,PROPN-PROPN,PROPN-PROPN-PROPN,compound-dobj,compound-compound-nsubjpass,NNP-NNP,NNP-NNP-NNP,3,1
1462,15053.0,43,agreed,20,10,1,-9,9,41,10,-19,Countrywide Financial,Angelo R Mozilo,ORGANIZATION-ORGANIZATION,PERSON-PERSON-PERSON,PROPN-PROPN,PROPN-PROPN-PROPN,compound-pobj,compound-compound-nsubj,NNP-NNP,NNP-NNP-NNP,4,1
1463,3246.0,41,been,8,29,15,-14,28,25,-21,7,Wen Qiang,China,PERSON-PERSON,COUNTRY,PROPN-PROPN,PROPN,compound-pobj,dobj,NNP-NNP,NNP,7,1
1464,9324.0,23,executed,4,6,1,-5,5,21,-2,-3,Wen Qiang,China,PERSON-PERSON,COUNTRY,PROPN-PROPN,PROPN,compound-dobj,nsubj,NNP-NNP,NNP,3,1
1465,13862.0,37,said,34,1,13,12,0,23,33,-21,Wen Qiang,China,PERSON-PERSON,COUNTRY,PROPN-PROPN,PROPN,compound-nsubjpass,poss,NNP-NNP,NNP,5,1
1466,15459.0,39,executed,12,14,5,-9,13,33,-2,-7,Wen Qiang,China,PERSON-PERSON,COUNTRY,PROPN-PROPN,PROPN,compound-dobj,nsubj,NNP-NNP,NNP,6,1
1467,3249.0,37,said,33,17,2,-15,16,34,16,-31,his,Dutch,PERSON,NATIONALITY,DET,ADJ,poss,amod,PRP$,JJ,6,1
1468,14838.0,30,said,5,16,2,-14,15,27,-11,-3,his,Dutch,PERSON,NATIONALITY,DET,ADJ,poss,amod,PRP$,JJ,4,1
1469,3254.0,34,said,32,25,18,-7,24,15,7,-14,ALICO,American Life Insurance Co,ORGANIZATION,ORGANIZATION-ORGANIZATION-ORGANIZATION-ORGANIZATION,PROPN,PROPN-PROPN-PROPN-PROPN,pobj,compound-compound-compound-appos,NNP,NNP-NNP-NNP-NNP,4,1
1470,7809.0,18,closed,1,14,8,-6,13,9,-13,7,ALICO,American Life Insurance Co,ORGANIZATION,ORGANIZATION-ORGANIZATION-ORGANIZATION-ORGANIZATION,PROPN,PROPN-PROPN-PROPN-PROPN,conj,compound-compound-compound-pobj,NNP,NNP-NNP-NNP-NNP,6,1
1471,13771.0,31,shedding,3,22,5,-17,21,25,-19,2,ALICO,American Life Insurance Co,ORGANIZATION,ORGANIZATION-ORGANIZATION-ORGANIZATION-ORGANIZATION,PROPN,PROPN-PROPN-PROPN-PROPN,pobj,compound-compound-compound-conj,NNP,NNP-NNP-NNP-NNP,4,1
1472,15057.0,42,said,32,18,13,-5,17,28,14,-19,ALICO,American Life Insurance Co,ORGANIZATION,ORGANIZATION-ORGANIZATION-ORGANIZATION-ORGANIZATION,PROPN,PROPN-PROPN-PROPN-PROPN,compound,compound-compound-compound-subtok,NNP,NNP-NNP-NNP-NNP,3,1
1473,3263.0,30,said,5,16,10,-6,15,19,-11,5,ALICO,American Life Insurance,ORGANIZATION,ORGANIZATION-ORGANIZATION-ORGANIZATION,PROPN,PROPN-PROPN-PROPN,pobj,compound-compound-dobj,NNP,NNP-NNP-NNP,3,1
1474,6827.0,31,come,2,20,14,-6,19,16,-18,12,ALICO,American Life Insurance,ORGANIZATION,ORGANIZATION-ORGANIZATION-ORGANIZATION,PROPN,PROPN-PROPN-PROPN,pobj,compound-compound-dobj,NNP,NNP-NNP-NNP,4,1
1475,3266.0,33,said,9,2,1,-1,1,31,7,-8,Hollister Inc,Kip Hollister,ORGANIZATION-ORGANIZATION,PERSON-PERSON,PROPN-PROPN,PROPN-PROPN,compound-pobj,compound-nsubj,NNP-NNP,NNP-NNP,1,1
1476,3274.0,23,reach,14,4,13,9,3,9,10,-1,National Restaurant Association,U.S.,ORGANIZATION-ORGANIZATION-ORGANIZATION,COUNTRY,PROPN-PROPN-PROPN,PROPN,compound-compound-pobj,pobj,NNP-NNP-NNP,NNP,5,1
1477,3287.0,40,said,11,13,22,9,12,17,-2,11,Alessi,William W. Backus Hospital,PERSON,ORGANIZATION-ORGANIZATION-ORGANIZATION-ORGANIZATION,PROPN,PROPN-PROPN-PROPN-PROPN,nsubj,compound-compound-compound-pobj,NNP,NNP-NNP-NNP-NNP,4,1
1478,3288.0,39,released,2,11,38,27,10,0,-9,36,Carol Daniels,Oklahoma,PERSON-PERSON,STATE_OR_PROVINCE,PROPN-PROPN,PROPN,compound-pobj,pobj,NNP-NNP,NNP,6,1
1479,3292.0,30,died,4,1,20,19,0,9,3,16,Vladimir Ladyzhenskiy,Heinola,PERSON-PERSON,CITY,PROPN-PROPN,PROPN,compound-nsubj,pobj,NNP-NNP,NNP,9,1
1480,3293.0,14,attended,10,4,7,3,3,6,6,-3,Central American Parliament,Gloria Guadalupe Oqueli,ORGANIZATION-ORGANIZATION-ORGANIZATION,PERSON-PERSON-PERSON,ADJ-PROPN-PROPN,PROPN-PROPN-PROPN,compound-compound-compound,compound-compound-pobj,JJ-NNP-NNP,NNP-NNP-NNP,2,1
1481,3300.0,44,said,42,16,18,2,15,25,26,-24,HKI,Kathy Spahn,ORGANIZATION,PERSON-PERSON,PROPN,PROPN-PROPN,compound,compound-pobj,NNP,NNP-NNP,1,1
1482,3305.0,28,wait,22,6,16,10,5,11,16,-6,Natalie Hagemo,Church of Scientology,PERSON-PERSON,ORGANIZATION-ORGANIZATION-ORGANIZATION,PROPN-PROPN,PROPN-ADP-PROPN,compound-nsubj,pobj-prep-pobj,NNP-NNP,NNP-IN-NNP,7,1
1483,3310.0,17,said,2,4,11,7,3,5,-2,9,he,Perugia,PERSON,CITY,PRON,PROPN,nsubj,pobj,PRP,NNP,1,1
1484,14528.0,12,said,2,4,11,7,3,0,-2,9,he,Perugia,PERSON,CITY,PRON,PROPN,nsubj,pobj,PRP,NNP,2,1
1485,3323.0,29,chosen,17,8,1,-7,7,27,9,-16,Dance Theatre of Harlem,Arthur Mitchell,ORGANIZATION-ORGANIZATION-ORGANIZATION-ORGANIZATION,PERSON-PERSON,PROPN-PROPN-ADP-PROPN,PROPN-PROPN,compound-pobj-prep-pobj,compound-nsubjpass,NNP-NNP-IN-NNP,NNP-NNP,4,1
1486,3324.0,34,told,29,1,11,10,0,22,28,-18,Ruben van Assouw,Tilburg,PERSON-PERSON-PERSON,CITY,PROPN-PROPN-PROPN,PROPN,compound-compound-nsubj,pobj,NNP-NNP-NNP,NNP,3,1
1487,3912.0,21,said,4,12,20,8,11,0,-8,16,Ruben van Assouw,Tilburg,PERSON-PERSON-PERSON,CITY,PROPN-PROPN-PROPN,PROPN,compound-compound-attr,pobj,NNP-NNP-NNP,NNP,5,1
1488,10340.0,50,Hague,1,21,27,6,20,22,-20,26,Ruben van Assouw,Tilburg,PERSON-PERSON-PERSON,CITY,PROPN-PROPN-PROPN,PROPN,compound-compound-pobj,pobj,NNP-NNP-NNP,NNP,5,1
1489,10362.0,44,said,4,10,14,4,9,29,-6,10,Ruben van Assouw,Tilburg,PERSON-PERSON-PERSON,CITY,PROPN-PROPN-PROPN,PROPN,compound-compound-attr,pobj,NNP-NNP-NNP,NNP,2,1
1490,10573.0,33,be,13,18,22,4,17,10,-5,9,Ruben van Assouw,Tilburg,PERSON-PERSON-PERSON,CITY,PROPN-PROPN-PROPN,PROPN,compound-compound-attr,pobj,NNP-NNP-NNP,NNP,2,1
1491,10618.0,53,said,13,19,23,4,18,29,-6,10,Ruben van Assouw,Tilburg,PERSON-PERSON-PERSON,CITY,PROPN-PROPN-PROPN,PROPN,compound-compound-attr,pobj,NNP-NNP-NNP,NNP,2,1
1492,12089.0,40,refused,2,37,19,-18,36,20,-35,17,Ruben van Assouw,Tilburg,PERSON-PERSON-PERSON,CITY,PROPN-PROPN-PROPN,PROPN,compound-compound-attr,pobj,NNP-NNP-NNP,NNP,6,1
1493,12370.0,43,taken,31,13,15,2,12,27,18,-16,Ruben van Assouw,Tilburg,PERSON-PERSON-PERSON,CITY,PROPN-PROPN-PROPN,PROPN,compound-compound-nsubjpass,pobj,NNP-NNP-NNP,NNP,2,1
1494,13631.0,45,said,4,10,14,4,9,30,-6,10,Ruben van Assouw,Tilburg,PERSON-PERSON-PERSON,CITY,PROPN-PROPN-PROPN,PROPN,compound-compound-attr,pobj,NNP-NNP-NNP,NNP,2,1
1495,3331.0,40,trying,17,12,1,-11,11,38,5,-16,Progressive Democrats of America,Marcy Winograd,ORGANIZATION-ORGANIZATION-ORGANIZATION-ORGANIZATION,PERSON-PERSON,PROPN-PROPN-ADP-PROPN,PROPN-PROPN,compound-pobj-prep-pobj,compound-nsubj,NNP-NNPS-IN-NNP,NNP-NNP,4,1
1496,3332.0,34,appealed,20,4,20,16,3,13,16,0,Meredith Kercher,Monday,PERSON-PERSON,DATE,PROPN-PROPN,PROPN,compound-pobj,pobj,NNP-NNP,NNP,3,1
1497,3341.0,36,said,34,34,21,-13,33,14,0,-13,she,he,PERSON,PERSON,PRON,PRON,nsubj,nsubjpass,PRP,PRP,8,1
1498,3345.0,40,undermining,13,28,37,9,27,2,-15,24,Ahmed Rashid,BBC News,PERSON-PERSON,ORGANIZATION-ORGANIZATION,PROPN-PROPN,PROPN-PROPN,compound-nsubj,compound-compound,NNP-NNP,NNP-NNP,6,1
1499,3359.0,28,told,6,1,5,4,0,22,5,-1,Vagni,Francesco,PERSON,PERSON,PROPN,PROPN,poss,appos,NNP,NNP,4,1
1500,4778.0,25,told,6,1,5,4,0,19,5,-1,Vagni,Francesco,PERSON,PERSON,PROPN,PROPN,poss,appos,NNP,NNP,4,1
1501,9284.0,33,told,14,9,13,4,8,19,5,-1,Vagni,Francesco,PERSON,PERSON,PROPN,PROPN,poss,appos,NNP,NNP,4,1
1502,12485.0,35,told,16,11,15,4,10,19,5,-1,Vagni,Francesco,PERSON,PERSON,PROPN,PROPN,poss,appos,NNP,NNP,4,1
1503,3361.0,64,Oscar,0,22,13,-9,21,50,-22,13,Mark Fisher,executive producer,PERSON-PERSON,TITLE-TITLE,PROPN-PROPN,ADJ-NOUN,compound-pobj,amod-pobj,NNP-NNP,JJ-NN,1,1
1504,4606.0,64,Oscar,0,22,13,-9,21,50,-22,13,Mark Fisher,executive producer,PERSON-PERSON,TITLE-TITLE,PROPN-PROPN,ADJ-NOUN,compound-pobj,amod-pobj,NNP-NNP,JJ-NN,1,1
1505,8163.0,64,Oscar,0,22,13,-9,21,50,-22,13,Mark Fisher,executive producer,PERSON-PERSON,TITLE-TITLE,PROPN-PROPN,ADJ-NOUN,compound-pobj,amod-nsubj,NNP-NNP,JJ-NN,1,1
1506,3365.0,44,'s,2,38,43,5,37,0,-36,41,Menil Collection,Texas,ORGANIZATION-ORGANIZATION,STATE_OR_PROVINCE,PROPN-PROPN,PROPN,compound-conj,appos,NNP-NNP,NNP,4,1
1507,3368.0,26,profiled,11,24,22,-2,23,3,-13,11,Sarah Kunstler,Emily,PERSON-PERSON,PERSON,PROPN-PROPN,PROPN,compound-conj,appos,NNP-NNP,NNP,2,1
1508,6012.0,27,says,15,17,7,-10,16,19,-2,-8,Sarah Kunstler,Emily,PERSON-PERSON,PERSON,PROPN-PROPN,PROPN,compound-nsubj,nsubj,NNP-NNP,NNP,5,1
1509,6227.0,50,explore,14,13,11,-2,12,38,1,-3,Sarah Kunstler,Emily,PERSON-PERSON,PERSON,PROPN-PROPN,PROPN,compound-conj,appos,NNP-NNP,NNP,2,1
1510,7669.0,16,according,3,14,12,-2,13,3,-11,9,Sarah Kunstler,Emily,PERSON-PERSON,PERSON,PROPN-PROPN,PROPN,compound-conj,advmod,NNP-NNP,NNP,2,1
1511,10689.0,33,was,12,1,11,10,0,21,11,-1,Sarah Kunstler,Emily,PERSON-PERSON,PERSON,PROPN-PROPN,PROPN,compound-nsubj,npadvmod,NNP-NNP,NNP,3,1
1512,11388.0,54,explore,18,17,15,-2,16,38,1,-3,Sarah Kunstler,Emily,PERSON-PERSON,PERSON,PROPN-PROPN,PROPN,compound-conj,appos,NNP-NNP,NNP,2,1
1513,3369.0,38,-LRB-,0,7,10,3,6,27,-7,10,Eloise Spooner,82,PERSON-PERSON,NUMBER,PROPN-PROPN,NUM,compound-appos,appos,NNP-NNP,CD,-1,1
1514,3624.0,22,said,9,11,14,3,10,7,-2,5,Eloise Spooner,82,PERSON-PERSON,NUMBER,PROPN-PROPN,NUM,compound-nsubj,appos,NNP-NNP,CD,2,1
1515,4074.0,32,awoke,5,1,4,3,0,27,4,-1,Eloise Spooner,82,PERSON-PERSON,NUMBER,PROPN-PROPN,NUM,compound-nsubj,appos,NNP-NNP,CD,2,1
1516,7769.0,31,'m,16,21,24,3,20,6,-5,8,Eloise Spooner,82,PERSON-PERSON,NUMBER,PROPN-PROPN,NUM,compound-nsubj,appos,NNP-NNP,CD,4,1
1517,3378.0,27,owned,1,1,8,7,0,18,0,7,Cerniglia,New Jersey,PERSON,STATE_OR_PROVINCE-STATE_OR_PROVINCE,PROPN,PROPN-PROPN,nsubj,compound-appos,NNP,NNP-NNP,3,1
1518,3592.0,10,owned,1,1,8,7,0,1,0,7,Cerniglia,New Jersey,PERSON,STATE_OR_PROVINCE-STATE_OR_PROVINCE,PROPN,PROPN-PROPN,nsubj,compound-appos,NNP,NNP-NNP,3,1
1519,3381.0,27,-LRB-,1,10,14,4,9,12,-9,13,Rashid,journalist,PERSON,TITLE,PROPN,NOUN,pobj,appos,NNP,NN,4,1
1520,3393.0,37,said,34,23,16,-7,22,20,11,-18,National Energy Administration,Shi Lishan,ORGANIZATION-ORGANIZATION-ORGANIZATION,PERSON-PERSON,PROPN-PROPN-PROPN,PROPN-PROPN,compound-compound-poss,compound-nsubj,NNP-NNP-NNP,NNP-NNP,5,1
1521,6881.0,43,made,16,13,1,-12,12,41,3,-15,National Energy Administration,Shi Lishan,ORGANIZATION-ORGANIZATION-ORGANIZATION,PERSON-PERSON,PROPN-PROPN-PROPN,PROPN-PROPN,compound-compound-pobj,compound-nsubj,NNP-NNP-NNP,NNP-NNP,6,1
1522,3398.0,29,wrote,1,4,8,4,3,20,-3,7,Knox,Kurt Knox,PERSON,PERSON-PERSON,PROPN,PROPN-PROPN,poss,compound-appos,NNP,NNP-NNP,3,1
1523,3404.0,24,said,7,1,6,5,0,17,6,-1,Bibi,Sidra,PERSON,PERSON,PROPN,PROPN,poss,appos,NNP,NNP,3,1
1524,3412.0,34,wrote,1,23,21,-2,22,12,-22,20,National Urban League,New York-based,ORGANIZATION-ORGANIZATION-ORGANIZATION,STATE_OR_PROVINCE-STATE_OR_PROVINCE,PROPN-PROPN-PROPN,PROPN-PROPN,compound-compound-pobj,compound-compound,NNP-NNP-NNP,NNP-NNP,3,1
1525,3414.0,26,sentenced,9,4,7,3,3,18,5,-2,Wen,Xie Caiping,PERSON,PERSON-PERSON,PROPN,PROPN-PROPN,poss,compound-nsubjpass,NNP,NNP-NNP,3,1
1526,3418.0,34,played,3,22,29,7,21,4,-19,26,Assaf Ramon,pilot,PERSON-PERSON,TITLE,PROPN-PROPN,NOUN,compound-pobj,compound,NNP-NNP,NN,3,1
1527,6469.0,32,named,2,8,5,-3,7,26,-6,3,Assaf Ramon,pilot,PERSON-PERSON,TITLE,PROPN-PROPN,NOUN,compound-pobj,dobj,NNP-NNP,NN,1,1
1528,8733.0,34,named,2,8,5,-3,7,28,-6,3,Assaf Ramon,pilot,PERSON-PERSON,TITLE,PROPN-PROPN,NOUN,compound-pobj,appos,NNP-NNP,NN,1,1
1529,10288.0,35,named,2,8,5,-3,7,29,-6,3,Assaf Ramon,pilot,PERSON-PERSON,TITLE,PROPN-PROPN,NOUN,compound-pobj,appos,NNP-NNP,NN,1,1
1530,14723.0,36,played,3,24,31,7,23,4,-21,28,Assaf Ramon,pilot,PERSON-PERSON,TITLE,PROPN-PROPN,NOUN,compound-pobj,compound,NNP-NNP,NN,3,1
1531,3424.0,11,morons,9,1,7,6,0,3,8,-2,He,poet,PERSON,TITLE,PRON,NOUN,nsubj,pobj,PRP,NN,2,1
1532,3426.0,41,were,2,20,33,13,19,7,-18,31,Wen Qiang,executive deputy director,PERSON-PERSON,TITLE-TITLE-TITLE,PROPN-PROPN,ADJ-NOUN-NOUN,compound-conj,amod-compound-conj,NNP-NNP,JJ-NN-NN,3,1
1533,7545.0,23,offered,2,15,6,-9,14,16,-13,4,Wen Qiang,executive deputy director,PERSON-PERSON,TITLE-TITLE-TITLE,PROPN-PROPN,ADJ-NOUN-NOUN,compound-appos,amod-compound-dobj,NNP-NNP,JJ-NN-NN,4,1
1534,3442.0,37,said,35,25,15,-10,24,21,10,-20,his,Sulu,PERSON,LOCATION,DET,PROPN,poss,pobj,PRP$,NNP,6,1
1535,3445.0,27,died,5,1,4,3,0,22,4,-1,Assaf Ramon,21,PERSON-PERSON,NUMBER,PROPN-PROPN,NUM,compound-nsubj,appos,NNP-NNP,CD,2,1
1536,4990.0,28,interrupted,4,14,17,3,13,10,-10,13,Assaf Ramon,21,PERSON-PERSON,NUMBER,PROPN-PROPN,NUM,compound-pobj,appos,NNP-NNP,CD,5,1
1537,5199.0,35,named,2,8,11,3,7,23,-6,9,Assaf Ramon,21,PERSON-PERSON,NUMBER,PROPN-PROPN,NUM,compound-pobj,appos,NNP-NNP,CD,1,1
1538,12841.0,43,was,5,1,4,3,0,38,4,-1,Assaf Ramon,21,PERSON-PERSON,NUMBER,PROPN-PROPN,NUM,compound-nsubj,appos,NNP-NNP,CD,2,1
1539,3449.0,46,ended,11,3,16,13,2,29,8,5,PATA,Indonesia,ORGANIZATION,COUNTRY,PROPN,PROPN,compound,poss,NNP,NNP,-1,1
1540,3454.0,39,said,4,11,17,6,10,21,-7,13,Shah Abdul Aziz,Taliban,PERSON-PERSON-PERSON,ORGANIZATION,PROPN-PROPN-PROPN,PROPN,compound-compound-dobj,compound,NNP-NNP-NNP,NNP,2,1
1541,3455.0,17,worked,2,1,5,4,0,11,1,3,She,Florida State University,PERSON,ORGANIZATION-ORGANIZATION-ORGANIZATION,PRON,PROPN-PROPN-PROPN,nsubj,compound-compound-pobj,PRP,NNP-NNP-NNP,4,1
1542,7427.0,24,UTC,6,8,12,4,7,11,-2,6,She,Florida State University,PERSON,ORGANIZATION-ORGANIZATION-ORGANIZATION,PRON,PROPN-PROPN-PROPN,nsubj,compound-compound-pobj,PRP,NNP-NNP-NNP,-1,1
1543,3460.0,40,moved,5,5,3,-2,4,36,0,-2,he,Queens,PERSON,LOCATION,PRON,PROPN,nsubj,pobj,PRP,NNP,1,1
1544,7799.0,40,moved,5,5,3,-2,4,36,0,-2,he,Queens,PERSON,LOCATION,PRON,PROPN,nsubj,pobj,PRP,NNP,1,1
1545,12651.0,40,moved,5,5,3,-2,4,36,0,-2,he,Queens,PERSON,LOCATION,PRON,PROPN,nsubj,pobj,PRP,NNP,1,1
1546,3462.0,33,arraigned,6,28,30,2,27,2,-22,24,murder,Tamaihia Lynae Moore,PERSON,CAUSE_OF_DEATH-CAUSE_OF_DEATH-CAUSE_OF_DEATH,NOUN,PROPN-PROPN-PROPN,conj,compound-compound-pobj,NN,NNP-NNP-NNP,2,1
1547,3471.0,38,congratulate,7,2,14,12,1,23,5,7,National Urban League,Joe Biden,ORGANIZATION-ORGANIZATION-ORGANIZATION,PERSON-PERSON,PROPN-PROPN-PROPN,PROPN-PROPN,compound-compound-nsubj,compound-conj,NNP-NNP-NNP,NNP-NNP,5,1
1548,3479.0,30,recalls,17,17,23,6,16,6,0,6,Dworin,Cuban,PERSON,NATIONALITY,PROPN,ADJ,nsubj,amod,NNP,JJ,5,1
1549,3481.0,38,spoken,7,6,14,8,5,23,1,7,he,US,PERSON,COUNTRY,PRON,PROPN,nsubj,pobj,PRP,NNP,2,1
1550,3482.0,37,asked,10,13,6,-7,12,30,-3,-4,she,Boise,PERSON,LOCATION,PRON,PROPN,nsubj,pobj,PRP,NNP,6,1
1551,3483.0,36,is,8,6,3,-3,5,32,2,-5,National Restaurant Association,1919,ORGANIZATION-ORGANIZATION-ORGANIZATION,DATE,PROPN-PROPN-PROPN,NUM,compound-compound-nsubj,pobj,NNP-NNP-NNP,CD,3,1
1552,3489.0,41,is,5,21,17,-4,20,23,-16,12,her,president,PERSON,TITLE,DET,NOUN,poss,compound,PRP$,NN,3,1
1553,3497.0,36,Bank.,1,1,13,12,0,22,0,12,Countrywide Bank.,NYSE,ORGANIZATION-ORGANIZATION,ORGANIZATION,PROPN-PROPN,PROPN,compound-ROOT,ROOT,NNP-NNP,NNP,1,1
1554,3505.0,18,accelerated,9,15,2,-13,14,15,-6,-7,her,Haiti,PERSON,COUNTRY,DET,PROPN,poss,poss,PRP$,NNP,7,1
1555,3506.0,42,born,4,1,12,11,0,29,3,8,Andrew E Lange,"July 23 , 1957",PERSON-PERSON-PERSON,DATE-DATE-DATE-DATE,PROPN-PROPN-PROPN,PROPN-NUM-PUNCT-NUM,compound-compound-nsubjpass,pobj-nummod-punct-nummod,NNP-NNP-NNP,"NNP-CD-,-CD",5,1
1556,3508.0,38,testified,17,30,14,-16,29,23,-13,-3,she,teacher,PERSON,TITLE,PRON,NOUN,nsubjpass,pobj,PRP,NN,10,1
1557,3510.0,25,said,1,6,9,3,5,15,-5,8,John Graham,55,PERSON-PERSON,NUMBER,PROPN-PROPN,NUM,compound-appos,appos,NNP-NNP,CD,3,1
1558,14262.0,26,told,1,7,10,3,6,15,-6,9,John Graham,55,PERSON-PERSON,NUMBER,PROPN-PROPN,NUM,compound-appos,appos,NNP-NNP,CD,4,1
1559,3512.0,53,joined,21,2,17,15,1,35,19,-4,Tribeca Enterprises,Geoffrey Gilmore,ORGANIZATION-ORGANIZATION,PERSON-PERSON,PROPN-PROPN,PROPN-PROPN,compound-pobj,compound-appos,NNP-NNPS,NNP-NNP,5,1
1560,5733.0,47,said,27,36,29,-7,35,17,-9,2,Tribeca Enterprises,Geoffrey Gilmore,ORGANIZATION-ORGANIZATION,PERSON-PERSON,PROPN-PROPN,PROPN-PROPN,compound-pobj,compound-nsubj,NNP-NNPS,NNP-NNP,5,1
1561,3516.0,49,CHICAGO,0,16,25,9,15,23,-16,25,ACSE,Zhou Lubo,ORGANIZATION,PERSON-PERSON,PROPN,PROPN-PROPN,pobj,compound-pobj,NNP,NNP-NNP,9,1
1562,3532.0,41,said,4,11,37,26,10,3,-7,33,Shah Abdul Aziz,last September,PERSON-PERSON-PERSON,DATE-DATE,PROPN-PROPN-PROPN,ADJ-PROPN,compound-compound-dobj,amod-npadvmod,NNP-NNP-NNP,JJ-NNP,10,1
1563,3538.0,52,identified,4,10,18,8,9,33,-6,14,Alan Gross,Development Alternatives Inc,PERSON-PERSON,ORGANIZATION-ORGANIZATION-ORGANIZATION,PROPN-PROPN,PROPN-PROPN-PROPN,compound-appos,compound-compound-compound,NNP-NNP,NNP-NNP-NNP,7,1
1564,11990.0,39,identified,4,9,17,8,8,21,-5,13,Alan Gross,Development Alternatives Inc,PERSON-PERSON,ORGANIZATION-ORGANIZATION-ORGANIZATION,PROPN-PROPN,PROPN-PROPN-PROPN,compound-pobj,compound-compound-pobj,NNP-NNP,NNP-NNP-NNP,2,1
1565,3563.0,25,expected,15,12,11,-1,11,13,3,-4,Annie Mae,activist,PERSON-PERSON,TITLE,PROPN-PROPN,NOUN,compound-compound,compound,NNP-NNP,NN,2,1
1566,3566.0,44,accused,15,27,18,-9,26,25,-12,3,his,rape,PERSON,CRIMINAL_CHARGE,DET,NOUN,poss,pobj,PRP$,NN,7,1
1567,7457.0,24,Court,4,20,14,-6,19,9,-16,10,his,rape,PERSON,CRIMINAL_CHARGE,DET,NOUN,poss,conj,PRP$,NN,5,1
1568,3571.0,27,found,3,1,21,20,0,5,2,18,Carol Daniels,Pentecostal,PERSON-PERSON,RELIGION,PROPN-PROPN,PROPN,compound-nsubjpass,amod,NNP-NNP,NNP,7,1
1569,3575.0,26,worked,5,5,24,19,4,1,0,19,Cerniglia,executive chef,PERSON,TITLE-TITLE,PROPN,ADJ-NOUN,nsubj,amod-attr,NNP,JJ-NN,3,1
1570,10081.0,15,is,1,1,5,4,0,9,0,4,Cerniglia,executive chef,PERSON,TITLE-TITLE,PROPN,ADJ-NOUN,nsubj,amod-attr,NNP,JJ-NN,1,1
1571,3577.0,23,said,1,3,14,11,2,8,-2,13,he,Venezuela,PERSON,COUNTRY,PRON,PROPN,nsubjpass,pobj,PRP,NNP,7,1
1572,3587.0,33,said,5,14,21,7,13,11,-9,16,Alan P Gross,government contractor,PERSON-PERSON-PERSON,TITLE-TITLE,PROPN-PROPN-PROPN,NOUN-NOUN,compound-compound-pobj,compound-appos,NNP-NNP-NNP,NN-NN,5,1
1573,3589.0,31,began,1,29,5,-24,28,25,-28,4,her,KBR,PERSON,ORGANIZATION,DET,PROPN,poss,pobj,PRP$,NNP,6,1
1574,3596.0,32,kills,5,23,28,5,22,3,-18,23,Morita Chemical Industries Co,Osaka,ORGANIZATION-ORGANIZATION-ORGANIZATION-ORGANIZATION,CITY,PROPN-PROPN-PROPN-PROPN,PROPN,compound-compound-compound-pobj,poss,NNP-NNP-NNP-NNP,NNP,6,1
1575,3659.0,25,occurred,2,16,21,5,15,3,-14,19,Morita Chemical Industries Co,Osaka,ORGANIZATION-ORGANIZATION-ORGANIZATION-ORGANIZATION,CITY,PROPN-PROPN-PROPN-PROPN,PROPN,compound-compound-compound-pobj,poss,NNP-NNP-NNP-NNP,NNP,6,1
1576,3598.0,50,told,22,1,15,14,0,34,21,-7,Adela Dworin,Jewish Community House,PERSON-PERSON,ORGANIZATION-ORGANIZATION-ORGANIZATION,PROPN-PROPN,PROPN-PROPN-PROPN,compound-nsubj,amod-compound-appos,NNP-NNP,NNP-NNP-NNP,5,1
1577,6741.0,46,told,22,1,15,14,0,30,21,-7,Adela Dworin,Jewish Community House,PERSON-PERSON,ORGANIZATION-ORGANIZATION-ORGANIZATION,PROPN-PROPN,PROPN-PROPN-PROPN,compound-nsubj,amod-compound-appos,NNP-NNP,NNP-NNP-NNP,5,1
1578,3602.0,9,died,2,1,8,7,0,0,1,6,William Kunstler,76,PERSON-PERSON,NUMBER,PROPN-PROPN,NUM,compound-nsubj,nummod,NNP-NNP,CD,2,1
1579,3604.0,20,notified,4,15,2,-13,14,17,-11,-2,his,President,PERSON,TITLE,DET,PROPN,poss,compound,PRP$,NNP,5,1
1580,3608.0,5,Cleaver,4,1,4,3,0,0,3,0,NDA,Anthony Cleaver,ORGANIZATION,PERSON-PERSON,PROPN,PROPN-PROPN,compound,compound-ROOT,NNP,NNP-NNP,1,1
1581,3630.0,25,told,2,18,16,-2,17,8,-16,14,Ladyzhenskiy,Russian,PERSON,NATIONALITY,PROPN,ADJ,appos,amod,NNP,JJ,4,1
1582,3633.0,30,arrested,2,5,8,3,4,21,-3,6,his,Karak,PERSON,CITY,DET,PROPN,poss,pobj,PRP$,NNP,1,1
1583,3640.0,28,denounced,2,23,8,-15,22,19,-21,6,Asia Bibi,Pakistan,PERSON-PERSON,COUNTRY,PROPN-PROPN,PROPN,compound-pobj,poss,NNP-NNP,NNP,8,1
1584,8217.0,26,sentenced,3,1,8,7,0,17,2,5,Asia Bibi,Pakistan,PERSON-PERSON,COUNTRY,PROPN-PROPN,PROPN,compound-nsubjpass,poss,NNP-NNP,NNP,6,1
1585,10686.0,38,asked,5,31,26,-5,30,11,-26,21,Asia Bibi,Pakistan,PERSON-PERSON,COUNTRY,PROPN-PROPN,PROPN,compound-dobj,poss,NNP-NNP,NNP,4,1
1586,11333.0,27,sentenced,3,1,8,7,0,18,2,5,Asia Bibi,Pakistan,PERSON-PERSON,NATIONALITY,PROPN-PROPN,PROPN,compound-nsubjpass,poss,NNP-NNP,NNP,6,1
1587,13478.0,13,------,0,5,12,7,4,0,-5,12,Asia Bibi,Pakistan,PERSON-PERSON,COUNTRY,PROPN-PROPN,PROPN,compound-pobj,pobj,NNP-NNP,NNP,4,1
1588,3642.0,46,said,41,33,27,-6,32,18,8,-14,National Energy Administration,Jiang Bing,ORGANIZATION-ORGANIZATION-ORGANIZATION,PERSON-PERSON,PROPN-PROPN-PROPN,PROPN-PROPN,compound-compound-poss,compound-appos,NNP-NNP-NNP,NNP-NNP,5,1
1589,9373.0,66,*,0,56,44,-12,55,21,-56,44,National Energy Administration,Jiang Bing,ORGANIZATION-ORGANIZATION-ORGANIZATION,PERSON-PERSON,PROPN-PROPN-PROPN,PROPN-PROPN,compound-compound-pobj,compound-oprd,NNP-NNP-NNP,NNP-NNP,6,1
1590,12456.0,44,kept,7,34,22,-12,33,21,-27,15,National Energy Administration,Jiang Bing,ORGANIZATION-ORGANIZATION-ORGANIZATION,PERSON-PERSON,PROPN-PROPN-PROPN,PROPN-PROPN,compound-compound-pobj,compound-appos,NNP-NNP-NNP,NNP-NNP,6,1
1591,3648.0,55,says,17,10,7,-3,9,47,7,-10,Corporate Library,Portland,ORGANIZATION-ORGANIZATION,CITY,PROPN-PROPN,PROPN,compound-conj,pobj,NNP-NNP,NNP,4,1
1592,4406.0,44,said,14,24,28,4,23,15,-10,14,Corporate Library,Portland,ORGANIZATION-ORGANIZATION,CITY,PROPN-PROPN,PROPN,compound-pobj,nmod,NNP-NNP,NNP,3,1
1593,7200.0,30,said,18,8,15,7,7,14,10,-3,Corporate Library,Portland,ORGANIZATION-ORGANIZATION,CITY,PROPN-PROPN,PROPN,compound-pobj,pobj,NNP-NNP,NNP,7,1
1594,7922.0,21,interviewed,2,14,11,-3,13,9,-12,9,Corporate Library,Portland,ORGANIZATION-ORGANIZATION,CITY,PROPN-PROPN,PROPN,compound-appos,pobj,NNP-NNP,NNP,4,1
1595,8321.0,35,misaligned,8,23,32,9,22,2,-15,24,Corporate Library,Portland,ORGANIZATION-ORGANIZATION,CITY,PROPN-PROPN,PROPN,compound-pobj,pobj,NNP-NNP,NNP,8,1
1596,10294.0,45,said,22,32,36,4,31,8,-10,14,Corporate Library,Portland,ORGANIZATION-ORGANIZATION,CITY,PROPN-PROPN,PROPN,compound-pobj,nmod,NNP-NNP,NNP,4,1
1597,12897.0,39,said,16,26,30,4,25,8,-10,14,Corporate Library,Portland,ORGANIZATION-ORGANIZATION,CITY,PROPN-PROPN,PROPN,compound-pobj,nmod,NNP-NNP,NNP,3,1
1598,13830.0,28,said,8,16,25,9,15,2,-8,17,Corporate Library,Portland,ORGANIZATION-ORGANIZATION,CITY,PROPN-PROPN,PROPN,compound-pobj,pobj,NNP-NNP,NNP,6,1
1599,3650.0,50,said,24,15,18,3,14,31,9,-6,Sodini,programmer-analyst,PERSON,TITLE,PROPN,NOUN,appos,appos,NNP,NN,3,1
1600,9646.0,41,said,15,6,9,3,5,31,9,-6,Sodini,programmer-analyst,PERSON,TITLE,PROPN,NOUN,nsubj,appos,NNP,NN,3,1
1601,3652.0,31,Festival,4,13,9,-4,12,21,-9,5,NTSO,Taiwan,ORGANIZATION,COUNTRY,PROPN,PROPN,compound,pobj,NNP,NNP,-1,1
1602,10890.0,31,Festival,4,13,9,-4,12,21,-9,5,NTSO,Taiwan,ORGANIZATION,COUNTRY,PROPN,PROPN,compound,pobj,NNP,NNP,-1,1
1603,3673.0,41,described,4,1,3,2,0,37,3,-1,Sodini,48,PERSON,NUMBER,PROPN,NUM,nsubj,appos,NNP,CD,3,1
1604,6627.0,28,shows,11,4,6,2,3,21,7,-5,Sodini,48,PERSON,NUMBER,PROPN,NUM,pobj,appos,NNP,CD,2,1
1605,3674.0,24,said,1,8,3,-5,7,20,-7,2,Pluribus,James Finkelstein,ORGANIZATION,PERSON-PERSON,PROPN,PROPN-PROPN,dobj,compound-nsubj,NNP,NNP-NNP,3,1
1606,5849.0,23,------,0,7,2,-5,6,20,-7,2,Pluribus,James Finkelstein,ORGANIZATION,PERSON-PERSON,PROPN,PROPN-PROPN,dobj,compound-nsubj,NNP,NNP-NNP,3,1
1607,3679.0,41,said,39,11,20,9,10,20,28,-19,her,Finland,PERSON,COUNTRY,DET,PROPN,poss,pobj,PRP$,NNP,7,1
1608,4904.0,41,said,39,11,20,9,10,20,28,-19,her,Finland,PERSON,COUNTRY,PRON,PROPN,dobj,pobj,PRP,NNP,7,1
1609,3697.0,49,are,9,31,42,11,30,6,-22,33,"Qatalys , Inc",Texas,ORGANIZATION-ORGANIZATION-ORGANIZATION,STATE_OR_PROVINCE,PROPN-PUNCT-PROPN,PROPN,ROOT-punct-appos,appos,"NNP-,-NNP",NNP,2,1
1610,14113.0,21,founded,5,3,14,11,2,6,2,9,"Qatalys , Inc",Texas,ORGANIZATION-ORGANIZATION-ORGANIZATION,STATE_OR_PROVINCE,PROPN-PUNCT-PROPN,PROPN,nmod-punct-nsubj,appos,"NNP-,-NNP",NNP,5,1
1611,3700.0,9,Gage,1,1,4,3,0,4,0,3,Richard Gage,AIA,PERSON-PERSON,ORGANIZATION,PROPN-PROPN,PROPN,compound-ROOT,compound,NNP-NNP,NNP,1,1
1612,7255.0,28,acclaimed,1,7,10,3,6,17,-6,9,Richard Gage,AIA,PERSON-PERSON,ORGANIZATION,PROPN-PROPN,PROPN,compound-appos,appos,NNP-NNP,NNP,4,1
1613,13749.0,38,Google,0,23,26,3,22,11,-23,26,Richard Gage,AIA,PERSON-PERSON,ORGANIZATION,PROPN-PROPN,PROPN,compound-pobj,appos,NNP-NNP,NNP,7,1
1614,3703.0,33,is,9,20,4,-16,19,28,-11,-5,Carol Daniels,son,PERSON-PERSON,PERSON,PROPN-PROPN,NOUN,compound-pobj,nsubj,NNP-NNP,NN,11,1
1615,3707.0,33,detained,2,18,31,13,17,1,-16,29,Xie Caiping,Chongqing,PERSON-PERSON,CITY,PROPN-PROPN,PROPN,compound-npadvmod,compound,NNP-NNP,NNP,6,1
1616,6878.0,28,sentenced,21,7,19,12,6,8,14,-2,Xie Caiping,Chongqing,PERSON-PERSON,CITY,PROPN-PROPN,PROPN,compound-nsubj,pobj,NNP-NNP,NNP,3,1
1617,12633.0,45,sentenced,8,5,25,20,4,19,3,17,Xie Caiping,Chongqing,PERSON-PERSON,CITY,PROPN-PROPN,PROPN,compound-appos,compound,NNP-NNP,NNP,9,1
1618,3728.0,45,articulated,11,10,7,-3,9,37,1,-4,TPI,US,ORGANIZATION,COUNTRY,PROPN,PROPN,pobj,compound,NNP,NNP,6,1
1619,3734.0,28,taken,3,10,19,9,9,8,-7,16,Third Guard Division,Beijing,ORGANIZATION-ORGANIZATION-ORGANIZATION,CITY,PROPN-PROPN-PROPN,PROPN,compound-compound-pobj,dobj,NNP-NNP-NNP,NNP,7,1
1620,3736.0,22,receive,4,3,11,8,2,10,1,7,Countrywide,Bank of America,ORGANIZATION,ORGANIZATION-ORGANIZATION-ORGANIZATION,PROPN,PROPN-ADP-PROPN,pobj,nmod-prep-pobj,NNP,NNP-IN-NNP,8,1
1621,14935.0,34,was,1,1,29,28,0,4,0,28,Countrywide,Bank of America,ORGANIZATION,ORGANIZATION-ORGANIZATION-ORGANIZATION,PROPN,PROPN-ADP-PROPN,nsubj,pobj-prep-pobj,NNP,NNP-IN-NNP,7,1
1622,3744.0,24,see,15,13,4,-9,12,19,2,-11,he,her,PERSON,PERSON,PRON,DET,nsubj,poss,PRP,PRP$,6,1
1623,14225.0,24,see,15,13,4,-9,12,19,2,-11,he,her,PERSON,PERSON,PRON,DET,nsubj,poss,PRP,PRP$,6,1
1624,3748.0,29,collected,4,15,4,-11,14,24,-11,0,her,doctor,PERSON,TITLE,DET,NOUN,poss,nsubj,PRP$,NN,5,1
1625,3761.0,25,said,23,20,18,-2,19,6,3,-5,Eugenio Vagni,aid worker,PERSON-PERSON,TITLE-TITLE,PROPN-PROPN,NOUN-NOUN,compound-pobj,compound-compound,NNP-NNP,NN-NN,3,1
1626,5668.0,33,freed,10,8,6,-2,7,26,2,-4,Eugenio Vagni,aid worker,PERSON-PERSON,TITLE-TITLE,PROPN-PROPN,NOUN-NOUN,compound-appos,compound-compound,NNP-NNP,NN-NN,1,1
1627,6283.0,37,Philippines,2,15,13,-2,14,23,-13,11,Eugenio Vagni,aid worker,PERSON-PERSON,TITLE-TITLE,PROPN-PROPN,NOUN-NOUN,compound-nsubjpass,compound-pobj,NNP-NNP,NN-NN,1,1
1628,10631.0,34,says,24,9,7,-2,8,26,15,-17,Eugenio Vagni,aid worker,PERSON-PERSON,TITLE-TITLE,PROPN-PROPN,NOUN-NOUN,compound-conj,compound-compound,NNP-NNP,NN-NN,1,1
1629,11791.0,24,been,4,20,18,-2,19,5,-16,14,Eugenio Vagni,aid worker,PERSON-PERSON,TITLE-TITLE,PROPN-PROPN,NOUN-NOUN,compound-dobj,compound-compound,NNP-NNP,NN-NN,1,1
1630,15083.0,47,sparked,4,31,29,-2,30,17,-27,25,Eugenio Vagni,aid worker,PERSON-PERSON,TITLE-TITLE,PROPN-PROPN,NOUN-NOUN,compound-dobj,compound-compound,NNP-NNP,NN-NN,1,1
1631,3769.0,50,formed,1,30,27,-3,29,22,-29,26,he,Motorola,PERSON,ORGANIZATION,PRON,PROPN,nsubj,compound,PRP,NNP,2,1
1632,3775.0,45,used,25,8,16,8,7,28,17,-9,China Charity Federation,Qinghai,ORGANIZATION-ORGANIZATION-ORGANIZATION,STATE_OR_PROVINCE,PROPN-PROPN-PROPN,PROPN,compound-compound-pobj,pobj,NNP-NNP-NNP,NNP,8,1
1633,3777.0,35,was,5,13,17,4,12,17,-8,12,Norris Church Mailer,Mallory,PERSON-PERSON-PERSON,PERSON,PROPN-PROPN-PROPN,PROPN,compound-compound-appos,poss,NNP-NNP-NNP,NNP,9,1
1634,3778.0,42,said,10,12,5,-7,11,36,-2,-5,he,U.N.,PERSON,ORGANIZATION,PRON,PROPN,nsubj,compound,PRP,NNP,2,1
1635,3791.0,19,organized,3,7,14,7,6,4,-4,11,Pacific Asia Travel Association,Taiwan,ORGANIZATION-ORGANIZATION-ORGANIZATION-ORGANIZATION,COUNTRY,PROPN-PROPN-PROPN-PROPN,PROPN,compound-compound-compound-pobj,nsubj,NNP-NNP-NNP-NNP,NNP,2,1
1636,7651.0,77,invited,42,65,8,-57,64,68,-23,-34,Pacific Asia Travel Association,Taiwan,ORGANIZATION-ORGANIZATION-ORGANIZATION-ORGANIZATION,COUNTRY,PROPN-PROPN-PROPN-PROPN,PROPN,compound-compound-compound-pobj,poss,NNP-NNP-NNP-NNP,NNP,8,1
1637,3792.0,15,told,7,1,5,4,0,9,6,-2,Daniels,Ivan Henderson,PERSON,PERSON-PERSON,NOUN,PROPN-PROPN,poss,compound-appos,NNS,NNP-NNP,3,1
1638,3797.0,42,said,39,34,9,-25,33,32,5,-30,National Taiwan Symphony Orchestra,Taiwan,ORGANIZATION-ORGANIZATION-ORGANIZATION-ORGANIZATION,COUNTRY,PROPN-PROPN-PROPN-PROPN,PROPN,compound-compound-compound-pobj,poss,NNP-NNP-NNP-NNP,NNP,12,1
1639,7951.0,31,Festival,4,8,9,1,7,21,-4,5,National Taiwan Symphony Orchestra,Taiwan,ORGANIZATION-ORGANIZATION-ORGANIZATION-ORGANIZATION,COUNTRY,PROPN-PROPN-PROPN-PROPN,PROPN,compound-compound-compound-pobj,pobj,NNP-NNP-NNP-NNP,NNP,2,1
1640,3803.0,19,were,16,3,9,6,2,9,13,-7,Koch Foods,Chicago,ORGANIZATION-ORGANIZATION,CITY,PROPN-PROPN,PROPN,compound-pobj,compound,NNP-NNP,NNP,5,1
1641,4421.0,37,said,26,14,23,9,13,13,12,-3,Koch Foods,Chicago,ORGANIZATION-ORGANIZATION,CITY,PROPN-PROPN,PROPN,compound-compound,compound,NNP-NNP,NNP,7,1
1642,9985.0,43,said,26,14,23,9,13,19,12,-3,Koch Foods,Chicago,ORGANIZATION-ORGANIZATION,CITY,PROPN-PROPN,PROPN,compound-compound,compound,NNP-NNP,NNP,7,1
1643,3818.0,33,CIRCUS-BOOK-REVIEW,0,24,28,4,23,4,-24,28,Norris Church Mailer,Norman Mailer,PERSON-PERSON-PERSON,PERSON-PERSON,PROPN-PROPN-PROPN,PROPN-PROPN,compound-compound-pobj,compound-poss,NNP-NNP-NNP,NNP-NNP,2,1
1644,4564.0,27,died,25,1,6,5,0,20,24,-19,Norris Church Mailer,Norman Mailer,PERSON-PERSON-PERSON,PERSON-PERSON,PROPN-PROPN-PROPN,PROPN-PROPN,compound-compound-pobj,compound-pobj,NNP-NNP-NNP,NNP-NNP,3,1
1645,6087.0,49,am,1,5,20,15,4,28,-4,19,Norris Church Mailer,Norman Mailer,PERSON-PERSON-PERSON,PERSON-PERSON,PROPN-PROPN-PROPN,PROPN-PROPN,compound-compound-nsubj,compound-pobj,NNP-NNP-NNP,NNP-NNP,-1,1
1646,9986.0,45,died,34,1,16,15,0,28,33,-18,Norris Church Mailer,Norman Mailer,PERSON-PERSON-PERSON,PERSON-PERSON,PROPN-PROPN-PROPN,PROPN-PROPN,compound-compound-nsubj,compound-pobj,NNP-NNP-NNP,NNP-NNP,6,1
1647,3824.0,53,intend,3,20,22,2,19,30,-17,19,ADF,Australian Defence Force,ORGANIZATION,ORGANIZATION-ORGANIZATION-ORGANIZATION,PROPN,PROPN-PROPN-PROPN,compound,compound-compound-compound,NNP,NNP-NNP-NNP,8,1
1648,5195.0,33,SYDNEY,0,15,17,2,14,15,-15,17,ADF,Australian Defence Force,ORGANIZATION,ORGANIZATION-ORGANIZATION-ORGANIZATION,PROPN,PROPN-PROPN-PROPN,compound,compound-compound-compound,NNP,NNP-NNP-NNP,-1,1
1649,7002.0,38,investigating,11,6,2,-4,5,35,5,-9,ADF,Australian Defence Force,ORGANIZATION,ORGANIZATION-ORGANIZATION-ORGANIZATION,PROPN,PROPN-PROPN-PROPN,compound,compound-compound-compound,NNP,NNP-NNP-NNP,3,1
1650,10408.0,44,SYDNEY,0,22,18,-4,21,25,-22,18,ADF,Australian Defence Force,ORGANIZATION,ORGANIZATION-ORGANIZATION-ORGANIZATION,PROPN,PROPN-PROPN-PROPN,compound,compound-compound-compound,NNP,NNP-NNP-NNP,3,1
1651,13837.0,52,intend,2,19,21,2,18,30,-17,19,ADF,Australian Defence Force,ORGANIZATION,ORGANIZATION-ORGANIZATION-ORGANIZATION,PROPN,PROPN-PROPN-PROPN,compound,compound-compound-compound,NNP,NNP-NNP-NNP,8,1
1652,3829.0,56,said,35,29,33,4,28,22,6,-2,PATA,Peter de Jong,ORGANIZATION,PERSON-PERSON-PERSON,ADJ,PROPN-PROPN-PROPN,compound,compound-compound-nsubj,JJ,NNP-NNP-NNP,5,1
1653,3965.0,41,said,34,36,38,2,35,2,-2,4,PATA,Peter de Jong,ORGANIZATION,PERSON-PERSON-PERSON,PROPN,PROPN-PROPN-PROPN,compound,compound-compound-nsubj,NNP,NNP-NNP-NNP,2,1
1654,12049.0,35,said,24,26,32,6,25,2,-2,8,PATA,Peter de Jong,ORGANIZATION,PERSON-PERSON-PERSON,PROPN,PROPN-PROPN-PROPN,compound,compound-compound-appos,NNP,NNP-NNP-NNP,4,1
1655,3833.0,28,keep,17,1,13,12,0,14,16,-4,Heloise,author,PERSON,TITLE,PROPN,NOUN,compound,appos,NNP,NN,6,1
1656,3834.0,51,contended,7,29,39,10,28,11,-22,32,her,Idaho,PERSON,STATE_OR_PROVINCE,DET,PROPN,poss,pobj,PRP$,NNP,8,1
1657,3839.0,31,worked,4,1,16,15,0,14,3,12,Jupp,burns,PERSON,CAUSE_OF_DEATH,PROPN,NOUN,nsubj,dobj,NNP,NNS,5,1
1658,3847.0,34,led,2,17,14,-3,16,19,-15,12,Wen Qiang,judicial department,PERSON-PERSON,ORGANIZATION-ORGANIZATION,PROPN-PROPN,ADJ-NOUN,compound-appos,amod-pobj,NNP-NNP,JJ-NN,3,1
1659,3855.0,42,said,14,11,14,3,10,27,3,0,Jupp,Pat,PERSON,PERSON,PROPN,PROPN,poss,appos,NNP,NNP,3,1
1660,3856.0,14,sponsors,10,2,8,6,1,5,8,-2,American Association of University Women,Willingboro Chapter,ORGANIZATION-ORGANIZATION-ORGANIZATION-ORGANIZATION-ORGANIZATION,ORGANIZATION-ORGANIZATION,PROPN-PROPN-ADP-PROPN-PROPN,PROPN-PROPN,compound-nsubj-prep-compound-pobj,compound-appos,NNP-NNP-IN-NNP-NNPS,NNP-NNP,1,1
1661,3867.0,30,said,5,21,12,-9,20,17,-16,7,ALICO,American Life Insurance company,ORGANIZATION,ORGANIZATION-ORGANIZATION-ORGANIZATION-ORGANIZATION,PROPN,PROPN-PROPN-PROPN-NOUN,compound,compound-compound-compound-dobj,NNP,NNP-NNP-NNP-NN,4,1
1662,15477.0,54,says,5,10,36,26,9,17,-5,31,ALICO,American Life Insurance company,ORGANIZATION,ORGANIZATION-ORGANIZATION-ORGANIZATION-ORGANIZATION,PROPN,PROPN-PROPN-PROPN-NOUN,compound,compound-compound-compound-dobj,NNP,NNP-NNP-NNP-NN,-1,1
1663,3873.0,27,wrote,8,22,6,-16,21,20,-14,-2,husband,Judy Gross,PERSON,PERSON-PERSON,NOUN,PROPN-PROPN,poss,compound-appos,NN,NNP-NNP,8,1
1664,5449.0,36,said,12,15,10,-5,14,25,-3,-2,husband,Judy Gross,PERSON,PERSON-PERSON,NOUN,PROPN-PROPN,nsubj,compound-pobj,NN,NNP-NNP,7,1
1665,15237.0,34,wrote,6,22,5,-17,21,28,-16,-1,husband,Judy Gross,PERSON,PERSON-PERSON,NOUN,PROPN-PROPN,nsubj,compound-nsubj,NN,NNP-NNP,7,1
1666,3876.0,40,said,11,13,29,16,12,10,-2,18,Alessi,Conn.,PERSON,STATE_OR_PROVINCE,PROPN,PROPN,nsubj,subtok,NNP,NNP,2,1
1667,3885.0,36,said,5,4,1,-3,3,34,1,-4,Ahmed Rashid,Analyst,PERSON-PERSON,TITLE,PROPN-PROPN,NOUN,compound-conj,nsubj,NNP-NNP,NN,2,1
1668,3889.0,30,estimated,15,8,1,-7,7,28,7,-14,Urban League,Patrick Graham,ORGANIZATION-ORGANIZATION,PERSON-PERSON,PROPN-PROPN,PROPN-PROPN,compound-pobj,compound-nsubj,NNP-NNP,NNP-NNP,3,1
1669,3891.0,30,charged,2,1,23,22,0,6,1,21,Graham,rape,PERSON,CRIMINAL_CHARGE,PROPN,NOUN,nsubjpass,pobj,NNP,NN,3,1
1670,3892.0,27,died,7,2,6,4,1,20,5,-1,Ramon,Ilan,PERSON,PERSON,PROPN,PROPN,poss,appos,NNP,NNP,4,1
1671,3899.0,11,born,2,1,10,9,0,0,1,8,Lange,Illinois,PERSON,STATE_OR_PROVINCE,PROPN,PROPN,nsubjpass,pobj,NNP,NNP,2,1
1672,3906.0,38,hunting,5,17,14,-3,16,23,-12,9,Eugenio Vagni,Red Cross,PERSON-PERSON,ORGANIZATION-ORGANIZATION,PROPN-PROPN,PROPN-PROPN,compound-nsubj,compound-compound,NNP-NNP,NNP-NNP,4,1
1673,4181.0,40,kidnapped,5,11,8,-3,10,31,-6,3,Eugenio Vagni,Red Cross,PERSON-PERSON,ORGANIZATION-ORGANIZATION,PROPN-PROPN,PROPN-PROPN,compound-nsubj,compound-compound,NNP-NNP,NNP-NNP,2,1
1674,8808.0,35,was,6,5,2,-3,4,32,1,-4,Eugenio Vagni,Red Cross,PERSON-PERSON,ORGANIZATION-ORGANIZATION,PROPN-PROPN,PROPN-PROPN,compound-nsubj,compound-compound,NNP-NNP,NNP-NNP,2,1
1675,11207.0,31,kill,1,26,23,-3,25,7,-25,22,Eugenio Vagni,Red Cross,PERSON-PERSON,ORGANIZATION-ORGANIZATION,PROPN-PROPN,PROPN-PROPN,compound-dobj,compound-compound,NNP-NNP,NNP-NNP,2,1
1676,13004.0,56,said,13,43,4,-39,42,51,-30,-9,Eugenio Vagni,Red Cross,PERSON-PERSON,ORGANIZATION-ORGANIZATION,PROPN-PROPN,PROPN-PROPN,compound-pobj,compound-pobj,NNP-NNP,NNP-NNP,8,1
1677,14062.0,49,believed,4,15,21,6,14,27,-11,17,Eugenio Vagni,Red Cross,PERSON-PERSON,ORGANIZATION-ORGANIZATION,PROPN-PROPN,PROPN-PROPN,compound-dobj,compound-compound,NNP-NNP,NNP-NNP,3,1
1678,15310.0,23,said,21,5,2,-3,4,20,16,-19,Eugenio Vagni,Red Cross,PERSON-PERSON,ORGANIZATION-ORGANIZATION,PROPN-PROPN,PROPN-PROPN,compound-nsubjpass,compound-compound,NNP-NNP,NNP-NNP,2,1
1679,3914.0,40,appeared,25,1,14,13,0,25,24,-11,The killer,Bridgeville,PERSON-PERSON,CITY,DET-NOUN,PROPN,det-nsubj,pobj,DT-NN,NNP,4,1
1680,3920.0,47,believed,14,12,1,-11,11,45,2,-13,PATA,Gregory Duffell,ORGANIZATION,PERSON-PERSON,PROPN,PROPN-PROPN,compound,compound-nsubj,NNP,NNP-NNP,1,1
1681,3923.0,14,listed,5,1,9,8,0,4,4,4,Her,multiple sharp force injuries,PERSON,CAUSE_OF_DEATH-CAUSE_OF_DEATH-CAUSE_OF_DEATH-CAUSE_OF_DEATH,DET,ADJ-ADJ-NOUN-NOUN,poss,amod-amod-compound-pobj,PRP$,JJ-JJ-NN-NNS,4,1
1682,3928.0,25,leads,2,16,12,-4,15,12,-14,10,Countrywide Financial Corporation,Premiere Business Bankers,ORGANIZATION-ORGANIZATION-ORGANIZATION,ORGANIZATION-ORGANIZATION-ORGANIZATION,PROPN-PROPN-PROPN,PROPN-PROPN-PROPN,compound-compound-pobj,compound-compound-conj,NNP-NNP-NNP,NNP-NNP-NNPS,2,1
1683,3932.0,35,told,8,4,1,-3,3,33,4,-7,Amanda Knox,Curt Knox,PERSON-PERSON,PERSON-PERSON,PROPN-PROPN,PROPN-PROPN,compound-poss,compound-nsubj,NNP-NNP,NNP-NNP,2,1
1684,3938.0,83,include,2,1,40,39,0,42,1,38,OANA,PPI,ORGANIZATION,ORGANIZATION,PROPN,PROPN,compound,conj,NNP,NNP,9,1
1685,3949.0,33,said,24,11,8,-3,10,24,13,-16,Laura Silsby,Port-au-Prince,PERSON-PERSON,CITY,PROPN-PROPN,PROPN,compound-nsubj,compound,NNP-NNP,NNP,3,1
1686,14204.0,44,said,42,5,14,9,4,29,37,-28,Laura Silsby,Port-au-Prince,PERSON-PERSON,CITY,PROPN-PROPN,PROPN,compound-nsubj,pobj,NNP-NNP,NNP,8,1
1687,3959.0,36,include,1,3,6,3,2,29,-2,5,his,Sandra,PERSON,PERSON,DET,PROPN,poss,appos,PRP$,NNP,1,1
1688,11629.0,36,include,1,3,6,3,2,29,-2,5,his,Sandra,PERSON,PERSON,DET,PROPN,poss,appos,PRP$,NNP,1,1
1689,3968.0,36,formed,3,2,6,4,1,29,1,3,OANA,1961,ORGANIZATION,DATE,PROPN,NUM,nsubjpass,pobj,NNP,CD,2,1
1690,12050.0,29,groups,6,6,3,-3,5,25,0,-3,OANA,1961,ORGANIZATION,DATE,PROPN,NUM,compound,pobj,NNP,CD,1,1
1691,13876.0,38,formed,3,2,6,4,1,31,1,3,OANA,1961,ORGANIZATION,DATE,PROPN,NUM,nsubjpass,pobj,NNP,CD,2,1
1692,3984.0,32,said,29,20,14,-6,19,17,9,-15,OANA,Organization of Asia-Pacific News Agencies,ORGANIZATION,ORGANIZATION-ORGANIZATION-ORGANIZATION-ORGANIZATION-ORGANIZATION,PROPN,PROPN-ADP-PROPN-PROPN-PROPN,compound,pobj-prep-compound-compound-pobj,NNP,NNP-IN-NNP-NNP-NNPS,7,1
1693,5958.0,36,announced,6,24,18,-6,23,17,-18,12,OANA,Organization of Asia-Pacific News Agencies,ORGANIZATION,ORGANIZATION-ORGANIZATION-ORGANIZATION-ORGANIZATION-ORGANIZATION,PROPN,PROPN-ADP-PROPN-PROPN-PROPN,compound,pobj-prep-compound-compound-pobj,NNP,NNP-IN-NNP-NNP-NNPS,7,1
1694,15313.0,38,passed,4,19,13,-6,18,24,-15,9,OANA,Organization of Asia-Pacific News Agencies,ORGANIZATION,ORGANIZATION-ORGANIZATION-ORGANIZATION-ORGANIZATION-ORGANIZATION,PROPN,PROPN-ADP-PROPN-PROPN-PROPN,compound,pobj-prep-compound-compound-pobj,NNP,NNP-IN-NNP-NNP-NNPS,4,1
1695,3986.0,76,com,9,23,20,-3,22,55,-14,11,Sycamore Software Solutions,California,ORGANIZATION-ORGANIZATION-ORGANIZATION,STATE_OR_PROVINCE,PROPN-PROPN-PROPN,PROPN,compound-compound-appos,compound,NNP-NNP-NNPS,NNP,2,1
1696,3988.0,24,Poverty,0,1,6,5,0,17,-1,6,Poverty and Social Impact Analysis,http://www.worldbank.org/psia,ORGANIZATION-ORGANIZATION-ORGANIZATION-ORGANIZATION-ORGANIZATION,URL,NOUN-CCONJ-PROPN-PROPN-PROPN,X,ROOT-cc-compound-compound-conj,ROOT,NN-CC-NNP-NNP-NNP,ADD,-1,1
1697,3990.0,26,said,14,13,9,-4,12,16,1,-5,Assaf Ramon,his father,PERSON-PERSON,PERSON-PERSON,PROPN-PROPN,DET-NOUN,compound-nsubj,poss-nsubj,NNP-NNP,PRP$-NN,7,1
1698,3992.0,31,said,19,19,27,8,18,3,0,8,Silsby,Port-au-Prince,PERSON,CITY,PROPN,PROPN,nsubj,poss,NNP,NNP,6,1
1699,9262.0,40,released,15,33,38,5,32,1,-18,23,Silsby,Port-au-Prince,PERSON,CITY,PROPN,PROPN,dobj,compound,NNP,NNP,4,1
1700,13173.0,31,released,7,19,30,11,18,0,-12,23,Silsby,Port-au-Prince,PERSON,CITY,PROPN,PROPN,nsubjpass,pobj,NNP,NNP,5,1
1701,3998.0,39,said,34,2,5,3,1,33,32,-29,Alan,social worker,PERSON,TITLE-TITLE,PROPN,ADJ-NOUN,nsubj,amod-attr,NNP,JJ-NN,3,1
1702,4032.0,24,identified,3,12,12,0,11,11,-9,9,Ruben van Assouw,Ruben,PERSON-PERSON-PERSON,PERSON,PROPN-PROPN-PROPN,PROPN,compound-compound-pobj,pobj,NNP-NNP-NNP,NNP,0,1
1703,5011.0,23,identified,4,12,12,0,11,10,-8,8,Ruben van Assouw,Ruben,PERSON-PERSON-PERSON,PERSON,PROPN-PROPN-PROPN,PROPN,compound-compound-pobj,pobj,NNP-NNP-NNP,NNP,0,1
1704,7897.0,35,found,23,11,11,0,10,23,12,-12,Ruben van Assouw,Ruben,PERSON-PERSON-PERSON,PERSON,PROPN-PROPN-PROPN,PROPN,compound-compound-pobj,pobj,NNP-NNP-NNP,NNP,0,1
1705,4053.0,28,said,26,1,19,18,0,8,25,-7,Koch Foods,United States,ORGANIZATION-ORGANIZATION,COUNTRY-COUNTRY,PROPN-PROPN,PROPN-PROPN,compound-nsubjpass,compound-pobj,NNP-NNP,NNP-NNP,6,1
1706,4059.0,11,freed,6,5,3,-2,4,7,1,-3,Laura Silsby,US,PERSON-PERSON,NATIONALITY,PROPN-PROPN,PROPN,compound-nsubj,compound,NNP-NNP,NNP,1,1
1707,4067.0,30,teaches,16,1,25,24,0,4,15,9,Wayne A. Holst,St. David 's United Church,PERSON-PERSON-PERSON,ORGANIZATION-ORGANIZATION-ORGANIZATION-ORGANIZATION-ORGANIZATION,PROPN-PROPN-PROPN,PROPN-PROPN-PART-PROPN-PROPN,compound-compound-nsubj,compound-poss-case-compound-pobj,NNP-NNP-NNP,NNP-NNP-POS-NNP-NNP,6,1
1708,9455.0,17,teaches,3,1,12,11,0,4,2,9,Wayne A. Holst,St. David 's United Church,PERSON-PERSON-PERSON,ORGANIZATION-ORGANIZATION-ORGANIZATION-ORGANIZATION-ORGANIZATION,PROPN-NOUN-PROPN,PROPN-PROPN-PART-PROPN-PROPN,compound-compound-nsubj,compound-poss-case-compound-pobj,NNP-NN-NNP,NNP-NNP-POS-NNP-NNP,6,1
1709,4071.0,31,acknowledged,16,14,13,-1,13,17,2,-3,Frank Baldino Jr.,executive,PERSON-PERSON-PERSON,TITLE,PROPN-PROPN-PROPN,NOUN,compound-compound-nsubj,compound,NNP-NNP-NNP,NN,2,1
1710,4078.0,52,said,6,10,14,4,9,37,-4,8,Countrywide Financial,nation,ORGANIZATION-ORGANIZATION,COUNTRY,PROPN-PROPN,NOUN,compound-dobj,poss,NNP-NNP,NN,4,1
1711,4081.0,39,said,3,13,6,-7,12,32,-10,3,Countrywide,David E Sambol,ORGANIZATION,PERSON-PERSON-PERSON,PROPN,PROPN-PROPN-PROPN,pobj,compound-compound-nsubj,NNP,NNP-NNP-NNP,3,1
1712,4083.0,36,included,2,7,9,2,6,26,-5,7,her,Lyle,PERSON,PERSON,DET,PROPN,poss,appos,PRP$,NNP,1,1
1713,4086.0,16,trim,3,7,15,8,6,0,-4,12,Professional Ski Instructors of America,1961,ORGANIZATION-ORGANIZATION-ORGANIZATION-ORGANIZATION-ORGANIZATION,DATE,PROPN-PROPN-PROPN-ADP-PROPN,NUM,compound-compound-nsubjpass-prep-pobj,pobj,NNP-NNP-NNP-IN-NNP,CD,3,1
1714,4095.0,39,said,15,25,19,-6,24,19,-10,4,OANA,Organization of Asia-Pacific News Agency,ORGANIZATION,ORGANIZATION-ORGANIZATION-ORGANIZATION-ORGANIZATION-ORGANIZATION,PROPN,PROPN-ADP-PROPN-PROPN-PROPN,compound,npadvmod-prep-compound-compound-pobj,NNP,NNP-IN-NNP-NNP-NNP,4,1
1715,4098.0,34,Said,0,9,13,4,8,20,-9,13,Corporate Library,Maine,ORGANIZATION-ORGANIZATION,STATE_OR_PROVINCE,PROPN-PROPN,PROPN,compound-pobj,npadvmod,NNP-NNP,NNP,3,1
1716,4103.0,38,said,24,10,16,6,9,21,14,-8,Corporate Library,Maine,ORGANIZATION-ORGANIZATION,STATE_OR_PROVINCE,PROPN-PROPN,PROPN,compound-pobj,nmod,NNP-NNP,NNP,3,1
1717,4179.0,28,said,8,16,27,11,15,0,-8,19,Corporate Library,Maine,ORGANIZATION-ORGANIZATION,STATE_OR_PROVINCE,PROPN-PROPN,PROPN,compound-pobj,appos,NNP-NNP,NNP,7,1
1718,6310.0,45,said,22,32,38,6,31,6,-10,16,Corporate Library,Maine,ORGANIZATION-ORGANIZATION,STATE_OR_PROVINCE,PROPN-PROPN,PROPN,compound-pobj,appos,NNP-NNP,NNP,3,1
1719,7989.0,39,said,16,26,32,6,25,6,-10,16,Corporate Library,Maine,ORGANIZATION-ORGANIZATION,STATE_OR_PROVINCE,PROPN-PROPN,PROPN,compound-pobj,npadvmod,NNP-NNP,NNP,4,1
1720,8687.0,50,said,27,37,49,12,36,0,-10,22,Corporate Library,Maine,ORGANIZATION-ORGANIZATION,STATE_OR_PROVINCE,PROPN-PROPN,PROPN,compound-pobj,appos,NNP-NNP,NNP,8,1
1721,9428.0,38,said,24,10,16,6,9,21,14,-8,Corporate Library,Maine,ORGANIZATION-ORGANIZATION,STATE_OR_PROVINCE,PROPN-PROPN,PROPN,compound-pobj,nmod,NNP-NNP,NNP,3,1
1722,9593.0,39,appears,26,3,14,11,2,24,23,-12,Corporate Library,Maine,ORGANIZATION-ORGANIZATION,STATE_OR_PROVINCE,PROPN-PROPN,PROPN,compound-pobj,appos,NNP-NNP,NNP,3,1
1723,11627.0,40,said,19,28,39,11,27,0,-9,20,Corporate Library,Maine,ORGANIZATION-ORGANIZATION,STATE_OR_PROVINCE,PROPN-PROPN,PROPN,compound-pobj,appos,NNP-NNP,NNP,7,1
1724,13847.0,23,is,3,16,20,4,15,2,-13,17,Corporate Library,Maine,ORGANIZATION-ORGANIZATION,STATE_OR_PROVINCE,PROPN-PROPN,PROPN,compound-pobj,compound,NNP-NNP,NNP,4,1
1725,4104.0,43,Map,11,24,17,-7,23,25,-13,6,RocketBoots,Robin Hilliard,ORGANIZATION,PERSON-PERSON,PROPN,PROPN-PROPN,pobj,compound-nsubj,NNP,NNP-NNP,3,1
1726,4106.0,33,com,0,21,26,5,20,6,-21,26,Thai Petrochemical Industry Plc,TPI,ORGANIZATION-ORGANIZATION-ORGANIZATION-ORGANIZATION,ORGANIZATION,PROPN-PROPN-PROPN-PROPN,PROPN,compound-compound-compound-compound,compound,NNP-NNP-NNP-NNP,NNP,-1,1
1727,4118.0,23,served,5,1,10,9,0,12,4,5,Her,Chongqing,PERSON,CITY,DET,PROPN,poss,compound,PRP$,NNP,2,1
1728,4124.0,31,became,4,4,13,9,3,17,0,9,he,Jet Propulsion Laboratory,PERSON,ORGANIZATION-ORGANIZATION-ORGANIZATION,PRON,PROPN-PROPN-PROPN,nsubj,compound-compound-pobj,PRP,NNP-NNP-NNP,4,1
1729,4129.0,28,allowed,2,10,26,16,9,1,-8,24,his,drug trafficking,PERSON,CRIMINAL_CHARGE-CRIMINAL_CHARGE,DET,NOUN-NOUN,poss,compound-pobj,PRP$,NN-NN,9,1
1730,14402.0,28,allowed,2,10,26,16,9,1,-8,24,his,drug trafficking,PERSON,CRIMINAL_CHARGE-CRIMINAL_CHARGE,DET,NOUN-NOUN,poss,compound-pobj,PRP$,NN-NN,9,1
1731,4131.0,79,reported,5,18,21,3,17,57,-13,16,Loose Change,Dylan Avery,ORGANIZATION-ORGANIZATION,PERSON-PERSON,PROPN-PROPN,PROPN-PROPN,compound-compound,compound-dobj,NNP-NNP,NNP-NNP,2,1
1732,4146.0,31,told,9,3,7,4,2,23,6,-2,Graham,Naneek Graham,PERSON,PERSON-PERSON,PROPN,PROPN-PROPN,poss,compound-appos,NNP,NNP-NNP,5,1
1733,4154.0,38,started,14,13,8,-5,12,29,1,-6,New Fabris,Eugene and Quentin Fabris,ORGANIZATION-ORGANIZATION,PERSON-PERSON-PERSON-PERSON,PROPN-PROPN,PROPN-CCONJ-PROPN-PROPN,compound-nsubj,appos-cc-conj-appos,NNP-NNP,NNP-CC-NNP-NNP,6,1
1734,4156.0,47,love,3,27,20,-7,26,26,-24,17,Benjamin Chertoff,editor,PERSON-PERSON,TITLE,PROPN-PROPN,NOUN,compound-attr,dobj,NNP-NNP,NN,2,1
1735,4158.0,28,put,11,16,8,-8,15,19,-5,-3,him,Chongqing,PERSON,CITY,PRON,PROPN,pobj,compound,PRP,NNP,3,1
1736,4161.0,26,faces,10,1,5,4,0,20,9,-5,Graham,Southern Tutchone Indian,PERSON,NATIONALITY-NATIONALITY-NATIONALITY,PROPN,PROPN-PROPN-PROPN,nsubj,compound-compound-appos,NNP,NNP-NNP-NNP,4,1
1737,15080.0,34,charged,10,1,4,3,0,29,9,-6,Graham,Southern Tutchone Indian,PERSON,NATIONALITY-NATIONALITY-NATIONALITY,PROPN,PROPN-PROPN-PROPN,nsubjpass,compound-compound-appos,NNP,NNP-NNP-NNP,3,1
1738,4177.0,45,Forum,2,1,5,4,0,39,1,3,Africa Diaspora Forum,ADF,ORGANIZATION-ORGANIZATION-ORGANIZATION,ORGANIZATION,PROPN-PROPN-PROPN,PROPN,compound-compound-ROOT,compound,NNP-NNP-NNP,NNP,2,1
1739,4182.0,41,Using,0,2,8,6,1,32,-2,8,PSIA,http://siteresources.worldbank.org/INTPSIA/Resources/GPN_August08_fin,ORGANIZATION,URL,NOUN,PROPN,dobj,pobj,NNS,NNP,3,1
1740,4197.0,37,wrote,17,25,16,-9,24,20,-8,-1,Alan P Gross,Judy Gross,PERSON-PERSON-PERSON,PERSON-PERSON,PROPN-PROPN-PROPN,PROPN-PROPN,compound-compound-appos,compound-nsubj,NNP-NNP-NNP,NNP-NNP,7,1
1741,4202.0,26,said,15,22,1,-21,21,24,-7,-14,Bibi,Minister,PERSON,TITLE,PROPN,PROPN,nsubjpass,nmod,NNP,NNP,6,1
1742,4210.0,55,start,23,53,47,-6,52,7,-30,24,NDRC,National Development and Reform Commission,ORGANIZATION,ORGANIZATION-ORGANIZATION-ORGANIZATION-ORGANIZATION-ORGANIZATION,PROPN,PROPN-PROPN-CCONJ-PROPN-PROPN,compound,nmod-nmod-cc-conj-pobj,NNP,NNP-NNP-CC-NNP-NNP,-1,1
1743,6324.0,42,deepen,4,23,17,-6,22,24,-19,13,NDRC,National Development and Reform Commission,ORGANIZATION,ORGANIZATION-ORGANIZATION-ORGANIZATION-ORGANIZATION-ORGANIZATION,PROPN,PROPN-PROPN-CCONJ-PROPN-PROPN,compound,nmod-nmod-cc-conj-pobj,NNP,NNP-NNP-CC-NNP-NNP,6,1
1744,7616.0,23,approved,8,18,12,-6,17,10,-10,4,NDRC,National Development and Reform Commission,ORGANIZATION,ORGANIZATION-ORGANIZATION-ORGANIZATION-ORGANIZATION-ORGANIZATION,PROPN,PROPN-PROPN-CCONJ-PROPN-PROPN,compound,nmod-nmod-cc-conj-pobj,NNP,NNP-NNP-CC-NNP-NNP,-1,1
1745,11276.0,34,said,16,25,19,-6,24,14,-9,3,NDRC,National Development and Reform Commission,ORGANIZATION,ORGANIZATION-ORGANIZATION-ORGANIZATION-ORGANIZATION-ORGANIZATION,PROPN,PROPN-PROPN-CCONJ-PROPN-PROPN,compound,nmod-nmod-cc-conj-nsubj,NNP,NNP-NNP-CC-NNP-NNP,2,1
1746,11971.0,36,was,19,11,5,-6,10,30,8,-14,NDRC,National Development and Reform Commission,ORGANIZATION,ORGANIZATION-ORGANIZATION-ORGANIZATION-ORGANIZATION-ORGANIZATION,PROPN,PROPN-PROPN-CCONJ-PROPN-PROPN,compound,nmod-nmod-cc-conj-pobj,NNP,NNP-NNP-CC-NNP-NNP,4,1
1747,12300.0,33,appointed,19,31,25,-6,30,7,-12,6,NDRC,National Development and Reform Commission,ORGANIZATION,ORGANIZATION-ORGANIZATION-ORGANIZATION-ORGANIZATION-ORGANIZATION,PROPN,PROPN-PROPN-CCONJ-PROPN-PROPN,compound,nmod-nmod-cc-conj-pobj,NNP,NNP-NNP-CC-NNP-NNP,-1,1
1748,13310.0,39,Commission,5,8,2,-6,7,36,-3,-3,NDRC,National Development and Reform Commission,ORGANIZATION,ORGANIZATION-ORGANIZATION-ORGANIZATION-ORGANIZATION-ORGANIZATION,PROPN,PROPN-PROPN-CCONJ-PROPN-PROPN,compound,nmod-nmod-cc-conj-ROOT,NNP,NNP-NNP-CC-NNP-NNP,2,1
1749,13625.0,46,Ministry,2,17,11,-6,16,34,-15,9,NDRC,National Development and Reform Commission,ORGANIZATION,ORGANIZATION-ORGANIZATION-ORGANIZATION-ORGANIZATION-ORGANIZATION,PROPN,PROPN-PROPN-CCONJ-PROPN-PROPN,compound,nmod-nmod-cc-conj-conj,NNP,NNP-NNP-CC-NNP-NNP,-1,1
1750,14040.0,64,Zhenhua,1,16,10,-6,15,53,-15,9,NDRC,National Development and Reform Commission,ORGANIZATION,ORGANIZATION-ORGANIZATION-ORGANIZATION-ORGANIZATION-ORGANIZATION,PROPN,PROPN-PROPN-CCONJ-PROPN-PROPN,compound,nmod-nmod-cc-conj-pobj,NNP,NNP-NNP-CC-NNP-NNP,7,1
1751,14236.0,45,take,5,26,20,-6,25,24,-21,15,NDRC,National Development and Reform Commission,ORGANIZATION,ORGANIZATION-ORGANIZATION-ORGANIZATION-ORGANIZATION-ORGANIZATION,PROPN,PROPN-PROPN-CCONJ-PROPN-PROPN,compound,nmod-nmod-cc-conj-pobj,NNP,NNP-NNP-CC-NNP-NNP,8,1
1752,14879.0,45,said,20,35,29,-6,34,15,-15,9,NDRC,National Development and Reform Commission,ORGANIZATION,ORGANIZATION-ORGANIZATION-ORGANIZATION-ORGANIZATION-ORGANIZATION,PROPN,PROPN-PROPN-CCONJ-PROPN-PROPN,compound,nmod-nmod-cc-conj-pobj,NNP,NNP-NNP-CC-NNP-NNP,-1,1
1753,4214.0,34,been,2,1,20,19,0,13,1,18,She,Eloise Bowles,PERSON,PERSON-PERSON,PRON,PROPN-PROPN,nsubjpass,compound-appos,PRP,NNP-NNP,6,1
1754,4222.0,37,confirmed,31,6,25,19,5,11,25,-6,Chen Tao,June,PERSON-PERSON,DATE,PROPN-PROPN,PROPN,compound-appos,pobj,NNP-NNP,NNP,4,1
1755,4234.0,59,said,42,26,22,-4,25,36,16,-20,HKI,Helen Keller International,ORGANIZATION,ORGANIZATION-ORGANIZATION-ORGANIZATION,PROPN,PROPN-PROPN-PROPN,nsubj,compound-compound-compound,NNP,NNP-NNP-NNP,2,1
1756,13111.0,59,said,42,26,22,-4,25,36,16,-20,HKI,Helen Keller International,ORGANIZATION,ORGANIZATION-ORGANIZATION-ORGANIZATION,PROPN,PROPN-PROPN-PROPN,compound,compound-compound-compound,NNP,NNP-NNP-NNP,2,1
1757,4244.0,24,reported,1,21,13,-8,20,10,-20,12,his,Scientology,PERSON,RELIGION,DET,PROPN,poss,compound,PRP$,NNP,4,1
1758,4246.0,56,served,2,34,1,-33,33,54,-32,-1,Progressive Democrats of America,He,ORGANIZATION-ORGANIZATION-ORGANIZATION-ORGANIZATION,PERSON,PROPN-PROPN-ADP-PROPN,PRON,compound-pobj-prep-pobj,nsubj,NNP-NNPS-IN-NNP,PRP,4,1
1759,4252.0,19,jailed,3,1,10,9,0,8,2,7,She,Punjab,PERSON,STATE_OR_PROVINCE,PRON,PROPN,nsubjpass,pobj,PRP,NNP,2,1
1760,4254.0,38,said,1,28,33,5,27,4,-27,32,Wen Qiang,judicial chief,PERSON-PERSON,TITLE-TITLE,PROPN-PROPN,ADJ-NOUN,compound-pobj,amod-appos,NNP-NNP,JJ-NN,1,1
1761,4286.0,4,was,1,1,3,2,0,0,0,2,He,57,PERSON,NUMBER,PRON,NUM,nsubj,attr,PRP,CD,1,1
1762,4299.0,58,warned,18,29,5,-24,28,52,-11,-13,BedBug Central,Richard,ORGANIZATION-ORGANIZATION,PERSON,PROPN-PROPN,PROPN,compound-dobj,appos,NNP-NNP,NNP,6,1
1763,4303.0,34,said,27,32,29,-3,31,4,-5,2,ShopperTrak,Bill Marti,ORGANIZATION,PERSON-PERSON,PROPN,PROPN-PROPN,compound,compound-nsubj,NNP,NNP-NNP,3,1
1764,4307.0,34,said,11,4,8,4,3,25,7,-3,Central American Parliament,Parlacen,ORGANIZATION-ORGANIZATION-ORGANIZATION,ORGANIZATION,ADJ-ADJ-PROPN,PROPN,compound-compound-pobj,compound,JJ-JJ-NNP,NNP,-1,1
1765,5276.0,42,TEGUCIGALPA,0,34,38,4,33,3,-34,38,Central American Parliament,Parlacen,ORGANIZATION-ORGANIZATION-ORGANIZATION,ORGANIZATION,ADJ-ADJ-PROPN,PROPN,compound-compound-pobj,compound,JJ-JJ-NNP,NNP,4,1
1766,4315.0,28,scheduled,19,6,9,3,5,18,13,-10,Huntington Library,Steven Koblik,ORGANIZATION-ORGANIZATION,PERSON-PERSON,PROPN-PROPN,PROPN-PROPN,compound-compound,compound-pobj,NNP-NNP,NNP-NNP,2,1
1767,4321.0,9,died,1,4,5,1,3,3,-3,4,his,injuries,PERSON,CAUSE_OF_DEATH,DET,NOUN,poss,pobj,PRP$,NNS,5,1
1768,4332.0,31,turns,1,19,17,-2,18,13,-18,16,Samudio,homicide,PERSON,CAUSE_OF_DEATH,PROPN,NOUN,pobj,conj,NNP,NN,9,1
1769,4335.0,30,is,16,1,6,5,0,23,15,-10,Bamba,ambassador,PERSON,TITLE,PROPN,NOUN,nsubj,attr,NNP,NN,4,1
1770,7341.0,26,was,7,1,12,11,0,13,6,5,Bamba,ambassador,PERSON,TITLE,PROPN,NOUN,nsubj,attr,NNP,NN,5,1
1771,4337.0,28,received,14,5,3,-2,4,24,9,-11,China Charity Federation,1994,ORGANIZATION-ORGANIZATION-ORGANIZATION,DATE,PROPN-PROPN-PROPN,NUM,compound-compound-nsubj,pobj,NNP-NNP-NNP,CD,3,1
1772,4343.0,24,reading,11,22,21,-1,21,2,-11,10,Christopher Bollyn,journalist,PERSON-PERSON,TITLE,PROPN-PROPN,NOUN,compound-pobj,compound,NNP-NNP,NN,1,1
1773,6681.0,22,is,2,1,7,6,0,14,1,5,Christopher Bollyn,journalist,PERSON-PERSON,TITLE,PROPN-PROPN,NOUN,compound-nsubj,attr,NNP-NNP,NN,3,1
1774,4349.0,39,showed,4,21,25,4,20,13,-17,21,Charles Ble Goude,leader,PERSON-PERSON-PERSON,TITLE,PROPN-PROPN-PROPN,NOUN,compound-compound-nsubj,appos,NNP-NNP-NNP,NN,2,1
1775,11386.0,25,oppose,3,20,19,-1,19,5,-17,16,Charles Ble Goude,leader,PERSON-PERSON-PERSON,TITLE,PROPN-PROPN-PROPN,NOUN,compound-compound-appos,nsubj,NNP-NNP-NNP,NN,2,1
1776,14608.0,34,included,1,16,21,5,15,12,-15,20,Charles Ble Goude,leader,PERSON-PERSON-PERSON,TITLE,PROPN-PROPN-PROPN,NOUN,compound-compound-conj,appos,NNP-NNP-NNP,NN,3,1
1777,4351.0,52,said,15,14,1,-13,13,50,1,-14,NDRC,Chen Deming,ORGANIZATION,PERSON-PERSON,PROPN,PROPN-PROPN,compound,compound-nsubj,NNP,NNP-NNP,1,1
1778,4354.0,32,says,1,27,7,-20,26,24,-26,6,ALICO,US,ORGANIZATION,COUNTRY,PROPN,PROPN,compound,compound,NNP,NNP,7,1
1779,9909.0,45,announced,15,29,10,-19,28,34,-14,-5,ALICO,US,ORGANIZATION,COUNTRY,PROPN,PROPN,appos,compound,NNP,NNP,6,1
1780,11505.0,54,says,5,10,25,15,9,28,-5,20,ALICO,US,ORGANIZATION,COUNTRY,PROPN,PROPN,compound,compound,NNP,NNP,-1,1
1781,4362.0,42,born,4,1,12,11,0,29,3,8,Andrew E. Lange,"July 23 , 1957",PERSON-PERSON-PERSON,DATE-DATE-DATE-DATE,PROPN-PROPN-PROPN,PROPN-NUM-PUNCT-NUM,compound-compound-nsubjpass,pobj-nummod-punct-nummod,NNP-NNP-NNP,"NNP-CD-,-CD",5,1
1782,4365.0,31,became,4,4,21,17,3,9,0,17,he,Caltech,PERSON,ORGANIZATION,PRON,PROPN,nsubj,poss,PRP,NNP,6,1
1783,4366.0,15,is,1,1,11,10,0,3,0,10,Cerniglia,Gallagher 's Steakhouse,PERSON,ORGANIZATION-ORGANIZATION-ORGANIZATION,PROPN,PROPN-PART-PROPN,nsubj,poss-case-compound,NNP,NNP-POS-NNP,4,1
1784,4368.0,21,served,3,1,14,13,0,6,2,11,Wayne A. Holst,president,PERSON-PERSON-PERSON,TITLE,PROPN-PROPN-PROPN,NOUN,compound-compound-nsubj,pobj,NNP-NNP-NNP,NN,5,1
1785,4380.0,28,was,1,1,6,5,0,21,0,5,Xie,Wen Qiang,PERSON,PERSON-PERSON,PROPN,PROPN-PROPN,nsubj,compound-pobj,NNP,NNP-NNP,3,1
1786,4386.0,21,interviewed,2,14,13,-1,13,7,-12,11,Corporate Library,Maine-based,ORGANIZATION-ORGANIZATION,STATE_OR_PROVINCE,PROPN-PROPN,PROPN,compound-appos,amod,NNP-NNP,NNP,4,1
1787,7461.0,55,says,17,10,9,-1,9,45,7,-8,Corporate Library,Maine-based,ORGANIZATION-ORGANIZATION,STATE_OR_PROVINCE,PROPN-PROPN,PROPN,compound-conj,amod,NNP-NNP,NNP,4,1
1788,4387.0,34,worked,4,9,19,10,8,14,-5,15,United Association for Studies and Research,UASR,ORGANIZATION-ORGANIZATION-ORGANIZATION-ORGANIZATION-ORGANIZATION-ORGANIZATION,ORGANIZATION,PROPN-PROPN-ADP-PROPN-CCONJ-PROPN,PROPN,compound-pobj-prep-pobj-cc-conj,compound,NNP-NNP-IN-NNPS-CC-NNP,NNP,-1,1
1789,13913.0,34,worked,4,9,19,10,8,14,-5,15,United Association for Studies and Research,UASR,ORGANIZATION-ORGANIZATION-ORGANIZATION-ORGANIZATION-ORGANIZATION-ORGANIZATION,ORGANIZATION,PROPN-PROPN-ADP-PROPN-CCONJ-PROPN,PROPN,compound-pobj-prep-pobj-cc-conj,compound,NNP-NNP-IN-NNPS-CC-NNP,NNP,4,1
1790,4397.0,38,explained,15,11,7,-4,10,30,4,-8,Jupp,scientists,PERSON,TITLE,PROPN,NOUN,nsubj,nsubj,NNP,NNS,2,1
1791,4405.0,51,made,9,12,48,36,11,2,-3,39,Alan P. Gross,Cuba,PERSON-PERSON-PERSON,COUNTRY,PROPN-PROPN-PROPN,PROPN,compound-compound-pobj,poss,NNP-NNP-NNP,NNP,11,1
1792,4408.0,51,is,1,26,33,7,25,17,-25,32,Mark Fisher,New York City,PERSON-PERSON,CITY-CITY-CITY,PROPN-PROPN,PROPN-PROPN-PROPN,compound-pobj,compound-compound-pobj,NNP-NNP,NNP-NNP-NNP,3,1
1793,13882.0,48,was,7,16,42,26,15,5,-9,35,Mark Fisher,New York City,PERSON-PERSON,CITY-CITY-CITY,PROPN-PROPN,PROPN-PROPN-PROPN,compound-dobj,compound-compound-pobj,NNP-NNP,NNP-NNP-NNP,6,1
1794,4420.0,6,Press,2,1,5,4,0,0,1,3,American Free Press,www.americanfreepress.net,ORGANIZATION-ORGANIZATION-ORGANIZATION,URL,PROPN-PROPN-PROPN,NOUN,compound-compound-ROOT,appos,NNP-NNP-NNP,NN,2,1
1795,4423.0,10,died,2,5,2,-3,4,7,-3,0,his,46-year-old,PERSON,DURATION,DET,NUM,poss,nsubj,PRP$,CD,2,1
1796,4425.0,34,see,6,22,30,8,21,3,-16,24,National Development and Reform Commission,Ma Kai,ORGANIZATION-ORGANIZATION-ORGANIZATION-ORGANIZATION-ORGANIZATION,PERSON-PERSON,PROPN-PROPN-CCONJ-PROPN-PROPN,PROPN-PROPN,nmod-nmod-cc-conj-appos,compound-nsubj,NNP-NNP-CC-NNP-NNP,NNP-NNP,-1,1
1797,4426.0,39,Yusuf,2,19,1,-18,18,37,-17,-1,Organization of Asia Pacific News Agencies,Ahmad Mukhlis Yusuf,ORGANIZATION-ORGANIZATION-ORGANIZATION-ORGANIZATION-ORGANIZATION-ORGANIZATION,PERSON-PERSON-PERSON,PROPN-ADP-PROPN-PROPN-PROPN-PROPN,PROPN-PROPN-PROPN,pobj-prep-compound-compound-compound-pobj,compound-compound-ROOT,NNP-IN-NNP-NNP-NNP-NNPS,NNP-NNP-NNP,6,1
1798,4435.0,46,said,44,1,3,2,0,42,43,-41,Xie,46,PERSON,NUMBER,PROPN,NUM,nsubj,appos,NNP,CD,3,1
1799,4448.0,34,--,0,6,7,1,5,26,-6,7,Edub9,wwwscrapblogcom,ORGANIZATION,URL,PROPN,NOUN,compound,ROOT,NNP,NN,-1,1
1800,4458.0,52,said,42,45,35,-10,44,16,-3,-7,NDA,UK,ORGANIZATION,COUNTRY,PROPN,PROPN,poss,poss,NNP,NNP,6,1
1801,4462.0,27,died,5,1,25,24,0,1,4,20,Assaf Ramon,West Bank,PERSON-PERSON,LOCATION-LOCATION,PROPN-PROPN,PROPN-PROPN,compound-nsubj,compound-pobj,NNP-NNP,NNP-NNP,8,1
1802,4465.0,48,CHONGQING,0,20,44,24,19,3,-20,44,She,giving bribes to officials,PERSON,CRIMINAL_CHARGE-CRIMINAL_CHARGE-CRIMINAL_CHARGE-CRIMINAL_CHARGE,PRON,VERB-NOUN-ADP-NOUN,nsubjpass,conj-dobj-dative-pobj,PRP,VBG-NNS-IN-NNS,-1,1
1803,4478.0,35,said,20,16,6,-10,15,28,4,-14,National Energy Administration,Sun Qin,ORGANIZATION-ORGANIZATION-ORGANIZATION,PERSON-PERSON,PROPN-PROPN-PROPN,PROPN-PROPN,compound-compound-pobj,compound-pobj,NNP-NNP-NNP,NNP-NNP,2,1
1804,6074.0,45,said,26,35,28,-7,34,16,-9,2,National Energy Administration,Sun Qin,ORGANIZATION-ORGANIZATION-ORGANIZATION,PERSON-PERSON,PROPN-PROPN-PROPN,PROPN-PROPN,compound-compound-pobj,compound-nsubj,NNP-NNP-NNP,NNP-NNP,5,1
1805,9941.0,56,appointed,13,8,1,-7,7,54,5,-12,National Energy Administration,Sun Qin,ORGANIZATION-ORGANIZATION-ORGANIZATION,PERSON-PERSON,PROPN-PROPN-PROPN,PROPN-PROPN,compound-compound-pobj,compound-nsubjpass,NNP-NNP-NNP,NNP-NNP,4,1
1806,10928.0,64,BEIJING,0,16,9,-7,15,54,-16,9,National Energy Administration,Sun Qin,ORGANIZATION-ORGANIZATION-ORGANIZATION,PERSON-PERSON,PROPN-PROPN-PROPN,PROPN-PROPN,compound-compound-pobj,compound-appos,NNP-NNP-NNP,NNP-NNP,4,1
1807,12109.0,52,BEIJING,0,42,35,-7,41,16,-42,35,National Energy Administration,Sun Qin,ORGANIZATION-ORGANIZATION-ORGANIZATION,PERSON-PERSON,PROPN-PROPN-PROPN,PROPN-PROPN,compound-compound-pobj,compound-nsubj,NNP-NNP-NNP,NNP-NNP,5,1
1808,13476.0,53,close,5,47,40,-7,46,12,-42,35,National Energy Administration,Sun Qin,ORGANIZATION-ORGANIZATION-ORGANIZATION,PERSON-PERSON,PROPN-PROPN-PROPN,PROPN-PROPN,compound-compound-pobj,compound-nsubj,NNP-NNP-NNP,NNP-NNP,4,1
1809,4503.0,11,knew,1,1,4,3,0,6,0,3,She,recruiter,PERSON,TITLE,PRON,NOUN,nsubj,dobj,PRP,NN,1,1
1810,4507.0,31,jumped,14,2,26,24,1,4,12,12,chef,New York,PERSON,STATE_OR_PROVINCE-STATE_OR_PROVINCE,NOUN,PROPN-PROPN,nsubj,compound-dobj,NN,NNP-NNP,8,1
1811,4510.0,31,given,3,15,29,14,14,1,-12,26,Jamie Leigh Jones,United States,PERSON-PERSON-PERSON,COUNTRY-COUNTRY,PROPN-PROPN-PROPN,PROPN-PROPN,compound-compound-pobj,compound-pobj,NNP-NNP-NNP,NNP-NNP,4,1
1812,4522.0,32,YORK,1,11,24,13,10,7,-10,23,Cerniglia,commit suicide,PERSON,CAUSE_OF_DEATH-CAUSE_OF_DEATH,PROPN,VERB-NOUN,nsubj,acl-dobj,NNP,VB-NN,3,1
1813,4526.0,18,know,1,7,13,6,6,4,-6,12,him,NWO,PERSON,ORGANIZATION,PRON,PROPN,pobj,nsubj,PRP,NNP,2,1
1814,4529.0,43,said,32,17,15,-2,16,27,15,-17,worker,red cross,PERSON,ORGANIZATION-ORGANIZATION,NOUN,ADJ-NOUN,pobj,amod-compound,NN,JJ-NN,6,1
1815,4532.0,31,Bio,2,5,14,9,4,16,-3,12,Wayne A. Holst,University of Calgary,PERSON-PERSON-PERSON,ORGANIZATION-ORGANIZATION-ORGANIZATION,PROPN-NOUN-PROPN,PROPN-ADP-PROPN,compound-compound-nsubj,pobj-prep-pobj,NNP-NN-NNP,NNP-IN-NNP,5,1
1816,4649.0,30,teaches,16,1,20,19,0,9,15,4,Wayne A. Holst,University of Calgary,PERSON-PERSON-PERSON,ORGANIZATION-ORGANIZATION-ORGANIZATION,PROPN-PROPN-PROPN,PROPN-ADP-PROPN,compound-compound-nsubj,pobj-prep-pobj,NNP-NNP-NNP,NNP-IN-NNP,5,1
1817,5916.0,17,teaches,3,1,7,6,0,9,2,4,Wayne A. Holst,University of Calgary,PERSON-PERSON-PERSON,ORGANIZATION-ORGANIZATION-ORGANIZATION,PROPN-NOUN-PROPN,PROPN-ADP-PROPN,compound-compound-nsubj,pobj-prep-pobj,NNP-NN-NNP,NNP-IN-NNP,5,1
1818,9445.0,27,Bio,2,5,15,10,4,11,-3,13,Wayne A. Holst,University of Calgary,PERSON-PERSON-PERSON,ORGANIZATION-ORGANIZATION-ORGANIZATION,PROPN-PROPN-PROPN,PROPN-ADP-PROPN,compound-compound-nsubj,pobj-prep-pobj,NNP-NNP-NNP,NNP-IN-NNP,7,1
1819,13898.0,19,teaches,3,1,7,6,0,11,2,4,Wayne A. Holst,University of Calgary,PERSON-PERSON-PERSON,ORGANIZATION-ORGANIZATION-ORGANIZATION,PROPN-NOUN-PROPN,PROPN-ADP-PROPN,compound-compound-nsubj,pobj-prep-pobj,NNP-NN-NNP,NNP-IN-NNP,5,1
1820,4533.0,43,working,15,9,7,-2,8,35,6,-8,National Development and Reform Commission,Cabinet,ORGANIZATION-ORGANIZATION-ORGANIZATION-ORGANIZATION-ORGANIZATION,ORGANIZATION,PROPN-PROPN-CCONJ-PROPN-PROPN,PROPN,nmod-nmod-cc-conj-appos,poss,NNP-NNP-CC-NNP-NNP,NNP,3,1
1821,10814.0,34,said,32,28,26,-2,27,7,4,-6,National Development and Reform Commission,Cabinet,ORGANIZATION-ORGANIZATION-ORGANIZATION-ORGANIZATION-ORGANIZATION,ORGANIZATION,PROPN-PROPN-CCONJ-PROPN-PROPN,PROPN,nmod-nmod-cc-conj-nsubj,poss,NNP-NNP-CC-NNP-NNP,NNP,3,1
1822,4534.0,45,said,34,21,7,-14,20,37,13,-27,Wen Qiang,Xie Caiping,PERSON-PERSON,PERSON-PERSON,PROPN-PROPN,PROPN-PROPN,compound-appos,compound-pobj,NNP-NNP,NNP-NNP,7,1
1823,7662.0,34,detained,3,1,19,18,0,14,2,16,Wen Qiang,Xie Caiping,PERSON-PERSON,PERSON-PERSON,PROPN-PROPN,PROPN-PROPN,compound-nsubjpass,compound-npadvmod,NNP-NNP,NNP-NNP,10,1
1824,4541.0,32,said,30,24,20,-4,23,11,6,-10,ADF,Allied Democratic Forces,ORGANIZATION,ORGANIZATION-ORGANIZATION-ORGANIZATION,PROPN,PROPN-ADJ-PROPN,compound,compound-compound-compound,NNP,NNP-JJ-NNPS,2,1
1825,4552.0,35,set,9,1,19,18,0,15,8,10,OANA,UN,ORGANIZATION,ORGANIZATION,PROPN,PROPN,nsubjpass,nmod,NNP,NNP,8,1
1826,4554.0,25,is,1,11,5,-6,10,19,-10,4,he,European,PERSON,NATIONALITY,PRON,ADJ,nsubj,amod,PRP,JJ,2,1
1827,4568.0,43,said,30,32,35,3,31,7,-2,5,Chen Tao,chairman,PERSON-PERSON,TITLE,PROPN-PROPN,NOUN,compound-nsubj,appos,NNP-NNP,NN,2,1
1828,4571.0,31,is,13,1,4,3,0,26,12,-9,Asia Bibi,45,PERSON-PERSON,NUMBER,PROPN-PROPN,NUM,compound-nsubj,appos,NNP-NNP,CD,1,1
1829,7209.0,50,LAHORE,0,12,15,3,11,34,-12,15,Asia Bibi,45,PERSON-PERSON,NUMBER,PROPN-PROPN,NUM,compound-nsubjpass,appos,NNP-NNP,CD,2,1
1830,4581.0,48,was,7,16,46,30,15,1,-9,39,Mark Fisher,October 2003,PERSON-PERSON,DATE-DATE,PROPN-PROPN,PROPN-NUM,compound-dobj,pobj-nummod,NNP-NNP,NNP-CD,10,1
1831,4583.0,24,carried,5,22,9,-13,21,14,-17,4,Messina Denaro,Trapani,PERSON-PERSON,CITY,PROPN-PROPN,PROPN,compound-pobj,pobj,NNP-NNP,NNP,7,1
1832,4600.0,14,is,1,3,10,7,2,3,-2,9,her,Jewish,PERSON,RELIGION,DET,ADJ,poss,amod,PRP$,JJ,5,1
1833,4615.0,21,insisted,12,1,6,5,0,14,11,-6,Laura Silsby,New Life Children 's Refuge,PERSON-PERSON,ORGANIZATION-ORGANIZATION-ORGANIZATION-ORGANIZATION-ORGANIZATION,PROPN-PROPN,PROPN-PROPN-PROPN-PART-PROPN,compound-nsubj,compound-compound-poss-case-pobj,NNP-NNP,NNP-NNP-NNP-POS-NNP,5,1
1834,6270.0,56,was,31,1,7,6,0,48,30,-24,Laura Silsby,New Life Children 's Refuge,PERSON-PERSON,ORGANIZATION-ORGANIZATION-ORGANIZATION-ORGANIZATION-ORGANIZATION,PROPN-PROPN,PROPN-PROPN-PROPN-PART-PROPN,compound-nsubj,compound-compound-poss-case-pobj,NNP-NNP,NNP-NNP-NNP-POS-NNP,5,1
1835,7721.0,23,insisted,14,1,8,7,0,14,13,-6,Laura Silsby,New Life Children 's Refuge,PERSON-PERSON,ORGANIZATION-ORGANIZATION-ORGANIZATION-ORGANIZATION-ORGANIZATION,PROPN-PROPN,PROPN-PROPN-PROPN-PART-PROPN,compound-nsubj,compound-compound-poss-case-pobj,NNP-NNP,NNP-NNP-NNP-POS-NNP,5,1
1836,9785.0,26,insisted,15,1,10,9,0,15,14,-5,Laura Silsby,New Life Children 's Refuge,PERSON-PERSON,ORGANIZATION-ORGANIZATION-ORGANIZATION-ORGANIZATION-ORGANIZATION,PROPN-PROPN,PROPN-PROPN-PROPN-PART-PROPN,compound-nsubj,compound-compound-poss-case-oprd,NNP-NNP,NNP-NNP-NNP-POS-NNP,4,1
1837,4623.0,30,said,26,1,12,11,0,17,25,-14,Ruben,Enzo,PERSON,PERSON,PROPN,PROPN,nsubj,appos,NNP,NNP,5,1
1838,6199.0,30,said,5,7,29,22,6,0,-2,24,Ruben,Enzo,PERSON,PERSON,PROPN,PROPN,nsubj,ROOT,NNP,NNP,3,1
1839,6252.0,53,Hague,1,39,46,7,38,6,-38,45,Ruben,Enzo,PERSON,PERSON,PROPN,PROPN,appos,appos,NNP,NNP,2,1
1840,13864.0,41,said,5,7,40,33,6,0,-2,35,Ruben,Enzo,PERSON,PERSON,PROPN,PROPN,nsubj,conj,NNP,NNP,2,1
1841,4626.0,30,see,1,3,10,7,2,19,-2,9,Heloise,Texas State University,PERSON,ORGANIZATION-ORGANIZATION-ORGANIZATION,PROPN,PROPN-PROPN-PROPN,nsubj,compound-compound-pobj,NNP,NNP-NNP-NNP,4,1
1842,4629.0,38,found,7,13,5,-8,12,32,-6,-2,her,London,PERSON,CITY,DET,PROPN,poss,pobj,PRP$,NNP,4,1
1843,4651.0,20,show,12,7,18,11,6,1,5,6,George Sodini,Pittsburgh,PERSON-PERSON,CITY,PROPN-PROPN,PROPN,compound-pobj,compound,NNP-NNP,NNP,6,1
1844,4663.0,7,Congress,1,1,7,6,0,-1,0,6,National Congress of American Indians,http://www.ncai.org/,ORGANIZATION-ORGANIZATION-ORGANIZATION-ORGANIZATION-ORGANIZATION,URL,PROPN-PROPN-ADP-PROPN-PROPN,ADJ,compound-ROOT-prep-compound-pobj,appos,NNP-NNP-IN-NNP-NNPS,JJ,-1,1
1845,4683.0,27,MANAGUA,0,8,17,9,7,9,-8,17,PARLACEN,Guatemala City,ORGANIZATION,CITY-CITY,PROPN,PROPN-PROPN,nsubjpass,compound-pobj,NNP,NNP-NNP,5,1
1846,4696.0,35,said,25,27,31,4,26,3,-2,6,John Graham,Duke University,PERSON-PERSON,ORGANIZATION-ORGANIZATION,PROPN-PROPN,PROPN-PROPN,compound-nsubj,compound-compound,NNP-NNP,NNP-NNP,4,1
1847,4701.0,35,said,2,23,20,-3,22,14,-21,18,Silsby,missionary,PERSON,TITLE,PROPN,NOUN,appos,amod,NNP,NN,2,1
1848,4711.0,16,discovered,5,1,12,11,0,3,4,7,Daniels,Pentecostal,PERSON,RELIGION,PROPN,PROPN,poss,amod,NNP,NNP,5,1
1849,4714.0,16,is,4,1,3,2,0,12,3,-1,Bibi,45,PERSON,NUMBER,PROPN,NUM,nsubj,appos,NNP,CD,3,1
1850,4730.0,19,were,16,3,12,9,2,6,13,-4,Koch Foods,Park Ridge,ORGANIZATION-ORGANIZATION,CITY-CITY,PROPN-PROPN,PROPN-PROPN,compound-pobj,compound-pobj,NNP-NNP,NNP-NNP,7,1
1851,4731.0,58,were,11,35,53,18,34,4,-24,42,Wen Qiang,corruption,PERSON-PERSON,CRIMINAL_CHARGE,PROPN-PROPN,NOUN,compound-conj,compound,NNP-NNP,NN,8,1
1852,13526.0,23,convicted,15,1,18,17,0,4,14,3,Wen Qiang,corruption,PERSON-PERSON,CRIMINAL_CHARGE,PROPN-PROPN,NOUN,compound-nsubjpass,compound,NNP-NNP,NN,3,1
1853,4746.0,32,boast,12,1,7,6,0,24,11,-5,Adela Dworin,Jewish,PERSON-PERSON,RELIGION,PROPN-PROPN,ADJ,compound-nsubj,amod,NNP-NNP,JJ,3,1
1854,5455.0,51,said,12,1,9,8,0,41,11,-3,Adela Dworin,Jewish,PERSON-PERSON,RELIGION,PROPN-PROPN,ADJ,compound-nsubj,amod,NNP-NNP,JJ,4,1
1855,6099.0,31,said,11,13,27,14,12,3,-2,16,Adela Dworin,Jewish,PERSON-PERSON,RELIGION,PROPN-PROPN,ADJ,compound-nsubj,amod,NNP-NNP,JJ,4,1
1856,12211.0,50,told,22,1,15,14,0,34,21,-7,Adela Dworin,Jewish,PERSON-PERSON,RELIGION,PROPN-PROPN,ADJ,compound-nsubj,amod,NNP-NNP,JJ,5,1
1857,12717.0,32,boast,12,1,7,6,0,24,11,-5,Adela Dworin,Jewish,PERSON-PERSON,RELIGION,PROPN-PROPN,ADJ,compound-nsubj,amod,NNP-NNP,JJ,3,1
1858,13719.0,33,said,13,15,29,14,14,3,-2,16,Adela Dworin,Jewish,PERSON-PERSON,RELIGION,PROPN-PROPN,ADJ,compound-nsubj,amod,NNP-NNP,JJ,6,1
1859,4756.0,36,is,1,32,27,-5,31,8,-31,26,Progressive Democrats of America,Wisconsin,ORGANIZATION-ORGANIZATION-ORGANIZATION-ORGANIZATION,STATE_OR_PROVINCE,PROPN-PROPN-ADP-PROPN,PROPN,compound-pobj-prep-pobj,compound,NNP-NNPS-IN-NNP,NNP,3,1
1860,4769.0,43,says,29,38,31,-7,37,11,-9,2,National Development and Reform Commission,Wu Shulin,ORGANIZATION-ORGANIZATION-ORGANIZATION-ORGANIZATION-ORGANIZATION,PERSON-PERSON,PROPN-PROPN-CCONJ-PROPN-PROPN,PROPN-PROPN,nmod-nmod-cc-conj-pobj,compound-nsubj,NNP-NNP-CC-NNP-NNP,NNP-NNP,4,1
1861,4776.0,50,said,4,12,32,20,11,17,-8,28,Countrywide Financial,U.S.,ORGANIZATION-ORGANIZATION,COUNTRY,PROPN-PROPN,PROPN,compound-dobj,poss,NNP-NNP,NNP,6,1
1862,4786.0,29,advocated,1,1,5,4,0,23,0,4,Rashid,assault,PERSON,CRIMINAL_CHARGE,NOUN,NOUN,nsubj,dobj,NN,NN,1,1
1863,4788.0,16,told,5,8,5,-3,7,10,-3,0,she,Clearwater,PERSON,CITY,PRON,PROPN,nsubj,pobj,PRP,NNP,2,1
1864,4799.0,27,sentenced,17,25,9,-16,24,17,-8,-8,his,29,PERSON,NUMBER,DET,NUM,poss,appos,PRP$,CD,7,1
1865,4801.0,48,included,4,32,16,-16,31,31,-28,12,architect Richard Gage,founder of ae911truthorg,PERSON-PERSON-PERSON,TITLE-TITLE-TITLE,NOUN-PROPN-PROPN,NOUN-ADP-PROPN,compound-compound-ROOT,appos-prep-pobj,NN-NNP-NNP,NN-IN-NNP,4,1
1866,4809.0,37,reports,35,25,14,-11,24,22,10,-21,National Restaurant Association,Herman Cain,ORGANIZATION-ORGANIZATION-ORGANIZATION,PERSON-PERSON,PROPN-PROPN-PROPN,PROPN-PROPN,compound-compound-pobj,compound-nsubj,NNP-NNP-NNP,NNP-NNP,7,1
1867,6961.0,19,contradicts,5,8,4,-4,7,14,-3,-1,National Restaurant Association,Herman Cain,ORGANIZATION-ORGANIZATION-ORGANIZATION,PERSON-PERSON,PROPN-PROPN-PROPN,PROPN-PROPN,compound-compound-compound,compound-nsubj,NNP-NNP-NNP,NNP-NNP,4,1
1868,4810.0,24,see,15,4,13,9,3,10,11,-2,her,he,PERSON,PERSON,PRON,PRON,poss,nsubj,PRP,PRP,6,1
1869,14343.0,24,see,15,4,13,9,3,10,11,-2,her,he,PERSON,PERSON,DET,PRON,poss,nsubj,PRP$,PRP,6,1
1870,4813.0,24,said,13,22,15,-7,21,8,-9,2,Urban League,Darwin Davis,ORGANIZATION-ORGANIZATION,PERSON-PERSON,PROPN-PROPN,PROPN-PROPN,compound-pobj,compound-nsubj,NNP-NNP,NNP-NNP,5,1
1871,4844.0,46,managed,6,33,1,-32,32,44,-27,-5,Countrywide,Wachovia,ORGANIZATION,ORGANIZATION,PROPN,PROPN,conj,poss,NNP,NNP,4,1
1872,4851.0,54,fell,6,46,50,4,45,3,-40,44,Countrywide Financial,BofA,ORGANIZATION-ORGANIZATION,ORGANIZATION,PROPN-PROPN,PROPN,compound-pobj,nsubj,NNP-NNP,NNP,1,1
1873,10534.0,55,were,1,47,51,4,46,3,-46,50,Countrywide Financial,BofA,ORGANIZATION-ORGANIZATION,PERSON,PROPN-PROPN,PROPN,compound-pobj,nsubj,NNP-NNP,NNP,1,1
1874,4864.0,27,named,11,1,9,8,0,17,10,-2,Pauliina Miettinen,Finaland,PERSON-PERSON,COUNTRY,PROPN-PROPN,PROPN,compound-nsubjpass,pobj,NNP-NNP,NNP,2,1
1875,4870.0,21,was,1,15,7,-8,14,13,-14,6,ADF,Alain Ducasse,ORGANIZATION,PERSON-PERSON,PROPN,PROPN-PROPN,npadvmod,compound-poss,NNP,NNP-NNP,4,1
1876,4884.0,32,dismissed,8,6,30,24,5,1,2,22,Graham,Canadian,PERSON,NATIONALITY,PROPN,ADJ,nsubj,amod,NNP,JJ,5,1
1877,4894.0,33,held,17,4,11,7,3,21,13,-6,Shah Abdul Aziz,Pakistan,PERSON-PERSON-PERSON,COUNTRY,PROPN-PROPN-PROPN,PROPN,compound-compound-appos,poss,NNP-NNP-NNP,NNP,6,1
1878,13522.0,41,Warsaw,0,10,17,7,9,23,-10,17,Shah Abdul Aziz,Pakistan,PERSON-PERSON-PERSON,COUNTRY,PROPN-PROPN-PROPN,PROPN,compound-compound-nsubjpass,pobj,NNP-NNP-NNP,NNP,3,1
1879,15044.0,34,condemned,6,4,33,29,3,0,2,27,Shah Abdul Aziz,Pakistan,PERSON-PERSON-PERSON,COUNTRY,PROPN-PROPN-PROPN,PROPN,compound-compound-nsubj,pobj,NNP-NNP-NNP,NNP,3,1
1880,4913.0,62,shows,24,34,27,-7,33,34,-10,3,Progressive Democrats of America,Mimi Kennedy,ORGANIZATION-ORGANIZATION-ORGANIZATION-ORGANIZATION,PERSON-PERSON,PROPN-PROPN-ADP-PROPN,PROPN-PROPN,compound-pobj-prep-pobj,compound-nsubj,NNP-NNPS-IN-NNP,NNP-NNP,5,1
1881,4917.0,42,believe,9,3,6,3,2,35,6,-3,Corporate Library,Minow,ORGANIZATION-ORGANIZATION,PERSON,PROPN-PROPN,PROPN,compound-poss,nsubj,NNP-NNP,NNP,2,1
1882,4923.0,31,gave,12,19,10,-9,18,20,-7,-2,he,ambassador,PERSON,TITLE,PRON,NOUN,nsubj,nsubj,PRP,NN,3,1
1883,5270.0,33,said,16,19,24,5,18,8,-3,8,he,ambassador,PERSON,TITLE,PRON,NOUN,nsubjpass,oprd,PRP,NN,3,1
1884,10446.0,42,said,10,12,6,-6,11,35,-2,-4,he,ambassador,PERSON,TITLE,PRON,NOUN,nsubj,nsubj,PRP,NN,3,1
1885,4936.0,12,is,6,4,9,5,3,2,2,3,Brad Hagemo,optometrist,PERSON-PERSON,TITLE,PROPN-PROPN,NOUN,compound-appos,attr,NNP-NNP,NN,4,1
1886,4945.0,25,been,4,24,17,-7,23,7,-20,13,Alico,American Life Insurance Co,ORGANIZATION,ORGANIZATION-ORGANIZATION-ORGANIZATION-ORGANIZATION,PROPN,PROPN-PROPN-PROPN-PROPN,pobj,compound-compound-compound-pobj,NNP,NNP-NNP-NNP-NNP,11,1
1887,5686.0,40,said,38,22,14,-8,21,25,16,-24,Alico,American Life Insurance Co,ORGANIZATION,ORGANIZATION-ORGANIZATION-ORGANIZATION-ORGANIZATION,PROPN,PROPN-PROPN-PROPN-PROPN,pobj,compound-compound-compound-dobj,NNP,NNP-NNP-NNP-NNP,4,1
1888,4947.0,27,said,15,17,21,4,16,5,-2,6,Mark Fisher,curator,PERSON-PERSON,TITLE,PROPN-PROPN,NOUN,compound-nsubj,appos,NNP-NNP,NN,2,1
1889,4958.0,43,is,10,1,4,3,0,38,9,-6,Sycamore,Chelmsford,PERSON,CITY,PROPN,PROPN,nsubj,compound,NNP,NNP,2,1
1890,6548.0,33,charged,6,8,16,8,7,16,-2,10,Sycamore,Chelmsford,PERSON,CITY,PROPN,PROPN,dobj,pobj,NNP,NNP,2,1
1891,4967.0,35,survives,1,27,21,-6,26,13,-26,20,William A. Lange,Lange,PERSON-PERSON-PERSON,PERSON,PROPN-PROPN-PROPN,PROPN,compound-compound-conj,nsubj,NNP-NNP-NNP,NNP,3,1
1892,4968.0,31,Festival,4,13,2,-11,12,28,-9,-2,NTSO,2007 International Music Festival,ORGANIZATION,ORGANIZATION-ORGANIZATION-ORGANIZATION-ORGANIZATION,PROPN,NUM-PROPN-PROPN-PROPN,compound,nummod-compound-compound-ROOT,NNP,CD-NNP-NNP-NNP,-1,1
1893,4978.0,33,said,16,28,18,-10,27,14,-12,2,National Congress of American Indians,Heather Dawn Thompson,ORGANIZATION-ORGANIZATION-ORGANIZATION-ORGANIZATION-ORGANIZATION,PERSON-PERSON-PERSON,PROPN-PROPN-ADP-PROPN-PROPN,PROPN-PROPN-PROPN,compound-pobj-prep-compound-pobj,compound-compound-nsubj,NNP-NNP-IN-NNP-NNPS,NNP-NNP-NNP,4,1
1894,4979.0,22,was,10,16,6,-10,15,15,-6,-4,Cerniglia,director,PERSON,TITLE,PROPN,NOUN,pobj,appos,NNP,NN,4,1
1895,4987.0,22,said,9,11,17,6,10,4,-2,8,Eloise Spooner,Iron City,PERSON-PERSON,CITY-CITY,PROPN-PROPN,PROPN-PROPN,compound-nsubj,compound-pobj,NNP-NNP,NNP-NNP,4,1
1896,4989.0,45,signed,8,4,44,40,3,0,4,36,Nuclear Decommissioning Authority,Sellafield,ORGANIZATION-ORGANIZATION-ORGANIZATION,ORGANIZATION,PROPN-PROPN-PROPN,PROPN,compound-compound-pobj,dobj,NNP-NNP-NNP,NNP,4,1
1897,5003.0,23,offered,2,15,11,-4,14,11,-13,9,Wen Qiang,Chongiqng,PERSON-PERSON,LOCATION,PROPN-PROPN,PROPN,compound-appos,nmod,NNP-NNP,NNP,3,1
1898,5012.0,18,found,3,1,10,9,0,7,2,7,Her,Wanblee,PERSON,LOCATION,DET,PROPN,poss,pobj,PRP$,NNP,3,1
1899,5019.0,28,skipped,6,14,5,-9,13,22,-8,-1,National Urban League,Giuliani,ORGANIZATION-ORGANIZATION-ORGANIZATION,PERSON,PROPN-PROPN-PROPN,PROPN,compound-compound-pobj,conj,NNP-NNP-NNP,NNP,5,1
1900,5022.0,20,has,7,6,9,3,5,10,1,2,OANA,40,ORGANIZATION,NUMBER,PROPN,NUM,nsubj,nummod,NNP,CD,2,1
1901,5027.0,55,wrote,45,37,53,16,36,1,8,8,National Restaurant Association,Jerry Jurgensen,ORGANIZATION-ORGANIZATION-ORGANIZATION,PERSON-PERSON,PROPN-PROPN-PROPN,PROPN-PROPN,compound-compound-compound,compound-pobj,NNP-NNP-NNP,NNP-NNP,8,1
1902,5031.0,26,made,1,17,24,7,16,1,-16,23,Association of Chinese-American Scientists and Engineers,ACSE,ORGANIZATION-ORGANIZATION-ORGANIZATION-ORGANIZATION-ORGANIZATION-ORGANIZATION,ORGANIZATION,PROPN-ADP-PROPN-PROPN-CCONJ-PROPN,PROPN,pobj-prep-amod-pobj-cc-conj,compound,NNP-IN-NNP-NNPS-CC-NNPS,NNP,9,1
1903,6048.0,28,pledged,12,4,11,7,3,16,8,-1,Association of Chinese-American Scientists and Engineers,ACSE,ORGANIZATION-ORGANIZATION-ORGANIZATION-ORGANIZATION-ORGANIZATION-ORGANIZATION,ORGANIZATION,PROPN-ADP-PROPN-PROPN-CCONJ-PROPN,PROPN,pobj-prep-amod-pobj-cc-conj,compound,NNP-IN-NNP-NNPS-CC-NNPS,NNP,4,1
1904,5034.0,40,found,31,1,5,4,0,34,30,-26,Andrew Lange,astrophysicist,PERSON-PERSON,TITLE,PROPN-PROPN,NOUN,compound-nsubj,appos,NNP-NNP,NN,4,1
1905,5173.0,42,obituary,6,11,10,-1,10,31,-5,4,Andrew Lange,astrophysicist,PERSON-PERSON,TITLE,PROPN-PROPN,NOUN,compound-pobj,amod,NNP-NNP,NN,1,1
1906,5728.0,40,found,31,1,5,4,0,34,30,-26,Andrew Lange,astrophysicist,PERSON-PERSON,TITLE,PROPN-PROPN,NOUN,compound-nsubj,appos,NNP-NNP,NN,4,1
1907,9770.0,43,-RRB-,0,12,11,-1,11,31,-12,11,Andrew Lange,astrophysicist,PERSON-PERSON,TITLE,PROPN-PROPN,NOUN,compound-pobj,amod,NNP-NNP,NN,1,1
1908,5044.0,23,said,14,1,8,7,0,14,13,-6,Laura Silsby,New Life Children 's Refuge charity,PERSON-PERSON,ORGANIZATION-ORGANIZATION-ORGANIZATION-ORGANIZATION-ORGANIZATION-ORGANIZATION,PROPN-PROPN,PROPN-PROPN-PROPN-PART-PROPN-NOUN,compound-nsubj,compound-compound-poss-case-compound-pobj,NNP-NNP,NNP-NNP-NNP-POS-NNP-NN,4,1
1909,5048.0,32,serves,5,5,7,2,4,24,0,2,Alico,20 million,ORGANIZATION,NUMBER-NUMBER,PROPN,NUM-NUM,nsubj,compound-nummod,NNP,CD-CD,2,1
1910,5063.0,28,said,11,8,1,-7,7,26,3,-10,Australian Defence Force,Douglas Campbell,ORGANIZATION-ORGANIZATION-ORGANIZATION,PERSON-PERSON,PROPN-PROPN-PROPN,PROPN-PROPN,compound-compound-pobj,compound-nsubj,NNP-NNP-NNP,NNP-NNP,4,1
1911,5067.0,24,charged,14,3,8,5,2,15,11,-6,Jupp,"Defense , Scientific and Technology Laboratory",PERSON,ORGANIZATION-ORGANIZATION-ORGANIZATION-ORGANIZATION-ORGANIZATION-ORGANIZATION,PROPN,PROPN-PUNCT-PROPN-CCONJ-PROPN-PROPN,poss,nmod-punct-conj-cc-conj-pobj,NNP,"NNP-,-NNP-CC-NNP-NNP",6,1
1912,11407.0,32,charged,22,3,15,12,2,16,19,-7,Jupp,"Defense , Scientific and Technology Laboratory",PERSON,ORGANIZATION-ORGANIZATION-ORGANIZATION-ORGANIZATION-ORGANIZATION-ORGANIZATION,PROPN,PROPN-PUNCT-PROPN-CCONJ-PROPN-PROPN,poss,nmod-punct-conj-cc-conj-appos,NNP,"NNP-,-NNP-CC-NNP-NNP",7,1
1913,5068.0,33,was,12,1,4,3,0,28,11,-8,Sarah Kunstler,12,PERSON-PERSON,NUMBER,PROPN-PROPN,NUM,compound-nsubj,attr,NNP-NNP,CD,3,1
1914,5071.0,37,working,11,20,7,-13,19,29,-9,-4,he,Potomac,PERSON,CITY,PRON,PROPN,nsubjpass,pobj,PRP,NNP,7,1
1915,5076.0,39,recalls,1,1,20,19,0,18,0,19,Lomax,Los Angeles,PERSON,CITY-CITY,PROPN,PROPN-PROPN,nsubj,compound-pobj,NNP,NNP-NNP,5,1
1916,5095.0,30,said,10,17,25,8,16,4,-7,15,William Kunstler,lawyer,PERSON-PERSON,TITLE,PROPN-PROPN,NOUN,compound-pobj,appos,NNP-NNP,NN,2,1
1917,5099.0,42,born,4,1,21,20,0,20,3,17,Andrew E. Lange,Joan Lange,PERSON-PERSON-PERSON,PERSON-PERSON,PROPN-PROPN-PROPN,PROPN-PROPN,compound-compound-nsubjpass,compound-pobj,NNP-NNP-NNP,NNP-NNP,7,1
1918,5103.0,40,received,20,18,10,-8,17,29,2,-10,Chen Tao,officers,PERSON-PERSON,TITLE,PROPN-PROPN,NOUN,compound-conj,nsubj,NNP-NNP,NNS,4,1
1919,5116.0,23,said,9,4,1,-3,3,21,5,-8,Knox,Madison Paxton,PERSON,PERSON-PERSON,PROPN,PROPN-PROPN,poss,compound-nsubj,NNP,NNP-NNP,3,1
1920,5120.0,18,says,2,7,11,4,6,6,-5,9,Sandy Herold,Monday,PERSON-PERSON,DATE,PROPN-PROPN,PROPN,compound-appos,compound,NNP-NNP,NNP,3,1
1921,5121.0,45,2,3,12,11,-1,11,33,-9,8,Countrywide,California-based,ORGANIZATION,STATE_OR_PROVINCE,PROPN,PROPN,nsubj,compound,NNP,NNP,1,1
1922,5135.0,38,received,2,26,30,4,25,7,-24,28,Ruben,An van de Sande,PERSON,PERSON-PERSON-PERSON-PERSON,PROPN,DET-NOUN-X-PROPN,nsubj,det-compound-compound-appos,NNP,DT-NN-FW-NNP,3,1
1923,5151.0,39,writes,10,37,33,-4,36,5,-27,23,chairman,Angelo Mozilo,ORGANIZATION,PERSON-PERSON,NOUN,PROPN-PROPN,appos,compound-pobj,NN,NNP-NNP,3,1
1924,5158.0,28,languished,3,2,7,5,1,20,1,4,He,Cuban,PERSON,COUNTRY,PRON,ADJ,nsubj,amod,PRP,JJ,4,1
1925,5167.0,23,say,1,3,15,12,2,7,-2,14,Samudio,Belo Horizonte,PERSON,CITY-CITY,PROPN,PROPN-PROPN,nsubjpass,compound-pobj,NNP,NNP-NNP,4,1
1926,5184.0,40,found,31,1,35,34,0,4,30,4,Andrew Lange,Jan. 22,PERSON-PERSON,DATE-DATE,PROPN-PROPN,PROPN-NUM,compound-nsubj,pobj-nummod,NNP-NNP,NNP-CD,2,1
1927,5185.0,22,told,12,9,11,2,8,10,3,-1,Bamba,60,PERSON,NUMBER,PROPN,NUM,npadvmod,pobj,NNP,CD,1,1
1928,5190.0,40,gave,9,7,2,-5,6,37,2,-7,Third Guard Division,People 's Liberation Army,ORGANIZATION-ORGANIZATION-ORGANIZATION,ORGANIZATION-ORGANIZATION-ORGANIZATION-ORGANIZATION,PROPN-PROPN-PROPN,PROPN-PART-PROPN-PROPN,compound-compound-nsubj,poss-case-compound-poss,NNP-NNP-NNP,NNPS-POS-NNP-NNP,4,1
1929,6871.0,40,gave,9,7,2,-5,6,37,2,-7,Third Guard Division,People 's Liberation Army,ORGANIZATION-ORGANIZATION-ORGANIZATION,ORGANIZATION-ORGANIZATION-ORGANIZATION-ORGANIZATION,PROPN-PROPN-PROPN,PROPN-PART-PROPN-PROPN,compound-compound-nsubj,poss-case-compound-poss,NNP-NNP-NNP,NNPS-POS-NNP-NNP,4,1
1930,5193.0,28,is,2,24,20,-4,23,7,-22,18,New Fabris,Vienne,ORGANIZATION-ORGANIZATION,STATE_OR_PROVINCE,PROPN-PROPN,PROPN,compound-nsubjpass,compound,NNP-NNP,NNP,9,1
1931,5200.0,30,been,9,1,4,3,0,25,8,-5,Bibi,45-year-old,PERSON,NUMBER,PROPN,ADJ,nsubj,amod,NNP,JJ,5,1
1932,7558.0,34,said,9,1,4,3,0,29,8,-5,Bibi,45-year-old,PERSON,DURATION,PROPN,ADJ,nsubj,amod,NNP,JJ,5,1
1933,5203.0,19,--,0,8,3,-5,7,15,-8,3,High Point Church,Gary Simons,ORGANIZATION-ORGANIZATION-ORGANIZATION,PERSON-PERSON,PROPN-PROPN-PROPN,PROPN-PROPN,compound-compound-pobj,compound-nsubj,NNP-NNP-NNP,NNP-NNP,4,1
1934,5207.0,19,said,3,6,5,-1,5,13,-3,2,Hollister Inc.,Kip Hollister,ORGANIZATION-ORGANIZATION,PERSON-PERSON,PROPN-PROPN,PROPN-PROPN,compound-pobj,compound-nsubj,NNP-NNP,NNP-NNP,1,1
1935,10342.0,33,said,9,2,1,-1,1,31,7,-8,Hollister Inc.,Kip Hollister,ORGANIZATION-ORGANIZATION,PERSON-PERSON,PROPN-PROPN,PROPN-PROPN,compound-pobj,compound-nsubj,NNP-NNP,NNP-NNP,1,1
1936,5209.0,34,said,11,4,10,6,3,23,7,-1,Central American Parliament,Jacinto Suarez,ORGANIZATION-ORGANIZATION-ORGANIZATION,PERSON-PERSON,ADJ-ADJ-PROPN,PROPN-PROPN,compound-compound-pobj,compound-appos,JJ-JJ-NNP,NNP-NNP,-1,1
1937,5297.0,29,said,26,21,14,-7,20,14,5,-12,Central American Parliament,Jacinto Suarez,ORGANIZATION-ORGANIZATION-ORGANIZATION,PERSON-PERSON,ADJ-ADJ-PROPN,PROPN-PROPN,compound-compound-pobj,compound-appos,JJ-JJ-NNP,NNP-NNP,4,1
1938,5212.0,39,said,15,19,25,6,18,13,-4,10,Organization of Asia-Pacific News Agency,OANA,ORGANIZATION-ORGANIZATION-ORGANIZATION-ORGANIZATION-ORGANIZATION,ORGANIZATION,PROPN-ADP-PROPN-PROPN-PROPN,PROPN,npadvmod-prep-compound-compound-pobj,compound,NNP-IN-NNP-NNP-NNP,NNP,4,1
1939,5228.0,36,released,28,1,9,8,0,26,27,-19,Eugenio Vagni,International Committee Red Cross,PERSON-PERSON,ORGANIZATION-ORGANIZATION-ORGANIZATION-ORGANIZATION,PROPN-PROPN,PROPN-PROPN-PROPN-PROPN,compound-nsubjpass,compound-compound-compound-pobj,NNP-NNP,NNP-NNP-NNP-NNP,4,1
1940,5233.0,47,is,17,1,12,11,0,34,16,-5,Ahmed Rashid,Pacific Council,PERSON-PERSON,ORGANIZATION-ORGANIZATION,PROPN-PROPN,PROPN-PROPN,compound-nsubj,compound-pobj,NNP-NNP,NNP-NNP,4,1
1941,5242.0,28,keep,17,1,3,2,0,24,16,-14,Heloise,Ponce Kiah Marchelle Heloise Cruse,PERSON,PERSON-PERSON-PERSON-PERSON-PERSON,PROPN,PROPN-PROPN-PROPN-PROPN-PROPN,compound,compound-compound-compound-compound-compound,NNP,NNP-NNP-NNP-NNP-NNP,3,1
1942,5256.0,42,born,4,1,39,38,0,2,3,35,Andrew E Lange,"Easton , Conn",PERSON-PERSON-PERSON,CITY-CITY-CITY,PROPN-PROPN-PROPN,PROPN-PUNCT-PROPN,compound-compound-nsubjpass,pobj-punct-appos,NNP-NNP-NNP,"NNP-,-NNP",6,1
1943,5257.0,29,62-year-old,1,3,17,14,2,11,-2,16,Vagni,Montevarchi,PERSON,CITY,PROPN,PROPN,nsubj,pobj,NNP,NNP,6,1
1944,5268.0,58,says,7,1,6,5,0,51,6,-1,Jamie Leigh Jones,22,PERSON-PERSON-PERSON,NUMBER,PROPN-PROPN-PROPN,NUM,compound-compound-nsubj,appos,NNP-NNP-NNP,CD,3,1
1945,8307.0,68,Victim,1,11,16,5,10,51,-10,15,Jamie Leigh Jones,22,PERSON-PERSON-PERSON,NUMBER,PROPN-PROPN-PROPN,NUM,compound-compound-nsubj,appos,NNP-NNP-NNP,CD,2,1
1946,14341.0,59,said,7,1,6,5,0,52,6,-1,Jamie Leigh Jones,22,PERSON-PERSON-PERSON,NUMBER,PROPN-PROPN-PROPN,NUM,compound-compound-nsubj,appos,NNP-NNP-NNP,CD,3,1
1947,5272.0,28,joined,2,2,8,6,1,19,0,6,Finn,Barry University,PERSON,ORGANIZATION-ORGANIZATION,PROPN,PROPN-PROPN,nsubj,compound-pobj,NNP,NNP-NNP,3,1
1948,5274.0,55,said,47,44,37,-7,43,17,3,-10,National Energy Administration,Wu Yin,ORGANIZATION-ORGANIZATION-ORGANIZATION,PERSON-PERSON,PROPN-PROPN-PROPN,PROPN-PROPN,compound-compound-pobj,compound-appos,NNP-NNP-NNP,NNP-NNP,4,1
1949,11480.0,32,said,13,7,11,4,6,20,6,-2,National Energy Administration,Wu Yin,ORGANIZATION-ORGANIZATION-ORGANIZATION,PERSON-PERSON,PROPN-PROPN-PROPN,PROPN-PROPN,compound-compound-pobj,compound-appos,NNP-NNP-NNP,NNP-NNP,4,1
1950,5283.0,47,_,0,40,45,5,39,1,-40,45,United Solutions and Services,US2,ORGANIZATION-ORGANIZATION-ORGANIZATION-ORGANIZATION,ORGANIZATION,PROPN-PROPN-CCONJ-PROPN,PROPN,compound-appos-cc-compound,compound,NNP-NNPS-CC-NNPS,NNP,-1,1
1951,5298.0,17,graduated,1,1,4,3,0,12,0,3,Sodini,Pittsburgh,PERSON,CITY,PROPN,PROPN,nsubj,pobj,NNP,NNP,1,1
1952,5579.0,30,graduated,1,1,9,8,0,20,0,8,Sodini,Pittsburgh,PERSON,CITY,PROPN,PROPN,nsubj,pobj,NNP,NNP,1,1
1953,10680.0,30,graduated,1,1,9,8,0,20,0,8,Sodini,Pittsburgh,PERSON,CITY,PROPN,PROPN,nsubj,compound,NNP,NNP,1,1
1954,5299.0,34,detained,3,19,16,-3,18,17,-16,13,Xie Caiping,his,PERSON-PERSON,PERSON,PROPN-PROPN,DET,compound-npadvmod,poss,NNP-NNP,PRP$,2,1
1955,6559.0,29,accused,2,14,11,-3,13,17,-12,9,Xie Caiping,his,PERSON-PERSON,PERSON,PROPN-PROPN,DET,compound-npadvmod,poss,NNP-NNP,PRP$,2,1
1956,11029.0,33,detained,2,18,15,-3,17,17,-16,13,Xie Caiping,his,PERSON-PERSON,PERSON,PROPN-PROPN,DET,compound-npadvmod,poss,NNP-NNP,PRP$,2,1
1957,11151.0,33,detained,2,18,15,-3,17,17,-16,13,Xie Caiping,his,PERSON-PERSON,PERSON,PROPN-PROPN,DET,compound-npadvmod,poss,NNP-NNP,PRP$,2,1
1958,13761.0,36,accused,10,21,18,-3,20,17,-11,8,Xie Caiping,his,PERSON-PERSON,PERSON,PROPN-PROPN,DET,compound-npadvmod,poss,NNP-NNP,PRP$,2,1
1959,5300.0,38,was,1,19,16,-3,18,21,-18,15,ADF,Defense Force,ORGANIZATION,ORGANIZATION-ORGANIZATION,PROPN,PROPN-PROPN,compound,compound-compound,NNP,NNP-NNP,2,1
1960,5310.0,33,was,12,6,11,5,5,21,6,-1,her,Emily,PERSON,PERSON,DET,PROPN,poss,npadvmod,PRP$,NNP,1,1
1961,5311.0,26,faces,10,1,4,3,0,21,9,-6,Graham,55-year-old,PERSON,DURATION,PROPN,NUM,nsubj,compound,NNP,CD,5,1
1962,5313.0,48,said,31,12,6,-6,11,41,19,-25,OANA,Organisation of Asia-Pacific News Agencies,ORGANIZATION,ORGANIZATION-ORGANIZATION-ORGANIZATION-ORGANIZATION-ORGANIZATION,PROPN,PROPN-ADP-PROPN-PROPN-PROPN,compound,pobj-prep-compound-compound-pobj,NNP,NNP-IN-NNP-NNP-NNPS,4,1
1963,9122.0,48,said,31,12,6,-6,11,41,19,-25,OANA,Organisation of Asia-Pacific News Agencies,ORGANIZATION,ORGANIZATION-ORGANIZATION-ORGANIZATION-ORGANIZATION-ORGANIZATION,PROPN,PROPN-ADP-PROPN-PROPN-PROPN,compound,pobj-prep-compound-compound-pobj,NNP,NNP-IN-NNP-NNP-NNPS,4,1
1964,5319.0,13,worked,1,1,10,9,0,2,0,9,She,Scientology,PERSON,RELIGION,PRON,PROPN,nsubj,dobj,PRP,NNP,2,1
1965,12138.0,22,took,1,1,3,2,0,18,0,2,She,Scientology,PERSON,RELIGION,PRON,PROPN,nsubj,compound,PRP,NNP,1,1
1966,5324.0,33,arrested,17,20,23,3,19,9,-3,6,his,Oneonta,PERSON,CITY,DET,PROPN,poss,pobj,PRP$,NNP,3,1
1967,5325.0,35,revised,12,10,16,6,9,18,2,4,Silsby,irregular travel,PERSON,CRIMINAL_CHARGE-CRIMINAL_CHARGE,PROPN,ADJ-NOUN,pobj,amod-pobj,NNP,JJ-NN,4,1
1968,5328.0,30,accused,5,16,29,13,15,0,-11,24,she,Italy,PERSON,COUNTRY,PRON,PROPN,nsubjpass,pobj,PRP,NNP,8,1
1969,5342.0,50,began,4,44,47,3,43,2,-40,43,Koch Foods,Fairfield,ORGANIZATION-ORGANIZATION,CITY,PROPN-PROPN,PROPN,compound-pobj,pobj,NNP-NNP,NNP,5,1
1970,5350.0,18,described,2,1,15,14,0,2,1,13,Samudio,film actress,PERSON,TITLE-TITLE,NOUN,NOUN-NOUN,nsubjpass,compound-conj,NN,NN-NN,6,1
1971,5357.0,27,said,20,13,6,-7,12,20,7,-14,him,Thursday,PERSON,DATE,PRON,PROPN,nsubj,npadvmod,PRP,NNP,3,1
1972,5363.0,83,include,2,1,70,69,0,12,1,68,OANA,SPA,ORGANIZATION,ORGANIZATION,PROPN,PROPN,compound,conj,NNP,NNP,13,1
1973,5370.0,38,dismissed,6,36,13,-23,35,24,-30,7,Eliza Samudio,he,PERSON-PERSON,PERSON,PROPN-PROPN,PRON,compound-appos,nsubjpass,NNP-NNP,PRP,8,1
1974,5374.0,25,become,15,9,3,-6,8,21,6,-12,CCF,Fan Baojun,ORGANIZATION,PERSON-PERSON,PROPN,PROPN-PROPN,pobj,compound-pobj,NNP,NNP-NNP,1,1
1975,5377.0,26,faces,10,1,7,6,0,18,9,-3,Graham,Indian,PERSON,NATIONALITY,PROPN,PROPN,nsubj,appos,NNP,NNP,3,1
1976,5388.0,41,operated,4,1,23,22,0,17,3,19,"Air Evac EMS , Inc",United States,PERSON-PERSON-PERSON-PERSON-PERSON,COUNTRY-COUNTRY,PROPN-PROPN-PROPN-PUNCT-PROPN,PROPN-PROPN,compound-compound-pobj-punct-appos,compound-pobj,"NNP-NNP-NNP-,-NNP",NNP-NNP,8,1
1977,5403.0,42,said,10,16,6,-10,15,35,-6,-4,his,ambassador,PERSON,TITLE,DET,NOUN,poss,nsubj,PRP$,NN,7,1
1978,7402.0,31,gave,12,21,10,-11,20,20,-9,-2,his,ambassador,PERSON,TITLE,DET,NOUN,poss,nsubj,PRP$,NN,4,1
1979,9472.0,24,gave,9,17,6,-11,16,17,-8,-3,his,ambassador,PERSON,TITLE,DET,NOUN,poss,compound,PRP$,NN,4,1
1980,5406.0,37,followed,2,24,36,12,23,0,-22,34,Bibi,blasphemy,PERSON,CRIMINAL_CHARGE,PROPN,NOUN,nsubjpass,pobj,NNP,NN,11,1
1981,5415.0,23,was,10,1,8,7,0,14,9,-2,His,University of Pennsylvania,PERSON,ORGANIZATION-ORGANIZATION-ORGANIZATION,DET,PROPN-ADP-PROPN,poss,pobj-prep-pobj,PRP$,NNP-IN-NNP,5,1
1982,5429.0,64,appoints,1,12,6,-6,11,57,-11,5,the National Energy Administration,Sun Qin,ORGANIZATION-ORGANIZATION-ORGANIZATION-ORGANIZATION,PERSON-PERSON,DET-PROPN-PROPN-PROPN,PROPN-PROPN,det-compound-compound-pobj,compound-dobj,DT-NNP-NNP-NNP,NNP-NNP,4,1
1983,5437.0,35,announced,2,17,22,5,16,12,-15,20,Mark Fisher,chairman,PERSON-PERSON,TITLE,PROPN-PROPN,NOUN,compound-ROOT,pobj,NNP-NNP,NN,1,1
1984,6406.0,11,Amro,1,7,11,4,6,-1,-6,10,Mark Fisher,chairman,PERSON-PERSON,TITLE,PROPN-PROPN,NOUN,compound-dobj,pobj,NNP-NNP,NN,-1,1
1985,5458.0,25,made,1,1,10,9,0,14,0,9,Daniels,Oklahoma City,PERSON,CITY-CITY,NOUN,PROPN-PROPN,nsubj,compound-pobj,NNS,NNP-NNP,2,1
1986,9239.0,22,made,1,1,7,6,0,14,0,6,Daniels,Oklahoma City,PERSON,CITY-CITY,NOUN,PROPN-PROPN,nsubj,compound-pobj,NNS,NNP-NNP,2,1
1987,13089.0,39,said,15,18,25,7,17,13,-3,10,Daniels,Oklahoma City,PERSON,CITY-CITY,PROPN,PROPN-PROPN,pobj,compound-pobj,NNP,NNP-NNP,4,1
1988,5460.0,37,wrote,2,20,14,-6,19,22,-18,12,Progressive Democrats of America,NJ State PDA Yahoo Group,ORGANIZATION-ORGANIZATION-ORGANIZATION-ORGANIZATION,ORGANIZATION-ORGANIZATION-ORGANIZATION-ORGANIZATION-ORGANIZATION,PROPN-PROPN-ADP-PROPN,PROPN-PROPN-PROPN-PROPN-PROPN,compound-conj-prep-compound,compound-compound-compound-compound-pobj,NNP-NNPS-IN-NNP,NNP-NNP-NNP-NNP-NNP,2,1
1989,5461.0,48,said,46,8,34,26,7,13,38,-12,Eugenio Vagni,Indanan,PERSON-PERSON,LOCATION,PROPN-PROPN,PROPN,compound-nsubj,compound,NNP-NNP,NNP,7,1
1990,5466.0,29,convicts,5,12,20,8,11,8,-7,15,her,British,PERSON,NATIONALITY,DET,ADJ,poss,amod,PRP$,JJ,4,1
1991,5474.0,39,is,4,1,15,14,0,23,3,11,Sycamore Valley Ranch Co.,Colony Capital LLC,ORGANIZATION-ORGANIZATION-ORGANIZATION-ORGANIZATION,ORGANIZATION-ORGANIZATION-ORGANIZATION,PROPN-PROPN-PROPN-PROPN,PROPN-PROPN-PROPN,compound-compound-compound-nsubj,compound-compound-pobj,NNP-NNP-NNP-NNP,NNP-NNP-NNP,9,1
1992,5483.0,31,is,4,10,14,4,9,16,-6,10,Matteo Messina Denaro,45,PERSON-PERSON-PERSON,NUMBER,PROPN-PROPN-PROPN,NUM,compound-compound-appos,appos,NNP-NNP-NNP,CD,2,1
1993,5489.0,40,said,35,1,5,4,0,34,34,-30,Countrywide Financial,Angelo Mozilo,ORGANIZATION-ORGANIZATION,PERSON-PERSON,PROPN-PROPN,PROPN-PROPN,compound-compound,compound-nsubj,NNP-NNP,NNP-NNP,4,1
1994,7329.0,45,McKown,2,42,33,-9,41,11,-40,31,Countrywide Financial,Angelo Mozilo,ORGANIZATION-ORGANIZATION,PERSON-PERSON,PROPN-PROPN,PROPN-PROPN,compound-compound,compound-pobj,NNP-NNP,NNP-NNP,5,1
1995,9518.0,51,taken,7,27,22,-5,26,28,-20,15,Countrywide Financial,Angelo Mozilo,ORGANIZATION-ORGANIZATION,PERSON-PERSON,PROPN-PROPN,PROPN-PROPN,nmod-nmod,compound-pobj,NNP-NNP,NNP-NNP,3,1
1996,10363.0,40,refinanced,1,8,29,21,7,10,-7,28,Countrywide Financial,Angelo Mozilo,ORGANIZATION-ORGANIZATION,PERSON-PERSON,PROPN-PROPN,PROPN-PROPN,compound-pobj,compound-pobj,NNP-NNP,NNP-NNP,3,1
1997,13401.0,20,filed,2,10,14,4,9,5,-8,12,Countrywide Financial,Angelo Mozilo,ORGANIZATION-ORGANIZATION,PERSON-PERSON,PROPN-PROPN,PROPN-PROPN,compound-compound,compound-pobj,NNP-NNP,NNP-NNP,4,1
1998,5495.0,24,was,4,7,11,4,6,12,-3,7,Automatic Direction Finder,ADF,ORGANIZATION-ORGANIZATION-ORGANIZATION,ORGANIZATION,PROPN-PROPN-PROPN,PROPN,compound-attr-compound,compound,NNP-NNP-NNP,NNP,3,1
1999,5498.0,25,developing,3,14,16,2,13,8,-11,13,NEA,New Energy and Renewable Energy Department,ORGANIZATION,ORGANIZATION-ORGANIZATION-ORGANIZATION-ORGANIZATION-ORGANIZATION-ORGANIZATION,PROPN,PROPN-PROPN-CCONJ-PROPN-PROPN-PROPN,poss,nmod-nmod-cc-compound-conj-compound,NNP,NNP-NNP-CC-NNP-NNP-NNP,3,1
2000,5499.0,32,got,3,13,11,-2,12,20,-10,8,Richard Gage,California,PERSON-PERSON,STATE_OR_PROVINCE,PROPN-PROPN,PROPN,compound-nsubj,compound,NNP-NNP,NNP,1,1
2001,5503.0,27,said,20,1,19,18,0,7,19,-1,Lange,asphyxiation,PERSON,CAUSE_OF_DEATH,PROPN,NOUN,nsubj,pobj,NNP,NN,2,1
2002,5527.0,42,met,11,11,17,6,10,24,0,6,Lange,Frances Arnold,PERSON,PERSON-PERSON,PROPN,PROPN-PROPN,nsubj,compound-appos,NNP,NNP-NNP,1,1
2003,5532.0,72,Context,0,43,36,-7,42,35,-43,36,Helen Keller International,Kathy Spahn,ORGANIZATION-ORGANIZATION-ORGANIZATION,PERSON-PERSON,PROPN-PROPN-PROPN,PROPN-PROPN,compound-compound-conj,compound-appos,NNP-NNP-NNP,NNP-NNP,7,1
2004,5552.0,19,has,5,5,3,-2,4,15,0,-2,ALICO,1921,ORGANIZATION,DATE,PROPN,NUM,nsubj,pobj,NNP,CD,1,1
2005,9164.0,54,is,17,17,15,-2,16,38,0,-2,ALICO,1921,ORGANIZATION,DATE,PROPN,NUM,nsubj,pobj,NNP,CD,1,1
2006,5555.0,43,say,1,27,38,11,26,4,-26,37,Matteo Messina Denaro,Trapani,PERSON-PERSON-PERSON,CITY,PROPN-PROPN-PROPN,PROPN,compound-compound-appos,pobj,NNP-NNP-NNP,NNP,3,1
2007,15246.0,23,cooperating,3,6,18,12,5,4,-3,15,Matteo Messina Denaro,Trapani,PERSON-PERSON-PERSON,CITY,PROPN-PROPN-PROPN,PROPN,compound-compound-pobj,pobj,NNP-NNP-NNP,NNP,4,1
2008,5557.0,45,said,4,10,35,25,9,9,-6,31,Ruben van Assouw,Patrick,PERSON-PERSON-PERSON,PERSON,PROPN-PROPN-PROPN,PROPN,compound-compound-attr,appos,NNP-NNP-NNP,NNP,6,1
2009,5610.0,44,said,4,10,35,25,9,8,-6,31,Ruben van Assouw,Patrick,PERSON-PERSON-PERSON,PERSON,PROPN-PROPN-PROPN,PROPN,compound-compound-attr,appos,NNP-NNP-NNP,NNP,6,1
2010,11978.0,61,Writethru,2,27,35,8,26,25,-25,33,Ruben van Assouw,Patrick,PERSON-PERSON-PERSON,PERSON,PROPN-PROPN-PROPN,PROPN,compound-compound-pobj,appos,NNP-NNP-NNP,NNP,4,1
2011,5568.0,37,born,3,1,15,14,0,21,2,12,Ble Goude,Guiberoua,PERSON-PERSON,CITY,PROPN-PROPN,PROPN,compound-nsubjpass,appos,NNP-NNP,NNP,2,1
2012,5588.0,22,were,5,12,19,7,11,2,-7,14,Alessi,NPM,PERSON,ORGANIZATION,PROPN,PROPN,pobj,pobj,NNP,NNP,2,1
2013,5595.0,30,charged,2,1,8,7,0,21,1,6,Graham,felony murder,PERSON,CRIMINAL_CHARGE-CRIMINAL_CHARGE,PROPN,NOUN-NOUN,nsubjpass,compound-pobj,NNP,NN-NN,5,1
2014,6959.0,30,charged,2,1,8,7,0,21,1,6,Graham,felony murder,PERSON,CRIMINAL_CHARGE-CRIMINAL_CHARGE,PROPN,NOUN-NOUN,nsubjpass,compound-pobj,NNP,NN-NN,5,1
2015,5620.0,19,called,11,8,1,-7,7,17,3,-10,National Urban,Marc Morial,ORGANIZATION-ORGANIZATION,PERSON-PERSON,PROPN-PROPN,PROPN-PROPN,compound-compound,compound-nsubj,NNP-NNP,NNP-NNP,4,1
2016,5622.0,47,said,18,2,27,25,1,19,16,9,Countrywide,last week,ORGANIZATION,DATE-DATE,PROPN,ADJ-NOUN,pobj,amod-npadvmod,NNP,JJ-NN,6,1
2017,5627.0,44,said,5,7,30,23,6,13,-2,25,the boy,Trudy,PERSON-PERSON,PERSON,DET-NOUN,PROPN,det-nsubj,appos,DT-NN,NNP,6,1
2018,5635.0,24,said,12,14,22,8,13,1,-2,10,Sarah Kunstler,New York,PERSON-PERSON,STATE_OR_PROVINCE-STATE_OR_PROVINCE,PROPN-PROPN,PROPN-PROPN,compound-nsubj,compound-pobj,NNP-NNP,NNP-NNP,3,1
2019,5647.0,51,think,37,13,7,-6,12,43,24,-30,Loose Change,CIT,ORGANIZATION-ORGANIZATION,ORGANIZATION,PROPN-PROPN,PROPN,compound-compound,poss,NNP-NNP,NNP,6,1
2020,5648.0,32,said,24,9,23,14,8,8,15,-1,National Congress of American Indians,U.S.,ORGANIZATION-ORGANIZATION-ORGANIZATION-ORGANIZATION-ORGANIZATION,COUNTRY,PROPN-PROPN-ADP-PROPN-PROPN,PROPN,compound-pobj-prep-compound-pobj,pobj,NNP-NNP-IN-NNP-NNPS,NNP,5,1
2021,5652.0,36,said,15,14,5,-9,13,30,1,-10,Ahmed Rashid,Evening Standard,PERSON-PERSON,ORGANIZATION-ORGANIZATION,PROPN-PROPN,PROPN-PROPN,compound-conj,compound-compound,NNP-NNP,NNP-NNP,3,1
2022,5660.0,30,died,4,7,4,-3,6,25,-3,0,she,Russia,PERSON,COUNTRY,PRON,PROPN,nsubj,pobj,PRP,NNP,1,1
2023,5663.0,41,Hilliard,1,38,5,-33,37,35,-37,4,email,http://wwwrocketbootscomau,ORGANIZATION,URL,NOUN,PROPN,ROOT,nsubj,NN,NNP,-1,1
2024,5672.0,22,charged,6,19,18,-1,18,3,-13,12,Annie Mae Aquash,activist,PERSON-PERSON-PERSON,TITLE,PROPN-PROPN-PROPN,NOUN,compound-compound-pobj,compound,NNP-NNP-NNP,NN,2,1
2025,7121.0,22,accused,3,16,15,-1,15,6,-13,12,Annie Mae Aquash,activist,PERSON-PERSON-PERSON,TITLE,PROPN-PROPN-PROPN,NOUN,compound-compound-dobj,compound,NNP-NNP-NNP,NN,2,1
2026,13920.0,24,charged,5,21,20,-1,20,3,-16,15,Annie Mae Aquash,activist,PERSON-PERSON-PERSON,TITLE,PROPN-PROPN-PROPN,NOUN,compound-compound-pobj,compound,NNP-NNP-NNP,NN,2,1
2027,5674.0,25,launched,7,6,2,-4,5,22,1,-5,CCF,China Charity Federation,ORGANIZATION,ORGANIZATION-ORGANIZATION-ORGANIZATION,PROPN,PROPN-PROPN-PROPN,compound,compound-compound-compound,NNP,NNP-NNP-NNP,3,1
2028,5694.0,44,said,29,17,11,-6,16,32,12,-18,Mark Fisher,NBA,PERSON-PERSON,ORGANIZATION,PROPN-PROPN,PROPN,compound-pobj,compound,NNP-NNP,NNP,3,1
2029,6820.0,44,said,29,17,11,-6,16,32,12,-18,Mark Fisher,NBA,PERSON-PERSON,ORGANIZATION,PROPN-PROPN,PROPN,compound-pobj,compound,NNP-NNP,NNP,3,1
2030,5696.0,36,threatened,2,13,11,-2,12,24,-11,9,Abdul Aziz,leader,PERSON-PERSON,TITLE,PROPN-PROPN,NOUN,compound-appos,nsubjpass,NNP-NNP,NN,2,1
2031,13645.0,37,said,12,24,23,-1,23,13,-12,11,Abdul Aziz,leader,PERSON-PERSON,TITLE,PROPN-PROPN,NOUN,compound-dobj,compound,NNP-NNP,NN,1,1
2032,5697.0,22,was,1,19,5,-14,18,16,-18,4,her,Clearwater,PERSON,CITY,DET,PROPN,poss,pobj,PRP$,NNP,4,1
2033,5708.0,29,benefit,6,9,18,9,8,10,-3,12,"Huntington Library , Art Collections and Botanical Gardens",San Marino,ORGANIZATION-ORGANIZATION-ORGANIZATION-ORGANIZATION-ORGANIZATION-ORGANIZATION-ORGANIZATION-ORGANIZATION,CITY-CITY,PROPN-PROPN-PUNCT-PROPN-PROPN-CCONJ-PROPN-PROPN,PROPN-PROPN,compound-dobj-punct-compound-conj-cc-compound-conj,compound-pobj,"NNP-NNP-,-NNP-NNPS-CC-NNP-NNPS",NNP-NNP,3,1
2034,15021.0,29,benefit,6,9,18,9,8,10,-3,12,"Huntington Library , Art Collections and Botanical Gardens",San Marino,ORGANIZATION-ORGANIZATION-ORGANIZATION-ORGANIZATION-ORGANIZATION-ORGANIZATION-ORGANIZATION-ORGANIZATION,CITY-CITY,PROPN-PROPN-PUNCT-PROPN-PROPN-CCONJ-PROPN-PROPN,PROPN-PROPN,compound-dobj-punct-compound-conj-cc-compound-conj,compound-pobj,"NNP-NNP-,-NNP-NNPS-CC-NNP-NNPS",NNP-NNP,3,1
2035,5709.0,26,see,1,3,14,11,2,11,-2,13,Heloise,San Marcos,PERSON,CITY-CITY,PROPN,PROPN-PROPN,nsubj,compound-pobj,NNP,NNP-NNP,5,1
2036,5721.0,19,is,10,1,4,3,0,14,9,-6,Mark Fisher,author,PERSON-PERSON,TITLE,PROPN-PROPN,NOUN,compound-nsubj,appos,NNP-NNP,NN,2,1
2037,5731.0,22,arrested,3,1,10,9,0,11,2,7,Bibi,Muslim,PERSON,PERSON,PROPN,ADJ,nsubjpass,amod,NNP,JJ,4,1
2038,5734.0,34,was,1,1,15,14,0,18,0,14,Vagni,Jolo,PERSON,CITY,PROPN,PROPN,nsubj,pobj,NNP,NNP,9,1
2039,13563.0,40,said,38,8,21,13,7,18,30,-17,Vagni,Jolo,PERSON,CITY,PROPN,PROPN,nsubj,poss,NNP,NNP,6,1
2040,5747.0,22,hinted,1,1,16,15,0,5,0,15,He,diplomat,PERSON,TITLE,PRON,NOUN,nsubj,pobj,PRP,NN,3,1
2041,5751.0,28,said,16,26,18,-8,25,9,-10,2,Urban League,Marc Morial,ORGANIZATION-ORGANIZATION,PERSON-PERSON,PROPN-PROPN,PROPN-PROPN,compound-pobj,compound-nsubj,NNP-NNP,NNP-NNP,5,1
2042,5753.0,29,got,4,1,3,2,0,25,3,-1,TPI,Prachai Leophairatana,ORGANIZATION,PERSON-PERSON,NOUN,PROPN-PROPN,compound,compound-appos,NN,NNP-NNP,1,1
2043,5776.0,57,received,28,41,39,-2,40,17,-13,11,Eloise Spooner,Roger,PERSON-PERSON,PERSON,PROPN-PROPN,PROPN,compound-conj,appos,NNP-NNP,NNP,2,1
2044,5778.0,31,worked,4,3,1,-2,2,29,1,-3,46,Jupp,PERSON,NUMBER,NUM,PROPN,appos,nsubj,CD,NNP,3,1
2045,5783.0,42,com,0,7,36,29,6,5,-7,36,AAUW,United States,ORGANIZATION,COUNTRY-COUNTRY,PROPN,PROPN-PROPN,compound,compound-pobj,NNP,NNP-NNP,9,1
2046,5789.0,36,said,5,4,10,6,3,25,1,5,Ahmed Rashid,BBC,PERSON-PERSON,ORGANIZATION,PROPN-PROPN,PROPN,compound-nsubj,compound,NNP-NNP,NNP,3,1
2047,5798.0,23,packed,4,17,12,-5,16,10,-13,8,she,pastor,PERSON,TITLE,PRON,NOUN,nsubj,dobj,PRP,NN,2,1
2048,5802.0,22,said,9,11,21,10,10,0,-2,12,Eloise Spooner,Georgia,PERSON-PERSON,STATE_OR_PROVINCE,PROPN-PROPN,PROPN,compound-nsubj,pobj,NNP-NNP,NNP,3,1
2049,5807.0,20,has,7,16,3,-13,15,16,-9,-4,Asia and Pacific region,December 1961,ORGANIZATION-ORGANIZATION-ORGANIZATION-ORGANIZATION,DATE-DATE,PROPN-CCONJ-PROPN-NOUN,PROPN-NUM,nmod-cc-conj-pobj,pobj-nummod,NNP-CC-NNP-NN,NNP-CD,11,1
2050,5808.0,59,said,42,22,26,4,21,32,20,-16,Helen Keller International,HKI,ORGANIZATION-ORGANIZATION-ORGANIZATION,ORGANIZATION,PROPN-PROPN-PROPN,PROPN,compound-compound-compound,compound,NNP-NNP-NNP,NNP,2,1
2051,7787.0,59,said,42,22,26,4,21,32,20,-16,Helen Keller International,HKI,ORGANIZATION-ORGANIZATION-ORGANIZATION,ORGANIZATION,PROPN-PROPN-PROPN,PROPN,compound-compound-compound,nsubj,NNP-NNP-NNP,NNP,2,1
2052,13061.0,29,combats,7,2,6,4,1,22,5,-1,Helen Keller International,HKI,ORGANIZATION-ORGANIZATION-ORGANIZATION,ORGANIZATION,PROPN-PROPN-PROPN,PROPN,compound-compound-compound,compound,NNP-NNP-NNP,NNP,2,1
2053,5812.0,37,said,19,30,33,3,29,3,-11,14,Huntington Library,San Marino,ORGANIZATION-ORGANIZATION,CITY-CITY,PROPN-PROPN,PROPN-PROPN,compound-pobj,compound-pobj,NNP-NNP,NNP-NNP,4,1
2054,5826.0,28,48-year-old,1,3,2,-1,2,25,-2,1,Sodini,48-year-old,PERSON,NUMBER,PROPN,NUM,nsubj,ROOT,NNP,CD,1,1
2055,5828.0,35,plans,12,17,17,0,16,17,-5,5,Taiwan Symphony Orchestra,Taiwan,ORGANIZATION-ORGANIZATION-ORGANIZATION,COUNTRY,PROPN-PROPN-PROPN,PROPN,compound-compound-conj,compound,NNP-NNP-NNP,NNP,0,1
2056,5830.0,30,died,25,1,10,9,0,19,24,-15,Dr Frank Baldino Jr,Cephalon,PERSON-PERSON-PERSON-PERSON,ORGANIZATION,PROPN-PROPN-PROPN-PROPN,PROPN,compound-compound-compound-nsubj,appos,NNP-NNP-NNP-NNP,NNP,3,1
2057,5839.0,22,accused,3,16,12,-4,15,9,-13,9,Annie Mae Aquash,American Indian,PERSON-PERSON-PERSON,NATIONALITY-NATIONALITY,PROPN-PROPN-PROPN,PROPN-PROPN,compound-compound-dobj,amod-compound,NNP-NNP-NNP,NNP-NNP,4,1
2058,5841.0,29,hired,6,4,2,-2,3,26,2,-4,Pauliina Miettinen,Finland,PERSON-PERSON,COUNTRY,PROPN-PROPN,PROPN,compound-nsubjpass,compound,NNP-NNP,NNP,1,1
2059,7376.0,12,was,7,4,7,3,3,4,3,0,Pauliina Miettinen,Finland,PERSON-PERSON,COUNTRY,PROPN-PROPN,PROPN,compound-nsubj,pobj,NNP-NNP,NNP,2,1
2060,5858.0,38,snatched,3,16,32,16,15,5,-13,29,Eugenio Vagni,International Committee of the Red Cross,PERSON-PERSON,ORGANIZATION-ORGANIZATION-ORGANIZATION-ORGANIZATION-ORGANIZATION-ORGANIZATION,PROPN-PROPN,PROPN-PROPN-ADP-DET-PROPN-PROPN,compound-conj,compound-pobj-prep-det-compound-pobj,NNP-NNP,NNP-NNP-IN-DT-NNP-NNP,8,1
2061,6691.0,59,Writethru,2,41,28,-13,40,30,-39,26,Eugenio Vagni,International Committee of the Red Cross,PERSON-PERSON,ORGANIZATION-ORGANIZATION-ORGANIZATION-ORGANIZATION-ORGANIZATION-ORGANIZATION,PROPN-PROPN,PROPN-PROPN-ADP-DET-PROPN-PROPN,compound-conj,compound-dobj-prep-det-compound-compound,NNP-NNP,NNP-NNP-IN-DT-NNP-NNP,2,1
2062,11835.0,37,Philippines,2,15,7,-8,14,29,-13,5,Eugenio Vagni,International Committee of the Red Cross,PERSON-PERSON,ORGANIZATION-ORGANIZATION-ORGANIZATION-ORGANIZATION-ORGANIZATION-ORGANIZATION,PROPN-PROPN,PROPN-PROPN-ADP-DET-PROPN-PROPN,compound-nsubjpass,compound-pobj-prep-det-compound-compound,NNP-NNP,NNP-NNP-IN-DT-NNP-NNP,2,1
2063,14810.0,48,said,5,34,42,8,33,5,-29,37,Eugenio Vagni,International Committee of the Red Cross,PERSON-PERSON,ORGANIZATION-ORGANIZATION-ORGANIZATION-ORGANIZATION-ORGANIZATION-ORGANIZATION,PROPN-PROPN,PROPN-PROPN-ADP-DET-PROPN-PROPN,compound-pobj,compound-pobj-prep-det-compound-pobj,NNP-NNP,NNP-NNP-IN-DT-NNP-NNP,1,1
2064,5866.0,41,presents,28,22,20,-2,21,20,6,-8,Meredith Kercher,British,PERSON-PERSON,NATIONALITY,PROPN-PROPN,ADJ,compound-appos,amod,NNP-NNP,JJ,1,1
2065,10906.0,30,dates,1,9,7,-2,8,22,-8,6,Meredith Kercher,British,PERSON-PERSON,NATIONALITY,PROPN-PROPN,ADJ,compound-pobj,amod,NNP-NNP,JJ,1,1
2066,12260.0,33,resumed,28,14,12,-2,13,20,14,-16,Meredith Kercher,British,PERSON-PERSON,NATIONALITY,PROPN-PROPN,ADJ,compound-pobj,amod,NNP-NNP,JJ,1,1
2067,12959.0,35,told,6,22,31,9,21,3,-16,25,Meredith Kercher,British,PERSON-PERSON,NATIONALITY,PROPN-PROPN,ADJ,compound-pobj,amod,NNP-NNP,JJ,7,1
2068,5872.0,24,was,1,1,6,5,0,17,0,5,Miettinen,Franklin Pierce College,PERSON,ORGANIZATION-ORGANIZATION-ORGANIZATION,PROPN,PROPN-PROPN-PROPN,nsubj,compound-compound-pobj,NNP,NNP-NNP-NNP,4,1
2069,5877.0,37,said,33,11,7,-4,10,29,22,-26,ADF,Asian Development Fund,ORGANIZATION,ORGANIZATION-ORGANIZATION-ORGANIZATION,PROPN,PROPN-PROPN-PROPN,compound,compound-compound-dobj,NNP,NNP-NNP-NNP,2,1
2070,5886.0,51,arrested,20,15,11,-4,14,39,5,-9,Alan Gross,State Department,PERSON-PERSON,ORGANIZATION-ORGANIZATION,PROPN-PROPN,PROPN-PROPN,compound-appos,compound-compound,NNP-NNP,NNP-NNP,4,1
2071,5890.0,33,said,1,13,31,18,12,1,-12,30,Matteo Messina Denaro,Sicilian Mafia,PERSON-PERSON-PERSON,ORGANIZATION-ORGANIZATION,PROPN-PROPN-PROPN,PROPN-PROPN,compound-compound-pobj,compound-dobj,NNP-NNP-NNP,NNP-NNP,10,1
2072,5907.0,26,been,2,1,11,10,0,14,1,9,Wen,Public Security Bureau,PERSON,ORGANIZATION-ORGANIZATION-ORGANIZATION,PROPN,PROPN-PROPN-PROPN,nsubj,compound-compound-pobj,NNP,NNP-NNP-NNP,5,1
2073,12378.0,43,said,41,1,12,11,0,30,40,-29,Wen,Public Security Bureau,PERSON,ORGANIZATION-ORGANIZATION-ORGANIZATION,PROPN,PROPN-PROPN-PROPN,nsubjpass,compound-compound-pobj,NNP,NNP-NNP-NNP,6,1
2074,5913.0,28,believe,3,5,13,8,4,14,-2,10,he,Jolo,PERSON,CITY,PRON,PROPN,nsubj,compound,PRP,NNP,4,1
2075,5917.0,28,says,5,8,2,-6,7,25,-3,-3,Andrew Lange,California Institute of Technology,PERSON-PERSON,ORGANIZATION-ORGANIZATION-ORGANIZATION-ORGANIZATION,PROPN-PROPN,PROPN-PROPN-ADP-PROPN,compound-nsubj,compound-nsubj-prep-pobj,NNP-NNP,NNP-NNP-IN-NNP,3,1
2076,5918.0,44,said,5,28,12,-16,27,31,-23,7,his,Tilburg,PERSON,CITY,DET,PROPN,poss,pobj,PRP$,NNP,4,1
2077,5929.0,28,according,1,4,22,18,3,5,-3,21,Mark Fisher,Boston,PERSON-PERSON,CITY,PROPN-PROPN,PROPN,compound-pobj,pobj,NNP-NNP,NNP,6,1
2078,5937.0,43,said,30,39,14,-25,38,28,-9,-16,Pacific Asia Travel Association,China,ORGANIZATION-ORGANIZATION-ORGANIZATION-ORGANIZATION,COUNTRY,PROPN-PROPN-PROPN-PROPN,PROPN,compound-compound-compound-pobj,pobj,NNP-NNP-NNP-NNP,NNP,11,1
2079,5943.0,34,said,5,13,20,7,12,13,-8,15,he,Florida,PERSON,STATE_OR_PROVINCE,PRON,PROPN,nsubjpass,pobj,PRP,NNP,4,1
2080,5962.0,32,left,27,22,12,-10,21,19,5,-15,Eliza Samudio,his,PERSON-PERSON,PERSON,PROPN-PROPN,DET,compound-appos,poss,NNP-NNP,PRP$,5,1
2081,12032.0,38,dismissed,6,36,26,-10,35,11,-30,20,Eliza Samudio,his,PERSON-PERSON,PERSON,PROPN-PROPN,DET,compound-appos,poss,NNP-NNP,PRP$,4,1
2082,5967.0,36,announced,6,18,24,6,17,11,-12,18,Organization of Asia-Pacific News Agencies,OANA,ORGANIZATION-ORGANIZATION-ORGANIZATION-ORGANIZATION-ORGANIZATION,ORGANIZATION,PROPN-ADP-PROPN-PROPN-PROPN,PROPN,pobj-prep-compound-compound-pobj,compound,NNP-IN-NNP-NNP-NNPS,NNP,7,1
2083,6819.0,38,passed,4,13,19,6,12,18,-9,15,Organization of Asia-Pacific News Agencies,OANA,ORGANIZATION-ORGANIZATION-ORGANIZATION-ORGANIZATION-ORGANIZATION,ORGANIZATION,PROPN-ADP-PROPN-PROPN-PROPN,PROPN,pobj-prep-compound-compound-pobj,compound,NNP-IN-NNP-NNP-NNPS,NNP,4,1
2084,8903.0,36,ISTANBUL,0,23,29,6,22,6,-23,29,Organization of Asia-Pacific News Agencies,OANA,ORGANIZATION-ORGANIZATION-ORGANIZATION-ORGANIZATION-ORGANIZATION,ORGANIZATION,PROPN-ADP-PROPN-PROPN-PROPN,PROPN,pobj-prep-compound-compound-pobj,compound,NNP-IN-NNP-NNP-NNPS,NNP,4,1
2085,9581.0,38,said,35,20,26,6,19,11,15,-9,Organization of Asia-Pacific News Agencies,OANA,ORGANIZATION-ORGANIZATION-ORGANIZATION-ORGANIZATION-ORGANIZATION,ORGANIZATION,PROPN-ADP-PROPN-PROPN-PROPN,PROPN,pobj-prep-compound-compound-pobj,compound,NNP-IN-NNP-NNP-NNPS,NNP,7,1
2086,10107.0,32,said,29,14,20,6,13,11,15,-9,Organization of Asia-Pacific News Agencies,OANA,ORGANIZATION-ORGANIZATION-ORGANIZATION-ORGANIZATION-ORGANIZATION,ORGANIZATION,PROPN-ADP-PROPN-PROPN-PROPN,PROPN,pobj-prep-compound-compound-pobj,compound,NNP-IN-NNP-NNP-NNPS,NNP,7,1
2087,5968.0,51,executes,1,12,25,13,11,25,-11,24,Qiang,Chongqing,PERSON,CITY,PROPN,PROPN,nsubjpass,compound,NNP,NNP,6,1
2088,5975.0,24,demanding,6,21,3,-18,20,20,-15,-3,her,25,PERSON,NUMBER,DET,NUM,poss,appos,PRP$,CD,9,1
2089,5981.0,40,NTSO,5,6,1,-5,5,38,-1,-4,NTSO,National Taiwan Symphony Orchestra,ORGANIZATION,ORGANIZATION-ORGANIZATION-ORGANIZATION-ORGANIZATION,PROPN,PROPN-PROPN-PROPN-PROPN,ROOT,compound-compound-compound-compound,NNP,NNP-NNP-NNP-NNP,3,1
2090,13553.0,31,Festival,4,13,8,-5,12,22,-9,4,NTSO,National Taiwan Symphony Orchestra,ORGANIZATION,ORGANIZATION-ORGANIZATION-ORGANIZATION-ORGANIZATION,PROPN,PROPN-PROPN-PROPN-PROPN,compound,compound-compound-compound-pobj,NNP,NNP-NNP-NNP-NNP,-1,1
2091,14028.0,43,said,41,23,18,-5,22,24,18,-23,NTSO,National Taiwan Symphony Orchestra,ORGANIZATION,ORGANIZATION-ORGANIZATION-ORGANIZATION-ORGANIZATION,PROPN,PROPN-PROPN-PROPN-PROPN,compound,compound-compound-compound-compound,NNP,NNP-NNP-NNP-NNP,-1,1
2092,5985.0,37,born,3,1,21,20,0,15,2,18,Ble Goude,secretary general,PERSON-PERSON,TITLE-TITLE,PROPN-PROPN,NOUN-NOUN,compound-nsubjpass,compound-attr,NNP-NNP,NN-NN,4,1
2093,5988.0,19,serving,2,1,15,14,0,3,1,13,Knox,sexual assault,PERSON,CRIMINAL_CHARGE-CRIMINAL_CHARGE,PROPN,ADJ-NOUN,nsubj,amod-conj,NNP,JJ-NN,5,1
2094,13055.0,25,charged,11,1,16,15,0,8,10,5,Knox,sexual assault,PERSON,CRIMINAL_CHARGE-CRIMINAL_CHARGE,PROPN,ADJ-NOUN,nsubjpass,conj-pobj,NNP,JJ-NN,5,1
2095,5996.0,27,helped,2,5,5,0,4,21,-3,3,his,his,PERSON,PERSON,DET,DET,poss,poss,PRP$,PRP$,0,1
2096,5998.0,25,wrote,2,10,12,2,9,12,-8,10,her,Alan Gross,PERSON,PERSON-PERSON,DET,PROPN-PROPN,poss,compound-appos,PRP$,NNP-NNP,1,1
2097,6001.0,83,include,2,1,82,81,0,0,1,80,OANA,Anadolu,ORGANIZATION,ORGANIZATION,PROPN,NOUN,compound,conj,NNP,NNS,15,1
2098,6003.0,19,said,5,1,4,3,0,14,4,-1,NDA,John Clarke,ORGANIZATION,PERSON-PERSON,PROPN,PROPN-PROPN,nsubj,compound-nsubj,NNP,NNP-NNP,2,1
2099,12152.0,19,said,5,1,4,3,0,14,4,-1,NDA,John Clarke,ORGANIZATION,PERSON-PERSON,PROPN,PROPN-PROPN,nmod,compound-nsubj,NNP,NNP-NNP,2,1
2100,13974.0,42,said,34,39,36,-3,38,5,-5,2,NDA,John Clarke,ORGANIZATION,PERSON-PERSON,PROPN,PROPN-PROPN,compound,compound-nsubj,NNP,NNP-NNP,3,1
2101,6004.0,35,arrested,29,4,26,22,3,8,25,-3,Chen Tao,public security administration,PERSON-PERSON,ORGANIZATION-ORGANIZATION-ORGANIZATION,PROPN-PROPN,ADJ-NOUN-NOUN,compound-conj,amod-compound-conj,NNP-NNP,JJ-NN-NN,9,1
2102,6009.0,42,born,4,1,21,20,0,20,3,17,Andrew E Lange,Joan Lange,PERSON-PERSON-PERSON,PERSON-PERSON,PROPN-PROPN-PROPN,PROPN-PROPN,compound-compound-nsubjpass,compound-pobj,NNP-NNP-NNP,NNP-NNP,6,1
2103,6018.0,17,is,1,1,4,3,0,12,0,3,He,founder,PERSON,TITLE,PRON,NOUN,nsubj,attr,PRP,NN,2,1
2104,6022.0,43,invested,10,18,21,3,17,21,-8,11,Countrywide Financial,California,ORGANIZATION-ORGANIZATION,STATE_OR_PROVINCE,PROPN-PROPN,PROPN,compound-dobj,pobj,NNP-NNP,NNP,2,1
2105,6035.0,23,draws,2,15,21,6,14,1,-13,19,Poverty and Social Impact Analysis,PSIA,ORGANIZATION-ORGANIZATION-ORGANIZATION-ORGANIZATION-ORGANIZATION,ORGANIZATION,PROPN-CCONJ-PROPN-PROPN-PROPN,PROPN,nmod-cc-compound-conj-pobj,ROOT,NNP-CC-NNP-NNP-NNP,NNP,5,1
2106,6043.0,31,Festival,4,13,13,0,12,17,-9,9,NTSO,NTSO,ORGANIZATION,ORGANIZATION,PROPN,PROPN,compound,compound,NNP,NNP,0,1
2107,6046.0,30,says,13,5,12,7,4,17,8,-1,pastor,Oklahoma,PERSON,STATE_OR_PROVINCE,NOUN,PROPN,pobj,compound,NN,NNP,3,1
2108,6052.0,28,Mailer,0,15,6,-9,14,21,-15,6,Norris Church Mailer,Massachusetts,PERSON-PERSON-PERSON,STATE_OR_PROVINCE,PROPN-PROPN-PROPN,PROPN,compound-compound-appos,appos,NNP-NNP-NNP,NNP,3,1
2109,6070.0,40,knew,2,21,19,-2,20,20,-19,17,Frank Chiafari,Police Officer,PERSON-PERSON,TITLE-TITLE,PROPN-PROPN,PROPN-PROPN,compound-conj,compound-compound,NNP-NNP,NNP-NNP,1,1
2110,13076.0,39,were,7,3,1,-2,2,37,4,-6,Frank Chiafari,Police Officer,PERSON-PERSON,TITLE-TITLE,PROPN-PROPN,PROPN-PROPN,compound-nsubj,compound-compound,NNP-NNP,NNP-NNP,1,1
2111,6083.0,43,said,21,20,18,-2,19,24,1,-3,Michael Lomax,UNCF,PERSON-PERSON,ORGANIZATION,PROPN-PROPN,PROPN,compound-nsubj,compound,NNP-NNP,NNP,1,1
2112,9670.0,4,Lomax,3,3,1,-2,2,2,0,-2,Michael Lomax,UNCF,PERSON-PERSON,ORGANIZATION,PROPN-PROPN,PROPN,compound-ROOT,poss,NNP-NNP,NNP,2,1
2113,6094.0,51,said,12,1,4,3,0,46,11,-8,Adela Dworin,vice president,PERSON-PERSON,TITLE-TITLE,PROPN-PROPN,NOUN-NOUN,compound-nsubj,compound-appos,NNP-NNP,NN-NN,1,1
2114,6108.0,20,was,14,18,16,-2,17,3,-4,2,she,30,PERSON,NUMBER,PRON,NUM,nsubj,attr,PRP,CD,1,1
2115,15499.0,23,was,14,18,16,-2,17,6,-4,2,she,30,PERSON,NUMBER,PRON,NUM,nsubj,attr,PRP,CD,1,1
2116,6109.0,29,began,2,2,7,5,1,21,0,5,ADF,Uganda,ORGANIZATION,COUNTRY,PROPN,PROPN,nsubj,pobj,NNP,NNP,1,1
2117,11958.0,9,seek,4,3,1,-2,2,7,1,-3,ADF,Uganda,ORGANIZATION,COUNTRY,PROPN,PROPN,compound,poss,NNP,NNP,2,1
2118,6122.0,24,was,14,19,23,4,18,0,-5,9,Frank Baldino Jr.,56,PERSON-PERSON-PERSON,NUMBER,PROPN-PROPN-PROPN,NUM,compound-compound-attr,appos,NNP-NNP-NNP,CD,3,1
2119,6128.0,25,split,6,11,5,-6,10,19,-5,-1,Alico,AIG,ORGANIZATION,ORGANIZATION,PROPN,PROPN,conj,nsubj,NNP,NNP,2,1
2120,7709.0,46,signaled,2,14,1,-13,13,44,-12,-1,Alico,AIG,ORGANIZATION,ORGANIZATION,PROPN,PROPN,conj,nsubj,NNP,NNP,4,1
2121,15143.0,34,is,13,33,18,-15,32,15,-20,5,Alico,AIG,ORGANIZATION,ORGANIZATION,PROPN,PROPN,appos,pobj,NNP,NNP,3,1
2122,6139.0,36,attended,4,20,30,10,19,5,-16,26,NDRC,Xia Deren,ORGANIZATION,PERSON-PERSON,PROPN,PROPN-PROPN,compound,compound-conj,NNP,NNP-NNP,3,1
2123,6144.0,39,seized,5,1,16,15,0,22,4,11,Vagni,Switzerland,PERSON,COUNTRY,PROPN,PROPN,nsubjpass,pobj,NNP,NNP,5,1
2124,6147.0,25,added,23,19,3,-16,18,21,4,-20,his,United States,PERSON,COUNTRY-COUNTRY,DET,PROPN-PROPN,poss,compound-nsubj,PRP$,NNP-NNP,6,1
2125,6161.0,33,founded,6,3,16,13,2,16,3,10,High Point Church,April,ORGANIZATION-ORGANIZATION-ORGANIZATION,PERSON,PROPN-PROPN-PROPN,PROPN,compound-compound-nsubjpass,appos,NNP-NNP-NNP,NNP,6,1
2126,6162.0,32,executed,5,7,24,17,6,7,-2,19,Wen Qiang,bribery,PERSON-PERSON,CRIMINAL_CHARGE,PROPN-PROPN,NOUN,compound-dobj,dobj,NNP-NNP,NN,6,1
2127,10064.0,33,charged,24,1,27,26,0,5,23,3,Wen Qiang,bribery,PERSON-PERSON,CRIMINAL_CHARGE,PROPN-PROPN,NOUN,compound-nsubjpass,pobj,NNP-NNP,NN,3,1
2128,10690.0,39,executed,12,14,31,17,13,7,-2,19,Wen Qiang,bribery,PERSON-PERSON,CRIMINAL_CHARGE,PROPN-PROPN,NOUN,compound-dobj,dobj,NNP-NNP,NN,6,1
2129,6171.0,38,was,1,1,22,21,0,15,0,21,He,prime minister,PERSON,TITLE-TITLE,PRON,ADJ-NOUN,nsubj,amod-appos,PRP,JJ-NN,1,1
2130,6192.0,34,lost,1,11,18,7,10,15,-10,17,Frank Baldino Jr,founder,PERSON-PERSON-PERSON,TITLE,PROPN-PROPN-PROPN,NOUN,compound-compound-dobj,appos,NNP-NNP-NNP,NN,3,1
2131,6193.0,26,sued,21,8,11,3,7,14,13,-10,Countrywide,Eric Sieracki,ORGANIZATION,PERSON-PERSON,PROPN,PROPN-PROPN,pobj,compound-conj,NNP,NNP-NNP,2,1
2132,10637.0,44,Is,3,1,33,32,0,10,2,30,Countrywide,Eric Sieracki,ORGANIZATION,PERSON-PERSON,PROPN,PROPN-PROPN,poss,compound-conj,NNP,NNP-NNP,6,1
2133,6194.0,56,said,11,30,13,-17,29,42,-19,2,National Congress of American Indians,W. Ron Allen,ORGANIZATION-ORGANIZATION-ORGANIZATION-ORGANIZATION-ORGANIZATION,PERSON-PERSON-PERSON,PROPN-PROPN-ADP-PROPN-PROPN,PROPN-PROPN-PROPN,compound-pobj-prep-compound-pobj,compound-compound-nsubj,NNP-NNP-IN-NNP-NNPS,NNP-NNP-NNP,9,1
2134,6205.0,16,is,5,7,15,8,6,0,-2,10,Countrywide Financial,IndyMac,ORGANIZATION-ORGANIZATION,ORGANIZATION,PROPN-PROPN,PROPN,compound-attr,pobj,NNP-NNP,NNP,2,1
2135,6211.0,36,suspected,14,1,5,4,0,30,13,-9,Wen Qiang,55-year-old,PERSON-PERSON,NUMBER,PROPN-PROPN,NUM,compound-nsubjpass,amod,NNP-NNP,CD,4,1
2136,6213.0,28,said,14,1,8,7,0,19,13,-6,Awaiting the verdict with other family members,"Knox 's mother , Edda Mellas , said she felt the trial had `` ended on a high note",PERSON-PERSON-PERSON-PERSON-PERSON-PERSON-PERSON,PERSON-PERSON-PERSON-PERSON-PERSON-PERSON-PERSON-PERSON-PERSON-PERSON-PERSON-PERSON-PERSON-PERSON-PERSON-PERSON-PERSON-PERSON-PERSON,VERB-DET-NOUN-ADP-ADJ-NOUN-NOUN,PROPN-PART-NOUN-PUNCT-PROPN-PROPN-PUNCT-VERB-PRON-VERB-DET-NOUN-VERB-PUNCT-VERB-ADP-DET-ADJ-NOUN,advcl-det-dobj-prep-amod-compound-pobj,poss-case-appos-punct-compound-appos-punct-ROOT-nsubj-ccomp-det-nsubj-aux-punct-ccomp-prep-det-amod-pobj,VBG-DT-NN-IN-JJ-NN-NNS,"NNP-POS-NN-,-NNP-NNP-,-VBD-PRP-VBD-DT-NN-VBD-``-VBN-IN-DT-JJ-NN",5,1
2137,6214.0,42,wake,4,29,32,3,28,9,-25,28,his,Judy Gross,PERSON,PERSON-PERSON,DET,PROPN-PROPN,poss,compound-appos,PRP$,NNP-NNP,3,1
2138,6224.0,50,formed,1,30,49,19,29,0,-29,48,he,NavTeq,PERSON,ORGANIZATION,PRON,PROPN,nsubj,pobj,PRP,NNP,2,1
2139,6256.0,32,grew,8,5,13,8,4,18,3,5,his,Pennsylvania,PERSON,STATE_OR_PROVINCE,DET,PROPN,poss,pobj,PRP$,NNP,5,1
2140,6258.0,23,said,21,7,10,3,6,12,14,-11,him,activist,PERSON,TITLE,PRON,NOUN,dobj,pobj,PRP,NN,3,1
2141,6266.0,28,survived,3,22,1,-21,21,26,-19,-2,Adam Lange,He,PERSON-PERSON,PERSON,PROPN-PROPN,PRON,compound-appos,nsubjpass,NNP-NNP,PRP,5,1
2142,6275.0,17,won,1,8,12,4,7,4,-7,11,event,South Carolina,ORGANIZATION,STATE_OR_PROVINCE-STATE_OR_PROVINCE,NOUN,PROPN-PROPN,pobj,compound-pobj,NN,NNP-NNP,3,1
2143,6276.0,14,stood,10,8,3,-5,7,10,2,-7,Eloise Spooner,farmer,PERSON-PERSON,TITLE,PROPN-PROPN,NOUN,compound-appos,nsubj,NNP-NNP,NN,3,1
2144,6285.0,34,recounted,11,31,27,-4,30,6,-20,16,Annie Mae Aquash,December 1975,PERSON-PERSON-PERSON,DATE-DATE,PROPN-PROPN-PROPN,PROPN-NUM,compound-compound-pobj,pobj-nummod,NNP-NNP-NNP,NNP-CD,11,1
2145,6290.0,35,sentenced,16,31,23,-8,30,11,-15,7,Meredith Kercher,murder,PERSON-PERSON,CRIMINAL_CHARGE,PROPN-PROPN,NOUN,compound-appos,pobj,NNP-NNP,NN,6,1
2146,6307.0,18,described,2,1,10,9,0,7,1,8,Samudio,student,PERSON,TITLE,NOUN,NOUN,nsubjpass,pobj,NN,NN,3,1
2147,6316.0,40,found,31,1,35,34,0,4,30,4,Andrew Lange,Jan 22,PERSON-PERSON,DATE-DATE,PROPN-PROPN,PROPN-NUM,compound-nsubj,pobj-nummod,NNP-NNP,NNP-CD,2,1
2148,6326.0,41,filed,1,22,9,-13,21,31,-21,8,she,Halliburton,PERSON,ORGANIZATION,PRON,PROPN,nsubjpass,compound,PRP,NNP,6,1
2149,9810.0,31,began,1,13,24,11,12,6,-12,23,she,Halliburton,PERSON,ORGANIZATION,PRON,PROPN,nsubj,compound,PRP,NNP,7,1
2150,6342.0,44,began,4,4,10,6,3,33,0,6,Bibi,Ittan,PERSON,CITY,PROPN,PROPN,pobj,compound,NNP,NNP,4,1
2151,6346.0,26,occurred,7,11,14,3,10,11,-4,7,his,Patricia Gonzalez,PERSON,PERSON-PERSON,DET,PROPN-PROPN,poss,compound-appos,PRP$,NNP-NNP,1,1
2152,6347.0,46,said,44,39,8,-31,38,37,5,-36,her,illegal gambling,PERSON,CRIMINAL_CHARGE-CRIMINAL_CHARGE,DET,ADJ-NOUN,poss,amod-compound,PRP$,JJ-NN,7,1
2153,6361.0,33,Sentencing,0,5,12,7,4,20,-5,12,General Re,Connecticut,PERSON-PERSON,STATE_OR_PROVINCE,PROPN-PROPN,PROPN,compound-aux,pobj,NNP-NNP,NNP,4,1
2154,6367.0,7,closed,2,1,5,4,0,1,1,3,New Fabris,June 16,ORGANIZATION-ORGANIZATION,DATE-DATE,PROPN-PROPN,PROPN-NUM,compound-nsubj,npadvmod-nummod,NNP-NNP,NNP-CD,3,1
2155,6397.0,31,found,7,4,2,-2,3,28,3,-5,Cerniglia,Friday,PERSON,DATE,PROPN,PROPN,poss,pobj,NNP,NNP,4,1
2156,6398.0,45,racked,33,24,28,4,23,16,9,-5,Countrywide Financial,Calabasas,ORGANIZATION-ORGANIZATION,CITY,PROPN-PROPN,PROPN,compound-compound,pobj,NNP-NNP,NNP,2,1
2157,6404.0,31,gave,12,19,8,-11,18,22,-7,-4,he,United Nations,PERSON,ORGANIZATION-ORGANIZATION,PRON,PROPN-PROPN,nsubj,compound-compound,PRP,NNP-NNP,4,1
2158,6415.0,30,called,10,6,1,-5,5,28,4,-9,Pacific Asia Travel Association,John Koldowski,ORGANIZATION-ORGANIZATION-ORGANIZATION-ORGANIZATION,PERSON-PERSON,PROPN-PROPN-PROPN-PROPN,PROPN-PROPN,compound-compound-compound-pobj,compound-nsubj,NNP-NNP-NNP-NNP,NNP-NNP,3,1
2159,6432.0,35,pronounced,13,10,16,6,9,18,3,3,his,late Saturday,PERSON,DATE-DATE,DET,ADJ-PROPN,poss,amod-npadvmod,PRP$,JJ-NNP,6,1
2160,10218.0,26,say,1,16,6,-10,15,19,-15,5,his,late Saturday,PERSON,DATE-DATE,DET,ADJ-PROPN,poss,amod-npadvmod,PRP$,JJ-NNP,4,1
2161,12460.0,28,say,1,18,6,-12,17,21,-17,5,his,late Saturday,PERSON,DATE-DATE,DET,ADJ-PROPN,poss,amod-npadvmod,PRP$,JJ-NNP,4,1
2162,6433.0,32,asked,8,1,6,5,0,25,7,-2,The American,Curt Knox,PERSON-PERSON,PERSON-PERSON,DET-PROPN,PROPN-PROPN,det-poss,compound-appos,DT-NNP,NNP-NNP,2,1
2163,6441.0,12,is,5,5,9,4,4,2,0,4,ADF,Muslim,ORGANIZATION,RELIGION,PROPN,ADJ,nsubj,amod,NNP,JJ,4,1
2164,8655.0,37,pointed,18,35,25,-10,34,11,-17,7,ADF,Muslim,ORGANIZATION,RELIGION,PROPN,ADJ,compound,amod,NNP,JJ,2,1
2165,11087.0,39,is,2,2,5,3,1,33,0,3,ADF,Muslim,ORGANIZATION,RELIGION,PROPN,ADJ,nsubj,amod,NNP,JJ,2,1
2166,12361.0,45,pointed,26,43,33,-10,42,11,-17,7,ADF,Muslim,ORGANIZATION,RELIGION,PROPN,ADJ,compound,amod,NNP,JJ,2,1
2167,6453.0,51,dismissed,31,8,11,3,7,39,23,-20,John Graham,administrator,PERSON-PERSON,TITLE,PROPN-PROPN,NOUN,compound-appos,appos,NNP-NNP,NN,2,1
2168,6461.0,47,said,1,27,36,9,26,10,-26,35,he,China,PERSON,COUNTRY,PRON,PROPN,nsubj,pobj,PRP,NNP,5,1
2169,6464.0,61,issued,8,2,8,6,1,52,6,0,UASR,Fattah,ORGANIZATION,PERSON,PROPN,NOUN,compound,nsubj,NNP,NN,2,1
2170,6468.0,38,said,17,17,10,-7,16,27,0,-7,Rashid,U.S.,PERSON,COUNTRY,PROPN,PROPN,nsubj,pobj,NNP,NNP,6,1
2171,6473.0,18,described,2,1,12,11,0,5,1,10,Samudio,model,PERSON,TITLE,NOUN,NOUN,nsubjpass,conj,NN,NN,4,1
2172,6476.0,27,com,0,20,11,-9,19,15,-20,11,baby,homicide,PERSON,CAUSE_OF_DEATH,NOUN,NOUN,poss,attr,NN,NN,6,1
2173,6479.0,25,wrote,2,10,1,-9,9,23,-8,-1,her,Judy Gross,PERSON,PERSON-PERSON,DET,PROPN-PROPN,poss,compound-nsubj,PRP$,NNP-NNP,5,1
2174,6480.0,26,remains,15,15,25,10,14,0,0,10,she,Ohio,PERSON,STATE_OR_PROVINCE,PRON,PROPN,nsubj,pobj,PRP,NNP,1,1
2175,6500.0,23,submitted,2,11,1,-10,10,21,-9,-1,Central American Parliament,Panama,ORGANIZATION-ORGANIZATION-ORGANIZATION,ORGANIZATION,ADJ-ADJ-PROPN,PROPN,compound-compound-dobj,nsubj,JJ-JJ-NNP,NNP,7,1
2176,10836.0,12,withdraws,1,4,1,-3,3,10,-3,0,Central American Parliament,Panama,ORGANIZATION-ORGANIZATION-ORGANIZATION,ORGANIZATION,ADJ-PROPN-PROPN,PROPN,amod-compound-pobj,nsubj,JJ-NNP-NNP,NNP,3,1
2177,6504.0,27,found,3,1,6,5,0,20,2,3,Carol Daniels,Aug. 23,PERSON-PERSON,DATE-DATE,PROPN-PROPN,PROPN-NUM,compound-nsubjpass,npadvmod-nummod,NNP-NNP,NNP-CD,3,1
2178,6511.0,30,teaches,16,1,11,10,0,18,15,-5,Wayne A. Holst,Albertan,PERSON-PERSON-PERSON,LOCATION,PROPN-PROPN-PROPN,PROPN,compound-compound-nsubj,conj,NNP-NNP-NNP,NNP,3,1
2179,6517.0,22,teaches,4,1,8,7,0,13,3,4,Wayne A Holst,University of Calgary,PERSON-PERSON-PERSON,ORGANIZATION-ORGANIZATION-ORGANIZATION,PROPN-PROPN-NOUN,PROPN-ADP-PROPN,compound-det-dep,pobj-prep-pobj,NNP-NNP-NN,NNP-IN-NNP,5,1
2180,6526.0,13,Meyssan,1,8,5,-3,7,7,-7,4,he,French,PERSON,NATIONALITY,PRON,ADJ,nsubj,amod,PRP,JJ,2,1
2181,6532.0,29,labeled,6,4,19,15,3,9,2,13,Xie Caiping,Chongqing Municipality,PERSON-PERSON,LOCATION-LOCATION,PROPN-PROPN,PROPN-PROPN,compound-nsubj,compound-pobj,NNP-NNP,NNP-NNP,4,1
2182,6533.0,43,says,5,7,32,25,6,10,-2,27,she,Iraqi,PERSON,NATIONALITY,PRON,ADJ,nsubjpass,amod,PRP,JJ,-1,1
2183,6541.0,56,wounded,48,23,40,17,22,15,25,-8,George Sodini,Pennsylvania,PERSON-PERSON,STATE_OR_PROVINCE,PROPN-PROPN,PROPN,compound-nsubj,compound,NNP-NNP,NNP,9,1
2184,13938.0,17,said,3,11,16,5,10,0,-8,13,George Sodini,Pennsylvania,PERSON-PERSON,STATE_OR_PROVINCE,PROPN-PROPN,PROPN,compound-pobj,appos,NNP-NNP,NNP,4,1
2185,6547.0,30,taken,14,4,28,24,3,1,10,14,Baldino,chief executive,PERSON,TITLE-TITLE,PROPN,ADJ-NOUN,nsubj,amod-conj,NNP,JJ-NN,7,1
2186,6555.0,25,in,0,9,12,3,8,12,-9,12,The,wwwqatalyscom,ORGANIZATION,URL,DET,NOUN,det,acomp,DT,NN,3,1
2187,6564.0,31,by,1,7,26,19,6,4,-6,25,Mailer,Penn State,PERSON,ORGANIZATION-ORGANIZATION,PROPN,PROPN-PROPN,pobj,compound-pobj,NNP,NNP-NNP,5,1
2188,6565.0,20,graduated,1,1,7,6,0,12,0,6,He,Allentown,PERSON,CITY,PRON,PROPN,nsubj,pobj,PRP,NNP,5,1
2189,6579.0,27,Bio,2,5,1,-4,4,25,-3,-1,Wayne A. Holst,Reviewer,PERSON-PERSON-PERSON,TITLE,PROPN-PROPN-PROPN,PROPN,compound-compound-nsubj,poss,NNP-NNP-NNP,NNP,5,1
2190,6580.0,48,CHONGQING,0,20,38,18,19,9,-20,38,She,harboring people taking illegal narcotics,PERSON,CRIMINAL_CHARGE-CRIMINAL_CHARGE-CRIMINAL_CHARGE-CRIMINAL_CHARGE-CRIMINAL_CHARGE,PRON,VERB-NOUN-VERB-ADJ-NOUN,nsubjpass,advcl-dobj-acl-amod-dobj,PRP,VBG-NNS-VBG-JJ-NNS,-1,1
2191,6582.0,27,dismissed,11,2,6,4,1,20,9,-5,his,`` Young Patriots,PERSON,ORGANIZATION-ORGANIZATION-ORGANIZATION,DET,PUNCT-PROPN-PROPN,poss,punct-compound-pobj,PRP$,``-NNP-NNPS,4,1
2192,6583.0,15,is,1,1,14,13,0,0,0,13,He,suicide,PERSON,CAUSE_OF_DEATH,PRON,NOUN,nsubj,dobj,PRP,NN,1,1
2193,6625.0,38,started,14,10,8,-2,9,29,4,-6,Quentin Fabris,Eugene,PERSON-PERSON,PERSON,PROPN-PROPN,PROPN,conj-appos,appos,NNP-NNP,NNP,2,1
2194,6630.0,42,said,39,23,14,-9,22,27,16,-25,an American,Cuba,PERSON-PERSON,COUNTRY,DET-PROPN,PROPN,det-amod,pobj,DT-NNP,NNP,6,1
2195,6643.0,35,revised,12,10,4,-6,9,30,2,-8,Silsby,child abduction,PERSON,CRIMINAL_CHARGE-CRIMINAL_CHARGE,PROPN,NOUN-NOUN,pobj,compound-pobj,NNP,NN-NN,4,1
2196,6645.0,14,was,1,5,3,-2,4,10,-4,2,her,4,PERSON,NUMBER,DET,NUM,poss,attr,PRP$,CD,2,1
2197,6651.0,26,welcome,2,10,15,5,9,10,-8,13,Mamane,Claudine,PERSON,PERSON,PROPN,PROPN,nsubj,appos,NNP,NNP,3,1
2198,6653.0,18,recorded,6,11,14,3,10,3,-5,8,his,"Aug. 4 , 2009",PERSON,DATE-DATE-DATE-DATE,DET,PROPN-NUM-PUNCT-NUM,poss,pobj-nummod-punct-nummod,PRP$,"NNP-CD-,-CD",6,1
2199,6661.0,30,graduated,1,1,7,6,0,22,0,6,Sodini,University of Pittsburgh,PERSON,ORGANIZATION-ORGANIZATION-ORGANIZATION,PROPN,PROPN-ADP-PROPN,nsubj,pobj-prep-pobj,NNP,NNP-IN-NNP,3,1
2200,6664.0,23,cousin,4,1,7,6,0,15,3,3,Benjamin Chertoff,Michael Chertoff,PERSON-PERSON,PERSON-PERSON,PROPN-PROPN,PROPN-PROPN,compound-nmod,compound-pobj,NNP-NNP,NNP-NNP,2,1
2201,12714.0,23,cousin,4,1,7,6,0,15,3,3,Benjamin Chertoff,Michael Chertoff,PERSON-PERSON,PERSON-PERSON,PROPN-PROPN,PROPN-PROPN,compound-compound,compound-pobj,NNP-NNP,NNP-NNP,2,1
2202,13197.0,19,hit,13,1,6,5,0,12,12,-7,Benjamin Chertoff,Michael Chertoff,PERSON-PERSON,PERSON-PERSON,PROPN-PROPN,PROPN-PROPN,nmod-nmod,compound-pobj,NNP-NNP,NNP-NNP,2,1
2203,6666.0,47,killed,6,42,43,1,41,3,-36,37,her,Christian,ORGANIZATION,RELIGION,DET,ADJ,poss,amod,PRP$,JJ,1,1
2204,6685.0,26,is,6,3,2,-1,2,23,3,-4,Progressive Democrats of America,http://pdamerica.org,ORGANIZATION-ORGANIZATION-ORGANIZATION-ORGANIZATION,URL,PROPN-PROPN-ADP-PROPN,PROPN,compound-nsubj-prep-pobj,compound,NNP-NNPS-IN-NNP,NNP,1,1
2205,6686.0,37,served,3,3,10,7,2,26,0,7,Wen,Chongqing Municipal Public Security Bureau,PERSON,ORGANIZATION-ORGANIZATION-ORGANIZATION-ORGANIZATION-ORGANIZATION,PROPN,PROPN-PROPN-PROPN-PROPN-PROPN,nsubj,compound-compound-compound-compound-pobj,NNP,NNP-NNP-NNP-NNP-NNP,5,1
2206,6690.0,89,Smith,2,6,12,6,5,76,-4,10,High Point Church,Texas,ORGANIZATION-ORGANIZATION-ORGANIZATION,STATE_OR_PROVINCE,PROPN-PROPN-PROPN,PROPN,compound-compound-appos,compound,NNP-NNP-NNP,NNP,3,1
2207,6707.0,28,said,10,2,5,3,1,22,8,-5,Mark Fisher,LBG,PERSON-PERSON,ORGANIZATION,PROPN-PROPN,PROPN,compound-nsubj,compound,NNP-NNP,NNP,1,1
2208,12654.0,29,said,13,15,18,3,14,10,-2,5,Mark Fisher,LBG,PERSON-PERSON,ORGANIZATION,PROPN-PROPN,PROPN,compound-nsubj,compound,NNP-NNP,NNP,3,1
2209,6721.0,11,Football,0,5,3,-2,4,7,-5,3,Miettinen,Finland,PERSON,COUNTRY,PROPN,PROPN,nsubj,poss,NNP,NNP,3,1
2210,11239.0,50,Football,0,5,3,-2,4,46,-5,3,Miettinen,Finland,PERSON,NATIONALITY,PROPN,PROPN,nsubj,poss,NNP,NNP,3,1
2211,6748.0,29,traveled,1,9,8,-1,8,20,-8,7,Menil Collection,de Menil,ORGANIZATION-ORGANIZATION,PERSON-PERSON,PROPN-PROPN,X-PROPN,compound-dobj,compound-nsubj,NNP-NNP,FW-NNP,1,1
2212,6753.0,27,MAILER,2,1,5,4,0,21,1,3,NORRIS CHURCH MAILER,ARTIST,PERSON-PERSON-PERSON,TITLE,PROPN-NOUN-ADV,PROPN,compound-compound-ROOT,appos,NNP-NN-RB,NNP,3,1
2213,6759.0,39,screening,25,12,21,9,11,17,13,-4,Craig Ranke,CIT,PERSON-PERSON,ORGANIZATION,PROPN-PROPN,PROPN,compound-nsubj,compound,NNP-NNP,NNP,1,1
2214,6764.0,24,said,1,9,16,7,8,7,-8,15,her,attack,PERSON,CAUSE_OF_DEATH,DET,NOUN,poss,pobj,PRP$,NN,2,1
2215,8311.0,24,said,1,9,16,7,8,7,-8,15,her,attack,PERSON,CAUSE_OF_DEATH,DET,NOUN,poss,pobj,PRP$,NN,2,1
2216,6779.0,35,include,9,11,26,15,10,8,-2,17,her,Maggie Mailer,PERSON,PERSON-PERSON,DET,PROPN-PROPN,poss,compound-conj,PRP$,NNP-NNP,7,1
2217,6781.0,62,poised,15,10,14,4,9,47,5,-1,Jamie Leigh Jones,Congress,PERSON-PERSON-PERSON,ORGANIZATION,PROPN-PROPN-PROPN,PROPN,compound-compound-pobj,nsubjpass,NNP-NNP-NNP,NNP,6,1
2218,6783.0,19,has,5,5,7,2,4,11,0,2,ALICO,"12,500",ORGANIZATION,NUMBER,PROPN,NUM,nsubj,nummod,NNP,CD,1,1
2219,6784.0,17,born,2,1,16,15,0,0,1,14,Baldino,Pennsylvania,PERSON,STATE_OR_PROVINCE,PROPN,PROPN,nsubjpass,conj,NNP,NNP,2,1
2220,6788.0,43,gave,14,5,23,18,4,19,9,9,Hollister Inc.,Burlington,ORGANIZATION-ORGANIZATION,CITY,PROPN-PROPN,PROPN,compound-nsubj,compound,NNP-NNP,NNP,7,1
2221,6789.0,29,face,11,7,10,3,6,18,4,-1,Denaro,Salvatore,PERSON,PERSON,PROPN,PROPN,poss,appos,NNP,NNP,6,1
2222,6795.0,46,urged,17,13,7,-6,12,38,4,-10,Charles Ble Goude,General,PERSON-PERSON-PERSON,TITLE,PROPN-PROPN-PROPN,PROPN,compound-compound-pobj,nsubj,NNP-NNP-NNP,NNP,5,1
2223,7580.0,38,brought,8,35,26,-9,34,11,-27,18,Charles Ble Goude,General,PERSON-PERSON-PERSON,TITLE,PROPN-PROPN-PROPN,PROPN,compound-compound-dobj,appos,NNP-NNP-NNP,NNP,4,1
2224,8390.0,39,urged,18,15,10,-5,14,28,3,-8,Charles Ble Goude,General,PERSON-PERSON-PERSON,TITLE,PROPN-PROPN-PROPN,PROPN,compound-compound-conj,nmod,NNP-NNP-NNP,NNP,4,1
2225,10704.0,41,urged,17,12,6,-6,11,34,5,-11,Charles Ble Goude,General,PERSON-PERSON-PERSON,TITLE,PROPN-PROPN-PROPN,PROPN,compound-compound-pobj,nsubj,NNP-NNP-NNP,NNP,5,1
2226,6800.0,41,believe,1,13,7,-6,12,33,-12,6,Arlo Looking Cloud,AIM,PERSON-PERSON-PERSON,ORGANIZATION,PROPN-PROPN-PROPN,PROPN,compound-compound-conj,compound,NNP-NNP-NNP,NNP,3,1
2227,6803.0,38,was,1,11,21,10,10,16,-10,20,Mario Gonzalez,Patricia Gonzalez,PERSON-PERSON,PERSON-PERSON,PROPN-PROPN,PROPN-PROPN,compound-dobj,compound-pobj,NNP-NNP,NNP-NNP,3,1
2228,6804.0,42,said,32,18,7,-11,17,34,14,-25,ALICO,AIG Star Life Insurance Co,ORGANIZATION,ORGANIZATION-ORGANIZATION-ORGANIZATION-ORGANIZATION-ORGANIZATION,PROPN,PROPN-PROPN-PROPN-PROPN-PROPN,compound,compound-compound-compound-compound-conj,NNP,NNP-NNP-NNP-NNP-NNP,3,1
2229,6838.0,39,attorney,2,37,1,-36,36,37,-35,-1,her,Graham,PERSON,PERSON,DET,PROPN,poss,dobj,PRP$,NNP,10,1
2230,6846.0,40,said,35,1,5,4,0,34,34,-30,Countrywide Financial Corp.,Angelo Mozilo,ORGANIZATION-ORGANIZATION-ORGANIZATION,PERSON-PERSON,PROPN-PROPN-PROPN,PROPN-PROPN,compound-compound-compound,compound-nsubj,NNP-NNP-NNP,NNP-NNP,3,1
2231,6856.0,37,born,3,1,28,27,0,8,2,25,Ble Goude,Students ' Federation of Ivory Coast,PERSON-PERSON,ORGANIZATION-ORGANIZATION-ORGANIZATION-ORGANIZATION-ORGANIZATION-ORGANIZATION,PROPN-PROPN,NOUN-PART-PROPN-ADP-PROPN-PROPN,compound-nsubjpass,poss-case-pobj-prep-compound-pobj,NNP-NNP,NNS-POS-NNP-IN-NNP-NNP,8,1
2232,6864.0,37,Italy,0,3,1,-2,2,35,-3,1,Knox,Italy,PERSON,COUNTRY,PROPN,PROPN,nsubj,ROOT,NNP,NNP,-1,1
2233,13793.0,17,said,7,9,1,-8,8,15,-2,-6,Knox,Italy,PERSON,COUNTRY,PROPN,PROPN,poss,poss,NNP,NNP,7,1
2234,6865.0,24,is,1,7,1,-6,6,22,-6,0,Pluribus Capital Management,E5,ORGANIZATION-ORGANIZATION-ORGANIZATION,ORGANIZATION,PROPN-PROPN-PROPN,PROPN,compound-compound-pobj,nsubj,NNP-NNP-NNP,NNP,4,1
2235,6872.0,67,is,1,9,21,12,8,45,-8,20,Heloise,Texas,PERSON,STATE_OR_PROVINCE,PROPN,PROPN,poss,pobj,NNP,NNP,5,1
2236,14199.0,30,see,1,3,10,7,2,19,-2,9,Heloise,Texas,PERSON,STATE_OR_PROVINCE,PROPN,PROPN,nsubj,compound,NNP,NNP,4,1
2237,6883.0,29,wrote,6,5,16,11,4,12,1,10,Nir Rosen,New York Times Sunday Magazine,PERSON-PERSON,ORGANIZATION-ORGANIZATION-ORGANIZATION-ORGANIZATION-ORGANIZATION,PROPN-PROPN,PROPN-PROPN-PROPN-PROPN-PROPN,compound-nsubj,compound-compound-compound-compound-pobj,NNP-NNP,NNP-NNP-NNP-NNP-NNP,7,1
2238,6886.0,22,took,1,1,13,12,0,8,0,12,She,Los Angeles,PERSON,CITY-CITY,PRON,PROPN-PROPN,nsubj,compound-pobj,PRP,NNP-NNP,3,1
2239,6890.0,30,arrested,2,5,27,22,4,2,-3,25,his,Northwest Frontier Province,PERSON,LOCATION-LOCATION-LOCATION,DET,PROPN-PROPN-PROPN,poss,compound-compound-pobj,PRP$,NNP-NNP-NNP,7,1
2240,6896.0,41,said,31,3,26,23,2,14,28,-5,Alan Gross,United States,PERSON-PERSON,NATIONALITY-NATIONALITY,PROPN-PROPN,PROPN-PROPN,compound-nsubj,compound-pobj,NNP-NNP,NNP-NNP,13,1
2241,9354.0,34,added,32,20,12,-8,19,21,12,-20,Alan Gross,United States,PERSON-PERSON,NATIONALITY-NATIONALITY,PROPN-PROPN,PROPN-PROPN,compound-pobj,compound-appos,NNP-NNP,NNP-NNP,6,1
2242,6929.0,15,is,3,1,5,4,0,9,2,2,Michael L. Lomax,president,PERSON-PERSON-PERSON,TITLE,PROPN-PROPN-PROPN,NOUN,compound-compound-nsubj,attr,NNP-NNP-NNP,NN,4,1
2243,6937.0,30,said,7,5,1,-4,4,28,2,-6,Ashiq Masih,Bibi,PERSON-PERSON,PERSON,PROPN-PROPN,PROPN,compound-appos,poss,NNP-NNP,NNP,3,1
2244,6938.0,7,by,0,2,4,2,1,2,-2,4,Christopher Bollyn,Reporter,PERSON-PERSON,TITLE,PROPN-PROPN,NOUN,compound-compound,compound,NNP-NNP,NN,2,1
2245,6950.0,27,Bio,2,5,10,5,4,16,-3,8,Wayne A. Holst,writer,PERSON-PERSON-PERSON,TITLE,PROPN-PROPN-PROPN,NOUN,compound-compound-nsubj,attr,NNP-NNP-NNP,NN,5,1
2246,6954.0,39,Yusuf,2,19,26,7,18,12,-17,24,Organization of Asia Pacific News Agencies,OANA,ORGANIZATION-ORGANIZATION-ORGANIZATION-ORGANIZATION-ORGANIZATION-ORGANIZATION,ORGANIZATION,PROPN-ADP-PROPN-PROPN-PROPN-PROPN,PROPN,pobj-prep-compound-compound-compound-pobj,compound,NNP-IN-NNP-NNP-NNP-NNPS,NNP,-1,1
2247,13599.0,46,issued,13,5,12,7,4,33,8,-1,Organization of Asia Pacific News Agencies,OANA,ORGANIZATION-ORGANIZATION-ORGANIZATION-ORGANIZATION-ORGANIZATION-ORGANIZATION,ORGANIZATION,PROPN-ADP-PROPN-PROPN-PROPN-PROPN,PROPN,pobj-prep-compound-compound-compound-pobj,compound,NNP-IN-NNP-NNP-NNP-NNPS,NNP,4,1
2248,6957.0,16,said,1,4,6,2,3,9,-3,5,she,Catholic,PERSON,RELIGION,PRON,ADJ,nsubj,acomp,PRP,JJ,1,1
2249,13292.0,16,said,1,4,6,2,3,9,-3,5,she,Catholic,PERSON,RELIGION,PRON,ADJ,nsubj,acomp,PRP,JJ,1,1
2250,6982.0,34,charged,10,1,16,15,0,17,9,6,Graham,second-degree murder,PERSON,CRIMINAL_CHARGE-CRIMINAL_CHARGE,PROPN,ADJ-NOUN,nsubjpass,conj-pobj,NNP,JJ-NN,7,1
2251,14578.0,39,charged,21,11,27,16,10,11,10,6,Graham,second-degree murder,PERSON,CRIMINAL_CHARGE-CRIMINAL_CHARGE,PROPN,ADJ-NOUN,dobj,conj-pobj,NNP,JJ-NN,10,1
2252,6995.0,25,moved,1,9,17,8,8,7,-8,16,National Congress of American Indians,her,ORGANIZATION-ORGANIZATION-ORGANIZATION-ORGANIZATION-ORGANIZATION,PERSON,PROPN-PROPN-ADP-PROPN-PROPN,PRON,compound-pobj-prep-compound-pobj,dobj,NNP-NNP-IN-NNP-NNPS,PRP,4,1
2253,6996.0,14,said,12,1,9,8,0,4,11,-3,He,captain,PERSON,TITLE,PRON,NOUN,nsubjpass,pobj,PRP,NN,3,1
2254,6998.0,10,knew,8,1,6,5,0,3,7,-2,His,Condoleezza Rice,PERSON,PERSON-PERSON,DET,PROPN-PROPN,poss,compound-appos,PRP$,NNP-NNP,3,1
2255,7001.0,35,Think,2,7,21,14,6,13,-5,19,Mark Fisher,CA,PERSON-PERSON,STATE_OR_PROVINCE,PROPN-PROPN,PROPN,compound-pobj,conj,NNP-NNP,NNP,6,1
2256,7005.0,33,2007-12-16T23,0,5,4,-1,4,28,-5,4,Matteo Messina Denaro,boss,PERSON-PERSON-PERSON,TITLE,PROPN-PROPN-PROPN,NOUN,compound-compound-nsubj,compound,NNP-NNP-NNP,NN,2,1
2257,7006.0,35,President,0,7,12,5,6,22,-7,12,Pacific Asia Travel Association,Peter de Jong,ORGANIZATION-ORGANIZATION-ORGANIZATION-ORGANIZATION,PERSON-PERSON-PERSON,PROPN-PROPN-PROPN-PROPN,PROPN-PROPN-PROPN,compound-compound-compound-pobj,compound-compound-nsubj,NNP-NNP-NNP-NNP,NNP-NNP-NNP,4,1
2258,7010.0,43,says,5,11,14,3,10,28,-6,9,her,Iraq,PERSON,COUNTRY,DET,PROPN,poss,pobj,PRP$,NNP,3,1
2259,14957.0,50,told,5,7,12,5,6,37,-2,7,her,Iraq,PERSON,COUNTRY,PRON,PROPN,dobj,dobj,PRP,NNP,4,1
2260,7042.0,14,Call,5,3,1,-2,2,12,2,-4,PDA,Tim Carpenter,ORGANIZATION,PERSON-PERSON,PROPN,PROPN-PROPN,compound,compound-compound,NNP,NNP-NNP,3,1
2261,7749.0,16,URGENT,0,10,8,-2,9,7,-10,8,PDA,Tim Carpenter,ORGANIZATION,PERSON-PERSON,PROPN,PROPN-PROPN,compound,compound-compound,NNP,NNP-NNP,4,1
2262,12080.0,64,*,0,40,38,-2,39,25,-40,38,PDA,Tim Carpenter,ORGANIZATION,PERSON-PERSON,PROPN,PROPN-PROPN,compound,compound-ROOT,NNP,NNP-NNP,4,1
2263,7043.0,48,accused,17,1,5,4,0,42,16,-12,Wen Qiang,deputy police chief,PERSON-PERSON,TITLE-TITLE-TITLE,PROPN-PROPN,NOUN-NOUN-NOUN,compound-nsubjpass,compound-compound-appos,NNP-NNP,NN-NN-NN,2,1
2264,11826.0,21,stood,16,1,5,4,0,15,15,-11,Wen Qiang,deputy police chief,PERSON-PERSON,TITLE-TITLE-TITLE,PROPN-PROPN,NOUN-NOUN-NOUN,compound-nsubj,compound-compound-appos,NNP-NNP,NN-NN-NN,2,1
2265,7054.0,35,Shield,2,29,32,3,28,2,-27,30,Defence Force,ADF,ORGANIZATION-ORGANIZATION,ORGANIZATION,PROPN-PROPN,PROPN,compound-npadvmod,compound,NNP-NNP,NNP,1,1
2266,7057.0,43,said,28,38,30,-8,37,12,-10,2,American Association of University Women,Catherine Hill,ORGANIZATION-ORGANIZATION-ORGANIZATION-ORGANIZATION-ORGANIZATION,PERSON-PERSON,PROPN-PROPN-ADP-PROPN-PROPN,PROPN-PROPN,compound-pobj-prep-compound-pobj,compound-nsubj,NNP-NNP-IN-NNP-NNPS,NNP-NNP,5,1
2267,10412.0,35,said,20,30,22,-8,29,12,-10,2,American Association of University Women,Catherine Hill,ORGANIZATION-ORGANIZATION-ORGANIZATION-ORGANIZATION-ORGANIZATION,PERSON-PERSON,PROPN-PROPN-ADP-PROPN-PROPN,PROPN-PROPN,compound-pobj-prep-compound-pobj,compound-nsubj,NNP-NNP-IN-NNP-NNPS,NNP-NNP,5,1
2268,7070.0,32,said,24,9,1,-8,8,30,15,-23,National Congress of American Indians,Jacqueline Johnson Pata,ORGANIZATION-ORGANIZATION-ORGANIZATION-ORGANIZATION-ORGANIZATION,PERSON-PERSON-PERSON,PROPN-PROPN-ADP-PROPN-PROPN,PROPN-PROPN-PROPN,compound-pobj-prep-compound-pobj,compound-compound-nsubj,NNP-NNP-IN-NNP-NNPS,NNP-NNP-NNP,4,1
2269,13995.0,32,said,24,9,1,-8,8,30,15,-23,National Congress of American Indians,Jacqueline Johnson Pata,ORGANIZATION-ORGANIZATION-ORGANIZATION-ORGANIZATION-ORGANIZATION,PERSON-PERSON-PERSON,PROPN-PROPN-ADP-PROPN-PROPN,PROPN-PROPN-PROPN,compound-pobj-prep-compound-pobj,compound-compound-nsubj,NNP-NNP-IN-NNP-NNPS,NNP-NNP-NNP,4,1
2270,7072.0,39,BEIJING,0,14,8,-6,13,30,-14,8,China Charity Federation,Fan Baojun,ORGANIZATION-ORGANIZATION-ORGANIZATION,PERSON-PERSON,PROPN-PROPN-PROPN,PROPN-PROPN,compound-compound-pobj,compound-nsubj,NNP-NNP-NNP,NNP-NNP,4,1
2271,7081.0,29,recommended,6,18,15,-3,17,13,-12,9,Asia Bibi,blasphemy,PERSON-PERSON,CRIMINAL_CHARGE,PROPN-PROPN,NOUN,compound-pobj,compound,NNP-NNP,NN,4,1
2272,7463.0,31,is,13,1,24,23,0,6,12,11,Asia Bibi,blasphemy,PERSON-PERSON,CRIMINAL_CHARGE,PROPN-PROPN,NOUN,compound-nsubj,pobj,NNP-NNP,NN,2,1
2273,7663.0,23,said,1,12,9,-3,11,13,-11,8,Asia Bibi,blasphemy,PERSON-PERSON,CRIMINAL_CHARGE,PROPN-PROPN,NOUN,compound-pobj,compound,NNP-NNP,NN,4,1
2274,7089.0,30,told,10,4,7,3,3,22,6,-3,Laura Silsby,"Meridian , Idaho",PERSON-PERSON,CITY-CITY-CITY,PROPN-PROPN,PROPN-PUNCT-PROPN,compound-appos,pobj-punct-appos,NNP-NNP,"NNP-,-NNP",3,1
2275,7096.0,35,said,12,7,1,-6,6,33,5,-11,PATA,John Koldowski,ORGANIZATION,PERSON-PERSON,PROPN,PROPN-PROPN,compound,compound-nsubj,NNP,NNP-NNP,4,1
2276,7099.0,60,says,42,52,44,-8,51,15,-10,2,Tribeca Enterprises,Geoff Gilmore,ORGANIZATION-ORGANIZATION,PERSON-PERSON,PROPN-PROPN,PROPN-PROPN,compound-pobj,compound-nsubj,NNP-NNPS,NNP-NNP,5,1
2277,10347.0,32,said,1,20,14,-6,19,17,-19,13,Tribeca Enterprises,Geoff Gilmore,ORGANIZATION-ORGANIZATION,PERSON-PERSON,PROPN-PROPN,PROPN-PROPN,compound-pobj,compound-nsubj,NNP-NNPS,NNP-NNP,3,1
2278,7117.0,37,said,13,8,1,-7,7,35,5,-12,National Congress of American Indians,Robert Holden,ORGANIZATION-ORGANIZATION-ORGANIZATION-ORGANIZATION-ORGANIZATION,PERSON-PERSON,PROPN-PROPN-ADP-PROPN-PROPN,PROPN-PROPN,compound-pobj-prep-compound-pobj,compound-nsubj,NNP-NNP-IN-NNP-NNPS,NNP-NNP,3,1
2279,14096.0,37,said,13,8,1,-7,7,35,5,-12,National Congress of American Indians,Robert Holden,ORGANIZATION-ORGANIZATION-ORGANIZATION-ORGANIZATION-ORGANIZATION,PERSON-PERSON,PROPN-PROPN-ADP-PROPN-PROPN,PROPN-PROPN,compound-pobj-prep-compound-pobj,compound-nsubj,NNP-NNP-IN-NNP-NNPS,NNP-NNP,3,1
2280,7122.0,26,worked,5,5,3,-2,4,22,0,-2,Cerniglia,chef,PERSON,TITLE,PROPN,NOUN,nsubj,advcl,NNP,NN,3,1
2281,7124.0,22,are,1,19,13,-6,18,8,-18,12,National Restaurant Association,United States,ORGANIZATION-ORGANIZATION-ORGANIZATION,COUNTRY-COUNTRY,PROPN-PROPN-PROPN,PROPN-PROPN,compound-compound-pobj,compound-pobj,NNP-NNP-NNP,NNP-NNP,3,1
2282,7142.0,44,said,5,7,35,28,6,8,-2,30,the boy,Patrick,PERSON-PERSON,PERSON,DET-NOUN,PROPN,det-nsubj,appos,DT-NN,NNP,6,1
2283,7152.0,44,said,5,19,41,22,18,2,-14,36,he,Enzo,PERSON,PERSON,PRON,PROPN,nsubj,ROOT,PRP,NNP,6,1
2284,7160.0,46,quoted,12,10,2,-8,9,43,2,-10,TPI,Peter Allen,ORGANIZATION,PERSON-PERSON,PROPN,PROPN-PROPN,appos,compound-nsubjpass,NNP,NNP-NNP,2,1
2285,7162.0,35,recounted,15,15,26,11,14,8,0,11,he,Red Cross,PERSON,ORGANIZATION-ORGANIZATION,PRON,PROPN-PROPN,nsubjpass,compound-compound,PRP,NNP-NNP,4,1
2286,12871.0,25,told,8,13,2,-11,12,22,-5,-6,he,Red Cross,PERSON,ORGANIZATION-ORGANIZATION,PRON,PROPN-PROPN,nsubj,compound-compound,PRP,NNP-NNP,4,1
2287,7165.0,48,says,17,31,19,-12,30,28,-14,2,PDA,Darcy Sweeney,ORGANIZATION,PERSON-PERSON,PROPN,PROPN-PROPN,compound,compound-nsubj,NNP,NNP-NNP,-1,1
2288,7166.0,24,President,5,7,1,-6,6,22,-2,-4,"THE GOOD BROKER , LLC",Jason E Brown,ORGANIZATION-ORGANIZATION-ORGANIZATION-ORGANIZATION-ORGANIZATION,PERSON-PERSON-PERSON,DET-ADJ-PROPN-PUNCT-PROPN,PROPN-PROPN-PROPN,det-amod-appos-punct-appos,compound-compound-compound,"DT-JJ-NNP-,-NNP",NNP-NNP-NNP,4,1
2289,14329.0,32,2007-11-01T19,0,12,6,-6,11,25,-12,6,"THE GOOD BROKER , LLC",Jason E Brown,ORGANIZATION-ORGANIZATION-ORGANIZATION-ORGANIZATION-ORGANIZATION,PERSON-PERSON-PERSON,DET-ADJ-PROPN-PUNCT-PROPN,PROPN-PROPN-PROPN,det-amod-appos-punct-npadvmod,compound-compound-compound,"DT-JJ-NNP-,-NNP",NNP-NNP-NNP,4,1
2290,7181.0,39,was,1,1,33,32,0,5,0,32,She,Cuba,PERSON,COUNTRY,PRON,PROPN,nsubj,pobj,PRP,NNP,1,1
2291,7192.0,34,accused,8,7,29,22,6,4,1,21,Amanda Knox,Italian,PERSON-PERSON,NATIONALITY,PROPN-PROPN,ADJ,compound-pobj,amod,NNP-NNP,JJ,7,1
2292,7201.0,28,jumped,17,2,6,4,1,21,15,-11,Joseph Cerniglia,contestant,PERSON-PERSON,TITLE,PROPN-PROPN,NOUN,compound-nsubj,appos,NNP-NNP,NN,2,1
2293,7214.0,42,According,0,20,16,-4,19,25,-20,16,NUL,National Urban League,ORGANIZATION,ORGANIZATION-ORGANIZATION-ORGANIZATION,PROPN,PROPN-PROPN-PROPN,compound,compound-compound-pobj,NNP,NNP-NNP-NNP,12,1
2294,14624.0,42,According,0,20,16,-4,19,25,-20,16,NUL,National Urban League,ORGANIZATION,ORGANIZATION-ORGANIZATION-ORGANIZATION,PROPN,PROPN-PROPN-PROPN,compound,compound-compound-pobj,NNP,NNP-NNP-NNP,10,1
2295,7215.0,26,testified,8,11,16,5,10,9,-3,8,UASR,Muslim Brotherhood 's Palestine Committee,ORGANIZATION,ORGANIZATION-ORGANIZATION-ORGANIZATION-ORGANIZATION-ORGANIZATION,PROPN,PROPN-PROPN-PART-PROPN-PROPN,nsubj,compound-poss-case-compound-pobj,NNP,NNP-NNP-POS-NNP-NNP,4,1
2296,7219.0,57,62-year-old,1,3,18,15,2,38,-2,17,Vagni,Red Cross,PERSON,ORGANIZATION-ORGANIZATION,PROPN,PROPN-PROPN,nsubjpass,compound-compound,NNP,NNP-NNP,4,1
2297,10639.0,13,kidnapped,2,1,6,5,0,6,1,4,Vagni,Red Cross,PERSON,ORGANIZATION-ORGANIZATION,PROPN,PROPN-PROPN,nsubjpass,compound-compound,NNP,NNP-NNP,4,1
2298,7242.0,22,LANGE,1,1,4,3,0,17,0,3,ANDREW LANGE,SCHOLAR,PERSON-PERSON,TITLE,PROPN-PROPN,PROPN,compound-ROOT,appos,NNP-NNP,NNP,2,1
2299,7259.0,28,was,1,25,16,-9,24,11,-24,15,he,Chongqing,PERSON,CITY,PRON,PROPN,nsubjpass,compound,PRP,NNP,6,1
2300,11581.0,47,said,1,27,46,19,26,0,-26,45,he,Chongqing,PERSON,CITY,PRON,PROPN,nsubj,pobj,PRP,NNP,7,1
2301,7262.0,42,WASHINGTON,0,5,12,7,4,29,-5,12,Alan P Gross,Cuba,PERSON-PERSON-PERSON,COUNTRY,PROPN-PROPN-PROPN,PROPN,compound-compound-appos,pobj,NNP-NNP-NNP,NNP,4,1
2302,7282.0,14,was,1,1,4,3,0,9,0,3,He,subcontractor,PERSON,TITLE,PRON,NOUN,nsubj,attr,PRP,NN,2,1
2303,7297.0,56,offered,16,10,5,-5,9,50,6,-11,National Restaurant Association,The Daily Caller,ORGANIZATION-ORGANIZATION-ORGANIZATION,ORGANIZATION-ORGANIZATION-ORGANIZATION,PROPN-PROPN-PROPN,DET-PROPN-PROPN,compound-compound-compound,det-compound-pobj,NNP-NNP-NNP,DT-NNP-NNP,9,1
2304,7301.0,18,MACAO,0,17,9,-8,16,8,-17,9,PATA,SAR 's Tourist Office,ORGANIZATION,ORGANIZATION-ORGANIZATION-ORGANIZATION-ORGANIZATION,PROPN,PROPN-PART-PROPN-PROPN,pobj,poss-case-compound-nsubj,NNP,NNP-POS-NNP-NNP,4,1
2305,7305.0,26,been,2,1,5,4,0,20,1,3,Wen,vice Party chief,PERSON,TITLE-TITLE-TITLE,PROPN,NOUN-PROPN-NOUN,nsubj,compound-compound-attr,NNP,NN-NNP-NN,3,1
2306,7306.0,32,was,4,1,3,2,0,28,3,-1,Wen,54,PERSON,NUMBER,PROPN,NUM,nsubj,appos,NNP,CD,3,1
2307,7316.0,40,gave,9,7,1,-6,6,38,2,-8,Third Guard Division,The People 's Liberation Army,ORGANIZATION-ORGANIZATION-ORGANIZATION,ORGANIZATION-ORGANIZATION-ORGANIZATION-ORGANIZATION-ORGANIZATION,PROPN-PROPN-PROPN,DET-PROPN-PART-PROPN-PROPN,compound-compound-nsubj,det-poss-case-compound-poss,NNP-NNP-NNP,DT-NNPS-POS-NNP-NNP,3,1
2308,7318.0,58,said,14,49,35,-14,48,22,-35,21,Alico,American Life Insurance Co.,ORGANIZATION,ORGANIZATION-ORGANIZATION-ORGANIZATION-ORGANIZATION,PROPN,PROPN-PROPN-PROPN-PROPN,conj,compound-compound-compound-conj,NNP,NNP-NNP-NNP-NNP,6,1
2309,7322.0,41,reports,4,29,10,-19,28,30,-25,6,Laura Silsby,Terry Silsby,PERSON-PERSON,PERSON-PERSON,PROPN-PROPN,PROPN-PROPN,compound-nsubj,compound-appos,NNP-NNP,NNP-NNP,8,1
2310,7325.0,51,executes,1,11,31,20,10,19,-10,30,Wen Qiang,police chief,PERSON-PERSON,TITLE-TITLE,PROPN-PROPN,NOUN-NOUN,compound-nsubjpass,compound-conj,NNP-NNP,NN-NN,3,1
2311,7328.0,35,served,1,29,4,-25,28,30,-28,3,he,vice director,PERSON,TITLE-TITLE,PRON,NOUN-NOUN,nsubjpass,compound-pobj,PRP,NN-NN,4,1
2312,7331.0,28,assumed,6,13,1,-12,12,26,-7,-5,Central American Parliament,Nicaraguan,ORGANIZATION-ORGANIZATION-ORGANIZATION,ORGANIZATION,ADJ-ADJ-PROPN,ADJ,compound-compound-pobj,amod,JJ-JJ-NNP,JJ,7,1
2313,7352.0,38,said,17,30,19,-11,29,18,-13,2,Corporate Library,Annalisa Barrett,ORGANIZATION-ORGANIZATION,PERSON-PERSON,PROPN-PROPN,PROPN-PROPN,compound-pobj,compound-nsubj,NNP-NNP,NNP-NNP,4,1
2314,7354.0,20,served,5,5,18,13,4,1,0,13,he,L'Arche Calgary,PERSON,ORGANIZATION-ORGANIZATION,PRON,PROPN-PROPN,nsubj,compound-pobj,PRP,NNP-NNP,4,1
2315,7372.0,28,Go,0,4,11,7,3,16,-4,11,National Restaurant Association 's,http://wwwrestaurantorg/,ORGANIZATION-ORGANIZATION-ORGANIZATION-ORGANIZATION,URL,PROPN-PROPN-PROPN-PART,PUNCT,compound-compound-poss-case,compound,NNP-NNP-NNP-POS,.,-1,1
2316,7381.0,40,said,1,31,39,8,30,0,-30,38,Knox,Perugia,PERSON,CITY,PROPN,PROPN,pobj,pobj,NNP,NNP,10,1
2317,8142.0,40,found,9,39,25,-14,38,14,-30,16,Knox,Perugia,PERSON,CITY,PROPN,PROPN,pobj,pobj,NNP,NNP,10,1
2318,7383.0,24,was,3,1,17,16,0,6,2,14,Jamie Leigh Jones,KBR,PERSON-PERSON-PERSON,ORGANIZATION,PROPN-PROPN-PROPN,PROPN,compound-compound-nsubj,pobj,NNP-NNP-NNP,NNP,5,1
2319,9494.0,29,says,13,1,9,8,0,19,12,-4,Jamie Leigh Jones,KBR,PERSON-PERSON-PERSON,ORGANIZATION,PROPN-PROPN-PROPN,PROPN,compound-compound-nsubj,compound,NNP-NNP-NNP,NNP,3,1
2320,13250.0,62,poised,15,10,8,-2,9,53,5,-7,Jamie Leigh Jones,KBR,PERSON-PERSON-PERSON,ORGANIZATION,PROPN-PROPN-PROPN,PROPN,compound-compound-pobj,compound,NNP-NNP-NNP,NNP,4,1
2321,13733.0,62,poised,15,10,8,-2,9,53,5,-7,Jamie Leigh Jones,KBR,PERSON-PERSON-PERSON,ORGANIZATION,PROPN-PROPN-PROPN,PROPN,compound-compound-pobj,compound,NNP-NNP-NNP,NNP,4,1
2322,14665.0,25,sued,7,1,20,19,0,4,6,13,Jamie Leigh Jones,KBR,PERSON-PERSON-PERSON,ORGANIZATION,PROPN-PROPN-PROPN,PROPN,compound-compound-nsubj,pobj,NNP-NNP-NNP,NNP,6,1
2323,7385.0,32,said,30,16,27,11,15,4,14,-3,Assaf Ramon,Ilan,PERSON-PERSON,PERSON,PROPN-PROPN,PROPN,compound-pobj,appos,NNP-NNP,NNP,5,1
2324,7387.0,48,began,4,4,39,35,3,8,0,35,Bibi,landlord,PERSON,TITLE,PROPN,NOUN,pobj,pobj,NNP,NN,4,1
2325,7396.0,23,is,1,6,22,16,5,0,-5,21,Patricia Gonzalez,Chihuahua,PERSON-PERSON,CITY,PROPN-PROPN,PROPN,compound-pobj,pobj,NNP-NNP,NNP,4,1
2326,7409.0,51,is,1,26,23,-3,25,27,-25,22,Mark Fisher,2003,PERSON-PERSON,DATE,PROPN-PROPN,NUM,compound-pobj,nummod,NNP-NNP,CD,2,1
2327,11802.0,42,convicted,2,9,6,-3,8,35,-7,4,Mark Fisher,2003,PERSON-PERSON,DATE,PROPN-PROPN,NUM,compound-pobj,nummod,NNP-NNP,CD,2,1
2328,7434.0,30,taken,14,21,29,8,20,0,-7,15,his,executive,PERSON,TITLE,DET,NOUN,poss,conj,PRP$,NN,3,1
2329,7453.0,46,said,6,17,36,19,16,9,-11,30,Countrywide Bank,United States,ORGANIZATION-ORGANIZATION,COUNTRY-COUNTRY,PROPN-PROPN,PROPN-PROPN,compound-nsubj,compound-pobj,NNP-NNP,NNP-NNP,9,1
2330,7458.0,48,began,4,4,10,6,3,37,0,6,Bibi,Ittan Wali,PERSON,LOCATION-LOCATION,PROPN,PROPN-PROPN,pobj,compound-pobj,NNP,NNP-NNP,4,1
2331,7460.0,35,pronounced,13,19,16,-3,18,18,-6,3,he,late Saturday,PERSON,DATE-DATE,PRON,ADJ-PROPN,nsubj,amod-npadvmod,PRP,JJ-NNP,2,1
2332,14166.0,21,pronounced,3,9,6,-3,8,14,-6,3,he,late Saturday,PERSON,DATE-DATE,PRON,ADJ-PROPN,nsubj,amod-npadvmod,PRP,JJ-NNP,2,1
2333,7467.0,48,--,0,8,12,4,7,35,-8,12,Countrywide Financial Corp,http://wwwcountrywidecom,ORGANIZATION-ORGANIZATION-ORGANIZATION,URL,PROPN-PROPN-PROPN,X,compound-compound-ROOT,appos,NNP-NNP-NNP,ADD,-1,1
2334,7472.0,31,says,15,17,4,-13,16,26,-2,-11,Ilan Vilenda,Israeli,PERSON-PERSON,NATIONALITY,PROPN-PROPN,ADJ,compound-nsubj,amod,NNP-NNP,JJ,5,1
2335,7473.0,26,is,10,10,3,-7,9,22,0,-7,ACSE,1992,ORGANIZATION,DATE,PROPN,NUM,nsubj,pobj,NNP,CD,2,1
2336,7478.0,30,shut,24,14,20,6,13,9,10,-4,Countrywide Financial Corp,US,ORGANIZATION-ORGANIZATION-ORGANIZATION,COUNTRY,PROPN-PROPN-PROPN,PROPN,compound-compound-conj,compound,NNP-NNP-NNP,NNP,4,1
2337,7485.0,28,says,5,8,27,19,7,0,-3,22,Andrew Lange,53,PERSON-PERSON,NUMBER,PROPN-PROPN,NUM,compound-nsubj,nummod,NNP-NNP,CD,3,1
2338,7498.0,40,moved,5,5,8,3,4,31,0,3,he,Connecticut,PERSON,STATE_OR_PROVINCE,PRON,PROPN,nsubj,pobj,PRP,NNP,1,1
2339,12223.0,40,moved,5,5,8,3,4,31,0,3,he,Connecticut,PERSON,STATE_OR_PROVINCE,PRON,PROPN,nsubj,pobj,PRP,NNP,1,1
2340,14675.0,40,moved,5,5,8,3,4,31,0,3,he,Connecticut,PERSON,STATE_OR_PROVINCE,PRON,PROPN,nsubj,pobj,PRP,NNP,1,1
2341,7500.0,30,signed,2,28,1,-27,27,28,-26,-1,ADF,Australia,ORGANIZATION,COUNTRY,PROPN,PROPN,compound,nsubj,NNP,NNP,6,1
2342,7511.0,18,met,1,1,11,10,0,6,0,10,Samudio,Flamengo,PERSON,ORGANIZATION,NOUN,PROPN,nsubj,compound,NN,NNP,4,1
2343,7518.0,33,made,14,8,12,4,7,20,6,-2,National Energy Administration,international department,ORGANIZATION-ORGANIZATION-ORGANIZATION,ORGANIZATION-ORGANIZATION,PROPN-PROPN-PROPN,ADJ-NOUN,compound-compound-poss,amod-pobj,NNP-NNP-NNP,JJ-NN,2,1
2344,7523.0,35,figured,1,20,26,6,19,8,-19,25,Countrywide Financial,Bank of America,ORGANIZATION-ORGANIZATION,PERSON-PERSON-PERSON,PROPN-PROPN,PROPN-ADP-PROPN,compound-pobj,pobj-prep-pobj,NNP-NNP,NNP-IN-NNP,6,1
2345,7526.0,26,worked,5,21,24,3,20,1,-16,19,he,executive chef,PERSON,TITLE-TITLE,PRON,ADJ-NOUN,nsubj,amod-attr,PRP,JJ-NN,4,1
2346,7529.0,28,was,7,7,14,7,6,13,0,7,he,Development Alternatives Inc,PERSON,ORGANIZATION-ORGANIZATION-ORGANIZATION,PRON,PROPN-PROPN-PROPN,nsubj,compound-compound-pobj,PRP,NNP-NNP-NNP,3,1
2347,7534.0,32,questioned,5,14,11,-3,13,20,-9,6,Laura Silsby,Baptist,PERSON-PERSON,RELIGION,PROPN-PROPN,PROPN,compound-appos,compound,NNP-NNP,NNP,3,1
2348,7539.0,38,insisted,1,24,21,-3,23,16,-23,20,Vagni,Parad,PERSON,CITY,PROPN,PROPN,dobj,dobj,NNP,NNP,3,1
2349,7541.0,26,founded,4,1,7,6,0,18,3,3,Hellen Keller International,1915,ORGANIZATION-ORGANIZATION-ORGANIZATION,DATE,PROPN-PROPN-PROPN,NUM,compound-compound-nsubjpass,pobj,NNP-NNP-NNP,CD,3,1
2350,7552.0,68,said,48,42,26,-16,41,41,6,-22,National Energy Administration,Li Ye,ORGANIZATION-ORGANIZATION-ORGANIZATION,PERSON-PERSON,PROPN-PROPN-PROPN,PROPN-PROPN,compound-compound-pobj,compound-nsubj,NNP-NNP-NNP,NNP-NNP,8,1
2351,7555.0,51,executes,1,10,14,4,9,36,-9,13,Xinhua Wen Qiang,54,PERSON-PERSON-PERSON,NUMBER,PROPN-PROPN-PROPN,NUM,compound-compound-nsubjpass,appos,NNP-NNP-NNP,CD,2,1
2352,7560.0,47,said,1,5,36,31,4,10,-4,35,Wen,China,PERSON,COUNTRY,PROPN,PROPN,nsubj,pobj,NNP,NNP,10,1
2353,7569.0,33,Fund,3,6,2,-4,5,30,-3,-1,ADF,Alliance Defense Fund,ORGANIZATION,ORGANIZATION-ORGANIZATION-ORGANIZATION,PROPN,PROPN-PROPN-PROPN,compound,compound-compound-ROOT,NNP,NNP-NNP-NNP,2,1
2354,7572.0,27,is,2,1,5,4,0,21,1,3,Benjamin Chertoff,Editor,PERSON-PERSON,TITLE,PROPN-PROPN,PROPN,compound-nsubj,attr,NNP-NNP,NNP,3,1
2355,7577.0,34,dismissed,7,12,19,7,11,14,-5,12,John Graham,murder,PERSON-PERSON,CRIMINAL_CHARGE,PROPN-PROPN,NOUN,compound-pobj,pobj,NNP-NNP,NN,4,1
2356,7617.0,13,told,1,5,4,-1,4,8,-4,3,she,AP,PERSON,ORGANIZATION,PRON,PROPN,nsubj,dobj,PRP,NNP,1,1
2357,7627.0,35,took,3,18,34,16,17,0,-15,31,New Fabris,Paris,ORGANIZATION-ORGANIZATION,CITY,PROPN-PROPN,PROPN,compound-pobj,pobj,NNP-NNP,NNP,9,1
2358,7634.0,22,said,1,15,1,-14,14,20,-14,0,his,Linares,PERSON,PERSON,DET,NOUN,poss,nsubj,PRP$,NNS,4,1
2359,7639.0,35,said,32,1,14,13,0,20,31,-18,A Christian woman,blasphemy,PERSON-PERSON-PERSON,CRIMINAL_CHARGE,DET-ADJ-NOUN,NOUN,det-amod-nsubjpass,pobj,DT-JJ-NN,NN,7,1
2360,7646.0,32,said,18,28,30,2,27,1,-10,12,NDRC,transportation institute,ORGANIZATION,ORGANIZATION-ORGANIZATION,PROPN,NOUN-NOUN,poss,compound-pobj,NNP,NN-NN,2,1
2361,7650.0,32,been,5,31,13,-18,30,18,-26,8,Countrywide,Angelo R Mozilo,ORGANIZATION,PERSON-PERSON-PERSON,PROPN,PROPN-PROPN-PROPN,pobj,compound-compound-pobj,NNP,NNP-NNP-NNP,12,1
2362,7660.0,24,allege,1,14,12,-2,13,11,-13,11,Matteo Messina Denaro,Mafia,PERSON-PERSON-PERSON,ORGANIZATION,PROPN-PROPN-PROPN,PROPN,compound-compound-pobj,dobj,NNP-NNP-NNP,NNP,2,1
2363,12855.0,42,said,10,23,37,14,22,4,-13,27,Matteo Messina Denaro,Mafia,PERSON-PERSON-PERSON,ORGANIZATION,PROPN-PROPN-PROPN,PROPN,compound-compound-appos,poss,NNP-NNP-NNP,NNP,5,1
2364,13086.0,24,allege,1,14,12,-2,13,11,-13,11,Matteo Messina Denaro,Mafia,PERSON-PERSON-PERSON,ORGANIZATION,PROPN-PROPN-PROPN,PROPN,compound-compound-pobj,compound,NNP-NNP-NNP,NNP,2,1
2365,7668.0,54,told,48,43,33,-10,42,20,5,-15,Professional Ski Instructors of America,David Achey,ORGANIZATION-ORGANIZATION-ORGANIZATION-ORGANIZATION-ORGANIZATION,PERSON-PERSON,PROPN-PROPN-PROPN-ADP-PROPN,PROPN-PROPN,compound-compound-pobj-prep-pobj,compound-nsubj,NNP-NNP-NNP-IN-NNP,NNP-NNP,7,1
2366,7681.0,39,said,23,30,10,-20,29,28,-7,-13,TPI,America,ORGANIZATION,COUNTRY,PROPN,PROPN,pobj,pobj,NNP,NNP,9,1
2367,7691.0,44,wrote,38,38,42,4,37,1,0,4,he,BBC,PERSON,ORGANIZATION,PRON,PROPN,nsubj,compound,PRP,NNP,4,1
2368,7698.0,22,became,11,4,2,-2,3,19,7,-9,Vladimir Ladyzhenskiy,Russian,PERSON-PERSON,NATIONALITY,PROPN-PROPN,ADJ,compound-appos,amod,NNP-NNP,JJ,1,1
2369,7702.0,41,said,28,1,4,3,0,36,27,-24,Eugenio Vagni,63,PERSON-PERSON,NUMBER,PROPN-PROPN,NUM,compound-nsubj,appos,NNP-NNP,CD,2,1
2370,7707.0,34,said,12,30,1,-29,29,32,-18,-11,his,Pastor,PERSON,TITLE,DET,PROPN,poss,compound,PRP$,NNP,8,1
2371,7708.0,32,was,9,19,30,11,18,1,-10,21,National Urban League,www.nul.org,ORGANIZATION-ORGANIZATION-ORGANIZATION,URL,PROPN-PROPN-PROPN,PROPN,compound-compound-ROOT,compound,NNP-NNP-NNP,NNP,-1,1
2372,7715.0,28,Mailer,0,15,4,-11,14,23,-15,4,Norris Church Mailer,Provincetown,PERSON-PERSON-PERSON,CITY,PROPN-PROPN-PROPN,PROPN,compound-compound-appos,pobj,NNP-NNP-NNP,NNP,5,1
2373,7716.0,45,is,1,1,7,6,0,37,0,6,ADF,Greenwich Village KFC/Taco Bell,ORGANIZATION,ORGANIZATION-ORGANIZATION-ORGANIZATION-ORGANIZATION,PROPN,PROPN-PROPN-PROPN-PROPN,nsubj,compound-compound-compound-pobj,NNP,NNP-NNP-NNP-NNP,4,1
2374,7717.0,20,participated,10,2,8,6,1,11,8,-2,Third Guard Division,1941,ORGANIZATION-ORGANIZATION-ORGANIZATION,DATE,PROPN-PROPN-PROPN,NUM,compound-compound-nsubj,pobj,NNP-NNP-NNP,CD,3,1
2375,7718.0,44,said,28,14,43,29,13,0,14,15,Koch Foods,Michigan,ORGANIZATION-ORGANIZATION,STATE_OR_PROVINCE,PROPN-PROPN,PROPN,compound-compound,conj,NNP-NNP,NNP,14,1
2376,7728.0,24,said,22,21,2,-19,20,21,1,-20,her,23-year-old,PERSON,DURATION,DET,NUM,poss,amod,PRP$,CD,8,1
2377,7733.0,23,became,3,11,3,-8,10,19,-8,0,National Restaurant Association,he,ORGANIZATION-ORGANIZATION-ORGANIZATION,PERSON,PROPN-PROPN-PROPN,PRON,compound-compound-pobj,nsubj,NNP-NNP-NNP,PRP,4,1
2378,7735.0,35,pronounced,13,10,6,-4,9,28,3,-7,his,wrestler,PERSON,TITLE,DET,NOUN,poss,appos,PRP$,NN,3,1
2379,7747.0,40,JR,2,1,10,9,0,29,1,8,FRANK BALDINO JR,DIES,PERSON-PERSON-PERSON,DATE,PROPN-PROPN-PROPN,PROPN,compound-compound-ROOT,conj,NNP-NNP-NNP,NNP,2,1
2380,7750.0,16,recalled,2,12,15,3,11,0,-10,13,he,dentist,PERSON,TITLE,PRON,NOUN,nsubj,attr,PRP,NN,5,1
2381,8552.0,40,had,10,26,7,-19,25,32,-16,-3,he,dentist,PERSON,TITLE,PRON,NOUN,nsubj,compound,PRP,NN,5,1
2382,7756.0,40,said,33,28,19,-9,27,20,5,-14,Gay Men 's Health Crisis,Marjorie J Hill,ORGANIZATION-ORGANIZATION-ORGANIZATION-ORGANIZATION-ORGANIZATION,PERSON-PERSON-PERSON,PROPN-PROPN-PART-PROPN-PROPN,PROPN-PROPN-PROPN,compound-poss-case-compound-pobj,compound-compound-nsubj,NNP-NNPS-POS-NNP-NNP,NNP-NNP-NNP,6,1
2383,7797.0,24,see,15,1,13,12,0,10,14,-2,She,he,PERSON,PERSON,PRON,PRON,nsubj,nsubj,PRP,PRP,3,1
2384,7800.0,42,told,37,4,18,14,3,23,33,-19,Mario Angel Gonzalez,Chihuahua,PERSON-PERSON-PERSON,STATE_OR_PROVINCE,PROPN-PROPN-PROPN,PROPN,compound-compound-compound,compound,NNP-NNP-NNP,NNP,9,1
2385,7804.0,83,include,2,1,77,76,0,5,1,75,OANA,Yonhap,ORGANIZATION,ORGANIZATION,PROPN,PROPN,compound,pobj,NNP,NNP,15,1
2386,7805.0,26,said,10,2,6,4,1,19,8,-4,Hollister Inc.,Boston,ORGANIZATION-ORGANIZATION,CITY,PROPN-PROPN,PROPN,compound-pobj,compound,NNP-NNP,NNP,2,1
2387,8558.0,19,said,3,6,18,12,5,0,-3,15,Hollister Inc.,Boston,ORGANIZATION-ORGANIZATION,CITY,PROPN-PROPN,PROPN,compound-pobj,pobj,NNP-NNP,NNP,3,1
2388,9981.0,42,said,35,5,8,3,4,33,30,-27,Hollister Inc.,Boston,ORGANIZATION-ORGANIZATION,CITY,PROPN-PROPN,PROPN,compound-pobj,pobj,NNP-NNP,NNP,3,1
2389,7810.0,29,got,4,19,3,-16,18,25,-15,-1,TPIPL,Prachai Leophairatana,ORGANIZATION,PERSON-PERSON,PROPN,PROPN-PROPN,poss,compound-appos,NNP,NNP-NNP,11,1
2390,7811.0,35,survives,1,21,27,6,20,7,-20,26,Lange,William A Lange,PERSON,PERSON-PERSON-PERSON,PROPN,PROPN-PROPN-PROPN,nsubj,compound-compound-conj,NNP,NNP-NNP-NNP,3,1
2391,7820.0,41,told,33,23,31,8,22,9,10,-2,he,Judy Gross,PERSON,PERSON-PERSON,PRON,PROPN-PROPN,nsubjpass,compound-appos,PRP,NNP-NNP,7,1
2392,7916.0,42,wake,4,24,32,8,23,9,-20,28,he,Judy Gross,PERSON,PERSON-PERSON,PRON,PROPN-PROPN,nsubjpass,compound-appos,PRP,NNP-NNP,7,1
2393,7824.0,56,served,2,34,27,-7,33,28,-32,25,Progressive Democrats of America,Dennis Kucinich,ORGANIZATION-ORGANIZATION-ORGANIZATION-ORGANIZATION,PERSON-PERSON,PROPN-PROPN-ADP-PROPN,PROPN-PROPN,compound-pobj-prep-pobj,compound-pobj,NNP-NNPS-IN-NNP,NNP-NNP,9,1
2394,7825.0,7,was,1,1,7,6,0,-1,0,6,Sodini,LA,PERSON,ORGANIZATION,PROPN,PROPN,nsubj,pobj,NNP,NNP,-1,1
2395,7829.0,43,asked,25,30,23,-7,29,19,-5,-2,her,public relations representative,PERSON,TITLE-TITLE-TITLE,PRON,ADJ-NOUN-NOUN,dobj,amod-compound-nsubj,PRP,JJ-NNS-NN,4,1
2396,7833.0,54,TURKEY-VENDOR,0,12,5,-7,11,48,-12,5,Greenberg Smoked Turkey,Texas,ORGANIZATION-ORGANIZATION-ORGANIZATION,STATE_OR_PROVINCE,PROPN-PROPN-PROPN,PROPN,compound-compound-dobj,compound,NNP-NNP-NNP,NNP,-1,1
2397,7838.0,24,came,16,1,10,9,0,13,15,-6,John Graham,technician,PERSON-PERSON,TITLE,PROPN-PROPN,NOUN,compound-nsubj,conj,NNP-NNP,NN,2,1
2398,7844.0,36,include,1,3,15,12,2,20,-2,14,his,Douglas,PERSON,PERSON,DET,PROPN,poss,conj,PRP$,NNP,5,1
2399,7850.0,44,published,5,4,7,3,3,36,1,2,Norris Mailer,her,PERSON-PERSON,PERSON,PROPN-PROPN,DET,compound-nsubj,poss,NNP-NNP,PRP$,2,1
2400,7853.0,42,com,0,12,7,-5,11,34,-12,7,The American Association of University Women,AAUW,ORGANIZATION-ORGANIZATION-ORGANIZATION-ORGANIZATION-ORGANIZATION-ORGANIZATION,ORGANIZATION,DET-PROPN-PROPN-ADP-PROPN-PROPN,PROPN,det-compound-nsubj-prep-compound-compound,compound,DT-NNP-NNP-IN-NNP-NNP,NNP,3,1
2401,7856.0,41,Celebrate,0,23,28,5,22,12,-23,28,Dance Theatre of Harlem,DTH,ORGANIZATION-ORGANIZATION-ORGANIZATION-ORGANIZATION,ORGANIZATION,PROPN-PROPN-ADP-PROPN,PROPN,compound-nmod-prep-pobj,compound,NNP-NNP-IN-NNP,NNP,3,1
2402,8154.0,26,died,18,8,13,5,7,12,10,-5,Dance Theatre of Harlem,DTH,ORGANIZATION-ORGANIZATION-ORGANIZATION-ORGANIZATION,ORGANIZATION,PROPN-PROPN-ADP-PROPN,PROPN,compound-nmod-prep-pobj,compound,NNP-NNP-IN-NNP,NNP,2,1
2403,7857.0,33,UTC,4,26,25,-1,25,7,-22,21,Samudio,beaten,PERSON,CAUSE_OF_DEATH,PROPN,VERB,dobj,pcomp,NNP,VBN,2,1
2404,7858.0,8,hired,1,1,6,5,0,1,0,5,Miettinen,Sky Blue FC,PERSON,ORGANIZATION-ORGANIZATION-ORGANIZATION,PROPN,PROPN-ADJ-PROPN,nsubj,compound-compound-pobj,NNP,NNP-JJ-NNP,3,1
2405,7865.0,37,born,3,1,6,5,0,30,2,3,Ble Goude,1972,PERSON-PERSON,DATE,PROPN-PROPN,NUM,compound-nsubjpass,pobj,NNP-NNP,CD,2,1
2406,7872.0,36,said,15,10,15,5,9,20,5,0,Jupp,Anne,PERSON,PERSON,PROPN,PROPN,poss,conj,NNP,NNP,4,1
2407,7890.0,24,was,14,19,16,-3,18,7,-5,2,Frank Baldino Jr.,Cephalon Inc.,PERSON-PERSON-PERSON,ORGANIZATION-ORGANIZATION,PROPN-PROPN-PROPN,PROPN-PROPN,compound-compound-attr,compound-compound,NNP-NNP-NNP,NNP-NNP,3,1
2408,7898.0,30,taken,14,4,9,5,3,20,10,-5,Baldino,West Chester,PERSON,CITY-CITY,PROPN,PROPN-PROPN,nsubj,compound-pobj,NNP,NNP-NNP,4,1
2409,8067.0,30,taken,14,4,9,5,3,20,10,-5,Baldino,West Chester,PERSON,CITY-CITY,PROPN,PROPN-PROPN,nsubj,compound-pobj,NNP,NNP-NNP,4,1
2410,7910.0,32,said,30,16,10,-6,15,21,14,-20,Mr Gross,Cuba,PERSON-PERSON,COUNTRY,PROPN-PROPN,PROPN,compound-dobj,pobj,NNP-NNP,NNP,7,1
2411,7914.0,32,said,15,17,21,4,16,10,-2,6,Alessio Alessi,chief executive officer,PERSON-PERSON,TITLE-TITLE-TITLE,PROPN-PROPN,ADJ-ADJ-NOUN,compound-nsubj,amod-amod-appos,NNP-NNP,JJ-JJ-NN,3,1
2412,7932.0,23,tried,7,1,5,4,0,17,6,-2,Her,Claudie Mamane,PERSON,PERSON-PERSON,DET,PROPN-PROPN,poss,compound-appos,PRP$,NNP-NNP,3,1
2413,7945.0,31,comes,2,17,5,-12,16,25,-15,3,TPI,Karr Ingham,ORGANIZATION,PERSON-PERSON,PROPN,PROPN-PROPN,compound,compound-pobj,NNP,NNP-NNP,1,1
2414,7957.0,40,uncovered,13,19,2,-17,18,37,-6,-11,Eliza,police chief,PERSON,TITLE-TITLE,PROPN,NOUN-NOUN,nsubj,compound-compound,NNP,NN-NN,4,1
2415,7960.0,11,posts,4,3,1,-2,2,9,1,-3,Semen Gresik,Indonesia,ORGANIZATION-ORGANIZATION,COUNTRY,PROPN-PROPN,PROPN,compound-nsubj,poss,NNP-NNP,NNP,2,1
2416,9331.0,30,announced,9,7,1,-6,6,28,2,-8,Semen Gresik,Indonesia,ORGANIZATION-ORGANIZATION,COUNTRY,PROPN-PROPN,PROPN,compound-appos,poss,NNP-NNP,NNP,3,1
2417,7962.0,28,unveil,12,2,4,2,1,23,10,-8,PATA,Pacific Asia Travel Association -RRB- Travel Mart,ORGANIZATION,ORGANIZATION-ORGANIZATION-ORGANIZATION-ORGANIZATION-ORGANIZATION-ORGANIZATION-ORGANIZATION,PROPN,PROPN-PROPN-PROPN-PROPN-PROPN-PROPN-PROPN,compound,compound-compound-compound-compound-compound-compound-nsubj,NNP,NNP-NNP-NNP-NNP-NNP-NNP-NNP,-1,1
2418,7963.0,33,told,6,13,12,-1,12,20,-7,6,Ruben van Assouw,nine-year-old,PERSON-PERSON-PERSON,DURATION,PROPN-PROPN-PROPN,PROPN,compound-compound-compound,compound,NNP-NNP-NNP,NNP,1,1
2419,7995.0,42,said,40,7,21,14,6,20,33,-19,Ruben van Assouw,nine-year-old,PERSON-PERSON-PERSON,DURATION,PROPN-PROPN-PROPN,PROPN,compound-compound-pobj,compound,NNP-NNP-NNP,NNP,7,1
2420,10917.0,50,said,48,8,23,15,7,26,40,-25,Ruben van Assouw,nine-year-old,PERSON-PERSON-PERSON,DURATION,PROPN-PROPN-PROPN,PROPN,compound-compound-pobj,compound,NNP-NNP-NNP,NNP,6,1
2421,12267.0,34,TRIPOLI/THE,1,5,10,5,4,23,-4,9,Ruben van Assouw,nine-year-old,PERSON-PERSON-PERSON,NUMBER,PROPN-PROPN-PROPN,ADJ,compound-compound-nsubj,amod,NNP-NNP-NNP,JJ,-1,1
2422,14875.0,40,recovering,28,11,10,-1,10,29,17,-18,Ruben van Assouw,nine-year-old,PERSON-PERSON-PERSON,DURATION,PROPN-PROPN-PROPN,PROPN,compound-compound-pobj,compound,NNP-NNP-NNP,NNP,1,1
2423,15137.0,45,identified,3,11,10,-1,10,34,-8,7,Ruben van Assouw,nine-year-old,PERSON-PERSON-PERSON,DURATION,PROPN-PROPN-PROPN,PROPN,compound-compound-pobj,compound,NNP-NNP-NNP,NNP,1,1
2424,7964.0,34,began,3,2,6,4,1,27,1,3,ADF,the 1990s,ORGANIZATION,DATE-DATE,PROPN,DET-NOUN,compound,det-pobj,NNP,DT-NNS,3,1
2425,7968.0,30,had,1,21,10,-11,20,19,-20,9,he,Popular Mechanics,PERSON,ORGANIZATION-ORGANIZATION,PRON,PROPN-PROPN,nsubj,compound-pobj,PRP,NNP-NNPS,8,1
2426,7970.0,30,been,2,28,18,-10,27,11,-26,16,Meredith Kercher,"Nov. 1 , 2007",PERSON-PERSON,DATE-DATE-DATE-DATE,PROPN-PROPN,PROPN-NUM-PUNCT-NUM,compound-appos,pobj-nummod-punct-nummod,NNP-NNP,"NNP-CD-,-CD",8,1
2427,7974.0,83,include,2,1,63,62,0,19,1,61,OANA,Itar-Tass,ORGANIZATION,ORGANIZATION,PROPN,NOUN,compound,conj,NNP,NN,12,1
2428,7975.0,27,attacked,8,19,13,-6,18,13,-11,5,her,Stamford,PERSON,CITY,DET,PROPN,poss,pobj,PRP$,NNP,3,1
2429,11617.0,33,said,6,24,18,-6,23,14,-18,12,her,Stamford,PERSON,CITY,DET,PROPN,poss,pobj,PRP$,NNP,5,1
2430,13026.0,35,Herold,0,19,34,15,18,0,-19,34,her,Stamford,PERSON,CITY,DET,PROPN,poss,pobj,PRP$,NNP,7,1
2431,7977.0,47,said,44,39,43,4,38,3,5,-1,National Energy Administration,NEA,ORGANIZATION-ORGANIZATION-ORGANIZATION,ORGANIZATION,PROPN-PROPN-PROPN,PROPN,compound-compound-pobj,compound,NNP-NNP-NNP,NNP,7,1
2432,8164.0,37,BEIJING,0,30,34,4,29,2,-30,34,National Energy Administration,NEA,ORGANIZATION-ORGANIZATION-ORGANIZATION,ORGANIZATION,PROPN-PROPN-PROPN,PROPN,compound-compound-dobj,compound,NNP-NNP-NNP,NNP,4,1
2433,9149.0,19,data,3,8,12,4,7,6,-5,9,National Energy Administration,NEA,ORGANIZATION-ORGANIZATION-ORGANIZATION,ORGANIZATION,PROPN-PROPN-PROPN,PROPN,compound-compound-pobj,compound,NNP-NNP-NNP,NNP,4,1
2434,9244.0,68,said,48,42,46,4,41,21,6,-2,National Energy Administration,NEA,ORGANIZATION-ORGANIZATION-ORGANIZATION,ORGANIZATION,PROPN-PROPN-PROPN,PROPN,compound-compound-pobj,compound,NNP-NNP-NNP,NNP,9,1
2435,9659.0,28,continued,6,20,24,4,19,3,-14,18,National Energy Administration,NEA,ORGANIZATION-ORGANIZATION-ORGANIZATION,ORGANIZATION,PROPN-PROPN-PROPN,PROPN,compound-compound-pobj,compound,NNP-NNP-NNP,NNP,5,1
2436,9707.0,57,compiled,27,21,25,4,20,31,6,-2,National Energy Administration,NEA,ORGANIZATION-ORGANIZATION-ORGANIZATION,ORGANIZATION,PROPN-PROPN-PROPN,PROPN,compound-compound-pobj,pobj,NNP-NNP-NNP,NNP,2,1
2437,10596.0,27,become,2,19,23,4,18,3,-17,21,National Energy Administration,NEA,ORGANIZATION-ORGANIZATION-ORGANIZATION,ORGANIZATION,PROPN-PROPN-PROPN,PROPN,compound-compound-pobj,compound,NNP-NNP-NNP,NNP,5,1
2438,10970.0,37,expected,6,25,29,4,24,7,-19,23,National Energy Administration,NEA,ORGANIZATION-ORGANIZATION-ORGANIZATION,ORGANIZATION,PROPN-PROPN-PROPN,PROPN,compound-compound-pobj,compound,NNP-NNP-NNP,NNP,6,1
2439,11228.0,56,said,39,33,37,4,32,18,6,-2,National Energy Administration,NEA,ORGANIZATION-ORGANIZATION-ORGANIZATION,ORGANIZATION,PROPN-PROPN-PROPN,PROPN,compound-compound-pobj,compound,NNP-NNP-NNP,NNP,6,1
2440,12198.0,35,put,2,26,30,4,25,4,-24,28,National Energy Administration,NEA,ORGANIZATION-ORGANIZATION-ORGANIZATION,ORGANIZATION,PROPN-PROPN-PROPN,PROPN,compound-compound-pobj,compound,NNP-NNP-NNP,NNP,6,1
2441,13228.0,30,fell,6,22,26,4,21,3,-16,20,National Energy Administration,NEA,ORGANIZATION-ORGANIZATION-ORGANIZATION,ORGANIZATION,PROPN-PROPN-PROPN,PROPN,compound-compound-appos,compound,NNP-NNP-NNP,NNP,2,1
2442,14084.0,41,shut,1,33,37,4,32,3,-32,36,National Energy Administration,NEA,ORGANIZATION-ORGANIZATION-ORGANIZATION,ORGANIZATION,PROPN-PROPN-PROPN,PROPN,compound-compound-npadvmod,compound,NNP-NNP-NNP,NNP,2,1
2443,7981.0,34,began,1,19,23,4,18,10,-18,22,Mark Fisher,19-year old,PERSON-PERSON,DURATION-DURATION,PROPN-PROPN,ADJ-ADJ,compound-nsubj,nummod-amod,NNP-NNP,JJ-JJ,3,1
2444,7988.0,41,Italy,0,19,1,-18,18,39,-19,1,Matteo Messina Denaro,Italy,PERSON-PERSON-PERSON,COUNTRY,PROPN-PROPN-PROPN,PROPN,compound-compound-pobj,ROOT,NNP-NNP-NNP,NNP,4,1
2445,8013.0,37,killed,11,27,5,-22,26,31,-16,-6,Ramon,crash,PERSON,CAUSE_OF_DEATH,PROPN,NOUN,pobj,nsubj,NNP,NN,7,1
2446,8015.0,8,purchased,3,5,1,-4,4,6,-2,-2,TPI,Information Services Group,ORGANIZATION,ORGANIZATION-ORGANIZATION-ORGANIZATION,PROPN,PROPN-PROPN-PROPN,dobj,compound-compound-nsubj,NNP,NNP-NNPS-NNP,3,1
2447,8020.0,36,said,1,18,9,-9,17,26,-17,8,ALICO,Federal Reserve Bank,ORGANIZATION,ORGANIZATION-ORGANIZATION-ORGANIZATION,PROPN,PROPN-PROPN-PROPN,appos,compound-compound-pobj,NNP,NNP-NNP-NNP,4,1
2448,8023.0,28,added,10,1,7,6,0,20,9,-3,Alico,Christopher J. Swift,ORGANIZATION,PERSON-PERSON-PERSON,PROPN,PROPN-PROPN-PROPN,poss,compound-compound-appos,NNP,NNP-NNP-NNP,4,1
2449,8025.0,34,said,32,2,23,21,1,10,30,-9,Cun,Chongqing,PERSON,CITY,PROPN,PROPN,nsubjpass,pobj,NNP,NNP,9,1
2450,8028.0,36,is,7,34,30,-4,33,5,-27,23,NDA,Nuclear Decommissioning Authority,ORGANIZATION,ORGANIZATION-ORGANIZATION-ORGANIZATION,PROPN,PROPN-PROPN-PROPN,compound,compound-compound-compound,NNP,NNP-NNP-NNP,4,1
2451,10110.0,37,confirmed,8,6,2,-4,5,34,2,-6,NDA,Nuclear Decommissioning Authority,ORGANIZATION,ORGANIZATION-ORGANIZATION-ORGANIZATION,PROPN,PROPN-PROPN-PROPN,compound,compound-compound-compound,NNP,NNP-NNP-NNP,3,1
2452,8037.0,61,fallen,3,55,59,4,54,1,-52,56,National Restaurant Association,NRA,ORGANIZATION-ORGANIZATION-ORGANIZATION,ORGANIZATION,PROPN-PROPN-PROPN,PROPN,compound-compound-pobj,compound,NNP-NNP-NNP,NNP,8,1
2453,15275.0,33,features,21,11,19,8,10,13,10,-2,National Restaurant Association,NRA,ORGANIZATION-ORGANIZATION-ORGANIZATION,ORGANIZATION,PROPN-PROPN-PROPN,PROPN,compound-compound-compound,compound,NNP-NNP-NNP,NNP,4,1
2454,8047.0,39,has,31,28,36,8,27,2,3,5,National Restaurant Association,Conserve Solutions Center,ORGANIZATION-ORGANIZATION-ORGANIZATION,ORGANIZATION-ORGANIZATION-ORGANIZATION,PROPN-PROPN-PROPN,PROPN-PROPN-PROPN,compound-compound-nsubj,compound-compound-dobj,NNP-NNP-NNP,NNP-NNPS-NNP,5,1
2455,8052.0,40,moved,5,10,3,-7,9,36,-5,-2,his,Queens,PERSON,LOCATION,DET,PROPN,poss,pobj,PRP$,NNP,4,1
2456,8056.0,48,said,16,14,10,-4,13,37,2,-6,Youssoufou Bamba,new UN ambassador,PERSON-PERSON,ORGANIZATION-ORGANIZATION-ORGANIZATION,PROPN-PROPN,ADJ-PROPN-NOUN,compound-appos,amod-compound-nsubj,NNP-NNP,JJ-NNP-NN,2,1
2457,8059.0,28,attended,1,15,27,12,14,0,-14,26,he,professor,PERSON,TITLE,PRON,NOUN,nsubj,pobj,PRP,NN,3,1
2458,8069.0,15,is,3,1,11,10,0,3,2,8,Michael L. Lomax,United Negro College Fund,PERSON-PERSON-PERSON,ORGANIZATION-ORGANIZATION-ORGANIZATION-ORGANIZATION,PROPN-PROPN-PROPN,PROPN-PROPN-PROPN-PROPN,compound-compound-nsubj,compound-compound-compound-pobj,NNP-NNP-NNP,NNP-NNP-NNP-NNP,6,1
2459,8081.0,13,told,2,8,1,-7,7,11,-6,-1,his,Francesco Sollecito,PERSON,PERSON-PERSON,DET,PROPN-PROPN,poss,compound-nsubj,PRP$,NNP-NNP,3,1
2460,8086.0,45,said,1,10,40,30,9,4,-9,39,Graham,Cleo Gates,PERSON,PERSON-PERSON,PROPN,PROPN-PROPN,conj,compound-appos,NNP,NNP-NNP,9,1
2461,8092.0,33,convicted,2,18,17,-1,17,15,-16,15,Meredith Kercher,student,PERSON-PERSON,TITLE,PROPN-PROPN,NOUN,compound-dobj,compound,NNP-NNP,NN,1,1
2462,8102.0,56,offered,16,10,15,5,9,40,6,-1,National Restaurant Association,Joseph Fassler,ORGANIZATION-ORGANIZATION-ORGANIZATION,PERSON-PERSON,PROPN-PROPN-PROPN,PROPN-PROPN,compound-compound-compound,compound-nsubj,NNP-NNP-NNP,NNP-NNP,3,1
2463,8105.0,31,said,11,22,30,8,21,0,-11,19,National Restaurant Association,D.C.,ORGANIZATION-ORGANIZATION-ORGANIZATION,LOCATION,PROPN-PROPN-PROPN,PROPN,compound-compound-pobj,appos,NNP-NNP-NNP,NNP,6,1
2464,8106.0,26,made,1,17,14,-3,16,11,-16,13,Association of Chinese-American Scientists and Engineers,Chicago,ORGANIZATION-ORGANIZATION-ORGANIZATION-ORGANIZATION-ORGANIZATION-ORGANIZATION,CITY,PROPN-ADP-PROPN-PROPN-CCONJ-PROPN,PROPN,pobj-prep-amod-pobj-cc-conj,npadvmod,NNP-IN-NNP-NNPS-CC-NNPS,NNP,3,1
2465,8108.0,23,offered,2,15,11,-4,14,11,-13,9,Wen Qiang,Chongiqng public security bureau,PERSON-PERSON,ORGANIZATION-ORGANIZATION-ORGANIZATION-ORGANIZATION,PROPN-PROPN,PROPN-ADJ-NOUN-NOUN,compound-appos,nmod-amod-compound-pobj,NNP-NNP,NNP-JJ-NN-NN,3,1
2466,8109.0,23,operates,16,15,9,-6,14,13,1,-7,Alico,American Life Insurance,ORGANIZATION,ORGANIZATION-ORGANIZATION-ORGANIZATION,PROPN,PROPN-PROPN-PROPN,pobj,compound-compound-appos,NNP,NNP-NNP-NNP,4,1
2467,8123.0,43,wrote,18,13,16,3,12,26,5,-2,Ruben,Patrick van Assouw,PERSON,PERSON-PERSON-PERSON,PROPN,PROPN-PROPN-PROPN,poss,compound-compound-appos,NNP,NNP-NNP-NNP,9,1
2468,8157.0,26,was,1,5,1,-4,4,24,-4,0,Wen Qiang,Xie,PERSON-PERSON,PERSON,PROPN-PROPN,PROPN,compound-pobj,nsubj,NNP-NNP,NNP,3,1
2469,8158.0,22,said,1,10,13,3,9,8,-9,12,Laura Silsby,Meridian,PERSON-PERSON,CITY,PROPN-PROPN,PROPN,compound-appos,pobj,NNP-NNP,NNP,3,1
2470,8168.0,41,said,18,35,25,-10,34,15,-17,7,she,Brooklyn College,PERSON,ORGANIZATION-ORGANIZATION,PRON,PROPN-PROPN,nsubj,compound-poss,PRP,NNP-NNP,8,1
2471,8185.0,30,said,5,7,18,11,6,11,-2,13,Ruben,Trudy,PERSON,PERSON,PROPN,PROPN,nsubj,appos,NNP,NNP,5,1
2472,8196.0,34,charged,10,22,17,-5,21,16,-12,7,Aquash,murder,PERSON,CAUSE_OF_DEATH,PROPN,NOUN,pobj,pobj,NNP,NN,5,1
2473,8229.0,25,said,11,8,1,-7,7,23,3,-10,National Energy Administration,But Zhang Guobao,ORGANIZATION-ORGANIZATION-ORGANIZATION,PERSON-PERSON-PERSON,PROPN-PROPN-PROPN,CCONJ-PROPN-PROPN,compound-compound-pobj,cc-compound-nsubj,NNP-NNP-NNP,CC-NNP-NNP,5,1
2474,8235.0,49,killed,11,34,39,5,33,9,-23,28,Pakistan,Khyber Pakhtunkhwa,PERSON,STATE_OR_PROVINCE-STATE_OR_PROVINCE,PROPN,PROPN-PROPN,poss,compound-pobj,NNP,NNP-NNP,4,1
2475,8254.0,50,told,5,7,5,-2,6,44,-2,0,her,Halliburton,PERSON,ORGANIZATION,DET,PROPN,poss,nsubj,PRP$,NNP,2,1
2476,8258.0,22,received,16,2,7,5,1,14,14,-9,Alessi,Curious Case of Benjamin Button,PERSON,ORGANIZATION-ORGANIZATION-ORGANIZATION-ORGANIZATION-ORGANIZATION,PROPN,PROPN-PROPN-ADP-PROPN-PROPN,nsubj,compound-dobj-prep-compound-pobj,NNP,NNP-NNP-IN-NNP-NNP,3,1
2477,8260.0,7,believes,1,3,1,-2,2,5,-2,0,he,Cuba,PERSON,COUNTRY,PRON,PROPN,nsubj,nsubj,PRP,NNP,1,1
2478,9775.0,42,says,11,13,6,-7,12,35,-2,-5,he,Cuba,PERSON,COUNTRY,PRON,PROPN,nsubj,pobj,PRP,NNP,4,1
2479,8262.0,56,said,25,41,27,-14,40,28,-16,2,National Urban League,Marc H Morial,ORGANIZATION-ORGANIZATION-ORGANIZATION,PERSON-PERSON-PERSON,PROPN-PROPN-PROPN,PROPN-PROPN-PROPN,compound-compound-pobj,compound-compound-nsubj,NNP-NNP-NNP,NNP-NNP-NNP,7,1
2480,8289.0,28,according,1,4,10,6,3,17,-3,9,Mark Fisher,lawyer,PERSON-PERSON,TITLE,PROPN-PROPN,NOUN,compound-pobj,appos,NNP-NNP,NN,2,1
2481,8291.0,15,says,5,9,5,-4,8,9,-4,0,AIG ALICO,MetLife,ORGANIZATION-ORGANIZATION,ORGANIZATION,PROPN-PROPN,PROPN,compound-compound,nsubj,NNP-NNP,NNP,3,1
2482,8306.0,22,charged,6,1,12,11,0,9,5,6,John Graham,killing or aiding the murder of activist Annie Mae Aquash,PERSON-PERSON,CRIMINAL_CHARGE-CRIMINAL_CHARGE-CRIMINAL_CHARGE-CRIMINAL_CHARGE-CRIMINAL_CHARGE-CRIMINAL_CHARGE-CRIMINAL_CHARGE-CRIMINAL_CHARGE-CRIMINAL_CHARGE-CRIMINAL_CHARGE,PROPN-PROPN,VERB-CCONJ-VERB-DET-NOUN-ADP-NOUN-PROPN-PROPN-PROPN,compound-nsubjpass,pcomp-cc-conj-det-dobj-prep-compound-compound-compound-pobj,NNP-NNP,VBG-CC-VBG-DT-NN-IN-NN-NNP-NNP-NNP,4,1
2483,8309.0,38,carrying,3,27,17,-10,26,20,-24,14,Samudio,Esmeralda,PERSON,CITY,PROPN,PROPN,poss,pobj,NNP,NNP,7,1
2484,8315.0,30,bribed,2,16,29,13,15,0,-14,27,Chen Tao,corruption,PERSON-PERSON,CRIMINAL_CHARGE,PROPN-PROPN,NOUN,compound-pobj,pobj,NNP-NNP,NN,5,1
2485,8740.0,11,jailed,7,5,10,5,4,0,2,3,Chen Tao,corruption,PERSON-PERSON,CRIMINAL_CHARGE,PROPN-PROPN,NOUN,compound-nsubjpass,pobj,NNP-NNP,NN,2,1
2486,10787.0,40,received,20,18,38,20,17,1,2,18,Chen Tao,corruption,PERSON-PERSON,CRIMINAL_CHARGE,PROPN-PROPN,NOUN,compound-conj,compound,NNP-NNP,NN,10,1
2487,8318.0,44,was,8,12,43,31,11,0,-4,35,Jamie Leigh Jones,Baghdad,PERSON-PERSON-PERSON,CITY,PROPN-PROPN-PROPN,PROPN,compound-compound-pobj,pobj,NNP-NNP-NNP,NNP,9,1
2488,12188.0,30,filed,3,1,26,25,0,3,2,23,Jamie Leigh Jones,Baghdad,PERSON-PERSON-PERSON,CITY,PROPN-PROPN-PROPN,PROPN,compound-compound-nsubj,appos,NNP-NNP-NNP,NNP,5,1
2489,8322.0,36,waned,3,26,32,6,25,3,-23,29,Countrywide Financial,Bank of America Corp,ORGANIZATION-ORGANIZATION,PERSON-PERSON-PERSON-PERSON,PROPN-PROPN,PROPN-ADP-PROPN-PROPN,compound-pobj,pobj-prep-compound-pobj,NNP-NNP,NNP-IN-NNP-NNP,3,1
2490,8328.0,28,was,1,6,22,16,5,5,-5,21,Wen Qiang,justice bureau,PERSON-PERSON,ORGANIZATION-ORGANIZATION,PROPN-PROPN,NOUN-NOUN,compound-pobj,compound-pobj,NNP-NNP,NN-NN,10,1
2491,8576.0,30,attracted,3,12,20,8,11,9,-9,17,Wen Qiang,justice bureau,PERSON-PERSON,ORGANIZATION-ORGANIZATION,PROPN-PROPN,NOUN-NOUN,compound-dobj,compound-pobj,NNP-NNP,NN-NN,3,1
2492,8332.0,35,turned,3,13,34,21,12,0,-10,31,Latin,suicide,PERSON,CAUSE_OF_DEATH,ADJ,NOUN,amod,dobj,JJ,NN,7,1
2493,8342.0,34,is,2,24,28,4,23,5,-22,26,Thai Petrochemical Industry,TPI,ORGANIZATION-ORGANIZATION-ORGANIZATION,ORGANIZATION,PROPN-PROPN-NOUN,PROPN,compound-compound-pobj,compound,NNP-NNP-NN,NNP,-1,1
2494,8349.0,43,go,6,31,32,1,30,10,-25,26,his,11-year,PERSON,DURATION,DET,ADJ,poss,npadvmod,PRP$,JJ,4,1
2495,8359.0,21,served,3,1,16,15,0,4,2,13,Wayne A. Holst,L'Arche Calgary,PERSON-PERSON-PERSON,ORGANIZATION-ORGANIZATION,PROPN-PROPN-PROPN,PROPN-PROPN,compound-compound-nsubj,compound-pobj,NNP-NNP-NNP,NNP-NNP,6,1
2496,8378.0,53,quoted,43,32,32,0,31,20,11,-11,Australian Defence Force,Australian Associated Press,ORGANIZATION-ORGANIZATION-ORGANIZATION,ORGANIZATION-ORGANIZATION-ORGANIZATION,PROPN-PROPN-PROPN,PROPN-PROPN-PROPN,compound-compound-poss,compound-compound-pobj,NNP-NNP-NNP,NNP-NNP-NNP,0,1
2497,8384.0,30,emerged,7,17,19,2,16,10,-10,12,brother,Patricia Gonzalez,PERSON,PERSON-PERSON,NOUN,PROPN-PROPN,dobj,compound-pobj,NN,NNP-NNP,1,1
2498,8386.0,28,went,5,23,9,-14,22,18,-18,4,him,Rio,PERSON,LOCATION,PRON,PROPN,pobj,pobj,PRP,NNP,6,1
2499,8389.0,42,born,4,1,9,8,0,32,3,5,Andrew E. Lange,Ill.,PERSON-PERSON-PERSON,STATE_OR_PROVINCE,PROPN-PROPN-PROPN,PROPN,compound-compound-nsubjpass,appos,NNP-NNP-NNP,NNP,3,1
2500,8407.0,32,said,1,20,20,0,19,11,-19,19,Tribeca Enterprises,Tribeca Film Festival,ORGANIZATION-ORGANIZATION,ORGANIZATION-ORGANIZATION-ORGANIZATION,PROPN-PROPN,PROPN-PROPN-PROPN,compound-pobj,compound-compound-dobj,NNP-NNPS,NNP-NNP-NNP,0,1
2501,8411.0,36,**************************************************************,0,4,16,12,3,19,-4,16,Countrywide,United States,ORGANIZATION,COUNTRY-COUNTRY,PROPN,PROPN-PROPN,pobj,compound-pobj,NNP,NNP-NNP,2,1
2502,8417.0,47,is,17,1,12,11,0,34,16,-5,Ahmed Rashid,Pacific Council on International Policy,PERSON-PERSON,ORGANIZATION-ORGANIZATION-ORGANIZATION-ORGANIZATION-ORGANIZATION,PROPN-PROPN,PROPN-PROPN-ADP-PROPN-PROPN,compound-nsubj,compound-pobj-prep-compound-pobj,NNP-NNP,NNP-NNP-IN-NNP-NNP,4,1
2503,13622.0,42,is,17,1,12,11,0,29,16,-5,Ahmed Rashid,Pacific Council on International Policy,PERSON-PERSON,ORGANIZATION-ORGANIZATION-ORGANIZATION-ORGANIZATION-ORGANIZATION,PROPN-PROPN,PROPN-PROPN-ADP-PROPN-PROPN,compound-nsubj,compound-pobj-prep-compound-pobj,NNP-NNP,NNP-NNP-IN-NNP-NNP,4,1
2504,8418.0,89,Smith,2,6,10,4,5,78,-4,8,High Point Church,Arlington,ORGANIZATION-ORGANIZATION-ORGANIZATION,CITY,PROPN-PROPN-PROPN,PROPN,compound-compound-appos,conj,NNP-NNP-NNP,NNP,2,1
2505,12127.0,19,--,0,8,12,4,7,6,-8,12,High Point Church,Arlington,ORGANIZATION-ORGANIZATION-ORGANIZATION,CITY,PROPN-PROPN-PROPN,PROPN,compound-compound-pobj,pobj,NNP-NNP-NNP,NNP,5,1
2506,8420.0,50,told,5,7,43,36,6,6,-2,38,her,US,PERSON,COUNTRY,PRON,PROPN,dobj,compound,PRP,NNP,-1,1
2507,8426.0,34,be,3,33,20,-13,32,13,-30,17,NEA,Huang Li,ORGANIZATION,PERSON-PERSON,PROPN,PROPN-PROPN,appos,compound-nsubj,NNP,NNP-NNP,2,1
2508,8453.0,51,resigned,6,5,1,-4,4,49,1,-5,Nir Rosen,NYU,PERSON-PERSON,ORGANIZATION,PROPN-PROPN,PROPN,compound-conj,compound,NNP-NNP,NNP,1,1
2509,8455.0,76,com,9,23,17,-6,22,58,-14,8,Sycamore,Los Angeles,ORGANIZATION,CITY-CITY,PROPN,PROPN-PROPN,poss,compound-pobj,NNP,NNP-NNP,3,1
2510,8469.0,35,reported,33,20,26,6,19,8,13,-7,Wen,rape,PERSON,CRIMINAL_CHARGE,PROPN,NOUN,nsubjpass,pobj,NNP,NN,4,1
2511,13018.0,37,charged,6,1,31,30,0,5,5,25,Wen,rape,PERSON,CRIMINAL_CHARGE,PROPN,NOUN,nsubjpass,pobj,NNP,NN,3,1
2512,8476.0,41,turned,9,15,20,5,14,20,-6,11,he,Secretary General,PERSON,TITLE-TITLE,PRON,PROPN-PROPN,nsubj,compound-compound,PRP,NNP-NNP,3,1
2513,8480.0,35,told,30,25,27,2,24,7,5,-3,PATA,Strategic Intelligence Center,ORGANIZATION,ORGANIZATION-ORGANIZATION-ORGANIZATION,PROPN,PROPN-PROPN-PROPN,poss,compound-compound-pobj,NNP,NNP-NNP-NNP,3,1
2514,8496.0,27,found,3,1,24,23,0,2,2,21,Carol Daniels,Anadarko,PERSON-PERSON,CITY,PROPN-PROPN,PROPN,compound-nsubjpass,pobj,NNP-NNP,NNP,5,1
2515,8511.0,46,iD8DBQFHIR5Iiz2i76ou9wQRAttYAKC8LcHQ2VZwNzzpkNZ12nyytxAKbgCfYOan,0,35,39,4,34,6,-35,39,Central American Parliament,PARLACEN,ORGANIZATION-ORGANIZATION-ORGANIZATION,ORGANIZATION,ADJ-ADJ-PROPN,PROPN,compound-compound-pobj,compound,JJ-JJ-NNP,NNP,6,1
2516,9450.0,23,submitted,2,11,15,4,10,7,-9,13,Central American Parliament,PARLACEN,ORGANIZATION-ORGANIZATION-ORGANIZATION,ORGANIZATION,ADJ-ADJ-PROPN,PROPN,compound-compound-dobj,compound,JJ-JJ-NNP,NNP,7,1
2517,8513.0,35,told,30,25,34,9,24,0,5,4,PATA,Singapore,ORGANIZATION,COUNTRY,PROPN,PROPN,poss,pobj,NNP,NNP,7,1
2518,8517.0,28,survived,3,12,16,4,11,11,-9,13,Karen Lange,Washington,PERSON-PERSON,STATE_OR_PROVINCE,PROPN-PROPN,PROPN,compound-appos,pobj,NNP-NNP,NNP,2,1
2519,8530.0,40,<,2,21,32,11,20,7,-19,30,United Association for Studies and Research,Council on American Islamic Relations,ORGANIZATION-ORGANIZATION-ORGANIZATION-ORGANIZATION-ORGANIZATION-ORGANIZATION,ORGANIZATION-ORGANIZATION-ORGANIZATION-ORGANIZATION-ORGANIZATION,PROPN-PROPN-ADP-PROPN-CCONJ-PROPN,PROPN-ADP-PROPN-PROPN-PROPN,compound-oprd-prep-pobj-cc-conj,dep-prep-compound-compound-pobj,NNP-NNP-IN-NNPS-CC-NNP,NNP-IN-NNP-NNP-NNPS,8,1
2520,8538.0,30,taken,14,4,12,8,3,17,10,-2,Baldino,Pa.,PERSON,STATE_OR_PROVINCE,PROPN,PROPN,nsubj,appos,NNP,NNP,3,1
2521,8551.0,21,said,8,10,5,-5,9,15,-2,-3,he,lawyer,PERSON,TITLE,PRON,NOUN,nsubj,appos,PRP,NN,5,1
2522,8554.0,55,'s,2,2,43,41,1,11,0,41,She,Kurt Knox,PERSON,PERSON-PERSON,PRON,PROPN-PROPN,nsubj,compound-appos,PRP,NNP-NNP,5,1
2523,8572.0,19,were,16,3,15,12,2,3,13,-1,Koch Foods,Illinois,ORGANIZATION-ORGANIZATION,STATE_OR_PROVINCE,PROPN-PROPN,PROPN,compound-pobj,appos,NNP-NNP,NNP,4,1
2524,8587.0,25,leads,2,16,9,-7,15,15,-14,7,Countrywide Financial Corporation,Financial Consultants,ORGANIZATION-ORGANIZATION-ORGANIZATION,ORGANIZATION-ORGANIZATION,PROPN-PROPN-PROPN,PROPN-PROPN,compound-compound-pobj,compound-pobj,NNP-NNP-NNP,NNP-NNPS,5,1
2525,8592.0,55,Posted,1,32,30,-2,31,24,-31,29,Adela Dworin,community president,PERSON-PERSON,TITLE-TITLE,PROPN-PROPN,NOUN-NOUN,compound-nsubj,compound-compound,NNP-NNP,NN-NN,4,1
2526,8594.0,30,taken,14,21,26,5,20,3,-7,12,his,chairman,PERSON,TITLE,DET,NOUN,poss,pobj,PRP$,NN,3,1
2527,8602.0,32,women,3,11,15,4,10,16,-8,12,Chen Tao,87,PERSON-PERSON,NUMBER,PROPN-PROPN,NUM,compound-nsubj,appos,NNP-NNP,CD,2,1
2528,8643.0,32,found,16,4,12,8,3,19,12,-4,Knox,University for Foreigners,PERSON,ORGANIZATION-ORGANIZATION-ORGANIZATION,PROPN,PROPN-ADP-PROPN,pobj,pobj-prep-pobj,NNP,NNP-IN-NNP,4,1
2529,12020.0,20,cast,2,16,12,-4,15,7,-14,10,Knox,University for Foreigners,PERSON,ORGANIZATION-ORGANIZATION-ORGANIZATION,PROPN,PROPN-ADP-PROPN,nsubj,conj-prep-pobj,NNP,NNP-IN-NNPS,4,1
2530,8646.0,55,Loss,2,5,10,5,4,44,-3,8,Iconic Fighter Pilot,pilot,PERSON-PERSON-PERSON,TITLE,PROPN-PROPN-PROPN,NOUN,compound-compound-pobj,poss,NNP-NNP-NNP,NN,6,1
2531,8647.0,45,posted,3,1,39,38,0,5,2,36,Cerniglia,Melissa,PERSON,PERSON,PROPN,PROPN,poss,appos,NNP,NNP,11,1
2532,8649.0,30,were,12,2,10,8,1,19,10,-2,Gay Men 's Health Crisis,GMHC,ORGANIZATION-ORGANIZATION-ORGANIZATION-ORGANIZATION-ORGANIZATION,ORGANIZATION,PROPN-PROPN-PART-PROPN-PROPN,PROPN,compound-poss-case-compound-pobj,pobj,NNP-NNPS-POS-NNP-NNP,NNP,4,1
2533,8666.0,37,vowed,28,18,1,-17,17,35,10,-27,China Charity Federation,Jiang Yiman,ORGANIZATION-ORGANIZATION-ORGANIZATION,PERSON-PERSON,PROPN-PROPN-PROPN,PROPN-PROPN,compound-compound-pobj,compound-nsubj,NNP-NNP-NNP,NNP-NNP,6,1
2534,8670.0,38,charged,8,5,3,-2,4,34,3,-5,Xie Caiping,ringleader,PERSON-PERSON,TITLE,PROPN-PROPN,NOUN,compound-appos,nsubjpass,NNP-NNP,NN,2,1
2535,8680.0,32,Knox,1,1,6,5,0,25,0,5,Amanda Knox,Italy,PERSON-PERSON,COUNTRY,PROPN-PROPN,PROPN,compound-ROOT,poss,NNP-NNP,NNP,5,1
2536,12104.0,48,broke,4,3,20,17,2,27,1,16,Amanda Knox,Italy,PERSON-PERSON,COUNTRY,PROPN-PROPN,PROPN,compound-nsubj,pobj,NNP-NNP,NNP,2,1
2537,13618.0,29,convicts,5,9,5,-4,8,23,-4,0,Amanda Knox,Italy,PERSON-PERSON,COUNTRY,PROPN-PROPN,PROPN,compound-dobj,pobj,NNP-NNP,NNP,1,1
2538,8702.0,30,said,5,12,1,-11,11,28,-7,-4,American Life Insurance company,US,ORGANIZATION-ORGANIZATION-ORGANIZATION-ORGANIZATION,COUNTRY,PROPN-PROPN-PROPN-NOUN,PROPN,compound-compound-compound-dobj,compound,NNP-NNP-NNP-NN,NNP,9,1
2539,8705.0,29,benefit,6,9,21,12,8,7,-3,15,"Huntington Library , Art Collections and Botanical Gardens",California,ORGANIZATION-ORGANIZATION-ORGANIZATION-ORGANIZATION-ORGANIZATION-ORGANIZATION-ORGANIZATION-ORGANIZATION,STATE_OR_PROVINCE,PROPN-PROPN-PUNCT-PROPN-PROPN-CCONJ-PROPN-PROPN,PROPN,compound-dobj-punct-compound-conj-cc-compound-conj,appos,"NNP-NNP-,-NNP-NNPS-CC-NNP-NNPS",NNP,2,1
2540,8730.0,26,plans,1,1,11,10,0,14,0,10,ShopperTrak,Aaron Martin,ORGANIZATION,PERSON-PERSON,PROPN,PROPN-PROPN,nsubj,compound-nsubj,NNP,NNP-NNP,2,1
2541,8757.0,11,testifying,4,1,7,6,0,3,3,3,Jamie Leigh Jones,Capitol Hill,PERSON-PERSON-PERSON,LOCATION-LOCATION,PROPN-PROPN-PROPN,PROPN-PROPN,compound-compound-nsubj,compound-pobj,NNP-NNP-NNP,NNP-NNP,4,1
2542,8762.0,32,made,2,2,28,26,1,3,0,26,ADF,ministry of internal affairs,ORGANIZATION,ORGANIZATION-ORGANIZATION-ORGANIZATION-ORGANIZATION,PROPN,NOUN-ADP-ADJ-NOUN,nsubj,pobj-prep-amod-pobj,NNP,NN-IN-JJ-NNS,7,1
2543,8765.0,43,lived,3,11,1,-10,10,41,-8,-2,his,Journalist,PERSON,TITLE,DET,PROPN,poss,compound,PRP$,NNP,3,1
2544,10528.0,43,lived,3,11,1,-10,10,41,-8,-2,his,Journalist,PERSON,TITLE,DET,PROPN,poss,compound,PRP$,NNP,3,1
2545,8773.0,41,Italy,0,19,7,-12,18,33,-19,7,Matteo Messina Denaro,supremo :,PERSON-PERSON-PERSON,TITLE-TITLE,PROPN-PROPN-PROPN,NOUN-PUNCT,compound-compound-pobj,ROOT-punct,NNP-NNP-NNP,NN-:,4,1
2546,8774.0,29,versatility,2,1,14,13,0,14,1,12,Her,coach,PERSON,TITLE,DET,NOUN,poss,pobj,PRP$,NN,3,1
2547,8778.0,17,employs,4,4,7,3,3,9,0,3,company,"60,000",ORGANIZATION,NUMBER,NOUN,NUM,nsubj,nummod,NN,CD,5,1
2548,8783.0,25,disappeared,14,1,23,22,0,1,13,9,Eliza Samudio,Minas Gerais,PERSON-PERSON,STATE_OR_PROVINCE-STATE_OR_PROVINCE,PROPN-PROPN,PROPN-PROPN,compound-nsubj,compound-appos,NNP-NNP,NNP-NNP,3,1
2549,8795.0,30,said,10,23,12,-11,22,17,-13,2,AAUW,Lisa Maatz,ORGANIZATION,PERSON-PERSON,PROPN,PROPN-PROPN,pobj,compound-nsubj,NNP,NNP-NNP,4,1
2550,8806.0,31,became,4,4,19,15,3,11,0,15,he,chairman,PERSON,TITLE,PRON,NOUN,nsubj,oprd,PRP,NN,3,1
2551,8826.0,83,include,2,1,13,12,0,69,1,11,OANA,AAP,ORGANIZATION,ORGANIZATION,PROPN,PROPN,compound,appos,NNP,NNP,3,1
2552,8830.0,59,included,2,48,52,4,47,6,-46,50,Norris Church Mailer,his,PERSON-PERSON-PERSON,PERSON,PROPN-PROPN-PROPN,DET,compound-compound-pobj,poss,NNP-NNP-NNP,PRP$,5,1
2553,8844.0,35,served,1,1,8,7,0,26,0,7,He,Chongqing Municipal Judicial Bureau,PERSON,ORGANIZATION-ORGANIZATION-ORGANIZATION-ORGANIZATION,PRON,PROPN-PROPN-PROPN-PROPN,nsubj,compound-compound-compound-pobj,PRP,NNP-NNP-NNP-NNP,5,1
2554,8845.0,32,linked,8,14,18,4,13,13,-6,10,Matteo Messina Denaro,46,PERSON-PERSON-PERSON,NUMBER,PROPN-PROPN-PROPN,NUM,compound-compound-pobj,appos,NNP-NNP-NNP,CD,2,1
2555,8848.0,28,survived,3,12,1,-11,11,26,-9,-2,Karen Lange,He,PERSON-PERSON,PERSON,PROPN-PROPN,PRON,compound-appos,nsubjpass,NNP-NNP,PRP,5,1
2556,8854.0,46,died,37,1,44,43,0,1,36,7,Norris Church Mailer,New York,PERSON-PERSON-PERSON,STATE_OR_PROVINCE-STATE_OR_PROVINCE,PROPN-PROPN-PROPN,PROPN-PROPN,compound-compound-nsubj,compound-pobj,NNP-NNP-NNP,NNP-NNP,7,1
2557,8919.0,44,born,9,8,27,19,7,16,1,18,she,James Davis,PERSON,PERSON-PERSON,PRON,PROPN-PROPN,nsubjpass,compound-appos,PRP,NNP-NNP,8,1
2558,8925.0,53,did,23,28,32,4,27,20,-5,9,John Graham,Canadian,PERSON-PERSON,NATIONALITY,PROPN-PROPN,PROPN,compound-pobj,appos,NNP-NNP,NNP,5,1
2559,8956.0,14,says,1,9,3,-6,8,10,-8,2,National Congress of American,Jefferson Keel,ORGANIZATION-ORGANIZATION-ORGANIZATION-ORGANIZATION,PERSON-PERSON,PROPN-PROPN-ADP-PROPN,PROPN-PROPN,compound-pobj-prep-compound,compound-nsubj,NNP-NNP-IN-NNP,NNP-NNP,3,1
2560,8957.0,32,President,3,7,17,10,6,14,-4,14,"The Good Broker , LLC",Atlanta,ORGANIZATION-ORGANIZATION-ORGANIZATION-ORGANIZATION-ORGANIZATION,CITY,DET-PROPN-PROPN-PUNCT-PROPN,PROPN,det-compound-ROOT-punct-npadvmod,appos,"DT-NNP-NNP-,-NNP",NNP,5,1
2561,8958.0,22,became,1,14,4,-10,13,17,-13,3,Mailer,journalist,PERSON,TITLE,PROPN,NOUN,dobj,attr,NNP,NN,3,1
2562,8962.0,57,accused,2,4,14,10,3,42,-2,12,Amanda Knox,University of Washington,PERSON-PERSON,ORGANIZATION-ORGANIZATION-ORGANIZATION,PROPN-PROPN,PROPN-ADP-PROPN,compound-dobj,pobj-prep-pobj,NNP-NNP,NNP-IN-NNP,4,1
2563,8963.0,22,is,1,1,7,6,0,14,0,6,He,New America Foundation,PERSON,ORGANIZATION-ORGANIZATION-ORGANIZATION,PRON,PROPN-PROPN-PROPN,nsubj,compound-compound-pobj,PRP,NNP-NNP-NNP,4,1
2564,8965.0,21,missing,16,14,10,-4,13,10,2,-6,Samudio,Rio de Janeiro,PERSON,CITY-CITY-CITY,PROPN,PROPN-PROPN-PROPN,nsubj,compound-compound-pobj,NNP,NNP-NNP-NNP,9,1
2565,10012.0,65,say,1,7,14,7,6,50,-6,13,Samudio,Rio de Janeiro,PERSON,CITY-CITY-CITY,PROPN,PROPN-PROPN-PROPN,nsubjpass,compound-compound-pobj,NNP,NNP-NNP-NNP,4,1
2566,8977.0,18,keeps,1,10,10,0,9,7,-9,9,TPI,TPI Polene,ORGANIZATION,ORGANIZATION-ORGANIZATION,PROPN,PROPN-PROPN,pobj,compound-pobj,NNP,NNP-NNP,0,1
2567,8979.0,57,was,4,3,8,5,2,48,1,4,George Sodini,Christian,PERSON-PERSON,RELIGION,PROPN-PROPN,PROPN,compound-appos,attr,NNP-NNP,NNP,3,1
2568,8989.0,30,was,7,5,1,-4,4,28,2,-6,Jamie Leigh Jones,Dear MoveOn,PERSON-PERSON-PERSON,ORGANIZATION-ORGANIZATION,PROPN-PROPN-PROPN,ADJ-PROPN,compound-compound-appos,amod-compound,NNP-NNP-NNP,JJ-NNP,3,1
2569,9002.0,14,charged,5,1,8,7,0,5,4,3,Wen,bribery,PERSON,CRIMINAL_CHARGE,PROPN,NOUN,nsubjpass,pobj,NNP,NN,5,1
2570,9008.0,37,wrote,17,25,22,-3,24,14,-8,5,Alan P. Gross,her,PERSON-PERSON-PERSON,PERSON,PROPN-PROPN-PROPN,DET,compound-compound-appos,poss,NNP-NNP-NNP,PRP$,3,1
2571,9018.0,28,Go,0,4,11,7,3,16,-4,11,National Restaurant Association,http://wwwrestaurantorg/,ORGANIZATION-ORGANIZATION-ORGANIZATION,URL,PROPN-PROPN-PROPN,PUNCT,compound-compound-poss,compound,NNP-NNP-NNP,.,-1,1
2572,9022.0,40,conveys,3,30,14,-16,29,25,-27,11,Alessi,Laura,PERSON,PERSON,PROPN,PROPN,compound,nsubj,NNP,NNP,3,1
2573,9036.0,16,recalled,2,5,15,10,4,0,-3,13,Piedra,dentist,PERSON,TITLE,PROPN,NOUN,nsubj,attr,NNP,NN,2,1
2574,12690.0,35,wrote,19,3,28,25,2,6,16,9,Piedra,dentist,PERSON,TITLE,PROPN,NOUN,npadvmod,nsubj,NNP,NN,4,1
2575,9051.0,31,comes,2,17,13,-4,16,17,-15,11,TPI,Texas Alliance of Energy Producers,ORGANIZATION,ORGANIZATION-ORGANIZATION-ORGANIZATION-ORGANIZATION-ORGANIZATION,PROPN,PROPN-PROPN-ADP-PROPN-PROPN,compound,compound-pobj-prep-compound-pobj,NNP,NNP-NNP-IN-NNP-NNPS,5,1
2576,9058.0,26,is,2,24,21,-3,23,4,-22,19,Eliza Samudio,5-month-old,PERSON-PERSON,DURATION,PROPN-PROPN,NUM,compound-appos,compound,NNP-NNP,CD,2,1
2577,9062.0,29,said,11,18,13,-5,17,15,-7,2,BedBug Central,Phillip Cooper,ORGANIZATION-ORGANIZATION,PERSON-PERSON,PROPN-PROPN,PROPN-PROPN,compound-pobj,compound-nsubj,NNP-NNP,NNP-NNP,3,1
2578,13378.0,37,said,18,13,1,-12,12,35,5,-17,BedBug Central,Phillip Cooper,ORGANIZATION-ORGANIZATION,PERSON-PERSON,PROPN-ADJ,PROPN-PROPN,nmod-amod,compound-nsubj,NNP-JJ,NNP-NNP,8,1
2579,9089.0,26,was,1,24,18,-6,23,7,-23,17,his,director,PERSON,TITLE,DET,NOUN,poss,conj,PRP$,NN,5,1
2580,9112.0,42,threatening,3,11,39,28,10,2,-8,36,its,366,ORGANIZATION,NUMBER,DET,NUM,poss,nummod,PRP$,CD,9,1
2581,9114.0,28,said,15,9,14,5,8,13,6,-1,Corporate Library,Washington,ORGANIZATION-ORGANIZATION,STATE_OR_PROVINCE,PROPN-PROPN,PROPN,compound-compound,pobj,NNP-NNP,NNP,6,1
2582,9120.0,38,agreed,7,33,27,-6,32,10,-26,20,Gay Men 's Health Crisis,Larry Kramer,ORGANIZATION-ORGANIZATION-ORGANIZATION-ORGANIZATION-ORGANIZATION,PERSON-PERSON,PROPN-PROPN-PART-PROPN-PROPN,PROPN-PROPN,compound-poss-case-compound-pobj,compound-pobj,NNP-NNPS-POS-NNP-NNP,NNP-NNP,2,1
2583,9127.0,38,said,14,8,1,-7,7,36,6,-13,Pacific Asia Travel Association,Peter Semone,ORGANIZATION-ORGANIZATION-ORGANIZATION-ORGANIZATION,PERSON-PERSON,PROPN-PROPN-PROPN-PROPN,PROPN-PROPN,compound-compound-compound-pobj,compound-nsubj,NNP-NNP-NNP-NNP,NNP-NNP,4,1
2584,9141.0,36,said,15,10,13,3,9,22,5,-2,Jupp,Roy,PERSON,PERSON,PROPN,PROPN,poss,appos,NNP,NNP,4,1
2585,9142.0,40,said,38,5,17,12,4,22,33,-21,group leader Laura Silsby,in detention in Port-au-Prince,PERSON-PERSON-PERSON-PERSON,CITY-CITY-CITY-CITY,NOUN-NOUN-PROPN-PROPN,ADP-NOUN-ADP-PROPN,compound-compound-compound-appos,prep-pobj-prep-pobj,NN-NN-NNP-NNP,IN-NN-IN-NNP,5,1
2586,9147.0,32,started,7,9,26,17,8,5,-2,19,his,Starbucks,PERSON,ORGANIZATION,DET,PROPN,poss,pobj,PRP$,NNP,4,1
2587,9151.0,28,wait,22,6,9,3,5,18,16,-13,Natalie Hagemo,19,PERSON-PERSON,NUMBER,PROPN-PROPN,NUM,compound-nsubj,nummod,NNP-NNP,CD,3,1
2588,9160.0,7,hired,1,1,4,3,0,2,0,3,Miettinen,WPS,PERSON,ORGANIZATION,PROPN,PROPN,nsubj,compound,NNP,NNP,3,1
2589,9163.0,59,said,39,54,48,-6,53,10,-15,9,National Development and Reform Commission,Academy of Macroeconomic Research,ORGANIZATION-ORGANIZATION-ORGANIZATION-ORGANIZATION-ORGANIZATION,ORGANIZATION-ORGANIZATION-ORGANIZATION-ORGANIZATION,PROPN-PROPN-CCONJ-PROPN-PROPN,PROPN-ADP-PROPN-PROPN,nmod-nmod-cc-conj-pobj,nmod-prep-compound-pobj,NNP-NNP-CC-NNP-NNP,NNP-IN-NNP-NNP,3,1
2590,9169.0,32,questioned,15,1,6,5,0,25,14,-9,Michael Lomax,chief executive officer,PERSON-PERSON,TITLE-TITLE-TITLE,PROPN-PROPN,ADJ-ADJ-NOUN,compound-nsubj,amod-amod-conj,NNP-NNP,JJ-JJ-NN,3,1
2591,9197.0,27,wrote,8,21,26,5,20,0,-13,18,her husband,Cuba,PERSON-PERSON,COUNTRY,DET-NOUN,PROPN,poss-poss,pobj,PRP$-NN,NNP,6,1
2592,9199.0,25,is,2,1,11,10,0,13,1,9,Amanda Knox,sexual violence,PERSON-PERSON,CRIMINAL_CHARGE-CRIMINAL_CHARGE,PROPN-PROPN,ADJ-NOUN,compound-nsubj,amod-conj,NNP-NNP,JJ-NN,8,1
2593,9205.0,29,traveled,1,9,14,5,8,14,-8,13,Menil Collection,Dominique de Menil,ORGANIZATION-ORGANIZATION,PERSON-PERSON-PERSON,PROPN-PROPN,PROPN-X-PROPN,compound-dobj,compound-compound-appos,NNP-NNP,NNP-FW-NNP,4,1
2594,9206.0,31,accused,10,14,25,11,13,5,-4,15,Aquash,Pine Ridge reservation,PERSON,CITY-CITY-CITY,PROPN,PROPN-PROPN-NOUN,dobj,compound-compound-pobj,NNP,NNP-NNP-NN,4,1
2595,9219.0,22,upheld,11,14,9,-5,13,12,-3,-2,she,slander,PERSON,CRIMINAL_CHARGE,PRON,NOUN,nsubjpass,amod,PRP,NN,3,1
2596,9223.0,44,accused,15,1,8,7,0,35,14,-7,Wen Qiang,Chongqing 's public,PERSON-PERSON,ORGANIZATION-ORGANIZATION-ORGANIZATION,PROPN-PROPN,PROPN-PART-ADJ,compound-nsubjpass,poss-case-amod,NNP-NNP,NNP-POS-JJ,5,1
2597,9228.0,42,born,4,29,33,4,28,8,-25,29,Albert Lange,architect,PERSON-PERSON,TITLE,PROPN-PROPN,NOUN,compound-conj,appos,NNP-NNP,NN,1,1
2598,9231.0,33,WASHINGTON,2,6,3,-3,5,29,-4,1,Urban League,WASHINGTON,ORGANIZATION-ORGANIZATION,STATE_OR_PROVINCE,PROPN-PROPN,PROPN,compound-nsubj,ROOT,NNP-NNP,NNP,-1,1
2599,9261.0,49,are,9,31,40,9,30,8,-22,31,"Qatalys , Inc",Dallas,ORGANIZATION-ORGANIZATION-ORGANIZATION,CITY,PROPN-PUNCT-PROPN,PROPN,ROOT-punct-appos,pobj,"NNP-,-NNP",NNP,2,1
2600,11867.0,21,founded,5,3,12,9,2,8,2,7,"Qatalys , Inc",Dallas,ORGANIZATION-ORGANIZATION-ORGANIZATION,CITY,PROPN-PUNCT-PROPN,PROPN,nmod-punct-nsubj,pobj,"NNP-,-NNP",NNP,5,1
2601,9285.0,45,said,23,25,43,18,24,1,-2,20,Dworin,Jewish Community,PERSON,ORGANIZATION-ORGANIZATION,PROPN,PROPN-PROPN,nsubj,compound-pobj,NNP,NNP-NNP,8,1
2602,9286.0,38,said,3,28,1,-27,27,36,-25,-2,ALICO,American International Group,ORGANIZATION,ORGANIZATION-ORGANIZATION-ORGANIZATION,PROPN,PROPN-PROPN-PROPN,compound,compound-compound-nsubj,NNP,NNP-NNP-NNP,6,1
2603,10039.0,48,YORK,1,38,11,-27,37,36,-37,10,ALICO,American International Group,ORGANIZATION,ORGANIZATION-ORGANIZATION-ORGANIZATION,PROPN,PROPN-PROPN-PROPN,compound,compound-compound-nsubj,NNP,NNP-NNP-NNP,6,1
2604,15293.0,30,said,5,21,12,-9,20,17,-16,7,ALICO,American International Group,ORGANIZATION,ORGANIZATION-ORGANIZATION-ORGANIZATION,PROPN,PROPN-PROPN-PROPN,compound,compound-compound-compound,NNP,NNP-NNP-NNP,4,1
2605,9300.0,42,respond,5,34,2,-32,33,39,-29,-3,he,Cuban,PERSON,NATIONALITY,PRON,ADJ,nsubj,amod,PRP,JJ,8,1
2606,9318.0,54,ignored,20,2,6,4,1,47,18,-14,child,Calvin Moore,PERSON,PERSON-PERSON,NOUN,PROPN-PROPN,poss,compound-nsubj,NN,NNP-NNP,3,1
2607,9344.0,25,tepatnya,11,23,19,-4,22,5,-12,8,TPI,Tempat Pelelangan Ikan,ORGANIZATION,ORGANIZATION-ORGANIZATION-ORGANIZATION,PROPN,PROPN-PROPN-PROPN,compound,compound-compound-ROOT,NNP,NNP-NNP-NNP,1,1
2608,9366.0,17,Nation,1,15,9,-6,14,7,-14,8,TPI,Prachai,ORGANIZATION,PERSON,PROPN,PROPN,compound,poss,NNP,NNP,-1,1
2609,12048.0,43,is,3,31,3,-28,30,39,-28,0,TPI,Prachai,ORGANIZATION,PERSON,PROPN,PROPN,dep,nsubj,NNP,NNP,5,1
2610,9370.0,41,PORT-AU-PRINCE,0,10,18,8,9,22,-10,18,Silsby,Baptists,PERSON,RELIGION,PROPN,PROPN,nsubjpass,pobj,NNP,NNPS,-1,1
2611,9388.0,29,said,18,4,1,-3,3,27,14,-17,Shoppertrak,Chicago,ORGANIZATION,CITY,PROPN,PROPN,nsubj,compound,NNP,NNP,3,1
2612,9403.0,21,said,2,6,20,14,5,0,-4,18,Samudio,Sousa,PERSON,PERSON,PROPN,PROPN,nsubj,pobj,NNP,NNP,4,1
2613,9412.0,52,identified,4,10,9,-1,9,42,-6,5,Alan Gross,60-year-old,PERSON-PERSON,NUMBER,PROPN-PROPN,PUNCT,compound-appos,appos,NNP-NNP,LS,1,1
2614,12631.0,39,identified,4,9,13,4,8,25,-5,9,Alan Gross,60-year-old,PERSON-PERSON,NUMBER,PROPN-PROPN,NUM,compound-pobj,amod,NNP-NNP,CD,4,1
2615,9427.0,32,said,27,5,3,-2,4,28,22,-24,Morita Chemical Industries,1935,ORGANIZATION-ORGANIZATION-ORGANIZATION,DATE,PROPN-PROPN-PROPN,NUM,compound-compound-nsubj,pobj,NNP-NNP-NNP,CD,3,1
2616,9432.0,22,said,1,10,8,-2,9,13,-9,7,Laura Silsby,leader,PERSON-PERSON,TITLE,PROPN-PROPN,NOUN,compound-appos,dobj,NNP-NNP,NN,2,1
2617,11073.0,28,told,13,7,6,-1,6,21,6,-7,Laura Silsby,leader,PERSON-PERSON,TITLE,PROPN-PROPN,NOUN,compound-nsubj,compound,NNP-NNP,NN,1,1
2618,11831.0,11,leave,3,7,6,-1,6,4,-4,3,Laura Silsby,leader,PERSON-PERSON,TITLE,PROPN-PROPN,NOUN,compound-dobj,compound,NNP-NNP,NN,1,1
2619,9435.0,43,been,8,17,37,20,16,5,-9,29,he,Ivorian,PERSON,NATIONALITY,PRON,ADJ,nsubj,dobj,PRP,JJ,6,1
2620,9441.0,32,graduated,1,1,5,4,0,26,0,4,He,"University of California , Berkeley",PERSON,ORGANIZATION-ORGANIZATION-ORGANIZATION-ORGANIZATION-ORGANIZATION,PRON,PROPN-ADP-PROPN-PUNCT-PROPN,nsubj,pobj-prep-pobj-punct-appos,PRP,"NNP-IN-NNP-,-NNP",1,1
2621,9447.0,15,BC-SCIENTOLOGY-RESPONSE,0,13,6,-7,12,8,-13,6,Natalie Hagemo,Scientology,PERSON-PERSON,RELIGION,PROPN-PROPN,PROPN,compound-pobj,poss,NNP-NNP,NNP,5,1
2622,9453.0,57,said,23,35,25,-10,34,31,-12,2,Huntington Library,Stephen Tabor,ORGANIZATION-ORGANIZATION,PERSON-PERSON,PROPN-PROPN,PROPN-PROPN,compound-pobj,compound-nsubj,NNP-NNP,NNP-NNP,7,1
2623,9468.0,35,survives,1,32,21,-11,31,13,-31,20,Joseph I. Lange,Lange,PERSON-PERSON-PERSON,PERSON,PROPN-PROPN-PROPN,PROPN,compound-compound-conj,nsubj,NNP-NNP-NNP,NNP,4,1
2624,9471.0,37,said,35,25,2,-23,24,34,10,-33,his,Red Cross,PERSON,ORGANIZATION-ORGANIZATION,DET,PROPN-PROPN,poss,compound-compound,PRP$,NNP-NNP,7,1
2625,9482.0,17,was,1,1,3,2,0,13,0,2,Gonzalez,attorney general,PERSON,TITLE-TITLE,PROPN,NOUN-ADJ,nsubj,compound-acomp,NNP,NN-JJ,1,1
2626,9484.0,29,is,3,26,21,-5,25,7,-23,18,Matteo Messina Denaro,leader,PERSON-PERSON-PERSON,TITLE,PROPN-PROPN-PROPN,NOUN,compound-compound-appos,pobj,NNP-NNP-NNP,NN,3,1
2627,9702.0,32,say,1,9,31,22,8,0,-8,30,Matteo Messina Denaro,leader,PERSON-PERSON-PERSON,TITLE,PROPN-PROPN-PROPN,NOUN,compound-compound-pobj,attr,NNP-NNP-NNP,NN,4,1
2628,9493.0,42,said,16,11,14,3,10,27,5,-2,Urban League,Eastern Massachusetts,ORGANIZATION-ORGANIZATION,LOCATION-LOCATION,PROPN-PROPN,PROPN-PROPN,compound-pobj,compound-pobj,NNP-NNP,NNP-NNP,2,1
2629,9498.0,13,got,3,3,2,-1,2,10,0,-1,woman,Idaho,PERSON,STATE_OR_PROVINCE,NOUN,PROPN,nsubj,compound,NN,NNP,1,1
2630,9522.0,36,said,9,5,1,-4,4,34,4,-8,NDA,Ian Roxburgh,ORGANIZATION,PERSON-PERSON,PROPN,PROPN-PROPN,poss,compound-nsubj,NNP,NNP-NNP,3,1
2631,14799.0,52,said,42,45,50,5,44,1,-3,8,NDA,Ian Roxburgh,ORGANIZATION,PERSON-PERSON,PROPN,PROPN-PROPN,poss,compound-appos,NNP,NNP-NNP,2,1
2632,9524.0,12,baptized,8,1,6,5,0,5,7,-2,Her,Scientologist,PERSON,RELIGION,DET,PROPN,poss,appos,PRP$,NNP,2,1
2633,9529.0,50,believe,18,33,27,-6,32,22,-15,9,National Congress of American Indians,Joe Garcia,ORGANIZATION-ORGANIZATION-ORGANIZATION-ORGANIZATION-ORGANIZATION,PERSON-PERSON,PROPN-PROPN-ADP-PROPN-PROPN,PROPN-PROPN,compound-pobj-prep-compound-pobj,compound-nsubj,NNP-NNP-IN-NNP-NNPS,NNP-NNP,5,1
2634,9551.0,35,pronounced,13,1,5,4,0,29,12,-8,Vladimir Ladyzhenskiy,amateur wrestler,PERSON-PERSON,TITLE-TITLE,PROPN-PROPN,ADJ-NOUN,compound-nsubjpass,amod-appos,NNP-NNP,JJ-NN,1,1
2635,9556.0,39,said,15,18,31,13,17,7,-3,16,Daniels,Worthy Temple Christ Holy Sanctified Church,PERSON,ORGANIZATION-ORGANIZATION-ORGANIZATION-ORGANIZATION-ORGANIZATION-ORGANIZATION,PROPN,PROPN-PROPN-PROPN-PROPN-PROPN-PROPN,pobj,compound-pobj-compound-compound-compound-appos,NNP,NNP-NNP-NNP-NNP-NNP-NNP,5,1
2636,9574.0,41,were,2,20,14,-6,19,26,-18,12,Wen Qiang,municipal judicial administrative bureau,PERSON-PERSON,ORGANIZATION-ORGANIZATION-ORGANIZATION-ORGANIZATION,PROPN-PROPN,ADJ-ADJ-ADJ-NOUN,compound-conj,amod-amod-amod-pobj,NNP-NNP,JJ-JJ-JJ-NN,8,1
2637,9580.0,35,said,24,26,31,5,25,3,-2,7,Shah Abdul Aziz,former member of Parliament,PERSON-PERSON-PERSON,TITLE-TITLE-TITLE-TITLE,PROPN-PROPN-PROPN,ADJ-NOUN-ADP-PROPN,compound-compound-nsubj,amod-appos-prep-pobj,NNP-NNP-NNP,JJ-NN-IN-NNP,3,1
2638,9582.0,46,said,2,35,13,-22,34,32,-33,11,Annie Mae Aquash,Rapid City,PERSON-PERSON-PERSON,CITY-CITY,PROPN-PROPN-PROPN,PROPN-PROPN,compound-compound-pobj,compound-pobj,NNP-NNP-NNP,NNP-NNP,12,1
2639,9590.0,32,reprint,2,18,23,5,17,8,-16,21,American Free Press,Pennsylvania Avenue SE,ORGANIZATION-ORGANIZATION-ORGANIZATION,LOCATION-LOCATION-LOCATION,PROPN-PROPN-PROPN,PROPN-PROPN-PROPN,compound-compound-pobj,compound-compound-appos,NNP-NNP-NNP,NNP-NNP-NNP,4,1
2640,9592.0,50,formed,1,1,43,42,0,6,0,42,He,Chicago,PERSON,CITY,PRON,PROPN,nsubj,pobj,PRP,NNP,2,1
2641,9607.0,36,said,24,22,26,4,21,9,2,2,his,Sgt.,PERSON,TITLE,DET,PROPN,poss,compound,PRP$,NNP,6,1
2642,9621.0,26,resumes,8,23,3,-20,22,22,-15,-5,Knox,US,PERSON,COUNTRY,PROPN,PROPN,conj,compound,NNP,NNP,7,1
2643,9632.0,24,detained,4,11,8,-3,10,15,-7,4,Alan Gross,government contractor,PERSON-PERSON,TITLE-TITLE,PROPN-PROPN,NOUN-NOUN,compound-appos,compound-dobj,NNP-NNP,NN-NN,1,1
2644,9836.0,52,identified,4,10,3,-7,9,48,-6,-1,Alan Gross,government contractor,PERSON-PERSON,TITLE-TITLE,PROPN-PROPN,NOUN-NOUN,compound-appos,compound-pobj,NNP-NNP,NN-NN,5,1
2645,10786.0,39,identified,4,9,3,-6,8,35,-5,-1,Alan Gross,government contractor,PERSON-PERSON,TITLE-TITLE,PROPN-PROPN,NOUN-NOUN,compound-pobj,compound-appos,NNP-NNP,NN-NN,3,1
2646,9636.0,46,seeking,33,3,3,0,2,42,30,-30,Australian Defence Force,Australian Government,ORGANIZATION-ORGANIZATION-ORGANIZATION,ORGANIZATION-ORGANIZATION,PROPN-PROPN-PROPN,ADJ-PROPN,compound-compound-appos,compound-compound,NNP-NNP-NNP,JJ-NNP,0,1
2647,9639.0,42,remained,1,23,17,-6,22,24,-22,16,Professional Ski Instructors of America,John Armstrong,ORGANIZATION-ORGANIZATION-ORGANIZATION-ORGANIZATION-ORGANIZATION,PERSON-PERSON,PROPN-PROPN-PROPN-ADP-PROPN,PROPN-PROPN,compound-compound-pobj-prep-pobj,compound-appos,NNP-NNP-NNP-IN-NNP,NNP-NNP,4,1
2648,9684.0,30,died,25,2,10,8,1,19,23,-15,Frank Baldino Jr.,Cephalon,PERSON-PERSON-PERSON,ORGANIZATION,PROPN-PROPN-PROPN,PROPN,compound-compound-nsubj,appos,NNP-NNP-NNP,NNP,3,1
2649,9701.0,25,remained,7,4,12,8,3,12,3,5,her,Jew,PERSON,RELIGION,DET,PROPN,poss,pobj,PRP$,NNP,3,1
2650,9705.0,36,AIG-METLIFE,0,19,7,-12,18,28,-19,7,Alico,American International Group,ORGANIZATION,ORGANIZATION-ORGANIZATION-ORGANIZATION,PROPN,PROPN-PROPN-PROPN,appos,compound-compound-nsubj,NNP,NNP-NNP-NNP,5,1
2651,12502.0,44,said,15,36,1,-35,35,42,-21,-14,Alico,American International Group,ORGANIZATION,ORGANIZATION-ORGANIZATION-ORGANIZATION,PROPN,PROPN-PROPN-PROPN,pobj,compound-compound-nsubj,NNP,NNP-NNP-NNP,7,1
2652,9709.0,37,know,4,1,7,6,0,29,3,3,His,he,PERSON,PERSON,DET,PRON,poss,nsubj,PRP$,PRP,3,1
2653,9710.0,27,charged,3,1,6,5,0,20,2,3,She,kidnapping,PERSON,CRIMINAL_CHARGE,PRON,NOUN,nsubjpass,pobj,PRP,NN,4,1
2654,9718.0,26,found,11,13,17,4,12,8,-2,6,John Graham,felony murder,PERSON-PERSON,CRIMINAL_CHARGE-CRIMINAL_CHARGE,PROPN-PROPN,NOUN-NOUN,compound-nsubj,compound-pobj,NNP-NNP,NN-NN,5,1
2655,9730.0,47,recalled,17,10,1,-9,9,45,7,-16,Huntington Library,David Zeidberg,ORGANIZATION-ORGANIZATION,PERSON-PERSON,PROPN-PROPN,PROPN-PROPN,compound-pobj,compound-nsubj,NNP-NNP,NNP-NNP,3,1
2656,9732.0,32,said,24,9,23,14,8,8,15,-1,National Congress of American Indians,US,ORGANIZATION-ORGANIZATION-ORGANIZATION-ORGANIZATION-ORGANIZATION,COUNTRY,PROPN-PROPN-ADP-PROPN-PROPN,PROPN,compound-pobj-prep-compound-pobj,pobj,NNP-NNP-IN-NNP-NNPS,NNP,5,1
2657,9741.0,42,born,4,1,9,8,0,32,3,5,Andrew E Lange,Ill,PERSON-PERSON-PERSON,STATE_OR_PROVINCE,PROPN-PROPN-PROPN,PROPN,compound-compound-nsubjpass,appos,NNP-NNP-NNP,NNP,3,1
2658,9742.0,36,trying,4,1,11,10,0,24,3,7,Messina Denaro,Palermo,PERSON-PERSON,CITY,PROPN-PROPN,PROPN,compound-nsubj,pobj,NNP-NNP,NNP,6,1
2659,9746.0,32,said,30,1,4,3,0,27,29,-26,Gross,international development worker,PERSON,TITLE-TITLE-TITLE,PROPN,ADJ-NOUN-NOUN,nsubj,amod-compound-attr,NNP,JJ-NN-NN,2,1
2660,9759.0,30,began,22,13,1,-12,12,28,9,-21,Professional Ski Instructors of America,Fiore,ORGANIZATION-ORGANIZATION-ORGANIZATION-ORGANIZATION-ORGANIZATION,PERSON,PROPN-PROPN-PROPN-ADP-PROPN,PROPN,compound-compound-pobj-prep-pobj,nsubj,NNP-NNP-NNP-IN-NNP,NNP,8,1
2661,9764.0,48,oftentimes,3,17,45,28,16,2,-14,42,chain,United States,ORGANIZATION,COUNTRY-COUNTRY,NOUN,PROPN-PROPN,pobj,compound-pobj,NN,NNP-NNP,9,1
2662,9769.0,31,accused,10,1,5,4,0,25,9,-5,John Graham,55-year-old,PERSON-PERSON,NUMBER,PROPN-PROPN,NUM,compound-nsubjpass,amod,NNP-NNP,CD,4,1
2663,9772.0,11,sold,1,3,5,2,2,5,-2,4,ALICO,MetLife Inc.,ORGANIZATION,ORGANIZATION-ORGANIZATION,PROPN,PROPN-PROPN,dobj,compound-pobj,NNP,NNP-NNP,1,1
2664,9776.0,38,testified,9,8,17,9,7,20,1,8,she,Florida,PERSON,STATE_OR_PROVINCE,PRON,PROPN,nsubj,pobj,PRP,NNP,4,1
2665,9782.0,34,said,16,32,28,-4,31,5,-16,12,Mario Gonzalez,OSPESCA,PERSON-PERSON,ORGANIZATION,PROPN-PROPN,PROPN,compound-appos,compound,NNP-NNP,NNP,-1,1
2666,9784.0,49,talks,10,18,14,-4,17,34,-8,4,he,his,PERSON,PERSON,PRON,DET,nsubj,appos,PRP,PRP$,5,1
2667,13595.0,38,blamed,6,6,8,2,5,29,0,2,he,his,PERSON,PERSON,PRON,DET,nsubj,poss,PRP,PRP$,1,1
2668,9791.0,57,Sent,0,25,21,-4,24,35,-25,21,Mark Fisher,SpringSource Team Blog,PERSON-PERSON,ORGANIZATION-ORGANIZATION-ORGANIZATION,PROPN-PROPN,PROPN-PROPN-PROPN,compound-pobj,compound-compound-pobj,NNP-NNP,NNP-NNP-NNP,5,1
2669,9802.0,24,showed,1,22,17,-5,21,6,-21,16,his,architect,PERSON,TITLE,DET,NOUN,poss,compound,PRP$,NN,4,1
2670,9804.0,24,see,15,1,17,16,0,6,14,2,She,his,PERSON,PERSON,PRON,DET,nsubj,poss,PRP,PRP$,3,1
2671,9808.0,28,said,10,2,6,4,1,21,8,-4,Mark Fisher,director,PERSON-PERSON,TITLE,PROPN-PROPN,NOUN,compound-nsubj,appos,NNP-NNP,NN,2,1
2672,10525.0,29,said,13,15,19,4,14,9,-2,6,Mark Fisher,director,PERSON-PERSON,TITLE,PROPN-PROPN,NOUN,compound-nsubj,appos,NNP-NNP,NN,2,1
2673,9824.0,33,ask,3,22,13,-9,21,19,-19,10,she,columnist,PERSON,TITLE,PRON,NOUN,nsubjpass,appos,PRP,NN,7,1
2674,9828.0,33,announced,3,12,16,4,11,16,-9,13,Countrywide Financial Corp.,America,ORGANIZATION-ORGANIZATION-ORGANIZATION,COUNTRY,PROPN-PROPN-PROPN,PROPN,compound-compound-dobj,poss,NNP-NNP-NNP,NNP,4,1
2675,9829.0,20,predicted,1,3,7,4,2,12,-2,6,Laura Silsby,leader of the Idaho-based missionary group,PERSON-PERSON,TITLE-TITLE-TITLE-TITLE-TITLE-TITLE,PROPN-PROPN,NOUN-ADP-DET-ADJ-NOUN-NOUN,compound-nsubjpass,appos-prep-det-amod-amod-pobj,NNP-NNP,NN-IN-DT-JJ-NN-NN,2,1
2676,9861.0,19,hospitalized,3,1,17,16,0,1,2,14,She,last week,PERSON,DATE-DATE,PRON,ADJ-NOUN,nsubjpass,amod-npadvmod,PRP,JJ-NN,5,1
2677,9863.0,45,invited,16,2,7,5,1,37,14,-9,Taiwan Symphony Orchestra,Taipei Philharmonic Orchestra,ORGANIZATION-ORGANIZATION-ORGANIZATION,ORGANIZATION-ORGANIZATION-ORGANIZATION,PROPN-PROPN-PROPN,PROPN-PROPN-PROPN,compound-compound-nsubjpass,compound-compound-appos,NNP-NNP-NNP,NNP-NNP-NNP,3,1
2678,9880.0,41,said,7,1,30,29,0,10,6,23,Jamie Leigh Jones,KBR Inc,PERSON-PERSON-PERSON,ORGANIZATION-ORGANIZATION,PROPN-PROPN-PROPN,PROPN-PROPN,compound-compound-nsubj,compound-pobj,NNP-NNP-NNP,NNP-NNP,6,1
2679,9884.0,39,recalls,1,1,28,27,0,10,0,27,Lomax,Alabama,PERSON,STATE_OR_PROVINCE,PROPN,PROPN,nsubj,appos,NNP,NNP,2,1
2680,9888.0,42,SOMERSET,0,13,17,4,12,24,-13,17,Miettinen,PK-35,PERSON,ORGANIZATION,PROPN,PROPN,nsubj,punct,NNP,NNPS,2,1
2681,9889.0,30,said,16,9,1,-8,8,28,7,-15,Pacific Asia Travel Association,Greg Duffell,ORGANIZATION-ORGANIZATION-ORGANIZATION-ORGANIZATION,PERSON-PERSON,PROPN-PROPN-PROPN-PROPN,PROPN-PROPN,compound-compound-compound-pobj,compound-nsubj,NNP-NNP-NNP-NNP,NNP-NNP,4,1
2682,14277.0,43,said,30,39,32,-7,38,10,-9,2,Pacific Asia Travel Association,Greg Duffell,ORGANIZATION-ORGANIZATION-ORGANIZATION-ORGANIZATION,PERSON-PERSON,PROPN-PROPN-PROPN-PROPN,PROPN-PROPN,compound-compound-compound-pobj,compound-nsubj,NNP-NNP-NNP-NNP,NNP-NNP,4,1
2683,9891.0,11,called,1,3,1,-2,2,9,-2,0,Miettinen,Rampone,PERSON,PERSON,PROPN,PROPN,dobj,nsubj,NNP,NNP,2,1
2684,9918.0,23,said,21,1,15,14,0,7,20,-6,He,Tripoli,PERSON,LOCATION,PRON,PROPN,nsubj,compound,PRP,NNP,1,1
2685,9942.0,20,was,14,1,7,6,0,12,13,-7,Aquash,Mi,PERSON,LOCATION,PROPN,PROPN,nsubj,pobj,NNP,NNP,5,1
2686,9952.0,9,expelled,2,1,5,4,0,3,1,3,He,Scientology,PERSON,RELIGION,PRON,PROPN,nsubjpass,pobj,PRP,NNP,2,1
2687,11522.0,15,closed,1,1,10,9,0,4,0,9,He,Scientology,PERSON,RELIGION,PRON,PROPN,nsubj,compound,PRP,NNP,4,1
2688,9955.0,43,said,30,39,38,-1,38,4,-9,8,Pacific Asia Travel Association,Bangkok-based,ORGANIZATION-ORGANIZATION-ORGANIZATION-ORGANIZATION,CITY,PROPN-PROPN-PROPN-PROPN,PROPN,compound-compound-compound-pobj,compound,NNP-NNP-NNP-NNP,NNP,1,1
2689,9956.0,26,said,10,22,12,-10,21,13,-12,2,Pacific Asia Travel Association,Oliver Martin,ORGANIZATION-ORGANIZATION-ORGANIZATION-ORGANIZATION,PERSON-PERSON,PROPN-PROPN-PROPN-PROPN,PROPN-PROPN,compound-compound-compound-appos,compound-nsubj,NNP-NNP-NNP-NNP,NNP-NNP,6,1
2690,9960.0,30,set,3,26,29,3,25,0,-23,26,NCCCC,1998,ORGANIZATION,DATE,PROPN,NUM,compound,pobj,NNP,CD,2,1
2691,9963.0,42,held,25,13,13,0,12,28,12,-12,Myanmar Equestrian Federation,Myanmar,ORGANIZATION-ORGANIZATION-ORGANIZATION,COUNTRY,PROPN-PROPN-PROPN,PROPN,compound-compound-pobj,compound,NNP-NNP-NNP,NNP,0,1
2692,11520.0,47,Myanmar,0,1,1,0,0,45,-1,1,Myanmar Equestrian Federation,Myanmar,ORGANIZATION-ORGANIZATION-ORGANIZATION,COUNTRY,PROPN-PROPN-PROPN,PROPN,compound-compound-pobj,ROOT,NNP-NNP-NNP,NNP,0,1
2693,9967.0,25,told,1,10,13,3,9,11,-9,12,Laura Silsby,Boise,PERSON-PERSON,CITY,PROPN-PROPN,PROPN,compound-appos,pobj,NNP-NNP,NNP,1,1
2694,9971.0,35,studied,1,7,17,10,6,17,-6,16,University of Maryland,he,PERSON-PERSON-PERSON,ORGANIZATION,PROPN-ADP-PROPN,PRON,pobj-prep-pobj,nsubj,NNP-IN-NNP,PRP,4,1
2695,9982.0,45,said,26,37,28,-9,36,16,-11,2,Corporate Library,Alexandra Higgins,ORGANIZATION-ORGANIZATION,PERSON-PERSON,PROPN-PROPN,PROPN-PROPN,compound-pobj,compound-nsubj,NNP-NNP,NNP-NNP,5,1
2696,10734.0,26,said,6,5,1,-4,4,24,1,-5,Corporate Library,Alexandra Higgins,ORGANIZATION-ORGANIZATION,PERSON-PERSON,PROPN-PROPN,PROPN-PROPN,compound-pobj,compound-nsubj,NNP-NNP,NNP-NNP,2,1
2697,9996.0,15,told,5,1,4,3,0,10,4,-1,Knox,Janet Huff,PERSON,PERSON-PERSON,PROPN,PROPN-PROPN,poss,compound-appos,NNP,NNP-NNP,3,1
2698,10169.0,27,told,10,1,5,4,0,21,9,-5,Knox,Janet Huff,PERSON,PERSON-PERSON,PROPN,PROPN-PROPN,poss,compound-appos,NNP,NNP-NNP,3,1
2699,10000.0,25,agreed,4,1,3,2,0,21,3,-1,Sarah,33,PERSON,NUMBER,PROPN,NUM,nsubj,appos,NNP,CD,2,1
2700,10005.0,26,say,1,3,7,4,2,18,-2,6,Vladimir Ladyzhenskiy,Saturday,PERSON-PERSON,DATE,PROPN-PROPN,PROPN,compound-nsubj,npadvmod,NNP-NNP,NNP,2,1
2701,10015.0,83,include,2,1,46,45,0,36,1,44,OANA,Kazinform,ORGANIZATION,ORGANIZATION,PROPN,PROPN,compound,conj,NNP,NNP,8,1
2702,10019.0,37,formed,18,1,34,33,0,2,17,16,Pluribus Capital Management,Nielsen Business Media,ORGANIZATION-ORGANIZATION-ORGANIZATION,ORGANIZATION-ORGANIZATION-ORGANIZATION,PROPN-PROPN-PROPN,PROPN-PROPN-PROPN,compound-compound-nsubj,compound-compound-pobj,NNP-NNP-NNP,NNP-NNP-NNP,8,1
2703,10030.0,42,said,10,16,5,-11,15,36,-6,-5,his,U.N.,PERSON,ORGANIZATION,DET,PROPN,poss,compound,PRP$,NNP,6,1
2704,10031.0,33,prompted,3,5,11,6,4,21,-2,8,Mario Gonzalez,sister,PERSON-PERSON,PERSON,PROPN-PROPN,NOUN,compound-dobj,nsubj,NNP-NNP,NN,4,1
2705,10079.0,15,is,3,1,7,6,0,7,2,4,Michael L Lomax,chief executive,PERSON-PERSON-PERSON,TITLE-TITLE,PROPN-PROPN-PROPN,ADJ-NOUN,compound-compound-nsubj,amod-conj,NNP-NNP-NNP,JJ-NN,4,1
2706,10082.0,37,said,26,14,14,0,13,22,12,-12,Koch Foods Inc.,Koch Foods,ORGANIZATION-ORGANIZATION-ORGANIZATION,ORGANIZATION-ORGANIZATION,PROPN-PROPN-PROPN,PROPN-PROPN,compound-compound-poss,compound-compound,NNP-NNP-NNP,NNP-NNP,0,1
2707,15375.0,44,said,28,14,14,0,13,29,14,-14,Koch Foods Inc.,Koch Foods,ORGANIZATION-ORGANIZATION-ORGANIZATION,ORGANIZATION-ORGANIZATION,PROPN-PROPN-PROPN,PROPN-PROPN,compound-compound-poss,compound-compound,NNP-NNP-NNP,NNP-NNP,0,1
2708,10090.0,36,are,4,31,34,3,30,1,-27,30,Samudio,last month,PERSON,DATE-DATE,PROPN,ADJ-NOUN,dobj,amod-npadvmod,NNP,JJ-NN,2,1
2709,10099.0,46,said,35,31,37,6,30,8,4,2,Tribeca Enterprises,Jon Patricof,ORGANIZATION-ORGANIZATION,PERSON-PERSON,PROPN-PROPN,PROPN-PROPN,compound-pobj,compound-nsubj,NNP-NNPS,NNP-NNP,14,1
2710,10104.0,44,built,24,10,14,4,9,29,14,-10,Countrywide,David Loeb,ORGANIZATION,PERSON-PERSON,PROPN,PROPN-PROPN,dobj,compound-pobj,NNP,NNP-NNP,3,1
2711,10112.0,31,includes,4,1,6,5,0,24,3,2,PDA,seven,ORGANIZATION,NUMBER,PROPN,NUM,poss,nummod,NNP,CD,4,1
2712,10119.0,42,said,40,23,6,-17,22,35,17,-34,he,assistant secretary of state,PERSON,TITLE-TITLE-TITLE-TITLE,PRON,NOUN-NOUN-ADP-NOUN,nsubj,compound-appos-prep-pobj,PRP,NN-NN-IN-NN,3,1
2713,10128.0,17,born,2,1,4,3,0,12,1,2,Baldino,"May 13 , 1953",PERSON,DATE-DATE-DATE-DATE,PROPN,PROPN-NUM-PUNCT-NUM,nsubjpass,npadvmod-nummod-punct-nummod,NNP,"NNP-CD-,-CD",3,1
2714,10136.0,41,said,27,29,40,11,28,0,-2,13,Ahmed Rashid,Pakistan,PERSON-PERSON,COUNTRY,PROPN-PROPN,PROPN,compound-nsubj,pobj,NNP-NNP,NNP,6,1
2715,12852.0,55,said,42,44,48,4,43,6,-2,6,Ahmed Rashid,Pakistan,PERSON-PERSON,COUNTRY,PROPN-PROPN,PROPN,compound-nsubj,npadvmod,NNP-NNP,NNP,3,1
2716,10159.0,27,said,16,2,23,21,1,3,14,7,her,Cuban,PERSON,NATIONALITY,DET,ADJ,poss,amod,PRP$,JJ,5,1
2717,10160.0,6,Case,5,1,5,4,0,0,4,0,Jamie Leigh Jones,Rape,PERSON-PERSON-PERSON,CRIMINAL_CHARGE,PROPN-PROPN-PROPN,PROPN,compound-compound-compound,compound,NNP-NNP-NNP,NNP,3,1
2718,10164.0,31,declined,1,12,20,8,11,10,-11,19,he,U.S.,PERSON,COUNTRY,PRON,PROPN,nsubj,compound,PRP,NNP,3,1
2719,10165.0,30,ended,8,5,18,13,4,11,3,10,Piedra,him,PERSON,PERSON,PROPN,PRON,nsubj,dobj,NNP,PRP,5,1
2720,10174.0,35,served,1,29,8,-21,28,26,-28,7,he,Chongqing Municipal Public Security Bureau,PERSON,ORGANIZATION-ORGANIZATION-ORGANIZATION-ORGANIZATION-ORGANIZATION,PRON,PROPN-PROPN-PROPN-PROPN-PROPN,nsubjpass,compound-compound-compound-compound-pobj,PRP,NNP-NNP-NNP-NNP-NNP,7,1
2721,10175.0,31,is,3,5,10,5,4,20,-2,7,Ruben,Holland,PERSON,COUNTRY,PROPN,PROPN,attr,pobj,NNP,NNP,4,1
2722,10187.0,33,kicked,23,29,19,-10,28,13,-6,-4,Australian Defence Force,Australia,ORGANIZATION-ORGANIZATION-ORGANIZATION,COUNTRY,PROPN-PROPN-PROPN,PROPN,compound-compound-compound,pobj,NNP-NNP-NNP,NNP,13,1
2723,10191.0,25,survived,1,21,24,3,20,0,-20,23,Chen Tao,China,PERSON-PERSON,COUNTRY,PROPN-PROPN,PROPN,compound-npadvmod,pobj,NNP-NNP,NNP,3,1
2724,14697.0,44,cleared,9,1,39,38,0,4,8,30,Chen Tao,China,PERSON-PERSON,COUNTRY,PROPN-PROPN,PROPN,compound-nsubj,pobj,NNP-NNP,NNP,5,1
2725,10197.0,25,tepatnya,11,19,23,4,18,1,-8,12,Tempat Pelelangan Ikan,TPI,ORGANIZATION-ORGANIZATION-ORGANIZATION,ORGANIZATION,PROPN-PROPN-PROPN,PROPN,compound-compound-ROOT,compound,NNP-NNP-NNP,NNP,1,1
2726,10215.0,16,said,14,1,3,2,0,12,13,-11,Ramon,21,PERSON,NUMBER,PROPN,NUM,nsubj,appos,NNP,CD,2,1
2727,10224.0,12,said,2,5,4,-1,4,7,-3,2,Chen Tao,captain,PERSON-PERSON,TITLE,PROPN-PROPN,NOUN,compound-nsubj,compound,NNP-NNP,NN,1,1
2728,15492.0,42,planning,28,18,17,-1,17,24,10,-11,Chen Tao,captain,PERSON-PERSON,TITLE,PROPN-PROPN,NOUN,compound-conj,compound,NNP-NNP,NN,1,1
2729,10230.0,41,survived,2,18,1,-17,17,39,-16,-1,Carol Daniels,He,PERSON-PERSON,PERSON,PROPN-PROPN,PRON,compound-appos,nsubjpass,NNP-NNP,PRP,5,1
2730,10232.0,37,denied,21,24,21,-3,23,15,-3,0,her,Thursday,PERSON,DATE,PRON,PROPN,dobj,pobj,PRP,NNP,2,1
2731,10235.0,25,found,6,23,3,-20,22,21,-17,-3,his,Allegheny County,PERSON,LOCATION-LOCATION,DET,PROPN-PROPN,poss,compound-compound,PRP$,NNP-NNP,8,1
2732,10246.0,24,demanding,6,1,3,2,0,20,5,-3,Samudio,25,PERSON,NUMBER,NOUN,NUM,nsubj,appos,NN,CD,3,1
2733,14109.0,24,demanding,6,1,3,2,0,20,5,-3,Samudio,25,PERSON,NUMBER,NOUN,NUM,nsubj,appos,NN,CD,3,1
2734,10261.0,43,is,1,8,12,4,7,30,-7,11,Nuclear Decommissioning Authority,NDA,ORGANIZATION-ORGANIZATION-ORGANIZATION,ORGANIZATION,PROPN-PROPN-PROPN,PROPN,compound-compound-compound,compound,NNP-NNP-NNP,NNP,3,1
2735,14406.0,37,confirmed,8,2,6,4,1,30,6,-2,Nuclear Decommissioning Authority,NDA,ORGANIZATION-ORGANIZATION-ORGANIZATION,ORGANIZATION,PROPN-PROPN-PROPN,PROPN,compound-compound-compound,compound,NNP-NNP-NNP,NNP,3,1
2736,10267.0,30,coaches,1,1,26,25,0,3,0,25,Miettinen,coach,PERSON,TITLE,PROPN,NOUN,nsubj,attr,NNP,NN,2,1
2737,10280.0,35,CITY,1,10,3,-7,9,31,-9,2,Daniels,2009-08-28,PERSON,DATE,PROPN,NUM,poss,nummod,NNP,CD,-1,1
2738,10289.0,37,said,11,8,20,12,7,16,3,9,Wen,Chinese,PERSON,COUNTRY,PROPN,ADJ,poss,compound,NNP,JJ,5,1
2739,10296.0,27,said,16,1,15,14,0,11,15,-1,Chen Tao,Shantou,PERSON-PERSON,LOCATION,PROPN-PROPN,PROPN,compound-nsubj,pobj,NNP-NNP,NNP,2,1
2740,10310.0,28,survived,3,12,6,-6,11,21,-9,3,Karen Lange,his,PERSON-PERSON,PERSON,PROPN-PROPN,DET,compound-appos,poss,NNP-NNP,PRP$,2,1
2741,10312.0,30,elected,13,21,25,4,20,4,-8,12,OANA,Yusuf,ORGANIZATION,PERSON,PROPN,PROPN,compound,dobj,NNP,NNP,4,1
2742,10315.0,34,shares,1,9,22,13,8,11,-8,21,his,her,PERSON,PERSON,DET,DET,poss,poss,PRP$,PRP$,6,1
2743,10324.0,53,includes,4,32,2,-30,31,50,-28,-2,Progressive Democrats of America,White Rose Coalition,ORGANIZATION-ORGANIZATION-ORGANIZATION-ORGANIZATION,ORGANIZATION-ORGANIZATION-ORGANIZATION,PROPN-PROPN-ADP-PROPN,PROPN-PROPN-PROPN,compound-conj-prep-pobj,compound-compound-nsubj,NNP-NNPS-IN-NNP,NNP-NNP-NNP,-1,1
2744,10331.0,19,live,4,14,13,-1,13,5,-10,9,Menil Collection,1987,ORGANIZATION-ORGANIZATION,DATE,PROPN-PROPN,NUM,compound-compound,nummod,NNP-NNP,CD,1,1
2745,10336.0,45,R,0,43,28,-15,42,16,-43,28,Sarah Kunstler,William Kunstler,PERSON-PERSON,PERSON-PERSON,PROPN-PROPN,PROPN-PROPN,compound-conj,compound-appos,NNP-NNP,NNP-NNP,-1,1
2746,10344.0,50,make,19,6,6,0,5,43,13,-13,Tribeca Enterprises,Tribeca,ORGANIZATION-ORGANIZATION,ORGANIZATION,PROPN-PROPN,PROPN,compound-pobj,compound,NNP-NNPS,NNP,0,1
2747,10346.0,27,said,25,22,24,2,21,2,3,-1,PATA,Brian Deeson,ORGANIZATION,PERSON-PERSON,PROPN,PROPN-PROPN,compound,compound-nsubj,NNP,NNP-NNP,4,1
2748,10349.0,25,had,11,6,24,18,5,0,5,13,her,Minneapolis,PERSON,CITY,DET,PROPN,poss,pobj,PRP$,NNP,5,1
2749,12206.0,25,had,11,6,24,18,5,0,5,13,her,Minneapolis,PERSON,CITY,DET,PROPN,poss,pobj,PRP$,NNP,5,1
2750,10357.0,39,recalls,1,9,7,-2,8,31,-8,6,his,13,PERSON,NUMBER,DET,NUM,poss,nummod,PRP$,CD,2,1
2751,12928.0,39,recalls,1,9,7,-2,8,31,-8,6,his,13,PERSON,NUMBER,DET,NUM,poss,nummod,PRP$,CD,2,1
2752,10367.0,54,MANILA,0,27,38,11,26,15,-27,38,Eugenio Vagni,Patikul,PERSON-PERSON,CITY,PROPN-PROPN,PROPN,compound-conj,compound,NNP-NNP,NNP,4,1
2753,10374.0,7,Congress,1,1,7,6,0,-1,0,6,National Congress of American Indians,http://www.ncai.org,ORGANIZATION-ORGANIZATION-ORGANIZATION-ORGANIZATION-ORGANIZATION,URL,PROPN-PROPN-ADP-PROPN-PROPN,INTJ,compound-ROOT-prep-compound-pobj,appos,NNP-NNP-IN-NNP-NNPS,UH,-1,1
2754,10377.0,32,kills,5,23,3,-20,22,28,-18,-2,Morita Chemical Industries Co,Japanese,ORGANIZATION-ORGANIZATION-ORGANIZATION-ORGANIZATION,COUNTRY,PROPN-PROPN-PROPN-PROPN,ADJ,compound-compound-compound-pobj,amod,NNP-NNP-NNP-NNP,JJ,-1,1
2755,10378.0,59,published,16,18,13,-5,17,45,-2,-3,his,59,PERSON,NUMBER,DET,NUM,poss,appos,PRP$,CD,3,1
2756,10382.0,28,executed,4,6,23,17,5,4,-2,19,Wen Qiang,bribes,PERSON-PERSON,CRIMINAL_CHARGE,PROPN-PROPN,NOUN,compound-dobj,dobj,NNP-NNP,NNS,5,1
2757,14220.0,45,sentences,1,15,41,26,14,3,-14,40,Wen Qiang,bribes,PERSON-PERSON,CRIMINAL_CHARGE,PROPN-PROPN,NOUN,compound-pobj,dobj,NNP-NNP,NNS,4,1
2758,10384.0,37,is,2,1,6,5,0,30,1,4,Ble Goude,minister,PERSON-PERSON,TITLE,PROPN-PROPN,NOUN,compound-nsubj,attr,NNP-NNP,NN,3,1
2759,10409.0,34,BEIJING,0,5,23,18,4,10,-5,23,Wen,taking bribes in exchange for protecting gang members,PERSON,CRIMINAL_CHARGE-CRIMINAL_CHARGE-CRIMINAL_CHARGE-CRIMINAL_CHARGE-CRIMINAL_CHARGE-CRIMINAL_CHARGE-CRIMINAL_CHARGE-CRIMINAL_CHARGE,PROPN,VERB-NOUN-ADP-NOUN-ADP-VERB-NOUN-NOUN,poss,pcomp-dobj-prep-pobj-prep-pcomp-compound-dobj,NNP,VBG-NNS-IN-NN-IN-VBG-NN-NNS,5,1
2760,10411.0,28,broke,15,2,15,13,1,12,13,0,Knox,American,PERSON,NATIONALITY,PROPN,PROPN,poss,nsubj,NNP,NNP,4,1
2761,10418.0,21,charged,12,3,15,12,2,5,9,3,People,bribery,PERSON,CRIMINAL_CHARGE,PROPN,NOUN,poss,pobj,NNPS,NN,6,1
2762,10426.0,9,graduated,1,1,4,3,0,4,0,3,She,Columbia Law School,PERSON,ORGANIZATION-ORGANIZATION-ORGANIZATION,PRON,PROPN-PROPN-PROPN,nsubj,compound-compound-pobj,PRP,NNP-NNP-NNP,3,1
2763,10435.0,15,was,5,2,1,-1,1,13,3,-4,Ramon,Lt.,PERSON,TITLE,PROPN,PROPN,nsubj,compound,NNP,NNP,1,1
2764,10438.0,40,was,1,16,19,3,15,20,-15,18,Alan Gross,61,PERSON-PERSON,NUMBER,PROPN-PROPN,NUM,compound-pobj,appos,NNP-NNP,CD,1,1
2765,10462.0,19,shaking,6,11,1,-10,10,17,-5,-5,her,Knox,PERSON,PERSON,DET,PROPN,poss,poss,PRP$,NNP,5,1
2766,10467.0,21,testified,1,3,15,12,2,5,-2,14,he,Tufts University School of Dental Medicine,PERSON,ORGANIZATION-ORGANIZATION-ORGANIZATION-ORGANIZATION-ORGANIZATION-ORGANIZATION,PRON,PROPN-PROPN-PROPN-ADP-PROPN-PROPN,nsubj,compound-compound-pobj-prep-compound-pobj,PRP,NNP-NNP-NNP-IN-NNP-NNP,7,1
2767,10476.0,34,led,6,13,9,-4,12,24,-7,3,Coastal Conservation League,Charleston-based,ORGANIZATION-ORGANIZATION-ORGANIZATION,CITY,PROPN-PROPN-PROPN,ADJ,compound-compound-oprd,amod,NNP-NNP-NNP,JJ,2,1
2768,12220.0,32,led,4,11,7,-4,10,24,-7,3,Coastal Conservation League,Charleston-based,ORGANIZATION-ORGANIZATION-ORGANIZATION,CITY,PROPN-PROPN-PROPN,ADJ,compound-compound-oprd,amod,NNP-NNP-NNP,JJ,4,1
2769,10480.0,32,said,13,20,22,2,19,9,-7,9,Tribeca,Robert De Niro,ORGANIZATION,PERSON-PERSON-PERSON,PROPN,PROPN-PROPN-PROPN,dobj,compound-compound-pobj,NNP,NNP-NNP-NNP,2,1
2770,10501.0,21,KAMPALA,0,8,11,3,7,9,-8,11,It,1996,ORGANIZATION,DATE,PRON,NUM,nsubj,pobj,PRP,CD,1,1
2771,10509.0,39,was,1,1,7,6,0,31,0,6,He,Ilan Ramon,PERSON,PERSON-PERSON,PRON,PROPN-PROPN,nsubj,compound-pobj,PRP,NNP-NNP,3,1
2772,10511.0,42,vowed,33,8,1,-7,7,40,25,-32,Charles Ble Goude,Youth minister,PERSON-PERSON-PERSON,TITLE-TITLE,PROPN-PROPN-PROPN,NOUN-NOUN,compound-compound-appos,compound-nsubj,NNP-NNP-NNP,NN-NN,2,1
2773,10517.0,43,said,26,14,1,-13,13,41,12,-25,Koch Foods Inc.,U.S.,ORGANIZATION-ORGANIZATION-ORGANIZATION,COUNTRY,PROPN-PROPN-PROPN,PROPN,compound-compound-poss,nmod,NNP-NNP-NNP,NNP,6,1
2774,10526.0,20,indicted,3,1,18,17,0,1,2,15,Graham,murder,PERSON,CRIMINAL_CHARGE,PROPN,NOUN,nsubjpass,compound,NNP,NN,4,1
2775,10537.0,42,said,28,37,30,-7,36,11,-9,2,American Association of University Women,Michele Wetherald,ORGANIZATION-ORGANIZATION-ORGANIZATION-ORGANIZATION-ORGANIZATION,PERSON-PERSON,PROPN-PROPN-ADP-PROPN-PROPN,PROPN-PROPN,compound-pobj-prep-compound-pobj,compound-nsubj,NNP-NNP-IN-NNP-NNPS,NNP-NNP,5,1
2776,10545.0,29,was,1,17,19,2,16,9,-16,18,his,professor,PERSON,TITLE,DET,NOUN,poss,pobj,PRP$,NN,3,1
2777,10548.0,38,said,18,10,26,16,9,11,8,8,NTSO,his,ORGANIZATION,PERSON,PROPN,DET,poss,poss,NNP,PRP$,9,1
2778,10555.0,48,named,34,40,3,-37,39,44,-6,-31,Menil Collection,Bernice Berend Rose,ORGANIZATION-ORGANIZATION,PERSON-PERSON-PERSON,PROPN-PROPN,PROPN-PROPN-PROPN,compound-poss,compound-compound-nsubjpass,NNP-NNP,NNP-NNP-NNP,6,1
2779,10556.0,42,planning,28,18,4,-14,17,37,10,-24,Chen Tao,Chinese,PERSON-PERSON,NATIONALITY,PROPN-PROPN,ADJ,compound-conj,amod,NNP-NNP,JJ,2,1
2780,10564.0,36,charges,2,16,33,17,15,2,-14,31,AFP,Western Regional Bureau,ORGANIZATION,ORGANIZATION-ORGANIZATION-ORGANIZATION,PROPN,PROPN-PROPN-PROPN,compound,compound-compound-pobj,NNP,NNP-NNP-NNP,-1,1
2781,10566.0,42,convicted,2,9,19,10,8,22,-7,17,Mark Fisher,Andover,PERSON-PERSON,CITY,PROPN-PROPN,PROPN,compound-pobj,pobj,NNP-NNP,NNP,4,1
2782,10569.0,45,quoted,5,1,3,2,0,41,4,-2,Knox,23,PERSON,NUMBER,PROPN,NUM,nsubjpass,appos,NNP,CD,3,1
2783,10576.0,21,arrived,11,4,8,4,3,12,7,-3,woman,Curt Knox,PERSON,PERSON-PERSON,NOUN,PROPN-PROPN,poss,compound-appos,NN,NNP-NNP,3,1
2784,10578.0,36,said,23,29,25,-4,28,10,-6,2,NTSO,Hank Hei,ORGANIZATION,PERSON-PERSON,PROPN,PROPN-PROPN,compound,compound-nsubj,NNP,NNP-NNP,3,1
2785,10581.0,30,is,16,1,15,14,0,14,15,-1,Bamba,Vienna,PERSON,STATE_OR_PROVINCE,PROPN,PROPN,nsubj,pobj,NNP,NNP,3,1
2786,10588.0,28,accused,3,1,13,12,0,14,2,10,Wen,"sister-in-law , Xie",PERSON,PERSON-PERSON-PERSON,PROPN,NOUN-PUNCT-PROPN,nsubjpass,pobj-punct-compound,NNP,"NN-,-NNP",8,1
2787,10589.0,26,delivered,3,19,13,-6,18,12,-16,10,Chen Tao,Huang Daiqiang,PERSON-PERSON,PERSON-PERSON,PROPN-PROPN,PROPN-PROPN,compound-conj,compound-appos,NNP-NNP,NNP-NNP,2,1
2788,10601.0,30,said,17,27,19,-8,26,10,-10,2,National Energy Administration,Qian Zhimin,ORGANIZATION-ORGANIZATION-ORGANIZATION,PERSON-PERSON,PROPN-PROPN-PROPN,PROPN-PROPN,compound-compound-pobj,compound-nsubj,NNP-NNP-NNP,NNP-NNP,4,1
2789,10604.0,29,was,1,17,24,7,16,4,-16,23,his,University of California,PERSON,ORGANIZATION-ORGANIZATION-ORGANIZATION,DET,PROPN-ADP-PROPN,poss,pobj-prep-pobj,PRP$,NNP-IN-NNP,5,1
2790,10627.0,24,is,7,10,15,5,9,8,-3,8,Menil,1987,ORGANIZATION,DATE,ADJ,NUM,compound,nummod,JJ,CD,2,1
2791,10634.0,85,Ld-Writethru,2,35,28,-7,34,56,-33,26,of the National,-RRB- --,ORGANIZATION-ORGANIZATION-ORGANIZATION,PERSON-PERSON,ADP-DET-PROPN,PROPN-PUNCT,prep-det-compound,nsubjpass-punct,IN-DT-NNP,NNP-:,-1,1
2792,10636.0,11,Congress,1,1,11,10,0,-1,0,10,National Congress of American Indians,http://tinyurl.com/krs986,ORGANIZATION-ORGANIZATION-ORGANIZATION-ORGANIZATION-ORGANIZATION,URL,PROPN-PROPN-ADP-PROPN-PROPN,PUNCT,compound-ROOT-prep-compound-poss,intj,NNP-NNP-IN-NNP-NNPS,.,-1,1
2793,10638.0,16,said,14,1,7,6,0,8,13,-7,Sandy Herold,a ruptured aortic aneurysm,PERSON-PERSON,CAUSE_OF_DEATH-CAUSE_OF_DEATH-CAUSE_OF_DEATH-CAUSE_OF_DEATH,PROPN-PROPN,DET-ADJ-ADJ-NOUN,compound-nsubj,det-amod-amod-pobj,NNP-NNP,DT-JJ-JJ-NNS,4,1
2794,10647.0,19,said,5,1,18,17,0,0,4,13,NDA,Westinghouse,ORGANIZATION,ORGANIZATION,PROPN,PROPN,nmod,pobj,NNP,NNP,5,1
2795,10652.0,40,CHIMP-SLAY-AFTERMATH,0,27,30,3,26,9,-27,30,Sandra Herold,71,PERSON-PERSON,NUMBER,PROPN-PROPN,NUM,compound-pobj,appos,NNP-NNP,CD,3,1
2796,10655.0,38,said,24,10,1,-9,9,36,14,-23,Corporate Library,Beth M. Young,ORGANIZATION-ORGANIZATION,PERSON-PERSON-PERSON,PROPN-PROPN,PROPN-PROPN-PROPN,compound-pobj,compound-compound-nsubj,NNP-NNP,NNP-NNP-NNP,4,1
2797,10660.0,54,TURKEY-VENDOR,0,12,31,19,11,22,-12,31,Greenberg Smoked Turkey,200,ORGANIZATION-ORGANIZATION-ORGANIZATION,NUMBER,PROPN-PROPN-PROPN,NUM,compound-compound-dobj,nummod,NNP-NNP-NNP,CD,7,1
2798,10662.0,42,said,40,29,26,-3,28,15,11,-14,her,Britain,PERSON,COUNTRY,DET,PROPN,poss,pobj,PRP$,NNP,3,1
2799,10673.0,46,go,11,18,22,4,17,23,-7,11,ALICO,Federal Reserve Bank of New York,ORGANIZATION,ORGANIZATION-ORGANIZATION-ORGANIZATION-ORGANIZATION-ORGANIZATION-ORGANIZATION,PROPN,PROPN-PROPN-PROPN-ADP-PROPN-PROPN,pobj,compound-compound-pobj-prep-compound-pobj,NNP,NNP-NNP-NNP-IN-NNP-NNP,3,1
2800,10682.0,41,came,2,25,39,14,24,1,-23,37,she,Wounded Knee,PERSON,LOCATION-LOCATION,PRON,PROPN-PROPN,nsubj,compound-pobj,PRP,NNP-NNP,5,1
2801,10702.0,13,watch,8,10,13,3,9,-1,-2,5,Loose Change,www.loosechange911.com,ORGANIZATION-ORGANIZATION,URL,PROPN-PROPN,NOUN,compound-dobj,pobj,NNP-NNP,NN,-1,1
2802,10703.0,30,insisted,20,1,16,15,0,13,19,-4,Silsby,Baptist,PERSON,RELIGION,PROPN,PROPN,nsubj,amod,NNP,NNP,4,1
2803,10725.0,8,festival,3,2,7,5,1,0,1,4,NTSO,Oct. 6,ORGANIZATION,DATE-DATE,PROPN,PROPN-NUM,compound,npadvmod-nummod,NNP,NNP-CD,4,1
2804,10727.0,31,said,6,8,28,20,7,2,-2,22,Vagni,62-year,PERSON,NUMBER,PROPN,ADJ,nsubj,compound,NNP,JJ,7,1
2805,10730.0,38,working,1,12,18,6,11,19,-11,17,National Energy Administration,Zhang,ORGANIZATION-ORGANIZATION-ORGANIZATION,PERSON,PROPN-PROPN-PROPN,PROPN,compound-compound-nsubj,pobj,NNP-NNP-NNP,NNP,7,1
2806,10731.0,42,born,4,29,9,-20,28,32,-25,5,Albert Lange,Ill.,PERSON-PERSON,STATE_OR_PROVINCE,PROPN-PROPN,PROPN,compound-conj,appos,NNP-NNP,NNP,5,1
2807,10750.0,34,shares,1,9,18,9,8,15,-8,17,his,Los Angeles,PERSON,CITY-CITY,DET,PROPN-PROPN,poss,compound-pobj,PRP$,NNP-NNP,3,1
2808,12629.0,39,recalls,1,9,20,11,8,18,-8,19,his,Los Angeles,PERSON,CITY-CITY,DET,PROPN-PROPN,poss,compound-pobj,PRP$,NNP-NNP,5,1
2809,10761.0,59,expected,6,48,40,-8,47,18,-42,34,National Development and Reform Commission,Zhang Ping,ORGANIZATION-ORGANIZATION-ORGANIZATION-ORGANIZATION-ORGANIZATION,PERSON-PERSON,PROPN-PROPN-CCONJ-PROPN-PROPN,PROPN-PROPN,nmod-nmod-cc-conj-pobj,compound-npadvmod,NNP-NNP-CC-NNP-NNP,NNP-NNP,10,1
2810,10768.0,37,demonstrated,2,35,34,-1,34,2,-33,32,John Graham,artist,PERSON-PERSON,TITLE,PROPN-PROPN,NOUN,compound-appos,dobj,NNP-NNP,NN,1,1
2811,10774.0,28,returned,12,6,5,-1,5,22,6,-7,Ruben van Assouw,9-year-old,PERSON-PERSON-PERSON,DURATION,PROPN-PROPN-PROPN,NUM,compound-compound-appos,compound,NNP-NNP-NNP,CD,1,1
2812,10783.0,30,received,13,10,6,-4,9,23,3,-7,Arlo Looking Cloud,killing,PERSON-PERSON-PERSON,CRIMINAL_CHARGE,PROPN-PROPN-PROPN,VERB,compound-compound-appos,pcomp,NNP-NNP-NNP,VBG,2,1
2813,10792.0,41,occupying,11,5,8,3,4,32,6,-3,New Fabris,central-eastern Chatellerault,ORGANIZATION-ORGANIZATION,COUNTRY-COUNTRY,PROPN-PROPN,ADJ-PROPN,compound-pobj,amod-pobj,NNP-NNP,JJ-NNP,6,1
2814,10801.0,47,said,8,10,5,-5,9,41,-2,-3,her,33-year-old,PERSON,DURATION,DET,NUM,poss,appos,PRP$,CD,3,1
2815,10803.0,27,named,11,1,5,4,0,21,10,-6,Pauliina Miettinen,defender,PERSON-PERSON,TITLE,PROPN-PROPN,NOUN,compound-nsubjpass,appos,NNP-NNP,NN,2,1
2816,10811.0,35,infused,13,8,11,3,7,23,5,-2,Menil Collection,1981,ORGANIZATION-ORGANIZATION,DATE,PROPN-PROPN,NUM,compound-pobj,pobj,NNP-NNP,CD,5,1
2817,10828.0,24,estimated,9,1,4,3,0,19,8,-5,ShopperTrak,independent,ORGANIZATION,RELIGION,PROPN,ADJ,nsubj,amod,NNP,JJ,2,1
2818,10849.0,18,sentenced,4,3,2,-1,2,15,1,-2,woman,Seattle,PERSON,CITY,NOUN,PROPN,nsubjpass,compound,NN,NNP,2,1
2819,10866.0,36,include,1,3,35,32,2,0,-2,34,his,Paul,PERSON,PERSON,DET,PROPN,poss,conj,PRP$,NNP,2,1
2820,10872.0,42,met,11,11,27,16,10,14,0,16,Lange,Princeton,PERSON,ORGANIZATION,PROPN,PROPN,nsubj,dobj,NNP,NNP,4,1
2821,10877.0,40,moved,5,5,24,19,4,15,0,19,he,printer,PERSON,TITLE,PRON,NOUN,nsubj,pobj,PRP,NN,1,1
2822,10880.0,32,released,24,1,9,8,0,22,23,-15,Eugenio Vagni,ICRC,PERSON-PERSON,ORGANIZATION,PROPN-PROPN,PROPN,compound-nsubjpass,pobj,NNP-NNP,NNP,2,1
2823,14629.0,54,MANILA,0,27,19,-8,26,34,-27,19,Eugenio Vagni,ICRC,PERSON-PERSON,ORGANIZATION,PROPN-PROPN,PROPN,compound-conj,compound,NNP-NNP,NNP,-1,1
2824,10893.0,4,was,1,1,3,2,0,0,0,2,She,72,PERSON,NUMBER,PRON,NUM,nsubj,attr,PRP,CD,1,1
2825,10894.0,40,nominated,21,8,4,-4,7,35,13,-17,Mark Fisher,executive,PERSON-PERSON,TITLE,PROPN-PROPN,ADJ,compound-nsubj,compound,NNP-NNP,JJ,2,1
2826,11066.0,35,announced,2,17,16,-1,16,18,-15,14,Mark Fisher,executive,PERSON-PERSON,TITLE,PROPN-PROPN,NOUN,compound-ROOT,compound,NNP-NNP,NN,1,1
2827,11092.0,34,said,29,14,10,-4,13,23,15,-19,Mark Fisher,executive,PERSON-PERSON,TITLE,PROPN-PROPN,NOUN,compound-attr,pobj,NNP-NNP,NN,-1,1
2828,10913.0,27,said,25,5,14,9,4,12,20,-11,Andrew Lange,chairman,PERSON-PERSON,TITLE,PROPN-PROPN,NOUN,compound-nsubj,pobj,NNP-NNP,NN,5,1
2829,10922.0,36,stored,21,31,35,4,30,0,-10,14,NDA,BNG,ORGANIZATION,ORGANIZATION,PROPN,PROPN,pobj,pobj,NNP,NNP,5,1
2830,10927.0,22,says,2,1,6,5,0,15,1,4,Arline Kercher,Meredith,PERSON-PERSON,PERSON,PROPN-PROPN,PROPN,compound-nsubj,poss,NNP-NNP,NNP,6,1
2831,10942.0,33,said,15,10,17,7,9,15,5,2,Urban League,he,ORGANIZATION-ORGANIZATION,PERSON,PROPN-PROPN,PRON,compound-dobj,nsubj,NNP-NNP,PRP,5,1
2832,15325.0,36,said,5,1,7,6,0,28,4,2,Urban League,he,ORGANIZATION-ORGANIZATION,PERSON,PROPN-PROPN,PRON,compound-compound,nsubj,NNP-NNP,PRP,4,1
2833,10948.0,43,gave,14,5,11,6,4,31,9,-3,Hollister Inc,85,ORGANIZATION-ORGANIZATION,NUMBER,PROPN-PROPN,NUM,compound-nsubj,nummod,NNP-NNP,CD,4,1
2834,10953.0,42,said,14,11,16,5,10,25,3,2,Jupp,her,PERSON,PERSON,PROPN,DET,poss,poss,NNP,PRP$,5,1
2835,13451.0,42,said,14,11,16,5,10,25,3,2,Jupp,her,PERSON,PERSON,PROPN,PRON,poss,dobj,NNP,PRP,5,1
2836,14643.0,42,said,14,11,16,5,10,25,3,2,Jupp,her,PERSON,PERSON,PROPN,PRON,poss,dobj,NNP,PRP,5,1
2837,10958.0,38,said,35,2,1,-1,1,36,33,-34,Andrew E. Lange,Physicist,PERSON-PERSON-PERSON,TITLE,PROPN-PROPN-PROPN,PROPN,compound-compound-nsubj,compound,NNP-NNP-NNP,NNP,2,1
2838,10965.0,40,began,2,28,17,-11,27,22,-26,15,he,Dominican Republic,PERSON,COUNTRY-COUNTRY,PRON,PROPN-PROPN,nsubjpass,compound-pobj,PRP,NNP-NNP,9,1
2839,10980.0,40,conveys,3,30,17,-13,29,22,-27,14,Alessi,she,PERSON,PERSON,PROPN,PRON,compound,nsubj,NNP,PRP,2,1
2840,10983.0,25,told,21,8,13,5,7,11,13,-8,her,foster parent,PERSON,TITLE-TITLE,DET,ADJ-NOUN,poss,amod-pobj,PRP$,JJ-NN,4,1
2841,10989.0,25,expected,15,12,9,-3,11,15,3,-6,Annie Mae Aquash,Indian,PERSON-PERSON-PERSON,NATIONALITY,PROPN-PROPN-PROPN,PROPN,compound-compound-pobj,compound,NNP-NNP-NNP,NNP,3,1
2842,10992.0,35,told,30,24,28,4,23,6,6,-2,Knox,Chris Mellas,PERSON,PERSON-PERSON,PROPN,PROPN-PROPN,poss,compound-appos,NNP,NNP-NNP,3,1
2843,10998.0,10,dead,7,6,10,4,5,-1,1,3,Andrew Lange,52,PERSON-PERSON,NUMBER,PROPN-PROPN,NUM,compound-nsubj,pobj,NNP-NNP,CD,-1,1
2844,10999.0,45,told,16,26,43,17,25,1,-10,27,Pacific Asia Travel Association,Jusuf Kalla,ORGANIZATION-ORGANIZATION-ORGANIZATION-ORGANIZATION,PERSON-PERSON,PROPN-PROPN-PROPN-PROPN,PROPN-PROPN,compound-compound-compound-pobj,compound-pobj,NNP-NNP-NNP-NNP,NNP-NNP,-1,1
2845,11002.0,34,said,20,29,33,4,28,0,-9,13,Pacific-Asia Travel Association,Bangkok,ORGANIZATION-ORGANIZATION-ORGANIZATION,CITY,PROPN-PROPN-PROPN,PROPN,compound-compound-pobj,pobj,NNP-NNP-NNP,NNP,1,1
2846,11012.0,34,says,16,15,13,-2,14,20,1,-3,TPI,Americas,ORGANIZATION,LOCATION,PROPN,PROPN,appos,conj,NNP,NNPS,7,1
2847,11016.0,45,told,35,42,39,-3,41,5,-7,4,PATA,Bangkok,ORGANIZATION,CITY,PROPN,PROPN,nsubjpass,pobj,NNP,NNP,2,1
2848,11017.0,43,lived,3,2,9,7,1,33,1,6,Nir Rosen,Iraq,PERSON-PERSON,COUNTRY,PROPN-PROPN,PROPN,compound-nsubj,pobj,NNP-NNP,NNP,2,1
2849,11037.0,41,sentenced,24,1,4,3,0,36,23,-20,Wen Qiang,54,PERSON-PERSON,NUMBER,PROPN-PROPN,NUM,compound-nsubjpass,appos,NNP-NNP,CD,1,1
2850,11044.0,35,include,9,27,16,-11,26,18,-18,7,Mailer,Danielle,PERSON,PERSON,PROPN,PROPN,conj,conj,NNP,NNP,4,1
2851,11046.0,39,said,3,13,16,3,12,22,-10,13,Countrywide,Eric P Sieracki,ORGANIZATION,PERSON-PERSON-PERSON,PROPN,PROPN-PROPN-PROPN,pobj,compound-compound-conj,NNP,NNP-NNP-NNP,3,1
2852,11047.0,26,ruled,8,14,17,3,13,8,-6,9,Joseph Cerniglia,suicide,PERSON-PERSON,CAUSE_OF_DEATH,PROPN-PROPN,NOUN,compound-pobj,dobj,NNP-NNP,NN,3,1
2853,11061.0,39,was,1,1,31,30,0,7,0,30,She,Jewish,PERSON,RELIGION,PRON,ADJ,nsubj,advcl,PRP,JJ,4,1
2854,11113.0,30,said,10,17,12,-5,16,17,-7,2,William Kunstler,Kunstler,PERSON-PERSON,PERSON,PROPN-PROPN,PROPN,compound-pobj,nsubj,NNP-NNP,NNP,4,1
2855,11133.0,42,com,0,13,36,23,12,5,-13,36,American Association of University Women,United States,ORGANIZATION-ORGANIZATION-ORGANIZATION-ORGANIZATION-ORGANIZATION,COUNTRY-COUNTRY,PROPN-PROPN-ADP-PROPN-PROPN,PROPN-PROPN,compound-nsubj-prep-compound-compound,compound-pobj,NNP-NNP-IN-NNP-NNP,NNP-NNP,8,1
2856,11170.0,25,occurred,2,16,21,5,15,3,-14,19,Morita Chemical Industries,Osaka,ORGANIZATION-ORGANIZATION-ORGANIZATION,CITY,PROPN-PROPN-PROPN,PROPN,compound-compound-compound,poss,NNP-NNP-NNP,NNP,6,1
2857,11173.0,27,showed,11,6,7,1,5,19,5,-4,his,4-year-old,PERSON,DURATION,DET,NUM,poss,amod,PRP$,CD,2,1
2858,11174.0,19,murdered,15,1,18,17,0,0,14,3,Anna Mae Pictou Aquash,1975,PERSON-PERSON-PERSON-PERSON,DATE,PROPN-PROPN-PROPN-PROPN,NUM,compound-compound-compound-nsubjpass,pobj,NNP-NNP-NNP-NNP,CD,3,1
2859,11187.0,41,said,25,1,21,20,0,19,24,-4,National Urban League,U.S.,ORGANIZATION-ORGANIZATION-ORGANIZATION,COUNTRY,PROPN-PROPN-PROPN,PROPN,compound-compound-compound,compound,NNP-NNP-NNP,NNP,5,1
2860,11193.0,30,said,5,7,23,16,6,6,-2,18,Ruben,Patrick,PERSON,PERSON,PROPN,PROPN,nsubj,appos,NNP,NNP,5,1
2861,11196.0,27,see,1,7,27,20,6,-1,-6,26,Loose Change,http://video.google.com/videoplay?do...arch&plindex=4,ORGANIZATION-ORGANIZATION,URL,PROPN-PROPN,X,compound-dobj,pobj,NNP-NNP,ADD,4,1
2862,11212.0,37,made,32,14,21,7,13,15,18,-11,Daniels,four,PERSON,NUMBER,PROPN,NUM,nsubj,nummod,NNP,CD,5,1
2863,11213.0,41,told,38,35,27,-8,34,13,3,-11,National Energy Administration,Huang Li,ORGANIZATION-ORGANIZATION-ORGANIZATION,PERSON-PERSON,PROPN-PROPN-PROPN,PROPN-PROPN,compound-compound-pobj,compound-nsubj,NNP-NNP-NNP,NNP-NNP,4,1
2864,11225.0,33,said,9,1,5,4,0,27,8,-4,Kip Hollister,executive,PERSON-PERSON,TITLE,PROPN-PROPN,NOUN,compound-nsubj,appos,NNP-NNP,NN,2,1
2865,11230.0,23,proposes,3,20,11,-9,19,11,-17,8,Central American Parliament,Zelaya,ORGANIZATION-ORGANIZATION-ORGANIZATION,ORGANIZATION,ADJ-PROPN-PROPN,PROPN,compound-compound-pobj,nsubj,JJ-NNP-NNP,NNP,6,1
2866,11235.0,47,said,12,15,11,-4,14,35,-3,-1,Lange,Chicago,PERSON,STATE_OR_PROVINCE,PROPN,PROPN,pobj,pobj,NNP,NNP,2,1
2867,11237.0,41,said,7,1,39,38,0,1,6,32,Jamie Leigh Jones,US,PERSON-PERSON-PERSON,COUNTRY,PROPN-PROPN-PROPN,PROPN,compound-compound-nsubj,compound,NNP-NNP-NNP,NNP,10,1
2868,11240.0,26,received,14,19,1,-18,18,24,-5,-13,OANA,Hilmi Bengi,ORGANIZATION,PERSON-PERSON,PROPN,PROPN-PROPN,pobj,compound-nsubj,NNP,NNP-NNP,2,1
2869,11241.0,35,issue,2,14,10,-4,13,24,-12,8,Coastal Conservation League,Patrick Moore,ORGANIZATION-ORGANIZATION-ORGANIZATION,PERSON-PERSON,PROPN-PROPN-PROPN,PROPN-PROPN,compound-compound-poss,compound-nsubj,NNP-NNP-NNP,NNP-NNP,3,1
2870,11245.0,31,tells,14,9,1,-8,8,29,5,-13,National Congress of American Indians,Jacqueline L. Pata,ORGANIZATION-ORGANIZATION-ORGANIZATION-ORGANIZATION-ORGANIZATION,PERSON-PERSON-PERSON,PROPN-PROPN-ADP-PROPN-PROPN,PROPN-PROPN-PROPN,compound-pobj-prep-compound-pobj,compound-compound-nsubj,NNP-NNP-IN-NNP-NNPS,NNP-NNP-NNP,4,1
2871,11301.0,30,died,4,1,10,9,0,19,3,6,Vladimir Ladyzhenskiy,shock,PERSON-PERSON,CAUSE_OF_DEATH,PROPN-PROPN,NOUN,compound-nsubj,dobj,NNP-NNP,NN,3,1
2872,11325.0,55,talked,12,20,38,18,19,16,-8,26,PATA,USA,ORGANIZATION,COUNTRY,PROPN,PROPN,poss,conj,NNP,NNP,8,1
2873,11337.0,24,said,7,4,9,5,3,14,3,2,ShopperTrak,he,ORGANIZATION,PERSON,PROPN,PRON,poss,nsubj,NNP,PRP,4,1
2874,11338.0,22,became,11,4,3,-1,3,18,7,-8,Vladimir Ladyzhenskiy,competitor,PERSON-PERSON,TITLE,PROPN-PROPN,NOUN,compound-appos,nsubj,NNP-NNP,NN,1,1
2875,11342.0,28,said,10,7,1,-6,6,26,3,-9,National Restaurant Association,Michael Gibbons,ORGANIZATION-ORGANIZATION-ORGANIZATION,PERSON-PERSON,PROPN-PROPN-PROPN,PROPN-PROPN,compound-compound-pobj,compound-nsubj,NNP-NNP-NNP,NNP-NNP,4,1
2876,11363.0,41,said,5,7,11,4,6,29,-2,6,Ruben,Tilburg,PERSON,CITY,PROPN,PROPN,nsubj,pobj,NNP,NNP,1,1
2877,12461.0,21,said,19,6,16,10,5,4,13,-3,Ruben,Tilburg,PERSON,CITY,PROPN,PROPN,attr,pobj,NNP,NNP,4,1
2878,13460.0,24,reported,5,7,20,13,6,3,-2,15,Ruben,Tilburg,PERSON,CITY,PROPN,PROPN,nsubjpass,pobj,NNP,NNP,2,1
2879,11390.0,27,died,5,1,13,12,0,13,4,8,Assaf Ramon,jet he was flying crashed,PERSON-PERSON,CAUSE_OF_DEATH-CAUSE_OF_DEATH-CAUSE_OF_DEATH-CAUSE_OF_DEATH-CAUSE_OF_DEATH,PROPN-PROPN,NOUN-PRON-VERB-VERB-VERB,compound-nsubj,nsubj-nsubj-aux-relcl-advcl,NNP-NNP,NN-PRP-VBD-VBG-VBD,7,1
2880,11395.0,18,got,3,3,2,-1,2,15,0,-1,tourists,French,PERSON,NATIONALITY,NOUN,ADJ,nsubj,amod,NNS,JJ,1,1
2881,11406.0,24,shown,14,2,1,-1,1,22,12,-13,Mario Gonzalez,Attorney,PERSON-PERSON,TITLE,PROPN-PROPN,PROPN,compound-nsubjpass,compound,NNP-NNP,NNP,1,1
2882,11416.0,12,was,6,1,8,7,0,3,5,2,Assaf,15,PERSON,NUMBER,PROPN,NUM,nsubj,attr,NNP,CD,3,1
2883,11417.0,33,cast,12,17,20,3,16,12,-5,8,his,Ana Rita Puello,PERSON,PERSON-PERSON-PERSON,DET,PROPN-PROPN-PROPN,poss,compound-compound-appos,PRP$,NNP-NNP-NNP,2,1
2884,11430.0,49,spent,8,10,19,9,9,29,-2,11,his,Puerto Rico,PERSON,STATE_OR_PROVINCE-STATE_OR_PROVINCE,DET,PROPN-PROPN,poss,compound-conj,PRP$,NNP-NNP,5,1
2885,11437.0,31,comes,2,13,13,0,12,17,-11,11,Texas Petro Index,Texas Alliance of Energy Producers,ORGANIZATION-ORGANIZATION-ORGANIZATION,ORGANIZATION-ORGANIZATION-ORGANIZATION-ORGANIZATION-ORGANIZATION,PROPN-PROPN-PROPN,PROPN-PROPN-ADP-PROPN-PROPN,compound-compound-dobj,compound-pobj-prep-compound-pobj,NNP-NNP-NNP,NNP-NNP-IN-NNP-NNPS,0,1
2886,11441.0,55,Digest,3,35,43,8,34,11,-32,40,the National Energy Administration,Zhang Guobao,ORGANIZATION-ORGANIZATION-ORGANIZATION-ORGANIZATION,PERSON-PERSON,DET-PROPN-PROPN-PROPN,PROPN-PROPN,det-compound-compound-pobj,compound-nsubj,DT-NNP-NNP-NNP,NNP-NNP,5,1
2887,11444.0,20,treated,12,5,1,-4,4,18,7,-11,Ruben van Assouw,AMSTERDAM,PERSON-PERSON-PERSON,COUNTRY,PROPN-PROPN-PROPN,ADV,compound-compound-nsubjpass,nmod,NNP-NNP-NNP,RB,4,1
2888,11445.0,35,said,24,26,32,6,25,2,-2,8,Shah Abdul Aziz,member of Parliament,PERSON-PERSON-PERSON,TITLE-TITLE-TITLE,PROPN-PROPN-PROPN,NOUN-ADP-PROPN,compound-compound-nsubj,appos-prep-pobj,NNP-NNP-NNP,NN-IN-NNP,2,1
2889,11452.0,47,believed,14,7,1,-6,6,45,7,-13,Pacific Asia Travel Association,Gregory Duffell,ORGANIZATION-ORGANIZATION-ORGANIZATION-ORGANIZATION,PERSON-PERSON,PROPN-PROPN-PROPN-PROPN,PROPN-PROPN,compound-compound-compound-pobj,compound-nsubj,NNP-NNP-NNP-NNP,NNP-NNP,4,1
2890,11453.0,43,said,1,3,6,3,2,36,-2,5,Sodini,Scott Township,PERSON,CITY-CITY,PROPN,PROPN-PROPN,nsubj,compound-pobj,NNP,NNP-NNP,3,1
2891,11458.0,26,donated,13,10,19,9,9,6,3,6,China Charity Federation,Zhouqu,ORGANIZATION-ORGANIZATION-ORGANIZATION,LOCATION,PROPN-PROPN-PROPN,PROPN,compound-compound-pobj,pobj,NNP-NNP-NNP,NNP,8,1
2892,11470.0,35,named,2,8,22,14,7,12,-6,20,Assaf Ramon,Israeli,PERSON-PERSON,NATIONALITY,PROPN-PROPN,ADJ,compound-pobj,amod,NNP-NNP,JJ,2,1
2893,11473.0,25,wrote,2,12,10,-2,11,14,-10,8,Alan Gross,her,PERSON-PERSON,PERSON,PROPN-PROPN,DET,compound-appos,poss,NNP-NNP,PRP$,1,1
2894,11475.0,15,ordered,5,10,2,-8,9,12,-5,-3,TPIPL,Stock Exchange of Thailand,ORGANIZATION,ORGANIZATION-ORGANIZATION-ORGANIZATION-ORGANIZATION,PROPN,PROPN-PROPN-ADP-PROPN,compound,compound-nsubj-prep-pobj,NNP,NNP-NNP-IN-NNP,4,1
2895,11491.0,28,said,23,9,7,-2,8,20,14,-16,Alan Gross,U.S.,PERSON-PERSON,COUNTRY,PROPN-PROPN,PROPN,compound-dobj,compound,NNP-NNP,NNP,1,1
2896,13513.0,27,said,19,3,1,-2,2,25,16,-18,Alan Gross,U.S.,PERSON-PERSON,COUNTRY,PROPN-PROPN,PROPN,compound-nsubj,compound,NNP-NNP,NNP,1,1
2897,11498.0,55,upended,20,9,7,-2,8,47,11,-13,Charles Ble Goude,employment minister,PERSON-PERSON-PERSON,TITLE-TITLE,PROPN-PROPN-PROPN,NOUN-NOUN,compound-compound-npadvmod,conj-compound,NNP-NNP-NNP,NN-NN,5,1
2898,11509.0,36,Bank.,1,1,1,0,0,34,0,0,Countrywide Bank.,"Countrywide Financial Corporation , Inc.",ORGANIZATION-ORGANIZATION,ORGANIZATION-ORGANIZATION-ORGANIZATION-ORGANIZATION-ORGANIZATION,PROPN-PROPN,PROPN-PROPN-PROPN-PUNCT-PROPN,compound-ROOT,compound-compound-pobj-punct-subtok,NNP-NNP,"NNP-NNP-NNP-,-NNP",0,1
2899,11513.0,53,Goude,2,1,16,15,0,36,1,14,Charles Ble Goude,Cote d'Ivoire,PERSON-PERSON-PERSON,COUNTRY-COUNTRY,PROPN-PROPN-PROPN,PROPN-PROPN,compound-compound-ROOT,compound-poss,NNP-NNP-NNP,NNP-NNP,6,1
2900,11530.0,13,said,1,9,1,-8,8,11,-8,0,Samudio,Moreira,PERSON,PERSON,PROPN,PROPN,nsubjpass,nsubj,NNP,NNP,3,1
2901,11533.0,45,died,34,1,44,43,0,0,33,10,Norris Church,NY,PERSON-PERSON,CITY,PROPN-PROPN,PROPN,compound-compound,appos,NNP-NNP,NNP,7,1
2902,11549.0,30,arrested,2,1,8,7,0,21,1,6,He,Karak,PERSON,CITY,PRON,PROPN,nsubjpass,pobj,PRP,NNP,4,1
2903,11555.0,18,embraced,13,1,9,8,0,8,12,-4,Aquash,Debbie Maloney Pictou,PERSON,PERSON-PERSON-PERSON,PROPN,PROPN-PROPN-PROPN,poss,compound-compound-conj,NNP,NNP-NNP-NNP,5,1
2904,11558.0,42,born,4,1,29,28,0,12,3,25,Andrew E Lange,Albert Lange,PERSON-PERSON-PERSON,PERSON-PERSON,PROPN-PROPN-PROPN,PROPN-PROPN,compound-compound-nsubjpass,compound-conj,NNP-NNP-NNP,NNP-NNP,6,1
2905,11568.0,30,died,25,2,29,27,1,0,23,4,Frank Baldino Jr.,Philadelphia,PERSON-PERSON-PERSON,CITY,PROPN-PROPN-PROPN,PROPN,compound-compound-nsubj,pobj,NNP-NNP-NNP,NNP,3,1
2906,11588.0,41,survived,2,18,13,-5,17,27,-16,11,Carol Daniels,Calif.,PERSON-PERSON,STATE_OR_PROVINCE,PROPN-PROPN,PROPN,compound-appos,appos,NNP-NNP,NNP,3,1
2907,12532.0,41,survived,2,18,13,-5,17,27,-16,11,Carol Daniels,Calif.,PERSON-PERSON,STATE_OR_PROVINCE,PROPN-PROPN,PROPN,compound-appos,appos,NNP-NNP,NNP,3,1
2908,11616.0,37,said,12,24,8,-16,23,28,-12,-4,Abdul Aziz,Red Mosque -RRB- Action Committee,PERSON-PERSON,ORGANIZATION-ORGANIZATION-ORGANIZATION-ORGANIZATION-ORGANIZATION,PROPN-PROPN,PROPN-PROPN-PROPN-PROPN-PROPN,compound-dobj,compound-compound-compound-compound-pobj,NNP-NNP,NNP-NNP-NNP-NNP-NNP,5,1
2909,11622.0,22,found,5,3,18,15,2,3,2,13,Meredith Kercher,"Nov. 2 , 2007",PERSON-PERSON,DATE-DATE-DATE-DATE,PROPN-PROPN,PROPN-NUM-PUNCT-NUM,compound-nsubjpass,pobj-nummod-punct-nummod,NNP-NNP,"NNP-CD-,-CD",8,1
2910,11623.0,55,was,45,5,42,37,4,12,40,-3,GEORGE SODINI,American,PERSON-PERSON,NATIONALITY,PROPN-PROPN,ADJ,compound-appos,amod,NNP-NNP,JJ,5,1
2911,11638.0,35,survives,1,21,10,-11,20,24,-20,9,Lange,James Bailey,PERSON,PERSON-PERSON,PROPN,PROPN-PROPN,nsubj,compound-appos,NNP,NNP-NNP,1,1
2912,11650.0,27,wondered,20,6,9,3,5,17,14,-11,her,David,PERSON,PERSON,DET,PROPN,poss,appos,PRP$,NNP,1,1
2913,11656.0,26,found,3,19,16,-3,18,9,-16,13,Meredith Kercher,Italy,PERSON-PERSON,COUNTRY,PROPN-PROPN,PROPN,compound-nsubjpass,appos,NNP-NNP,NNP,3,1
2914,11664.0,29,begins,2,8,15,7,7,13,-6,13,Aquash,American Indian,PERSON,NATIONALITY-NATIONALITY,PROPN,PROPN-PROPN,poss,compound-compound,NNP,NNP-NNP,7,1
2915,11674.0,46,died,37,1,3,2,0,42,36,-34,Norris Church Mailer,Mailer,PERSON-PERSON-PERSON,PERSON,PROPN-PROPN-PROPN,PROPN,compound-compound-nsubj,dobj,NNP-NNP-NNP,NNP,3,1
2916,11677.0,25,said,21,19,9,-10,18,15,2,-12,Governor Rick Perry,United States,ORGANIZATION-ORGANIZATION-ORGANIZATION,COUNTRY-COUNTRY,PROPN-PROPN-PROPN,PROPN-PROPN,compound-compound-nsubj,compound-pobj,NNP-NNP-NNP,NNP-NNP,6,1
2917,11679.0,45,died,34,1,22,21,0,22,33,-12,Norris Church Mailer,model,PERSON-PERSON-PERSON,TITLE,PROPN-PROPN-PROPN,NOUN,compound-compound-nsubj,attr,NNP-NNP-NNP,NN,5,1
2918,11702.0,16,founded,4,3,7,4,2,8,1,3,Zirh,1995,ORGANIZATION,DATE,PROPN,NUM,nsubjpass,pobj,NNP,CD,3,1
2919,11705.0,40,is,8,1,6,5,0,33,7,-2,The Parlacen,"Guatemala City ,",ORGANIZATION-ORGANIZATION,CITY-CITY-CITY,DET-PROPN,PROPN-PROPN-PUNCT,det-nsubj,compound-pobj-punct,DT-NNP,"NNP-NNP-,",3,1
2920,11706.0,50,told,5,10,7,-3,9,42,-5,2,she,her,PERSON,PERSON,PRON,DET,nsubj,poss,PRP,PRP$,2,1
2921,11711.0,30,is,8,27,22,-5,26,7,-19,14,Countrywide Financial Corp.,Merrill Lynch,ORGANIZATION-ORGANIZATION-ORGANIZATION,ORGANIZATION-ORGANIZATION,PROPN-PROPN-PROPN,PROPN-PROPN,compound-compound-conj,compound-pobj,NNP-NNP-NNP,NNP-NNP,2,1
2922,11729.0,27,imprisoned,7,7,3,-4,6,23,0,-4,contractor,Agency for International Development,PERSON,ORGANIZATION-ORGANIZATION-ORGANIZATION-ORGANIZATION,NOUN,PROPN-ADP-PROPN-PROPN,pobj,nsubj-prep-compound-compound,NN,NNP-IN-NNP-NNP,2,1
2923,11734.0,24,said,12,14,19,5,13,4,-2,7,Sarah Kunstler,defense attorney,PERSON-PERSON,TITLE-TITLE,PROPN-PROPN,NOUN-NOUN,compound-nsubj,compound-appos,NNP-NNP,NN-NN,1,1
2924,11749.0,44,said,9,7,9,2,6,34,2,0,PATA,Beere,ORGANIZATION,PERSON,PROPN,PROPN,pobj,nsubj,NNP,NNP,1,1
2925,11751.0,29,shared,5,7,5,-2,6,23,-2,0,his,guard,PERSON,TITLE,DET,NOUN,poss,nsubj,PRP$,NN,2,1
2926,11763.0,38,formed,3,2,11,9,1,26,1,8,OANA,UNESCO,ORGANIZATION,ORGANIZATION,PROPN,PROPN,nsubjpass,pobj,NNP,NNP,3,1
2927,11787.0,29,confirmed,4,11,17,6,10,11,-7,13,George Sodini,Scott Township,PERSON-PERSON,CITY-CITY,PROPN-PROPN,PROPN-PROPN,compound-attr,compound-pobj,NNP-NNP,NNP-NNP,2,1
2928,11790.0,16,discovered,5,1,15,14,0,0,4,10,Daniels,Anadarko,PERSON,LOCATION,PROPN,PROPN,poss,pobj,NNP,NNP,4,1
2929,12105.0,35,CITY,1,10,34,24,9,0,-9,33,Daniels,Anadarko,PERSON,CITY,PROPN,PROPN,poss,pobj,NNP,NNP,5,1
2930,11816.0,18,described,2,1,14,13,0,3,1,12,Samudio,pornographic film actress,PERSON,TITLE-TITLE-TITLE,NOUN,ADJ-NOUN-NOUN,nsubjpass,amod-compound-conj,NN,JJ-NN-NN,6,1
2931,11839.0,46,raised,20,6,18,12,5,27,14,-2,Vagni,Jolo Island,PERSON,LOCATION-LOCATION,PROPN,PROPN-PROPN,pobj,compound-pobj,NNP,NNP-NNP,7,1
2932,11843.0,38,blamed,6,6,4,-2,5,33,0,-2,he,interrogator,PERSON,TITLE,PRON,NOUN,nsubj,pobj,PRP,NN,1,1
2933,11849.0,51,contended,7,29,49,20,28,1,-22,42,her,Haitian,PERSON,NATIONALITY,PRON,ADJ,dobj,amod,PRP,JJ,12,1
2934,11851.0,50,formed,1,3,30,27,2,19,-2,29,his,he,PERSON,PERSON,DET,PRON,poss,nsubj,PRP$,PRP,3,1
2935,11855.0,50,believe,18,33,41,8,32,8,-15,23,National Congress of American Indians,his,ORGANIZATION-ORGANIZATION-ORGANIZATION-ORGANIZATION-ORGANIZATION,PERSON,PROPN-PROPN-ADP-PROPN-PROPN,DET,compound-pobj-prep-compound-pobj,poss,NNP-NNP-IN-NNP-NNPS,PRP$,8,1
2936,11860.0,24,came,16,1,12,11,0,11,15,-4,John Graham,Paramus,PERSON-PERSON,CITY,PROPN-PROPN,PROPN,compound-nsubj,pobj,NNP-NNP,NNP,4,1
2937,11862.0,15,told,1,3,7,4,2,7,-2,6,her,He,PERSON,PERSON,DET,PRON,poss,nsubj,PRP$,PRP,3,1
2938,11868.0,26,was,14,14,17,3,13,8,0,3,she,art teacher,PERSON,TITLE-TITLE,PRON,NOUN-NOUN,nsubj,compound-attr,PRP,NN-NN,1,1
2939,11879.0,15,formed,2,7,9,2,6,5,-5,7,Countrywide,Angelo R. Mozilo,ORGANIZATION,PERSON-PERSON-PERSON,PROPN,PROPN-PROPN-PROPN,compound,compound-compound-pobj,NNP,NNP-NNP-NNP,2,1
2940,11884.0,43,said,34,34,33,-1,33,9,0,-1,woman,63-year-old,PERSON,NUMBER,NOUN,NUM,nsubj,amod,NN,CD,2,1
2941,11888.0,28,say,1,18,19,1,17,8,-17,18,his,Finnish,PERSON,NATIONALITY,DET,ADJ,poss,amod,PRP$,JJ,1,1
2942,11894.0,31,became,4,4,8,4,3,22,0,4,he,research scientist,PERSON,TITLE-TITLE,PRON,NOUN-NOUN,nsubj,compound-attr,PRP,NN-NN,1,1
2943,11896.0,26,profiled,11,24,19,-5,23,6,-13,8,Sarah Kunstler,his,PERSON-PERSON,PERSON,PROPN-PROPN,DET,compound-conj,poss,NNP-NNP,PRP$,5,1
2944,11904.0,30,coaches,1,1,3,2,0,26,0,2,Miettinen,Helsinki,PERSON,ORGANIZATION,PROPN,PROPN,nsubj,dobj,NNP,NNP,3,1
2945,11907.0,12,maintained,5,1,3,2,0,8,4,-2,Graham,55,PERSON,NUMBER,PROPN,NUM,nsubj,appos,NNP,CD,3,1
2946,11919.0,34,accused,14,26,7,-19,25,26,-12,-7,Tamaihia,Debra Oliver,PERSON,PERSON-PERSON,PROPN,PROPN-PROPN,poss,compound-nsubj,NNP,NNP-NNP,8,1
2947,11920.0,30,were,12,2,28,26,1,1,10,16,Gay Men 's Health Crisis,Marjorie Hill,ORGANIZATION-ORGANIZATION-ORGANIZATION-ORGANIZATION-ORGANIZATION,PERSON-PERSON,PROPN-PROPN-PART-PROPN-PROPN,PROPN-PROPN,compound-poss-case-compound-pobj,compound-appos,NNP-NNPS-POS-NNP-NNP,NNP-NNP,6,1
2948,11930.0,30,made,7,7,3,-4,6,26,0,-4,Daniels,Oklahoma,PERSON,CITY,PROPN,PROPN,appos,npadvmod,NNP,NNP,3,1
2949,11953.0,37,found,2,14,11,-3,13,25,-12,9,Annie Mae Aquash,the 1970s,PERSON-PERSON-PERSON,DATE-DATE,PROPN-PROPN-PROPN,DET-NOUN,compound-compound-pobj,det-pobj,NNP-NNP-NNP,DT-NNS,3,1
2950,11967.0,20,filed,8,18,15,-3,17,4,-10,7,George Sodini,executor,PERSON-PERSON,TITLE,PROPN-PROPN,NOUN,compound-pobj,conj,NNP-NNP,NN,3,1
2951,11992.0,41,survived,2,18,21,3,17,19,-16,19,Carol Daniels,Morro Bay,PERSON-PERSON,CITY-CITY,PROPN-PROPN,PROPN-PROPN,compound-appos,compound-pobj,NNP-NNP,NNP-NNP,2,1
2952,11994.0,24,approached,8,1,6,5,0,17,7,-2,She,Roger Spooner,PERSON,PERSON-PERSON,PRON,PROPN-PROPN,nsubj,compound-appos,PRP,NNP-NNP,3,1
2953,12006.0,33,detained,2,15,18,3,14,14,-13,16,his,Xie Caiping,PERSON,PERSON-PERSON,DET,PROPN-PROPN,poss,compound-npadvmod,PRP$,NNP-NNP,2,1
2954,14168.0,28,accused,3,12,15,3,11,12,-9,12,his,Xie Caiping,PERSON,PERSON-PERSON,DET,PROPN-PROPN,poss,compound-npadvmod,PRP$,NNP-NNP,2,1
2955,12017.0,61,fallen,3,59,55,-4,58,5,-56,52,NRA,National Restaurant Association,ORGANIZATION,ORGANIZATION-ORGANIZATION-ORGANIZATION,PROPN,PROPN-PROPN-PROPN,compound,compound-compound-pobj,NNP,NNP-NNP-NNP,8,1
2956,12030.0,19,sent,12,1,6,5,0,12,11,-6,Gross,Jewish,PERSON,RELIGION,PROPN,ADJ,nsubjpass,acomp,NNP,JJ,3,1
2957,12033.0,38,focuses,13,21,19,-2,20,18,-8,6,he,Detroit News,PERSON,ORGANIZATION-ORGANIZATION,PRON,PROPN-PROPN,nsubj,compound-pobj,PRP,NNP-NNP,6,1
2958,12060.0,41,committed,7,6,17,11,5,23,1,10,NDA,Thorp,ORGANIZATION,PERSON,PROPN,PROPN,nsubj,conj,NNP,NNP,5,1
2959,12061.0,16,said,1,14,6,-8,13,9,-13,5,her,Catholic,PERSON,RELIGION,DET,ADJ,poss,acomp,PRP$,JJ,3,1
2960,12065.0,27,was,12,18,1,-17,17,25,-6,-11,National Urban League,Stephanie J Jones,ORGANIZATION-ORGANIZATION-ORGANIZATION,PERSON-PERSON-PERSON,PROPN-PROPN-PROPN,PROPN-PROPN-PROPN,compound-compound-compound,compound-compound-nsubj,NNP-NNP-NNP,NNP-NNP-NNP,7,1
2961,12067.0,28,wait,22,20,9,-11,19,18,2,-13,she,19,PERSON,NUMBER,PRON,NUM,nsubj,nummod,PRP,CD,4,1
2962,15090.0,31,began,1,13,15,2,12,15,-12,14,she,19,PERSON,NUMBER,PRON,NUM,nsubj,attr,PRP,CD,5,1
2963,12068.0,35,include,9,11,18,7,10,16,-2,9,her,Elizabeth,PERSON,PERSON,DET,PROPN,poss,conj,PRP$,NNP,4,1
2964,12074.0,22,got,12,1,5,4,0,16,11,-7,Her,Cruse,PERSON,PERSON,DET,PROPN,poss,appos,PRP$,NNP,1,1
2965,12076.0,53,warned,1,16,30,14,15,22,-15,29,Countrywide Financial Corp.,"13,000",ORGANIZATION-ORGANIZATION-ORGANIZATION,NUMBER,PROPN-PROPN-PROPN,NUM,compound-compound-conj,nummod,NNP-NNP-NNP,CD,5,1
2966,12084.0,30,told,1,12,17,5,11,12,-11,16,Graham,Yellowknife,PERSON,CITY,PROPN,PROPN,nsubj,pobj,NNP,NNP,4,1
2967,12092.0,34,said,13,5,15,10,4,18,8,2,National Restaurant Association,she,ORGANIZATION-ORGANIZATION-ORGANIZATION,PERSON,PROPN-PROPN-PROPN,PRON,compound-compound-poss,nsubj,NNP-NNP-NNP,PRP,5,1
2968,12102.0,28,told,25,18,14,-4,17,13,7,-11,Knox,University of Foreigners,PERSON,ORGANIZATION-ORGANIZATION-ORGANIZATION,PROPN,PROPN-ADP-PROPN,nsubj,pobj-prep-pobj,NNP,NNP-IN-NNPS,4,1
2969,12108.0,71,said,13,1,9,8,0,61,12,-4,Laura Silsby,SOS Children 's Villages,PERSON-PERSON,ORGANIZATION-ORGANIZATION-ORGANIZATION-ORGANIZATION,PROPN-PROPN,PROPN-PROPN-PART-PROPN,compound-nsubj,compound-poss-case-pobj,NNP-NNP,NNP-NNP-POS-NNPS,4,1
2970,12119.0,30,said,3,5,24,19,4,5,-2,21,Daniels,Sunday,PERSON,DATE,PROPN,PROPN,poss,npadvmod,NNP,NNP,8,1
2971,12124.0,37,stands,17,1,30,29,0,6,16,13,Wen Qiang,multiple rapes,PERSON-PERSON,CRIMINAL_CHARGE-CRIMINAL_CHARGE,PROPN-PROPN,ADJ-NOUN,compound-nsubj,amod-dobj,NNP-NNP,JJ-NNS,7,1
2972,12125.0,21,sees,3,3,11,8,2,9,0,8,Piedra,U.S.,PERSON,COUNTRY,PROPN,PROPN,nsubj,pobj,NNP,NNP,3,1
2973,12126.0,32,compete,3,19,30,11,18,1,-16,27,National Taiwan Symphony Orchestra,Taichung County,ORGANIZATION-ORGANIZATION-ORGANIZATION-ORGANIZATION,LOCATION-LOCATION,PROPN-PROPN-PROPN-PROPN,PROPN-PROPN,compound-compound-compound-poss,compound-appos,NNP-NNP-NNP-NNP,NNP-NNP,3,1
2974,12141.0,42,born,4,1,7,6,0,34,3,3,Andrew E Lange,Urbana,PERSON-PERSON-PERSON,CITY,PROPN-PROPN-PROPN,PROPN,compound-compound-nsubjpass,pobj,NNP-NNP-NNP,NNP,5,1
2975,12156.0,40,had,10,1,8,7,0,31,9,-2,He,Anita Pandey,PERSON,PERSON-PERSON,PRON,PROPN-PROPN,nsubj,compound-appos,PRP,NNP-NNP,3,1
2976,12157.0,17,dismissed,5,4,3,-1,3,13,1,-2,Joel Denaro,lawyer,PERSON-PERSON,TITLE,PROPN-PROPN,NOUN,compound-appos,nsubj,NNP-NNP,NN,1,1
2977,12160.0,22,BEIJING,0,8,16,8,7,5,-8,16,The orchestra,Tsai Chih-kue,ORGANIZATION-ORGANIZATION,PERSON-PERSON,DET-NOUN,PROPN-PROPN,det-nsubjpass,compound-pobj,DT-NN,NNP-NNP,4,1
2978,12170.0,29,chosen,17,8,13,5,7,15,9,-4,Dance Theatre of Harlem,New York,ORGANIZATION-ORGANIZATION-ORGANIZATION-ORGANIZATION,STATE_OR_PROVINCE-STATE_OR_PROVINCE,PROPN-PROPN-ADP-PROPN,PROPN-PROPN,compound-pobj-prep-pobj,compound-pobj,NNP-NNP-IN-NNP,NNP-NNP,2,1
2979,12179.0,27,sentenced,17,25,5,-20,24,21,-8,-12,his,driver,PERSON,TITLE,DET,NOUN,poss,nsubjpass,PRP$,NN,7,1
2980,12182.0,38,said,17,15,25,10,14,12,2,8,Piedra,attorney,PERSON,TITLE,PROPN,NOUN,dobj,appos,NNP,NN,4,1
2981,12183.0,33,told,12,1,4,3,0,28,11,-8,Knox,Deanna,PERSON,PERSON,PROPN,PROPN,poss,appos,NNP,NNP,3,1
2982,12190.0,62,said,40,51,42,-9,50,19,-11,2,TPI,Peter A. Allen,ORGANIZATION,PERSON-PERSON-PERSON,PROPN,PROPN-PROPN-PROPN,pobj,compound-compound-nsubj,NNP,NNP-NNP-NNP,4,1
2983,12191.0,46,warned,1,11,16,5,10,29,-10,15,Countrywide Financial,United States,ORGANIZATION-ORGANIZATION,COUNTRY-COUNTRY,PROPN-PROPN,PROPN-PROPN,compound-compound,compound-pobj,NNP-NNP,NNP-NNP,6,1
2984,12197.0,33,found,4,24,17,-7,23,15,-20,13,Meredith Kercher,2007,PERSON-PERSON,DATE,PROPN-PROPN,NUM,compound-appos,nummod,NNP-NNP,CD,4,1
2985,12199.0,47,said,45,7,14,7,6,32,38,-31,Wen,senior police officer,PERSON,TITLE-TITLE-TITLE,PROPN,ADJ-NOUN-NOUN,nsubj,amod-compound-pobj,NNP,JJ-NN-NN,5,1
2986,12217.0,42,said,5,7,2,-5,6,39,-2,-3,she,lawyer,PERSON,TITLE,PRON,NOUN,nsubj,nsubj,PRP,NN,4,1
2987,12221.0,37,said,1,28,15,-13,27,21,-27,14,she,Attian Wali,PERSON,CITY-CITY,PRON,PROPN-PROPN,nsubj,compound-pobj,PRP,NNP-NNP,7,1
2988,12224.0,35,said,19,21,8,-13,20,26,-2,-11,Michael Lomax,Morehouse,PERSON-PERSON,ORGANIZATION,PROPN-PROPN,PROPN,compound-nsubj,pobj,NNP-NNP,NNP,7,1
2989,12229.0,53,year,1,6,22,16,5,30,-5,21,man,Agency for International Development,PERSON,ORGANIZATION-ORGANIZATION-ORGANIZATION-ORGANIZATION,NOUN,PROPN-ADP-PROPN-PROPN,pobj,pobj-prep-compound-pobj,NN,NNP-IN-NNP-NNP,12,1
2990,12238.0,47,founded,2,1,7,6,0,39,1,5,UASR,Mousa abu Mazook,ORGANIZATION,PERSON-PERSON-PERSON,PROPN,PROPN-PROPN-PROPN,nsubjpass,nmod-compound-nmod,NNP,NNP-NNP-NNP,4,1
2991,12239.0,35,include,9,11,14,3,10,20,-2,5,her,Susan,PERSON,PERSON,DET,PROPN,poss,conj,PRP$,NNP,2,1
2992,12240.0,38,passed,4,13,28,15,12,9,-9,24,Organization of Asia-Pacific News Agencies,50,ORGANIZATION-ORGANIZATION-ORGANIZATION-ORGANIZATION-ORGANIZATION,NUMBER,PROPN-ADP-PROPN-PROPN-PROPN,NUM,pobj-prep-compound-compound-pobj,nummod,NNP-IN-NNP-NNP-NNPS,CD,5,1
2993,12241.0,33,kidnapped,17,3,10,7,2,22,14,-7,Eugenio Vagni,International Committee,PERSON-PERSON,ORGANIZATION-ORGANIZATION,PROPN-PROPN,PROPN-PROPN,compound-nsubjpass,compound-pobj,NNP-NNP,NNP-NNP,3,1
2994,12246.0,46,updated,7,7,45,38,6,0,0,38,Sodini,8/4/2009,PERSON,DATE,PROPN,NUM,nsubj,intj,NNP,CD,3,1
2995,12248.0,29,got,4,19,1,-18,18,27,-15,-3,TPIPL,TPI,ORGANIZATION,ORGANIZATION,PROPN,NOUN,poss,compound,NNP,NN,12,1
2996,12255.0,18,Mozilo,2,17,2,-15,16,15,-15,0,lender,Angelo Mozilo,ORGANIZATION,PERSON-PERSON,NOUN,PROPN-PROPN,attr,compound-ROOT,NN,NNP-NNP,1,1
2997,12268.0,18,described,2,1,16,15,0,1,1,14,Samudio,actress,PERSON,TITLE,NOUN,NOUN,nsubjpass,conj,NN,NN,5,1
2998,12275.0,16,told,2,1,7,6,0,8,1,5,Alvin Daniels,his,PERSON-PERSON,PERSON,PROPN-PROPN,DET,compound-nsubj,poss,NNP-NNP,PRP$,4,1
2999,12278.0,45,sued,3,1,6,5,0,38,2,3,Tracy Barker,contractor,PERSON-PERSON,TITLE,PROPN-PROPN,NOUN,compound-nsubj,compound,NNP-NNP,NN,3,1
3000,12287.0,36,started,1,33,9,-24,32,26,-32,8,her,Shelby,PERSON,PERSON,PRON,PROPN,dobj,dobj,PRP,NNP,6,1
3001,12289.0,26,is,10,10,7,-3,9,18,0,-3,ACSE,Illinois,ORGANIZATION,STATE_OR_PROVINCE,PROPN,PROPN,nsubj,appos,NNP,NNP,1,1
3002,12291.0,59,published,16,6,9,3,5,49,10,-7,he,writer,PERSON,TITLE,PRON,NOUN,nsubj,attr,PRP,NN,2,1
3003,12298.0,53,said,10,40,36,-4,39,16,-30,26,PATA,Pacific-Asia Travel Association,ORGANIZATION,ORGANIZATION-ORGANIZATION-ORGANIZATION,PROPN,PROPN-PROPN-PROPN,compound,compound-compound-pobj,NNP,NNP-NNP-NNP,2,1
3004,12307.0,26,2007-12-18T10,0,9,20,11,8,5,-9,20,"THE GOOD BROKER , LLC",Atlanta,ORGANIZATION-ORGANIZATION-ORGANIZATION-ORGANIZATION-ORGANIZATION,CITY,DET-ADJ-PROPN-PUNCT-PROPN,PROPN,det-amod-appos-punct-appos,appos,"DT-JJ-NNP-,-NNP",NNP,-1,1
3005,12314.0,36,accuses,1,3,23,20,2,12,-2,22,Gross,USAID,PERSON,ORGANIZATION,PROPN,PROPN,dobj,compound,NNP,NNP,8,1
3006,12318.0,12,is,6,4,1,-3,3,10,2,-5,Brad Hagemo,Her,PERSON-PERSON,PERSON,PROPN-PROPN,DET,compound-appos,poss,NNP-NNP,PRP$,1,1
3007,12325.0,30,was,7,5,10,5,4,19,2,3,Jamie Leigh Jones,20-year-old,PERSON-PERSON-PERSON,NUMBER,PROPN-PROPN-PROPN,ADJ,compound-compound-appos,amod,NNP-NNP-NNP,JJ,7,1
3008,12327.0,43,Prachai,3,27,4,-23,26,38,-24,1,Thai Petrochemical Industry,Prachai Leophairatana,ORGANIZATION-ORGANIZATION-ORGANIZATION,PERSON-PERSON,PROPN-PROPN-PROPN,PROPN-PROPN,compound-compound-pobj,compound-nmod,NNP-NNP-NNP,NNP-NNP,7,1
3009,12347.0,9,died,2,1,5,4,0,3,1,3,William Kunstler,1995,PERSON-PERSON,DATE,PROPN-PROPN,NUM,compound-nsubj,pobj,NNP-NNP,CD,2,1
3010,12360.0,47,denied,7,17,5,-12,16,41,-10,-2,he,Judy,PERSON,PERSON,PRON,PROPN,nsubj,appos,PRP,NNP,3,1
3011,12364.0,22,seeking,6,5,4,-1,4,17,1,-2,Knox,23-year-old,PERSON,NUMBER,PROPN,NUM,pobj,amod,NNP,CD,1,1
3012,12366.0,38,told,16,13,6,-7,12,31,3,-10,National Urban League,New Orleans,ORGANIZATION-ORGANIZATION-ORGANIZATION,CITY-CITY,PROPN-PROPN-PROPN,PROPN-PROPN,compound-compound-dobj,compound-compound,NNP-NNP-NNP,NNP-NNP,4,1
3013,12398.0,42,accused,1,21,39,18,20,2,-20,38,he,state media,PERSON,ORGANIZATION-ORGANIZATION,PRON,NOUN-NOUN,nsubj,compound-compound,PRP,NN-NNS,5,1
3014,12412.0,43,said,18,8,1,-7,7,41,10,-17,National Energy Administration,Wu Guihui,ORGANIZATION-ORGANIZATION-ORGANIZATION,PERSON-PERSON,PROPN-PROPN-PROPN,PROPN-PROPN,compound-compound-pobj,compound-nsubj,NNP-NNP-NNP,NNP-NNP,4,1
3015,12442.0,38,said,8,31,6,-25,30,31,-23,-2,Defence Force,US,ORGANIZATION-ORGANIZATION,COUNTRY,PROPN-PROPN,PROPN,compound-compound,compound,NNP-NNP,NNP,9,1
3016,12446.0,31,think,10,8,12,4,7,18,2,2,Loose Change,he,ORGANIZATION-ORGANIZATION,ORGANIZATION,PROPN-PROPN,PRON,compound-compound,nsubj,NNP-NNP,PRP,7,1
3017,12451.0,34,working,11,1,9,8,0,24,10,-2,Gross,Maryland,PERSON,STATE_OR_PROVINCE,PROPN,PROPN,nsubj,appos,NNP,NNP,3,1
3018,14975.0,26,working,10,1,8,7,0,17,9,-2,Gross,Maryland,PERSON,STATE_OR_PROVINCE,PROPN,PROPN,nsubj,appos,NNP,NNP,3,1
3019,12455.0,55,According,0,25,12,-13,24,42,-25,12,PATA,UN World Tourism Organization,ORGANIZATION,ORGANIZATION-ORGANIZATION-ORGANIZATION-ORGANIZATION,PROPN,PROPN-PROPN-PROPN-PROPN,compound,compound-compound-compound-pobj,NNP,NNP-NNP-NNP-NNP,7,1
3020,12459.0,44,President,2,6,1,-5,5,42,-4,-1,"The Good Broker , LLC",Joe Eman,ORGANIZATION-ORGANIZATION-ORGANIZATION-ORGANIZATION-ORGANIZATION,PERSON-PERSON,DET-PROPN-PROPN-PUNCT-PROPN,PROPN-PROPN,det-compound-ROOT-punct-npadvmod,compound-compound,"DT-NNP-NNP-,-NNP",NNP-NNP,4,1
3021,12483.0,35,migrated,1,8,15,7,7,19,-7,14,group,Committee on Urban Conditions Among Negroes,ORGANIZATION,ORGANIZATION-ORGANIZATION-ORGANIZATION-ORGANIZATION-ORGANIZATION-ORGANIZATION,NOUN,PROPN-ADP-PROPN-PROPN-ADP-PROPN,conj,oprd-prep-compound-pobj-prep-compound,NN,NNP-IN-NNP-NNPS-IN-NNP,4,1
3022,12484.0,14,meets,3,2,10,8,1,3,1,7,High Point,Arlington,ORGANIZATION-ORGANIZATION,CITY,PROPN-PROPN,PROPN,compound-nsubj,pobj,NNP-NNP,NNP,4,1
3023,12508.0,40,urges,29,3,1,-2,2,38,26,-28,Charles Ble Goude,Youth Minister,PERSON-PERSON-PERSON,TITLE-TITLE,PROPN-PROPN-PROPN,PROPN-PROPN,compound-compound-nsubj,compound-compound,NNP-NNP-NNP,NNP-NNP,2,1
3024,12521.0,45,sentences,1,15,8,-7,14,36,-14,7,Wen Qiang,prostitution,PERSON-PERSON,CRIMINAL_CHARGE,PROPN-PROPN,NOUN,compound-pobj,compound,NNP-NNP,NN,7,1
3025,12536.0,41,survived,2,18,5,-13,17,35,-16,3,Carol Daniels,his,PERSON-PERSON,PERSON,PROPN-PROPN,DET,compound-appos,poss,NNP-NNP,PRP$,2,1
3026,15092.0,41,survived,2,18,5,-13,17,35,-16,3,Carol Daniels,his,PERSON-PERSON,PERSON,PROPN-PROPN,DET,compound-appos,poss,NNP-NNP,PRP$,2,1
3027,12539.0,32,said,13,20,30,10,19,1,-7,17,Tribeca,Craig Hatkoff,ORGANIZATION,PERSON-PERSON,PROPN,PROPN-PROPN,dobj,compound-appos,NNP,NNP-NNP,6,1
3028,12547.0,42,wrote,5,17,39,22,16,2,-12,34,he,President,PERSON,TITLE,PRON,PROPN,nsubj,compound,PRP,NNP,-1,1
3029,12562.0,16,founded,4,3,1,-2,2,14,1,-3,Zirh,New York-based,ORGANIZATION,STATE_OR_PROVINCE-STATE_OR_PROVINCE,PROPN,PROPN-PROPN,nsubjpass,compound-compound,NNP,NNP-NNP,1,1
3030,12565.0,93,2007-10-02T13,0,29,37,8,28,55,-29,37,website,http://bestpartyevercom,ORGANIZATION,URL,NOUN,X,dobj,compound,NN,ADD,4,1
3031,12569.0,42,convicted,2,9,13,4,8,28,-7,11,Mark Fisher,19-year,PERSON-PERSON,DURATION,PROPN-PROPN,ADJ,compound-pobj,npadvmod,NNP-NNP,JJ,6,1
3032,15225.0,42,convicted,2,9,13,4,8,28,-7,11,Mark Fisher,19-year,PERSON-PERSON,DURATION,PROPN-PROPN,ADJ,compound-pobj,npadvmod,NNP-NNP,JJ,6,1
3033,12615.0,49,are,25,33,33,0,32,15,-8,8,Countrywide Financial,Countrywide Securities,ORGANIZATION-ORGANIZATION,ORGANIZATION-ORGANIZATION,PROPN-PROPN,PROPN-PROPN,compound-pobj,compound-conj,NNP-NNP,NNP-NNP,0,1
3034,12632.0,32,took,21,10,17,7,9,14,11,-4,Knox,University of Washington,PERSON,ORGANIZATION-ORGANIZATION-ORGANIZATION,PROPN,PROPN-ADP-PROPN,pobj,pobj-prep-pobj,NNP,NNP-IN-NNP,5,1
3035,13785.0,53,accuse,1,3,16,13,2,36,-2,15,Knox,University of Washington,PERSON,ORGANIZATION-ORGANIZATION-ORGANIZATION,PROPN,PROPN-ADP-PROPN,dobj,pobj-prep-pobj,NNP,NNP-IN-NNP,8,1
3036,12642.0,34,said,16,14,11,-3,13,22,2,-5,'',Foxy Knoxy,PERSON,PERSON-PERSON,PUNCT,PROPN-PROPN,punct,compound-pobj,'',NNP-NNP,6,1
3037,12653.0,34,condemned,6,9,19,10,8,14,-3,13,he,Muslim,PERSON,RELIGION,PRON,ADJ,nsubj,amod,PRP,JJ,2,1
3038,12662.0,42,said,14,11,24,13,10,17,3,10,Jupp,injuries,PERSON,CAUSE_OF_DEATH,PROPN,NOUN,poss,nsubj,NNP,NNS,7,1
3039,12679.0,41,said,4,11,35,24,10,5,-7,31,Shah Abdul Aziz,Afghan,PERSON-PERSON-PERSON,NATIONALITY,PROPN-PROPN-PROPN,ADJ,compound-compound-dobj,amod,NNP-NNP-NNP,JJ,11,1
3040,12686.0,43,said,26,14,1,-13,13,41,12,-25,Koch Foods,U.S.,ORGANIZATION-ORGANIZATION,COUNTRY,PROPN-PROPN,PROPN,compound-compound,nmod,NNP-NNP,NNP,6,1
3041,12694.0,32,is,2,2,18,16,1,13,0,16,ACSE,"6,500",ORGANIZATION,NUMBER,PROPN,NUM,nsubj,nummod,NNP,CD,4,1
3042,12696.0,22,LANGE,1,1,11,10,0,10,0,10,ANDREW LANGE,52,PERSON-PERSON,NUMBER,PROPN-PROPN,NUM,compound-ROOT,nummod,NNP-NNP,CD,2,1
3043,12704.0,46,said,16,11,3,-8,10,42,5,-13,National Development and Reform Commission,Zhang Xiaoqiang,ORGANIZATION-ORGANIZATION-ORGANIZATION-ORGANIZATION-ORGANIZATION,PERSON-PERSON,PROPN-PROPN-CCONJ-PROPN-PROPN,PROPN-PROPN,nmod-nmod-cc-conj-pobj,compound-nsubj,NNP-NNP-CC-NNP-NNP,NNP-NNP,4,1
3044,12707.0,59,copyright,0,17,21,4,16,37,-17,21,Sarah,1976,PERSON,DATE,PROPN,NUM,compound,pobj,NNP,CD,2,1
3045,12708.0,44,said,38,1,3,2,0,40,37,-35,Alan Gross,", 60",PERSON-PERSON,NUMBER-NUMBER,PROPN-PROPN,PUNCT-NUM,compound-nsubjpass,punct-appos,NNP-NNP,",-CD",1,1
3046,12727.0,7,hired,1,1,6,5,0,0,0,5,Miettinen,Sky Blue,PERSON,ORGANIZATION-ORGANIZATION,PROPN,PROPN-PROPN,nsubj,compound-pobj,NNP,NNP-NNP,2,1
3047,12734.0,27,named,11,1,7,6,0,19,10,-4,Pauliina Miettinen,goalkeeper,PERSON-PERSON,TITLE,PROPN-PROPN,NOUN,compound-nsubjpass,conj,NNP-NNP,NN,2,1
3048,12738.0,27,2007-08-30T03,0,23,17,-6,22,9,-23,17,it,Robin Hilliard,ORGANIZATION,PERSON-PERSON,PRON,PROPN-PROPN,dobj,compound-appos,PRP,NNP-NNP,3,1
3049,12753.0,35,named,2,5,7,2,4,27,-3,5,pilot,Lieutenant,PERSON,TITLE,NOUN,PROPN,dobj,compound,NN,NNP,2,1
3050,12769.0,36,said,24,35,2,-33,34,33,-11,-22,him,Dutch,PERSON,NATIONALITY,PRON,ADJ,dobj,amod,PRP,JJ,3,1
3051,12772.0,14,is,8,5,7,2,4,6,3,-1,ADF,Mukulu,ORGANIZATION,PERSON,PROPN,PROPN,pobj,appos,NNP,NNP,3,1
3052,12782.0,33,nailed,8,1,4,3,0,28,7,-4,John Graham,24,PERSON-PERSON,NUMBER,PROPN-PROPN,NUM,compound-nsubjpass,appos,NNP-NNP,CD,1,1
3053,12785.0,27,was,2,21,23,2,20,3,-19,21,UASR,Middle East Affairs Journal,ORGANIZATION,ORGANIZATION-ORGANIZATION-ORGANIZATION-ORGANIZATION,PROPN,PROPN-PROPN-PROPN-PROPN,poss,compound-compound-compound-pobj,NNP,NNP-NNP-NNPS-NNP,2,1
3054,12792.0,47,dies,2,20,2,-18,19,44,-18,0,Ladyzhenskiy,athlete,PERSON,TITLE,PROPN,NOUN,nsubj,nsubj,NNP,NN,5,1
3055,12799.0,50,said,28,4,3,-1,3,46,24,-25,Christopher Bollyn,reporter,PERSON-PERSON,TITLE,PROPN-PROPN,NOUN,compound-pobj,compound,NNP-NNP,NN,1,1
3056,12814.0,34,worked,4,19,9,-10,18,24,-15,5,UASR,United Association for Studies and Research,ORGANIZATION,ORGANIZATION-ORGANIZATION-ORGANIZATION-ORGANIZATION-ORGANIZATION-ORGANIZATION,PROPN,PROPN-PROPN-ADP-PROPN-CCONJ-PROPN,compound,compound-pobj-prep-pobj-cc-conj,NNP,NNP-NNP-IN-NNPS-CC-NNP,-1,1
3057,12823.0,24,said,1,8,15,7,7,8,-7,14,Pluribus,Matthew Doull,ORGANIZATION,PERSON-PERSON,PROPN,PROPN-PROPN,dobj,compound-conj,NNP,NNP-NNP,5,1
3058,12824.0,26,became,9,16,1,-15,15,24,-7,-8,Organization of Asia - Pacific News Agencies,Trend,ORGANIZATION-ORGANIZATION-ORGANIZATION-ORGANIZATION-ORGANIZATION-ORGANIZATION-ORGANIZATION,ORGANIZATION,PROPN-ADP-PROPN-PUNCT-PROPN-PROPN-PROPN,PROPN,pobj-prep-compound-punct-compound-compound-pobj,nsubj,NNP-IN-NNP-HYPH-NNP-NNP-NNPS,NNP,6,1
3059,12831.0,63,Poverty,0,3,40,37,2,22,-3,40,Social Impact Analysis,PSIA,ORGANIZATION-ORGANIZATION-ORGANIZATION,ORGANIZATION,PROPN-PROPN-PROPN,NOUN,compound-conj-appos,nsubjpass,NNP-NNP-NNP,NNS,-1,1
3060,12833.0,23,reported,21,1,3,2,0,19,20,-18,Wen,55,PERSON,NUMBER,PROPN,NUM,nsubjpass,appos,NNP,CD,2,1
3061,12842.0,43,Using,0,1,34,33,0,8,-1,34,Using Poverty and Social Impact Analysis,PSIA,ORGANIZATION-ORGANIZATION-ORGANIZATION-ORGANIZATION-ORGANIZATION-ORGANIZATION,ORGANIZATION,VERB-PROPN-CCONJ-PROPN-PROPN-PROPN,PROPN,ROOT-dobj-cc-compound-compound-conj,compound,VBG-NNP-CC-NNP-NNP-NNP,NNP,8,1
3062,12846.0,28,survived,3,22,26,4,21,1,-19,23,Adam Lange,St. Louis,PERSON-PERSON,LOCATION-LOCATION,PROPN-PROPN,PROPN-PROPN,compound-appos,compound-pobj,NNP-NNP,NNP-NNP,3,1
3063,12860.0,34,said,1,12,27,15,11,6,-11,26,boy,Enzo,PERSON,PERSON,NOUN,PROPN,pobj,appos,NN,NNP,2,1
3064,12869.0,36,told,33,15,14,-1,14,21,18,-19,Shah Abdul Aziz,parliamentarian,PERSON-PERSON-PERSON,TITLE,PROPN-PROPN-PROPN,NOUN,compound-compound-pobj,compound,NNP-NNP-NNP,NN,2,1
3065,12876.0,53,said,26,1,6,5,0,46,25,-20,Bamba,diplomat,PERSON,TITLE,PROPN,NOUN,nsubj,appos,NNP,NN,3,1
3066,12877.0,33,drew,6,12,23,11,11,9,-6,17,Vagni,his,PERSON,PERSON,PROPN,DET,poss,poss,NNP,PRP$,6,1
3067,12890.0,16,said,14,1,9,8,0,6,13,-5,Ramon,pilot,PERSON,TITLE,PROPN,NOUN,nsubj,compound,NNP,NN,5,1
3068,12901.0,29,commented,6,12,16,4,11,12,-6,10,Alan Gross,American,PERSON-PERSON,NATIONALITY,PROPN-PROPN,ADJ,compound-pobj,amod,NNP-NNP,JJ,1,1
3069,13175.0,16,continues,1,9,6,-3,8,9,-8,5,Alan Gross,American,PERSON-PERSON,NATIONALITY,PROPN-PROPN,ADJ,compound-appos,amod,NNP-NNP,JJ,1,1
3070,14495.0,27,pressed,9,14,19,5,13,7,-5,10,Alan Gross,American,PERSON-PERSON,NATIONALITY,PROPN-PROPN,ADJ,compound-dobj,amod,NNP-NNP,JJ,1,1
3071,12907.0,37,see,5,1,12,11,0,24,4,7,Her,University of Washington,PERSON,ORGANIZATION-ORGANIZATION-ORGANIZATION,DET,PROPN-ADP-PROPN,poss,nmod-prep-pobj,PRP$,NNP-IN-NNP,7,1
3072,12917.0,46,says,29,11,3,-8,10,42,18,-26,William Kunstler,33-year-old,PERSON-PERSON,DURATION,PROPN-PROPN,NUM,compound-appos,amod,NNP-NNP,CD,8,1
3073,12924.0,29,ISLAMABAD,0,14,13,-1,13,15,-14,13,Christian woman,Pakistani,PERSON-PERSON,NATIONALITY,ADJ-NOUN,ADJ,amod-pobj,amod,JJ-NN,JJ,1,1
3074,12932.0,47,said,21,30,23,-7,29,23,-9,2,National Development and Reform Commission,Wang Yiming,ORGANIZATION-ORGANIZATION-ORGANIZATION-ORGANIZATION-ORGANIZATION,PERSON-PERSON,PROPN-PROPN-CCONJ-PROPN-PROPN,PROPN-PROPN,nmod-nmod-cc-conj-pobj,compound-nsubj,NNP-NNP-CC-NNP-NNP,NNP-NNP,5,1
3075,12938.0,31,was,26,25,10,-15,24,20,1,-16,him,drifter,PERSON,TITLE,PRON,NOUN,pobj,pobj,PRP,NN,7,1
3076,12943.0,25,is,11,2,9,7,1,15,9,-2,Huntington Library,Henry Huntington,ORGANIZATION-ORGANIZATION,PERSON-PERSON,PROPN-PROPN,PROPN-PROPN,compound-nsubj,compound-pobj,NNP-NNP,NNP-NNP,3,1
3077,12947.0,49,told,11,22,20,-2,21,28,-11,9,Arlo Looking Cloud,activists,PERSON-PERSON-PERSON,TITLE,PROPN-PROPN-PROPN,NOUN,compound-compound-conj,conj,NNP-NNP-NNP,NNS,3,1
3078,12955.0,30,taken,14,4,29,25,3,0,10,15,Baldino,executive,PERSON,TITLE,PROPN,NOUN,nsubj,conj,NNP,NN,3,1
3079,12962.0,26,is,10,10,5,-5,9,20,0,-5,ACSE,Schaumburg,ORGANIZATION,CITY,PROPN,PROPN,nsubj,pobj,NNP,NNP,4,1
3080,12968.0,43,makes,2,1,36,35,0,6,1,34,Amanda Knox,Chris Mellas,PERSON-PERSON,PERSON-PERSON,PROPN-PROPN,PROPN-PROPN,compound-nsubj,compound-appos,NNP-NNP,NNP-NNP,5,1
3081,12986.0,31,comes,2,13,5,-8,12,25,-11,3,Texas Petro Index,Karr Ingham,ORGANIZATION-ORGANIZATION-ORGANIZATION,PERSON-PERSON,PROPN-PROPN-PROPN,PROPN-PROPN,compound-compound-dobj,compound-pobj,NNP-NNP-NNP,NNP-NNP,4,1
3082,13010.0,40,suing,5,1,36,35,0,3,4,31,Meredith Kercher,"November 1 , 2007",PERSON-PERSON,DATE-DATE-DATE-DATE,PROPN-PROPN,PROPN-NUM-PUNCT-NUM,compound-poss,pobj-nummod-punct-nummod,NNP-NNP,"NNP-CD-,-CD",8,1
3083,13024.0,16,mentioned,4,11,14,3,10,1,-7,10,Alan Gross,Potomac,PERSON-PERSON,CITY,PROPN-PROPN,PROPN,compound-attr,pobj,NNP-NNP,NNP,1,1
3084,13032.0,40,Bank,1,1,16,15,0,23,0,15,Countrywide Financial Corporation,CFC,ORGANIZATION-ORGANIZATION-ORGANIZATION,ORGANIZATION,PROPN-PROPN-PROPN,PROPN,compound-compound-pobj,compound,NNP-NNP-NNP,NNP,-1,1
3085,13033.0,21,founded,5,3,8,5,2,12,2,3,"Qatalys , Inc",1995,ORGANIZATION-ORGANIZATION-ORGANIZATION,DATE,PROPN-PUNCT-PROPN,NUM,nmod-punct-nsubj,pobj,"NNP-,-NNP",CD,4,1
3086,13651.0,49,are,9,31,36,5,30,12,-22,27,"Qatalys , Inc",1995,ORGANIZATION-ORGANIZATION-ORGANIZATION,DATE,PROPN-PUNCT-PROPN,NUM,ROOT-punct-appos,pobj,"NNP-,-NNP",CD,3,1
3087,13052.0,32,grew,8,1,13,12,0,18,7,5,Steele,Pennsylvania,PERSON,STATE_OR_PROVINCE,PROPN,PROPN,npadvmod,pobj,NNP,NNP,2,1
3088,13053.0,50,JANEIRO,2,30,29,-1,29,20,-28,27,Samudio,25-year-old,PERSON,NUMBER,PROPN,NUM,pobj,compound,NNP,CD,1,1
3089,13062.0,15,is,3,1,11,10,0,3,2,8,Michael L Lomax,United Negro College Fund,PERSON-PERSON-PERSON,ORGANIZATION-ORGANIZATION-ORGANIZATION-ORGANIZATION,PROPN-PROPN-PROPN,PROPN-PROPN-PROPN-PROPN,compound-compound-nsubj,compound-compound-compound-pobj,NNP-NNP-NNP,NNP-NNP-NNP-NNP,6,1
3090,13063.0,30,taken,14,21,12,-9,20,17,-7,-2,his,Pa.,PERSON,STATE_OR_PROVINCE,DET,PROPN,poss,appos,PRP$,NNP,3,1
3091,13064.0,49,study,2,11,24,13,10,24,-9,22,AAUW,Ivy League,ORGANIZATION,MISC-MISC,PROPN,PROPN-PROPN,compound,compound-pobj,NNP,NNP-NNP,6,1
3092,13080.0,27,proved,17,3,8,5,2,18,14,-9,Ahmed Rashid,Taliban,PERSON-PERSON,ORGANIZATION,PROPN-PROPN,PROPN,compound-dobj,compound,NNP-NNP,NNP,4,1
3093,13087.0,38,said,18,36,4,-32,35,33,-18,-14,Assaf Ramon,crashed,PERSON-PERSON,CAUSE_OF_DEATH,PROPN-PROPN,VERB,compound-pobj,ccomp,NNP-NNP,VBD,5,1
3094,13237.0,27,died,5,1,17,16,0,9,4,12,Assaf Ramon,crashed,PERSON-PERSON,CAUSE_OF_DEATH,PROPN-PROPN,VERB,compound-nsubj,advcl,NNP-NNP,VBD,5,1
3095,13091.0,21,been,9,14,8,-6,13,12,-5,-1,he,Scientology,PERSON,RELIGION,PRON,PROPN,nsubj,pobj,PRP,NNP,3,1
3096,13093.0,32,comes,2,12,20,8,11,11,-10,18,Wen Qiang,accepting bribes,PERSON-PERSON,CRIMINAL_CHARGE-CRIMINAL_CHARGE,PROPN-PROPN,VERB-NOUN,compound-appos,conj-dobj,NNP-NNP,VBG-NNS,3,1
3097,13105.0,29,believed,13,12,28,16,11,0,1,15,her,Salaam,PERSON,PERSON,DET,PROPN,poss,dobj,PRP$,NNP,4,1
3098,13120.0,34,shares,1,6,16,10,5,17,-5,15,Almena Lomax,journalist,PERSON-PERSON,TITLE,PROPN-PROPN,NOUN,compound-pobj,conj,NNP-NNP,NN,3,1
3099,13125.0,43,was,21,18,12,-6,17,30,3,-9,National Urban League,he,ORGANIZATION-ORGANIZATION-ORGANIZATION,PERSON,PROPN-PROPN-PROPN,PRON,compound-compound-pobj,nsubj,NNP-NNP-NNP,PRP,6,1
3100,13128.0,17,seemed,3,2,14,12,1,2,1,11,Piedra,Church of Scientology,PERSON,ORGANIZATION-ORGANIZATION-ORGANIZATION,PROPN,PROPN-ADP-PROPN,nsubj,appos-prep-pobj,NNP,NNP-IN-NNP,6,1
3101,13144.0,48,CHONGQING,0,18,35,17,17,12,-18,35,Godmother,illegal imprisonment,PERSON,CRIMINAL_CHARGE-CRIMINAL_CHARGE,PROPN,ADJ-NOUN,appos,amod-appos,NNP,JJ-NN,-1,1
3102,13155.0,19,began,10,7,1,-6,6,17,3,-9,Countrywide Financial Corp,America,ORGANIZATION-ORGANIZATION-ORGANIZATION,COUNTRY,PROPN-PROPN-PROPN,PROPN,compound-compound-appos,poss,NNP-NNP-NNP,NNP,4,1
3103,13163.0,37,asked,10,13,8,-5,12,28,-3,-2,she,Idaho,PERSON,STATE_OR_PROVINCE,PRON,PROPN,nsubj,appos,PRP,NNP,3,1
3104,13168.0,58,killed,37,11,17,6,10,40,26,-20,Assaf Ramon,Israel,PERSON-PERSON,NATIONALITY,PROPN-PROPN,PROPN,compound-pobj,poss,NNP-NNP,NNP,5,1
3105,13172.0,23,told,16,7,20,13,6,2,9,4,Bibi,Islamabad,PERSON,CITY,PROPN,PROPN,poss,pobj,NNP,NNP,4,1
3106,13180.0,46,updated,7,9,45,36,8,0,-2,38,his,8/4/2009,PERSON,DATE,DET,NUM,poss,intj,PRP$,CD,4,1
3107,13196.0,38,said,35,2,33,31,1,4,33,-2,Andrew E Lange,suicide,PERSON-PERSON-PERSON,CAUSE_OF_DEATH,PROPN-PROPN-PROPN,NOUN,compound-compound-nsubj,pobj,NNP-NNP-NNP,NN,5,1
3108,13213.0,27,said,20,13,19,6,12,7,7,-1,him,asphyxiation,PERSON,CAUSE_OF_DEATH,PRON,NOUN,nsubj,pobj,PRP,NN,4,1
3109,13214.0,12,is,1,1,8,7,0,3,0,7,Countrywide,N.C.-based Bank of America,ORGANIZATION,ORGANIZATION-ORGANIZATION-ORGANIZATION-ORGANIZATION,PROPN,PROPN-PROPN-ADP-PROPN,nsubj,compound-appos-prep-pobj,NNP,NNP-NNP-IN-NNP,2,1
3110,13216.0,31,cut,2,26,20,-6,25,10,-24,18,National Development and Reform Commission,Han Yongwen,ORGANIZATION-ORGANIZATION-ORGANIZATION-ORGANIZATION-ORGANIZATION,PERSON-PERSON,PROPN-PROPN-CCONJ-PROPN-PROPN,PROPN-PROPN,nmod-nmod-cc-conj-pobj,compound-pobj,NNP-NNP-CC-NNP-NNP,NNP-NNP,3,1
3111,13219.0,42,accused,27,4,7,3,3,34,23,-20,Amanda Knox,21,PERSON-PERSON,NUMBER,PROPN-PROPN,NUM,compound-appos,appos,NNP-NNP,CD,2,1
3112,13227.0,26,found,10,1,17,16,0,8,9,7,Meredith Kercher,Friday,PERSON-PERSON,DATE,PROPN-PROPN,PROPN,compound-nsubjpass,pobj,NNP-NNP,NNP,4,1
3113,13238.0,34,named,2,7,17,10,6,16,-5,15,Lieutenant Assaf Ramon,Colonel Ilan Ramon,PERSON-PERSON-PERSON,PERSON-PERSON-PERSON,PROPN-PROPN-PROPN,PROPN-PROPN-PROPN,compound-compound-pobj,compound-compound-pobj,NNP-NNP-NNP,NNP-NNP-NNP,5,1
3114,13246.0,31,said,11,22,28,6,21,2,-11,17,National Restaurant Association,Washington,ORGANIZATION-ORGANIZATION-ORGANIZATION,STATE_OR_PROVINCE,PROPN-PROPN-PROPN,PROPN,compound-compound-pobj,pobj,NNP-NNP-NNP,NNP,8,1
3115,13252.0,36,travel,7,6,34,28,5,1,1,27,Harper,Yukon,PERSON,STATE_OR_PROVINCE,PROPN,PROPN,nsubj,conj,NNP,NNP,2,1
3116,13261.0,54,said,33,52,43,-9,51,10,-19,10,OANA,Malaysian National News Agency,ORGANIZATION,ORGANIZATION-ORGANIZATION-ORGANIZATION-ORGANIZATION,PROPN,PROPN-PROPN-PROPN-PROPN,compound,compound-compound-compound-pobj,NNP,NNP-NNP-NNP-NNP,6,1
3117,13280.0,31,may,2,17,21,4,16,9,-15,19,Meredith Kercher,Leeds,PERSON-PERSON,ORGANIZATION,PROPN-PROPN,PROPN,compound-pobj,compound,NNP-NNP,NNP,1,1
3118,13284.0,28,attended,1,15,4,-11,14,23,-14,3,he,University of California,PERSON,ORGANIZATION-ORGANIZATION-ORGANIZATION,PRON,PROPN-ADP-PROPN,nsubj,conj-prep-pobj,PRP,NNP-IN-NNP,3,1
3119,13289.0,35,include,9,11,33,22,10,1,-2,24,her,Gaynell Davis,PERSON,PERSON-PERSON,DET,PROPN-PROPN,poss,compound-appos,PRP$,NNP-NNP,2,1
3120,13296.0,31,said,28,7,9,2,6,21,21,-19,member,parliament,PERSON,ORGANIZATION,NOUN,NOUN,dobj,pobj,NN,NN,3,1
3121,13340.0,43,lived,3,11,9,-2,10,33,-8,6,his,Iraq,PERSON,COUNTRY,DET,PROPN,poss,pobj,PRP$,NNP,2,1
3122,13341.0,27,appeared,9,1,6,5,0,20,8,-3,Mario Gonzalez Rodriguez,lawyer,PERSON-PERSON-PERSON,TITLE,PROPN-PROPN-PROPN,NOUN,compound-compound-nsubj,appos,NNP-NNP-NNP,NN,3,1
3123,13342.0,24,was,3,1,23,22,0,0,2,20,Jamie Leigh Jones,Houston,PERSON-PERSON-PERSON,CITY,PROPN-PROPN-PROPN,PROPN,compound-compound-nsubj,pobj,NNP-NNP-NNP,NNP,3,1
3124,13347.0,35,COMING,5,9,11,2,8,23,-4,6,ALICO,METLIFE,ORGANIZATION,ORGANIZATION,PROPN,PROPN,dobj,pobj,NNP,NNP,1,1
3125,13355.0,34,said,13,5,18,13,4,15,8,5,National Restaurant Association,her,ORGANIZATION-ORGANIZATION-ORGANIZATION,PERSON,PROPN-PROPN-PROPN,DET,compound-compound-poss,poss,NNP-NNP-NNP,PRP$,5,1
3126,13371.0,36,tried,4,1,9,8,0,26,3,5,Knox,defamation,PERSON,CRIMINAL_CHARGE,PROPN,NOUN,nsubjpass,pobj,NNP,NN,4,1
3127,14297.0,42,FOUND,2,9,15,6,8,26,-7,13,Knox,defamation,PERSON,CRIMINAL_CHARGE,PROPN,NOUN,pobj,pobj,NNP,NN,2,1
3128,13383.0,29,believed,13,10,28,18,9,0,3,15,she,Salaam,PERSON,PERSON,PRON,PROPN,nsubj,dobj,PRP,NNP,4,1
3129,13396.0,53,sources,1,9,52,43,8,0,-8,51,Loose Change,she,ORGANIZATION-ORGANIZATION,PERSON,PROPN-PROPN,PRON,compound-appos,pobj,NNP-NNP,PRP,7,1
3130,13416.0,27,died,25,1,11,10,0,15,24,-14,Norris Church Mailer,61,PERSON-PERSON-PERSON,NUMBER,PROPN-PROPN-PROPN,NUM,compound-compound-pobj,nummod,NNP-NNP-NNP,CD,4,1
3131,13421.0,34,won,17,26,32,6,25,1,-9,15,Sushi Ran,United States,PERSON-PERSON,COUNTRY-COUNTRY,PROPN-PROPN,PROPN-PROPN,compound-compound,compound-appos,NNP-NNP,NNP-NNP,6,1
3132,13426.0,28,survived,3,22,12,-10,21,15,-19,9,Adam Lange,Karen Lange,PERSON-PERSON,PERSON-PERSON,PROPN-PROPN,PROPN-PROPN,compound-appos,compound-appos,NNP-NNP,NNP-NNP,4,1
3133,13430.0,29,founded,13,9,1,-8,8,27,4,-12,Countrywide Financial,LandSafe Inc,ORGANIZATION-ORGANIZATION,ORGANIZATION-ORGANIZATION,PROPN-PROPN,PROPN-PROPN,compound-compound,compound-nsubjpass,NNP-NNP,NNP-NNP,4,1
3134,13448.0,37,said,16,12,3,-9,11,33,4,-13,Urban League,Darnell Williams,ORGANIZATION-ORGANIZATION,PERSON-PERSON,PROPN-PROPN,PROPN-PROPN,compound-pobj,compound-nsubj,NNP-NNP,NNP-NNP,3,1
3135,13450.0,30,died,4,1,9,8,0,20,3,5,Vladimir Ladyzhenskiy,a shock,PERSON-PERSON,CAUSE_OF_DEATH-CAUSE_OF_DEATH,PROPN-PROPN,DET-NOUN,compound-nsubj,det-dobj,NNP-NNP,DT-NN,3,1
3136,13452.0,37,leading,3,1,1,0,0,35,2,-2,PDA,PDA Virginia,ORGANIZATION,LOCATION-LOCATION,PROPN,PROPN-PROPN,compound,compound-nsubj,NNP,NNP-NNP,0,1
3137,13469.0,45,LAHORE,0,5,10,5,4,34,-5,10,Ahmed Rashid,Washington Post,PERSON-PERSON,ORGANIZATION-ORGANIZATION,PROPN-PROPN,PROPN-PROPN,compound-compound,compound-compound,NNP-NNP,NNP-NNP,6,1
3138,13474.0,17,ROME,0,5,11,6,4,5,-5,11,He,Italy,PERSON,COUNTRY,PRON,PROPN,nsubjpass,poss,PRP,NNP,-1,1
3139,13483.0,16,Led,11,14,2,-12,13,13,-3,-9,Wayne Holst,Christian,PERSON-PERSON,RELIGION,PROPN-PROPN,PROPN,compound-pobj,compound,NNP-NNP,NNP,3,1
3140,13489.0,38,said,35,2,33,31,1,4,33,-2,Andrew E. Lange,suicide,PERSON-PERSON-PERSON,CAUSE_OF_DEATH,PROPN-PROPN-PROPN,NOUN,compound-compound-nsubj,pobj,NNP-NNP-NNP,NN,5,1
3141,13503.0,43,cited,1,11,10,-1,10,32,-10,9,Alan Gross,subcontractor,PERSON-PERSON,TITLE,PROPN-PROPN,NOUN,compound-pobj,compound,NNP-NNP,NN,1,1
3142,13521.0,13,Giago,1,11,9,-2,10,3,-10,8,Anna Mae,Murder,PERSON-PERSON,CRIMINAL_CHARGE,PROPN-PROPN,NOUN,compound-pobj,pobj,NNP-NNP,NN,1,1
3143,13528.0,38,told,22,6,3,-3,5,34,16,-19,she,diplomat,PERSON,TITLE,PRON,NOUN,nsubj,nsubj,PRP,NN,2,1
3144,13531.0,19,cried,6,1,4,3,0,14,5,-2,Her,Mick Huff,PERSON,PERSON-PERSON,DET,PROPN-PROPN,poss,compound-appos,PRP$,NNP-NNP,1,1
3145,13547.0,39,recalls,1,1,7,6,0,31,0,6,Lomax,13,PERSON,NUMBER,PROPN,NUM,nsubj,nummod,NNP,CD,2,1
3146,13555.0,39,Yusuf,2,19,7,-12,18,31,-17,5,Organization of Asia Pacific News Agencies,Indonesia,ORGANIZATION-ORGANIZATION-ORGANIZATION-ORGANIZATION-ORGANIZATION-ORGANIZATION,COUNTRY,PROPN-ADP-PROPN-PROPN-PROPN-PROPN,PROPN,pobj-prep-compound-compound-compound-pobj,poss,NNP-IN-NNP-NNP-NNP-NNPS,NNP,10,1
3147,13558.0,22,said,9,2,8,6,1,13,7,-1,Defence Force,Lieutenant General,ORGANIZATION-ORGANIZATION,ORGANIZATION-ORGANIZATION,PROPN-PROPN,PROPN-PROPN,compound-compound,compound-nsubj,NNP-NNP,NNP-NNP,3,1
3148,13560.0,30,said,5,10,5,-5,9,24,-5,0,"American Life Insurance , known as ALICO",AIG,ORGANIZATION-ORGANIZATION-ORGANIZATION-ORGANIZATION-ORGANIZATION-ORGANIZATION-ORGANIZATION,ORGANIZATION,PROPN-PROPN-PROPN-PUNCT-VERB-ADP-PROPN,PROPN,compound-compound-dobj-punct-acl-prep-pobj,nsubj,"NNP-NNP-NNP-,-VBN-IN-NNP",NNP,3,1
3149,13574.0,18,was,3,10,14,4,9,3,-7,11,her,"Jan 31 , 1949",PERSON,DATE-DATE-DATE-DATE,DET,PROPN-NUM-PUNCT-NUM,poss,attr-nummod-punct-appos,PRP$,"NNP-CD-,-CD",6,1
3150,13590.0,34,says,16,13,5,-8,12,28,3,-11,National Restaurant Association,R.D.,ORGANIZATION-ORGANIZATION-ORGANIZATION,PERSON,PROPN-PROPN-PROPN,PROPN,compound-compound-pobj,nmod,NNP-NNP-NNP,NNP,6,1
3151,13594.0,47,is,15,1,18,17,0,28,14,3,The leader of the group of Americans,Idaho,PERSON-PERSON-PERSON-PERSON-PERSON-PERSON-PERSON,STATE_OR_PROVINCE,DET-NOUN-ADP-DET-NOUN-ADP-PROPN,PROPN,det-nsubj-prep-det-pobj-prep-pobj,amod,DT-NN-IN-DT-NN-IN-NNPS,NNP,2,1
3152,13604.0,7,merges,2,5,1,-4,4,5,-3,-1,9-11 Truth,Fox News,ORGANIZATION-ORGANIZATION,ORGANIZATION-ORGANIZATION,NUM-NOUN,PROPN-PROPN,compound-pobj,compound-nsubj,CD-NN,NNP-NNP,6,1
3153,13610.0,46,reflects,2,17,22,5,16,23,-15,20,Charles Ble Goude,government minister,PERSON-PERSON-PERSON,TITLE-TITLE,PROPN-PROPN-PROPN,NOUN-NOUN,compound-compound-appos,compound-appos,NNP-NNP-NNP,NN-NN,2,1
3154,13613.0,72,partnered,11,53,39,-14,52,32,-42,28,NCAI,Drug-Free America,ORGANIZATION,ORGANIZATION-ORGANIZATION,PROPN,PROPN-PROPN,compound,compound-pobj,NNP,NNP-NNP,8,1
3155,13636.0,36,were,4,1,1,0,0,34,3,-3,Chiafari,Chiafari,PERSON,PERSON,PROPN,PROPN,nsubj,nsubj,NNP,NNP,0,1
3156,13646.0,41,said,23,33,25,-8,32,15,-10,2,Huntington Library,Sue Lafferty,ORGANIZATION-ORGANIZATION,PERSON-PERSON,PROPN-PROPN,PROPN-PROPN,compound-pobj,compound-nsubj,NNP-NNP,NNP-NNP,3,1
3157,13654.0,27,said,16,1,4,3,0,22,15,-12,Chen Tao,sales manager,PERSON-PERSON,TITLE-TITLE,PROPN-PROPN,NOUN-NOUN,compound-nsubj,compound-appos,NNP-NNP,NNS-NN,1,1
3158,13655.0,29,adopted,8,3,11,8,2,17,5,3,Richard Gage,Producer,PERSON-PERSON,TITLE,PROPN-PROPN,PROPN,compound-poss,compound,NNP-NNP,NNP,5,1
3159,13660.0,28,allowed,2,10,21,11,9,6,-8,19,his,Venezuela,PERSON,COUNTRY,DET,PROPN,poss,pobj,PRP$,NNP,6,1
3160,13678.0,30,died,25,2,29,27,1,0,23,4,Frank Baldino Jr,Philadelphia,PERSON-PERSON-PERSON,CITY,PROPN-PROPN-PROPN,PROPN,compound-compound-nsubj,pobj,NNP-NNP-NNP,NNP,3,1
3161,13683.0,53,stayed,50,2,38,36,1,14,48,-12,Countrywide,Full Spectrum Lending division,ORGANIZATION,ORGANIZATION-ORGANIZATION-ORGANIZATION-ORGANIZATION,PROPN,PROPN-PROPN-PROPN-NOUN,nsubj,compound-compound-compound-pobj,NNP,NNP-NNP-NNP-NN,8,1
3162,13686.0,48,CHONGQING,0,20,24,4,19,23,-20,24,She,organizing and leading a criminal organization,PERSON,CRIMINAL_CHARGE-CRIMINAL_CHARGE-CRIMINAL_CHARGE-CRIMINAL_CHARGE-CRIMINAL_CHARGE-CRIMINAL_CHARGE,PRON,VERB-CCONJ-VERB-DET-ADJ-NOUN,nsubjpass,pcomp-cc-conj-det-amod-dobj,PRP,VBG-CC-VBG-DT-JJ-NN,-1,1
3163,13707.0,28,was,1,25,22,-3,24,5,-24,21,he,justice bureau,PERSON,ORGANIZATION-ORGANIZATION,PRON,NOUN-NOUN,nsubjpass,compound-pobj,PRP,NN-NN,3,1
3164,13711.0,26,is,6,3,10,7,2,15,3,4,Progressive Democrats of America,PAC,ORGANIZATION-ORGANIZATION-ORGANIZATION-ORGANIZATION,ORGANIZATION,PROPN-PROPN-ADP-PROPN,PROPN,compound-nsubj-prep-pobj,attr,NNP-NNPS-IN-NNP,NNP,4,1
3165,13728.0,46,says,29,11,10,-1,10,35,18,-19,William Kunstler,attorney,PERSON-PERSON,TITLE,PROPN-PROPN,NOUN,compound-appos,pobj,NNP-NNP,NN,3,1
3166,13730.0,24,said,10,5,1,-4,4,22,5,-9,National Congress of American Indians,Johnson,ORGANIZATION-ORGANIZATION-ORGANIZATION-ORGANIZATION-ORGANIZATION,PERSON,PROPN-PROPN-ADP-PROPN-PROPN,PROPN,compound-pobj-prep-compound-pobj,nsubj,NNP-NNP-IN-NNP-NNPS,NNP,3,1
3167,13742.0,39,said,37,7,11,4,6,27,30,-26,he,Italian,PERSON,NATIONALITY,PRON,ADJ,nsubj,acomp,PRP,JJ,3,1
3168,13748.0,31,became,4,4,11,7,3,19,0,7,he,NASA,PERSON,ORGANIZATION,PRON,PROPN,nsubj,poss,PRP,NNP,5,1
3169,13763.0,42,convicted,2,9,36,27,8,5,-7,34,Mark Fisher,his,PERSON-PERSON,PERSON,PROPN-PROPN,DET,compound-pobj,poss,NNP-NNP,PRP$,8,1
3170,13768.0,51,said,12,1,9,8,0,41,11,-3,Adela Dworin,Jewish Patronage,PERSON-PERSON,ORGANIZATION-ORGANIZATION,PROPN-PROPN,ADJ-PROPN,compound-nsubj,amod-pobj,NNP-NNP,JJ-NNP,4,1
3171,13770.0,33,KARACHI,0,17,28,11,16,4,-17,28,Asia Bibi,insulting,PERSON-PERSON,CRIMINAL_CHARGE,PROPN-PROPN,VERB,compound-appos,pcomp,NNP-NNP,VBG,4,1
3172,13789.0,23,mutilated,6,8,3,-5,7,19,-2,-3,Samudio,murder,PERSON,CRIMINAL_CHARGE,PROPN,NOUN,poss,pobj,NNP,NN,4,1
3173,13792.0,28,appointed,9,25,21,-4,24,6,-16,12,Charles Ble Goude,human rights violations,PERSON-PERSON-PERSON,CRIMINAL_CHARGE-CRIMINAL_CHARGE-CRIMINAL_CHARGE,PROPN-PROPN-PROPN,ADJ-NOUN-NOUN,compound-compound-npadvmod,amod-compound-pobj,NNP-NNP-NNP,JJ-NNS-NNS,7,1
3174,13826.0,27,told,14,11,9,-2,10,17,3,-5,Third Guard Division,army,ORGANIZATION-ORGANIZATION-ORGANIZATION,ORGANIZATION,PROPN-PROPN-PROPN,NOUN,compound-compound-pobj,poss,NNP-NNP-NNP,NN,3,1
3175,13877.0,34,said,16,32,18,-14,31,15,-16,2,Mario Gonzalez,Central American Organization of the Fisheries,PERSON-PERSON,ORGANIZATION-ORGANIZATION-ORGANIZATION-ORGANIZATION-ORGANIZATION-ORGANIZATION,PROPN-PROPN,PROPN-PROPN-PROPN-ADP-DET-PROPN,compound-appos,compound-compound-nsubj-prep-det-pobj,NNP-NNP,NNP-NNP-NNP-IN-DT-NNPS,-1,1
3176,13879.0,34,said,16,32,31,-1,31,2,-16,15,Mario Gonzalez,director,PERSON-PERSON,TITLE,PROPN-PROPN,NOUN,compound-appos,compound,NNP-NNP,NN,2,1
3177,13880.0,40,had,10,3,7,4,2,32,7,-3,his,dentist,PERSON,TITLE,DET,NOUN,poss,compound,PRP$,NN,2,1
3178,14104.0,21,become,10,8,4,-4,7,16,2,-6,his,dentist,PERSON,TITLE,DET,NOUN,poss,nsubj,PRP$,NN,4,1
3179,13887.0,30,taken,14,4,24,20,3,5,10,10,Baldino,Cephalon,PERSON,ORGANIZATION,PROPN,PROPN,nsubj,poss,NNP,NNP,8,1
3180,13894.0,42,endeavor,2,34,29,-5,33,12,-32,27,National Energy Administration,a senior official,ORGANIZATION-ORGANIZATION-ORGANIZATION,PERSON-PERSON-PERSON,PROPN-PROPN-PROPN,DET-ADJ-NOUN,compound-compound-pobj,det-amod-appos,NNP-NNP-NNP,DT-JJ-NN,4,1
3181,13907.0,44,said,42,16,37,21,15,6,26,-5,HKI,Manhattan,ORGANIZATION,CITY,PROPN,PROPN,compound,pobj,NNP,NNP,8,1
3182,13908.0,19,hospitalized,3,11,17,6,10,1,-8,14,she,last week,PERSON,DATE-DATE,PRON,ADJ-NOUN,nsubjpass,amod-npadvmod,PRP,JJ-NN,2,1
3183,13923.0,37,starts,1,1,7,6,0,29,0,6,Heloise,Texas Mathworks,PERSON,ORGANIZATION-ORGANIZATION,PROPN,PROPN-PROPN,nsubj,compound-compound,NNP,NNP-NNP,2,1
3184,13924.0,32,said,15,3,9,6,2,22,12,-6,Chen Tao,China Youth University for Political Sciences,PERSON-PERSON,ORGANIZATION-ORGANIZATION-ORGANIZATION-ORGANIZATION-ORGANIZATION-ORGANIZATION,PROPN-PROPN,PROPN-PROPN-PROPN-ADP-PROPN-PROPN,compound-nsubj,compound-compound-pobj-prep-compound-pobj,NNP-NNP,NNP-NNP-NNP-IN-NNP-NNPS,4,1
3185,13927.0,23,said,10,20,12,-8,19,10,-10,2,National Restaurant Association,Steven C. Anderson,ORGANIZATION-ORGANIZATION-ORGANIZATION,PERSON-PERSON-PERSON,PROPN-PROPN-PROPN,PROPN-PROPN-PROPN,compound-compound-pobj,compound-compound-nsubj,NNP-NNP-NNP,NNP-NNP-NNP,6,1
3186,13937.0,27,convicted,2,6,24,18,5,2,-4,22,Tao,bribery,PERSON,CRIMINAL_CHARGE,PROPN,NOUN,conj,conj,NNP,NN,10,1
3187,13939.0,35,announced,2,17,1,-16,16,33,-15,-1,Mark Fisher,ABN Amro,PERSON-PERSON,ORGANIZATION-ORGANIZATION,PROPN-PROPN,PROPN-PROPN,compound-ROOT,compound-nsubj,NNP-NNP,NNP-NNP,-1,1
3188,13942.0,17,traveled,7,1,6,5,0,10,6,-1,Mamane,Claudie,PERSON,PERSON,PROPN,PROPN,nsubj,appos,NNP,NNP,3,1
3189,13943.0,25,información,15,1,6,5,0,18,14,-9,Rosen,New America Foundation,PERSON,ORGANIZATION-ORGANIZATION-ORGANIZATION,PROPN,PROPN-PROPN-PROPN,amod,compound-compound-dobj,NNP,NNP-NNP-NNP,2,1
3190,13958.0,29,is,6,1,5,4,0,23,5,-1,Pluribus,2009,ORGANIZATION,DATE,PROPN,NUM,nsubj,pobj,NNP,CD,4,1
3191,13960.0,31,sentenced,9,1,17,16,0,13,8,8,Asia Bibi,hanging,PERSON-PERSON,CAUSE_OF_DEATH,PROPN-PROPN,VERB,compound-nsubjpass,pcomp,NNP-NNP,VBG,2,1
3192,14009.0,18,called,1,10,6,-4,9,11,-9,5,his,Texas,PERSON,STATE_OR_PROVINCE,DET,PROPN,poss,pobj,PRP$,NNP,4,1
3193,14010.0,22,joins,2,1,12,11,0,9,1,10,Nir Rosen,New York,PERSON-PERSON,STATE_OR_PROVINCE-STATE_OR_PROVINCE,PROPN-PROPN,PROPN-PROPN,compound-nsubj,compound-pobj,NNP-NNP,NNP-NNP,6,1
3194,14014.0,29,testified,11,25,22,-3,24,6,-14,11,her,Denver,PERSON,CITY,PRON,PROPN,dobj,pobj,PRP,NNP,3,1
3195,14019.0,49,prompted,2,34,4,-30,33,44,-32,2,ADF,Yum Brands Inc.,ORGANIZATION,ORGANIZATION-ORGANIZATION-ORGANIZATION,PROPN,PROPN-PROPN-PROPN,compound,compound-compound-dobj,NNP,NNP-NNP-NNP,6,1
3196,14024.0,66,said,12,19,64,45,18,1,-7,52,he,El Salvador,PERSON,COUNTRY-COUNTRY,PRON,PROPN-PROPN,nsubj,compound-pobj,PRP,NNP-NNP,14,1
3197,14029.0,48,was,7,16,20,4,15,27,-9,13,Mark Fisher,19-year-old,PERSON-PERSON,DURATION,PROPN-PROPN,PROPN,compound-dobj,compound,NNP-NNP,NNP,4,1
3198,14034.0,32,used,2,4,27,23,3,4,-2,25,Gross,spying,PERSON,TITLE,PROPN,VERB,poss,pcomp,NNP,VBG,10,1
3199,14039.0,33,said,1,17,11,-6,16,21,-16,10,NDA,Britain,ORGANIZATION,COUNTRY,PROPN,PROPN,compound,poss,NNP,NNP,7,1
3200,14042.0,45,posted,3,1,29,28,0,15,2,26,Cerniglia,Joe,PERSON,PERSON,PROPN,PROPN,poss,poss,NNP,NNP,5,1
3201,14054.0,39,recalls,1,9,23,14,8,15,-8,22,his,California,PERSON,STATE_OR_PROVINCE,DET,PROPN,poss,appos,PRP$,NNP,2,1
3202,14386.0,39,recalls,1,9,23,14,8,15,-8,22,his,California,PERSON,STATE_OR_PROVINCE,DET,PROPN,poss,appos,PRP$,NNP,2,1
3203,14987.0,22,works,9,20,7,-13,19,14,-11,-2,his,California,PERSON,STATE_OR_PROVINCE,DET,PROPN,poss,appos,PRP$,NNP,6,1
3204,14066.0,27,said,8,6,4,-2,5,22,2,-4,Chen Tao,assistant,PERSON-PERSON,TITLE,PROPN-PROPN,NOUN,compound-appos,nsubj,NNP-NNP,NN,2,1
3205,14077.0,24,Court,4,20,10,-10,19,13,-16,6,his,protecting criminal gangs,PERSON,CRIMINAL_CHARGE-CRIMINAL_CHARGE-CRIMINAL_CHARGE,DET,VERB-ADJ-NOUN,poss,conj-amod-dobj,PRP$,VBG-JJ-NNS,6,1
3206,14079.0,42,fell,11,25,8,-17,24,33,-14,-3,Meredith Kercher,Italian,PERSON-PERSON,NATIONALITY,PROPN-PROPN,ADJ,compound-pobj,amod,NNP-NNP,JJ,6,1
3207,14112.0,43,said,21,20,19,-1,19,23,1,-2,Michael Lomax,President,PERSON-PERSON,TITLE,PROPN-PROPN,PROPN,compound-nsubj,compound,NNP-NNP,NNP,1,1
3208,14115.0,83,include,2,1,35,34,0,47,1,33,OANA,Jiji Press,ORGANIZATION,ORGANIZATION-ORGANIZATION,PROPN,PROPN-PROPN,compound,compound-conj,NNP,NNP-NNP,7,1
3209,14116.0,41,Prosecutor,0,15,23,8,14,17,-15,23,Daniels,multiple sharp force injuries,PERSON,CAUSE_OF_DEATH-CAUSE_OF_DEATH-CAUSE_OF_DEATH-CAUSE_OF_DEATH,PROPN,ADJ-ADJ-NOUN-NOUN,poss,amod-amod-compound-pobj,NNP,JJ-JJ-NN-NNS,8,1
3210,14131.0,29,believed,13,12,10,-2,11,18,1,-3,her,she,PERSON,PERSON,DET,PRON,poss,nsubj,PRP$,PRP,2,1
3211,14132.0,26,2007-12-18T10,0,9,22,13,8,3,-9,22,"THE GOOD BROKER , LLC",GA,ORGANIZATION-ORGANIZATION-ORGANIZATION-ORGANIZATION-ORGANIZATION,STATE_OR_PROVINCE,DET-ADJ-PROPN-PUNCT-PROPN,PROPN,det-amod-appos-punct-appos,conj,"DT-JJ-NNP-,-NNP",NNP,-1,1
3212,14135.0,39,found,6,21,15,-6,20,23,-15,9,Amanda Knox,Perugia,PERSON-PERSON,CITY,PROPN-PROPN,PROPN,compound-pobj,pobj,NNP-NNP,NNP,3,1
3213,14176.0,50,Football,0,5,8,3,4,41,-5,8,Miettinen,US,PERSON,COUNTRY,PROPN,PROPN,nsubj,compound,NNP,NNP,3,1
3214,14178.0,38,focuses,13,16,19,3,15,18,-3,6,his,Detroit News,PERSON,ORGANIZATION-ORGANIZATION,DET,PROPN-PROPN,poss,compound-pobj,PRP$,NNP-NNP,3,1
3215,14188.0,49,Chatellerault,0,24,14,-10,23,34,-24,14,New Fabris,1947,ORGANIZATION-ORGANIZATION,DATE,PROPN-PROPN,NUM,compound-nsubj,pobj,NNP-NNP,CD,3,1
3216,14189.0,25,disappeared,14,1,20,19,0,4,13,6,Eliza Samudio,Belo Horizonte,PERSON-PERSON,CITY-CITY,PROPN-PROPN,PROPN-PROPN,compound-nsubj,compound-pobj,NNP-NNP,NNP-NNP,1,1
3217,14195.0,38,dismissed,6,36,3,-33,35,34,-30,-3,Eliza Samudio,star,PERSON-PERSON,TITLE,PROPN-PROPN,NOUN,compound-appos,compound,NNP-NNP,NN,10,1
3218,14202.0,32,jailed,6,18,1,-17,17,30,-12,-5,her,Wen,PERSON,PERSON,DET,PROPN,poss,poss,PRP$,NNP,10,1
3219,14208.0,23,found,7,15,5,-10,14,17,-8,-2,her,teacher,PERSON,TITLE,DET,NOUN,poss,appos,PRP$,NN,3,1
3220,14217.0,41,says,2,4,13,9,3,27,-2,11,he,Havana,PERSON,LOCATION,PRON,PROPN,nsubj,pobj,PRP,NNP,2,1
3221,14232.0,23,draws,2,21,15,-6,20,7,-19,13,PSIA,Poverty and Social Impact Analysis,ORGANIZATION,ORGANIZATION-ORGANIZATION-ORGANIZATION-ORGANIZATION-ORGANIZATION,PROPN,PROPN-CCONJ-PROPN-PROPN-PROPN,ROOT,nmod-cc-compound-conj-pobj,NNP,NNP-CC-NNP-NNP-NNP,5,1
3222,14239.0,50,formed,1,3,49,46,2,0,-2,48,his,NavTeq,PERSON,ORGANIZATION,DET,PROPN,poss,pobj,PRP$,NNP,3,1
3223,14253.0,34,let,8,20,6,-14,19,27,-12,-2,Countrywide Financial Corp.,"1,000",ORGANIZATION-ORGANIZATION-ORGANIZATION,NUMBER,PROPN-PROPN-PROPN,NUM,compound-compound-pobj,nummod,NNP-NNP-NNP,CD,8,1
3224,14263.0,37,seen,14,1,6,5,0,30,13,-8,Joseph Cerniglia,owner,PERSON-PERSON,TITLE,PROPN-PROPN,NOUN,compound-nsubjpass,appos,NNP-NNP,NN,3,1
3225,14276.0,41,Hilliard,1,5,1,-4,4,39,-4,0,http://wwwrocketbootscomau,Robin Hilliard,ORGANIZATION,PERSON-PERSON,PROPN,PROPN-PROPN,nsubj,compound-ROOT,NNP,NNP-NNP,4,1
3226,14286.0,36,is,8,6,33,27,5,2,2,25,National Restaurant Association,13 million,ORGANIZATION-ORGANIZATION-ORGANIZATION,NUMBER-NUMBER,PROPN-PROPN-PROPN,NUM-NUM,compound-compound-nsubj,compound-nummod,NNP-NNP-NNP,CD-CD,9,1
3227,14294.0,48,named,34,44,40,-4,43,7,-10,6,Drawings Institute,Menil Collection,ORGANIZATION-ORGANIZATION,ORGANIZATION-ORGANIZATION,PROPN-PROPN,PROPN-PROPN,compound-pobj,compound-poss,NNP-NNP,NNP-NNP,1,1
3228,14307.0,45,racked,33,24,21,-3,23,23,9,-12,Countrywide Financial,Calif,ORGANIZATION-ORGANIZATION,STATE_OR_PROVINCE,PROPN-PROPN,PROPN,compound-compound,conj,NNP-NNP,NNP,3,1
3229,14342.0,31,said,29,24,29,5,23,1,5,0,his,doctor,PERSON,TITLE,DET,NOUN,poss,nsubj,PRP$,NN,5,1
3230,14347.0,50,told,22,1,8,7,0,41,21,-14,Adela Dworin,Temple Beth Shalom,PERSON-PERSON,ORGANIZATION-ORGANIZATION-ORGANIZATION,PROPN-PROPN,PROPN-PROPN-PROPN,compound-nsubj,compound-compound-pobj,NNP-NNP,NNP-NNP-NNP,5,1
3231,14396.0,40,Smith,2,27,34,7,26,5,-25,32,addressee,"proprietary , confidential or privileged information",ORGANIZATION,URL-URL-URL-URL-URL-URL,NOUN,ADJ-PUNCT-ADJ-CCONJ-ADJ-NOUN,pobj,amod-punct-conj-cc-conj-dobj,NN,"JJ-,-JJ-CC-JJ-NN",5,1
3232,14400.0,24,charged,14,3,8,5,2,15,11,-6,Jupp,Defense,PERSON,ORGANIZATION,PROPN,PROPN,poss,nmod,NNP,NNP,6,1
3233,14409.0,47,AFP,7,1,39,38,0,7,6,32,"Jerusalem , Sept 14 , 2009",Assaf Ramon,PERSON-PERSON-PERSON-PERSON-PERSON-PERSON,DATE-DATE,PROPN-PUNCT-PROPN-NUM-PUNCT-NUM,PROPN-PROPN,nsubj-punct-appos-nummod-punct-nummod,compound-poss,"NNP-,-NNP-CD-,-CD",NNP-NNP,-1,1
3234,14413.0,48,named,34,40,44,4,39,3,-6,10,Menil Collection,Drawings Institute,ORGANIZATION-ORGANIZATION,ORGANIZATION-ORGANIZATION,PROPN-PROPN,PROPN-PROPN,compound-poss,compound-pobj,NNP-NNP,NNP-NNP,1,1
3235,14419.0,37,said,35,27,31,4,26,5,8,-4,Mark Fisher,spokesman,PERSON-PERSON,TITLE,PROPN-PROPN,NOUN,compound-nsubj,appos,NNP-NNP,NN,2,1
3236,14430.0,11,is,1,1,10,9,0,0,0,9,He,Canada,PERSON,COUNTRY,PRON,PROPN,nsubj,pobj,PRP,NNP,4,1
3237,14437.0,42,traveled,11,1,5,4,0,36,10,-6,Knox,William Knox,PERSON,PERSON-PERSON,PROPN,PROPN-PROPN,poss,compound-appos,NNP,NNP-NNP,3,1
3238,14442.0,28,survived,3,13,12,-1,12,15,-10,9,Lange,Karen Lange,PERSON,PERSON-PERSON,PROPN,PROPN-PROPN,appos,compound-appos,NNP,NNP-NNP,2,1
3239,14443.0,48,freed,9,15,11,-4,14,36,-6,2,Vagni,Italian,PERSON,NATIONALITY,PROPN,PROPN,nsubjpass,amod,NNP,NNP,5,1
3240,14468.0,34,said,13,5,9,4,4,24,8,-4,National Restaurant Association,chief,ORGANIZATION-ORGANIZATION-ORGANIZATION,PERSON,PROPN-PROPN-PROPN,NOUN,compound-compound-poss,nsubj,NNP-NNP-NNP,NN,3,1
3241,14536.0,39,executed,12,14,37,23,13,1,-2,25,Wen Qiang,gang-related activities,PERSON-PERSON,CRIMINAL_CHARGE-CRIMINAL_CHARGE,PROPN-PROPN,ADJ-NOUN,compound-dobj,amod-conj,NNP-NNP,JJ-NNS,9,1
3242,14546.0,50,formed,1,3,43,40,2,6,-2,42,his,Chicago,PERSON,CITY,DET,PROPN,poss,pobj,PRP$,NNP,4,1
3243,14575.0,16,mentioned,4,11,16,5,10,-1,-7,12,Alan Gross,Md,PERSON-PERSON,STATE_OR_PROVINCE,PROPN-PROPN,PROPN,compound-attr,npadvmod,NNP-NNP,NNP,-1,1
3244,14581.0,32,say,7,7,1,-6,6,30,0,-6,Countrywide,Independent,ORGANIZATION,RELIGION,PROPN,ADJ,pobj,amod,NNP,JJ,1,1
3245,14589.0,49,charged,26,13,18,5,12,30,13,-8,Countrywide Financial Corp,California,ORGANIZATION-ORGANIZATION-ORGANIZATION,STATE_OR_PROVINCE,PROPN-PROPN-PROPN,PROPN,compound-compound-dobj,compound,NNP-NNP-NNP,NNP,4,1
3246,14605.0,21,stood,16,5,1,-4,4,19,11,-15,deputy police chief,Wen Qiang,PERSON-PERSON-PERSON,TITLE-TITLE,NOUN-NOUN-NOUN,PROPN-PROPN,compound-compound-appos,compound-nsubj,NN-NN-NN,NNP-NNP,2,1
3247,14606.0,37,said,13,7,1,-6,6,35,6,-12,the National Congress of American Indians,Robert Holden,ORGANIZATION-ORGANIZATION-ORGANIZATION-ORGANIZATION-ORGANIZATION-ORGANIZATION,PERSON-PERSON,DET-PROPN-PROPN-ADP-PROPN-PROPN,PROPN-PROPN,det-compound-pobj-prep-compound-pobj,compound-nsubj,DT-NNP-NNP-IN-NNP-NNPS,NNP-NNP,4,1
3248,14610.0,30,let,4,21,21,0,20,8,-17,17,Semen Gresik,Semen Padang,ORGANIZATION-ORGANIZATION,ORGANIZATION-ORGANIZATION,PROPN-PROPN,PROPN-PROPN,compound-compound,compound-appos,NNP-NNP,NNP-NNP,0,1
3249,14611.0,22,see,13,15,12,-3,14,9,-2,-1,Ahmed Rashid,Afghanistan,PERSON-PERSON,COUNTRY,PROPN-PROPN,PROPN,compound-nsubj,pobj,NNP-NNP,NNP,5,1
3250,14614.0,28,said,11,8,1,-7,7,26,3,-10,National Restaurant Association,Michael C Gibbons,ORGANIZATION-ORGANIZATION-ORGANIZATION,PERSON-PERSON-PERSON,PROPN-PROPN-PROPN,PROPN-PROPN-PROPN,compound-compound-pobj,compound-compound-nsubj,NNP-NNP-NNP,NNP-NNP-NNP,5,1
3251,14637.0,32,reprint,2,18,31,13,17,0,-16,29,American Free Press,D.C.,ORGANIZATION-ORGANIZATION-ORGANIZATION,LOCATION,PROPN-PROPN-PROPN,PROPN,compound-compound-pobj,appos,NNP-NNP-NNP,NNP,7,1
3252,14647.0,47,came,27,7,9,2,6,37,20,-18,Countrywide,America,ORGANIZATION,COUNTRY,PROPN,PROPN,pobj,poss,NNP,NNP,4,1
3253,14663.0,36,said,16,9,26,17,8,9,7,10,Countrywide,his,ORGANIZATION,PERSON,PROPN,DET,poss,poss,NNP,PRP$,11,1
3254,14674.0,38,told,22,6,2,-4,5,35,16,-20,she,Dominican,PERSON,NATIONALITY,PRON,ADJ,nsubj,amod,PRP,JJ,2,1
3255,14682.0,25,threat,9,14,3,-11,13,21,-5,-6,The factory,France,ORGANIZATION-ORGANIZATION,COUNTRY,DET-NOUN,PROPN,det-poss,npadvmod,DT-NN,NNP,4,1
3256,14690.0,17,said,2,7,11,4,6,5,-5,9,his,Perugia,PERSON,CITY,DET,PROPN,poss,pobj,PRP$,NNP,4,1
3257,14693.0,20,graduated,1,1,18,17,0,1,0,17,He,Temple University,PERSON,ORGANIZATION-ORGANIZATION,PRON,PROPN-PROPN,nsubj,compound-pobj,PRP,NNP-NNP,3,1
3258,14712.0,14,been,2,1,7,6,0,6,1,5,Graham,Vancouver,PERSON,CITY,PROPN,PROPN,nsubj,pobj,NNP,NNP,6,1
3259,14755.0,27,wondered,20,1,9,8,0,17,19,-11,She,David,PERSON,PERSON,PRON,PROPN,nsubj,appos,PRP,NNP,3,1
3260,14761.0,37,testified,12,19,29,10,18,7,-7,17,Graham,Whitehorse,PERSON,CITY,PROPN,PROPN,nsubj,pobj,NNP,NNP,4,1
3261,14767.0,32,said,10,1,6,5,0,25,9,-4,The boy,An van de Sande,PERSON-PERSON,PERSON-PERSON-PERSON-PERSON,DET-NOUN,DET-NOUN-X-PROPN,det-poss,det-compound-compound-appos,DT-NN,DT-NN-FW-NNP,3,1
3262,14777.0,44,offers,29,1,15,14,0,28,28,-14,He,reporter,PERSON,TITLE,PRON,NOUN,nsubj,poss,PRP,NN,7,1
3263,14786.0,14,was,1,1,11,10,0,2,0,10,He,Development Alternatives Inc.,PERSON,ORGANIZATION-ORGANIZATION-ORGANIZATION,PRON,PROPN-PROPN-PROPN,nsubj,compound-compound-oprd,PRP,NNP-NNP-NNP,6,1
3264,14800.0,57,told,1,21,26,5,20,30,-20,25,Alan P Gross,US Agency for International Development,PERSON-PERSON-PERSON,ORGANIZATION-ORGANIZATION-ORGANIZATION-ORGANIZATION-ORGANIZATION,PROPN-PROPN-PROPN,PROPN-PROPN-ADP-PROPN-PROPN,compound-compound-dobj,compound-appos-prep-compound-compound,NNP-NNP-NNP,NNP-NNP-IN-NNP-NNP,2,1
3265,14802.0,22,BEIJING,0,8,13,5,7,8,-8,13,The orchestra,1945,ORGANIZATION-ORGANIZATION,DATE,DET-NOUN,NUM,det-nsubjpass,pobj,DT-NN,CD,2,1
3266,14813.0,41,is,5,25,3,-22,24,37,-20,-2,she,Havana,PERSON,LOCATION,PRON,PROPN,nsubj,pobj,PRP,NNP,4,1
3267,14837.0,40,said,26,36,28,-8,35,11,-10,2,Urban League,Lorna Latham,ORGANIZATION-ORGANIZATION,PERSON-PERSON,PROPN-PROPN,PROPN-PROPN,compound-pobj,compound-nsubj,NNP-NNP,NNP-NNP,4,1
3268,14877.0,50,formed,1,30,43,13,29,6,-29,42,he,Chicago,PERSON,CITY,PRON,PROPN,nsubj,pobj,PRP,NNP,1,1
3269,14884.0,40,kidnapped,5,20,29,9,19,10,-15,24,he,Philippines,PERSON,COUNTRY,PRON,PROPN,nsubj,pobj,PRP,NNP,2,1
3270,14895.0,4,was,1,1,3,2,0,0,0,2,He,52,PERSON,NUMBER,PRON,NUM,nsubj,attr,PRP,CD,1,1
3271,14907.0,29,selected,6,4,17,13,3,11,2,11,Ilan Ramon,Israel,PERSON-PERSON,COUNTRY,PROPN-PROPN,PROPN,compound-nsubjpass,poss,NNP-NNP,NNP,6,1
3272,14908.0,32,serves,5,5,12,7,4,19,0,7,Alico,"12,500",ORGANIZATION,NUMBER,PROPN,NUM,nsubj,nummod,NNP,CD,2,1
3273,14926.0,33,detained,2,15,21,6,14,11,-13,19,his,46,PERSON,NUMBER,DET,NUM,poss,appos,PRP$,CD,2,1
3274,14934.0,12,Activist,3,9,1,-8,8,10,-6,-2,Urban League,Hugh,ORGANIZATION-ORGANIZATION,PERSON,PROPN-PROPN,PROPN,compound-pobj,compound,NNP-NNP,NNP,4,1
3275,14942.0,33,said,31,20,26,6,19,6,11,-5,Lomax,Georgia,PERSON,STATE_OR_PROVINCE,PROPN,PROPN,nsubj,poss,NNP,NNP,4,1
3276,14955.0,38,served,4,1,11,10,0,26,3,7,Wen,Chongqing Municipal,PERSON,ORGANIZATION-ORGANIZATION,PROPN,PROPN-PROPN,nsubj,compound-compound,NNP,NNP-NNP,7,1
3277,14956.0,10,'s,1,7,9,2,6,0,-6,8,Heloise,Abelard,PERSON,PERSON,PROPN,PROPN,conj,conj,NNP,NNP,4,1
3278,14983.0,36,detained,30,21,12,-9,20,23,9,-18,he,deputy director,PERSON,TITLE-TITLE,PRON,NOUN-NOUN,nsubj,compound-appos,PRP,NN-NN,3,1
3279,15001.0,12,remains,1,1,11,10,0,0,0,10,She,Ohio,PERSON,STATE_OR_PROVINCE,PRON,PROPN,nsubj,pobj,PRP,NNP,1,1
3280,15004.0,25,is,11,2,7,5,1,17,9,-4,Huntington Library,1919,ORGANIZATION-ORGANIZATION,DATE,PROPN-PROPN,NUM,compound-nsubj,pobj,NNP-NNP,CD,2,1
3281,15006.0,32,said,9,29,11,-18,28,20,-20,2,National Restaurant Association,Gerald A. Fernandez,ORGANIZATION-ORGANIZATION-ORGANIZATION,PERSON-PERSON-PERSON,PROPN-PROPN-PROPN,PROPN-PROPN-PROPN,compound-compound-pobj,compound-compound-nsubj,NNP-NNP-NNP,NNP-NNP-NNP,6,1
3282,15016.0,39,insisted,8,15,12,-3,14,26,-7,4,Amanda Knox,her,PERSON-PERSON,PERSON,PROPN-PROPN,DET,compound-appos,poss,NNP-NNP,PRP$,3,1
3283,15031.0,31,FREEDOMS,1,25,19,-6,24,11,-24,18,Wayne A. Holst,University of Chicago Divinity School,PERSON-PERSON-PERSON,ORGANIZATION-ORGANIZATION-ORGANIZATION-ORGANIZATION-ORGANIZATION,PROPN-PROPN-PROPN,PROPN-ADP-PROPN-PROPN-PROPN,compound-pobj-ROOT,appos-prep-compound-compound-pobj,NNP-NNP-NNP,NNP-IN-NNP-NNP-NNP,4,1
3284,15035.0,13,sat,6,4,9,5,3,3,2,3,Piedra,Miami,PERSON,CITY,PROPN,PROPN,nsubj,poss,NNP,NNP,6,1
3285,15038.0,47,is,17,1,9,8,0,37,16,-8,Ahmed Rashid,fellow,PERSON-PERSON,TITLE,PROPN-PROPN,NOUN,compound-nsubj,conj,NNP-NNP,NN,3,1
3286,15051.0,45,said,15,10,1,-9,9,43,5,-14,National Congress of American Indians,Jackson Slim Brossy,ORGANIZATION-ORGANIZATION-ORGANIZATION-ORGANIZATION-ORGANIZATION,PERSON-PERSON-PERSON,PROPN-PROPN-ADP-PROPN-PROPN,PROPN-PROPN-PROPN,compound-pobj-prep-compound-pobj,compound-compound-nsubj,NNP-NNP-IN-NNP-NNPS,NNP-NNP-NNP,4,1
3287,15056.0,26,is,10,10,24,14,9,1,0,14,ACSE,United States,ORGANIZATION,COUNTRY-COUNTRY,PROPN,PROPN-PROPN,nsubj,compound-pobj,NNP,NNP-NNP,7,1
3288,15103.0,27,urging,13,2,11,9,1,15,11,-2,ADF,Arizona,ORGANIZATION,STATE_OR_PROVINCE,PROPN,PROPN,nsubj,pobj,NNP,NNP,3,1
3289,15119.0,31,says,15,17,22,5,16,8,-2,7,Ilan Vilenda,soldier,PERSON-PERSON,TITLE,PROPN-PROPN,NOUN,compound-nsubj,appos,NNP-NNP,NN,2,1
3290,15138.0,41,said,7,1,6,5,0,34,6,-1,Jamie Leigh Jones,23,PERSON-PERSON-PERSON,NUMBER,PROPN-PROPN-PROPN,NUM,compound-compound-nsubj,appos,NNP-NNP-NNP,CD,3,1
3291,15146.0,46,iD8DBQFHIR5Iiz2i76ou9wQRAttYAKC8LcHQ2VZwNzzpkNZ12nyytxAKbgCfYOan,0,35,42,7,34,3,-35,42,Central American Parliament,Nidia Diaz,ORGANIZATION-ORGANIZATION-ORGANIZATION,PERSON-PERSON,ADJ-ADJ-PROPN,PROPN-PROPN,compound-compound-pobj,compound-appos,JJ-JJ-NNP,NNP-NNP,7,1
3292,15169.0,37,said,27,29,36,7,28,0,-2,9,Mark Fisher,Lloyds,PERSON-PERSON,ORGANIZATION,PROPN-PROPN,PROPN,compound-nsubj,pobj,NNP-NNP,NNP,4,1
3293,15183.0,21,said,1,11,5,-6,10,15,-10,4,her,his,PERSON,PERSON,DET,DET,poss,poss,PRP$,PRP$,3,1
3294,15192.0,72,fired,35,20,9,-11,19,62,15,-26,Sodini,shot to his head,PERSON,CAUSE_OF_DEATH-CAUSE_OF_DEATH-CAUSE_OF_DEATH-CAUSE_OF_DEATH,PROPN,NOUN-ADP-DET-NOUN,nsubj,pobj-prep-poss-pobj,NNP,NN-IN-PRP$-NN,6,1
3295,15194.0,35,include,9,11,4,-7,10,30,-2,-5,her,John Buffalo,PERSON,PERSON-PERSON,DET,PROPN-PROPN,poss,compound-pobj,PRP$,NNP-NNP,5,1
3296,15197.0,33,founded,6,3,9,6,2,23,3,3,High Point Church,2000,ORGANIZATION-ORGANIZATION-ORGANIZATION,DATE,PROPN-PROPN-PROPN,NUM,compound-compound-nsubjpass,pobj,NNP-NNP-NNP,CD,3,1
3297,15204.0,38,percent,1,14,14,0,13,23,-13,13,PATA,PATA,ORGANIZATION,ORGANIZATION,PROPN,PROPN,conj,conj,NNP,NNP,0,1
3298,15205.0,22,says,6,11,17,6,10,4,-5,11,Natalie Hagemo,Shelby LaFreniere,PERSON-PERSON,PERSON-PERSON,PROPN-PROPN,PROPN-PROPN,compound-pobj,compound-appos,NNP-NNP,NNP-NNP,2,1
3299,15233.0,28,hired,19,26,9,-17,25,18,-7,-10,Pauliina Miettien,Sky Blue FC,PERSON-PERSON,ORGANIZATION-ORGANIZATION-ORGANIZATION,PROPN-PROPN,PROPN-PROPN-PROPN,compound-appos,compound-compound-appos,NNP-NNP,NNP-NNP-NNP,7,1
3300,15235.0,29,dont,2,27,15,-12,26,13,-25,13,LIHOP,pearl harbor,ORGANIZATION,LOCATION-LOCATION,PROPN,NOUN-NOUN,compound,compound-pobj,NNP,NN-NN,7,1
3301,15254.0,20,said,1,8,6,-2,7,13,-7,5,his,supervisor,PERSON,TITLE,DET,NOUN,poss,nsubj,PRP$,NN,1,1
3302,15257.0,32,was,11,1,14,13,0,17,10,3,Mailer,high school art teacher,PERSON,TITLE-TITLE-TITLE-TITLE,PROPN,ADJ-NOUN-NOUN-NOUN,nsubj,amod-compound-compound-attr,NNP,JJ-NN-NN-NN,4,1
3303,15289.0,35,survives,1,32,1,-31,31,33,-31,0,Joseph I. Lange,Arnold,PERSON-PERSON-PERSON,PERSON,PROPN-PROPN-PROPN,PROPN,compound-compound-conj,nsubj,NNP-NNP-NNP,NNP,5,1
3304,15296.0,20,approved,4,7,3,-4,6,16,-3,-1,NDA,Government,ORGANIZATION,ORGANIZATION,PROPN,PROPN,poss,nsubj,NNP,NNP,4,1
3305,15299.0,40,had,10,26,8,-18,25,31,-16,-2,he,Anita Pandey,PERSON,PERSON-PERSON,PRON,PROPN-PROPN,nsubj,compound-appos,PRP,NNP-NNP,4,1
3306,15307.0,34,address,4,7,14,7,6,19,-3,10,National Urban League,St. Louis,ORGANIZATION-ORGANIZATION-ORGANIZATION,LOCATION-LOCATION,PROPN-PROPN-PROPN,PROPN-PROPN,compound-compound-poss,compound-pobj,NNP-NNP-NNP,NNP-NNP,4,1
3307,15321.0,21,testified,1,7,15,8,6,5,-6,14,his,Tufts University School of Dental Medicine,PERSON,ORGANIZATION-ORGANIZATION-ORGANIZATION-ORGANIZATION-ORGANIZATION-ORGANIZATION,DET,PROPN-PROPN-PROPN-ADP-PROPN-PROPN,poss,compound-compound-pobj-prep-compound-pobj,PRP$,NNP-NNP-NNP-IN-NNP-NNP,6,1
3308,15337.0,9,opens,4,1,4,3,0,4,3,0,PATA Travel Mart,2007,ORGANIZATION-ORGANIZATION-ORGANIZATION,DATE,PROPN-PROPN-PROPN,NUM,compound-compound-nsubj,appos,NNP-NNP-NNP,CD,2,1
3309,15340.0,18,said,10,16,8,-8,15,9,-6,-2,his,prosecutor,PERSON,TITLE,DET,NOUN,poss,compound,PRP$,NN,5,1
3310,15342.0,53,said,10,40,6,-34,39,46,-30,-4,PATA,China,ORGANIZATION,COUNTRY,PROPN,PROPN,compound,poss,NNP,NNP,11,1
3311,15352.0,32,said,17,10,1,-9,9,30,7,-16,Matteo Messina Denaro,Italian,PERSON-PERSON-PERSON,NATIONALITY,PROPN-PROPN-PROPN,ADJ,compound-compound-pobj,amod,NNP-NNP-NNP,JJ,4,1
3312,15357.0,27,identified,2,19,8,-11,18,18,-17,6,Robben Van Achout,Dutch,PERSON-PERSON-PERSON,NATIONALITY,PROPN-PROPN-PROPN,ADJ,compound-compound-pobj,amod,NNP-NNP-NNP,JJ,6,1
3313,15364.0,38,said,35,2,1,-1,1,36,33,-34,Andrew E Lange,Physicist,PERSON-PERSON-PERSON,TITLE,PROPN-PROPN-PROPN,PROPN,compound-compound-nsubj,compound,NNP-NNP-NNP,NNP,2,1
3314,15369.0,23,is,1,1,4,3,0,18,0,3,He,author,PERSON,TITLE,PRON,NOUN,nsubj,attr,PRP,NN,2,1
3315,15394.0,48,wrote,43,23,18,-5,22,29,20,-25,he,Pittsburgh,PERSON,CITY,PRON,PROPN,nsubj,compound,PRP,NNP,3,1
3316,15431.0,29,believed,13,12,5,-7,11,23,1,-8,her,Sarah Kunstler,PERSON,PERSON-PERSON,DET,PROPN-PROPN,poss,compound-nsubj,PRP$,NNP-NNP,4,1
3317,15432.0,43,Tribeca,0,1,5,4,0,37,-1,5,Tribeca Enterprises,Beijing,ORGANIZATION-ORGANIZATION,CITY,PROPN-PROPN,PROPN,compound-pobj,nsubj,NNP-NNPS,NNP,4,1
3318,15449.0,24,tells,7,5,1,-4,4,22,2,-6,Arline Kercher,Kercher,PERSON-PERSON,PERSON,PROPN-PROPN,PROPN,compound-appos,poss,NNP-NNP,NNP,3,1
3319,15453.0,43,said,22,14,12,-2,13,30,8,-10,Amanda Knox,U.S.,PERSON-PERSON,COUNTRY,PROPN-PROPN,PROPN,compound-pobj,compound,NNP-NNP,NNP,1,1
3320,15466.0,49,killed,28,14,2,-12,13,46,14,-26,Ilan Ramon,Assaf Ramon,PERSON-PERSON,PERSON-PERSON,PROPN-PROPN,PROPN-PROPN,compound-appos,compound-nsubjpass,NNP-NNP,NNP-NNP,4,1
3321,15479.0,25,recovering,2,7,5,-2,6,19,-5,3,his,surgery,PERSON,CAUSE_OF_DEATH,DET,NOUN,poss,pobj,PRP$,NN,2,1
3322,15484.0,35,served,1,1,4,3,0,30,0,3,He,vice director,PERSON,TITLE-TITLE,PRON,NOUN-NOUN,nsubj,compound-pobj,PRP,NN-NN,2,1
3323,15500.0,27,wondered,20,23,9,-14,22,17,-3,-11,she,David,PERSON,PERSON,PRON,PROPN,nsubj,appos,PRP,NNP,-1,1
3324,15505.0,48,comes,2,20,19,-1,19,28,-18,17,Meredith Kercher,21-year-old,PERSON-PERSON,DURATION,PROPN-PROPN,NUM,compound-pobj,compound,NNP-NNP,CD,1,1
0,0.0,41,resigned,2,11,1,-10,10,39,-9,-1,All Basotho Convention,Tom Thabane,ORGANIZATION-ORGANIZATION-ORGANIZATION,PERSON-PERSON,PROPN-PROPN-PROPN,PROPN-PROPN,compound-compound-dobj,compound-nsubj,NNP-NNP-NNP,NNP-NNP,4,1
1,6255.0,41,promises,2,24,29,5,23,11,-22,27,All Basotho Convention,Tom Thabane,ORGANIZATION-ORGANIZATION-ORGANIZATION,PERSON-PERSON,DET-PROPN-PROPN,PROPN-PROPN,det-compound-nsubj,compound-pobj,DT-NNP-NNP,NNP-NNP,2,1
2,7001.0,44,told,41,34,28,-6,33,15,7,-13,All Basotho Convention,Tom Thabane,ORGANIZATION-ORGANIZATION-ORGANIZATION,PERSON-PERSON,PROPN-PROPN-PROPN,PROPN-PROPN,compound-compound-pobj,compound-nsubj,NNP-NNP-NNP,NNP-NNP,6,1
3,7483.0,43,is,4,22,29,7,21,13,-18,25,All Basotho Convention,Tom Thabane,ORGANIZATION-ORGANIZATION-ORGANIZATION,PERSON-PERSON,DET-PROPN-PROPN,PROPN-PROPN,det-compound-conj,compound-attr,DT-NNP-NNP,NNP-NNP,10,1
4,8567.0,20,set,7,4,1,-3,3,18,3,-6,All Basotho Convention,Tom Thabane,ORGANIZATION-ORGANIZATION-ORGANIZATION,PERSON-PERSON,PROPN-PROPN-PROPN,PROPN-PROPN,det-compound-nsubj,compound-poss,NNP-NNP-NNP,NNP-NNP,3,1
5,38063.0,34,faces,8,16,22,6,15,11,-8,14,All Basotho Convention,Tom Thabane,ORGANIZATION-ORGANIZATION-ORGANIZATION,PERSON-PERSON,DET-PROPN-PROPN,PROPN-PROPN,det-compound-compound,compound-pobj,DT-NNP-NNP,NNP-NNP,2,1
6,44819.0,40,comes,12,16,31,15,15,8,-4,19,All Basotho Convention,Tom Thabane,ORGANIZATION-ORGANIZATION-ORGANIZATION,PERSON-PERSON,PROPN-PROPN-PROPN,PROPN-PROPN,compound-compound-pobj,compound-pobj,NNP-NNP-NNP,NNP-NNP,7,1
7,47744.0,40,said,14,8,1,-7,7,38,6,-13,All Basotho Convention,Tom Thabane,ORGANIZATION-ORGANIZATION-ORGANIZATION,PERSON-PERSON,DET-PROPN-PROPN,PROPN-PROPN,det-compound-appos,compound-nsubj,DT-NNP-NNP,NNP-NNP,3,1
8,48193.0,45,complained,14,8,1,-7,7,43,6,-13,All Basotho Convention,Tom Thabane,ORGANIZATION-ORGANIZATION-ORGANIZATION,PERSON-PERSON,PROPN-PROPN-PROPN,PROPN-PROPN,compound-compound-dobj,compound-nsubj,NNP-NNP-NNP,NNP-NNP,3,1
9,48436.0,30,said,14,8,1,-7,7,28,6,-13,All Basotho Convention,Tom Thabane,ORGANIZATION-ORGANIZATION-ORGANIZATION,PERSON-PERSON,PROPN-PROPN-PROPN,PROPN-PROPN,compound-compound-dobj,compound-nsubj,NNP-NNP-NNP,NNP-NNP,3,1
10,53197.0,30,came,16,9,13,4,8,16,7,-3,All Basotho Convention,Tom Thabane,ORGANIZATION-ORGANIZATION-ORGANIZATION,PERSON-PERSON,DET-PROPN-PROPN,PROPN-PROPN,det-compound-appos,compound-appos,DT-NNP-NNP,NNP-NNP,2,1
11,8.0,43,looking,3,1,31,30,0,11,2,28,Olivia Palermo,Gossip Girl,PERSON-PERSON,ORGANIZATION-ORGANIZATION,PROPN-PROPN,PROPN-PROPN,compound-nsubj,compound-poss,NNP-NNP,NNP-NNP,-1,1
12,9.0,40,say,5,14,20,6,13,19,-9,15,Lashkar-e-Taiba,Army of the Pure,ORGANIZATION,ORGANIZATION-ORGANIZATION-ORGANIZATION-ORGANIZATION,PROPN,PROPN-ADP-DET-PROPN,pobj,dobj-prep-det-pobj,NNP,NNP-IN-DT-NNP,4,1
13,26265.0,51,suspected,2,11,15,4,10,35,-9,13,Lashkar-e-Taiba,Army of the Pure,ORGANIZATION,ORGANIZATION-ORGANIZATION-ORGANIZATION-ORGANIZATION,PROPN,PROPN-ADP-DET-PROPN,pobj,conj-prep-det-pobj,NNP,NNP-IN-DT-NNP,3,1
14,61419.0,35,resigned,7,13,15,2,12,19,-6,8,Lashkar-e-Taiba,Army of the Pure,ORGANIZATION,ORGANIZATION-ORGANIZATION-ORGANIZATION-ORGANIZATION,PROPN,PROPN-ADP-DET-PROPN,compound,pobj-prep-det-compound,NNP,NNP-IN-DT-NNP,2,1
15,64048.0,31,established,10,1,5,4,0,25,9,-5,Lashkar-e-Taiba,Army of the Pure,ORGANIZATION,ORGANIZATION-ORGANIZATION-ORGANIZATION-ORGANIZATION,PROPN,PROPN-ADP-DET-PROPN,nsubjpass,dobj-prep-det-pobj,NNP,NNP-IN-DT-NNP,3,1
16,14.0,7,Pratt,1,1,4,3,0,2,0,3,Spencer Pratt,Beverly Hills,PERSON-PERSON,CITY-CITY,PROPN-PROPN,PROPN-PROPN,compound-ROOT,compound-appos,NNP-NNP,NNP-NNP,2,1
17,16.0,66,survived,12,11,29,18,10,36,1,17,Kaiser,Robert G,PERSON,PERSON-PERSON,PROPN,PROPN-PROPN,nsubjpass,compound-appos,NNP,NNP-NNP,4,1
18,22.0,41,*,0,2,21,19,1,19,-2,21,Britney,Jayden,PERSON,PERSON,PROPN,PROPN,poss,conj,NNP,NNP,5,1
19,23.0,27,asking,14,1,10,9,0,16,13,-4,Donald Wildmon,American Family Association,PERSON-PERSON,ORGANIZATION-ORGANIZATION-ORGANIZATION,PROPN-PROPN,PROPN-PROPN-PROPN,compound-nsubj,compound-compound-pobj,NNP-NNP,NNP-NNP-NNP,4,1
20,9461.0,22,is,7,15,19,4,14,2,-8,12,Donald Wildmon,American Family Association,PERSON-PERSON,ORGANIZATION-ORGANIZATION-ORGANIZATION,PROPN-PROPN,PROPN-PROPN-PROPN,compound-appos,compound-compound-pobj,NNP-NNP,NNP-NNP-NNP,3,1
21,9732.0,13,piled,10,3,7,4,2,5,7,-3,Donald Wildmon,American Family Association,PERSON-PERSON,ORGANIZATION-ORGANIZATION-ORGANIZATION,PROPN-PROPN,PROPN-PROPN-PROPN,compound-nsubj,compound-compound-pobj,NNP-NNP,NNP-NNP-NNP,3,1
22,12595.0,14,joined,10,1,4,3,0,9,9,-6,Donald Wildmon,American Family Association,PERSON-PERSON,ORGANIZATION-ORGANIZATION-ORGANIZATION,PROPN-PROPN,PROPN-PROPN-PROPN,compound-poss,compound-compound-compound,NNP-NNP,NNP-NNP-NNP,2,1
23,16615.0,60,confesses,28,12,19,7,11,40,16,-9,Donald Wildmon,American Family Association,PERSON-PERSON,ORGANIZATION-ORGANIZATION-ORGANIZATION,PROPN-PROPN,PROPN-PROPN-PROPN,compound-appos,compound-compound-pobj,NNP-NNP,NNP-NNP-NNP,4,1
24,18540.0,25,UTC,2,5,19,14,4,5,-3,17,Donald Wildmon,American Family Association,PERSON-PERSON,ORGANIZATION-ORGANIZATION-ORGANIZATION,PROPN-PROPN,PROPN-PROPN-PROPN,compound-ROOT,compound-compound-pobj,NNP-NNP,NNP-NNP-NNP,5,1
25,28098.0,49,mailed,13,4,10,6,3,38,9,-3,Donald Wildmon,American Family Association,PERSON-PERSON,ORGANIZATION-ORGANIZATION-ORGANIZATION,PROPN-PROPN,PROPN-PROPN-PROPN,compound-nsubj,compound-compound-pobj,NNP-NNP,NNP-NNP-NNP,4,1
26,37040.0,30,Huckabee,1,8,14,6,7,15,-7,13,Donald Wildmon,American Family Association,PERSON-PERSON,ORGANIZATION-ORGANIZATION-ORGANIZATION,PROPN-PROPN,PROPN-PROPN-PROPN,compound-pobj,compound-compound-pobj,NNP-NNP,NNP-NNP-NNP,4,1
27,48365.0,34,said,14,7,11,4,6,22,7,-3,Donald Wildmon,American Family Association,PERSON-PERSON,ORGANIZATION-ORGANIZATION-ORGANIZATION,PROPN-PROPN,PROPN-PROPN-PROPN,compound-appos,compound-compound-pobj,NNP-NNP,NNP-NNP-NNP,3,1
28,61944.0,37,announced,10,9,5,-4,8,31,1,-5,Donald Wildmon,American Family Association,PERSON-PERSON,ORGANIZATION-ORGANIZATION-ORGANIZATION,PROPN-PROPN,PROPN-PROPN-PROPN,compound-nsubj,compound-compound-compound,NNP-NNP,NNP-NNP-NNP,3,1
29,29.0,35,be,25,3,2,-1,2,32,22,-23,Fuller,creator,PERSON,TITLE,PROPN,NOUN,nsubj,compound,NNP,NN,2,1
30,42.0,24,issued,16,4,14,10,3,9,12,-2,Steve McPherson,Tom Hoberman,PERSON-PERSON,PERSON-PERSON,PROPN-PROPN,PROPN-PROPN,compound-pobj,compound-appos,NNP-NNP,NNP-NNP,3,1
31,44.0,36,been,5,4,2,-2,3,33,1,-3,Boyle,Catholic,PERSON,RELIGION,PROPN,PROPN,nsubj,compound,NNP,NNP,3,1
32,47.0,49,was,23,9,12,3,8,36,14,-11,Kim,25-year-old,PERSON,NUMBER,PROPN,NUM,pobj,appos,NNP,CD,4,1
33,52.0,60,survived,2,11,31,20,10,28,-9,29,Josephine Robinson McNair,Robin Lee Howell,PERSON-PERSON-PERSON,PERSON-PERSON-PERSON,PROPN-PROPN-PROPN,PROPN-PROPN-PROPN,compound-compound-appos,compound-compound-conj,NNP-NNP-NNP,NNP-NNP-NNP,5,1
34,58.0,42,Mujahid,1,11,7,-4,10,34,-10,6,PRC,Popular Resistance Committee,ORGANIZATION,ORGANIZATION-ORGANIZATION-ORGANIZATION,PROPN,PROPN-PROPN-PROPN,compound,compound-compound-pobj,NNP,NNP-NNP-NNP,6,1
35,61.0,41,seeks,3,31,2,-29,30,38,-28,-1,Barbara Boxer,Sen,PERSON-PERSON,ORGANIZATION,PROPN-PROPN,PROPN,compound-nsubj,compound,NNP-NNP,NNP,4,1
36,43495.0,57,Labels,0,3,52,49,2,4,-3,52,Barbara Boxer,Sen,PERSON-PERSON,TITLE,PROPN-PROPN,PROPN,compound-nsubj,compound,NNP-NNP,NNP,9,1
37,67896.0,31,jumped,6,2,1,-1,1,29,4,-5,Barbara Boxer,Sen,PERSON-PERSON,TITLE,PROPN-PROPN,PROPN,compound-nsubj,compound,NNP-NNP,NNP,1,1
38,74.0,43,laying,22,13,6,-7,12,36,9,-16,Britney Spears,Los Angeles,PERSON-PERSON,CITY-CITY,PROPN-PROPN,PROPN-PROPN,compound-nsubj,compound-compound,NNP-NNPS,NNP-NNP,4,1
39,77.0,40,predicted,15,6,9,3,5,30,9,-6,Al Hubbard,chairman,PERSON-PERSON,TITLE,PROPN-PROPN,NOUN,compound-nsubj,appos,NNP-NNP,NN,2,1
40,3976.0,21,seemed,1,10,14,4,9,6,-9,13,Al Hubbard,chairman,PERSON-PERSON,TITLE,PROPN-PROPN,NOUN,compound-pobj,appos,NNP-NNP,NN,2,1
41,25913.0,43,plans,13,1,5,4,0,37,12,-8,Al Hubbard,chairman,PERSON-PERSON,TITLE,PROPN-PROPN,NOUN,compound-nsubj,appos,NNP-NNP,NN,2,1
42,31647.0,45,plans,15,1,5,4,0,39,14,-10,Al Hubbard,chairman,PERSON-PERSON,TITLE,PROPN-PROPN,NOUN,compound-nsubj,appos,NNP-NNP,NN,2,1
43,52965.0,33,predicted,11,1,5,4,0,27,10,-6,Al Hubbard,chairman,PERSON-PERSON,TITLE,PROPN-PROPN,NOUN,compound-nsubj,appos,NNP-NNP,NN,2,1
44,78.0,4,Foundation,1,1,4,3,0,-1,0,3,Barnes Foundation,http://www.barnesfoundation.org/,ORGANIZATION-ORGANIZATION,URL,PROPN-PROPN,X,compound-ROOT,appos,NNP-NNP,ADD,-1,1
45,81.0,55,occupies,20,7,14,7,6,40,13,-6,Carolyn Goodman,Las Vegas,PERSON-PERSON,CITY-CITY,PROPN-PROPN,PROPN-PROPN,compound-pobj,compound-compound,NNP-NNP,NNP-NNP,4,1
46,88.0,39,holds,3,26,38,12,25,0,-23,35,Ferrara,Bianconeri,PERSON,ORGANIZATION,PROPN,PROPN,nsubj,pobj,NNP,NNP,6,1
47,90.0,34,point,7,32,31,-1,31,2,-25,24,Richard Lindzen,professor,PERSON-PERSON,TITLE,PROPN-PROPN,NOUN,compound-pobj,compound,NNP-NNP,NN,2,1
48,22106.0,43,had,7,34,40,6,33,2,-27,33,Richard Lindzen,professor,PERSON-PERSON,TITLE,PROPN-PROPN,NOUN,compound-conj,appos,NNP-NNP,NN,2,1
49,93.0,36,Football,0,6,6,0,5,29,-6,6,Blackburn Rovers,Blackburn,ORGANIZATION-ORGANIZATION,ORGANIZATION,PROPN-PROPN,PROPN,compound-nsubj,compound,NNP-NNPS,NNP,0,1
50,95.0,15,played,2,2,5,3,1,9,0,3,Scheider,police chief,PERSON,TITLE-TITLE,PROPN,NOUN-NOUN,nsubj,compound-dobj,NNP,NN-NN,1,1
51,98.0,16,dies,13,4,3,-1,3,12,9,-10,Teddy Kollek,Mayor,PERSON-PERSON,TITLE,PROPN-PROPN,PROPN,compound-nsubj,compound,NNP-NNP,NNP,1,1
52,58201.0,44,transformed,16,4,3,-1,3,40,12,-13,Teddy Kollek,Mayor,PERSON-PERSON,TITLE,PROPN-PROPN,PROPN,compound-nsubj,compound,NNP-NNP,NNP,1,1
53,99.0,38,died,36,1,34,33,0,3,35,-2,William Anderson,Tennessee,PERSON-PERSON,STATE_OR_PROVINCE,PROPN-PROPN,PROPN,compound-nsubj,pobj,NNP-NNP,NNP,2,1
54,101.0,36,are,6,26,6,-20,25,29,-20,0,Noordhoff Craniofacial Foundation,TOAID,ORGANIZATION-ORGANIZATION-ORGANIZATION,ORGANIZATION,PROPN-PROPN-PROPN,PROPN,compound-compound-conj,dobj,NNP-NNP-NNP,NNP,5,1
55,104.0,46,argued,12,7,9,2,6,36,5,-3,FEC,Trevor Potter,ORGANIZATION,PERSON-PERSON,PROPN,PROPN-PROPN,compound,compound-appos,NNP,NNP-NNP,1,1
56,27819.0,27,said,11,6,8,2,5,18,5,-3,FEC,Trevor Potter,ORGANIZATION,PERSON-PERSON,PROPN,PROPN-PROPN,compound,compound-appos,NNP,NNP-NNP,1,1
57,48380.0,28,said,11,6,8,2,5,19,5,-3,FEC,Trevor Potter,ORGANIZATION,PERSON-PERSON,PROPN,PROPN-PROPN,compound,compound-appos,NNP,NNP-NNP,1,1
58,106.0,24,grew,13,13,22,9,12,1,0,9,Negroponte,United States,PERSON,COUNTRY-COUNTRY,PROPN,PROPN-PROPN,nsubj,compound-conj,NNP,NNP-NNP,4,1
59,108.0,26,said,18,20,23,3,19,2,-2,5,SLDN,C Dixon Osburn,ORGANIZATION,PERSON-PERSON-PERSON,PROPN,PROPN-PROPN-PROPN,compound,compound-compound-nsubj,NNP,NNP-NNP-NNP,4,1
60,109.0,41,confers,5,20,19,-1,19,21,-15,14,Noordhoff Craniofacial Foundation,Samuel Noordhoff,ORGANIZATION-ORGANIZATION-ORGANIZATION,PERSON-PERSON,PROPN-PROPN-PROPN,PROPN-PROPN,compound-compound-pobj,compound-pobj,NNP-NNP-NNP,NNP-NNP,2,1
61,110.0,27,represents,16,4,7,3,3,19,12,-9,ITW,Glenview,ORGANIZATION,CITY,PROPN,PROPN,pobj,npadvmod,NNP,NNP,3,1
62,114.0,38,taught,16,3,8,5,2,29,13,-8,George Young,Holy Temple Baptist Church,PERSON-PERSON,ORGANIZATION-ORGANIZATION-ORGANIZATION-ORGANIZATION,PROPN-PROPN,PROPN-PROPN-PROPN-PROPN,compound-nsubj,compound-compound-compound-pobj,NNP-NNP,NNP-NNP-NNP-NNP,4,1
63,142.0,28,encouraged,1,15,11,-4,14,16,-14,10,Chinese Communist Party,National Congress,ORGANIZATION-ORGANIZATION-ORGANIZATION,ORGANIZATION-ORGANIZATION,PROPN-PROPN-PROPN,PROPN-PROPN,compound-compound-pobj,compound-pobj,NNP-NNP-NNP,NNP-NNP,3,1
64,152.0,48,mention,19,13,4,-9,12,43,6,-15,Korean Central News Agency,North Korea,ORGANIZATION-ORGANIZATION-ORGANIZATION-ORGANIZATION,COUNTRY-COUNTRY,PROPN-PROPN-PROPN-PROPN,PROPN-PROPN,compound-compound-compound-pobj,compound-pobj,NNP-NNP-NNP-NNP,NNP-NNP,6,1
65,7563.0,47,made,3,31,22,-9,30,24,-28,19,Korean Central News Agency,North Korea,ORGANIZATION-ORGANIZATION-ORGANIZATION-ORGANIZATION,COUNTRY-COUNTRY,PROPN-PROPN-PROPN-PROPN,PROPN-PROPN,compound-compound-compound-appos,compound-poss,NNP-NNP-NNP-NNP,NNP-NNP,7,1
66,10322.0,24,said,22,19,15,-4,18,8,3,-7,Korean Central News Agency,North Korea,ORGANIZATION-ORGANIZATION-ORGANIZATION-ORGANIZATION,COUNTRY-COUNTRY,PROPN-PROPN-PROPN-PROPN,PROPN-PROPN,compound-compound-compound-nsubj,compound-poss,NNP-NNP-NNP-NNP,NNP-NNP,2,1
67,40112.0,44,said,36,33,1,-32,32,42,3,-35,Korean Central News Agency,North Korea,ORGANIZATION-ORGANIZATION-ORGANIZATION-ORGANIZATION,COUNTRY-COUNTRY,PROPN-PROPN-PROPN-PROPN,PROPN-PROPN,compound-compound-compound-nsubj,compound-poss,NNP-NNP-NNP-NNP,NNP-NNP,6,1
68,169.0,31,said,15,29,21,-8,28,9,-14,6,RIA Novosti,Church,ORGANIZATION-ORGANIZATION,ORGANIZATION,PROPN-PROPN,PROPN,compound-pobj,compound,NNP-NNP,NNP,7,1
69,171.0,48,Messing,1,8,4,-4,7,43,-7,3,Chris Ivery,Ellen Pompeo,PERSON-PERSON,PERSON-PERSON,PROPN-PROPN,PROPN-PROPN,compound-conj,compound-appos,NNP-NNP,NNP-NNP,1,1
70,795.0,18,married,3,5,1,-4,4,16,-2,-2,Chris Ivery,Ellen Pompeo,PERSON-PERSON,PERSON-PERSON,PROPN-PROPN,PROPN-PROPN,compound-compound,compound-nsubj,NNP-NNP,NNP-NNP,3,1
71,12305.0,57,married,19,21,17,-4,20,39,-2,-2,Chris Ivery,Ellen Pompeo,PERSON-PERSON,PERSON-PERSON,PROPN-PROPN,PROPN-PROPN,compound-compound,compound-pobj,NNP-NNP,NNP-NNP,6,1
72,176.0,28,borrowed,1,6,11,5,5,16,-5,10,Ownit Mortgage Solutions,California,ORGANIZATION-ORGANIZATION-ORGANIZATION,STATE_OR_PROVINCE,PROPN-PROPN-PROPN,PROPN,compound-compound-pobj,compound,NNP-NNP-NNPS,NNP,2,1
73,181.0,64,Koong-lian,2,58,51,-7,57,12,-56,49,Mainland Affairs Council,Liu Te-shun,ORGANIZATION-ORGANIZATION-ORGANIZATION,PERSON-PERSON,PROPN-PROPN-PROPN,PROPN-PROPN,compound-compound-pobj,compound-nsubj,NNP-NNPS-NNP,NNP-NNP,6,1
74,16183.0,52,-RRB-,1,9,17,8,8,34,-8,16,Mainland Affairs Council,Liu Te-shun,ORGANIZATION-ORGANIZATION-ORGANIZATION,PERSON-PERSON,PROPN-PROPN-PROPN,PROPN-PROPN,compound-compound-appos,compound-nsubj,NNP-NNPS-NNP,NNP-NNP,-1,1
75,29663.0,45,doing,4,33,41,8,32,3,-29,37,Mainland Affairs Council,Liu Te-shun,ORGANIZATION-ORGANIZATION-ORGANIZATION,PERSON-PERSON,PROPN-PROPN-PROPN,PROPN-PROPN,compound-compound-appos,compound-nsubj,NNP-NNPS-NNP,NNP-NNP,-1,1
76,42342.0,72,Taipei,0,63,68,5,62,3,-63,68,Mainland Affairs Council,Liu Te-shun,ORGANIZATION-ORGANIZATION-ORGANIZATION,PERSON-PERSON,PROPN-PROPN-PROPN,PROPN-PROPN,compound-compound-compound,compound-nsubj,NNP-NNPS-NNP,NNP-NNP,15,1
77,195.0,24,is,1,9,17,8,8,6,-8,16,New Jerusalem Foundation,Olmert,ORGANIZATION-ORGANIZATION-ORGANIZATION,PERSON,PROPN-PROPN-PROPN,PROPN,compound-compound-pobj,pobj,NNP-NNP-NNP,NNP,6,1
78,13802.0,35,began,3,10,29,19,9,5,-7,26,New Jerusalem Foundation,Olmert,ORGANIZATION-ORGANIZATION-ORGANIZATION,PERSON,PROPN-PROPN-PROPN,PROPN,compound-compound-pobj,poss,NNP-NNP-NNP,NNP,15,1
79,32672.0,24,is,1,9,17,8,8,6,-8,16,New Jerusalem Foundation,Olmert,ORGANIZATION-ORGANIZATION-ORGANIZATION,PERSON,PROPN-PROPN-PROPN,PROPN,compound-compound-pobj,pobj,NNP-NNP-NNP,NNP,6,1
80,197.0,45,said,42,19,19,0,18,25,23,-23,Taiwan Research Institute,Taiwan,ORGANIZATION-ORGANIZATION-ORGANIZATION,COUNTRY,PROPN-PROPN-PROPN,PROPN,compound-compound-pobj,nsubj,NNP-NNP-NNP,NNP,0,1
81,6267.0,29,said,15,3,3,0,2,25,12,-12,Taiwan Research Institute,Taiwan,ORGANIZATION-ORGANIZATION-ORGANIZATION,COUNTRY,PROPN-PROPN-PROPN,PROPN,compound-compound-pobj,poss,NNP-NNP-NNP,NNP,0,1
82,7398.0,38,predicted,34,1,1,0,0,36,33,-33,Taiwan Research Institute,Taiwan,ORGANIZATION-ORGANIZATION-ORGANIZATION,COUNTRY,PROPN-PROPN-PROPN,PROPN,compound-compound-nsubj,poss,NNP-NNP-NNP,NNP,0,1
83,43298.0,81,said,1,24,24,0,23,56,-23,23,Taiwan Research Institute,Taiwan,ORGANIZATION-ORGANIZATION-ORGANIZATION,COUNTRY,PROPN-PROPN-PROPN,PROPN,compound-compound-pobj,pobj,NNP-NNP-NNP,NNP,0,1
84,46465.0,57,said,35,1,1,0,0,55,34,-34,Taiwan Research Institute,Taiwan,ORGANIZATION-ORGANIZATION-ORGANIZATION,COUNTRY,PROPN-PROPN-PROPN,PROPN,compound-compound-pobj,poss,NNP-NNP-NNP,NNP,0,1
85,48185.0,45,Institute,2,1,1,0,0,43,1,-1,Taiwan Research Institute,Taiwan,ORGANIZATION-ORGANIZATION-ORGANIZATION,COUNTRY,PROPN-PROPN-PROPN,PROPN,compound-compound-ROOT,poss,NNP-NNP-NNP,NNP,0,1
86,54501.0,41,said,10,7,7,0,6,33,3,-3,Taiwan Research Institute,Taiwan,ORGANIZATION-ORGANIZATION-ORGANIZATION,COUNTRY,PROPN-PROPN-PROPN,PROPN,compound-compound-pobj,pobj,NNP-NNP-NNP,NNP,0,1
87,203.0,30,is,19,4,16,12,3,13,15,-3,Watson,captain,PERSON,TITLE,PROPN,NOUN,nsubj,poss,NNP,NN,5,1
88,206.0,48,said,45,42,35,-7,41,12,3,-10,American Beverage Association,Kevin Keane,ORGANIZATION-ORGANIZATION-ORGANIZATION,PERSON-PERSON,PROPN-PROPN-PROPN,PROPN-PROPN,compound-compound-pobj,compound-appos,NNP-NNP-NNP,NNP-NNP,5,1
89,1254.0,44,said,9,22,11,-11,21,32,-13,2,American Beverage Association,Kevin Keane,ORGANIZATION-ORGANIZATION-ORGANIZATION,PERSON-PERSON,PROPN-PROPN-PROPN,PROPN-PROPN,compound-compound-pobj,compound-nsubj,NNP-NNP-NNP,NNP-NNP,5,1
90,35808.0,42,said,31,28,12,-16,27,29,3,-19,American Beverage Association,Kevin Keane,ORGANIZATION-ORGANIZATION-ORGANIZATION,PERSON-PERSON,PROPN-PROPN-PROPN,PROPN-PROPN,compound-compound-pobj,compound-appos,NNP-NNP-NNP,NNP-NNP,5,1
91,39481.0,46,said,22,33,24,-9,32,21,-11,2,American Beverage Association,Kevin Keane,ORGANIZATION-ORGANIZATION-ORGANIZATION,PERSON-PERSON,PROPN-PROPN-PROPN,PROPN-PROPN,compound-compound-pobj,compound-nsubj,NNP-NNP-NNP,NNP-NNP,5,1
92,45316.0,25,said,12,9,1,-8,8,23,3,-11,American Beverage Association,Kevin Keane,ORGANIZATION-ORGANIZATION-ORGANIZATION,PERSON-PERSON,PROPN-PROPN-PROPN,PROPN-PROPN,compound-compound-pobj,compound-nsubj,NNP-NNP-NNP,NNP-NNP,4,1
93,208.0,25,said,22,9,21,12,8,3,13,-1,Czech National Bank,Zdenek Tuma,ORGANIZATION-ORGANIZATION-ORGANIZATION,PERSON-PERSON,PROPN-PROPN-PROPN,PROPN-PROPN,compound-compound-compound,compound-nsubj,NNP-NNP-NNP,NNP-NNP,4,1
94,216.0,26,Jr.,2,14,8,-6,13,17,-12,6,MECO,Manila Economic and Cultural Office,ORGANIZATION,ORGANIZATION-ORGANIZATION-ORGANIZATION-ORGANIZATION-ORGANIZATION,PROPN,PROPN-PROPN-CCONJ-PROPN-PROPN,compound,nmod-nmod-cc-conj-pobj,NNP,NNP-NNP-CC-NNP-NNP,5,1
95,4908.0,58,said,36,10,48,38,9,9,26,12,MECO,Manila Economic and Cultural Office,ORGANIZATION,ORGANIZATION-ORGANIZATION-ORGANIZATION-ORGANIZATION-ORGANIZATION,PROPN,PROPN-PROPN-CCONJ-PROPN-PROPN,compound,nmod-nmod-cc-conj-pobj,NNP,NNP-NNP-CC-NNP-NNP,11,1
96,6342.0,39,improve,6,35,29,-6,34,9,-29,23,MECO,Manila Economic and Cultural Office,ORGANIZATION,ORGANIZATION-ORGANIZATION-ORGANIZATION-ORGANIZATION-ORGANIZATION,PROPN,PROPN-PROPN-CCONJ-PROPN-PROPN,compound,nmod-nmod-cc-conj-pobj,NNP,NNP-NNP-CC-NNP-NNP,-1,1
97,11160.0,45,cast,7,42,36,-6,41,8,-35,29,MECO,Manila Economic and Cultural Office,ORGANIZATION,ORGANIZATION-ORGANIZATION-ORGANIZATION-ORGANIZATION-ORGANIZATION,PROPN,PROPN-PROPN-CCONJ-PROPN-PROPN,compound,nmod-amod-cc-conj-appos,NNP,NNP-NNP-CC-NNP-NNP,5,1
98,11713.0,36,Neddo,1,15,9,-6,14,26,-14,8,MECO,Manila Economic and Cultural Office,ORGANIZATION,ORGANIZATION-ORGANIZATION-ORGANIZATION-ORGANIZATION-ORGANIZATION,PROPN,PROPN-PROPN-CCONJ-PROPN-PROPN,compound,nmod-nmod-cc-conj-pobj,NNP,NNP-NNP-CC-NNP-NNP,5,1
99,31577.0,59,said,39,57,51,-6,56,7,-18,12,MECO,Manila Economic and Cultural Office,ORGANIZATION,ORGANIZATION-ORGANIZATION-ORGANIZATION-ORGANIZATION-ORGANIZATION,PROPN,PROPN-PROPN-CCONJ-PROPN-PROPN,compound,nmod-nmod-cc-conj-pobj,NNP,NNP-NNP-CC-NNP-NNP,-1,1
100,36658.0,44,held,6,16,10,-6,15,33,-10,4,MECO,Manila Economic and Cultural Office,ORGANIZATION,ORGANIZATION-ORGANIZATION-ORGANIZATION-ORGANIZATION-ORGANIZATION,PROPN,PROPN-PROPN-CCONJ-PROPN-PROPN,compound,nmod-nmod-cc-conj-pobj,NNP,NNP-NNP-CC-NNP-NNP,-1,1
101,41214.0,38,said,20,34,28,-6,33,9,-14,8,MECO,Manila Economic and Cultural Office,ORGANIZATION,ORGANIZATION-ORGANIZATION-ORGANIZATION-ORGANIZATION-ORGANIZATION,PROPN,PROPN-PROPN-CCONJ-PROPN-PROPN,compound,nmod-nmod-cc-conj-pobj,NNP,NNP-NNP-CC-NNP-NNP,6,1
102,43597.0,63,said,29,47,41,-6,46,21,-18,12,MECO,Manila Economic and Cultural Office,ORGANIZATION,ORGANIZATION-ORGANIZATION-ORGANIZATION-ORGANIZATION-ORGANIZATION,PROPN,PROPN-PROPN-CCONJ-PROPN-PROPN,compound,nmod-nmod-cc-conj-pobj,NNP,NNP-NNP-CC-NNP-NNP,7,1
103,55231.0,36,was,11,30,24,-6,29,11,-19,13,MECO,Manila Economic and Cultural Office,ORGANIZATION,ORGANIZATION-ORGANIZATION-ORGANIZATION-ORGANIZATION-ORGANIZATION,PROPN,PROPN-PROPN-CCONJ-PROPN-PROPN,compound,nmod-nmod-cc-conj-pobj,NNP,NNP-NNP-CC-NNP-NNP,8,1
104,63686.0,35,appealed,12,8,2,-6,7,32,4,-10,MECO,Manila Economic and Cultural Office,ORGANIZATION,ORGANIZATION-ORGANIZATION-ORGANIZATION-ORGANIZATION-ORGANIZATION,PROPN,PROPN-PROPN-CCONJ-PROPN-PROPN,compound,nmod-nmod-cc-conj-compound,NNP,NNP-NNP-CC-NNP-NNP,3,1
105,223.0,41,said,18,1,10,9,0,30,17,-8,Julian Bond,National Association for the Advancement of Colored People,PERSON-PERSON,ORGANIZATION-ORGANIZATION-ORGANIZATION-ORGANIZATION-ORGANIZATION-ORGANIZATION-ORGANIZATION-ORGANIZATION,PROPN-PROPN,PROPN-PROPN-ADP-DET-PROPN-ADP-PROPN-PROPN,compound-nsubj,compound-pobj-prep-det-pobj-prep-compound-pobj,NNP-NNP,NNP-NNP-IN-DT-NNP-IN-NNP-NNPS,5,1
106,45266.0,44,said,39,27,22,-5,26,21,12,-17,Julian Bond,National Association for the Advancement of Colored People,PERSON-PERSON,ORGANIZATION-ORGANIZATION-ORGANIZATION-ORGANIZATION-ORGANIZATION-ORGANIZATION-ORGANIZATION-ORGANIZATION,PROPN-PROPN,PROPN-PROPN-ADP-DET-PROPN-ADP-PROPN-PROPN,compound-nsubj,compound-pobj-prep-det-pobj-prep-compound-pobj,NNP-NNP,NNP-NNP-IN-DT-NNP-IN-NNP-NNPS,3,1
107,45849.0,40,was,15,1,7,6,0,32,14,-8,Julian Bond,National Association for the Advancement of Colored People,PERSON-PERSON,ORGANIZATION-ORGANIZATION-ORGANIZATION-ORGANIZATION-ORGANIZATION-ORGANIZATION-ORGANIZATION-ORGANIZATION,PROPN-PROPN,PROPN-PROPN-ADP-DET-PROPN-ADP-PROPN-PROPN,compound-nsubj,compound-pobj-prep-det-pobj-prep-compound-pobj,NNP-NNP,NNP-NNP-IN-DT-NNP-IN-NNP-NNPS,3,1
108,54049.0,45,wants,2,1,10,9,0,34,1,8,Julian Bond,National Association for the Advancement of Colored People,PERSON-PERSON,ORGANIZATION-ORGANIZATION-ORGANIZATION-ORGANIZATION-ORGANIZATION-ORGANIZATION-ORGANIZATION-ORGANIZATION,PROPN-PROPN,PROPN-PROPN-ADP-DET-PROPN-ADP-PROPN-PROPN,compound-nsubj,compound-pobj-prep-det-pobj-prep-compound-pobj,NNP-NNP,NNP-NNP-IN-DT-NNP-IN-NNP-NNPS,6,1
109,229.0,33,said,5,4,1,-3,3,31,1,-4,Philip Chen,Cathay Pacific,PERSON-PERSON,ORGANIZATION-ORGANIZATION,PROPN-PROPN,PROPN-PROPN,compound-nsubj,compound-nsubj,NNP-NNP,NNP-NNP,2,1
110,982.0,42,appointed,7,1,28,27,0,13,6,21,Philip Chen,Cathay Pacific,PERSON-PERSON,ORGANIZATION-ORGANIZATION,PROPN-PROPN,PROPN-PROPN,compound-nsubjpass,compound-pobj,NNP-NNP,NNP-NNP,4,1
111,16681.0,41,said,6,5,1,-4,4,39,1,-5,Philip Chen,Cathay Pacific,PERSON-PERSON,ORGANIZATION-ORGANIZATION,PROPN-PROPN,PROPN-PROPN,compound-nsubj,compound-poss,NNP-NNP,NNP-NNP,2,1
112,16739.0,51,said,6,5,1,-4,4,49,1,-5,Philip Chen,Cathay Pacific,PERSON-PERSON,ORGANIZATION-ORGANIZATION,PROPN-PROPN,PROPN-PROPN,compound-nsubj,compound-compound,NNP-NNP,NNP-NNP,2,1
113,17955.0,21,said,13,19,15,-4,18,5,-6,2,Philip Chen,Cathay Pacific,PERSON-PERSON,ORGANIZATION-ORGANIZATION,PROPN-PROPN,PROPN-PROPN,compound-nsubj,compound-compound,NNP-NNP,NNP-NNP,3,1
114,29473.0,39,made,15,14,10,-4,13,28,1,-5,Philip Chen,Cathay Pacific,PERSON-PERSON,ORGANIZATION-ORGANIZATION,PROPN-PROPN,PROPN-PROPN,compound-nsubj,compound-compound,NNP-NNP,NNP-NNP,2,1
115,30001.0,41,said,6,5,1,-4,4,39,1,-5,Philip Chen,Cathay Pacific,PERSON-PERSON,ORGANIZATION-ORGANIZATION,PROPN-PROPN,PROPN-PROPN,compound-nsubj,compound-compound,NNP-NNP,NNP-NNP,2,1
116,52913.0,25,said,12,1,9,8,0,15,11,-3,Philip Chen,Cathay Pacific,PERSON-PERSON,ORGANIZATION-ORGANIZATION,PROPN-PROPN,PROPN-PROPN,compound-nsubj,compound-pobj,NNP-NNP,NNP-NNP,4,1
117,54261.0,46,presented,7,5,1,-4,4,44,2,-6,Philip Chen,Cathay Pacific,PERSON-PERSON,ORGANIZATION-ORGANIZATION,PROPN-PROPN,PROPN-PROPN,compound-nsubj,compound-compound,NNP-NNP,NNP-NNP,2,1
118,60381.0,31,said,6,5,1,-4,4,29,1,-5,Philip Chen,Cathay Pacific,PERSON-PERSON,ORGANIZATION-ORGANIZATION,PROPN-PROPN,PROPN-PROPN,compound-nsubj,compound-compound,NNP-NNP,NNP-NNP,2,1
119,60386.0,34,signed,18,8,1,-7,7,32,10,-17,Philip Chen,Cathay Pacific,PERSON-PERSON,ORGANIZATION-ORGANIZATION,PROPN-PROPN,PROPN-PROPN,compound-appos,compound-compound,NNP-NNP,NNP-NNP,2,1
120,60812.0,33,said,5,4,1,-3,3,31,1,-4,Philip Chen,Cathay Pacific,PERSON-PERSON,ORGANIZATION-ORGANIZATION,PROPN-PROPN,PROPN-PROPN,compound-nsubj,compound-compound,NNP-NNP,NNP-NNP,2,1
121,65206.0,34,were,11,32,28,-4,31,5,-21,17,Philip Chen,Cathay Pacific,PERSON-PERSON,ORGANIZATION-ORGANIZATION,PROPN-PROPN,PROPN-PROPN,compound-conj,compound-compound,NNP-NNP,NNP-NNP,2,1
122,231.0,39,gone,13,20,34,14,19,4,-7,21,BNC Mortgage,"1,200",ORGANIZATION-ORGANIZATION,NUMBER,PROPN-PROPN,NUM,compound-pobj,nummod,NNP-NNP,CD,4,1
123,237.0,27,ANAHEIM,0,14,18,4,13,8,-14,18,Red Sox,American League Division Series,ORGANIZATION-ORGANIZATION,ORGANIZATION-ORGANIZATION-ORGANIZATION-ORGANIZATION,PROPN-PROPN,PROPN-PROPN-PROPN-PROPN,compound-conj,compound-compound-compound-dobj,NNP-NNPS,NNP-NNP-NNP-NNP,8,1
124,238.0,6,Network,3,1,6,5,0,-1,2,3,Servicemembers Legal Defense Network,http://www.sldn.org/,ORGANIZATION-ORGANIZATION-ORGANIZATION-ORGANIZATION,URL,PROPN-PROPN-PROPN-PROPN,X,compound-compound-compound-ROOT,ROOT,NNP-NNP-NNP-NNP,ADD,-1,1
125,242.0,30,Beyonce,0,1,3,2,0,26,-1,3,Beyonce,Jay-Z,PERSON,PERSON,PROPN,PROPN,ROOT,compound,NNP,NNP,3,1
126,245.0,28,opened,12,10,6,-4,9,21,2,-6,KKL,Kinmen Kaoliang Liquor,ORGANIZATION,ORGANIZATION-ORGANIZATION-ORGANIZATION,PROPN,PROPN-PROPN-PROPN,compound,compound-compound-compound,NNP,NNP-NNP-NNP,4,1
127,247.0,33,elected,6,14,2,-12,13,30,-8,-4,his,army,PERSON,ORGANIZATION,DET,NOUN,poss,compound,PRP$,NN,4,1
128,252.0,43,Is,1,6,15,9,5,27,-5,14,Institute for Diversity and Ethics in Sport,University of Central Florida,ORGANIZATION-ORGANIZATION-ORGANIZATION-ORGANIZATION-ORGANIZATION-ORGANIZATION-ORGANIZATION,ORGANIZATION-ORGANIZATION-ORGANIZATION-ORGANIZATION,PROPN-ADP-PROPN-CCONJ-PROPN-ADP-PROPN,PROPN-ADP-PROPN-PROPN,pobj-prep-pobj-cc-conj-prep-pobj,pobj-prep-compound-pobj,NNP-IN-NNP-CC-NNP-IN-NNP,NNP-IN-NNP-NNP,4,1
129,1561.0,20,conducted,3,7,16,9,6,3,-4,13,Institute for Diversity and Ethics in Sport,University of Central Florida,ORGANIZATION-ORGANIZATION-ORGANIZATION-ORGANIZATION-ORGANIZATION-ORGANIZATION-ORGANIZATION,ORGANIZATION-ORGANIZATION-ORGANIZATION-ORGANIZATION,PROPN-ADP-PROPN-CCONJ-PROPN-ADP-PROPN,PROPN-ADP-PROPN-PROPN,pobj-prep-pobj-cc-conj-prep-pobj,pobj-prep-compound-pobj,NNP-IN-NNP-CC-NNP-IN-NNP,NNP-IN-NNP-NNP,4,1
130,2201.0,52,put,26,13,22,9,12,29,13,-4,Institute for Diversity and Ethics in Sport,University of Central Florida,ORGANIZATION-ORGANIZATION-ORGANIZATION-ORGANIZATION-ORGANIZATION-ORGANIZATION-ORGANIZATION,ORGANIZATION-ORGANIZATION-ORGANIZATION-ORGANIZATION,PROPN-ADP-PROPN-CCONJ-PROPN-ADP-PROPN,PROPN-ADP-PROPN-PROPN,pobj-prep-pobj-cc-conj-prep-pobj,pobj-prep-compound-pobj,NNP-IN-NNP-CC-NNP-IN-NNP,NNP-IN-NNP-NNP,4,1
131,10102.0,40,said,5,14,23,9,13,16,-9,18,Institute for Diversity and Ethics in Sport,University of Central Florida,ORGANIZATION-ORGANIZATION-ORGANIZATION-ORGANIZATION-ORGANIZATION-ORGANIZATION-ORGANIZATION,ORGANIZATION-ORGANIZATION-ORGANIZATION-ORGANIZATION,PROPN-ADP-PROPN-CCONJ-PROPN-ADP-PROPN,PROPN-ADP-PROPN-PROPN,pobj-prep-pobj-cc-conj-prep-pobj,pobj-prep-compound-pobj,NNP-IN-NNP-CC-NNP-IN-NNP,NNP-IN-NNP-NNP,4,1
132,13255.0,36,received,2,23,32,9,22,3,-21,30,Institute for Diversity and Ethics in Sport,University of Central Florida,ORGANIZATION-ORGANIZATION-ORGANIZATION-ORGANIZATION-ORGANIZATION-ORGANIZATION-ORGANIZATION,ORGANIZATION-ORGANIZATION-ORGANIZATION-ORGANIZATION,PROPN-ADP-PROPN-CCONJ-PROPN-ADP-PROPN,PROPN-ADP-PROPN-PROPN,pobj-prep-pobj-cc-conj-prep-pobj,pobj-prep-compound-pobj,NNP-IN-NNP-CC-NNP-IN-NNP,NNP-IN-NNP-NNP,2,1
133,34789.0,40,were,11,27,36,9,26,3,-16,25,Institute for Diversity and Ethics in Sport,University of Central Florida,ORGANIZATION-ORGANIZATION-ORGANIZATION-ORGANIZATION-ORGANIZATION-ORGANIZATION-ORGANIZATION,ORGANIZATION-ORGANIZATION-ORGANIZATION-ORGANIZATION,PROPN-ADP-PROPN-CCONJ-PROPN-ADP-PROPN,PROPN-ADP-PROPN-PROPN,pobj-prep-pobj-cc-conj-prep-pobj,pobj-prep-compound-pobj,NNP-IN-NNP-CC-NNP-IN-NNP,NNP-IN-NNP-NNP,6,1
134,39541.0,46,said,21,8,17,9,7,28,13,-4,Institute for Diversity and Ethics in Sport,University of Central Florida,ORGANIZATION-ORGANIZATION-ORGANIZATION-ORGANIZATION-ORGANIZATION-ORGANIZATION-ORGANIZATION,ORGANIZATION-ORGANIZATION-ORGANIZATION-ORGANIZATION,PROPN-ADP-PROPN-CCONJ-PROPN-ADP-PROPN,PROPN-ADP-PROPN-PROPN,pobj-prep-pobj-cc-conj-prep-pobj,pobj-prep-compound-pobj,NNP-IN-NNP-CC-NNP-IN-NNP,NNP-IN-NNP-NNP,6,1
135,49030.0,58,'s,2,38,47,9,37,10,-36,45,Institute for Diversity and Ethics in Sport,University of Central Florida,ORGANIZATION-ORGANIZATION-ORGANIZATION-ORGANIZATION-ORGANIZATION-ORGANIZATION-ORGANIZATION,ORGANIZATION-ORGANIZATION-ORGANIZATION-ORGANIZATION,PROPN-ADP-PROPN-CCONJ-PROPN-ADP-PROPN,PROPN-ADP-PROPN-PROPN,pobj-prep-pobj-cc-conj-prep-pobj,pobj-prep-compound-pobj,NNP-IN-NNP-CC-NNP-IN-NNP,NNP-IN-NNP-NNP,2,1
136,50672.0,66,issued,11,43,52,9,42,13,-32,41,Institute for Diversity and Ethics in Sport,University of Central Florida,ORGANIZATION-ORGANIZATION-ORGANIZATION-ORGANIZATION-ORGANIZATION-ORGANIZATION-ORGANIZATION,ORGANIZATION-ORGANIZATION-ORGANIZATION-ORGANIZATION,PROPN-ADP-PROPN-CCONJ-PROPN-ADP-PROPN,PROPN-ADP-PROPN-PROPN,pobj-prep-pobj-cc-conj-prep-pobj,pobj-prep-compound-pobj,NNP-IN-NNP-CC-NNP-IN-NNP,NNP-IN-NNP-NNP,4,1
137,55907.0,47,released,14,2,11,9,1,35,12,-3,Institute for Diversity and Ethics in Sport,University of Central Florida,ORGANIZATION-ORGANIZATION-ORGANIZATION-ORGANIZATION-ORGANIZATION-ORGANIZATION-ORGANIZATION,ORGANIZATION-ORGANIZATION-ORGANIZATION-ORGANIZATION,PROPN-ADP-PROPN-CCONJ-PROPN-ADP-PROPN,PROPN-ADP-PROPN-PROPN,nsubj-prep-pobj-cc-conj-prep-pobj,pobj-prep-compound-pobj,NNP-IN-NNP-CC-NNP-IN-NNP,NNP-IN-NNP-NNP,4,1
138,58172.0,29,earned,1,22,17,-5,21,11,-21,16,Institute for Diversity and Ethics in Sport,University of Central Florida,ORGANIZATION-ORGANIZATION-ORGANIZATION-ORGANIZATION-ORGANIZATION-ORGANIZATION-ORGANIZATION,ORGANIZATION-ORGANIZATION-ORGANIZATION-ORGANIZATION,PROPN-ADP-PROPN-CCONJ-PROPN-ADP-PROPN,PROPN-ADP-PROPN-PROPN,pobj-prep-pobj-cc-conj-prep-pobj,pobj-prep-compound-poss,NNP-IN-NNP-CC-NNP-IN-NNP,NNP-IN-NNP-NNP,2,1
139,63442.0,32,said,11,19,28,9,18,3,-8,17,Institute for Diversity and Ethics in Sport,University of Central Florida,ORGANIZATION-ORGANIZATION-ORGANIZATION-ORGANIZATION-ORGANIZATION-ORGANIZATION-ORGANIZATION,ORGANIZATION-ORGANIZATION-ORGANIZATION-ORGANIZATION,PROPN-ADP-PROPN-CCONJ-PROPN-ADP-PROPN,PROPN-ADP-PROPN-PROPN,pobj-prep-pobj-cc-conj-prep-pobj,pobj-prep-compound-pobj,NNP-IN-NNP-CC-NNP-IN-NNP,NNP-IN-NNP-NNP,4,1
140,253.0,34,pitted,2,30,32,2,29,1,-28,30,Fyffes,David McCann,ORGANIZATION,PERSON-PERSON,PROPN,PROPN-PROPN,compound,compound-appos,NNP,NNP-NNP,1,1
141,255.0,47,sentenced,1,7,6,-1,6,40,-6,5,Hashim Ahmad al-Tai,Sultan,PERSON-PERSON-PERSON,TITLE,PROPN-PROPN-PROPN,PROPN,compound-attr-punct,compound,NNP-NNP-NNP,NNP,-1,1
142,1606.0,58,were,53,12,11,-1,11,46,41,-42,Hashim Ahmad al-Tai,Sultan,PERSON-PERSON-PERSON,TITLE,PROPN-PROPN-PROPN,PROPN,compound-nsubj-punct,compound,NNP-NNP-NNP,NNP,2,1
143,8327.0,23,Ahmad,3,3,2,-1,2,20,0,-1,Hashim Ahmad al-Tai,Sultan,PERSON-PERSON-PERSON,TITLE,PROPN-PROPN-PROPN,PROPN,compound-ROOT-punct,compound,NNP-NNP-NNP,NNP,2,1
144,9549.0,63,include,2,13,12,-1,12,50,-11,10,Hashim Ahmad al-Tai,Sultan,PERSON-PERSON-PERSON,TITLE,PROPN-PROPN-PROPN,PROPN,compound-appos-punct,compound,NNP-NNP-NNP,NNP,3,1
145,35141.0,22,_,0,3,2,-1,2,19,-3,2,Hashim Ahmad al-Tai,Sultan,PERSON-PERSON-PERSON,TITLE,PROPN-PROPN-PROPN,PROPN,compound-dobj-punct,compound,NNP-NNP-NNP,NNP,-1,1
146,35374.0,64,said,62,12,11,-1,11,52,50,-51,Hashim Ahmad al-Tai,Sultan,PERSON-PERSON-PERSON,TITLE,PROPN-PROPN-PROPN,PROPN,compound-nsubj-punct,compound,NNP-NNP-NNP,NNP,2,1
147,43840.0,34,Ahmad,2,2,1,-1,1,32,0,-1,Hashim Ahmad al-Tai,Sultan,PERSON-PERSON-PERSON,TITLE,PROPN-PROPN-PROPN,PROPN,compound-ROOT-ROOT,compound,NNP-NNP-NNP,NNP,2,1
148,49404.0,69,sentenced,49,8,7,-1,7,61,41,-42,Hashim Ahmad al-Tai,Sultan,PERSON-PERSON-PERSON,TITLE,PROPN-PROPN-PROPN,PROPN,compound-appos-punct,compound,NNP-NNP-NNP,NNP,3,1
149,256.0,34,said,2,24,23,-1,23,10,-22,21,National Action Network,his,ORGANIZATION-ORGANIZATION-ORGANIZATION,PERSON,PROPN-PROPN-PROPN,DET,compound-compound-compound,poss,NNP-NNP-NNP,PRP$,2,1
150,2985.0,37,called,25,23,22,-1,22,14,2,-3,National Action Network,his,ORGANIZATION-ORGANIZATION-ORGANIZATION,PERSON,PROPN-PROPN-PROPN,DET,compound-compound-conj,poss,NNP-NNP-NNP,PRP$,2,1
151,17396.0,30,was,1,25,22,-3,24,7,-24,21,National Action Network,his,ORGANIZATION-ORGANIZATION-ORGANIZATION,PERSON,PROPN-PROPN-PROPN,DET,compound-compound-pobj,poss,NNP-NNP-NNP,PRP$,2,1
152,19753.0,33,were,25,23,22,-1,22,10,2,-3,National Action Network,his,ORGANIZATION-ORGANIZATION-ORGANIZATION,PERSON,PROPN-PROPN-PROPN,DET,compound-compound-conj,poss,NNP-NNP-NNP,PRP$,2,1
153,57359.0,27,said,10,16,15,-1,15,11,-6,5,National Action Network,his,ORGANIZATION-ORGANIZATION-ORGANIZATION,PERSON,PROPN-PROPN-PROPN,DET,compound-compound-compound,poss,NNP-NNP-NNP,PRP$,2,1
154,257.0,56,said,54,20,22,2,19,33,34,-32,MAC,Department of Legal Affairs,ORGANIZATION,ORGANIZATION-ORGANIZATION-ORGANIZATION-ORGANIZATION,PROPN,PROPN-ADP-PROPN-PROPN,compound,dobj-prep-compound-pobj,NNP,NNP-IN-NNP-NNPS,3,1
155,258.0,44,came,32,5,11,6,4,32,27,-21,Kelly Cutrone,MTV,PERSON-PERSON,ORGANIZATION,PROPN-PROPN,PROPN,compound-conj,poss,NNP-NNP,NNP,5,1
156,11314.0,24,wasting,13,11,8,-3,10,15,2,-5,Kelly Cutrone,MTV,PERSON-PERSON,ORGANIZATION,PROPN-PROPN,PROPN,compound-nsubj,conj,NNP-NNP,NNP,2,1
157,47493.0,42,wasting,13,11,8,-3,10,33,2,-5,Kelly Cutrone,MTV,PERSON-PERSON,ORGANIZATION,PROPN-PROPN,PROPN,compound-nsubj,conj,NNP-NNP,NNP,2,1
158,261.0,36,said,14,19,16,-3,18,19,-5,2,MF Global,Mike Fitzpatrick,ORGANIZATION-ORGANIZATION,PERSON-PERSON,PROPN-PROPN,PROPN-PROPN,compound-pobj,compound-nsubj,NNP-NNP,NNP-NNP,4,1
159,1145.0,30,said,5,4,1,-3,3,28,1,-4,MF Global,Mike Fitzpatrick,ORGANIZATION-ORGANIZATION,PERSON-PERSON,PROPN-PROPN,PROPN-PROPN,compound-pobj,compound-nsubj,NNP-NNP,NNP-NNP,2,1
160,2546.0,22,said,14,20,16,-4,19,5,-6,2,MF Global,Mike Fitzpatrick,ORGANIZATION-ORGANIZATION,PERSON-PERSON,PROPN-PROPN,PROPN-PROPN,compound-pobj,compound-nsubj,NNP-NNP,NNP-NNP,5,1
161,14450.0,46,remains,7,41,44,3,40,1,-34,37,MF Global,Mike Fitzpatrick,ORGANIZATION-ORGANIZATION,PERSON-PERSON,PROPN-PROPN,PROPN-PROPN,compound-compound,compound-nsubj,NNP-NNP,NNP-NNP,2,1
162,18272.0,38,said,31,36,33,-3,35,4,-5,2,MF Global,Mike Fitzpatrick,ORGANIZATION-ORGANIZATION,PERSON-PERSON,PROPN-PROPN,PROPN-PROPN,compound-pobj,compound-nsubj,NNP-NNP,NNP-NNP,4,1
163,22338.0,29,said,22,27,24,-3,26,4,-5,2,MF Global,Mike Fitzpatrick,ORGANIZATION-ORGANIZATION,PERSON-PERSON,PROPN-PROPN,PROPN-PROPN,compound-pobj,compound-nsubj,NNP-NNP,NNP-NNP,4,1
164,26090.0,22,said,5,4,1,-3,3,20,1,-4,MF Global,Mike Fitzpatrick,ORGANIZATION-ORGANIZATION,PERSON-PERSON,PROPN-PROPN,PROPN-PROPN,compound-pobj,compound-nsubj,NNP-NNP,NNP-NNP,2,1
165,28479.0,52,said,15,13,7,-6,12,44,2,-8,MF Global,Mike Fitzpatrick,ORGANIZATION-ORGANIZATION,PERSON-PERSON,PROPN-PROPN,PROPN-PROPN,compound-pobj,compound-appos,NNP-NNP,NNP-NNP,3,1
166,35945.0,27,said,20,25,22,-3,24,4,-5,2,MF Global,Mike Fitzpatrick,ORGANIZATION-ORGANIZATION,PERSON-PERSON,PROPN-PROPN,PROPN-PROPN,compound-pobj,compound-nsubj,NNP-NNP,NNP-NNP,4,1
167,45760.0,40,said,31,38,33,-5,37,6,-7,2,MF Global,Mike Fitzpatrick,ORGANIZATION-ORGANIZATION,PERSON-PERSON,PROPN-PROPN,PROPN-PROPN,compound-pobj,compound-nsubj,NNP-NNP,NNP-NNP,3,1
168,46686.0,29,said,5,4,1,-3,3,27,1,-4,MF Global,Mike Fitzpatrick,ORGANIZATION-ORGANIZATION,PERSON-PERSON,PROPN-PROPN,PROPN-PROPN,compound-pobj,compound-nsubj,NNP-NNP,NNP-NNP,2,1
169,48681.0,22,said,15,20,17,-3,19,4,-5,2,MF Global,Mike Fitzpatrick,ORGANIZATION-ORGANIZATION,PERSON-PERSON,PROPN-PROPN,PROPN-PROPN,compound-pobj,compound-nsubj,NNP-NNP,NNP-NNP,2,1
170,53390.0,61,said,52,59,54,-5,58,6,-7,2,MF Global,Mike Fitzpatrick,ORGANIZATION-ORGANIZATION,PERSON-PERSON,PROPN-PROPN,PROPN-PROPN,compound-pobj,compound-nsubj,NNP-NNP,NNP-NNP,2,1
171,56373.0,24,said,17,22,19,-3,21,4,-5,2,MF Global,Mike Fitzpatrick,ORGANIZATION-ORGANIZATION,PERSON-PERSON,PROPN-PROPN,PROPN-PROPN,compound-pobj,compound-nsubj,NNP-NNP,NNP-NNP,4,1
172,67637.0,33,said,23,31,25,-6,30,7,-8,2,MF Global,Mike Fitzpatrick,ORGANIZATION-ORGANIZATION,PERSON-PERSON,PROPN-PROPN,PROPN-PROPN,compound-pobj,compound-nsubj,NNP-NNP,NNP-NNP,5,1
173,267.0,49,-LRB-,6,32,5,-27,31,43,-26,-1,she,Nick Cannon,PERSON,PERSON-PERSON,PRON,PROPN-PROPN,nsubj,compound-pobj,PRP,NNP-NNP,3,1
174,269.0,36,agreed,24,10,8,-2,9,27,14,-16,Haifa University,Israel,ORGANIZATION-ORGANIZATION,COUNTRY,PROPN-PROPN,PROPN,compound-pobj,poss,NNP-NNP,NNP,2,1
175,15884.0,35,follows,3,15,18,3,14,16,-12,15,Haifa University,Israel,ORGANIZATION-ORGANIZATION,COUNTRY,PROPN-PROPN,PROPN,compound-pobj,pobj,NNP-NNP,NNP,7,1
176,34957.0,47,are,1,42,46,4,41,0,-41,45,Haifa University,Israel,ORGANIZATION-ORGANIZATION,COUNTRY,PROPN-PROPN,PROPN,compound-pobj,pobj,NNP-NNP,NNP,7,1
177,40690.0,29,ostracized,10,5,8,3,4,20,5,-2,Haifa University,Israel,ORGANIZATION-ORGANIZATION,COUNTRY,PROPN-PROPN,PROPN,compound-pobj,poss,NNP-NNP,NNP,4,1
178,47706.0,38,said,25,11,9,-2,10,28,14,-16,Haifa University,Israel,ORGANIZATION-ORGANIZATION,COUNTRY,PROPN-PROPN,PROPN,compound-pobj,poss,NNP-NNP,NNP,2,1
179,65362.0,57,debate,19,31,26,-5,30,30,-12,7,Haifa University,Israel,ORGANIZATION-ORGANIZATION,COUNTRY,PROPN-PROPN,PROPN,compound-appos,poss,NNP-NNP,NNP,5,1
180,278.0,42,choosing,11,28,27,-1,27,14,-17,16,Paul Gillmor,Rep.,PERSON-PERSON,TITLE,PROPN-PROPN,PROPN,compound-dobj,compound,NNP-NNP,NNP,1,1
181,6496.0,31,introduced,19,15,14,-1,14,16,4,-5,Paul Gillmor,Rep.,PERSON-PERSON,TITLE,PROPN-PROPN,PROPN,compound-conj,compound,NNP-NNP,NNP,3,1
182,7301.0,42,released,22,2,1,-1,1,40,20,-21,Paul Gillmor,Rep.,PERSON-PERSON,TITLE,PROPN-PROPN,PROPN,compound-nsubj,compound,NNP-NNP,NNP,1,1
183,15752.0,45,won,21,31,19,-12,30,25,-10,-2,Paul Gillmor,Rep.,PERSON-PERSON,TITLE,PROPN-PROPN,PROPN,compound-dobj,compound,NNP-NNP,NNP,5,1
184,39492.0,27,fear,1,10,9,-1,9,17,-9,8,Paul Gillmor,Rep.,PERSON-PERSON,TITLE,PROPN-PROPN,PROPN,compound-pobj,compound,NNP-NNP,NNP,1,1
185,41926.0,18,said,6,2,1,-1,1,16,4,-5,Paul Gillmor,Rep.,PERSON-PERSON,TITLE,PROPN-PROPN,PROPN,compound-nsubj,compound,NNP-NNP,NNP,1,1
186,49575.0,5,Gillmor,2,2,1,-1,1,3,0,-1,Paul Gillmor,Rep.,PERSON-PERSON,TITLE,PROPN-PROPN,PROPN,compound-ROOT,compound,NNP-NNP,NNP,1,1
187,55409.0,37,complete,3,9,8,-1,8,28,-6,5,Paul Gillmor,Rep.,PERSON-PERSON,TITLE,PROPN-PROPN,PROPN,compound-pobj,compound,NNP-NNP,NNP,1,1
188,55898.0,33,Wal-Mart,0,9,8,-1,8,24,-9,8,Paul Gillmor,Rep.,PERSON-PERSON,TITLE,PROPN-PROPN,PROPN,compound-pobj,compound,NNP-NNP,NNP,4,1
189,56367.0,27,said,7,2,1,-1,1,25,5,-6,Paul Gillmor,Rep.,PERSON-PERSON,TITLE,PROPN-PROPN,PROPN,compound-nsubj,compound,NNP-NNP,NNP,1,1
190,65176.0,42,co-sponsored,11,7,6,-1,6,35,4,-5,Paul Gillmor,Rep.,PERSON-PERSON,TITLE,PROPN-PROPN,PROPN,compound-conj,compound,NNP-NNP,NNP,1,1
191,66886.0,46,introduced,20,10,9,-1,9,36,10,-11,Paul Gillmor,Rep.,PERSON-PERSON,TITLE,PROPN-PROPN,PROPN,compound-conj,compound,NNP-NNP,NNP,3,1
192,67606.0,38,said,36,2,1,-1,1,36,34,-35,Paul Gillmor,Rep.,PERSON-PERSON,TITLE,PROPN-PROPN,PROPN,compound-nsubjpass,compound,NNP-NNP,NNP,1,1
193,290.0,38,returned,16,4,15,11,3,22,12,-1,she,US,PERSON,COUNTRY,PRON,PROPN,nsubj,compound,PRP,NNP,2,1
194,298.0,26,said,16,23,18,-5,22,7,-7,2,Project Islamic Hope,Najee Ali,ORGANIZATION-ORGANIZATION-ORGANIZATION,PERSON-PERSON,PROPN-PROPN-PROPN,PROPN-PROPN,compound-compound-pobj,compound-nsubj,NNP-NNP-NNP,NNP-NNP,5,1
195,8422.0,30,accused,9,7,4,-3,6,25,2,-5,Project Islamic Hope,Najee Ali,ORGANIZATION-ORGANIZATION-ORGANIZATION,PERSON-PERSON,PROPN-PROPN-PROPN,PROPN-PROPN,compound-compound-pobj,compound-appos,NNP-NNP-NNP,NNP-NNP,2,1
196,306.0,16,been,5,1,11,10,0,4,4,6,Carson,Indianapolis City-County Council,PERSON,ORGANIZATION-ORGANIZATION-ORGANIZATION,PROPN,PROPN-PROPN-PROPN,nsubj,compound-compound-pobj,NNP,NNP-NNP-NNP,8,1
197,307.0,36,labeled,9,1,5,4,0,30,8,-4,Mia Farrow,UN,PERSON-PERSON,ORGANIZATION,PROPN-PROPN,PROPN,compound-nsubj,compound,NNP-NNP,NNP,2,1
198,25962.0,30,comes,3,12,2,-10,11,27,-9,-1,Mia Farrow,UN,PERSON-PERSON,ORGANIZATION,PROPN-PROPN,PROPN,compound-conj,compound,NNP-NNP,NNP,4,1
199,311.0,20,said,18,3,14,11,2,5,15,-4,FirstGroup,U.S.,ORGANIZATION,COUNTRY,PROPN,PROPN,conj,pobj,NNP,NNP,2,1
200,10136.0,26,gave,4,6,8,2,5,17,-2,4,FirstGroup,U.S.,ORGANIZATION,COUNTRY,PROPN,PROPN,dative,compound,NNP,NNP,2,1
201,312.0,27,thinking,21,8,14,6,7,12,13,-7,she,Gloucester,PERSON,CITY,PRON,PROPN,nsubj,pobj,PRP,NNP,2,1
202,316.0,43,said,27,30,39,9,29,3,-3,12,Juanita Millender-McDonald,Committee on House Administration,PERSON-PERSON,ORGANIZATION-ORGANIZATION-ORGANIZATION-ORGANIZATION,PROPN-PROPN,PROPN-ADP-PROPN-PROPN,compound-nsubj,pobj-prep-compound-pobj,NNP-NNP,NNP-IN-NNP-NNP,4,1
203,325.0,45,said,16,8,12,4,7,32,8,-4,St. Anselm College,Manchester,ORGANIZATION-ORGANIZATION-ORGANIZATION,CITY,PROPN-PROPN-PROPN,PROPN,compound-compound-pobj,pobj,NNP-NNP-NNP,NNP,4,1
204,1843.0,52,went,7,20,24,4,19,27,-13,17,St. Anselm College,Manchester,ORGANIZATION-ORGANIZATION-ORGANIZATION,CITY,PROPN-PROPN-PROPN,PROPN,compound-compound-pobj,pobj,NNP-NNP-NNP,NNP,6,1
205,12375.0,37,squared,4,11,18,7,10,18,-7,14,St. Anselm College,Manchester,ORGANIZATION-ORGANIZATION-ORGANIZATION,CITY,PROPN-PROPN-PROPN,PROPN,compound-compound-pobj,pobj,NNP-NNP-NNP,NNP,6,1
206,16782.0,47,asked,6,40,44,4,39,2,-34,38,St. Anselm College,Manchester,ORGANIZATION-ORGANIZATION-ORGANIZATION,CITY,PROPN-PROPN-PROPN,PROPN,compound-compound-pobj,pobj,NNP-NNP-NNP,NNP,2,1
207,47106.0,56,says,25,34,38,4,33,17,-9,13,St. Anselm College,Manchester,ORGANIZATION-ORGANIZATION-ORGANIZATION,CITY,PROPN-PROPN-PROPN,PROPN,compound-compound-pobj,pobj,NNP-NNP-NNP,NNP,3,1
208,54645.0,33,said,22,12,16,4,11,16,10,-6,St. Anselm College,Manchester,ORGANIZATION-ORGANIZATION-ORGANIZATION,CITY,PROPN-PROPN-PROPN,PROPN,compound-compound-pobj,pobj,NNP-NNP-NNP,NNP,2,1
209,63433.0,40,said,20,35,39,4,34,0,-15,19,St. Anselm College,Manchester,ORGANIZATION-ORGANIZATION-ORGANIZATION,CITY,PROPN-PROPN-PROPN,PROPN,compound-compound-pobj,pobj,NNP-NNP-NNP,NNP,3,1
210,337.0,62,been,13,45,8,-37,44,53,-32,-5,Badr Brigades,Muslim,ORGANIZATION-ORGANIZATION,RELIGION,PROPN-PROPN,ADJ,compound-appos,conj,NNP-NNP,JJ,12,1
211,347.0,38,cover,9,35,7,-28,34,30,-26,-2,Disney,Shanghai Disneyland,ORGANIZATION,ORGANIZATION-ORGANIZATION,PROPN,PROPN-PROPN,poss,compound-pobj,NNP,NNP-NNP,8,1
212,358.0,22,said,17,20,19,-1,19,2,-3,2,Bryan Baldwin,spokesman,PERSON-PERSON,TITLE,PROPN-PROPN,NOUN,compound-nsubj,compound,NNP-NNP,NN,2,1
213,5618.0,41,said,4,3,2,-1,2,38,1,-2,Bryan Baldwin,spokesman,PERSON-PERSON,TITLE,PROPN-PROPN,NOUN,compound-nsubj,compound,NNP-NNP,NN,1,1
214,6578.0,30,said,4,3,2,-1,2,27,1,-2,Bryan Baldwin,spokesman,PERSON-PERSON,TITLE,PROPN-PROPN,NOUN,compound-nsubj,compound,NNP-NNP,NN,1,1
215,9492.0,27,said,21,25,24,-1,24,2,-4,3,Bryan Baldwin,spokesman,PERSON-PERSON,TITLE,PROPN-PROPN,NOUN,compound-nsubj,compound,NNP-NNP,NN,1,1
216,10826.0,31,said,4,3,2,-1,2,28,1,-2,Bryan Baldwin,spokesman,PERSON-PERSON,TITLE,PROPN-PROPN,NOUN,compound-nsubj,compound,NNP-NNP,NN,1,1
217,10939.0,39,said,12,4,8,4,3,30,8,-4,Bryan Baldwin,spokesman,PERSON-PERSON,TITLE,PROPN-PROPN,NOUN,compound-nsubj,appos,NNP-NNP,NN,2,1
218,11737.0,28,told,7,1,6,5,0,21,6,-1,Bryan Baldwin,spokesman,PERSON-PERSON,TITLE,PROPN-PROPN,NOUN,compound-nsubj,appos,NNP-NNP,NN,2,1
219,16332.0,24,said,22,21,20,-1,20,3,1,-2,Bryan Baldwin,spokesman,PERSON-PERSON,TITLE,PROPN-PROPN,NOUN,compound-nsubj,compound,NNP-NNP,NN,1,1
220,18021.0,31,said,29,28,27,-1,27,3,1,-2,Bryan Baldwin,spokesman,PERSON-PERSON,TITLE,PROPN-PROPN,NOUN,compound-nsubj,compound,NNP-NNP,NN,2,1
221,19302.0,18,said,15,14,13,-1,13,4,1,-2,Bryan Baldwin,spokesman,PERSON-PERSON,TITLE,PROPN-PROPN,NOUN,compound-nsubj,compound,NNP-NNP,NN,1,1
222,25464.0,45,said,43,42,41,-1,41,3,1,-2,Bryan Baldwin,spokesman,PERSON-PERSON,TITLE,PROPN-PROPN,NOUN,compound-nsubj,compound,NNP-NNP,NN,3,1
223,28704.0,22,said,4,3,2,-1,2,19,1,-2,Bryan Baldwin,spokesman,PERSON-PERSON,TITLE,PROPN-PROPN,NOUN,compound-nsubj,compound,NNP-NNP,NN,1,1
224,34239.0,22,said,14,1,5,4,0,16,13,-9,Bryan Baldwin,spokesman,PERSON-PERSON,TITLE,PROPN-PROPN,NOUN,compound-nsubj,appos,NNP-NNP,NN,2,1
225,39048.0,22,said,4,3,2,-1,2,19,1,-2,Bryan Baldwin,spokesman,PERSON-PERSON,TITLE,PROPN-PROPN,NOUN,compound-nsubj,compound,NNP-NNP,NN,1,1
226,46679.0,16,said,10,14,13,-1,13,2,-4,3,Bryan Baldwin,spokesman,PERSON-PERSON,TITLE,PROPN-PROPN,NOUN,compound-nsubj,compound,NNP-NNP,NN,1,1
227,47725.0,35,said,33,32,31,-1,31,3,1,-2,Bryan Baldwin,spokesman,PERSON-PERSON,TITLE,PROPN-PROPN,NOUN,compound-nsubj,compound,NNP-NNP,NN,2,1
228,52964.0,18,said,16,15,14,-1,14,3,1,-2,Bryan Baldwin,spokesman,PERSON-PERSON,TITLE,PROPN-PROPN,NOUN,compound-nsubj,compound,NNP-NNP,NN,1,1
229,53456.0,26,said,20,24,23,-1,23,2,-4,3,Bryan Baldwin,spokesman,PERSON-PERSON,TITLE,PROPN-PROPN,NOUN,compound-nsubj,compound,NNP-NNP,NN,1,1
230,53634.0,28,said,23,26,25,-1,25,2,-3,2,Bryan Baldwin,spokesman,PERSON-PERSON,TITLE,PROPN-PROPN,NOUN,compound-nsubj,compound,NNP-NNP,NN,1,1
231,63899.0,21,said,19,18,17,-1,17,3,1,-2,Bryan Baldwin,spokesman,PERSON-PERSON,TITLE,PROPN-PROPN,NOUN,compound-nsubj,compound,NNP-NNP,NN,1,1
232,64993.0,22,wrote,13,16,15,-1,15,6,-3,2,Bryan Baldwin,spokesman,PERSON-PERSON,TITLE,PROPN-PROPN,NOUN,compound-nsubj,compound,NNP-NNP,NN,2,1
233,66731.0,37,said,28,30,34,4,29,2,-2,6,Bryan Baldwin,spokesman,PERSON-PERSON,TITLE,PROPN-PROPN,NOUN,compound-nsubj,appos,NNP-NNP,NN,2,1
234,67226.0,11,said,4,3,2,-1,2,8,1,-2,Bryan Baldwin,spokesman,PERSON-PERSON,TITLE,PROPN-PROPN,NOUN,compound-nsubj,compound,NNP-NNP,NN,1,1
235,67381.0,24,said,16,18,23,5,17,0,-2,7,Bryan Baldwin,spokesman,PERSON-PERSON,TITLE,PROPN-PROPN,NOUN,compound-nsubj,appos,NNP-NNP,NN,2,1
236,364.0,35,is,4,1,3,2,0,31,3,-1,Huber,57,PERSON,NUMBER,PROPN,NUM,nsubj,appos,NNP,CD,2,1
237,2728.0,34,is,4,1,3,2,0,30,3,-1,Huber,57,PERSON,NUMBER,PROPN,NUM,nsubj,appos,NNP,CD,2,1
238,24297.0,28,nominated,3,5,7,2,4,20,-2,4,Huber,57,PERSON,NUMBER,PROPN,NUM,dobj,appos,NNP,CD,2,1
239,30416.0,26,considered,5,1,3,2,0,22,4,-2,Huber,57,PERSON,NUMBER,PROPN,NUM,nsubjpass,appos,NNP,CD,2,1
240,373.0,44,help,3,7,16,9,6,27,-4,13,Spears,Britney Spears,PERSON,PERSON-PERSON,PROPN,PROPN-PROPN,nsubj,compound-pobj,NNP,NNP-NNPS,3,1
241,379.0,49,offered,42,10,27,17,9,21,32,-15,Gonzales,Texas,PERSON,STATE_OR_PROVINCE,PROPN,PROPN,pobj,pobj,NNP,NNP,8,1
242,381.0,33,gave,7,24,26,2,23,6,-17,19,AAA,Wright Express and Oil Price Information Service,ORGANIZATION,ORGANIZATION-ORGANIZATION-ORGANIZATION-ORGANIZATION-ORGANIZATION-ORGANIZATION-ORGANIZATION,PROPN,PROPN-PROPN-CCONJ-PROPN-PROPN-PROPN-PROPN,pobj,compound-conj-cc-compound-compound-compound-conj,NNP,NNP-NNP-CC-NNP-NNP-NNP-NNP,2,1
243,10301.0,24,is,1,15,17,2,14,6,-14,16,AAA,Wright Express and Oil Price Information Service,ORGANIZATION,ORGANIZATION-ORGANIZATION-ORGANIZATION-ORGANIZATION-ORGANIZATION-ORGANIZATION-ORGANIZATION,PROPN,PROPN-PROPN-CCONJ-PROPN-PROPN-PROPN-PROPN,pobj,compound-conj-cc-compound-compound-compound-conj,NNP,NNP-NNP-CC-NNP-NNP-NNP-NNP,2,1
244,384.0,46,was,15,14,17,3,13,28,1,2,Daily News,Zimbabwe,ORGANIZATION-ORGANIZATION,COUNTRY,PROPN-PROPN,PROPN,compound-nsubj,poss,NNP-NNP,NNP,4,1
245,385.0,26,Bank,3,2,6,4,1,19,1,3,Asian Development Bank,ADB,ORGANIZATION-ORGANIZATION-ORGANIZATION,ORGANIZATION,PROPN-PROPN-PROPN,PROPN,compound-compound-ROOT,compound,NNP-NNP-NNP,NNP,2,1
246,14007.0,30,Bank,3,2,6,4,1,23,1,3,Asian Development Bank,ADB,ORGANIZATION-ORGANIZATION-ORGANIZATION,ORGANIZATION,PROPN-PROPN-PROPN,PROPN,compound-compound-ROOT,compound,NNP-NNP-NNP,NNP,2,1
247,23421.0,46,president,1,5,9,4,4,36,-4,8,Asian Development Bank,ADB,ORGANIZATION-ORGANIZATION-ORGANIZATION,ORGANIZATION,PROPN-PROPN-PROPN,PROPN,compound-compound-pobj,compound,NNP-NNP-NNP,NNP,4,1
248,27716.0,34,chief,1,5,9,4,4,24,-4,8,Asian Development Bank,ADB,ORGANIZATION-ORGANIZATION-ORGANIZATION,ORGANIZATION,PROPN-PROPN-PROPN,PROPN,compound-compound-pobj,compound,NNP-NNP-NNP,NNP,4,1
249,28177.0,45,MANILA,0,4,8,4,3,36,-4,8,Asian Development Bank,ADB,ORGANIZATION-ORGANIZATION-ORGANIZATION,ORGANIZATION,PROPN-PROPN-PROPN,PROPN,compound-compound-ROOT,compound,NNP-NNP-NNP,NNP,2,1
250,29514.0,41,said,26,35,39,4,34,1,-9,13,Asian Development Bank,ADB,ORGANIZATION-ORGANIZATION-ORGANIZATION,ORGANIZATION,PROPN-PROPN-PROPN,PROPN,compound-compound-pobj,compound,NNP-NNP-NNP,NNP,6,1
251,34044.0,30,Bank,3,2,6,4,1,23,1,3,Asian Development Bank,ADB,ORGANIZATION-ORGANIZATION-ORGANIZATION,ORGANIZATION,PROPN-PROPN-PROPN,PROPN,compound-compound-ROOT,compound,NNP-NNP-NNP,NNP,2,1
252,37612.0,43,MANILA,0,9,13,4,8,29,-9,13,Asian Development Bank,ADB,ORGANIZATION-ORGANIZATION-ORGANIZATION,ORGANIZATION,PROPN-PROPN-PROPN,PROPN,compound-compound-ROOT,compound,NNP-NNP-NNP,NNP,3,1
253,37918.0,34,Bank,3,2,6,4,1,27,1,3,Asian Development Bank,ADB,ORGANIZATION-ORGANIZATION-ORGANIZATION,ORGANIZATION,PROPN-PROPN-PROPN,PROPN,compound-compound-ROOT,compound,NNP-NNP-NNP,NNP,3,1
254,41885.0,30,Bank,3,2,6,4,1,23,1,3,Asian Development Bank,ADB,ORGANIZATION-ORGANIZATION-ORGANIZATION,ORGANIZATION,PROPN-PROPN-PROPN,PROPN,compound-compound-ROOT,compound,NNP-NNP-NNP,NNP,2,1
255,45003.0,46,seek,7,6,12,6,5,33,1,5,Asian Development Bank,ADB,ORGANIZATION-ORGANIZATION-ORGANIZATION,ORGANIZATION,PROPN-PROPN-PROPN,PROPN,compound-compound-pobj,pobj,NNP-NNP-NNP,NNP,5,1
256,51103.0,37,post,3,17,21,4,16,15,-14,18,Asian Development Bank,ADB,ORGANIZATION-ORGANIZATION-ORGANIZATION,ORGANIZATION,PROPN-PROPN-PROPN,PROPN,compound-compound-appos,compound,NNP-NNP-NNP,NNP,4,1
257,55540.0,53,told,49,43,47,4,42,5,6,-2,Asian Development Bank,ADB,ORGANIZATION-ORGANIZATION-ORGANIZATION,ORGANIZATION,PROPN-PROPN-PROPN,PROPN,compound-compound-pobj,compound,NNP-NNP-NNP,NNP,1,1
258,60662.0,25,Bank,3,2,6,4,1,18,1,3,Asian Development Bank,ADB,ORGANIZATION-ORGANIZATION-ORGANIZATION,ORGANIZATION,PROPN-PROPN-PROPN,PROPN,compound-compound-ROOT,compound,NNP-NNP-NNP,NNP,2,1
259,66017.0,58,are,18,30,1,-29,29,56,-12,-17,Asian Development Bank,ADB,ORGANIZATION-ORGANIZATION-ORGANIZATION,ORGANIZATION,PROPN-PROPN-PROPN,PROPN,compound-compound-pobj,compound,NNP-NNP-NNP,NNP,-1,1
260,66162.0,35,said,33,12,16,4,11,18,21,-17,Asian Development Bank,ADB,ORGANIZATION-ORGANIZATION-ORGANIZATION,ORGANIZATION,PROPN-PROPN-PROPN,PROPN,compound-compound-nsubj,compound,NNP-NNP-NNP,NNP,2,1
261,67277.0,21,said,1,8,12,4,7,8,-7,11,Asian Development Bank,ADB,ORGANIZATION-ORGANIZATION-ORGANIZATION,ORGANIZATION,PROPN-PROPN-PROPN,PROPN,compound-compound-dobj,compound,NNP-NNP-NNP,NNP,4,1
262,386.0,21,announced,3,11,9,-2,10,11,-8,6,IPSCO,Canada,ORGANIZATION,COUNTRY,PROPN,PROPN,dobj,poss,NNP,NNP,4,1
263,12394.0,8,steelmaker,2,8,6,-2,7,1,-6,4,IPSCO,Canada,ORGANIZATION,COUNTRY,NOUN,PROPN,dobj,poss,NN,NNP,-1,1
264,49161.0,21,announced,3,11,9,-2,10,11,-8,6,IPSCO,Canada,ORGANIZATION,COUNTRY,PROPN,PROPN,dobj,poss,NNP,NNP,4,1
265,52424.0,26,announced,3,11,9,-2,10,16,-8,6,IPSCO,Canada,ORGANIZATION,COUNTRY,PROPN,PROPN,compound,poss,NNP,NNP,2,1
266,64595.0,15,Report,0,15,12,-3,14,2,-15,12,IPSCO,Canada,ORGANIZATION,COUNTRY,NOUN,PROPN,attr,dobj,NN,NNP,-1,1
267,389.0,57,said,4,14,10,-4,13,46,-10,6,Federal Motor Carrier Safety Administration,he,ORGANIZATION-ORGANIZATION-ORGANIZATION-ORGANIZATION-ORGANIZATION,PERSON,PROPN-PROPN-PROPN-PROPN-PROPN,PRON,compound-compound-compound-compound-dobj,nsubj,NNP-NNP-NNP-NNP-NNP,PRP,5,1
268,395.0,26,dropped,5,16,23,7,15,2,-11,18,National Beef Packing Co.,U.S.,ORGANIZATION-ORGANIZATION-ORGANIZATION-ORGANIZATION,COUNTRY,PROPN-PROPN-PROPN-PROPN,PROPN,compound-compound-compound-dobj,compound,NNP-NNP-NNP-NNP,NNP,3,1
269,67636.0,54,control,23,20,35,15,19,18,3,12,National Beef Packing Co.,U.S.,ORGANIZATION-ORGANIZATION-ORGANIZATION-ORGANIZATION,COUNTRY,PROPN-PROPN-PROPN-PROPN,PROPN,compound-compound-compound-conj,pobj,NNP-NNP-NNP-NNP,NNP,7,1
270,407.0,21,said,1,3,1,-2,2,19,-2,0,Scheider,Taylor,PERSON,PERSON,PROPN,PROPN,nsubj,nsubj,NNP,NNP,2,1
271,411.0,30,replaced,10,12,17,5,11,12,-2,7,Al Hubbard,businessman,PERSON-PERSON,TITLE,PROPN-PROPN,NOUN,compound-dobj,appos,NNP-NNP,NN,3,1
272,427.0,47,-LRB-,4,13,29,16,12,17,-9,25,Thomas Meskill,America,PERSON-PERSON,COUNTRY,PROPN-PROPN,PROPN,compound-conj,poss,NNP-NNP,NNP,8,1
273,433.0,73,composed,7,24,19,-5,23,53,-17,12,Don Wildmon,American Family Association,PERSON-PERSON,ORGANIZATION-ORGANIZATION-ORGANIZATION,PROPN-PROPN,PROPN-PROPN-PROPN,compound-pobj,compound-compound-poss,NNP-NNP,NNP-NNP-NNP,3,1
274,9116.0,28,being,4,21,25,4,20,2,-17,21,Don Wildmon,American Family Association,PERSON-PERSON,ORGANIZATION-ORGANIZATION-ORGANIZATION,PROPN-PROPN,PROPN-PROPN-PROPN,compound-pobj,compound-compound-pobj,NNP-NNP,NNP-NNP-NNP,3,1
275,39683.0,59,was,11,17,13,-4,16,45,-6,2,Don Wildmon,American Family Association,PERSON-PERSON,ORGANIZATION-ORGANIZATION-ORGANIZATION,PROPN-PROPN,PROPN-PROPN-PROPN,compound-attr,compound-compound-compound,NNP-NNP,NNP-NNP-NNP,3,1
276,437.0,22,said,7,4,6,2,3,15,3,-1,IMF,Dominique Strauss-Kahn,ORGANIZATION,PERSON-PERSON,PROPN,PROPN-PROPN,compound,compound-nsubj,NNP,NNP-NNP,2,1
277,52245.0,32,Board,2,10,30,20,9,1,-8,28,IMF,Dominique Strauss-Kahn,ORGANIZATION,PERSON-PERSON,PROPN,PROPN-PROPN,compound,compound-punct,NNP,NNP-NNP,6,1
278,64616.0,57,said,55,43,54,11,42,2,12,-1,IMF,Dominique Strauss-Kahn,ORGANIZATION,PERSON-PERSON,PROPN,PROPN-PROPN,pobj,compound-punct,NNP,NNP-NNP,9,1
279,440.0,45,presented,14,25,38,13,24,6,-11,24,American Psychological Association,144,ORGANIZATION-ORGANIZATION-ORGANIZATION,NUMBER,PROPN-PROPN-PROPN,NUM,compound-compound-pobj,nummod,NNP-NNP-NNP,CD,6,1
280,451.0,27,said,16,1,7,6,0,19,15,-9,Lindsay M Hayes,specialist,PERSON-PERSON-PERSON,TITLE,PROPN-PROPN-PROPN,NOUN,compound-compound-nsubj,appos,NNP-NNP-NNP,NN,3,1
281,454.0,52,went,8,23,34,11,22,17,-15,26,opposition party,Angola,ORGANIZATION-ORGANIZATION,COUNTRY,NOUN-NOUN,PROPN,compound-pobj,poss,NN-NN,NNP,6,1
282,459.0,30,said,18,3,13,10,2,16,15,-5,Ali Akbar Salehi,Atomic Energy Organization of Iran,PERSON-PERSON-PERSON,ORGANIZATION-ORGANIZATION-ORGANIZATION-ORGANIZATION-ORGANIZATION,PROPN-PROPN-PROPN,PROPN-PROPN-PROPN-ADP-PROPN,compound-compound-nsubj,compound-compound-pobj-prep-pobj,NNP-NNP-NNP,NNP-NNP-NNP-IN-NNP,6,1
283,2029.0,50,expected,15,35,11,-24,34,38,-20,-4,Ali Akbar Salehi,Atomic Energy Organization of Iran,PERSON-PERSON-PERSON,ORGANIZATION-ORGANIZATION-ORGANIZATION-ORGANIZATION-ORGANIZATION,PROPN-PROPN-PROPN,PROPN-PROPN-PROPN-ADP-PROPN,compound-compound-pobj,compound-compound-pobj-prep-pobj,NNP-NNP-NNP,NNP-NNP-NNP-IN-NNP,7,1
284,58888.0,25,made,1,13,20,7,12,4,-12,19,Ali Akbar Salehi,Atomic Energy Organization of Iran,PERSON-PERSON-PERSON,ORGANIZATION-ORGANIZATION-ORGANIZATION-ORGANIZATION-ORGANIZATION,PROPN-PROPN-PROPN,PROPN-PROPN-PROPN-ADP-PROPN,compound-compound-pobj,compound-compound-pobj-prep-pobj,NNP-NNP-NNP,NNP-NNP-NNP-IN-NNP,5,1
285,67383.0,48,told,13,11,3,-8,10,44,2,-10,Ali Akbar Salehi,Atomic Energy Organization of Iran,PERSON-PERSON-PERSON,ORGANIZATION-ORGANIZATION-ORGANIZATION-ORGANIZATION-ORGANIZATION,PROPN-PROPN-PROPN,PROPN-PROPN-PROPN-ADP-PROPN,compound-compound-appos,compound-compound-pobj-prep-pobj,NNP-NNP-NNP,NNP-NNP-NNP-IN-NNP,-1,1
286,461.0,64,said,62,12,19,7,11,44,50,-43,Hashim Ahmad al-Tai,minister,PERSON-PERSON-PERSON,TITLE,PROPN-PROPN-PROPN,NOUN,compound-nsubj-punct,appos,NNP-NNP-NNP,NN,3,1
287,17436.0,47,sentenced,1,7,14,7,6,32,-6,13,Hashim Ahmad al-Tai,minister,PERSON-PERSON-PERSON,TITLE,PROPN-PROPN-PROPN,NOUN,compound-attr-punct,appos,NNP-NNP-NNP,NN,3,1
288,38415.0,33,argued,3,30,27,-3,29,5,-27,24,Hashim Ahmad al-Tai,minister,PERSON-PERSON-PERSON,TITLE,PROPN-PROPN-X,NOUN,compound-appos-punct,dobj,NNP-NNP-ADD,NN,3,1
289,39883.0,23,Ahmad,3,3,10,7,2,12,0,7,Hashim Ahmad al-Tai,minister,PERSON-PERSON-PERSON,TITLE,PROPN-PROPN-PROPN,NOUN,compound-ROOT-punct,appos,NNP-NNP-NNP,NN,3,1
290,45433.0,22,_,0,3,9,6,2,12,-3,9,Hashim Ahmad al-Tai,minister,PERSON-PERSON-PERSON,TITLE,PROPN-PROPN-PROPN,NOUN,compound-dobj-punct,appos,NNP-NNP-NNP,NN,3,1
291,67583.0,69,sentenced,49,8,15,7,7,53,41,-34,Hashim Ahmad al-Tai,minister,PERSON-PERSON-PERSON,TITLE,PROPN-PROPN-PROPN,NOUN,compound-appos-punct,appos,NNP-NNP-NNP,NN,3,1
292,467.0,37,said,30,25,19,-6,24,17,5,-11,IMF,David Burton,ORGANIZATION,PERSON-PERSON,PROPN,PROPN-PROPN,nmod,compound-nsubj,NNP,NNP-NNP,5,1
293,470.0,49,praised,14,16,37,21,15,11,-2,23,Waldheim,foreign minister,PERSON,TITLE-TITLE,PROPN,ADJ-NOUN,poss,amod-conj,NNP,JJ-NN,7,1
294,475.0,18,settled,5,10,16,6,9,1,-5,11,MF Global,Man Financial,ORGANIZATION-ORGANIZATION,ORGANIZATION-ORGANIZATION,PROPN-PROPN,PROPN-PROPN,compound-pobj,compound-pobj,NNP-NNP,NNP-NNP,3,1
295,36922.0,25,become,10,15,7,-8,14,17,-5,-3,MF Global,Man Financial,ORGANIZATION-ORGANIZATION,ORGANIZATION-ORGANIZATION,PROPN-PROPN,PROPN-PROPN,compound-pobj,compound-pobj,NNP-NNP,NNP-NNP,7,1
296,56664.0,21,renamed,4,6,13,7,5,7,-2,9,MF Global,Man Financial,ORGANIZATION-ORGANIZATION,ORGANIZATION-ORGANIZATION,PROPN-PROPN,PROPN-PROPN,compound-oprd,compound-poss,NNP-NNP,NNP-NNP,5,1
297,479.0,10,was,1,1,4,3,0,5,0,3,He,Army,PERSON,ORGANIZATION,PRON,PROPN,nsubj,compound,PRP,NNP,1,1
298,27127.0,25,attended,1,1,10,9,0,14,0,9,He,Army,PERSON,ORGANIZATION,PRON,PROPN,nsubj,pobj,PRP,NNP,4,1
299,28613.0,28,served,2,1,11,10,0,16,1,9,He,Army,PERSON,ORGANIZATION,PRON,PROPN,nsubj,pobj,PRP,NNP,4,1
300,490.0,52,said,50,19,47,28,18,4,31,-3,Central American Parliament,Dominican Republic,ORGANIZATION-ORGANIZATION-ORGANIZATION,ORGANIZATION-ORGANIZATION,ADJ-PROPN-PROPN,PROPN-PROPN,compound-compound-pobj,compound-conj,JJ-NNP-NNP,NNP-NNP,23,1
301,492.0,71,said,45,42,35,-7,41,35,3,-10,American Beverage Association,Christopher Gindlesperger,ORGANIZATION-ORGANIZATION-ORGANIZATION,PERSON-PERSON,PROPN-PROPN-PROPN,PROPN-PROPN,compound-compound-pobj,compound-appos,NNP-NNP-NNP,NNP-NNP,10,1
302,493.0,26,called,4,19,13,-6,18,12,-15,9,He,Maryland,PERSON,STATE_OR_PROVINCE,PRON,PROPN,nsubj,pobj,PRP,NNP,5,1
303,35639.0,18,worked,1,1,12,11,0,5,0,11,He,Maryland,PERSON,STATE_OR_PROVINCE,PRON,PROPN,nsubj,compound,PRP,NNP,4,1
304,502.0,31,took,15,4,13,9,3,17,11,-2,FirstGroup,United Kingdom,ORGANIZATION,COUNTRY-COUNTRY,PROPN,PROPN-PROPN,compound,compound-pobj,NNP,NNP-NNP,4,1
305,511.0,48,said,17,36,31,-5,35,16,-19,14,David Banda,Rocco,PERSON-PERSON,PERSON,PROPN-PROPN,PROPN,compound-conj,appos,NNP-NNP,NNP,3,1
306,37588.0,41,said,10,29,24,-5,28,16,-19,14,David Banda,Rocco,PERSON-PERSON,PERSON,PROPN-PROPN,PROPN,compound-conj,appos,NNP-NNP,NNP,3,1
307,45272.0,24,have,2,12,7,-5,11,16,-10,5,David Banda,Rocco,PERSON-PERSON,PERSON,PROPN-PROPN,PROPN,compound-conj,appos,NNP-NNP,NNP,2,1
308,517.0,40,said,5,14,7,-7,13,32,-9,2,Institute for Diversity and Ethics in Sport,Richard E. Lapchick,ORGANIZATION-ORGANIZATION-ORGANIZATION-ORGANIZATION-ORGANIZATION-ORGANIZATION-ORGANIZATION,PERSON-PERSON-PERSON,PROPN-ADP-PROPN-CCONJ-PROPN-ADP-PROPN,PROPN-PROPN-PROPN,pobj-prep-pobj-cc-conj-prep-pobj,compound-compound-nsubj,NNP-IN-NNP-CC-NNP-IN-NNP,NNP-NNP-NNP,5,1
309,7490.0,58,'s,2,38,31,-7,37,26,-36,29,Institute for Diversity and Ethics in Sport,Richard E. Lapchick,ORGANIZATION-ORGANIZATION-ORGANIZATION-ORGANIZATION-ORGANIZATION-ORGANIZATION-ORGANIZATION,PERSON-PERSON-PERSON,PROPN-ADP-PROPN-CCONJ-PROPN-ADP-PROPN,PROPN-PROPN-PROPN,pobj-prep-pobj-cc-conj-prep-pobj,compound-compound-nsubj,NNP-IN-NNP-CC-NNP-IN-NNP,NNP-NNP-NNP,4,1
310,59759.0,33,told,17,7,1,-6,6,31,10,-16,Institute for Diversity and Ethics in Sport,Richard E. Lapchick,ORGANIZATION-ORGANIZATION-ORGANIZATION-ORGANIZATION-ORGANIZATION-ORGANIZATION-ORGANIZATION,PERSON-PERSON-PERSON,PROPN-ADP-PROPN-CCONJ-PROPN-ADP-PROPN,PROPN-PROPN-PROPN,pobj-prep-pobj-cc-conj-prep-pobj,compound-compound-nsubj,NNP-IN-NNP-CC-NNP-IN-NNP,NNP-NNP-NNP,4,1
311,518.0,34,persuade,6,13,20,7,12,13,-7,14,American Bar Association,UIA,ORGANIZATION-ORGANIZATION-ORGANIZATION,ORGANIZATION,PROPN-PROPN-PROPN,PROPN,compound-compound-pobj,dobj,NNP-NNP-NNP,NNP,7,1
312,19294.0,34,persuade,6,13,20,7,12,13,-7,14,American Bar Association,UIA,ORGANIZATION-ORGANIZATION-ORGANIZATION,ORGANIZATION,PROPN-PROPN-PROPN,PROPN,compound-compound-pobj,dobj,NNP-NNP-NNP,NNP,7,1
313,519.0,46,was,15,15,11,-4,14,34,0,-4,he,Small Business Committee,PERSON,ORGANIZATION-ORGANIZATION-ORGANIZATION,PRON,PROPN-PROPN-PROPN,nsubj,compound-compound-dobj,PRP,NNP-NNP-NNP,6,1
314,530.0,15,born,4,1,7,6,0,7,3,3,George Henry Sheldon,New Jersey,PERSON-PERSON-PERSON,STATE_OR_PROVINCE-STATE_OR_PROVINCE,PROPN-PROPN-PROPN,PROPN-PROPN,compound-compound-nsubjpass,compound-pobj,NNP-NNP-NNP,NNP-NNP,4,1
315,536.0,38,formed,14,1,33,32,0,4,13,19,Alcatel-Lucent,Alcatel,ORGANIZATION,ORGANIZATION,ADJ,PROPN,nsubjpass,conj,JJ,NNP,11,1
316,538.0,50,connected,29,37,49,12,36,0,-8,20,ABA,1976,ORGANIZATION,DATE,NOUN,NUM,pobj,pobj,NN,CD,8,1
317,545.0,33,demanded,6,12,10,-2,11,22,-6,4,Lee Jye,Defense,PERSON-PERSON,ORGANIZATION,PROPN-PROPN,PROPN,compound-nsubj,compound,NNP-NNP,NNP,1,1
318,30791.0,55,said,11,10,8,-2,9,46,1,-3,Lee Jye,Defense,PERSON-PERSON,ORGANIZATION,PROPN-PROPN,PROPN,compound-nsubj,compound,NNP-NNP,NNP,1,1
319,547.0,24,said,6,5,1,-4,4,22,1,-5,Bryan Baldwin,JetBlue Airways Corp,PERSON-PERSON,ORGANIZATION-ORGANIZATION-ORGANIZATION,PROPN-PROPN,PROPN-PROPN-PROPN,compound-nsubj,compound-compound-compound,NNP-NNP,NNP-NNP-NNP,3,1
320,48433.0,24,said,22,21,1,-20,20,22,1,-21,Bryan Baldwin,JetBlue Airways Corp,PERSON-PERSON,ORGANIZATION-ORGANIZATION-ORGANIZATION,PROPN-PROPN,PROPN-PROPN-PROPN,compound-nsubj,compound-compound-nsubj,NNP-NNP,NNP-NNP-NNP,4,1
321,552.0,36,hooked,18,30,14,-16,29,21,-12,-4,him,23-year-old,PERSON,DURATION,PRON,NUM,dobj,amod,PRP,CD,6,1
322,561.0,28,said,21,2,9,7,1,18,19,-12,Steve McPherson,president,PERSON-PERSON,TITLE,PROPN-PROPN,NOUN,compound-nsubj,pobj,NNP-NNP,NN,5,1
323,8280.0,34,said,9,1,5,4,0,28,8,-4,Steve McPherson,president,PERSON-PERSON,TITLE,PROPN-PROPN,NOUN,compound-nsubj,appos,NNP-NNP,NN,2,1
324,12246.0,60,announced,23,22,21,-1,21,38,1,-2,Steve McPherson,president,PERSON-PERSON,TITLE,PROPN-PROPN,NOUN,compound-appos,nsubj,NNP-NNP,NN,4,1
325,12292.0,40,said,1,3,8,5,2,31,-2,7,Steve McPherson,president,PERSON-PERSON,TITLE,PROPN-PROPN,NOUN,compound-nsubj,appos,NNP-NNP,NN,2,1
326,12481.0,42,revealed,14,4,3,-1,3,38,10,-11,Steve McPherson,president,PERSON-PERSON,TITLE,PROPN-PROPN,NOUN,compound-appos,nsubj,NNP-NNP,NN,1,1
327,13161.0,47,said,11,9,8,-1,8,38,2,-3,Steve McPherson,president,PERSON-PERSON,TITLE,PROPN-PROPN,NOUN,compound-nsubj,compound,NNP-NNP,NN,1,1
328,15344.0,46,asked,17,9,8,-1,8,37,8,-9,Steve McPherson,president,PERSON-PERSON,TITLE,PROPN-PROPN,NOUN,compound-appos,nsubj,NNP-NNP,NN,1,1
329,24881.0,36,said,6,4,3,-1,3,32,2,-3,Steve McPherson,president,PERSON-PERSON,TITLE,PROPN-PROPN,NOUN,compound-appos,nsubj,NNP-NNP,NN,1,1
330,25034.0,32,attacked,5,4,3,-1,3,28,1,-2,Steve McPherson,president,PERSON-PERSON,TITLE,PROPN-PROPN,NOUN,compound-appos,nsubj,NNP-NNP,NN,1,1
331,31295.0,65,revealed,21,58,57,-1,57,7,-37,36,Steve McPherson,president,PERSON-PERSON,TITLE,PROPN-PROPN,NOUN,compound-appos,pobj,NNP-NNP,NN,1,1
332,34516.0,23,parted,1,9,7,-2,8,15,-8,6,Steve McPherson,president,PERSON-PERSON,TITLE,PROPN-PROPN,NOUN,compound-appos,pobj,NNP-NNP,NN,2,1
333,38299.0,46,Kamp,3,14,13,-1,13,32,-11,10,Steve McPherson,president,PERSON-PERSON,TITLE,PROPN-PROPN,NOUN,compound-appos,nsubj,NNP-NNP,NN,2,1
334,39084.0,24,are,5,9,8,-1,8,15,-4,3,Steve McPherson,president,PERSON-PERSON,TITLE,PROPN-PROPN,NOUN,compound-attr,compound,NNP-NNP,NN,1,1
335,43362.0,37,seemed,1,8,12,4,7,24,-7,11,Steve McPherson,president,PERSON-PERSON,TITLE,PROPN-PROPN,NOUN,compound-nsubj,appos,NNP-NNP,NN,2,1
336,50055.0,22,said,20,19,18,-1,18,3,1,-2,Steve McPherson,president,PERSON-PERSON,TITLE,PROPN-PROPN,NOUN,compound-nsubj,compound,NNP-NNP,NN,2,1
337,53594.0,32,was,2,20,19,-1,19,12,-18,17,Steve McPherson,president,PERSON-PERSON,TITLE,PROPN-PROPN,NOUN,compound-pobj,compound,NNP-NNP,NN,1,1
338,55521.0,38,began,2,6,10,4,5,27,-4,8,Steve McPherson,president,PERSON-PERSON,TITLE,PROPN-PROPN,NOUN,compound-pobj,appos,NNP-NNP,NN,2,1
339,59940.0,48,had,3,45,44,-1,44,3,-42,41,Steve McPherson,president,PERSON-PERSON,TITLE,PROPN-PROPN,NOUN,compound-nsubj,compound,NNP-NNP,NN,2,1
340,564.0,32,made,2,13,21,8,12,10,-11,19,Dee Dee Myers,secretary,PERSON-PERSON-PERSON,TITLE,PROPN-PROPN-PROPN,NOUN,compound-compound-nsubj,poss,NNP-NNP-NNP,NN,5,1
341,2468.0,43,said,11,13,25,12,12,17,-2,14,Dee Dee Myers,secretary,PERSON-PERSON-PERSON,TITLE,PROPN-PROPN-PROPN,NOUN,compound-compound-nsubj,attr,NNP-NNP-NNP,NN,4,1
342,6849.0,13,said,0,2,12,10,1,0,-2,12,Dee Dee Myers,secretary,PERSON-PERSON-PERSON,TITLE,PROPN-PROPN-PROPN,NOUN,compound-compound-nsubj,appos,NNP-NNP-NNP,NN,3,1
343,8362.0,93,had,7,44,50,6,43,42,-37,43,Dee Dee Myers,secretary,PERSON-PERSON-PERSON,TITLE,PROPN-PROPN-PROPN,NOUN,compound-compound-conj,appos,NNP-NNP-NNP,NN,3,1
344,17605.0,28,attracting,25,12,20,8,11,7,13,-5,Dee Dee Myers,secretary,PERSON-PERSON-PERSON,TITLE,PROPN-PROPN-PROPN,NOUN,compound-compound-nsubj,attr,NNP-NNP-NNP,NN,4,1
345,19506.0,57,intended,22,18,17,-1,17,39,4,-5,Dee Dee Myers,secretary,PERSON-PERSON-PERSON,TITLE,PROPN-PROPN-PROPN,NOUN,compound-compound-pobj,compound,NNP-NNP-NNP,NN,2,1
346,20901.0,31,said,9,15,14,-1,14,16,-6,5,Dee Dee Myers,secretary,PERSON-PERSON-PERSON,TITLE,PROPN-PROPN-PROPN,NOUN,compound-compound-nsubj,compound,NNP-NNP-NNP,NN,2,1
347,26278.0,32,said,9,11,20,9,10,11,-2,11,Dee Dee Myers,secretary,PERSON-PERSON-PERSON,TITLE,PROPN-PROPN-PROPN,NOUN,compound-compound-nsubj,appos,NNP-NNP-NNP,NN,3,1
348,26390.0,23,sought,13,10,8,-2,9,14,3,-5,Dee Dee Myers,secretary,PERSON-PERSON-PERSON,TITLE,PROPN-PROPN-PROPN,NOUN,compound-compound-appos,nsubj,NNP-NNP-NNP,NN,3,1
349,26445.0,83,expected,3,65,28,-37,64,54,-62,25,Dee Dee Myers,secretary,PERSON-PERSON-PERSON,TITLE,PROPN-PROPN-PROPN,NOUN,compound-compound-nsubj,pobj,NNP-NNP-NNP,NN,8,1
350,29587.0,57,said,29,31,38,7,30,18,-2,9,Dee Dee Myers,secretary,PERSON-PERSON-PERSON,TITLE,PROPN-PROPN-PROPN,NOUN,compound-compound-nsubj,appos,NNP-NNP-NNP,NN,2,1
351,30231.0,40,had,5,17,23,6,16,16,-12,18,Dee Dee Myers,secretary,PERSON-PERSON-PERSON,TITLE,PROPN-PROPN-PROPN,NOUN,compound-compound-conj,appos,NNP-NNP-NNP,NN,8,1
352,45892.0,41,'s,1,19,27,8,18,13,-18,26,Dee Dee Myers,secretary,PERSON-PERSON-PERSON,TITLE,PROPN-PROPN-PROPN,NOUN,compound-compound-nsubj,appos,NNP-NNP-NNP,NN,4,1
353,49770.0,35,social-welfare,3,16,15,-1,15,19,-13,12,Dee Dee Myers,secretary,PERSON-PERSON-PERSON,TITLE,PROPN-PROPN-PROPN,NOUN,compound-compound-appos,pobj,NNP-NNP-NNP,NN,1,1
354,62494.0,38,fought,24,11,21,10,10,16,13,-3,Dee Dee Myers,secretary,PERSON-PERSON-PERSON,TITLE,PROPN-PROPN-PROPN,NOUN,compound-compound-nsubj,pobj,NNP-NNP-NNP,NN,4,1
355,63893.0,83,telling,9,44,52,8,43,30,-35,43,Dee Dee Myers,secretary,PERSON-PERSON-PERSON,TITLE,PROPN-PROPN-PROPN,NOUN,compound-compound-appos,appos,NNP-NNP-NNP,NN,4,1
356,566.0,44,said,9,43,39,-4,42,4,-34,30,FEC,six members,ORGANIZATION,NUMBER-NUMBER,PROPN,NUM-NOUN,pobj,nummod-pobj,NNP,CD-NNS,3,1
357,569.0,22,asked,6,8,6,-2,7,15,-2,0,Gonzales,Wisconsin,PERSON,STATE_OR_PROVINCE,PROPN,PROPN,dobj,pobj,NNP,NNP,2,1
358,579.0,38,received,5,2,2,0,1,35,3,-3,APA,APA Office,ORGANIZATION,ORGANIZATION-ORGANIZATION,PROPN,PROPN-PROPN,compound,compound-nsubj,NNP,NNP-NNP,0,1
359,585.0,36,represented,3,34,33,-1,33,2,-31,30,Ahmad Qattan,ambassador,PERSON-PERSON,TITLE,PROPN-PROPN,NOUN,compound-dobj,compound,NNP-NNP,NN,1,1
360,12449.0,26,said,11,9,3,-6,8,22,2,-8,Ahmad Qattan,ambassador,PERSON-PERSON,TITLE,PROPN-PROPN,NOUN,compound-appos,nsubj,NNP-NNP,NN,2,1
361,591.0,30,says,7,6,2,-4,5,27,1,-5,John Negroponte,US,PERSON-PERSON,COUNTRY,PROPN-PROPN,PROPN,compound-nsubj,nmod,NNP-NNP,NNP,1,1
362,9463.0,27,reported,23,1,4,3,0,22,22,-19,John Negroponte,US,PERSON-PERSON,ORGANIZATION,PROPN-PROPN,PROPN,compound-nsubj,compound,NNP-NNP,NNP,1,1
363,27905.0,20,announced,16,6,1,-5,5,18,10,-15,John Negroponte,US,PERSON-PERSON,ORGANIZATION,PROPN-PROPN,PROPN,compound-nsubj,nmod,NNP-NNP,NNP,2,1
364,34503.0,41,despatching,21,23,29,6,22,11,-2,8,John Negroponte,US,PERSON-PERSON,COUNTRY,PROPN-PROPN,PROPN,compound-dobj,nmod,NNP-NNP,NNP,6,1
365,38286.0,16,Note,1,6,11,5,5,4,-5,10,John Negroponte,US,PERSON-PERSON,COUNTRY,PROPN-PROPN,PROPN,compound-pobj,compound,NNP-NNP,NNP,2,1
366,39341.0,33,said,31,3,1,-2,2,31,28,-30,John Negroponte,US,PERSON-PERSON,ORGANIZATION,PROPN-PROPN,PROPN,compound-nsubj,compound,NNP-NNP,NNP,1,1
367,60163.0,43,touched,25,13,8,-5,12,34,12,-17,John Negroponte,US,PERSON-PERSON,COUNTRY,PROPN-PROPN,PROPN,compound-pobj,compound,NNP-NNP,NNP,3,1
368,67019.0,40,BEIJING,0,35,30,-5,34,9,-35,30,John Negroponte,US,PERSON-PERSON,ORGANIZATION,PROPN-PROPN,PROPN,compound-pobj,nmod,NNP-NNP,NNP,2,1
369,592.0,29,said,27,26,7,-19,25,21,1,-20,Bill McAllister,Wasilla,PERSON-PERSON,CITY,PROPN-PROPN,PROPN,compound-nsubj,pobj,NNP-NNP,NNP,3,1
370,598.0,6,passed,1,1,5,4,0,0,0,4,He,Saturday,PERSON,DATE,PRON,PROPN,nsubj,pobj,PRP,NNP,1,1
371,601.0,34,noticed,2,20,19,-1,19,14,-18,17,Mahdi,Imam,PERSON,TITLE,PROPN,PROPN,poss,compound,NNP,NNP,1,1
372,15934.0,37,pay,3,17,10,-7,16,26,-14,7,Mahdi,Imam,PERSON,TITLE,PROPN,PROPN,poss,compound,NNP,NNP,8,1
373,24407.0,29,went,2,2,1,-1,1,27,0,-1,Mahdi,Imam,PERSON,TITLE,PROPN,PROPN,nsubj,compound,NNP,NNP,1,1
374,39470.0,33,replied,2,26,25,-1,25,7,-24,23,Mahdi,Imam,PERSON,TITLE,PROPN,PROPN,poss,compound,NNP,NNP,1,1
375,59229.0,30,Talib,4,23,1,-22,22,28,-19,-3,Mahdi,Imam,PERSON,TITLE,PROPN,PROPN,compound,compound,NNP,NNP,3,1
376,64302.0,38,said,3,20,19,-1,19,18,-17,16,Mahdi,Imam,PERSON,TITLE,PROPN,PROPN,pobj,compound,NNP,NNP,1,1
377,603.0,45,STRANDS,3,8,38,30,7,6,-5,35,Red Cross,Mile High Chapter of the Red Cross,ORGANIZATION-ORGANIZATION,ORGANIZATION-ORGANIZATION-ORGANIZATION-ORGANIZATION-ORGANIZATION-ORGANIZATION-ORGANIZATION,PROPN-PROPN,PROPN-PROPN-NOUN-ADP-DET-PROPN-PROPN,compound-nsubj,compound-compound-pobj-prep-det-compound-pobj,NNP-NNP,NNP-NNP-NN-IN-DT-NNP-NNP,-1,1
378,607.0,46,returned,5,4,40,36,3,5,1,35,Mr Scheider,New York,PERSON-PERSON,STATE_OR_PROVINCE-STATE_OR_PROVINCE,PROPN-PROPN,PROPN-PROPN,compound-nsubj,compound-pobj,NNP-NNP,NNP-NNP,10,1
379,610.0,46,finished,11,22,10,-12,21,35,-11,-1,ISU,China,ORGANIZATION,COUNTRY,PROPN,PROPN,compound,pobj,NNP,NNP,5,1
380,611.0,37,told,30,29,27,-2,28,9,1,-3,Mahmood Shah,analyst,PERSON-PERSON,TITLE,PROPN-PROPN,NOUN,compound-nsubj,compound,NNP-NNP,NN,2,1
381,6085.0,24,said,12,14,23,9,13,0,-2,11,Mahmood Shah,analyst,PERSON-PERSON,TITLE,PROPN-PROPN,NOUN,compound-nsubj,appos,NNP-NNP,NN,3,1
382,19323.0,24,said,15,17,23,6,16,0,-2,8,Mahmood Shah,analyst,PERSON-PERSON,TITLE,PROPN-PROPN,NOUN,compound-nsubj,appos,NNP-NNP,NN,2,1
383,20912.0,39,said,25,28,27,-1,27,11,-3,2,Mahmood Shah,analyst,PERSON-PERSON,TITLE,PROPN-PROPN,NOUN,compound-nsubj,compound,NNP-NNP,NN,2,1
384,32913.0,64,said,48,51,50,-1,50,13,-3,2,Mahmood Shah,analyst,PERSON-PERSON,TITLE,PROPN-PROPN,NOUN,compound-nsubj,compound,NNP-NNP,NN,1,1
385,37794.0,22,said,10,12,17,5,11,4,-2,7,Mahmood Shah,analyst,PERSON-PERSON,TITLE,PROPN-PROPN,NOUN,compound-nsubj,appos,NNP-NNP,NN,2,1
386,50396.0,21,said,9,11,16,5,10,4,-2,7,Mahmood Shah,analyst,PERSON-PERSON,TITLE,PROPN-PROPN,NOUN,compound-nsubj,appos,NNP-NNP,NN,2,1
387,619.0,36,followed,10,34,30,-4,33,5,-24,20,John Negroponte,Deputy Secretary of State,PERSON-PERSON,TITLE-TITLE-TITLE-TITLE,PROPN-PROPN,PROPN-PROPN-ADP-PROPN,compound-pobj,nmod-nmod-prep-pobj,NNP-NNP,NNP-NNP-IN-NNP,1,1
388,7756.0,20,said,12,18,14,-4,17,5,-6,2,John Negroponte,Deputy Secretary of State,PERSON-PERSON,TITLE-TITLE-TITLE-TITLE,PROPN-PROPN,PROPN-PROPN-ADP-PROPN,compound-nsubj,nmod-nmod-prep-pobj,NNP-NNP,NNP-NNP-IN-NNP,3,1
389,19023.0,71,said,66,6,2,-4,5,68,60,-64,John Negroponte,Deputy Secretary of State,PERSON-PERSON,TITLE-TITLE-TITLE-TITLE,PROPN-PROPN,PROPN-PROPN-ADP-PROPN,compound-nsubj,nmod-nmod-prep-pobj,NNP-NNP,NNP-NNP-IN-NNP,1,1
390,28809.0,20,added,10,1,6,5,0,13,9,-4,John Negroponte,Deputy Secretary of State,PERSON-PERSON,TITLE-TITLE-TITLE-TITLE,PROPN-PROPN,PROPN-PROPN-ADP-PROPN,compound-nsubj,compound-appos-prep-pobj,NNP-NNP,NNP-NNP-IN-NNP,1,1
391,33956.0,32,is,7,6,2,-4,5,29,1,-5,John Negroponte,Deputy Secretary of State,PERSON-PERSON,TITLE-TITLE-TITLE-TITLE,PROPN-PROPN,PROPN-PROPN-ADP-PROPN,compound-nsubj,nmod-nmod-prep-pobj,NNP-NNP,NNP-NNP-IN-NNP,1,1
392,38734.0,55,urged,15,6,2,-4,5,52,9,-13,John Negroponte,Deputy Secretary of State,PERSON-PERSON,TITLE-TITLE-TITLE-TITLE,PROPN-PROPN,PROPN-PROPN-ADP-PROPN,compound-nsubj,nmod-nmod-prep-pobj,NNP-NNP,NNP-NNP-IN-NNP,1,1
393,50061.0,50,vowed,17,14,10,-4,13,39,3,-7,John Negroponte,Deputy Secretary of State,PERSON-PERSON,TITLE-TITLE-TITLE-TITLE,PROPN-PROPN,PROPN-PROPN-ADP-PROPN,compound-pobj,nmod-nmod-prep-pobj,NNP-NNP,NNP-NNP-IN-NNP,4,1
394,51644.0,34,said,13,6,2,-4,5,31,7,-11,John Negroponte,Deputy Secretary of State,PERSON-PERSON,TITLE-TITLE-TITLE-TITLE,PROPN-PROPN,PROPN-PROPN-ADP-PROPN,compound-nsubj,nmod-nmod-prep-pobj,NNP-NNP,NNP-NNP-IN-NNP,1,1
395,627.0,39,died,30,1,32,31,0,6,29,2,Mary Dent Crisp,March 24,PERSON-PERSON-PERSON,DATE-DATE,PROPN-PROPN-PROPN,PROPN-NUM,compound-compound-nsubj,npadvmod-nummod,NNP-NNP-NNP,NNP-CD,4,1
396,631.0,42,called,14,37,35,-2,36,6,-23,21,Hugo Chavez,Venezuelan,PERSON-PERSON,ORGANIZATION,PROPN-PROPN,ADJ,compound-dobj,amod,NNP-NNP,JJ,2,1
397,1295.0,21,says,4,3,1,-2,2,19,1,-3,Hugo Chavez,Venezuelan,PERSON-PERSON,NATIONALITY,PROPN-PROPN,ADJ,compound-nsubj,amod,NNP-NNP,JJ,1,1
398,15805.0,29,criticized,5,3,1,-2,2,27,2,-4,Hugo Chavez,Venezuelan,PERSON-PERSON,NATIONALITY,PROPN-PROPN,ADJ,compound-nsubj,amod,NNP-NNP,JJ,1,1
399,25561.0,31,nationalizes,5,11,9,-2,10,21,-6,4,Hugo Chavez,Venezuelan,PERSON-PERSON,ORGANIZATION,PROPN-PROPN,ADJ,compound-nsubj,amod,NNP-NNP,JJ,1,1
400,41945.0,44,are,13,12,10,-2,11,33,1,-3,Hugo Chavez,Venezuelan,PERSON-PERSON,NATIONALITY,PROPN-PROPN,ADJ,compound-appos,amod,NNP-NNP,JJ,1,1
401,60177.0,56,shows,1,52,50,-2,51,5,-51,49,Hugo Chavez,Venezuelan,PERSON-PERSON,NATIONALITY,PROPN-PROPN,ADJ,compound-poss,amod,NNP-NNP,JJ,1,1
402,63307.0,40,allege,1,20,18,-2,19,21,-19,17,Hugo Chavez,Venezuelan,PERSON-PERSON,NATIONALITY,PROPN-PROPN,ADJ,compound-pobj,amod,NNP-NNP,JJ,1,1
403,67071.0,22,decided,1,8,6,-2,7,15,-7,5,Hugo Chavez,Venezuelan,PERSON-PERSON,ORGANIZATION,PROPN-PROPN,ADJ,compound-poss,amod,NNP-NNP,JJ,1,1
404,632.0,31,gained,2,25,20,-5,24,10,-23,18,Clarence Mitchell III,his,PERSON-PERSON-PERSON,PERSON,PROPN-PROPN-PROPN,DET,compound-compound-ROOT,poss,NNP-NNP-NNP,PRP$,5,1
405,637.0,53,be,21,15,5,-10,14,47,6,-16,Dee Dee Myers,White House,PERSON-PERSON-PERSON,ORGANIZATION-ORGANIZATION,PROPN-PROPN-PROPN,PROPN-PROPN,compound-compound-nsubj,compound-nsubj,NNP-NNP-NNP,NNP-NNP,4,1
406,5985.0,29,has,12,10,7,-3,9,21,2,-5,Dee Dee Myers,White House,PERSON-PERSON-PERSON,ORGANIZATION-ORGANIZATION,PROPN-PROPN-PROPN,PROPN-PROPN,compound-compound-nsubj,compound-compound,NNP-NNP-NNP,NNP-NNP,3,1
407,13727.0,93,had,7,44,54,10,43,38,-37,47,Dee Dee Myers,White House,PERSON-PERSON-PERSON,ORGANIZATION-ORGANIZATION,PROPN-PROPN-PROPN,PROPN-PROPN,compound-compound-conj,compound-pobj,NNP-NNP-NNP,NNP-NNP,4,1
408,27501.0,93,had,7,44,54,10,43,38,-37,47,Dee Dee Myers,White House,PERSON-PERSON-PERSON,ORGANIZATION-ORGANIZATION,PROPN-PROPN-PROPN,PROPN-PROPN,compound-compound-conj,compound-pobj,NNP-NNP-NNP,NNP-NNP,4,1
409,36121.0,27,is,1,14,10,-4,13,16,-13,9,Dee Dee Myers,White House,PERSON-PERSON-PERSON,ORGANIZATION-ORGANIZATION,PROPN-PROPN-PROPN,PROPN-PROPN,compound-compound-nsubj,compound-compound,NNP-NNP-NNP,NNP-NNP,5,1
410,39271.0,32,said,9,11,17,6,10,14,-2,8,Dee Dee Myers,White House,PERSON-PERSON-PERSON,ORGANIZATION-ORGANIZATION,PROPN-PROPN-PROPN,PROPN-PROPN,compound-compound-nsubj,compound-compound,NNP-NNP-NNP,NNP-NNP,3,1
411,45530.0,28,attracting,25,12,8,-4,11,19,13,-17,Dee Dee Myers,White House,PERSON-PERSON-PERSON,ORGANIZATION-ORGANIZATION,PROPN-PROPN-PROPN,PROPN-PROPN,compound-compound-nsubj,compound-compound,NNP-NNP-NNP,NNP-NNP,4,1
412,53830.0,43,said,11,13,22,9,12,20,-2,11,Dee Dee Myers,White House,PERSON-PERSON-PERSON,ORGANIZATION-ORGANIZATION,PROPN-PROPN-PROPN,PROPN-PROPN,compound-compound-nsubj,compound-compound,NNP-NNP-NNP,NNP-NNP,6,1
413,64724.0,26,announced,7,5,1,-4,4,24,2,-6,Dee Dee Myers,White House,PERSON-PERSON-PERSON,ORGANIZATION-ORGANIZATION,PROPN-PROPN-PROPN,PROPN-PROPN,compound-compound-nsubj,compound-compound,NNP-NNP-NNP,NNP-NNP,3,1
414,67338.0,23,sought,13,10,5,-5,9,17,3,-8,Dee Dee Myers,White House,PERSON-PERSON-PERSON,ORGANIZATION-ORGANIZATION,PROPN-PROPN-PROPN,PROPN-PROPN,compound-compound-appos,compound-compound,NNP-NNP-NNP,NNP-NNP,3,1
415,638.0,67,confirmed,9,13,5,-8,12,61,-4,-4,American Psychiatric Association,U.S.,ORGANIZATION-ORGANIZATION-ORGANIZATION,COUNTRY,PROPN-PROPN-PROPN,PROPN,compound-compound-nsubj,compound,NNP-NNP-NNP,NNP,4,1
416,887.0,69,confirmed,9,13,5,-8,12,63,-4,-4,American Psychiatric Association,U.S.,ORGANIZATION-ORGANIZATION-ORGANIZATION,COUNTRY,PROPN-PROPN-PROPN,PROPN,compound-compound-nsubj,compound,NNP-NNP-NNP,NNP,4,1
417,640.0,62,said,37,39,44,5,38,17,-2,7,Sheldon,lawmaker,PERSON,TITLE,PROPN,NOUN,nsubj,appos,NNP,NN,1,1
418,644.0,9,is,1,6,1,-5,5,7,-5,0,National Action Network,Sharpton,ORGANIZATION-ORGANIZATION-ORGANIZATION,PERSON,PROPN-PROPN-PROPN,PROPN,compound-compound-pobj,nsubj,NNP-NNP-NNP,NNP,4,1
419,9224.0,32,included,14,11,9,-2,10,22,3,-5,National Action Network,Sharpton,ORGANIZATION-ORGANIZATION-ORGANIZATION,PERSON,PROPN-PROPN-PROPN,PROPN,compound-compound-pobj,poss,NNP-NNP-NNP,NNP,3,1
420,16289.0,42,said,29,39,31,-8,38,10,-10,2,National Action Network,Sharpton,ORGANIZATION-ORGANIZATION-ORGANIZATION,PERSON,PROPN-PROPN-PROPN,PROPN,compound-compound-appos,nsubj,NNP-NNP-NNP,NNP,4,1
421,16701.0,62,said,20,59,4,-55,58,57,-39,-16,National Action Network,Sharpton,ORGANIZATION-ORGANIZATION-ORGANIZATION,PERSON,PROPN-PROPN-PROPN,PROPN,compound-compound-pobj,poss,NNP-NNP-NNP,NNP,10,1
422,34123.0,26,said,1,20,10,-10,19,15,-19,9,National Action Network,Sharpton,ORGANIZATION-ORGANIZATION-ORGANIZATION,PERSON,PROPN-PROPN-PROPN,PROPN,compound-compound-pobj,nsubj,NNP-NNP-NNP,NNP,6,1
423,35183.0,37,praised,1,8,1,-7,7,35,-7,0,National Action Network,Sharpton,ORGANIZATION-ORGANIZATION-ORGANIZATION,PERSON,PROPN-PROPN-PROPN,PROPN,compound-compound-poss,nsubj,NNP-NNP-NNP,NNP,6,1
424,37670.0,38,said,19,11,5,-6,10,32,8,-14,National Action Network,Sharpton,ORGANIZATION-ORGANIZATION-ORGANIZATION,PERSON,PROPN-PROPN-PROPN,PROPN,compound-compound-pobj,nsubj,NNP-NNP-NNP,NNP,5,1
425,40184.0,40,said,1,28,1,-27,27,38,-27,0,National Action Network,Sharpton,ORGANIZATION-ORGANIZATION-ORGANIZATION,PERSON,PROPN-PROPN-PROPN,PROPN,compound-compound-pobj,poss,NNP-NNP-NNP,NNP,4,1
426,43392.0,30,was,1,25,6,-19,24,23,-24,5,National Action Network,Sharpton,ORGANIZATION-ORGANIZATION-ORGANIZATION,PERSON,PROPN-PROPN-PROPN,PROPN,compound-compound-pobj,nsubj,NNP-NNP-NNP,NNP,6,1
427,48260.0,53,told,32,43,32,-11,42,20,-11,0,National Action Network,Sharpton,ORGANIZATION-ORGANIZATION-ORGANIZATION,PERSON,PROPN-PROPN-PROPN,PROPN,compound-compound-compound,nsubj,NNP-NNP-NNP,NNP,6,1
428,60992.0,18,said,4,10,1,-9,9,16,-6,-3,National Action Network,Sharpton,ORGANIZATION-ORGANIZATION-ORGANIZATION,PERSON,PROPN-PROPN-PROPN,ADJ,compound-compound-conj,compound,NNP-NNP-NNP,JJ,6,1
429,645.0,17,be,13,2,5,3,1,11,11,-8,Chris Dodd,Connecticut,PERSON-PERSON,STATE_OR_PROVINCE,PROPN-PROPN,PROPN,compound-nsubj,pobj,NNP-NNP,NNP,1,1
430,8494.0,55,-RRB-,0,3,17,14,2,37,-3,17,Chris Dodd,Connecticut,PERSON-PERSON,STATE_OR_PROVINCE,PROPN-PROPN,PROPN,compound-ROOT,pobj,NNP-NNP,NNP,-1,1
431,9162.0,18,asking,2,6,17,11,5,0,-4,15,Chris Dodd,Connecticut,PERSON-PERSON,STATE_OR_PROVINCE,PROPN-PROPN,PROPN,compound-pobj,pobj,NNP-NNP,NNP,8,1
432,24778.0,32,took,26,13,16,3,12,15,13,-10,Chris Dodd,Connecticut,PERSON-PERSON,STATE_OR_PROVINCE,PROPN-PROPN,PROPN,compound-pobj,pobj,NNP-NNP,NNP,2,1
433,55892.0,14,proposed,6,2,5,3,1,8,4,-1,Chris Dodd,Connecticut,PERSON-PERSON,STATE_OR_PROVINCE,PROPN-PROPN,PROPN,compound-nsubj,pobj,NNP-NNP,NNP,2,1
434,60231.0,28,campaigned,19,16,14,-2,15,13,3,-5,Chris Dodd,Connecticut,PERSON-PERSON,STATE_OR_PROVINCE,PROPN-PROPN,PROPN,compound-compound,compound,NNP-NNP,NNP,1,1
435,65848.0,16,follows,1,4,7,3,3,8,-3,6,Chris Dodd,Connecticut,PERSON-PERSON,STATE_OR_PROVINCE,PROPN-PROPN,PROPN,compound-nsubj,pobj,NNP-NNP,NNP,2,1
436,655.0,28,worked,6,6,17,11,5,10,0,11,she,DLA Piper,PERSON,ORGANIZATION-ORGANIZATION,PRON,PROPN-PROPN,nsubj,compound-pobj,PRP,NNP-NNP,4,1
437,656.0,31,is,8,1,6,5,0,24,7,-2,Cathie Black,Hearst Magazines,PERSON-PERSON,ORGANIZATION-ORGANIZATION,PROPN-PROPN,PROPN-PROPN,compound-nsubj,compound-pobj,NNP-NNP,NNP-NNPS,3,1
438,24558.0,29,said,20,22,27,5,21,1,-2,7,Cathie Black,Hearst Magazines,PERSON-PERSON,ORGANIZATION-ORGANIZATION,PROPN-PROPN,PROPN-PROPN,compound-nsubj,compound-appos,NNP-NNP,NNP-NNPS,2,1
439,660.0,19,http://wwwdeborahjeanepalfreycom,0,12,1,-11,11,17,-12,1,Palfrey,http://wwwdeborahjeanepalfreycom,ORGANIZATION,URL,PROPN,X,nsubj,ROOT,NNP,ADD,3,1
440,661.0,25,removed,14,12,16,4,11,8,2,2,Sandy,him,PERSON,PERSON,PROPN,PRON,poss,nsubj,NNP,PRP,4,1
441,667.0,39,said,9,11,5,-6,10,33,-2,-4,he,district attorney,PERSON,TITLE-TITLE,PRON,NOUN-NOUN,nsubj,compound-appos,PRP,NN-NN,3,1
442,675.0,36,said,33,2,1,-1,1,34,31,-32,Mia Farrow,Actress,PERSON-PERSON,TITLE,PROPN-PROPN,PROPN,compound-nsubj,compound,NNP-NNP,NNP,1,1
443,1702.0,30,pleaded,3,2,1,-1,1,28,1,-2,Mia Farrow,Actress,PERSON-PERSON,TITLE,PROPN-PROPN,PROPN,compound-nsubj,compound,NNP-NNP,NNP,1,1
444,40308.0,42,GENEVA,0,4,3,-1,3,38,-4,3,Mia Farrow,Actress,PERSON-PERSON,TITLE,PROPN-PROPN,PROPN,compound-nsubj,compound,NNP-NNP,NNP,1,1
445,42487.0,26,encountered,3,2,1,-1,1,24,1,-2,Mia Farrow,Actress,PERSON-PERSON,TITLE,PROPN-PROPN,PROPN,compound-nsubj,compound,NNP-NNP,NNP,1,1
446,49801.0,40,leads,2,1,11,10,0,28,1,9,Mia Farrow,Actress,PERSON-PERSON,TITLE,PROPN-PROPN,PROPN,compound-nsubj,compound,NNP-NNP,NNP,6,1
447,67923.0,35,said,33,7,2,-5,6,32,26,-31,Mia Farrow,Actress,PERSON-PERSON,TITLE,PROPN-PROPN,NOUN,compound-appos,nsubj,NNP-NNP,NN,3,1
448,693.0,24,wonder,4,7,21,14,6,2,-3,17,Simon Cowell,American,PERSON-PERSON,NATIONALITY,PROPN-PROPN,PROPN,compound-nsubj,compound,NNP-NNP,NNP,4,1
449,694.0,49,invested,2,11,1,-10,10,47,-9,-1,Covidien,Yoon,ORGANIZATION,PERSON,PROPN,PROPN,pobj,nsubj,NNP,NNP,7,1
450,701.0,24,said,13,10,2,-8,9,21,3,-11,Army medical command,Elspeth Ritchie,ORGANIZATION-ORGANIZATION-ORGANIZATION,PERSON-PERSON,PROPN-ADJ-NOUN,PROPN-PROPN,nmod-amod-pobj,compound-nsubj,NNP-JJ-NN,NNP-NNP,4,1
451,718.0,17,August,0,5,9,4,4,7,-5,9,Irene Morgan Kirkaldy,90,PERSON-PERSON-PERSON,NUMBER,PROPN-PROPN-PROPN,NUM,compound-compound-appos,appos,NNP-NNP-NNP,CD,3,1
452,20376.0,45,changed,23,1,5,4,0,39,22,-18,Irene Morgan Kirkaldy,90,PERSON-PERSON-PERSON,NUMBER,PROPN-PROPN-PROPN,NUM,compound-compound-nsubj,appos,NNP-NNP-NNP,CD,2,1
453,46969.0,10,Kirkaldy,5,4,8,4,3,1,1,3,Irene Morgan Kirkaldy,90,PERSON-PERSON-PERSON,NUMBER,PROPN-PROPN-PROPN,NUM,compound-compound-ROOT,appos,NNP-NNP-NNP,CD,3,1
454,726.0,9,died,5,1,4,3,0,4,4,-1,Herrera,Ramona,PERSON,PERSON,PROPN,PROPN,poss,appos,NNP,NNP,4,1
455,732.0,19,came,1,16,14,-2,15,4,-15,13,Illinois Tool,US,ORGANIZATION-ORGANIZATION,COUNTRY,PROPN-PROPN,PROPN,compound-compound,compound,NNP-NNP,NNP,2,1
456,66287.0,32,double,9,6,12,6,5,19,3,3,Illinois Tool,US,ORGANIZATION-ORGANIZATION,COUNTRY,PROPN-PROPN,PROPN,compound-pobj,compound,NNP-NNP,NNP,5,1
457,733.0,32,Do,2,24,30,6,23,1,-22,28,Sean Preston,Christian Michael,PERSON-PERSON,PERSON-PERSON,PROPN-PROPN,ADJ-PROPN,compound-poss,compound-attr,NNP-NNP,JJ-NNP,3,1
458,738.0,32,broke,1,15,20,5,14,11,-14,19,Justice and Equality Movement,JEM,ORGANIZATION-ORGANIZATION-ORGANIZATION-ORGANIZATION,ORGANIZATION,PROPN-CCONJ-PROPN-PROPN,PROPN,nmod-cc-conj-pobj,compound,NNP-CC-NNP-NNP,NNP,8,1
459,2550.0,51,held,14,27,32,5,26,18,-13,18,Justice and Equality Movement,JEM,ORGANIZATION-ORGANIZATION-ORGANIZATION-ORGANIZATION,ORGANIZATION,PROPN-CCONJ-PROPN-PROPN,PROPN,nmod-cc-conj-pobj,compound,NNP-CC-NNP-NNP,NNP,5,1
460,13738.0,40,held,26,11,16,5,10,23,15,-10,Justice and Equality Movement,JEM,ORGANIZATION-ORGANIZATION-ORGANIZATION-ORGANIZATION,ORGANIZATION,PROPN-CCONJ-PROPN-PROPN,PROPN,nmod-cc-conj-conj,compound,NNP-CC-NNP-NNP,NNP,9,1
461,15599.0,48,acknowledged,12,40,45,5,39,2,-28,33,Justice and Equality Movement,JEM,ORGANIZATION-ORGANIZATION-ORGANIZATION-ORGANIZATION,ORGANIZATION,PROPN-CCONJ-PROPN-PROPN,PROPN,nmod-cc-conj-conj,compound,NNP-CC-NNP-NNP,NNP,9,1
462,15754.0,42,Sandal,1,9,14,5,8,27,-8,13,Justice and Equality Movement,JEM,ORGANIZATION-ORGANIZATION-ORGANIZATION-ORGANIZATION,MISC,PROPN-CCONJ-PROPN-PROPN,PROPN,nmod-cc-conj-pobj,compound,NNP-CC-NNP-NNP,NNP,6,1
463,16206.0,27,said,2,13,18,5,12,8,-11,16,Justice and Equality Movement,JEM,ORGANIZATION-ORGANIZATION-ORGANIZATION-ORGANIZATION,ORGANIZATION,PROPN-CCONJ-PROPN-PROPN,PROPN,nmod-cc-conj-pobj,compound,NNP-CC-NNP-NNP,NNP,7,1
464,17080.0,39,was,33,11,19,8,10,19,22,-14,Justice and Equality Movement,JEM,ORGANIZATION-ORGANIZATION-ORGANIZATION-ORGANIZATION,ORGANIZATION,PROPN-CCONJ-PROPN-PROPN,PROPN,nmod-cc-conj-pobj,pobj,NNP-CC-NNP-NNP,NNP,7,1
465,18911.0,43,country,3,24,29,5,23,13,-21,26,Justice and Equality Movement,JEM,ORGANIZATION-ORGANIZATION-ORGANIZATION-ORGANIZATION,ORGANIZATION,PROPN-CCONJ-PROPN-PROPN,PROPN,nmod-cc-conj-appos,compound,NNP-CC-NNP-NNP,NNP,8,1
466,18942.0,45,ceasefire,4,14,19,5,13,25,-10,15,Justice and Equality Movement,JEM,ORGANIZATION-ORGANIZATION-ORGANIZATION-ORGANIZATION,ORGANIZATION,PROPN-CCONJ-PROPN-PROPN,PROPN,nmod-cc-conj-conj,compound,NNP-CC-NNP-NNP,NNP,6,1
467,20386.0,41,announced,23,9,14,5,8,26,14,-9,Justice and Equality Movement,JEM,ORGANIZATION-ORGANIZATION-ORGANIZATION-ORGANIZATION,ORGANIZATION,PROPN-CCONJ-PROPN-PROPN,PROPN,conj-cc-compound-conj,compound,NNP-CC-NNP-NNP,NNP,6,1
468,21906.0,39,KHARTOUM,0,15,20,5,14,18,-15,20,Justice and Equality Movement,JEM,ORGANIZATION-ORGANIZATION-ORGANIZATION-ORGANIZATION,ORGANIZATION,PROPN-CCONJ-PROPN-PROPN,PROPN,nmod-cc-conj-pobj,compound,NNP-CC-NNP-NNP,NNP,8,1
469,31529.0,53,LD,1,41,46,5,40,6,-40,45,Justice and Equality Movement,JEM,ORGANIZATION-ORGANIZATION-ORGANIZATION-ORGANIZATION,ORGANIZATION,PROPN-CCONJ-PROPN-PROPN,PROPN,nmod-cc-conj-pobj,compound,NNP-CC-NNP-NNP,NNP,6,1
470,37239.0,33,say,2,14,19,5,13,13,-12,17,Justice and Equality Movement,JEM,ORGANIZATION-ORGANIZATION-ORGANIZATION-ORGANIZATION,ORGANIZATION,PROPN-CCONJ-PROPN-PROPN,PROPN,nmod-cc-conj-appos,compound,NNP-CC-NNP-NNP,NNP,9,1
471,37508.0,30,said,11,23,28,5,22,1,-12,17,Justice and Equality Movement,JEM,ORGANIZATION-ORGANIZATION-ORGANIZATION-ORGANIZATION,ORGANIZATION,PROPN-CCONJ-PROPN-PROPN,PROPN,nmod-cc-conj-pobj,compound,NNP-CC-NNP-NNP,NNP,1,1
472,40522.0,59,said,36,7,12,5,6,46,29,-24,Justice and Equality Movement,JEM,ORGANIZATION-ORGANIZATION-ORGANIZATION-ORGANIZATION,ORGANIZATION,PROPN-CCONJ-PROPN-PROPN,PROPN,nmod-cc-conj-pobj,compound,NNP-CC-NNP-NNP,NNP,7,1
473,40739.0,55,absence,2,13,18,5,12,36,-11,16,Justice and Equality Movement,JEM,ORGANIZATION-ORGANIZATION-ORGANIZATION-ORGANIZATION,MISC,PROPN-CCONJ-PROPN-PROPN,PROPN,nmod-cc-conj-pobj,compound,NNP-CC-NNP-NNP,NNP,7,1
474,49948.0,44,said,39,19,24,5,18,19,20,-15,Justice and Equality Movement,JEM,ORGANIZATION-ORGANIZATION-ORGANIZATION-ORGANIZATION,ORGANIZATION,PROPN-CCONJ-PROPN-PROPN,PROPN,nmod-cc-conj-conj,compound,NNP-CC-NNP-NNP,NNP,7,1
475,52739.0,46,KHARTOUM,0,21,26,5,20,19,-21,26,Justice and Equality Movement,JEM,ORGANIZATION-ORGANIZATION-ORGANIZATION-ORGANIZATION,ORGANIZATION,PROPN-CCONJ-PROPN-PROPN,PROPN,nmod-cc-conj-pobj,compound,NNP-CC-NNP-NNP,NNP,6,1
476,55840.0,60,blamed,7,11,16,5,10,43,-4,9,Justice and Equality Movement,JEM,ORGANIZATION-ORGANIZATION-ORGANIZATION-ORGANIZATION,ORGANIZATION,PROPN-CCONJ-PROPN-PROPN,PROPN,nmod-cc-conj-dobj,compound,NNP-CC-NNP-NNP,NNP,4,1
477,745.0,35,survived,2,27,11,-16,26,23,-25,9,Eleanor Derounian,Emily Ann Kennard Derounian,PERSON-PERSON,PERSON-PERSON-PERSON-PERSON,PROPN-PROPN,PROPN-PROPN-PROPN-PROPN,compound-conj,compound-compound-compound-appos,NNP-NNP,NNP-NNP-NNP-NNP,5,1
478,754.0,41,returned,3,3,37,34,2,3,0,34,she,Massachusetts Institute of Technology,PERSON,ORGANIZATION-ORGANIZATION-ORGANIZATION-ORGANIZATION,PRON,PROPN-PROPN-ADP-PROPN,nsubj,compound-pobj-prep-pobj,PRP,NNP-NNP-IN-NNP,7,1
479,758.0,15,formed,9,2,5,3,1,9,7,-4,Deaver,White House,PERSON,ORGANIZATION-ORGANIZATION,PROPN,PROPN-PROPN,nsubj,compound-dobj,NNP,NNP-NNP,1,1
480,766.0,33,said,26,31,29,-2,30,3,-5,3,Bill McAllister,spokesman,PERSON-PERSON,TITLE,PROPN-PROPN,NOUN,compound-appos,nsubj,NNP-NNP,NN,2,1
481,4490.0,29,said,27,26,25,-1,25,3,1,-2,Bill McAllister,spokesman,PERSON-PERSON,TITLE,PROPN-PROPN,NOUN,compound-nsubj,compound,NNP-NNP,NN,1,1
482,5004.0,45,said,6,4,2,-2,3,42,2,-4,Bill McAllister,spokesman,PERSON-PERSON,TITLE,PROPN-PROPN,NOUN,compound-appos,nsubj,NNP-NNP,NN,2,1
483,5053.0,27,said,7,1,6,5,0,20,6,-1,Bill McAllister,spokesman,PERSON-PERSON,TITLE,PROPN-PROPN,NOUN,compound-nsubj,appos,NNP-NNP,NN,2,1
484,6641.0,19,return,11,1,5,4,0,13,10,-6,Bill McAllister,spokesman,PERSON-PERSON,TITLE,PROPN-PROPN,NOUN,compound-nsubj,appos,NNP-NNP,NN,2,1
485,6896.0,9,declined,4,3,2,-1,2,6,1,-2,Bill McAllister,spokesman,PERSON-PERSON,TITLE,PROPN-PROPN,NOUN,compound-nsubj,compound,NNP-NNP,NN,1,1
486,7189.0,28,emerged,18,3,2,-1,2,25,15,-16,Bill McAllister,spokesman,PERSON-PERSON,TITLE,PROPN-PROPN,NOUN,compound-nsubj,compound,NNP-NNP,NN,1,1
487,8338.0,23,said,5,4,3,-1,3,19,1,-2,Bill McAllister,spokesman,PERSON-PERSON,TITLE,PROPN-PROPN,NOUN,compound-nsubj,compound,NNP-NNP,NN,1,1
488,10292.0,25,said,18,23,21,-2,22,3,-5,3,Bill McAllister,spokesman,PERSON-PERSON,TITLE,PROPN-PROPN,NOUN,compound-appos,nsubj,NNP-NNP,NN,2,1
489,12517.0,49,called,1,36,41,5,35,7,-35,40,Bill McAllister,spokesman,PERSON-PERSON,TITLE,PROPN-PROPN,NOUN,compound-nsubj,appos,NNP-NNP,NN,2,1
490,15623.0,24,said,4,3,2,-1,2,21,1,-2,Bill McAllister,spokesman,PERSON-PERSON,TITLE,PROPN-PROPN,NOUN,compound-nsubj,compound,NNP-NNP,NN,1,1
491,18806.0,24,said,17,22,21,-1,21,2,-5,4,Bill McAllister,spokesman,PERSON-PERSON,TITLE,PROPN-PROPN,NOUN,compound-nsubj,compound,NNP-NNP,NN,1,1
492,19848.0,33,said,31,30,29,-1,29,3,1,-2,Bill McAllister,spokesman,PERSON-PERSON,TITLE,PROPN-PROPN,NOUN,compound-nsubj,compound,NNP-NNP,NN,1,1
493,24218.0,21,said,10,12,18,6,11,2,-2,8,Bill McAllister,spokesman,PERSON-PERSON,TITLE,PROPN-PROPN,NOUN,compound-nsubj,appos,NNP-NNP,NN,2,1
494,25816.0,26,denied,5,3,2,-1,2,23,2,-3,Bill McAllister,spokesman,PERSON-PERSON,TITLE,PROPN-PROPN,NOUN,compound-nsubj,compound,NNP-NNP,NN,1,1
495,25840.0,7,McAllister,1,1,5,4,0,1,0,4,Bill McAllister,spokesman,PERSON-PERSON,TITLE,PROPN-PROPN,NOUN,compound-ROOT,appos,NNP-NNP,NN,2,1
496,33968.0,41,said,33,39,37,-2,38,3,-6,4,Bill McAllister,spokesman,PERSON-PERSON,TITLE,PROPN-PROPN,NOUN,compound-appos,nsubj,NNP-NNP,NN,2,1
497,37038.0,50,stopped,1,9,8,-1,8,41,-8,7,Bill McAllister,spokesman,PERSON-PERSON,TITLE,PROPN-PROPN,NOUN,compound-appos,nsubj,NNP-NNP,NN,1,1
498,41058.0,24,said,16,22,20,-2,21,3,-6,4,Bill McAllister,spokesman,PERSON-PERSON,TITLE,PROPN-PROPN,NOUN,compound-appos,nsubj,NNP-NNP,NN,2,1
499,45343.0,33,said,12,10,3,-7,9,29,2,-9,Bill McAllister,spokesman,PERSON-PERSON,TITLE,PROPN-PROPN,NOUN,compound-appos,nsubj,NNP-NNP,NN,2,1
500,45976.0,49,said,10,1,5,4,0,43,9,-5,Bill McAllister,spokesman,PERSON-PERSON,TITLE,PROPN-PROPN,NOUN,compound-nsubj,appos,NNP-NNP,NN,2,1
501,47647.0,50,stopped,1,9,8,-1,8,41,-8,7,Bill McAllister,spokesman,PERSON-PERSON,TITLE,PROPN-PROPN,NOUN,compound-appos,nsubj,NNP-NNP,NN,1,1
502,47996.0,44,said,17,19,23,4,18,20,-2,6,Bill McAllister,spokesman,PERSON-PERSON,TITLE,PROPN-PROPN,NOUN,compound-nsubj,appos,NNP-NNP,NN,2,1
503,54755.0,38,denied,4,12,10,-2,11,27,-8,6,Bill McAllister,spokesman,PERSON-PERSON,TITLE,PROPN-PROPN,NOUN,compound-appos,pobj,NNP-NNP,NN,2,1
504,767.0,5,replaces,1,3,5,2,2,-1,-2,4,Ferrara,Juventus,PERSON,ORGANIZATION,PROPN,PROPN,dobj,pobj,NNP,NNP,-1,1
505,51230.0,35,handed,11,1,7,6,0,27,10,-4,Ferrara,Juventus,PERSON,ORGANIZATION,PROPN,PROPN,nsubjpass,conj,NNP,NNP,2,1
506,772.0,26,concerned,7,5,14,9,4,11,2,7,Sills,Muffy,PERSON,PERSON,PROPN,PROPN,nsubjpass,pobj,NNP,NNP,6,1
507,779.0,17,be,3,2,7,5,1,9,1,4,he,leader,PERSON,TITLE,PRON,NOUN,nsubj,attr,PRP,NN,3,1
508,27641.0,26,say,5,7,3,-4,6,22,-2,-2,he,leader,PERSON,TITLE,PRON,NOUN,nsubj,poss,PRP,NN,5,1
509,40169.0,85,believe,2,24,10,-14,23,74,-22,8,he,leader,PERSON,TITLE,PRON,NOUN,nsubj,attr,PRP,NN,-1,1
510,782.0,19,chided,1,1,4,3,0,14,0,3,Bellecourt,American Indians,PERSON,NATIONALITY-NATIONALITY,PROPN,PROPN-PROPN,nsubj,compound-dobj,NNP,NNP-NNPS,1,1
511,783.0,37,broke,6,5,1,-4,4,35,1,-5,Steve McPherson,ABC,PERSON-PERSON,ORGANIZATION,PROPN-PROPN,PROPN,compound-pobj,compound,NNP-NNP,NNP,2,1
512,8769.0,22,said,13,4,1,-3,3,20,9,-12,Steve McPherson,ABC,PERSON-PERSON,ORGANIZATION,PROPN-PROPN,PROPN,compound-nsubj,compound,NNP-NNP,NNP,2,1
513,9031.0,35,seems,4,13,10,-3,12,24,-9,6,Steve McPherson,ABC,PERSON-PERSON,ORGANIZATION,PROPN-PROPN,PROPN,compound-nsubj,nsubj,NNP-NNP,NNP,2,1
514,11838.0,36,promised,10,9,6,-3,8,29,1,-4,Steve McPherson,ABC,PERSON-PERSON,ORGANIZATION,PROPN-PROPN,PROPN,compound-nsubj,compound,NNP-NNP,NNP,2,1
515,14227.0,29,said,13,12,9,-3,11,19,1,-4,Steve McPherson,ABC,PERSON-PERSON,ORGANIZATION,PROPN-PROPN,PROPN,compound-nsubj,nsubj,NNP-NNP,NNP,2,1
516,18482.0,38,began,2,6,9,3,5,28,-4,7,Steve McPherson,ABC,PERSON-PERSON,ORGANIZATION,PROPN-PROPN,PROPN,compound-pobj,compound,NNP-NNP,NNP,1,1
517,22971.0,42,programming,1,4,1,-3,3,40,-3,0,Steve McPherson,ABC,PERSON-PERSON,ORGANIZATION,PROPN-PROPN,PROPN,compound-nsubj,pobj,NNP-NNP,NNP,2,1
518,25986.0,32,said,5,3,1,-2,2,30,2,-4,Steve McPherson,ABC,PERSON-PERSON,ORGANIZATION,PROPN-PROPN,PROPN,compound-nsubj,compound,NNP-NNP,NNP,1,1
519,26284.0,60,announced,23,22,19,-3,21,40,1,-4,Steve McPherson,ABC,PERSON-PERSON,ORGANIZATION,PROPN-PROPN,PROPN,compound-appos,poss,NNP-NNP,NNP,5,1
520,40200.0,24,are,5,9,7,-2,8,16,-4,2,Steve McPherson,ABC,PERSON-PERSON,ORGANIZATION,PROPN-PROPN,PROPN,compound-attr,compound,NNP-NNP,NNP,1,1
521,40413.0,51,said,5,3,1,-2,2,49,2,-4,Steve McPherson,ABC,PERSON-PERSON,ORGANIZATION,PROPN-PROPN,PROPN,compound-nsubj,compound,NNP-NNP,NNP,1,1
522,41738.0,37,seemed,1,8,11,3,7,25,-7,10,Steve McPherson,ABC,PERSON-PERSON,ORGANIZATION,PROPN-PROPN,PROPN,compound-nsubj,compound,NNP-NNP,NNP,1,1
523,48824.0,42,programming,1,4,1,-3,3,40,-3,0,Steve McPherson,ABC,PERSON-PERSON,ORGANIZATION,PROPN-PROPN,PROPN,compound-nsubj,nsubj,NNP-NNP,NNP,2,1
524,51150.0,40,promised,2,35,33,-2,34,6,-33,31,Steve McPherson,ABC,PERSON-PERSON,ORGANIZATION,PROPN-PROPN,PROPN,compound-nsubj,compound,NNP-NNP,NNP,3,1
525,54309.0,46,play,33,6,1,-5,5,44,27,-32,Steve McPherson,ABC,PERSON-PERSON,ORGANIZATION,PROPN-PROPN,PROPN,compound-pobj,compound,NNP-NNP,NNP,2,1
526,57399.0,28,says,8,7,5,-2,6,22,1,-3,Steve McPherson,ABC,PERSON-PERSON,ORGANIZATION,PROPN-PROPN,PROPN,compound-nsubj,compound,NNP-NNP,NNP,1,1
527,62788.0,32,attacked,5,4,1,-3,3,30,1,-4,Steve McPherson,ABC,PERSON-PERSON,ORGANIZATION,PROPN-PROPN,PROPN,compound-appos,poss,NNP-NNP,NNP,3,1
528,64704.0,35,launched,16,15,13,-2,14,21,1,-3,Steve McPherson,ABC,PERSON-PERSON,ORGANIZATION,PROPN-PROPN,PROPN,compound-nsubj,poss,NNP-NNP,NNP,2,1
529,67372.0,40,said,1,3,6,3,2,33,-2,5,Steve McPherson,ABC,PERSON-PERSON,ORGANIZATION,PROPN-PROPN,PROPN,compound-nsubj,poss,NNP-NNP,NNP,3,1
530,793.0,39,said,21,30,36,6,29,2,-9,15,New Hampshire Institute of Politics,St Anselm College,ORGANIZATION-ORGANIZATION-ORGANIZATION-ORGANIZATION-ORGANIZATION,ORGANIZATION-ORGANIZATION-ORGANIZATION,PROPN-PROPN-PROPN-ADP-PROPN,PROPN-PROPN-PROPN,compound-compound-pobj-prep-pobj,compound-compound-pobj,NNP-NNP-NNP-IN-NNP,NNP-NNP-NNP,5,1
531,2512.0,30,came,2,21,27,6,20,2,-19,25,New Hampshire Institute of Politics,St Anselm College,ORGANIZATION-ORGANIZATION-ORGANIZATION-ORGANIZATION-ORGANIZATION,ORGANIZATION-ORGANIZATION-ORGANIZATION,PROPN-PROPN-PROPN-ADP-PROPN,PROPN-PROPN-PROPN,compound-compound-pobj-prep-pobj,compound-compound-pobj,NNP-NNP-NNP-IN-NNP,NNP-NNP-NNP,4,1
532,27987.0,40,said,20,29,35,6,28,4,-9,15,New Hampshire Institute of Politics,St Anselm College,ORGANIZATION-ORGANIZATION-ORGANIZATION-ORGANIZATION-ORGANIZATION,ORGANIZATION-ORGANIZATION-ORGANIZATION,PROPN-PROPN-PROPN-ADP-PROPN,PROPN-PROPN-PROPN,compound-compound-pobj-prep-pobj,compound-compound-pobj,NNP-NNP-NNP-IN-NNP,NNP-NNP-NNP,7,1
533,799.0,50,include,1,37,34,-3,36,15,-36,33,Daniel Gude,Gregory Gude,PERSON-PERSON,PERSON-PERSON,PROPN-PROPN,PROPN-PROPN,compound-conj,compound-conj,NNP-NNP,NNP-NNP,1,1
534,32606.0,58,include,1,28,20,-8,27,37,-27,19,Daniel Gude,Gregory Gude,PERSON-PERSON,PERSON-PERSON,PROPN-PROPN,PROPN-PROPN,compound-conj,compound-conj,NNP-NNP,NNP-NNP,4,1
535,805.0,40,gave,2,2,22,20,1,17,0,20,She,secretary of state,PERSON,PERSON-PERSON-PERSON,PRON,NOUN-ADP-NOUN,nsubj,nsubj-prep-pobj,PRP,NN-IN-NN,3,1
536,814.0,29,announced,3,14,28,14,13,0,-11,25,Aerolineas Argentinas,Marsans,ORGANIZATION-ORGANIZATION,PERSON,PROPN-PROPN,PROPN,compound-appos,appos,NNP-NNP,NNPS,5,1
537,17000.0,30,approved,3,13,29,16,12,0,-10,26,Aerolineas Argentinas,Marsans,ORGANIZATION-ORGANIZATION,ORGANIZATION,PROPN-PROPN,PROPN,compound-compound,appos,NNP-NNP,NNPS,-1,1
538,20002.0,12,owns,2,7,1,-6,6,10,-5,-1,Aerolineas Argentinas,Marsans,ORGANIZATION-ORGANIZATION,ORGANIZATION,PROPN-PROPN,NOUN,compound-appos,nsubj,NNP-NNP,NNS,3,1
539,20464.0,29,announced,3,14,28,14,13,0,-11,25,Aerolineas Argentinas,Marsans,ORGANIZATION-ORGANIZATION,PERSON,PROPN-PROPN,PROPN,compound-appos,appos,NNP-NNP,NNPS,5,1
540,25934.0,29,announced,3,14,28,14,13,0,-11,25,Aerolineas Argentinas,Marsans,ORGANIZATION-ORGANIZATION,ORGANIZATION,PROPN-PROPN,PROPN,compound-appos,appos,NNP-NNP,NNPS,5,1
541,31063.0,41,reverses,10,4,31,27,3,9,6,21,Aerolineas Argentinas,Marsans,ORGANIZATION-ORGANIZATION,PERSON,PROPN-PROPN,PROPN,compound-pobj,conj,NNP-NNP,NNPS,5,1
542,50406.0,14,owns,2,12,1,-11,11,12,-10,-1,Aerolineas Argentinas,Marsans,ORGANIZATION-ORGANIZATION,PERSON,PROPN-PROPN,PROPN,compound-pobj,nsubj,NNP-NNP,NNPS,4,1
543,819.0,46,DAMASCUS,0,29,1,-28,28,44,-29,1,his,DAMASCUS,PERSON,CITY,DET,NOUN,poss,ROOT,PRP$,NN,-1,1
544,823.0,40,start,24,11,9,-2,10,30,13,-15,RIA Novosti,Russia,ORGANIZATION-ORGANIZATION,COUNTRY,PROPN-PROPN,PROPN,compound-compound,poss,NNP-NNP,NNP,3,1
545,17181.0,38,told,31,34,1,-33,33,36,-3,-30,RIA Novosti,Russia,ORGANIZATION-ORGANIZATION,COUNTRY,PROPN-PROPN,PROPN,compound-compound,poss,NNP-NNP,NNP,6,1
546,23453.0,26,reported,24,21,19,-2,20,6,3,-5,RIA Novosti,Russia,ORGANIZATION-ORGANIZATION,COUNTRY,PROPN-PROPN,PROPN,compound-compound,poss,NNP-NNP,NNP,3,1
547,45395.0,36,reported,28,25,16,-9,24,19,3,-12,RIA Novosti,Russia,ORGANIZATION-ORGANIZATION,COUNTRY,PROPN-PROPN,PROPN,compound-compound,poss,NNP-NNP,NNP,8,1
548,59894.0,58,said,38,54,45,-9,53,12,-16,7,RIA Novosti,Russia,ORGANIZATION-ORGANIZATION,COUNTRY,PROPN-PROPN,PROPN,compound-compound,poss,NNP-NNP,NNP,10,1
549,833.0,16,win,11,14,10,-4,13,5,-3,-1,NFC South,Bucs,ORGANIZATION-ORGANIZATION,ORGANIZATION,PROPN-PROPN,PROPN,compound-dobj,nsubj,NNP-NNP,NNP,2,1
550,35474.0,28,improved,2,16,2,-14,15,25,-14,0,NFC South,Bucs,ORGANIZATION-ORGANIZATION,ORGANIZATION,PROPN-PROPN,PROPN,compound-pobj,nsubj,NNP-NNP,NNP,4,1
551,37335.0,25,20-29,9,23,8,-15,22,16,-14,-1,NFC South,Bucs,ORGANIZATION-ORGANIZATION,ORGANIZATION,PROPN-PROPN,PROPN,compound-pobj,nsubjpass,NNP-NNP,NNP,3,1
552,834.0,13,studied,2,1,6,5,0,6,1,4,He,Simon Bolivar University,PERSON,ORGANIZATION-ORGANIZATION-ORGANIZATION,PRON,PROPN-PROPN-PROPN,nsubj,compound-compound-pobj,PRP,NNP-NNP-NNP,4,1
553,835.0,33,entered,1,3,6,3,2,26,-2,5,Spelman College,Atlanta,ORGANIZATION-ORGANIZATION,CITY,PROPN-PROPN,PROPN,compound-dobj,pobj,NNP-NNP,NNP,1,1
554,2214.0,29,moved,5,18,8,-10,17,20,-13,3,Spelman College,Atlanta,ORGANIZATION-ORGANIZATION,CITY,PROPN-PROPN,PROPN,compound-pobj,pobj,NNP-NNP,NNP,5,1
555,4601.0,32,says,14,10,13,3,9,18,4,-1,Spelman College,Atlanta,ORGANIZATION-ORGANIZATION,CITY,PROPN-PROPN,PROPN,compound-pobj,pobj,NNP-NNP,NNP,5,1
556,13872.0,24,met,4,10,13,3,9,10,-6,9,Spelman College,Atlanta,ORGANIZATION-ORGANIZATION,CITY,PROPN-PROPN,PROPN,compound-pobj,pobj,NNP-NNP,NNP,5,1
557,16532.0,35,said,20,31,34,3,30,0,-11,14,Spelman College,Atlanta,ORGANIZATION-ORGANIZATION,CITY,PROPN-PROPN,PROPN,compound-pobj,pobj,NNP-NNP,NNP,2,1
558,23611.0,41,said,18,30,40,10,29,0,-12,22,Spelman College,Atlanta,ORGANIZATION-ORGANIZATION,CITY,PROPN-PROPN,PROPN,compound-pobj,pobj,NNP-NNP,NNP,7,1
559,24507.0,28,offered,5,17,27,10,16,0,-12,22,Spelman College,Atlanta,ORGANIZATION-ORGANIZATION,CITY,PROPN-PROPN,PROPN,compound-pobj,pobj,NNP-NNP,NNP,7,1
560,37960.0,23,learned,1,18,22,4,17,0,-17,21,Spelman College,Atlanta,ORGANIZATION-ORGANIZATION,CITY,PROPN-PROPN,PROPN,compound-conj,pobj,NNP-NNP,NNP,3,1
561,38703.0,40,said,25,6,16,10,5,23,19,-9,Spelman College,Atlanta,ORGANIZATION-ORGANIZATION,CITY,PROPN-PROPN,PROPN,compound-pobj,pobj,NNP-NNP,NNP,5,1
562,39170.0,27,was,2,20,23,3,19,3,-18,21,Spelman College,Atlanta,ORGANIZATION-ORGANIZATION,CITY,PROPN-PROPN,PROPN,compound-pobj,pobj,NNP-NNP,NNP,4,1
563,40104.0,25,said,8,21,24,3,20,0,-13,16,Spelman College,Atlanta,ORGANIZATION-ORGANIZATION,CITY,PROPN-PROPN,PROPN,compound-pobj,pobj,NNP-NNP,NNP,5,1
564,44044.0,22,says,8,18,21,3,17,0,-10,13,Spelman College,Atlanta,ORGANIZATION-ORGANIZATION,CITY,PROPN-PROPN,PROPN,compound-pobj,pobj,NNP-NNP,NNP,3,1
565,44367.0,37,loved,10,20,23,3,19,13,-10,13,Spelman College,Atlanta,ORGANIZATION-ORGANIZATION,CITY,PROPN-PROPN,PROPN,compound-pobj,pobj,NNP-NNP,NNP,3,1
566,44924.0,40,agitator,3,15,13,-2,14,26,-12,10,Spelman College,Atlanta,ORGANIZATION-ORGANIZATION,CITY,PROPN-PROPN,PROPN,compound-pobj,poss,NNP-NNP,NNP,2,1
567,45558.0,46,said,20,31,34,3,30,11,-11,14,Spelman College,Atlanta,ORGANIZATION-ORGANIZATION,CITY,PROPN-PROPN,PROPN,compound-pobj,pobj,NNP-NNP,NNP,3,1
568,47754.0,26,said,1,6,9,3,5,16,-5,8,Spelman College,Atlanta,ORGANIZATION-ORGANIZATION,CITY,PROPN-PROPN,PROPN,compound-pobj,pobj,NNP-NNP,NNP,1,1
569,53467.0,47,recalled,18,25,28,3,24,18,-7,10,Spelman College,Atlanta,ORGANIZATION-ORGANIZATION,CITY,PROPN-PROPN,PROPN,compound-pobj,pobj,NNP-NNP,NNP,3,1
570,54887.0,70,...,0,42,45,3,41,24,-42,45,Spelman College,Atlanta,ORGANIZATION-ORGANIZATION,CITY,PROPN-PROPN,PROPN,compound-pobj,pobj,NNP-NNP,NNP,4,1
571,59138.0,42,was,26,8,11,3,7,30,18,-15,Spelman College,Atlanta,ORGANIZATION-ORGANIZATION,CITY,PROPN-PROPN,PROPN,compound-pobj,pobj,NNP-NNP,NNP,3,1
572,66992.0,21,rallied,11,6,4,-2,5,16,5,-7,Spelman College,Atlanta,ORGANIZATION-ORGANIZATION,CITY,PROPN-PROPN,PROPN,compound-pobj,poss,NNP-NNP,NNP,2,1
573,839.0,33,Works,2,5,1,-4,4,31,-3,-1,FAW,First Automobile Works,ORGANIZATION,ORGANIZATION-ORGANIZATION-ORGANIZATION,PROPN,PROPN-PROPN-PROPN,compound,compound-compound-ROOT,NNP,NNP-NNP-NNPS,-1,1
574,61939.0,43,sellers,3,20,16,-4,19,26,-17,13,FAW,First Automobile Works,ORGANIZATION,ORGANIZATION-ORGANIZATION-ORGANIZATION,PROPN,PROPN-PROPN-PROPN,compound,compound-compound-appos,NNP,NNP-NNP-NNPS,2,1
575,847.0,28,said,12,8,7,-1,7,20,4,-5,Inter American Press Association,Miami-based,ORGANIZATION-ORGANIZATION-ORGANIZATION-ORGANIZATION,CITY,PROPN-PROPN-PROPN-PROPN,PROPN,compound-compound-compound-pobj,amod,NNP-NNP-NNP-NNP,NNP,1,1
576,43441.0,22,issued,12,3,2,-1,2,19,9,-10,Inter American Press Association,Miami-based,ORGANIZATION-ORGANIZATION-ORGANIZATION-ORGANIZATION,CITY,PROPN-PROPN-PROPN-PROPN,ADJ,compound-compound-compound-nsubj,amod,NNP-NNP-NNP-NNP,JJ,1,1
577,54333.0,49,UTC,4,9,8,-1,8,40,-5,4,Inter American Press Association,Miami-based,ORGANIZATION-ORGANIZATION-ORGANIZATION-ORGANIZATION,CITY,PROPN-PROPN-PROPN-PROPN,ADJ,compound-compound-compound-nsubj,amod,NNP-NNP-NNP-NNP,JJ,1,1
578,848.0,26,was,11,2,18,16,1,7,9,7,Badr Organization,Iran,ORGANIZATION-ORGANIZATION,COUNTRY,PROPN-PROPN,PROPN,compound-nsubj,pobj,NNP-NNP,NNP,4,1
579,861.0,27,agreed,16,24,18,-6,23,8,-8,2,American Bankers Association,Edward Yingling,ORGANIZATION-ORGANIZATION-ORGANIZATION,PERSON-PERSON,PROPN-PROPN-PROPN,PROPN-PROPN,compound-compound-pobj,compound-nsubj,NNP-NNPS-NNP,NNP-NNP,5,1
580,1529.0,46,said,31,39,33,-6,38,12,-8,2,American Bankers Association,Edward Yingling,ORGANIZATION-ORGANIZATION-ORGANIZATION,PERSON-PERSON,PROPN-PROPN-PROPN,PROPN-PROPN,compound-compound-pobj,compound-nsubj,NNP-NNPS-NNP,NNP-NNP,5,1
581,5478.0,33,issued,10,7,1,-6,6,31,3,-9,American Bankers Association,Edward Yingling,ORGANIZATION-ORGANIZATION-ORGANIZATION,PERSON-PERSON,PROPN-PROPN-PROPN,PROPN-PROPN,compound-compound-pobj,compound-nsubj,NNP-NNPS-NNP,NNP-NNP,4,1
582,5708.0,32,said,20,29,22,-7,28,9,-9,2,American Bankers Association,Edward Yingling,ORGANIZATION-ORGANIZATION-ORGANIZATION,PERSON-PERSON,PROPN-PROPN-PROPN,PROPN-PROPN,compound-compound-pobj,compound-nsubj,NNP-NNPS-NNP,NNP-NNP,5,1
583,12285.0,23,issued,16,11,15,4,10,7,5,-1,American Bankers Association,Edward Yingling,ORGANIZATION-ORGANIZATION-ORGANIZATION,PERSON-PERSON,PROPN-PROPN-PROPN,PROPN-PROPN,compound-compound-compound,compound-nsubj,NNP-NNPS-NNP,NNP-NNP,3,1
584,14632.0,39,issued,10,7,1,-6,6,37,3,-9,American Bankers Association,Edward Yingling,ORGANIZATION-ORGANIZATION-ORGANIZATION,PERSON-PERSON,PROPN-PROPN-PROPN,PROPN-PROPN,compound-compound-pobj,compound-nsubj,NNP-NNPS-NNP,NNP-NNP,4,1
585,18059.0,28,said,17,25,19,-6,24,8,-8,2,American Bankers Association,Edward Yingling,ORGANIZATION-ORGANIZATION-ORGANIZATION,PERSON-PERSON,PROPN-PROPN-PROPN,PROPN-PROPN,compound-compound-pobj,compound-nsubj,NNP-NNPS-NNP,NNP-NNP,5,1
586,20731.0,36,said,25,33,27,-6,32,8,-8,2,American Bankers Association,Edward Yingling,ORGANIZATION-ORGANIZATION-ORGANIZATION,PERSON-PERSON,PROPN-PROPN-PROPN,PROPN-PROPN,compound-compound-pobj,compound-nsubj,NNP-NNPS-NNP,NNP-NNP,5,1
587,40318.0,33,said,10,7,1,-6,6,31,3,-9,American Bankers Association,Edward Yingling,ORGANIZATION-ORGANIZATION-ORGANIZATION,PERSON-PERSON,PROPN-PROPN-PROPN,PROPN-PROPN,compound-compound-pobj,compound-nsubj,NNP-NNPS-NNP,NNP-NNP,4,1
588,49724.0,33,said,10,7,1,-6,6,31,3,-9,American Bankers Association,Edward Yingling,ORGANIZATION-ORGANIZATION-ORGANIZATION,PERSON-PERSON,PROPN-PROPN-PROPN,PROPN-PROPN,compound-compound-pobj,compound-nsubj,NNP-NNPS-NNP,NNP-NNP,4,1
589,51682.0,24,warned,14,11,5,-6,10,18,3,-9,American Bankers Association,Edward Yingling,ORGANIZATION-ORGANIZATION-ORGANIZATION,PERSON-PERSON,PROPN-PROPN-PROPN,PROPN-PROPN,compound-compound-pobj,compound-appos,NNP-NNPS-NNP,NNP-NNP,4,1
590,59495.0,27,said,10,7,1,-6,6,25,3,-9,American Bankers Association,Edward Yingling,ORGANIZATION-ORGANIZATION-ORGANIZATION,PERSON-PERSON,PROPN-PROPN-PROPN,PROPN-PROPN,compound-compound-pobj,compound-nsubj,NNP-NNPS-NNP,NNP-NNP,4,1
591,862.0,17,reported,15,6,1,-5,5,15,9,-14,Ali Akbar Salehi,Iran,PERSON-PERSON-PERSON,COUNTRY,PROPN-PROPN-PROPN,PROPN,compound-compound-appos,poss,NNP-NNP-NNP,NNP,4,1
592,2120.0,43,said,7,5,1,-4,4,41,2,-6,Ali Akbar Salehi,Iran,PERSON-PERSON-PERSON,COUNTRY,PROPN-PROPN-PROPN,PROPN,compound-compound-appos,poss,NNP-NNP-NNP,NNP,4,1
593,5029.0,31,said,13,10,4,-6,9,26,3,-9,Ali Akbar Salehi,Iran,PERSON-PERSON-PERSON,COUNTRY,PROPN-PROPN-PROPN,PROPN,compound-compound-appos,poss,NNP-NNP-NNP,NNP,4,1
594,15255.0,31,said,13,3,9,6,2,21,10,-4,Ali Akbar Salehi,Iran,PERSON-PERSON-PERSON,COUNTRY,PROPN-PROPN-PROPN,PROPN,compound-compound-nsubj,poss,NNP-NNP-NNP,NNP,5,1
595,16779.0,41,said,13,11,3,-8,10,37,2,-10,Ali Akbar Salehi,Iran,PERSON-PERSON-PERSON,COUNTRY,PROPN-PROPN-PROPN,PROPN,compound-compound-appos,poss,NNP-NNP-NNP,NNP,-1,1
596,19160.0,32,turned,2,14,8,-6,13,23,-12,6,Ali Akbar Salehi,Iran,PERSON-PERSON-PERSON,COUNTRY,PROPN-PROPN-PROPN,PROPN,compound-compound-appos,poss,NNP-NNP-NNP,NNP,4,1
597,19191.0,43,quoted,24,28,35,7,27,7,-4,11,Ali Akbar Salehi,Iran,PERSON-PERSON-PERSON,COUNTRY,PROPN-PROPN-PROPN,PROPN,compound-compound-dobj,poss,NNP-NNP-NNP,NNP,5,1
598,24662.0,38,told,35,32,8,-24,31,29,3,-27,Ali Akbar Salehi,Iran,PERSON-PERSON-PERSON,COUNTRY,PROPN-PROPN-PROPN,PROPN,compound-compound-appos,poss,NNP-NNP-NNP,NNP,11,1
599,25397.0,49,said,13,1,8,7,0,40,12,-5,Ali Akbar Salehi,Iran,PERSON-PERSON-PERSON,COUNTRY,PROPN-PROPN-PROPN,PROPN,compound-compound-nsubj,poss,NNP-NNP-NNP,NNP,6,1
600,26319.0,33,expressed,8,5,1,-4,4,31,3,-7,Ali Akbar Salehi,Iran,PERSON-PERSON-PERSON,COUNTRY,PROPN-PROPN-PROPN,PROPN,compound-compound-appos,poss,NNP-NNP-NNP,NNP,4,1
601,27445.0,50,Head,0,12,8,-4,11,41,-12,8,Ali Akbar Salehi,Iran,PERSON-PERSON-PERSON,COUNTRY,PROPN-PROPN-PROPN,PROPN,compound-compound-nsubj,nsubj,NNP-NNP-NNP,NNP,-1,1
602,31610.0,29,slammed,7,5,1,-4,4,27,2,-6,Ali Akbar Salehi,Iran,PERSON-PERSON-PERSON,COUNTRY,PROPN-PROPN-PROPN,PROPN,compound-compound-appos,poss,NNP-NNP-NNP,NNP,4,1
603,33106.0,52,Head,0,11,7,-4,10,44,-11,7,Ali Akbar Salehi,Iran,PERSON-PERSON-PERSON,COUNTRY,PROPN-PROPN-PROPN,PROPN,compound-compound-nsubj,nsubj,NNP-NNP-NNP,NNP,-1,1
604,36254.0,33,said,9,6,1,-5,5,31,3,-8,Ali Akbar Salehi,Iran,PERSON-PERSON-PERSON,COUNTRY,PROPN-PROPN-PROPN,PROPN,compound-compound-appos,poss,NNP-NNP-NNP,NNP,4,1
605,38756.0,56,told,52,50,21,-29,49,34,2,-31,Ali Akbar Salehi,Iran,PERSON-PERSON-PERSON,COUNTRY,PROPN-PROPN-PROPN,PROPN,compound-compound-appos,poss,NNP-NNP-NNP,NNP,7,1
606,39820.0,38,reported,34,1,5,4,0,32,33,-29,Ali Akbar Salehi,Iran,PERSON-PERSON-PERSON,COUNTRY,PROPN-PROPN-PROPN,PROPN,compound-compound-nsubj,poss,NNP-NNP-NNP,NNP,4,1
607,40974.0,33,said,7,5,1,-4,4,31,2,-6,Ali Akbar Salehi,Iran,PERSON-PERSON-PERSON,COUNTRY,PROPN-PROPN-PROPN,PROPN,compound-compound-appos,poss,NNP-NNP-NNP,NNP,4,1
608,42769.0,25,said,23,21,2,-19,20,22,2,-21,Ali Akbar Salehi,Iran,PERSON-PERSON-PERSON,COUNTRY,PROPN-PROPN-PROPN,PROPN,compound-compound-appos,nsubj,NNP-NNP-NNP,NNP,5,1
609,44878.0,51,told,28,25,1,-24,24,49,3,-27,Ali Akbar Salehi,Iran,PERSON-PERSON-PERSON,ORGANIZATION,PROPN-PROPN-PROPN,PROPN,compound-compound-pobj,poss,NNP-NNP-NNP,NNP,10,1
610,45588.0,32,reported,30,5,1,-4,4,30,25,-29,Ali Akbar Salehi,Iran,PERSON-PERSON-PERSON,COUNTRY,PROPN-PROPN-PROPN,PROPN,compound-compound-appos,poss,NNP-NNP-NNP,NNP,4,1
611,46060.0,58,told,3,1,16,15,0,41,2,13,Ali Akbar Salehi,Iran,PERSON-PERSON-PERSON,ORGANIZATION,PROPN-PROPN-PROPN,PROPN,compound-compound-nsubj,nsubj,NNP-NNP-NNP,NNP,6,1
612,49373.0,31,said,11,9,5,-4,8,25,2,-6,Ali Akbar Salehi,Iran,PERSON-PERSON-PERSON,COUNTRY,PROPN-PROPN-PROPN,PROPN,compound-compound-appos,poss,NNP-NNP-NNP,NNP,4,1
613,53209.0,53,told,13,10,4,-6,9,48,3,-9,Ali Akbar Salehi,Iran,PERSON-PERSON-PERSON,COUNTRY,PROPN-PROPN-PROPN,PROPN,compound-compound-appos,poss,NNP-NNP-NNP,NNP,6,1
614,57499.0,38,revealed,7,5,1,-4,4,36,2,-6,Ali Akbar Salehi,Iran,PERSON-PERSON-PERSON,COUNTRY,PROPN-PROPN-PROPN,PROPN,compound-compound-appos,poss,NNP-NNP-NNP,NNP,4,1
615,66483.0,40,TEHRAN,0,36,11,-25,35,28,-36,11,Ali Akbar Salehi,Iran,PERSON-PERSON-PERSON,COUNTRY,PROPN-PROPN-PROPN,PROPN,compound-compound-nsubj,nsubj,NNP-NNP-NNP,NNP,4,1
616,66610.0,20,lashed,15,5,1,-4,4,18,10,-14,Ali Akbar Salehi,Iran,PERSON-PERSON-PERSON,COUNTRY,PROPN-PROPN-PROPN,PROPN,compound-compound-appos,poss,NNP-NNP-NNP,NNP,4,1
617,863.0,35,resisted,24,23,2,-21,22,32,1,-22,MBIA,Gary C. Dunton,ORGANIZATION,PERSON-PERSON-PERSON,PROPN,PROPN-PROPN-PROPN,nsubj,compound-compound-pobj,NNP,NNP-NNP-NNP,5,1
618,65674.0,20,said,18,18,1,-17,17,18,0,-17,MBIA,Gary C. Dunton,ORGANIZATION,PERSON-PERSON-PERSON,PROPN,PROPN-PROPN-PROPN,nsubj,compound-compound-nsubj,NNP,NNP-NNP-NNP,3,1
619,881.0,30,has,9,7,6,-1,6,23,2,-3,Raul Castro,President,PERSON-PERSON,TITLE,PROPN-PROPN,PROPN,compound-appos,compound,NNP-NNP,NNP,1,1
620,5760.0,23,named,8,5,4,-1,4,18,3,-4,Raul Castro,President,PERSON-PERSON,TITLE,PROPN-PROPN,PROPN,compound-nsubj,compound,NNP-NNP,NNP,1,1
621,16584.0,22,accompanied,4,20,19,-1,19,2,-16,15,Raul Castro,President,PERSON-PERSON,TITLE,PROPN-PROPN,PROPN,compound-dobj,compound,NNP-NNP,NNP,1,1
622,19336.0,29,revealed,5,25,24,-1,24,4,-20,19,Raul Castro,President,PERSON-PERSON,TITLE,PROPN-PROPN,PROPN,compound-poss,compound,NNP-NNP,NNP,1,1
623,19676.0,43,said,29,5,4,-1,4,38,24,-25,Raul Castro,President,PERSON-PERSON,TITLE,PROPN-PROPN,PROPN,compound-nsubj,compound,NNP-NNP,NNP,1,1
624,20438.0,24,discussed,15,11,2,-9,10,21,4,-13,Raul Castro,President,PERSON-PERSON,TITLE,PROPN-PROPN,PROPN,compound-dobj,compound,NNP-NNP,NNP,4,1
625,23142.0,32,said,4,3,2,-1,2,29,1,-2,Raul Castro,President,PERSON-PERSON,TITLE,PROPN-PROPN,PROPN,compound-nsubj,compound,NNP-NNP,NNP,1,1
626,36643.0,42,led,4,3,2,-1,2,39,1,-2,Raul Castro,President,PERSON-PERSON,TITLE,PROPN-PROPN,PROPN,compound-nsubj,compound,NNP-NNP,NNP,1,1
627,41934.0,36,declared,14,3,2,-1,2,33,11,-12,Raul Castro,President,PERSON-PERSON,TITLE,PROPN-PROPN,PROPN,compound-nsubj,compound,NNP-NNP,NNP,1,1
628,45367.0,21,accepts,3,6,5,-1,5,15,-3,2,Raul Castro,President,PERSON-PERSON,TITLE,PROPN-PROPN,PROPN,compound-poss,compound,NNP-NNP,NNP,1,1
629,52906.0,22,given,7,2,1,-1,1,20,5,-6,Raul Castro,President,PERSON-PERSON,TITLE,PROPN-PROPN,PROPN,compound-poss,compound,NNP-NNP,NNP,1,1
630,67364.0,28,said,26,25,24,-1,24,3,1,-2,Raul Castro,President,PERSON-PERSON,TITLE,PROPN-PROPN,PROPN,compound-nsubj,compound,NNP-NNP,NNP,1,1
631,882.0,36,joined,7,2,6,4,1,29,5,-1,Zagat,Ted,ORGANIZATION,PERSON,PROPN,PROPN,poss,appos,NNP,NNP,4,1
632,886.0,60,Found,2,21,48,27,20,11,-19,46,Paul Gillmor,fall,PERSON-PERSON,CAUSE_OF_DEATH,PROPN-PROPN,NOUN,compound-appos,nmod,NNP-NNP,NN,4,1
633,51981.0,55,choosing,24,41,50,9,40,4,-17,26,Paul Gillmor,fall,PERSON-PERSON,CAUSE_OF_DEATH,PROPN-PROPN,NOUN,compound-dobj,pobj,NNP-NNP,NN,5,1
634,895.0,20,said,1,1,13,12,0,6,0,12,Sadia,Luiz Furlan,ORGANIZATION,PERSON-PERSON,PROPN,PROPN-PROPN,nsubj,compound-nsubj,NNP,NNP-NNP,4,1
635,906.0,30,are,1,26,19,-7,25,10,-25,18,Coalition for Economic Survival,Larry Gross,ORGANIZATION-ORGANIZATION-ORGANIZATION-ORGANIZATION,PERSON-PERSON,PROPN-ADP-PROPN-PROPN,PROPN-PROPN,pobj-prep-compound-pobj,compound-nsubj,NNP-IN-NNP-NNP,NNP-NNP,4,1
636,17603.0,44,said,26,35,28,-7,34,15,-9,2,Coalition for Economic Survival,Larry Gross,ORGANIZATION-ORGANIZATION-ORGANIZATION-ORGANIZATION,PERSON-PERSON,PROPN-ADP-PROPN-PROPN,PROPN-PROPN,pobj-prep-compound-pobj,compound-nsubj,NNP-IN-NNP-NNP,NNP-NNP,5,1
637,33834.0,39,estimates,19,9,1,-8,8,37,10,-18,Coalition for Economic Survival,Larry Gross,ORGANIZATION-ORGANIZATION-ORGANIZATION-ORGANIZATION,PERSON-PERSON,PROPN-ADP-PROPN-PROPN,PROPN-PROPN,pobj-prep-compound-pobj,compound-nsubj,NNP-IN-NNP-NNP,NNP-NNP,4,1
638,907.0,39,said,7,6,4,-2,5,34,1,-3,Le Point,French,ORGANIZATION-ORGANIZATION,COUNTRY,PROPN-PROPN,ADJ,compound-pobj,amod,NNP-NNP,JJ,1,1
639,908.0,25,said,22,5,3,-2,4,21,17,-19,Pascal Yoadimnadji,Prime Minister,PERSON-PERSON,TITLE-TITLE,PROPN-PROPN,PROPN-PROPN,compound-nsubj,compound-compound,NNP-NNPS,NNP-NNP,1,1
640,3659.0,27,said,25,4,2,-2,3,24,21,-23,Pascal Yoadimnadji,Prime Minister,PERSON-PERSON,TITLE-TITLE,PROPN-PROPN,PROPN-PROPN,compound-nsubj,compound-compound,NNP-NNP,NNP-NNP,1,1
641,3927.0,27,said,25,4,2,-2,3,24,21,-23,Pascal Yoadimnadji,Prime Minister,PERSON-PERSON,TITLE-TITLE,PROPN-PROPN,PROPN-PROPN,compound-nsubj,compound-compound,NNP-NNP,NNP-NNP,1,1
642,4847.0,8,dies,5,4,2,-2,3,5,1,-3,Pascal Yoadimnadji,Prime Minister,PERSON-PERSON,TITLE-TITLE,PROPN-PROPN,PROPN-PROPN,compound-nsubj,compound-compound,NNP-NNP,NNP-NNP,1,1
643,14630.0,40,PARIS,0,34,32,-2,33,7,-34,32,Pascal Yoadimnadji,Prime Minister,PERSON-PERSON,TITLE-TITLE,PROPN-PROPN,PROPN-PROPN,compound-pobj,compound-compound,NNP-NNPS,NNP-NNP,1,1
644,29264.0,25,said,23,4,2,-2,3,22,19,-21,Pascal Yoadimnadji,Prime Minister,PERSON-PERSON,TITLE-TITLE,PROPN-PROPN,PROPN-PROPN,compound-nsubj,compound-compound,NNP-NNP,NNP-NNP,1,1
645,31088.0,11,dies,5,4,2,-2,3,8,1,-3,Pascal Yoadimnadji,Prime Minister,PERSON-PERSON,TITLE-TITLE,PROPN-PROPN,PROPN-PROPN,compound-nsubj,compound-compound,NNP-NNP,NNP-NNP,1,1
646,34074.0,30,said,27,12,10,-2,11,19,15,-17,Pascal Yoadimnadji,Prime Minister,PERSON-PERSON,TITLE-TITLE,PROPN-PROPN,PROPN-PROPN,compound-pobj,compound-compound,NNP-NNPS,NNP-NNP,1,1
647,36290.0,28,said,26,3,1,-2,2,26,23,-25,Pascal Yoadimnadji,Prime Minister,PERSON-PERSON,TITLE-TITLE,PROPN-PROPN,PROPN-PROPN,compound-nsubj,compound-compound,NNP-NNPS,NNP-NNP,1,1
648,38114.0,38,said,36,4,2,-2,3,35,32,-34,Pascal Yoadimnadji,Prime Minister,PERSON-PERSON,TITLE-TITLE,PROPN-PROPN,PROPN-PROPN,compound-nsubj,compound-compound,NNP-NNP,NNP-NNP,1,1
649,46468.0,23,says,9,15,13,-2,14,9,-6,4,Pascal Yoadimnadji,Prime Minister,PERSON-PERSON,TITLE-TITLE,PROPN-PROPN,PROPN-PROPN,compound-nsubj,compound-compound,NNP-NNPS,NNP-NNP,4,1
650,51699.0,19,says,5,11,9,-2,10,9,-6,4,Pascal Yoadimnadji,Prime Minister,PERSON-PERSON,TITLE-TITLE,PROPN-PROPN,PROPN-PROPN,compound-nsubj,compound-compound,NNP-NNPS,NNP-NNP,1,1
651,56244.0,40,died,5,4,2,-2,3,37,1,-3,Pascal Yoadimnadji,Prime Minister,PERSON-PERSON,TITLE-TITLE,PROPN-PROPN,PROPN-PROPN,compound-nsubj,compound-compound,NNP-NNP,NNP-NNP,1,1
652,912.0,30,died,2,2,18,16,1,11,0,16,Goodman,Joseph Eisner,PERSON,PERSON-PERSON,PROPN,PROPN-PROPN,poss,compound-appos,NNP,NNP-NNP,3,1
653,915.0,33,Wal-Mart,0,9,1,-8,8,31,-9,1,Paul Gillmor,Wal-Mart,PERSON-PERSON,ORGANIZATION,PROPN-PROPN,PROPN,compound-pobj,ROOT,NNP-NNP,NNP,5,1
654,917.0,33,invited,13,10,1,-9,9,31,3,-12,Haifa University,Shaloufe-Rizek,ORGANIZATION-ORGANIZATION,PERSON,PROPN-PROPN,PROPN,compound-pobj,nsubjpass,NNP-NNP,NNP,4,1
655,927.0,45,said,5,4,3,-1,3,41,1,-2,Berthold Huber,leader,PERSON-PERSON,TITLE,PROPN-PROPN,NOUN,compound-nsubj,compound,NNP-NNP,NN,1,1
656,7984.0,44,defended,4,35,34,-1,34,9,-31,30,Berthold Huber,leader,PERSON-PERSON,TITLE,PROPN-PROPN,NOUN,compound-nsubj,compound,NNP-NNP,NN,1,1
657,11304.0,33,said,28,27,26,-1,26,6,1,-2,Berthold Huber,leader,PERSON-PERSON,TITLE,PROPN-PROPN,NOUN,compound-nsubj,compound,NNP-NNP,NN,2,1
658,15223.0,33,nominated,11,13,29,16,12,3,-2,18,Berthold Huber,leader,PERSON-PERSON,TITLE,PROPN-PROPN,NOUN,compound-dobj,pobj,NNP-NNP,NN,4,1
659,15866.0,44,defended,4,35,34,-1,34,9,-31,30,Berthold Huber,leader,PERSON-PERSON,TITLE,PROPN-PROPN,NOUN,compound-nsubj,compound,NNP-NNP,NN,1,1
660,26642.0,6,asked,0,4,3,-1,3,2,-4,3,Berthold Huber,leader,PERSON-PERSON,TITLE,PROPN-PROPN,NOUN,compound-dobj,compound,NNP-NNP,NN,1,1
661,56386.0,39,said,6,5,4,-1,4,34,1,-2,Berthold Huber,leader,PERSON-PERSON,TITLE,PROPN-PROPN,NOUN,compound-appos,nsubj,NNP-NNP,NN,1,1
662,935.0,52,is,2,2,25,23,1,26,0,23,ISU,US,ORGANIZATION,COUNTRY,PROPN,PROPN,nsubj,pobj,NNP,NNP,6,1
663,1119.0,30,won,5,13,5,-8,12,24,-8,0,ISU,US,ORGANIZATION,COUNTRY,PROPN,PROPN,compound,pobj,NNP,NNP,2,1
664,937.0,26,converted,1,1,23,22,0,2,0,22,He,American Sunni,PERSON,ORGANIZATION-ORGANIZATION,PRON,PROPN-PROPN,nsubj,amod-compound,PRP,NNP-NNP,7,1
665,941.0,36,unimpressed,9,7,1,-6,6,34,2,-8,Marco Contiero,Greenpeace,PERSON-PERSON,ORGANIZATION,PROPN-PROPN,PROPN,compound-nsubjpass,poss,NNP-NNP,NNP,3,1
666,17799.0,34,said,28,30,33,3,29,0,-2,5,Marco Contiero,Greenpeace,PERSON-PERSON,ORGANIZATION,PROPN-PROPN,PROPN,compound-nsubj,pobj,NNP-NNP,NNP,3,1
667,26055.0,31,said,25,27,30,3,26,0,-2,5,Marco Contiero,Greenpeace,PERSON-PERSON,ORGANIZATION,PROPN-PROPN,PROPN,compound-nsubj,pobj,NNP-NNP,NNP,3,1
668,34447.0,21,said,6,1,5,4,0,15,5,-1,Marco Contiero,Greenpeace,PERSON-PERSON,ORGANIZATION,PROPN-PROPN,PROPN,compound-nsubj,pobj,NNP-NNP,NNP,2,1
669,38481.0,53,told,4,3,1,-2,2,51,1,-3,Marco Contiero,Greenpeace,PERSON-PERSON,ORGANIZATION,PROPN-PROPN,NOUN,compound-nsubj,compound,NNP-NNP,NN,1,1
670,47400.0,47,said,32,34,44,10,33,2,-2,12,Marco Contiero,Greenpeace,PERSON-PERSON,ORGANIZATION,PROPN-PROPN,PROPN,compound-nsubj,pobj,NNP-NNP,NNP,4,1
671,51684.0,40,explained,34,36,39,3,35,0,-2,5,Marco Contiero,Greenpeace,PERSON-PERSON,ORGANIZATION,PROPN-PROPN,PROPN,compound-nsubj,pobj,NNP-NNP,NNP,2,1
672,59994.0,48,said,35,37,45,8,36,2,-2,10,Marco Contiero,Greenpeace,PERSON-PERSON,ORGANIZATION,PROPN-PROPN,PROPN,compound-nsubj,compound,NNP-NNP,NNP,5,1
673,64151.0,36,said,34,33,31,-2,32,4,1,-3,Marco Contiero,Greenpeace,PERSON-PERSON,ORGANIZATION,PROPN-PROPN,NOUN,compound-nsubj,compound,NNP-NNP,NN,3,1
674,955.0,33,says,21,30,23,-7,29,9,-9,2,American Bankers Association,James Chessen,ORGANIZATION-ORGANIZATION-ORGANIZATION,PERSON-PERSON,PROPN-PROPN-PROPN,PROPN-PROPN,compound-compound-pobj,compound-nsubj,NNP-NNPS-NNP,NNP-NNP,4,1
675,1760.0,58,said,53,50,43,-7,49,14,3,-10,American Bankers Association,James Chessen,ORGANIZATION-ORGANIZATION-ORGANIZATION,PERSON-PERSON,PROPN-PROPN-PROPN,PROPN-PROPN,compound-compound-pobj,compound-nsubj,NNP-NNPS-NNP,NNP-NNP,5,1
676,7528.0,30,said,21,23,28,5,22,1,-2,7,American Bankers Association,James Chessen,ORGANIZATION-ORGANIZATION-ORGANIZATION,PERSON-PERSON,PROPN-PROPN-PROPN,PROPN-PROPN,nmod-nmod-compound,compound-nsubj,NNP-NNP-NNP,NNP-NNP,4,1
677,21691.0,58,told,11,8,1,-7,7,56,3,-10,American Bankers Association,James Chessen,ORGANIZATION-ORGANIZATION-ORGANIZATION,PERSON-PERSON,PROPN-PROPN-PROPN,PROPN-PROPN,compound-compound-pobj,compound-nsubj,NNP-NNPS-NNP,NNP-NNP,4,1
678,27840.0,40,said,35,31,28,-3,30,11,4,-7,American Bankers Association,James Chessen,ORGANIZATION-ORGANIZATION-ORGANIZATION,PERSON-PERSON,PROPN-PROPN-PROPN,PROPN-PROPN,compound-compound-nmod,compound-nsubj,NNP-NNPS-NNP,NNP-NNP,4,1
679,30802.0,46,said,12,9,1,-8,8,44,3,-11,American Bankers Association,James Chessen,ORGANIZATION-ORGANIZATION-ORGANIZATION,PERSON-PERSON,PROPN-PROPN-PROPN,PROPN-PROPN,compound-compound-pobj,compound-nsubj,NNP-NNPS-NNP,NNP-NNP,4,1
680,34870.0,27,said,15,24,17,-7,23,9,-9,2,American Bankers Association,James Chessen,ORGANIZATION-ORGANIZATION-ORGANIZATION,PERSON-PERSON,PROPN-PROPN-PROPN,PROPN-PROPN,compound-compound-pobj,compound-nsubj,NNP-NNPS-NNP,NNP-NNP,5,1
681,46137.0,48,said,43,40,33,-7,39,14,3,-10,American Bankers Association,James Chessen,ORGANIZATION-ORGANIZATION-ORGANIZATION,PERSON-PERSON,PROPN-PROPN-PROPN,PROPN-PROPN,compound-compound-pobj,compound-nsubj,NNP-NNPS-NNP,NNP-NNP,5,1
682,958.0,41,served,2,1,39,38,0,1,1,37,Hubbard,United States,PERSON,COUNTRY-COUNTRY,PROPN,PROPN-PROPN,nsubj,compound-conj,NNP,NNP-NNP,13,1
683,964.0,40,Click,0,22,37,15,21,2,-22,37,Perle,International Advisors Inc,PERSON,ORGANIZATION-ORGANIZATION-ORGANIZATION,PROPN,PROPN-PROPN-PROPN,nsubj,compound-compound-appos,NNP,NNP-NNP-NNP,-1,1
684,973.0,47,'s,1,45,26,-19,44,20,-44,25,FMR Corp.,Fidelity,ORGANIZATION-ORGANIZATION,ORGANIZATION,PROPN-PROPN,PROPN,compound-pobj,poss,NNP-NNP,NNP,14,1
685,976.0,23,was,1,5,9,4,4,13,-4,8,Nitschmann Middle School,Bethlehem,ORGANIZATION-ORGANIZATION-ORGANIZATION,CITY,PROPN-PROPN-PROPN,PROPN,compound-compound-pobj,pobj,NNP-NNP-NNP,NNP,6,1
686,7112.0,47,arrested,25,32,36,4,31,10,-7,11,Nitschmann Middle School,Bethlehem,ORGANIZATION-ORGANIZATION-ORGANIZATION,CITY,PROPN-PROPN-PROPN,PROPN,compound-compound-pobj,pobj,NNP-NNP-NNP,NNP,4,1
687,8764.0,33,arrested,11,18,22,4,17,10,-7,11,Nitschmann Middle School,Bethlehem,ORGANIZATION-ORGANIZATION-ORGANIZATION,CITY,PROPN-PROPN-PROPN,PROPN,compound-compound-pobj,pobj,NNP-NNP-NNP,NNP,2,1
688,25960.0,23,was,1,5,9,4,4,13,-4,8,Nitschmann Middle School,Bethlehem,ORGANIZATION-ORGANIZATION-ORGANIZATION,CITY,PROPN-PROPN-PROPN,PROPN,compound-compound-pobj,pobj,NNP-NNP-NNP,NNP,6,1
689,41202.0,37,apologized,5,14,18,4,13,18,-9,13,Nitschmann Middle School,Bethlehem,ORGANIZATION-ORGANIZATION-ORGANIZATION,CITY,PROPN-PROPN-PROPN,PROPN,compound-compound-pobj,pobj,NNP-NNP-NNP,NNP,4,1
690,47888.0,43,apologized,11,20,24,4,19,18,-9,13,Nitschmann Middle School,Bethlehem,ORGANIZATION-ORGANIZATION-ORGANIZATION,CITY,PROPN-PROPN-PROPN,PROPN,compound-compound-pobj,pobj,NNP-NNP-NNP,NNP,5,1
691,50241.0,31,arrested,9,16,20,4,15,10,-7,11,Nitschmann Middle School,Bethlehem,ORGANIZATION-ORGANIZATION-ORGANIZATION,CITY,PROPN-PROPN-PROPN,PROPN,compound-compound-pobj,pobj,NNP-NNP-NNP,NNP,2,1
692,977.0,31,Speculation,0,7,15,8,6,15,-7,15,Ipsco,Saskatchewan,ORGANIZATION,STATE_OR_PROVINCE,PROPN,PROPN,pobj,conj,NNP,NNP,6,1
693,980.0,66,survived,12,2,29,27,1,36,10,17,his,Robert G.,PERSON,PERSON-PERSON,DET,PROPN-PROPN,poss,compound-appos,PRP$,NNP-NNP,5,1
694,984.0,31,Hometown,0,16,14,-2,15,16,-16,14,Bryan Fuller,executive producer,PERSON-PERSON,TITLE-TITLE,PROPN-PROPN,ADJ-NOUN,compound-appos,amod-dobj,NNP-NNP,JJ-NN,3,1
695,1010.0,17,graduated,1,1,4,3,0,12,0,3,He,Trinity College,PERSON,ORGANIZATION-ORGANIZATION,PRON,PROPN-PROPN,nsubj,compound-pobj,PRP,NNP-NNP,2,1
696,1017.0,11,making,4,3,2,-1,2,8,1,-2,Juliette Binoche,actress,PERSON-PERSON,TITLE,PROPN-PROPN,NOUN,compound-nsubj,compound,NNP-NNP,NN,1,1
697,3962.0,34,includes,2,32,31,-1,31,2,-30,29,Juliette Binoche,actress,PERSON-PERSON,TITLE,PROPN-PROPN,NOUN,compound-dobj,compound,NNP-NNP,NN,2,1
698,10545.0,36,embarked,4,3,2,-1,2,33,1,-2,Juliette Binoche,actress,PERSON-PERSON,TITLE,PROPN-PROPN,NOUN,compound-nsubj,compound,NNP-NNP,NN,1,1
699,29970.0,22,2008-04-05T11,0,7,6,-1,6,15,-7,6,Juliette Binoche,actress,PERSON-PERSON,TITLE,PROPN-PROPN,NOUN,compound-nsubj,compound,NNP-NNP,NN,5,1
700,32201.0,11,actress,5,1,6,5,0,4,4,1,Juliette Binoche,actress,PERSON-PERSON,TITLE,PROPN-PROPN,NOUN,compound-compound,ROOT,NNP-NNP,NN,3,1
701,35341.0,7,talks,4,3,2,-1,2,4,1,-2,Juliette Binoche,actress,PERSON-PERSON,TITLE,PROPN-PROPN,NOUN,compound-compound,compound,NNP-NNP,NN,1,1
702,36167.0,20,include,3,18,17,-1,17,2,-15,14,Juliette Binoche,actress,PERSON-PERSON,TITLE,PROPN-PROPN,NOUN,compound-conj,compound,NNP-NNP,NN,1,1
703,38925.0,45,reported,42,3,2,-1,2,42,39,-40,Juliette Binoche,actress,PERSON-PERSON,TITLE,PROPN-PROPN,NOUN,compound-nsubj,compound,NNP-NNP,NN,1,1
704,57240.0,38,reported,35,3,2,-1,2,35,32,-33,Juliette Binoche,actress,PERSON-PERSON,TITLE,PROPN-PROPN,NOUN,compound-nsubj,compound,NNP-NNP,NN,1,1
705,57680.0,32,condemned,10,20,19,-1,19,12,-10,9,Juliette Binoche,actress,PERSON-PERSON,TITLE,PROPN-PROPN,NOUN,compound-nsubj,compound,NNP-NNP,NN,1,1
706,57784.0,43,regarded,2,41,40,-1,40,2,-39,38,Juliette Binoche,actress,PERSON-PERSON,TITLE,PROPN-PROPN,NOUN,compound-dobj,compound,NNP-NNP,NN,3,1
707,60550.0,38,presented,4,3,2,-1,2,35,1,-2,Juliette Binoche,actress,PERSON-PERSON,TITLE,PROPN-PROPN,NOUN,compound-nsubj,compound,NNP-NNP,NN,1,1
708,1021.0,41,died,33,1,35,34,0,5,32,2,Jefferson J. DeBlanc,Nov. 22,PERSON-PERSON-PERSON,DATE-DATE,PROPN-PROPN-PROPN,PROPN-NUM,compound-compound-nsubj,npadvmod-nummod,NNP-NNP-NNP,NNP-CD,4,1
709,1024.0,29,claims,4,1,3,2,0,25,3,-1,Kurnaz,24,PERSON,NUMBER,PROPN,NUM,nsubj,appos,NNP,CD,3,1
710,14729.0,35,deny,5,23,28,5,22,6,-18,23,Kurnaz,24,PERSON,NUMBER,PROPN,NUM,pobj,attr,NNP,CD,3,1
711,21743.0,25,detained,5,1,3,2,0,21,4,-2,Kurnaz,24,PERSON,NUMBER,PROPN,NUM,nsubjpass,appos,NNP,CD,3,1
712,34697.0,19,spent,4,1,3,2,0,15,3,-1,Kurnaz,24,PERSON,NUMBER,PROPN,NUM,nsubj,appos,NNP,CD,3,1
713,49897.0,30,released,6,1,4,3,0,25,5,-2,Kurnaz,24,PERSON,NUMBER,PROPN,NUM,nsubjpass,appos,NNP,CD,2,1
714,1030.0,43,said,28,30,33,3,29,9,-2,5,Christopher Bentley,spokesman,PERSON-PERSON,TITLE,PROPN-PROPN,NOUN,compound-nsubj,appos,NNP-NNP,NN,2,1
715,3783.0,27,acknowledged,7,1,6,5,0,20,6,-1,Christopher Bentley,spokesman,PERSON-PERSON,TITLE,PROPN-PROPN,NOUN,compound-nsubj,appos,NNP-NNP,NN,2,1
716,21730.0,36,said,9,1,5,4,0,30,8,-4,Christopher Bentley,spokesman,PERSON-PERSON,TITLE,PROPN-PROPN,NOUN,compound-nsubj,appos,NNP-NNP,NN,2,1
717,27685.0,36,said,10,1,5,4,0,30,9,-5,Christopher Bentley,spokesman,PERSON-PERSON,TITLE,PROPN-PROPN,NOUN,compound-nsubj,appos,NNP-NNP,NN,3,1
718,35712.0,24,gobbling,7,22,21,-1,21,2,-15,14,Christopher Bentley,spokesman,PERSON-PERSON,TITLE,PROPN-PROPN,NOUN,compound-pobj,compound,NNP-NNP,NN,1,1
719,44952.0,7,Bentley,1,1,4,3,0,2,0,3,Christopher Bentley,spokesman,PERSON-PERSON,TITLE,PROPN-PROPN,NOUN,compound-ROOT,appos,NNP-NNP,NN,2,1
720,47861.0,44,has,2,17,16,-1,16,27,-15,14,Christopher Bentley,spokesman,PERSON-PERSON,TITLE,PROPN-PROPN,NOUN,compound-pobj,compound,NNP-NNP,NN,2,1
721,60000.0,23,defended,12,1,4,3,0,18,11,-8,Christopher Bentley,spokesman,PERSON-PERSON,TITLE,PROPN-PROPN,NOUN,compound-nsubj,appos,NNP-NNP,NN,3,1
722,1051.0,50,says,34,30,2,-28,29,47,4,-32,his,TLC,PERSON,ORGANIZATION,DET,PROPN,poss,dobj,PRP$,NNP,8,1
723,11052.0,59,contend,3,6,9,3,5,49,-3,6,his,TLC,PERSON,ORGANIZATION,DET,PROPN,poss,compound,PRP$,NNP,2,1
724,30835.0,45,is,5,19,13,-6,18,31,-14,8,his,TLC,PERSON,ORGANIZATION,DET,PROPN,poss,nsubj,PRP$,NNP,3,1
725,52724.0,60,sued,10,29,10,-19,28,49,-19,0,his,TLC,PERSON,ORGANIZATION,DET,PROPN,poss,nsubj,PRP$,NNP,9,1
726,1059.0,46,is,11,5,9,4,4,36,6,-2,American Bar Association,William Neukom,ORGANIZATION-ORGANIZATION-ORGANIZATION,PERSON-PERSON,PROPN-PROPN-PROPN,PROPN-PROPN,compound-compound-compound,compound-nsubj,NNP-NNP-NNP,NNP-NNP,3,1
727,56775.0,36,told,24,21,15,-6,20,20,3,-9,American Bar Association,William Neukom,ORGANIZATION-ORGANIZATION-ORGANIZATION,PERSON-PERSON,PROPN-PROPN-PROPN,PROPN-PROPN,compound-compound-pobj,compound-nsubj,NNP-NNP-NNP,NNP-NNP,5,1
728,1070.0,41,took,12,1,11,10,0,29,11,-1,Glover,activist,PERSON,TITLE,PROPN,NOUN,nsubj,pobj,NNP,NN,3,1
729,1075.0,63,closing,5,30,26,-4,29,36,-25,21,Lee Jye,Minister,PERSON-PERSON,TITLE,PROPN-PROPN,PROPN,compound-nsubj,nmod,NNP-NNP,NNP,9,1
730,11392.0,46,said,12,11,7,-4,10,38,1,-5,Lee Jye,Minister,PERSON-PERSON,TITLE,PROPN-PROPN,PROPN,compound-nsubj,nmod,NNP-NNP,NNP,2,1
731,14760.0,42,suspended,40,11,10,-1,10,31,29,-30,Lee Jye,Minister,PERSON-PERSON,TITLE,PROPN-PROPN,PROPN,compound-nsubj,compound,NNP-NNP,NNP,1,1
732,19773.0,33,quoted,2,16,15,-1,15,17,-14,13,Lee Jye,Minister,PERSON-PERSON,TITLE,PROPN-PROPN,PROPN,compound-nsubj,compound,NNP-NNP,NNP,1,1
733,19957.0,27,said,6,5,1,-4,4,25,1,-5,Lee Jye,Minister,PERSON-PERSON,TITLE,PROPN-PROPN,PROPN,compound-nsubj,nmod,NNP-NNP,NNP,2,1
734,1081.0,69,include,5,23,22,-1,22,46,-18,17,Jennifer Dunn,Rep,PERSON-PERSON,TITLE,PROPN-PROPN,PROPN,compound-conj,compound,NNP-NNP,NNP,1,1
735,1083.0,36,found,6,2,13,11,1,22,4,7,Federal Motor Carrier Safety Administration,U.S.,ORGANIZATION-ORGANIZATION-ORGANIZATION-ORGANIZATION-ORGANIZATION,COUNTRY,PROPN-PROPN-PROPN-PROPN-PROPN,PROPN,compound-compound-compound-compound-nsubj,compound,NNP-NNP-NNP-NNP-NNP,NNP,7,1
736,20690.0,38,said,25,33,4,-29,32,33,-8,-21,Federal Motor Carrier Safety Administration,U.S.,ORGANIZATION-ORGANIZATION-ORGANIZATION-ORGANIZATION-ORGANIZATION,COUNTRY,PROPN-PROPN-PROPN-PROPN-PROPN,PROPN,compound-compound-compound-compound-pobj,compound,NNP-NNP-NNP-NNP-NNP,NNP,9,1
737,44748.0,48,Administration,5,2,38,36,1,9,3,33,Federal Motor Carrier Safety Administration,U.S.,ORGANIZATION-ORGANIZATION-ORGANIZATION-ORGANIZATION-ORGANIZATION,COUNTRY,PROPN-PROPN-PROPN-PROPN-PROPN,PROPN,compound-compound-compound-compound-ROOT,pobj,NNP-NNP-NNP-NNP-NNP,NNP,12,1
738,51773.0,29,says,12,7,26,19,6,2,5,14,Federal Motor Carrier Safety Administration,U.S.,ORGANIZATION-ORGANIZATION-ORGANIZATION-ORGANIZATION-ORGANIZATION,COUNTRY,PROPN-PROPN-PROPN-PROPN-PROPN,PROPN,compound-compound-compound-compound-pobj,compound,NNP-NNP-NNP-NNP-NNP,NNP,11,1
739,1085.0,27,said,12,17,14,-3,16,12,-5,2,Citibank,Shannon Bell,ORGANIZATION,PERSON-PERSON,PROPN,PROPN-PROPN,poss,compound-nsubj,NNP,NNP-NNP,3,1
740,1112.0,25,Flowers,2,1,9,8,0,15,1,7,Richmond M Flowers,attorney,PERSON-PERSON-PERSON,ORGANIZATION,PROPN-PROPN-PROPN,NOUN,compound-compound-ROOT,compound,NNP-NNP-NNPS,NN,4,1
741,1117.0,58,splitting,15,30,2,-28,29,55,-15,-13,Covidien,Tyco International,ORGANIZATION,ORGANIZATION-ORGANIZATION,PROPN,PROPN-PROPN,oprd,compound-conj,NNP,NNP-NNP,4,1
742,17163.0,47,point,1,24,31,7,23,15,-23,30,Covidien,Tyco International,ORGANIZATION,ORGANIZATION-ORGANIZATION,PROPN,PROPN-PROPN,pobj,compound-pobj,NNP,NNP-NNP,4,1
743,41677.0,12,make,4,4,1,-3,3,10,0,-3,Covidien,Tyco International,ORGANIZATION,ORGANIZATION-ORGANIZATION,PROPN,PROPN-PROPN,appos,compound-pobj,NNP,NNP-NNP,1,1
744,56698.0,19,became,11,1,9,8,0,9,10,-2,Covidien,Tyco International,ORGANIZATION,ORGANIZATION-ORGANIZATION,PROPN,PROPN-PROPN,nsubj,compound-pobj,NNP,NNP-NNP,4,1
745,1127.0,48,suspected,2,7,23,16,6,24,-5,21,Iranian Revolutionary Guards Corps-Quds,IRGC-QF,ORGANIZATION-ORGANIZATION-ORGANIZATION-ORGANIZATION,ORGANIZATION,ADJ-PROPN-PROPN-PROPN,PROPN,compound-compound-compound-attr,compound,JJ-NNP-NNPS-NNPS,NNP,9,1
746,1131.0,49,died,39,1,46,45,0,2,38,7,Joseph S Farland,Winchester,PERSON-PERSON-PERSON,CITY,PROPN-PROPN-PROPN,PROPN,compound-compound-nsubj,pobj,NNP-NNP-NNP,NNP,7,1
747,1152.0,22,portraying,8,1,6,5,0,15,7,-2,Sean Parker,student,PERSON-PERSON,TITLE,PROPN-PROPN,NOUN,compound-nsubj,appos,NNP-NNP,NN,3,1
748,1155.0,49,spent,18,6,2,-4,5,46,12,-16,American Beverage Association,Washington State,ORGANIZATION-ORGANIZATION-ORGANIZATION,LOCATION-LOCATION,PROPN-PROPN-PROPN,PROPN-PROPN,compound-compound-nsubj,compound-pobj,NNP-NNP-NNP,NNP-NNP,4,1
749,1159.0,41,is,2,1,10,9,0,30,1,8,Paul Sculfor,Jennifer,PERSON-PERSON,PERSON,PROPN-PROPN,PROPN,compound-nsubj,dobj,NNP-NNP,NNP,5,1
750,3269.0,50,spotted,3,48,1,-47,47,48,-45,-2,Paul Sculfor,Jennifer,PERSON-PERSON,PERSON,PROPN-PROPN,PROPN,compound-appos,nsubjpass,NNP-NNP,NNP,4,1
751,1168.0,37,are,5,23,19,-4,22,17,-18,14,Paavo Nurmi,athletes,PERSON-PERSON,TITLE,PROPN-PROPN,VERB,compound-conj,conj,NNP-NNP,VBZ,2,1
752,1171.0,22,Jonas,2,12,1,-11,11,20,-10,-1,Fidelity Investments,Stephen P. Jonas,ORGANIZATION-ORGANIZATION,PERSON-PERSON-PERSON,PROPN-PROPN,PROPN-PROPN-PROPN,compound-pobj,compound-compound-ROOT,NNP-NNP,NNP-NNP-NNP,6,1
753,1174.0,20,said,9,1,7,6,0,12,8,-2,Cathleen P Black,Hearst Magazines,PERSON-PERSON-PERSON,ORGANIZATION-ORGANIZATION,PROPN-PROPN-PROPN,PROPN-PROPN,compound-compound-nsubj,compound-appos,NNP-NNP-NNP,NNP-NNP,3,1
754,17919.0,39,announced,2,14,1,-13,13,37,-12,-1,Cathleen P Black,Hearst Magazines,PERSON-PERSON-PERSON,ORGANIZATION-ORGANIZATION,PROPN-PROPN-PROPN,PROPN-PROPN,compound-compound-appos,compound-pobj,NNP-NNP-NNP,NNP-NNPS,5,1
755,23189.0,24,appointed,7,4,1,-3,3,22,3,-6,Cathleen P Black,Hearst Magazines,PERSON-PERSON-PERSON,ORGANIZATION-ORGANIZATION,PROPN-PROPN-PROPN,PROPN-PROPN,compound-compound-nsubj,compound-compound,NNP-NNP-NNP,NNP-NNPS,3,1
756,26070.0,22,said,11,13,20,7,12,1,-2,9,Cathleen P Black,Hearst Magazines,PERSON-PERSON-PERSON,ORGANIZATION-ORGANIZATION,PROPN-PROPN-PROPN,PROPN-PROPN,compound-compound-nsubj,compound-pobj,NNP-NNP-NNP,NNP-NNPS,6,1
757,30144.0,66,purchased,9,55,8,-47,54,57,-46,-1,Cathleen P Black,Hearst Magazines,PERSON-PERSON-PERSON,ORGANIZATION-ORGANIZATION,PROPN-PROPN-PROPN,PROPN-PROPN,compound-compound-appos,compound-compound,NNP-NNP-NNP,NNP-NNPS,9,1
758,38873.0,22,made,3,6,12,6,5,9,-3,9,Cathleen P Black,Hearst Magazines,PERSON-PERSON-PERSON,ORGANIZATION-ORGANIZATION,PROPN-PROPN-PROPN,PROPN-PROPN,compound-compound-pobj,compound-conj,NNP-NNP-NNP,NNP-NNPS,3,1
759,40428.0,17,announced,6,4,1,-3,3,15,2,-5,Cathleen P Black,Hearst Magazines,PERSON-PERSON-PERSON,ORGANIZATION-ORGANIZATION,PROPN-PROPN-PROPN,PROPN-PROPN,compound-compound-nsubj,compound-compound,NNP-NNP-NNP,NNP-NNPS,2,1
760,49557.0,20,report,4,7,13,6,6,6,-3,9,Cathleen P Black,Hearst Magazines,PERSON-PERSON-PERSON,ORGANIZATION-ORGANIZATION,PROPN-PROPN-PROPN,PROPN-PROPN,compound-compound-pobj,compound-appos,NNP-NNP-NNP,NNP-NNPS,3,1
761,52835.0,46,said,22,4,10,6,3,35,18,-12,Cathleen P Black,Hearst Magazines,PERSON-PERSON-PERSON,ORGANIZATION-ORGANIZATION,PROPN-PROPN-PROPN,PROPN-PROPN,compound-compound-pobj,compound-conj,NNP-NNP-NNP,NNP-NNPS,3,1
762,1182.0,12,projected,6,5,11,6,4,0,1,5,Barbara Boxer,Senate,PERSON-PERSON,ORGANIZATION,PROPN-PROPN,PROPN,compound-nsubj,compound,NNP-NNP,NNP,3,1
763,30096.0,55,declared,18,1,33,32,0,21,17,15,Barbara Boxer,Senate,PERSON-PERSON,ORGANIZATION,PROPN-PROPN,PROPN,compound-nsubj,compound,NNP-NNP,NNP,4,1
764,42712.0,41,released,22,5,1,-4,4,39,17,-21,Barbara Boxer,Senate,PERSON-PERSON,ORGANIZATION,PROPN-PROPN,PROPN,compound-nsubj,compound,NNP-NNP,NNP,3,1
765,1189.0,29,is,2,10,8,-2,9,20,-8,6,FAW Group,China,ORGANIZATION-ORGANIZATION,COUNTRY,PROPN-PROPN,PROPN,compound-pobj,poss,NNP-NNP,NNP,2,1
766,31659.0,42,run,4,7,17,10,6,24,-3,13,FAW Group,China,ORGANIZATION-ORGANIZATION,COUNTRY,PROPN-PROPN,PROPN,compound-pobj,poss,NNP-NNP,NNP,6,1
767,44955.0,26,appointed,16,12,7,-5,11,18,4,-9,FAW Group,China,ORGANIZATION-ORGANIZATION,COUNTRY,PROPN-PROPN,PROPN,compound-appos,poss,NNP-NNP,NNP,3,1
768,1199.0,38,occurred,2,20,9,-11,19,28,-18,7,ANP,Asfandyar Wali Khan,ORGANIZATION,PERSON-PERSON-PERSON,PROPN,PROPN-PROPN-PROPN,compound,compound-compound-pobj,NNP,NNP-NNP-NNP,4,1
769,29018.0,44,happened,1,15,4,-11,14,39,-14,3,ANP,Asfandyar Wali Khan,ORGANIZATION,PERSON-PERSON-PERSON,PROPN,PROPN-PROPN-PROPN,compound,compound-compound-pobj,NNP,NNP-NNP-NNP,4,1
770,1201.0,32,confirmed,3,14,6,-8,13,25,-11,3,Multidisciplinary Association for Psychedelic Studies,Rick Doblin,ORGANIZATION-ORGANIZATION-ORGANIZATION-ORGANIZATION-ORGANIZATION,PERSON-PERSON,PROPN-PROPN-ADP-PROPN-PROPN,PROPN-PROPN,compound-pobj-prep-compound-pobj,compound-pobj,NNP-NNP-IN-NNP-NNPS,NNP-NNP,4,1
771,7914.0,39,died,1,23,17,-6,22,21,-22,16,Multidisciplinary Association for Psychedelic Studies,Rick Doblin,ORGANIZATION-ORGANIZATION-ORGANIZATION-ORGANIZATION-ORGANIZATION,PERSON-PERSON,PROPN-PROPN-ADP-PROPN-PROPN,PROPN-PROPN,compound-pobj-prep-compound-pobj,compound-pobj,NNP-NNP-IN-NNP-NNPS,NNP-NNP,3,1
772,42866.0,41,said,7,17,9,-8,16,31,-10,2,Multidisciplinary Association for Psychedelic Studies,Rick Doblin,ORGANIZATION-ORGANIZATION-ORGANIZATION-ORGANIZATION-ORGANIZATION,PERSON-PERSON,PROPN-PROPN-ADP-PROPN-PROPN,PROPN-PROPN,compound-pobj-prep-compound-pobj,compound-nsubj,NNP-NNP-IN-NNP-NNPS,NNP-NNP,3,1
773,44016.0,27,said,12,22,14,-8,21,12,-10,2,Multidisciplinary Association for Psychedelic Studies,Rick Doblin,ORGANIZATION-ORGANIZATION-ORGANIZATION-ORGANIZATION-ORGANIZATION,PERSON-PERSON,PROPN-PROPN-ADP-PROPN-PROPN,PROPN-PROPN,compound-pobj-prep-compound-pobj,compound-nsubj,NNP-NNP-IN-NNP-NNPS,NNP-NNP,5,1
774,52201.0,34,said,18,26,20,-6,25,13,-8,2,Multidisciplinary Association for Psychedelic Studies,Rick Doblin,ORGANIZATION-ORGANIZATION-ORGANIZATION-ORGANIZATION-ORGANIZATION,PERSON-PERSON,PROPN-PROPN-ADP-PROPN-PROPN,PROPN-PROPN,compound-pobj-prep-compound-pobj,compound-nsubj,NNP-NNP-IN-NNP-NNPS,NNP-NNP,5,1
775,52681.0,38,said,13,21,15,-6,20,22,-8,2,Multidisciplinary Association for Psychedelic Studies,Rick Doblin,ORGANIZATION-ORGANIZATION-ORGANIZATION-ORGANIZATION-ORGANIZATION,PERSON-PERSON,PROPN-PROPN-ADP-PROPN-PROPN,PROPN-PROPN,compound-pobj-prep-compound-pobj,compound-nsubj,NNP-NNP-IN-NNP-NNPS,NNP-NNP,5,1
776,52978.0,42,said,7,17,9,-8,16,32,-10,2,Multidisciplinary Association for Psychedelic Studies,Rick Doblin,ORGANIZATION-ORGANIZATION-ORGANIZATION-ORGANIZATION-ORGANIZATION,PERSON-PERSON,PROPN-PROPN-ADP-PROPN-PROPN,PROPN-PROPN,compound-pobj-prep-compound-pobj,compound-nsubj,NNP-NNP-IN-NNP-NNPS,NNP-NNP,3,1
777,54189.0,33,said,8,17,10,-7,16,22,-9,2,Multidisciplinary Association for Psychedelic Studies,Rick Doblin,ORGANIZATION-ORGANIZATION-ORGANIZATION-ORGANIZATION-ORGANIZATION,PERSON-PERSON,PROPN-PROPN-ADP-PROPN-PROPN,PROPN-PROPN,compound-pobj-prep-compound-pobj,compound-nsubj,NNP-NNP-IN-NNP-NNPS,NNP-NNP,5,1
778,66219.0,34,died,1,29,20,-9,28,13,-28,19,Multidisciplinary Association for Psychedelic Studies,Rick Doblin,ORGANIZATION-ORGANIZATION-ORGANIZATION-ORGANIZATION-ORGANIZATION,PERSON-PERSON,PROPN-PROPN-ADP-PROPN-PROPN,PROPN-PROPN,compound-appos-prep-compound-pobj,compound-pobj,NNP-NNP-IN-NNP-NNPS,NNP-NNP,1,1
779,1206.0,63,DAMASCUS,0,29,10,-19,28,52,-29,10,Ahmad Qattan,Saudi,PERSON-PERSON,NATIONALITY,PROPN-PROPN,PROPN,compound-pobj,compound,NNP-NNP,NNP,3,1
780,8989.0,45,said,12,11,1,-10,10,43,1,-11,Ahmad Qattan,Saudi,PERSON-PERSON,NATIONALITY,PROPN-PROPN,ADJ,compound-pobj,amod,NNP-NNP,JJ,3,1
781,16473.0,44,said,15,14,4,-10,13,39,1,-11,Ahmad Qattan,Saudi,PERSON-PERSON,NATIONALITY,PROPN-PROPN,ADJ,compound-pobj,amod,NNP-NNP,JJ,2,1
782,30278.0,44,said,12,11,4,-7,10,39,1,-8,Ahmad Qattan,Saudi,PERSON-PERSON,NATIONALITY,PROPN-PROPN,ADJ,compound-pobj,amod,NNP-NNP,JJ,3,1
783,31546.0,26,said,11,9,2,-7,8,23,2,-9,Ahmad Qattan,Saudi,PERSON-PERSON,NATIONALITY,PROPN-PROPN,ADJ,compound-appos,amod,NNP-NNP,JJ,1,1
784,1211.0,46,...,0,32,35,3,31,10,-32,35,Richard Lindzen,Professor of Meteorology MIT,PERSON-PERSON,ORGANIZATION-ORGANIZATION-ORGANIZATION-ORGANIZATION,PROPN-PROPN,PROPN-ADP-PROPN-PROPN,compound-ROOT,appos-prep-compound-pobj,NNP-NNP,NNP-IN-NNP-NNP,2,1
785,1216.0,22,was,12,3,1,-2,2,20,9,-11,Carolyn Maloney,U.S.,PERSON-PERSON,COUNTRY,PROPN-PROPN,PROPN,compound-nsubj,compound,NNP-NNP,NNP,1,1
786,1228.0,48,Administration,5,2,8,6,1,39,3,3,Federal Motor Carrier Safety Administration,FMCSA,ORGANIZATION-ORGANIZATION-ORGANIZATION-ORGANIZATION-ORGANIZATION,ORGANIZATION,PROPN-PROPN-PROPN-PROPN-PROPN,PROPN,compound-compound-compound-compound-ROOT,compound,NNP-NNP-NNP-NNP-NNP,NNP,5,1
787,3357.0,36,FMCSA,15,10,16,6,9,19,5,1,Federal Motor Carrier Safety Administration,FMCSA,ORGANIZATION-ORGANIZATION-ORGANIZATION-ORGANIZATION-ORGANIZATION,ORGANIZATION,PROPN-PROPN-PROPN-PROPN-PROPN,PROPN,compound-compound-compound-compound-dobj,ROOT,NNP-NNP-NNP-NNP-NNP,NNP,8,1
788,11589.0,54,directed,3,6,12,6,5,41,-3,9,Federal Motor Carrier Safety Administration,FMCSA,ORGANIZATION-ORGANIZATION-ORGANIZATION-ORGANIZATION-ORGANIZATION,ORGANIZATION,PROPN-PROPN-PROPN-PROPN-PROPN,PROPN,compound-compound-compound-compound-dobj,ccomp,NNP-NNP-NNP-NNP-NNP,NNP,3,1
789,16330.0,35,Administration,5,2,8,6,1,26,3,3,Federal Motor Carrier Safety Administration,FMCSA,ORGANIZATION-ORGANIZATION-ORGANIZATION-ORGANIZATION-ORGANIZATION,ORGANIZATION,PROPN-PROPN-PROPN-PROPN-PROPN,PROPN,compound-compound-compound-compound-ROOT,compound,NNP-NNP-NNP-NNP-NNP,NNP,5,1
790,40867.0,41,said,38,2,9,7,1,31,36,-29,Federal Motor Carrier Safety Administration,FMCSA,ORGANIZATION-ORGANIZATION-ORGANIZATION-ORGANIZATION-ORGANIZATION,ORGANIZATION,PROPN-PROPN-PROPN-PROPN-PROPN,NOUN,compound-compound-compound-compound-nsubj,conj,NNP-NNP-NNP-NNP-NNP,NN,5,1
791,47838.0,52,WASHINGTON,0,43,49,6,42,2,-43,49,Federal Motor Carrier Safety Administration,FMCSA,ORGANIZATION-ORGANIZATION-ORGANIZATION-ORGANIZATION-ORGANIZATION,ORGANIZATION,PROPN-PROPN-PROPN-PROPN-PROPN,PROPN,compound-compound-compound-compound-dobj,ROOT,NNP-NNP-NNP-NNP-NNP,NNP,6,1
792,1241.0,38,misspelled,22,9,21,12,8,16,13,-1,Cathleen P. Black,chancellor,PERSON-PERSON-PERSON,TITLE,PROPN-PROPN-PROPN,NOUN,compound-compound-pobj,pobj,NNP-NNP-NNP,NN,4,1
793,2522.0,36,had,26,6,24,18,5,11,20,-2,Cathleen P. Black,chancellor,PERSON-PERSON-PERSON,TITLE,PROPN-PROPN-PROPN,NOUN,compound-compound-nsubj,attr,NNP-NNP-NNP,NN,2,1
794,18618.0,25,NY-SCHOOLS-CHIEF,0,14,24,10,13,0,-14,24,Cathleen P. Black,chancellor,PERSON-PERSON-PERSON,TITLE,PROPN-PROPN-PROPN,NOUN,compound-compound-pobj,pobj,NNP-NNP-NNP,NN,5,1
795,27999.0,69,NY-SCHOOLS-CHIEF,0,7,21,14,6,47,-7,21,Cathleen P. Black,chancellor,PERSON-PERSON-PERSON,TITLE,PROPN-PROPN-PROPN,NOUN,compound-compound-nsubj,attr,NNP-NNP-NNP,NN,3,1
796,32923.0,36,step,19,1,8,7,0,27,18,-11,Cathleen P. Black,chancellor,PERSON-PERSON-PERSON,TITLE,PROPN-PROPN-PROPN,NOUN,compound-compound-nsubj,oprd,NNP-NNP-NNP,NN,4,1
797,40289.0,89,have,30,1,27,26,0,61,29,-3,Cathleen P. Black,chancellor,PERSON-PERSON-PERSON,TITLE,PROPN-PROPN-PROPN,NOUN,compound-compound-nsubj,attr,NNP-NNP-NNP,NN,3,1
798,40433.0,52,was,22,4,16,12,3,35,18,-6,Cathleen P. Black,chancellor,PERSON-PERSON-PERSON,TITLE,PROPN-PROPN-PROPN,NOUN,compound-compound-pobj,attr,NNP-NNP-NNP,NN,8,1
799,49230.0,66,NY-SCHOOLS-CHIEF,0,24,34,10,23,31,-24,34,Cathleen P. Black,chancellor,PERSON-PERSON-PERSON,TITLE,PROPN-PROPN-PROPN,NOUN,compound-compound-pobj,attr,NNP-NNP-NNP,NN,5,1
800,51315.0,26,is,1,15,13,-2,14,12,-14,12,Cathleen P. Black,chancellor,PERSON-PERSON-PERSON,TITLE,PROPN-PROPN-PROPN,NOUN,compound-compound-appos,pobj,NNP-NNP-NNP,NN,3,1
801,64129.0,33,tried,13,3,13,10,2,19,10,0,Cathleen P. Black,chancellor,PERSON-PERSON-PERSON,TITLE,PROPN-PROPN-PROPN,NOUN,compound-compound-poss,nsubj,NNP-NNP-NNP,NN,5,1
802,1278.0,20,was,7,1,18,17,0,1,6,11,Her,African-American,PERSON,NATIONALITY,DET,ADJ,poss,amod,PRP$,JJ,7,1
803,1285.0,50,find,14,5,12,7,4,37,9,-2,Beverly Sills,78,PERSON-PERSON,NUMBER,PROPN-PROPN,NUM,compound-pobj,pobj,NNP-NNP,CD,4,1
804,21281.0,13,legend,1,3,12,9,2,0,-2,11,Beverly Sills,78,PERSON-PERSON,NUMBER,PROPN-PROPN,NUM,compound-nsubj,nummod,NNP-NNP,CD,2,1
805,41071.0,16,says,4,1,15,14,0,0,3,11,Beverly Sills,78,PERSON-PERSON,NUMBER,PROPN-PROPN,NUM,compound-poss,nummod,NNP-NNP,CD,3,1
806,53816.0,19,Labels,0,3,18,15,2,0,-3,18,Beverly Sills,78,PERSON-PERSON,NUMBER,PROPN-PROPN,NUM,compound-nsubj,nummod,NNP-NNP,CD,3,1
807,1286.0,25,Democrat,4,2,7,5,1,17,2,3,Juanita Millender-McDonald,California,PERSON-PERSON,STATE_OR_PROVINCE,PROPN-PROPN,PROPN,compound-compound,compound,NNP-NNP,NNP,3,1
808,7620.0,23,Millender-McDonald,3,3,1,-2,2,21,0,-2,Juanita Millender-McDonald,California,PERSON-PERSON,STATE_OR_PROVINCE,PROPN-PROPN,PROPN,compound-ROOT,compound,NNP-NNP,NNP,2,1
809,15769.0,29,died,16,2,7,5,1,21,14,-9,Juanita Millender-McDonald,California,PERSON-PERSON,STATE_OR_PROVINCE,PROPN-PROPN,PROPN,compound-nsubj,compound,NNP-NNP,NNP,4,1
810,44207.0,31,died,26,2,6,4,1,24,24,-20,Juanita Millender-McDonald,California,PERSON-PERSON,STATE_OR_PROVINCE,PROPN-PROPN,PROPN,compound-nsubj,compound,NNP-NNP,NNP,3,1
811,45164.0,4,Millender-McDonald,3,3,1,-2,2,2,0,-2,Juanita Millender-McDonald,California,PERSON-PERSON,STATE_OR_PROVINCE,PROPN-PROPN,PROPN,compound-ROOT,compound,NNP-NNP,NNP,2,1
812,59779.0,39,replied,13,12,10,-2,11,28,1,-3,Juanita Millender-McDonald,California,PERSON-PERSON,STATE_OR_PROVINCE,PROPN-PROPN,PROPN,compound-nsubj,compound,NNP-NNP,NNP,3,1
813,61878.0,31,reported,29,3,9,6,2,21,26,-20,Juanita Millender-McDonald,California,PERSON-PERSON,STATE_OR_PROVINCE,PROPN-PROPN,PROPN,compound-nsubj,appos,NNP-NNP,NNP,3,1
814,62475.0,25,hold,2,20,1,-19,19,23,-18,-1,Juanita Millender-McDonald,California,PERSON-PERSON,STATE_OR_PROVINCE,PROPN-PROPN,PROPN,compound-compound,nsubj,NNP-NNP,NNP,9,1
815,1294.0,28,said,17,25,15,-10,24,12,-8,-2,American Bankers Association,America,ORGANIZATION-ORGANIZATION-ORGANIZATION,COUNTRY,PROPN-PROPN-PROPN,PROPN,compound-compound-pobj,pobj,NNP-NNPS-NNP,NNP,8,1
816,66639.0,27,done,15,7,11,4,6,15,8,-4,American Bankers Association,America,ORGANIZATION-ORGANIZATION-ORGANIZATION,COUNTRY,PROPN-PROPN-PROPN,PROPN,compound-compound-pobj,poss,NNP-NNPS-NNP,NNP,4,1
817,1303.0,41,dedicated,11,37,18,-19,36,22,-26,7,his,Atlanta,PERSON,CITY,DET,PROPN,poss,compound,PRP$,NNP,6,1
818,19713.0,46,dedicated,11,37,18,-19,36,27,-26,7,his,Atlanta,PERSON,CITY,DET,PROPN,poss,compound,PRP$,NNP,6,1
819,1304.0,18,was,1,1,17,16,0,0,0,16,She,America,PERSON,COUNTRY,PRON,PROPN,nsubj,pobj,PRP,NNP,1,1
820,1305.0,53,dank,0,25,29,4,24,23,-25,29,American Psychological Association,APA,ORGANIZATION-ORGANIZATION-ORGANIZATION,ORGANIZATION,PROPN-PROPN-PROPN,PROPN,compound-compound-pobj,compound,NNP-NNP-NNP,NNP,-1,1
821,6565.0,26,Graduate,0,20,24,4,19,1,-20,24,American Psychological Association,APA,ORGANIZATION-ORGANIZATION-ORGANIZATION,ORGANIZATION,PROPN-PROPN-PROPN,PROPN,compound-compound-pobj,compound,NNP-NNP-NNP,NNP,-1,1
822,51508.0,32,confirmed,9,16,27,11,15,4,-7,18,American Psychological Association,APA,ORGANIZATION-ORGANIZATION-ORGANIZATION,ORGANIZATION,PROPN-PROPN-PROPN,PROPN,compound-compound-pobj,nsubj,NNP-NNP-NNP,NNP,9,1
823,1306.0,40,died,7,1,5,4,0,34,6,-2,Deaver,pancreatic cancer,PERSON,CAUSE_OF_DEATH-CAUSE_OF_DEATH,PROPN,ADJ-NOUN,compound,amod-dobj,NNP,JJ-NN,3,1
824,55341.0,16,died,8,2,6,4,1,9,6,-2,Deaver,pancreatic cancer,PERSON,CAUSE_OF_DEATH-CAUSE_OF_DEATH,PROPN,ADJ-NOUN,nsubj,amod-dobj,NNP,JJ-NN,3,1
825,1314.0,17,holds,8,2,2,0,1,14,6,-6,China National Aviation Corp.,China Eastern,ORGANIZATION-ORGANIZATION-ORGANIZATION-ORGANIZATION,ORGANIZATION-ORGANIZATION,PROPN-PROPN-PROPN-PROPN,PROPN-PROPN,compound-compound-compound-nsubj,compound-pobj,NNP-NNP-NNP-NNP,NNP-NNP,0,1
826,1326.0,33,alleged,18,7,9,2,6,23,11,-9,Scorpions,Gauteng province,ORGANIZATION,LOCATION-LOCATION,PROPN,PROPN-NOUN,pobj,compound-pobj,NNPS,NNP-NN,1,1
827,1329.0,33,born,30,26,15,-11,25,17,4,-15,his,Ukraine,PERSON,COUNTRY,DET,PROPN,poss,compound,PRP$,NNP,4,1
828,51529.0,23,emigrated,4,17,9,-8,16,13,-13,5,his,Ukraine,PERSON,COUNTRY,DET,PROPN,poss,pobj,PRP$,NNP,7,1
829,1350.0,33,said,9,1,4,3,0,28,8,-5,Paul Watson,captain,PERSON-PERSON,TITLE,PROPN-PROPN,NOUN,compound-nsubj,appos,NNP-NNP,NN,2,1
830,11806.0,28,said,12,3,2,-1,2,25,9,-10,Paul Watson,captain,PERSON-PERSON,TITLE,PROPN-PROPN,NOUN,compound-appos,nsubj,NNP-NNP,NN,1,1
831,17015.0,57,turn,6,4,3,-1,3,53,2,-3,Paul Watson,captain,PERSON-PERSON,TITLE,PROPN-PROPN,NOUN,compound-nsubj,compound,NNP-NNP,NN,1,1
832,17667.0,35,received,16,1,5,4,0,29,15,-11,Paul Watson,captain,PERSON-PERSON,TITLE,PROPN-PROPN,NOUN,compound-nsubj,appos,NNP-NNP,NN,2,1
833,33799.0,31,said,13,11,2,-9,10,28,2,-11,Paul Watson,captain,PERSON-PERSON,TITLE,PROPN-PROPN,NOUN,compound-appos,nsubj,NNP-NNP,NN,2,1
834,47823.0,38,said,5,4,3,-1,3,34,1,-2,Paul Watson,captain,PERSON-PERSON,TITLE,PROPN-PROPN,NOUN,compound-nsubj,compound,NNP-NNP,NN,1,1
835,50364.0,41,TOKYO,0,16,15,-1,15,25,-16,15,Paul Watson,captain,PERSON-PERSON,TITLE,PROPN-PROPN,NOUN,compound-nsubj,compound,NNP-NNP,NN,1,1
836,1353.0,27,said,14,24,16,-8,23,10,-10,2,Asian Development Bank,Rajat Nag,ORGANIZATION-ORGANIZATION-ORGANIZATION,PERSON-PERSON,PROPN-PROPN-PROPN,PROPN-PROPN,compound-compound-pobj,compound-nsubj,NNP-NNP-NNP,NNP-NNP,4,1
837,50041.0,30,said,25,19,23,4,18,6,6,-2,Asian Development Bank,Rajat Nag,ORGANIZATION-ORGANIZATION-ORGANIZATION,PERSON-PERSON,PROPN-PROPN-PROPN,PROPN-PROPN,compound-compound-pobj,compound-appos,NNP-NNP-NNP,NNP-NNP,4,1
838,1361.0,35,criticized,10,12,5,-7,11,29,-2,-5,Lee,KMT,PERSON,ORGANIZATION,PROPN,PROPN,nsubj,pobj,NNP,NNP,5,1
839,3822.0,68,decided,7,11,2,-9,10,65,-4,-5,Lee,KMT,PERSON,ORGANIZATION,PROPN,PROPN,nsubj,poss,NNP,NNP,7,1
840,1363.0,30,are,20,7,18,11,6,11,13,-2,ConAgra,United Agri Products,ORGANIZATION,ORGANIZATION-ORGANIZATION-ORGANIZATION,PROPN,PROPN-PROPN-PROPN,compound,compound-compound-appos,NNP,NNP-NNP-NNPS,6,1
841,1367.0,37,seen,4,18,2,-16,17,34,-14,-2,Cuba,Castro,PERSON,COUNTRY,PROPN,PROPN,pobj,nsubjpass,NNP,NNP,3,1
842,1372.0,23,says,2,9,11,2,8,11,-7,9,her,Heidi,PERSON,PERSON,DET,PROPN,poss,appos,PRP$,NNP,2,1
843,1375.0,55,s,8,50,44,-6,49,10,-42,36,institute,Richard Lapchick,ORGANIZATION,PERSON-PERSON,NOUN,PROPN-PROPN,pobj,compound-attr,NN,NNP-NNP,4,1
844,1396.0,65,told,41,7,14,7,6,50,34,-27,Al Hubbard,National Economic Council,PERSON-PERSON,ORGANIZATION-ORGANIZATION-ORGANIZATION,PROPN-PROPN,PROPN-PROPN-PROPN,compound-nsubj,compound-compound-pobj,NNP-NNP,NNP-NNP-NNP,4,1
845,3793.0,47,buttressed,5,16,12,-4,15,34,-11,7,Al Hubbard,National Economic Council,PERSON-PERSON,ORGANIZATION-ORGANIZATION-ORGANIZATION,PROPN-PROPN,PROPN-PROPN-PROPN,compound-pobj,compound-compound-compound,NNP-NNP,NNP-NNP-NNP,3,1
846,4369.0,20,seemed,1,10,17,7,9,2,-9,16,Al Hubbard,National Economic Council,PERSON-PERSON,ORGANIZATION-ORGANIZATION-ORGANIZATION,PROPN-PROPN,PROPN-PROPN-PROPN,compound-pobj,compound-compound-pobj,NNP-NNP,NNP-NNP-NNP,4,1
847,18605.0,29,nominated,5,21,17,-4,20,11,-16,12,Al Hubbard,National Economic Council,PERSON-PERSON,ORGANIZATION-ORGANIZATION-ORGANIZATION,PROPN-PROPN,PROPN-PROPN-PROPN,compound-appos,compound-compound-pobj,NNP-NNP,NNP-NNP-NNP,2,1
848,35779.0,27,is,1,3,9,6,2,17,-2,8,Al Hubbard,National Economic Council,PERSON-PERSON,ORGANIZATION-ORGANIZATION-ORGANIZATION,PROPN-PROPN,PROPN-PROPN-PROPN,compound-attr,compound-compound-pobj,NNP-NNP,NNP-NNP-NNP,4,1
849,44666.0,19,was,2,1,7,6,0,11,1,5,Al Hubbard,National Economic Council,PERSON-PERSON,ORGANIZATION-ORGANIZATION-ORGANIZATION,PROPN-PROPN,PROPN-PROPN-PROPN,compound-nsubj,compound-compound-pobj,NNP-NNP,NNP-NNP-NNP,5,1
850,48039.0,16,replaced,8,5,1,-4,4,14,3,-7,Al Hubbard,National Economic Council,PERSON-PERSON,ORGANIZATION-ORGANIZATION-ORGANIZATION,PROPN-PROPN,PROPN-PROPN-PROPN,compound-nsubjpass,compound-compound-compound,NNP-NNP,NNP-NNP-NNP,3,1
851,48280.0,40,predicted,15,6,12,6,5,27,9,-3,Al Hubbard,National Economic Council,PERSON-PERSON,ORGANIZATION-ORGANIZATION-ORGANIZATION,PROPN-PROPN,PROPN-PROPN-PROPN,compound-nsubj,compound-compound-pobj,NNP-NNP,NNP-NNP-NNP,4,1
852,50815.0,32,said,17,19,25,6,18,6,-2,8,Al Hubbard,National Economic Council,PERSON-PERSON,ORGANIZATION-ORGANIZATION-ORGANIZATION,PROPN-PROPN,PROPN-PROPN-PROPN,compound-nsubj,compound-compound-pobj,NNP-NNP,NNP-NNP-NNP,5,1
853,56503.0,50,said,18,9,15,6,8,34,9,-3,Al Hubbard,National Economic Council,PERSON-PERSON,ORGANIZATION-ORGANIZATION-ORGANIZATION,PROPN-PROPN,PROPN-PROPN-PROPN,compound-appos,compound-compound-pobj,NNP-NNP,NNP-NNP-NNP,4,1
854,58109.0,43,plans,13,1,10,9,0,32,12,-3,Al Hubbard,National Economic Council,PERSON-PERSON,ORGANIZATION-ORGANIZATION-ORGANIZATION,PROPN-PROPN,PROPN-PROPN-PROPN,compound-nsubj,compound-compound-pobj,NNP-NNP,NNP-NNP-NNP,4,1
855,58673.0,37,wants,8,10,17,7,9,19,-2,9,Al Hubbard,National Economic Council,PERSON-PERSON,ORGANIZATION-ORGANIZATION-ORGANIZATION,PROPN-PROPN,PROPN-PROPN-PROPN,compound-dobj,compound-compound-pobj,NNP-NNP,NNP-NNP-NNP,4,1
856,1400.0,20,received,1,3,8,5,2,11,-2,7,his,University of Wisconsin,PERSON,ORGANIZATION-ORGANIZATION-ORGANIZATION,DET,PROPN-ADP-PROPN,poss,pobj-prep-pobj,PRP$,NNP-IN-NNP,5,1
857,1401.0,22,spent,2,7,11,4,6,10,-5,9,Spencer,Ava,PERSON,PERSON,PROPN,PROPN,poss,appos,NNP,NNP,5,1
858,1407.0,10,s,2,4,1,-3,3,8,-2,-1,Sadia,Brazil,ORGANIZATION,COUNTRY,PROPN,PROPN,nsubj,nsubj,NNP,NNP,3,1
859,30204.0,26,said,24,1,13,12,0,12,23,-11,Sadia,Brazil,ORGANIZATION,COUNTRY,PROPN,PROPN,dobj,poss,NNP,NNP,4,1
860,1410.0,47,claimed,20,20,9,-11,19,37,0,-11,Chavez,leader,PERSON,TITLE,PROPN,NOUN,nsubj,dobj,NNP,NN,3,1
861,1411.0,52,left,43,11,31,20,10,20,32,-12,Oxford University Press,OUP,ORGANIZATION-ORGANIZATION-ORGANIZATION,ORGANIZATION,PROPN-PROPN-PROPN,PROPN,compound-compound-pobj,poss,NNP-NNP-NNP,NNP,11,1
862,15011.0,36,apologised,7,2,6,4,1,29,5,-1,Oxford University Press,OUP,ORGANIZATION-ORGANIZATION-ORGANIZATION,ORGANIZATION,PROPN-PROPN-PROPN,PROPN,compound-compound-nsubj,compound,NNP-NNP-NNP,NNP,2,1
863,1412.0,35,said,25,30,27,-3,29,7,-5,2,Carnival,Micky Arison,ORGANIZATION,PERSON-PERSON,PROPN,PROPN-PROPN,compound,compound-nsubj,NNP,NNP-NNP,3,1
864,39228.0,23,noted,10,5,9,4,4,13,5,-1,Carnival,Micky Arison,ORGANIZATION,PERSON-PERSON,PROPN,PROPN-PROPN,compound,compound-appos,NNP,NNP-NNP,3,1
865,63372.0,31,said,7,1,6,5,0,24,6,-1,Carnival,Micky Arison,ORGANIZATION,PERSON-PERSON,PROPN,PROPN-PROPN,compound,compound-appos,NNP,NNP-NNP,1,1
866,1413.0,31,said,29,1,28,27,0,2,28,-1,Goodman,Jonathan Goodman,PERSON,PERSON-PERSON,PROPN,PROPN-PROPN,nsubj,compound-appos,NNP,NNP-NNP,5,1
867,1417.0,37,tempting,2,12,12,0,11,24,-10,10,Chávez,Chávez,PERSON,PERSON,PROPN,PROPN,nsubj,attr,NNP,NNP,0,1
868,1419.0,35,took,16,8,15,7,7,19,8,-1,DeBlanc,Marines,PERSON,ORGANIZATION,PROPN,PROPN,nsubj,pobj,NNP,NNPS,3,1
869,1433.0,12,came,6,5,2,-3,4,9,1,-4,John Kerry,US,PERSON-PERSON,COUNTRY,PROPN-PROPN,PROPN,compound-nsubj,compound,NNP-NNP,NNP,2,1
870,56429.0,26,said,1,13,21,8,12,4,-12,20,John Kerry,US,PERSON-PERSON,COUNTRY,PROPN-PROPN,PROPN,compound-appos,compound,NNP-NNP,NNP,5,1
871,1434.0,34,said,14,24,16,-8,23,17,-10,2,Federal Motor Carrier Safety Administration,Melissa Mazzella DeLaney,ORGANIZATION-ORGANIZATION-ORGANIZATION-ORGANIZATION-ORGANIZATION,PERSON-PERSON-PERSON,PROPN-PROPN-PROPN-PROPN-PROPN,PROPN-PROPN-PROPN,compound-compound-compound-compound-pobj,compound-compound-nsubj,NNP-NNP-NNP-NNP-NNP,NNP-NNP-NNP,7,1
872,1437.0,29,accompanied,6,10,14,4,9,14,-4,8,his,she,PERSON,PERSON,DET,PRON,poss,nsubj,PRP$,PRP,3,1
873,54816.0,45,includes,6,22,29,7,21,15,-16,23,his,she,PERSON,PERSON,DET,PRON,poss,nsubj,PRP$,PRP,4,1
874,56316.0,29,accompanied,6,10,14,4,9,14,-4,8,his,she,PERSON,PERSON,DET,PRON,poss,nsubj,PRP$,PRP,3,1
875,1443.0,40,recorded,3,1,21,20,0,18,2,18,Hong Kong Disneyland,Walt Disney Company,ORGANIZATION-ORGANIZATION-ORGANIZATION,ORGANIZATION-ORGANIZATION-ORGANIZATION,PROPN-PROPN-PROPN,PROPN-PROPN-PROPN,compound-compound-nsubj,compound-compound-poss,NNP-NNP-NNP,NNP-NNP-NNP,8,1
876,1445.0,30,survived,2,8,1,-7,7,28,-6,-1,Carol Ann Bellecourt,Bellecourt,PERSON-PERSON-PERSON,PERSON,PROPN-PROPN-PROPN,PROPN,compound-compound-appos,nsubjpass,NNP-NNP-NNP,NNP,5,1
877,1450.0,52,detonated,4,16,11,-5,15,40,-12,7,ANP,National People 's Army,ORGANIZATION,ORGANIZATION-ORGANIZATION-ORGANIZATION-ORGANIZATION,PROPN,PROPN-PROPN-PART-PROPN,compound,compound-poss-case-compound,NNP,NNP-NNPS-POS-NNP,7,1
878,7435.0,29,detonated,3,15,10,-5,14,18,-12,7,ANP,National People 's Army,ORGANIZATION,ORGANIZATION-ORGANIZATION-ORGANIZATION-ORGANIZATION,PROPN,PROPN-PROPN-PART-PROPN,compound,compound-poss-case-compound,NNP,NNP-NNPS-POS-NNP,6,1
879,1469.0,42,investigating,3,2,1,-1,1,40,1,-2,Gilmor,Rep.,PERSON,TITLE,PROPN,PROPN,nsubj,compound,NNP,NNP,2,1
880,1479.0,27,represents,16,4,9,5,3,17,12,-7,ITW,Ill,ORGANIZATION,STATE_OR_PROVINCE,PROPN,PROPN,pobj,conj,NNP,NNP,4,1
881,1480.0,16,is,7,6,10,4,5,5,1,3,Spencer Pratt,rapper,PERSON-PERSON,TITLE,PROPN-PROPN,NOUN,compound-nsubj,attr,NNP-NNP,NN,2,1
882,1482.0,44,said,19,16,18,2,15,25,3,-1,EnergySolutions,Steve Creamer,ORGANIZATION,PERSON-PERSON,PROPN,PROPN-PROPN,compound,compound-nsubj,NNP,NNP-NNP,1,1
883,52595.0,29,went,6,28,17,-11,27,11,-22,11,EnergySolutions,Steve Creamer,ORGANIZATION,PERSON-PERSON,PROPN,PROPN-PROPN,pobj,compound-pobj,NNP,NNP-NNP,7,1
884,52958.0,44,said,19,16,18,2,15,25,3,-1,EnergySolutions,Steve Creamer,ORGANIZATION,PERSON-PERSON,PROPN,PROPN-PROPN,compound,compound-nsubj,NNP,NNP-NNP,1,1
885,1493.0,29,Of,0,4,9,5,3,19,-4,9,ABA,San Antonio,ORGANIZATION,ORGANIZATION-ORGANIZATION,PROPN,PROPN-PROPN,compound,compound-conj,NNP,NNP-NNP,5,1
886,1496.0,35,said,10,8,5,-3,7,29,2,-5,Carnival Cruise Lines,Miami,ORGANIZATION-ORGANIZATION-ORGANIZATION,CITY,PROPN-PROPN-PROPN,PROPN,compound-compound-nsubj,nmod,NNP-NNP-NNPS,NNP,3,1
887,1500.0,48,died,37,42,47,5,41,0,-5,10,her,Calif.,PERSON,STATE_OR_PROVINCE,DET,PROPN,poss,appos,PRP$,NNP,3,1
888,14042.0,45,died,36,16,44,28,15,0,20,8,her,Calif.,PERSON,STATE_OR_PROVINCE,DET,PROPN,poss,appos,PRP$,NNP,8,1
889,1502.0,26,started,12,10,7,-3,9,18,2,-5,Robert Goodman,her,PERSON-PERSON,PERSON,PROPN-PROPN,DET,compound-appos,poss,NNP-NNP,PRP$,1,1
890,1505.0,43,said,40,1,14,13,0,28,39,-26,Pentax Corp,Japanese,ORGANIZATION-ORGANIZATION,COUNTRY,PROPN-PROPN,ADJ,compound-pobj,amod,NNP-NNP,JJ,7,1
891,1506.0,35,served,6,6,14,8,5,20,0,8,Negroponte,United Nations,PERSON,ORGANIZATION-ORGANIZATION,PROPN,PROPN-PROPN,nsubj,compound-pobj,NNP,NNP-NNP,4,1
892,1512.0,34,said,12,1,8,7,0,25,11,-4,Rafael Molina,Inter American Press Association,ORGANIZATION-ORGANIZATION,PERSON-PERSON-PERSON-PERSON,PROPN-PROPN,PROPN-PROPN-PROPN-PROPN,compound-nsubj,compound-compound-compound-pobj,NNP-NNP,NNP-NNP-NNP-NNP,4,1
893,1516.0,40,submit,3,8,14,6,7,25,-5,11,Madoff Securities,I.B.M.,ORGANIZATION-ORGANIZATION,ORGANIZATION,PROPN-PROPN,PROPN,compound-pobj,compound,NNP-NNPS,NNP,4,1
894,1528.0,22,appealing,7,15,6,-9,14,15,-8,-1,International Skating Union,Germany,ORGANIZATION-ORGANIZATION-ORGANIZATION,COUNTRY,PROPN-PROPN-PROPN,PROPN,compound-compound-pobj,pobj,NNP-NNP-NNP,NNP,4,1
895,1531.0,28,said,8,1,5,4,0,22,7,-3,Paul Watson,Sea Shepherd Conservation Society,PERSON-PERSON,ORGANIZATION-ORGANIZATION-ORGANIZATION-ORGANIZATION,PROPN-PROPN,PROPN-PROPN-PROPN-PROPN,compound-nsubj,compound-compound-compound-pobj,NNP-NNP,NNP-NNP-NNP-NNP,3,1
896,4565.0,31,said,13,11,5,-6,10,25,2,-8,Paul Watson,Sea Shepherd Conservation Society,PERSON-PERSON,ORGANIZATION-ORGANIZATION-ORGANIZATION-ORGANIZATION,PROPN-PROPN,PROPN-PROPN-PROPN-PROPN,compound-appos,compound-compound-compound-compound,NNP-NNP,NNP-NNP-NNP-NNP,5,1
897,7115.0,54,sparked,5,17,2,-15,16,51,-12,-3,Paul Watson,Sea Shepherd Conservation Society,PERSON-PERSON,ORGANIZATION-ORGANIZATION-ORGANIZATION-ORGANIZATION,PROPN-PROPN,PROPN-PROPN-PROPN-PROPN,compound-appos,compound-compound-compound-nsubj,NNP-NNP,NNP-NNP-NNP-NNP,5,1
898,18513.0,40,said,15,2,6,4,1,33,13,-9,Paul Watson,Sea Shepherd Conservation Society,PERSON-PERSON,ORGANIZATION-ORGANIZATION-ORGANIZATION-ORGANIZATION,PROPN-PROPN,PROPN-PROPN-PROPN-PROPN,compound-nsubj,compound-compound-compound-compound,NNP-NNP,NNP-NNP-NNP-NNP,4,1
899,31747.0,28,said,11,1,7,6,0,20,10,-4,Paul Watson,Sea Shepherd Conservation Society,PERSON-PERSON,ORGANIZATION-ORGANIZATION-ORGANIZATION-ORGANIZATION,PROPN-PROPN,PROPN-PROPN-PROPN-PROPN,compound-nsubj,compound-compound-compound-pobj,NNP-NNP,NNP-NNP-NNP-NNP,4,1
900,56047.0,39,says,11,1,7,6,0,31,10,-4,Paul Watson,Sea Shepherd Conservation Society,PERSON-PERSON,ORGANIZATION-ORGANIZATION-ORGANIZATION-ORGANIZATION,PROPN-PROPN,PROPN-PROPN-PROPN-PROPN,compound-nsubj,compound-compound-compound-pobj,NNP-NNP,NNP-NNP-NNP-NNP,4,1
901,57710.0,35,named,9,1,5,4,0,29,8,-4,Paul Watson,Sea Shepherd Conservation Society,PERSON-PERSON,ORGANIZATION-ORGANIZATION-ORGANIZATION-ORGANIZATION,PROPN-PROPN,PROPN-PROPN-PROPN-PROPN,compound-nsubjpass,compound-compound-compound-pobj,NNP-NNP,NNP-NNP-NNP-NNP,3,1
902,58281.0,27,described,14,11,2,-9,10,24,3,-12,Paul Watson,Sea Shepherd Conservation Society,PERSON-PERSON,ORGANIZATION-ORGANIZATION-ORGANIZATION-ORGANIZATION,PROPN-PROPN,PROPN-PROPN-PROPN-PROPN,compound-pobj,compound-compound-compound-nsubj,NNP-NNP,NNP-NNP-NNP-NNP,5,1
903,1533.0,50,said,33,29,32,3,28,17,4,-1,Yolanda King,51,PERSON-PERSON,NUMBER,PROPN-PROPN,NUM,compound-nsubj,appos,NNP-NNP,CD,2,1
904,1538.0,60,confesses,28,12,6,-6,11,53,16,-22,Donald Wildmon,Tupelo,PERSON-PERSON,CITY,PROPN-PROPN,PROPN,compound-appos,pobj,NNP-NNP,NNP,7,1
905,15746.0,25,UTC,2,5,23,18,4,1,-3,21,Donald Wildmon,Tupelo,PERSON-PERSON,CITY,PROPN-PROPN,PROPN,compound-ROOT,pobj,NNP-NNP,NNP,7,1
906,26599.0,66,comes,2,47,63,16,46,2,-45,61,Donald Wildmon,Tupelo,PERSON-PERSON,CITY,PROPN-PROPN,PROPN,compound-pobj,pobj,NNP-NNP,NNP,6,1
907,35809.0,22,is,7,15,6,-9,14,15,-8,-1,Donald Wildmon,Tupelo,PERSON-PERSON,CITY,PROPN-PROPN,PROPN,compound-appos,appos,NNP-NNP,NNP,5,1
908,1541.0,29,scooping,15,11,22,11,10,6,4,7,Highland Capital Partners,City Sports,ORGANIZATION-ORGANIZATION-ORGANIZATION,ORGANIZATION-ORGANIZATION,PROPN-PROPN-PROPN,PROPN-PROPN,compound-compound-appos,compound-appos,NNP-NNP-NNP,NNP-NNPS,6,1
909,1542.0,40,said,34,29,24,-5,28,15,5,-10,Samsung,Choi Gee-sung,ORGANIZATION,PERSON-PERSON,PROPN,PROPN-PROPN,poss,compound-nsubj,NNP,NNP-NNP,2,1
910,1557.0,59,Football,0,3,10,7,2,48,-3,10,Blackburn Rovers,Venky 's Group,ORGANIZATION-ORGANIZATION,ORGANIZATION-ORGANIZATION-ORGANIZATION,PROPN-PROPN,PROPN-PART-PROPN,compound-compound,poss-case-nsubj,NNP-NNPS,NNP-POS-NNP,6,1
911,1559.0,21,started,2,1,8,7,0,12,1,6,She,general director,PERSON,TITLE-TITLE,PRON,ADJ-NOUN,nsubj,amod-pobj,PRP,JJ-NN,3,1
912,1573.0,23,is,12,1,20,19,0,2,11,8,Richard Perle,Defense Policy Board,PERSON-PERSON,ORGANIZATION-ORGANIZATION-ORGANIZATION,PROPN-PROPN,PROPN-PROPN-PROPN,compound-dep,compound-compound-pobj,NNP-NNP,NNP-NNP-NNP,5,1
913,8152.0,14,Perle,1,1,8,7,0,5,0,7,Richard Perle,Defense Policy Board,PERSON-PERSON,ORGANIZATION-ORGANIZATION-ORGANIZATION,PROPN-PROPN,PROPN-PROPN-PROPN,compound-ROOT,compound-compound-dobj,NNP-NNP,NNP-NNP-NNP,3,1
914,12850.0,24,2008-03-31T11,0,3,21,18,2,2,-3,21,Richard Perle,Defense Policy Board,PERSON-PERSON,ORGANIZATION-ORGANIZATION-ORGANIZATION,PROPN-PROPN,PROPN-PROPN-PROPN,compound-ROOT,compound-compound-pobj,NNP-NNP,NNP-NNP-NNP,5,1
915,27396.0,63,included,8,10,40,30,9,22,-2,32,Richard Perle,Defense Policy Board,PERSON-PERSON,ORGANIZATION-ORGANIZATION-ORGANIZATION,PROPN-PROPN,PROPN-PROPN-PROPN,compound-dobj,compound-compound-pobj,NNP-NNP,NNP-NNP-NNP,-1,1
916,1583.0,48,compared,20,26,30,4,25,17,-6,10,John Kerry,Massachusetts,PERSON-PERSON,STATE_OR_PROVINCE,PROPN-PROPN,PROPN,compound-pobj,compound,NNP-NNP,NNP,1,1
917,5324.0,45,2005-10-12T21,0,23,21,-2,22,23,-23,21,John Kerry,Massachusetts,PERSON-PERSON,ORGANIZATION,PROPN-PROPN,PROPN,compound-dobj,compound,NNP-NNP,NNP,1,1
918,7561.0,51,were,26,12,10,-2,11,40,14,-16,John Kerry,Massachusetts,PERSON-PERSON,STATE_OR_PROVINCE,PROPN-PROPN,PROPN,compound-appos,compound,NNP-NNP,NNP,1,1
919,32547.0,35,called,7,19,17,-2,18,17,-12,10,John Kerry,Massachusetts,PERSON-PERSON,STATE_OR_PROVINCE,PROPN-PROPN,PROPN,compound-nsubj,compound,NNP-NNP,NNP,1,1
920,32876.0,34,announced,17,2,8,6,1,25,15,-9,John Kerry,Massachusetts,PERSON-PERSON,STATE_OR_PROVINCE,PROPN-PROPN,PROPN,compound-nsubj,pobj,NNP-NNP,NNP,4,1
921,33907.0,40,stood,25,11,14,3,10,25,14,-11,John Kerry,Massachusetts,PERSON-PERSON,STATE_OR_PROVINCE,PROPN-PROPN,PROPN,compound-pobj,pobj,NNP-NNP,NNP,3,1
922,38666.0,38,ruled,5,2,5,3,1,32,3,0,John Kerry,Massachusetts,PERSON-PERSON,STATE_OR_PROVINCE,PROPN-PROPN,PROPN,compound-nsubj,pobj,NNP-NNP,NNP,1,1
923,53523.0,34,Nescio,1,7,10,3,6,23,-6,9,John Kerry,Massachusetts,PERSON-PERSON,STATE_OR_PROVINCE,PROPN-PROPN,PROPN,compound-nsubj,pobj,NNP-NNP,NNP,3,1
924,1596.0,48,put,35,1,18,17,0,29,34,-17,Zagat,1979,ORGANIZATION,DATE,PROPN,NUM,compound,pobj,NNP,CD,3,1
925,6965.0,32,powered,19,13,15,2,12,16,6,-4,Zagat,1979,ORGANIZATION,DATE,PROPN,NUM,pobj,pobj,NNP,CD,3,1
926,24237.0,46,founded,3,20,9,-11,19,36,-17,6,Zagat,1979,ORGANIZATION,DATE,PROPN,NUM,conj,pobj,NNP,CD,2,1
927,1601.0,28,talking,14,1,9,8,0,18,13,-5,Sean Parker,Facebook,PERSON-PERSON,ORGANIZATION,PROPN-PROPN,PROPN,compound-nsubj,conj,NNP-NNP,NNP,2,1
928,16298.0,31,-LRB-,1,6,14,8,5,16,-5,13,Sean Parker,Facebook,PERSON-PERSON,ORGANIZATION,PROPN-PROPN,PROPN,compound-nsubj,conj,NNP-NNP,NNP,-1,1
929,20450.0,32,said,14,16,12,-4,15,19,-2,-2,Sean Parker,Facebook,PERSON-PERSON,ORGANIZATION,PROPN-PROPN,PROPN,compound-nsubj,compound,NNP-NNP,NNP,6,1
930,31794.0,32,said,14,16,12,-4,15,19,-2,-2,Sean Parker,Facebook,PERSON-PERSON,ORGANIZATION,PROPN-PROPN,PROPN,compound-nsubj,pobj,NNP-NNP,NNP,6,1
931,1602.0,25,appointed,9,6,5,-1,5,19,3,-4,Cathleen P Black,President,PERSON-PERSON-PERSON,TITLE,PROPN-PROPN-PROPN,PROPN,compound-compound-nsubj,compound,NNP-NNP-NNP,NNP,2,1
932,34064.0,24,appointed,7,4,3,-1,3,20,3,-4,Cathleen P Black,President,PERSON-PERSON-PERSON,TITLE,PROPN-PROPN-PROPN,PROPN,compound-compound-nsubj,compound,NNP-NNP-NNP,NNP,2,1
933,63026.0,17,announced,6,4,3,-1,3,13,2,-3,Cathleen P Black,President,PERSON-PERSON-PERSON,TITLE,PROPN-PROPN-PROPN,PROPN,compound-compound-nsubj,compound,NNP-NNP-NNP,NNP,1,1
934,1604.0,42,Members,0,23,27,4,22,14,-23,27,FAPA,United States,ORGANIZATION,COUNTRY-COUNTRY,PROPN,PROPN-PROPN,compound,compound-pobj,NNP,NNP-NNP,3,1
935,1607.0,36,2009-12-11T12,0,22,28,6,21,7,-22,28,Kendra Wilkinson,Hank Baskett IV,PERSON-PERSON,PERSON-PERSON-PERSON,PROPN-PROPN,PROPN-PROPN-PROPN,compound-nsubj,compound-compound-pobj,NNP-NNP,NNP-NNP-NNP,3,1
936,1613.0,30,said,13,8,1,-7,7,28,5,-12,National Wenchuan Earthquake Expert Committee,Ma Zongjin,ORGANIZATION-ORGANIZATION-ORGANIZATION-ORGANIZATION-ORGANIZATION,PERSON-PERSON,PROPN-PROPN-PROPN-PROPN-PROPN,PROPN-PROPN,compound-compound-compound-compound-pobj,compound-nsubj,NNP-NNP-NNP-NNP-NNP,NNP-NNP,5,1
937,22245.0,53,Urgent,0,31,24,-7,30,28,-31,24,National Wenchuan Earthquake Expert Committee,Ma Zongjin,ORGANIZATION-ORGANIZATION-ORGANIZATION-ORGANIZATION-ORGANIZATION,PERSON-PERSON,PROPN-PROPN-PROPN-PROPN-PROPN,PROPN-PROPN,compound-compound-compound-compound-pobj,compound-nsubj,NNP-NNP-NNP-NNP-NNP,NNP-NNP,5,1
938,28522.0,47,said,34,29,22,-7,28,24,5,-12,National Wenchuan Earthquake Expert Committee,Ma Zongjin,ORGANIZATION-ORGANIZATION-ORGANIZATION-ORGANIZATION-ORGANIZATION,PERSON-PERSON,PROPN-PROPN-PROPN-PROPN-PROPN,PROPN-PROPN,compound-compound-compound-compound-pobj,compound-nsubj,NNP-NNP-NNP-NNP-NNP,NNP-NNP,5,1
939,1616.0,55,Mercado,5,40,49,9,39,5,-35,44,Michael Johns,Australia,PERSON-PERSON,COUNTRY,PROPN-PROPN,PROPN,compound-conj,pobj,NNP-NNP,NNP,3,1
940,36309.0,19,Johns,1,1,18,17,0,0,0,17,Michael Johns,Australia,PERSON-PERSON,COUNTRY,PROPN-PROPN,PROPN,compound-ROOT,appos,NNP-NNP,NNP,-1,1
941,52371.0,55,Mercado,5,40,49,9,39,5,-35,44,Michael Johns,Australia,PERSON-PERSON,COUNTRY,PROPN-PROPN,PROPN,compound-conj,pobj,NNP-NNP,NNP,3,1
942,1620.0,46,told,2,4,18,14,3,27,-2,16,ABC radio,five years ago,ORGANIZATION-ORGANIZATION,DATE-DATE-DATE,PROPN-NOUN,NUM-NOUN-ADV,compound-poss,nummod-npadvmod-advmod,NNP-NN,CD-NNS-RB,6,1
943,1621.0,35,begins,1,27,32,5,26,2,-26,31,Abbas Musawi,Lebanon,PERSON-PERSON,NATIONALITY,PROPN-PROPN,PROPN,compound-appos,pobj,NNP-NNP,NNP,6,1
944,1623.0,34,Bank,3,6,2,-4,5,31,-3,-1,ADB,Asian Development Bank,ORGANIZATION,ORGANIZATION-ORGANIZATION-ORGANIZATION,PROPN,PROPN-PROPN-PROPN,compound,compound-compound-ROOT,NNP,NNP-NNP-NNP,2,1
945,2252.0,38,said,29,36,32,-4,35,5,-7,3,ADB,Asian Development Bank,ORGANIZATION,ORGANIZATION-ORGANIZATION-ORGANIZATION,PROPN,PROPN-PROPN-PROPN,compound,compound-compound-nsubj,NNP,NNP-NNP-NNP,3,1
946,15438.0,39,MANILA,0,8,4,-4,7,34,-8,4,ADB,Asian Development Bank,ORGANIZATION,ORGANIZATION-ORGANIZATION-ORGANIZATION,PROPN,PROPN-PROPN-PROPN,compound,compound-compound-ROOT,NNP,NNP-NNP-NNP,2,1
947,41277.0,59,comes,9,20,16,-4,19,42,-11,7,ADB,Asian Development Bank,ORGANIZATION,ORGANIZATION-ORGANIZATION-ORGANIZATION,PROPN,PROPN-PROPN-PROPN,compound,compound-compound-pobj,NNP,NNP-NNP-NNP,5,1
948,42509.0,37,Bank,3,6,2,-4,5,34,-3,-1,ADB,Asian Development Bank,ORGANIZATION,ORGANIZATION-ORGANIZATION-ORGANIZATION,PROPN,PROPN-PROPN-PROPN,compound,compound-compound-ROOT,NNP,NNP-NNP-NNP,2,1
949,53178.0,17,President,0,8,4,-4,7,12,-8,4,ADB,Asian Development Bank,ORGANIZATION,ORGANIZATION-ORGANIZATION-ORGANIZATION,PROPN,PROPN-PROPN-PROPN,compound,compound-compound-pobj,NNP,NNP-NNP-NNP,4,1
950,65602.0,56,At,0,19,4,-15,18,51,-19,4,ADB,Asian Development Bank,ORGANIZATION,ORGANIZATION-ORGANIZATION-ORGANIZATION,PROPN,PROPN-PROPN-PROPN,compound,compound-compound-pobj,NNP,NNP-NNP-NNP,-1,1
951,1627.0,18,announced,2,11,6,-5,10,11,-9,4,Marcel Ospel,chairman,PERSON-PERSON,TITLE,PROPN-PROPN,NOUN,compound-appos,nsubj,NNP-NNP,NN,2,1
952,2683.0,57,said,25,1,6,5,0,50,24,-19,Marcel Ospel,chairman,PERSON-PERSON,TITLE,PROPN-PROPN,NOUN,compound-nsubj,appos,NNP-NNP,NN,2,1
953,11096.0,37,holds,4,33,36,3,32,0,-29,32,Marcel Ospel,chairman,PERSON-PERSON,TITLE,PROPN-PROPN,NOUN,compound-dobj,pobj,NNP-NNP,NN,10,1
954,16933.0,49,said,43,1,8,7,0,40,42,-35,Marcel Ospel,chairman,PERSON-PERSON,TITLE,PROPN-PROPN,NOUN,compound-nsubj,appos,NNP-NNP,NN,3,1
955,17362.0,31,questioned,9,18,30,12,17,0,-9,21,Marcel Ospel,chairman,PERSON-PERSON,TITLE,PROPN-PROPN,NOUN,compound-pobj,pobj,NNP-NNP,NN,5,1
956,22033.0,20,says,6,5,4,-1,4,15,1,-2,Marcel Ospel,chairman,PERSON-PERSON,TITLE,PROPN-PROPN,NOUN,compound-nsubj,compound,NNP-NNP,NN,1,1
957,24884.0,29,said,27,11,21,10,10,7,16,-6,Marcel Ospel,chairman,PERSON-PERSON,TITLE,PROPN-PROPN,NOUN,compound-poss,pobj,NNP-NNP,NN,4,1
958,28155.0,33,trained,15,3,2,-1,2,30,12,-13,Marcel Ospel,chairman,PERSON-PERSON,TITLE,PROPN-PROPN,NOUN,compound-nsubj,compound,NNP-NNP,NN,1,1
959,30903.0,42,seen,35,5,9,4,4,32,30,-26,Marcel Ospel,chairman,PERSON-PERSON,TITLE,PROPN-PROPN,NOUN,compound-pobj,appos,NNP-NNP,NN,3,1
960,38856.0,30,admitted,4,3,2,-1,2,27,1,-2,Marcel Ospel,chairman,PERSON-PERSON,TITLE,PROPN-PROPN,NOUN,compound-nsubj,compound,NNP-NNP,NN,1,1
961,47524.0,36,was,13,20,19,-1,19,16,-7,6,Marcel Ospel,chairman,PERSON-PERSON,TITLE,PROPN-PROPN,NOUN,compound-pobj,compound,NNP-NNP,NN,1,1
962,49790.0,40,included,2,9,8,-1,8,31,-7,6,Marcel Ospel,chairman,PERSON-PERSON,TITLE,PROPN-PROPN,NOUN,compound-pobj,compound,NNP-NNP,NN,1,1
963,60339.0,34,-LRB-,1,28,26,-2,27,7,-27,25,Marcel Ospel,chairman,PERSON-PERSON,TITLE,PROPN-PROPN,NOUN,compound-appos,nsubj,NNP-NNP,NN,2,1
964,66773.0,64,voted,7,20,17,-3,19,46,-13,10,Marcel Ospel,chairman,PERSON-PERSON,TITLE,PROPN-PROPN,NOUN,compound-dobj,pobj,NNP-NNP,NN,3,1
965,1631.0,42,wrote,20,30,22,-8,29,19,-10,2,Old Lane,John Havens,ORGANIZATION-ORGANIZATION,PERSON-PERSON,PROPN-PROPN,PROPN-PROPN,compound-pobj,compound-nsubj,NNP-NNP,NNP-NNP,6,1
966,1639.0,48,dubbed,13,16,19,3,15,28,-3,6,Awami League,AL,ORGANIZATION-ORGANIZATION,ORGANIZATION,PROPN-PROPN,PROPN,compound-compound,compound,NNP-NNP,NNP,5,1
967,9485.0,49,join,14,8,11,3,7,37,6,-3,Awami League,AL,ORGANIZATION-ORGANIZATION,ORGANIZATION,PROPN-PROPN,PROPN,compound-compound,compound,NNP-NNP,NNP,5,1
968,46849.0,28,minister,3,9,12,3,8,15,-6,9,Awami League,AL,ORGANIZATION-ORGANIZATION,ORGANIZATION,PROPN-PROPN,PROPN,compound-appos,compound,NNP-NNP,NNP,6,1
969,52711.0,45,announced,19,8,11,3,7,33,11,-8,Awami League,AL,ORGANIZATION-ORGANIZATION,ORGANIZATION,PROPN-PROPN,PROPN,compound-compound,compound,NNP-NNP,NNP,5,1
970,59257.0,63,affected,3,19,22,3,18,40,-16,19,Awami League,AL,ORGANIZATION-ORGANIZATION,STATE_OR_PROVINCE,PROPN-PROPN,PROPN,compound-pobj,compound,NNP-NNP,NNP,7,1
971,1642.0,53,said,12,16,29,13,15,23,-4,17,he,German,PERSON,NATIONALITY,PRON,ADJ,nsubj,amod,PRP,JJ,6,1
972,1643.0,43,said,41,22,25,3,21,17,19,-16,Alberto Gonzales,attorney general,PERSON-PERSON,TITLE-TITLE,PROPN-PROPN,NOUN-NOUN,compound-dobj,compound-pobj,NNP-NNP,NN-NN,3,1
973,23846.0,44,imagine,6,31,28,-3,30,15,-25,22,Alberto Gonzales,attorney general,PERSON-PERSON,TITLE-TITLE,PROPN-PROPN,NOUN-NOUN,compound-appos,compound-conj,NNP-NNP,NN-NN,1,1
974,1646.0,29,had,19,13,10,-3,12,18,6,-9,Focus on the Family,James Dobson,ORGANIZATION-ORGANIZATION-ORGANIZATION-ORGANIZATION,PERSON-PERSON,PROPN-ADP-DET-PROPN,PROPN-PROPN,appos-prep-det-pobj,compound-poss,NNP-IN-DT-NNP,NNP-NNP,2,1
975,3414.0,43,sent,22,18,10,-8,17,32,4,-12,Focus on the Family,James Dobson,ORGANIZATION-ORGANIZATION-ORGANIZATION-ORGANIZATION,PERSON-PERSON,PROPN-ADP-DET-PROPN,PROPN-PROPN,appos-prep-det-pobj,compound-appos,NNP-IN-DT-NNP,NNP-NNP,5,1
976,8671.0,73,wrote,44,53,46,-7,52,26,-9,2,Focus on the Family,James Dobson,ORGANIZATION-ORGANIZATION-ORGANIZATION-ORGANIZATION,PERSON-PERSON,PROPN-ADP-DET-PROPN,PROPN-PROPN,pobj-prep-det-compound,compound-nsubj,NNP-IN-DT-NNP,NNP-NNP,6,1
977,9299.0,20,been,15,10,1,-9,9,18,5,-14,Focus on the Family,James Dobson,ORGANIZATION-ORGANIZATION-ORGANIZATION-ORGANIZATION,PERSON-PERSON,PROPN-ADP-DET-PROPN,PROPN-PROPN,dobj-prep-det-pobj,compound-nsubj,NNP-IN-DT-NNP,NNP-NNP,3,1
978,9777.0,20,is,7,4,1,-3,3,18,3,-6,Focus on the Family,James Dobson,ORGANIZATION-ORGANIZATION-ORGANIZATION-ORGANIZATION,PERSON-PERSON,PROPN-ADP-DET-PROPN,PROPN-PROPN,nsubj-prep-det-pobj,compound-poss,NNP-IN-DT-NNP,NNP-NNP,2,1
979,19897.0,39,said,15,11,1,-10,10,37,4,-14,Focus on the Family,James Dobson,ORGANIZATION-ORGANIZATION-ORGANIZATION-ORGANIZATION,PERSON-PERSON,PROPN-ADP-DET-PROPN,PROPN-PROPN,appos-prep-det-pobj,compound-nsubj,NNP-IN-DT-NNP,NNP-NNP,5,1
980,23558.0,21,declined,17,13,10,-3,12,10,4,-7,Focus on the Family,James Dobson,ORGANIZATION-ORGANIZATION-ORGANIZATION-ORGANIZATION,PERSON-PERSON,PROPN-ADP-DET-PROPN,PROPN-PROPN,pobj-prep-det-pobj,compound-poss,NNP-IN-DT-NNP,NNP-NNP,2,1
981,24028.0,36,Denver,0,3,8,5,2,27,-3,8,Focus on the Family,James Dobson,ORGANIZATION-ORGANIZATION-ORGANIZATION-ORGANIZATION,PERSON-PERSON,PROPN-ADP-DET-PROPN,PROPN-PROPN,nsubj-prep-det-compound,compound-poss,NNP-IN-DT-NNP,NNP-NNP,2,1
982,29361.0,38,provides,1,12,8,-4,11,29,-11,7,Focus on the Family,James Dobson,ORGANIZATION-ORGANIZATION-ORGANIZATION-ORGANIZATION,PERSON-PERSON,PROPN-ADP-DET-PROPN,PROPN-PROPN,appos-prep-det-compound,compound-pobj,NNP-IN-DT-NNP,NNP-NNP,2,1
983,35126.0,38,claimed,18,15,12,-3,14,25,3,-6,Focus on the Family,James Dobson,ORGANIZATION-ORGANIZATION-ORGANIZATION-ORGANIZATION,PERSON-PERSON,PROPN-ADP-DET-PROPN,PROPN-PROPN,pobj-prep-det-pobj,compound-conj,NNP-IN-DT-NNP,NNP-NNP,2,1
984,39119.0,46,went,5,15,12,-3,14,33,-10,7,Focus on the Family,James Dobson,ORGANIZATION-ORGANIZATION-ORGANIZATION-ORGANIZATION,PERSON-PERSON,PROPN-ADP-DET-PROPN,PROPN-PROPN,pobj-prep-det-pobj,compound-poss,NNP-IN-DT-NNP,NNP-NNP,2,1
985,39363.0,62,Gilder,0,41,37,-4,40,24,-41,37,Focus on the Family,James Dobson,ORGANIZATION-ORGANIZATION-ORGANIZATION-ORGANIZATION,PERSON-PERSON,PROPN-ADP-DET-PROPN,PROPN-PROPN,nsubj-prep-det-pobj,compound-conj,NNP-IN-DT-NNP,NNP-NNP,5,1
986,45211.0,35,got,8,24,19,-5,23,15,-16,11,Focus on the Family,James Dobson,ORGANIZATION-ORGANIZATION-ORGANIZATION-ORGANIZATION,PERSON-PERSON,PROPN-ADP-DET-PROPN,PROPN-PROPN,pobj-prep-det-pobj,compound-pobj,NNP-IN-DT-NNP,NNP-NNP,2,1
987,50307.0,32,said,12,4,1,-3,3,30,8,-11,Focus on the Family,James Dobson,ORGANIZATION-ORGANIZATION-ORGANIZATION-ORGANIZATION,PERSON-PERSON,PROPN-ADP-DET-PROPN,PROPN-PROPN,appos-prep-det-compound,compound-nsubj,NNP-IN-DT-NNP,NNP-NNP,2,1
988,62646.0,68,are,13,20,15,-5,19,52,-7,2,Focus on the Family,James Dobson,ORGANIZATION-ORGANIZATION-ORGANIZATION-ORGANIZATION,PERSON-PERSON,PROPN-ADP-DET-PROPN,PROPN-PROPN,pobj-prep-det-pobj,compound-nsubj,NNP-IN-DT-NNP,NNP-NNP,4,1
989,1647.0,19,has,11,11,11,0,10,7,0,0,Samsung Electronics,Samsung,ORGANIZATION-ORGANIZATION,ORGANIZATION,PROPN-PROPN,PROPN,compound-pobj,nsubj,NNP-NNP,NNP,0,1
990,1656.0,36,said,14,4,10,6,3,25,10,-4,Paul Watson,Sea Shepherd,PERSON-PERSON,ORGANIZATION-ORGANIZATION,PROPN-PROPN,PROPN-PROPN,compound-nsubj,compound-poss,NNP-NNP,NNP-NNP,4,1
991,6358.0,22,said,12,17,14,-3,16,7,-5,2,Paul Watson,Sea Shepherd,PERSON-PERSON,ORGANIZATION-ORGANIZATION,PROPN-PROPN,PROPN-PROPN,compound-nsubj,compound-compound,NNP-NNP,NNP-NNP,4,1
992,10743.0,38,said,27,29,21,-8,28,16,-2,-6,Paul Watson,Sea Shepherd,PERSON-PERSON,ORGANIZATION-ORGANIZATION,PROPN-PROPN,PROPN-PROPN,compound-nsubj,compound-poss,NNP-NNP,NNP-NNP,6,1
993,21067.0,33,said,5,4,1,-3,3,31,1,-4,Paul Watson,Sea Shepherd,PERSON-PERSON,ORGANIZATION-ORGANIZATION,PROPN-PROPN,PROPN-PROPN,compound-nsubj,compound-compound,NNP-NNP,NNP-NNP,2,1
994,21532.0,37,filed,5,19,14,-5,18,22,-14,9,Paul Watson,Sea Shepherd,PERSON-PERSON,ORGANIZATION-ORGANIZATION,PROPN-PROPN,PROPN-PROPN,compound-appos,compound-poss,NNP-NNP,NNP-NNP,2,1
995,29241.0,30,said,6,5,2,-3,4,27,1,-4,Paul Watson,Sea Shepherd,PERSON-PERSON,ORGANIZATION-ORGANIZATION,PROPN-PROPN,PROPN-PROPN,compound-nsubj,compound-compound,NNP-NNP,NNP-NNP,2,1
996,29852.0,24,sought,3,13,10,-3,12,13,-10,7,Paul Watson,Sea Shepherd,PERSON-PERSON,ORGANIZATION-ORGANIZATION,PROPN-PROPN,PROPN-PROPN,compound-dobj,compound-compound,NNP-NNP,NNP-NNP,2,1
997,40851.0,39,told,5,4,1,-3,3,37,1,-4,Paul Watson,Sea Shepherd,PERSON-PERSON,ORGANIZATION-ORGANIZATION,PROPN-PROPN,PROPN-ADJ,compound-nsubj,compound-compound,NNP-NNP,NNP-JJ,2,1
998,47559.0,20,said,6,5,2,-3,4,17,1,-4,Paul Watson,Sea Shepherd,PERSON-PERSON,ORGANIZATION-ORGANIZATION,PROPN-PROPN,PROPN-PROPN,compound-nsubj,compound-compound,NNP-NNP,NNP-NNP,2,1
999,48312.0,32,said,5,4,1,-3,3,30,1,-4,Paul Watson,Sea Shepherd,PERSON-PERSON,ORGANIZATION-ORGANIZATION,PROPN-PROPN,PROPN-PROPN,compound-nsubj,compound-compound,NNP-NNP,NNP-NNP,2,1
1000,55994.0,34,heal,1,9,12,3,8,21,-8,11,Paul Watson,Sea Shepherd,PERSON-PERSON,ORGANIZATION-ORGANIZATION,PROPN-PROPN,PROPN-PROPN,compound-appos,compound-pobj,NNP-NNP,NNP-NNP,2,1
1001,64191.0,48,UTC,5,45,8,-37,44,39,-40,3,Paul Watson,Sea Shepherd,PERSON-PERSON,ORGANIZATION-ORGANIZATION,PROPN-PROPN,PROPN-PROPN,compound-nsubj,compound-compound,NNP-NNP,NNP-NNP,15,1
1002,65911.0,29,told,15,14,11,-3,13,17,1,-4,Paul Watson,Sea Shepherd,PERSON-PERSON,ORGANIZATION-ORGANIZATION,PROPN-PROPN,PROPN-PROPN,compound-nsubj,compound-compound,NNP-NNP,NNP-NNP,4,1
1003,1658.0,39,died,28,1,11,10,0,27,27,-17,Bradford Washburn,director,PERSON-PERSON,TITLE,PROPN-PROPN,NOUN,compound-nsubj,pobj,NNP-NNP,NN,4,1
1004,4777.0,43,shows,27,8,21,13,7,21,19,-6,Bradford Washburn,director,PERSON-PERSON,TITLE,PROPN-PROPN,NOUN,compound-nsubj,attr,NNP-NNP,NN,5,1
1005,9583.0,38,died,28,1,11,10,0,26,27,-17,Bradford Washburn,director,PERSON-PERSON,TITLE,PROPN-PROPN,NOUN,compound-nsubj,pobj,NNP-NNP,NN,4,1
1006,19026.0,28,died,26,1,11,10,0,16,25,-15,Bradford Washburn,director,PERSON-PERSON,TITLE,PROPN-PROPN,NOUN,compound-nsubj,pobj,NNP-NNP,NN,3,1
1007,1669.0,19,said,17,13,16,3,12,2,4,-1,bankers association,Bruce Spitzer,ORGANIZATION-ORGANIZATION,PERSON-PERSON,NOUN-NOUN,PROPN-PROPN,compound-compound,compound-nsubj,NNS-NN,NNP-NNP,4,1
1008,1670.0,41,said,19,3,9,6,2,31,16,-10,Abdul Karim al-Khawinay,journalist,PERSON-PERSON-PERSON,TITLE,PROPN-PROPN-PROPN,NOUN,compound-compound-nsubj,nsubj,NNP-NNP-NNP,NN,4,1
1009,1673.0,44,arrives,5,4,43,39,3,0,1,38,Frankie Delgado,California,PERSON-PERSON,STATE_OR_PROVINCE,PROPN-PROPN,PROPN,compound-nsubj,appos,NNP-NNP,NNP,-1,1
1010,1676.0,46,disputed,25,3,19,16,2,26,22,-6,Red Sox,Theo Epstein,ORGANIZATION-ORGANIZATION,PERSON-PERSON,PROPN-PROPN,PROPN-PROPN,compound-nsubj,compound-conj,NNP-NNPS,NNP-NNP,5,1
1011,10881.0,57,was,23,39,42,3,38,14,-16,19,Red Sox,Theo Epstein,ORGANIZATION-ORGANIZATION,PERSON-PERSON,PROPN-PROPN,PROPN-PROPN,compound-poss,compound-pobj,NNP-NNPS,NNP-NNP,3,1
1012,24378.0,50,broken,28,6,18,12,5,31,22,-10,Red Sox,Theo Epstein,ORGANIZATION-ORGANIZATION,PERSON-PERSON,PROPN-PROPN,PROPN-PROPN,compound-nsubj,compound-conj,NNP-NNPS,NNP-NNP,5,1
1013,37968.0,61,wrote,22,18,14,-4,17,46,4,-8,Red Sox,Theo Epstein,ORGANIZATION-ORGANIZATION,PERSON-PERSON,PROPN-PROPN,PROPN-PROPN,nmod-nmod,compound-conj,NNP-NNP,NNP-NNP,4,1
1014,1689.0,49,plans,9,43,1,-42,42,47,-34,-8,Convocation of Anglicans in North America,Archbishop Peter Akinola,ORGANIZATION-ORGANIZATION-ORGANIZATION-ORGANIZATION-ORGANIZATION-ORGANIZATION,PERSON-PERSON-PERSON,PROPN-ADP-PROPN-ADP-PROPN-PROPN,PROPN-PROPN-PROPN,pobj-prep-pobj-prep-compound-pobj,compound-compound-nsubj,NNP-IN-NNPS-IN-NNP-NNP,NNP-NNP-NNP,16,1
1015,1693.0,29,said,27,12,11,-1,11,17,15,-16,Ospel,Marcel Ospel,PERSON,PERSON-PERSON,PROPN,PROPN-PROPN,compound,compound-poss,NNP,NNP-NNP,1,1
1016,1701.0,22,been,2,11,19,8,10,2,-9,17,ABA,Major League Baseball,ORGANIZATION,ORGANIZATION-ORGANIZATION-ORGANIZATION,NOUN,PROPN-PROPN-PROPN,pobj,compound-compound-conj,NN,NNP-NNP-NNP,4,1
1017,1705.0,8,ITOCHU,0,1,8,7,0,-1,-1,8,ITOCHU,HEILONGJIANG,ORGANIZATION,LOCATION,PROPN,NOUN,ROOT,pobj,NNP,NN,-1,1
1018,1706.0,31,fell,15,1,7,6,0,23,14,-8,ConAgra Foods,Hebrew National,ORGANIZATION-ORGANIZATION,ORGANIZATION-ORGANIZATION,PROPN-PROPN,PROPN-PROPN,compound-compound,amod-nmod,NNP-NNP,NNP-NNP,5,1
1019,1707.0,40,LUMPUR,1,35,28,-7,34,11,-34,27,Bernama,Malaysia,ORGANIZATION,COUNTRY,PROPN,PROPN,appos,pobj,NNP,NNP,6,1
1020,14730.0,31,marked,6,6,1,-5,5,29,0,-5,Bernama,Malaysia,ORGANIZATION,COUNTRY,PROPN,PROPN,appos,poss,NNP,NNP,3,1
1021,27996.0,46,said,1,45,40,-5,44,5,-44,39,Bernama,Malaysia,ORGANIZATION,COUNTRY,PROPN,PROPN,appos,poss,NNP,NNP,5,1
1022,29851.0,34,CYBERJAYA,0,6,13,7,5,20,-6,13,Bernama,Malaysia,ORGANIZATION,COUNTRY,PROPN,PROPN,compound,nsubj,NNP,NNP,2,1
1023,35570.0,34,took,9,7,2,-5,6,31,2,-7,Bernama,Malaysia,ORGANIZATION,COUNTRY,PROPN,PROPN,compound,nmod,NNP,NNP,-1,1
1024,41004.0,25,reported,22,22,18,-4,21,6,0,-4,Bernama,Malaysia,ORGANIZATION,COUNTRY,PROPN,PROPN,appos,poss,NNP,NNP,3,1
1025,47000.0,56,quoted,38,38,33,-5,37,22,0,-5,Bernama,Malaysia,ORGANIZATION,COUNTRY,PROPN,PROPN,appos,poss,NNP,NNP,3,1
1026,54301.0,22,reported,18,18,1,-17,17,20,0,-17,Bernama,Malaysia,ORGANIZATION,COUNTRY,PROPN,PROPN,appos,nsubj,NNP,NNP,3,1
1027,1710.0,25,PITTSBURGH,0,6,2,-4,5,22,-6,2,USW,2007-04-13,ORGANIZATION,DATE,PROPN,NUM,nsubj,nummod,NNP,CD,4,1
1028,1718.0,39,said,32,16,34,18,15,4,16,2,Aerolineas Argentinas,Argentina,ORGANIZATION-ORGANIZATION,COUNTRY,PROPN-PROPN,PROPN,compound-compound,poss,NNP-NNP,NNP,7,1
1029,9372.0,11,moves,1,5,1,-4,4,9,-4,0,Aerolineas Argentinas,Argentina,ORGANIZATION-ORGANIZATION,COUNTRY,PROPN-PROPN,PROPN,compound-dobj,nsubj,NNP-NNP,NNP,2,1
1030,15006.0,14,operate,4,1,10,9,0,3,3,6,Aerolineas Argentinas,Argentina,ORGANIZATION-ORGANIZATION,COUNTRY,PROPN-PROPN,PROPN,compound-nsubj,poss,NNP-NNP,NNP,6,1
1031,17825.0,17,given,4,15,1,-14,14,15,-11,-3,Aerolineas Argentinas,Argentina,ORGANIZATION-ORGANIZATION,COUNTRY,PROPN-PROPN,PROPN,compound-pobj,poss,NNP-NNP,NNP,8,1
1032,26367.0,29,cancelled,8,6,1,-5,5,27,2,-7,Aerolineas Argentinas,Argentina,ORGANIZATION-ORGANIZATION,COUNTRY,PROPN-PROPN,PROPN,compound-appos,poss,NNP-NNP,NNP,3,1
1033,30848.0,29,announced,3,14,1,-13,13,27,-11,-2,Aerolineas Argentinas,Argentina,ORGANIZATION-ORGANIZATION,COUNTRY,PROPN-PROPN,PROPN,compound-appos,nsubj,NNP-NNP,NNP,6,1
1034,34522.0,27,approved,3,8,1,-7,7,25,-5,-2,Aerolineas Argentinas,Argentina,ORGANIZATION-ORGANIZATION,COUNTRY,PROPN-PROPN,PROPN,compound-pobj,poss,NNP-NNP,NNP,6,1
1035,46183.0,29,Delays,0,9,5,-4,8,23,-9,5,Aerolineas Argentinas,Argentina,ORGANIZATION-ORGANIZATION,COUNTRY,PROPN-PROPN,PROPN,compound-compound,poss,NNP-NNP,NNP,3,1
1036,64893.0,16,account,6,3,15,12,2,0,3,9,Aerolineas Argentinas,Argentina,ORGANIZATION-ORGANIZATION,COUNTRY,PROPN-PROPN,PROPN,compound-nsubj,pobj,NNP-NNP,NNP,2,1
1037,1721.0,35,said,33,32,1,-31,31,33,1,-32,Bryan Baldwin,JetBlue,PERSON-PERSON,ORGANIZATION,PROPN-PROPN,PROPN,compound-nsubj,nsubj,NNP-NNP,NNP,3,1
1038,7889.0,35,said,33,32,9,-23,31,25,1,-24,Bryan Baldwin,JetBlue,PERSON-PERSON,ORGANIZATION,PROPN-PROPN,PROPN,compound-nsubj,poss,NNP-NNP,NNP,-1,1
1039,8477.0,37,said,28,30,36,6,29,0,-2,8,Bryan Baldwin,JetBlue,PERSON-PERSON,ORGANIZATION,PROPN-PROPN,PROPN,compound-nsubj,pobj,NNP-NNP,NNP,4,1
1040,14488.0,41,said,4,3,1,-2,2,39,1,-3,Bryan Baldwin,JetBlue,PERSON-PERSON,ORGANIZATION,PROPN-PROPN,PROPN,compound-nsubj,compound,NNP-NNP,NNP,1,1
1041,15834.0,33,wrote,27,21,25,4,20,7,6,-2,Bryan Baldwin,JetBlue,PERSON-PERSON,ORGANIZATION,PROPN-PROPN,PROPN,compound-nsubj,compound,NNP-NNP,NNP,3,1
1042,16286.0,31,said,29,28,5,-23,27,25,1,-24,Bryan Baldwin,JetBlue,PERSON-PERSON,ORGANIZATION,PROPN-PROPN,PROPN,compound-nsubj,compound,NNP-NNP,NNP,-1,1
1043,17293.0,22,said,4,3,1,-2,2,20,1,-3,Bryan Baldwin,JetBlue,PERSON-PERSON,ORGANIZATION,PROPN-PROPN,PROPN,compound-nsubj,compound,NNP-NNP,NNP,1,1
1044,17608.0,16,said,10,14,12,-2,13,3,-4,2,Bryan Baldwin,JetBlue,PERSON-PERSON,ORGANIZATION,PROPN-PROPN,PROPN,compound-nsubj,compound,NNP-NNP,NNP,1,1
1045,18475.0,31,said,29,28,5,-23,27,25,1,-24,Bryan Baldwin,JetBlue,PERSON-PERSON,ORGANIZATION,PROPN-PROPN,PROPN,compound-nsubj,poss,NNP-NNP,NNP,-1,1
1046,19845.0,27,said,21,25,23,-2,24,3,-4,2,Bryan Baldwin,JetBlue,PERSON-PERSON,ORGANIZATION,PROPN-PROPN,PROPN,compound-nsubj,compound,NNP-NNP,NNP,1,1
1047,29900.0,22,said,14,1,7,6,0,14,13,-7,Bryan Baldwin,JetBlue,PERSON-PERSON,ORGANIZATION,PROPN-PROPN,PROPN,compound-nsubj,pobj,NNP-NNP,NNP,4,1
1048,34507.0,31,said,4,3,1,-2,2,29,1,-3,Bryan Baldwin,JetBlue,PERSON-PERSON,ORGANIZATION,PROPN-PROPN,PROPN,compound-nsubj,compound,NNP-NNP,NNP,1,1
1049,45941.0,33,said,7,1,5,4,0,27,6,-2,Bryan Baldwin,JetBlue,PERSON-PERSON,ORGANIZATION,PROPN-PROPN,PROPN,compound-nsubj,compound,NNP-NNP,NNP,1,1
1050,48029.0,22,said,4,3,1,-2,2,20,1,-3,Bryan Baldwin,JetBlue,PERSON-PERSON,ORGANIZATION,PROPN-PROPN,PROPN,compound-nsubj,compound,NNP-NNP,NNP,1,1
1051,56296.0,32,said,5,7,11,4,6,20,-2,6,Bryan Baldwin,JetBlue,PERSON-PERSON,ORGANIZATION,PROPN-PROPN,PROPN,compound-nsubj,compound,NNP-NNP,NNP,3,1
1052,1723.0,40,told,33,21,15,-6,20,24,12,-18,Army Medical Command,Kevin Kiley,ORGANIZATION-ORGANIZATION-ORGANIZATION,PERSON-PERSON,PROPN-PROPN-PROPN,PROPN-PROPN,compound-compound-pobj,compound-nsubj,NNP-NNP-NNP,NNP-NNP,4,1
1053,58273.0,40,told,33,21,15,-6,20,24,12,-18,Army Medical Command,Kevin Kiley,ORGANIZATION-ORGANIZATION-ORGANIZATION,PERSON-PERSON,PROPN-PROPN-PROPN,PROPN-PROPN,compound-compound-pobj,compound-nsubj,NNP-NNP-NNP,NNP-NNP,5,1
1054,1735.0,34,said,6,5,3,-2,4,30,1,-3,John Negroponte,spy chief,PERSON-PERSON,TITLE-TITLE,PROPN-PROPN,NOUN-NOUN,compound-nsubj,compound-compound,NNP-NNP,NN-NN,1,1
1055,1737.0,34,became,26,1,8,7,0,25,25,-18,He,MSNBC,PERSON,ORGANIZATION,PRON,PROPN,nsubj,pobj,PRP,NNP,1,1
1056,1739.0,17,shares,13,6,10,4,5,6,7,-3,American Bar Association,H. Thomas Wells,ORGANIZATION-ORGANIZATION-ORGANIZATION,PERSON-PERSON-PERSON,PROPN-PROPN-PROPN,PROPN-PROPN-PROPN,compound-compound-pobj,compound-compound-appos,NNP-NNP-NNP,NNP-NNP-NNP,5,1
1057,1740.0,30,noted,2,16,5,-11,15,24,-14,3,Murat Kurnaz,Germany,PERSON-PERSON,COUNTRY,PROPN-PROPN,PROPN,compound-appos,pobj,NNP-NNP,NNP,1,1
1058,3013.0,28,took,4,9,1,-8,8,26,-5,-3,Murat Kurnaz,Germany,PERSON-PERSON,COUNTRY,PROPN-PROPN,PROPN,compound-dobj,nsubj,NNP-NNP,NNP,3,1
1059,4790.0,46,said,2,28,36,8,27,9,-26,34,Murat Kurnaz,Germany,PERSON-PERSON,COUNTRY,PROPN-PROPN,PROPN,compound-dobj,pobj,NNP-NNP,NNP,4,1
1060,18228.0,53,held,14,1,12,11,0,40,13,-2,Murat Kurnaz,Germany,PERSON-PERSON,COUNTRY,PROPN-PROPN,PROPN,compound-compound,compound,NNP-NNP,NNP,2,1
1061,41918.0,31,recounted,17,16,7,-9,15,23,1,-10,Murat Kurnaz,Germany,PERSON-PERSON,COUNTRY,PROPN-PROPN,PROPN,compound-nsubj,pobj,NNP-NNP,NNP,4,1
1062,46233.0,58,is,1,23,21,-2,22,36,-22,20,Murat Kurnaz,Germany,PERSON-PERSON,COUNTRY,PROPN-PROPN,PROPN,compound-pobj,pobj,NNP-NNP,NNP,1,1
1063,65709.0,35,arrested,12,1,10,9,0,24,11,-2,Murat Kurnaz,Germany,PERSON-PERSON,COUNTRY,PROPN-PROPN,PROPN,compound-nsubjpass,pobj,NNP-NNP,NNP,2,1
1064,1746.0,37,said,34,29,24,-5,28,12,5,-10,Mohamed ElBaradei,International Atomic Energy Agency,PERSON-PERSON,ORGANIZATION-ORGANIZATION-ORGANIZATION-ORGANIZATION,PROPN-PROPN,PROPN-PROPN-PROPN-PROPN,compound-pobj,compound-compound-compound-compound,NNP-NNP,NNP-NNP-NNP-NNP,4,1
1065,25668.0,47,told,6,23,17,-6,22,29,-17,11,Mohamed ElBaradei,International Atomic Energy Agency,PERSON-PERSON,ORGANIZATION-ORGANIZATION-ORGANIZATION-ORGANIZATION,PROPN-PROPN,PROPN-PROPN-PROPN-PROPN,compound-nsubj,compound-compound-compound-dobj,NNP-NNP,NNP-NNP-NNP-NNP,-1,1
1066,34014.0,34,told,14,1,7,6,0,26,13,-7,Mohamed ElBaradei,International Atomic Energy Agency,PERSON-PERSON,ORGANIZATION-ORGANIZATION-ORGANIZATION-ORGANIZATION,PROPN-PROPN,PROPN-PROPN-PROPN-PROPN,compound-nsubj,compound-compound-compound-pobj,NNP-NNP,NNP-NNP-NNP-NNP,5,1
1067,36546.0,35,General,1,12,5,-7,11,29,-11,4,Mohamed ElBaradei,International Atomic Energy Agency,PERSON-PERSON,ORGANIZATION-ORGANIZATION-ORGANIZATION-ORGANIZATION,PROPN-PROPN,PROPN-PROPN-PROPN-PROPN,compound-nsubj,compound-compound-compound-pobj,NNP-NNP,NNP-NNP-NNP-NNP,5,1
1068,39343.0,32,said,29,25,5,-20,24,26,4,-24,Mohamed ElBaradei,International Atomic Energy Agency,PERSON-PERSON,ORGANIZATION-ORGANIZATION-ORGANIZATION-ORGANIZATION,PROPN-PROPN,PROPN-PROPN-PROPN-PROPN,compound-pobj,compound-compound-compound-conj,NNP-NNP,NNP-NNP-NNP-NNP,11,1
1069,39424.0,38,hold,8,21,16,-5,20,21,-13,8,Mohamed ElBaradei,International Atomic Energy Agency,PERSON-PERSON,ORGANIZATION-ORGANIZATION-ORGANIZATION-ORGANIZATION,PROPN-PROPN,PROPN-PROPN-PROPN-PROPN,compound-pobj,compound-compound-compound-compound,NNP-NNP,NNP-NNP-NNP-NNP,4,1
1070,43319.0,40,told,27,26,21,-5,25,18,1,-6,Mohamed ElBaradei,International Atomic Energy Agency,PERSON-PERSON,ORGANIZATION-ORGANIZATION-ORGANIZATION-ORGANIZATION,PROPN-PROPN,PROPN-PROPN-PROPN-PROPN,compound-nsubj,compound-compound-compound-compound,NNP-NNP,NNP-NNP-NNP-NNP,5,1
1071,44746.0,35,said,33,16,10,-6,15,24,17,-23,Mohamed ElBaradei,International Atomic Energy Agency,PERSON-PERSON,ORGANIZATION-ORGANIZATION-ORGANIZATION-ORGANIZATION,PROPN-PROPN,PROPN-PROPN-PROPN-PROPN,compound-nsubj,compound-compound-compound-compound,NNP-NNP,NNP-NNP-NNP-NNP,5,1
1072,48340.0,39,said,4,11,6,-5,10,32,-7,2,Mohamed ElBaradei,International Atomic Energy Agency,PERSON-PERSON,ORGANIZATION-ORGANIZATION-ORGANIZATION-ORGANIZATION,PROPN-PROPN,PROPN-PROPN-PROPN-PROPN,compound-nsubj,compound-compound-compound-compound,NNP-NNP,NNP-NNP-NNP-NNP,4,1
1073,52920.0,30,was,2,11,26,15,10,3,-9,24,Mohamed ElBaradei,International Atomic Energy Agency,PERSON-PERSON,ORGANIZATION-ORGANIZATION-ORGANIZATION-ORGANIZATION,PROPN-PROPN,PROPN-PROPN-PROPN-PROPN,compound-pobj,compound-compound-compound-appos,NNP-NNP,NNP-NNP-NNP-NNP,3,1
1074,66546.0,37,GayandRight,0,9,4,-5,8,32,-9,4,Mohamed ElBaradei,International Atomic Energy Agency,PERSON-PERSON,ORGANIZATION-ORGANIZATION-ORGANIZATION-ORGANIZATION,PROPN-PROPN,PROPN-PROPN-PROPN-PROPN,compound-nsubj,compound-compound-compound-compound,NNP-NNP,NNP-NNP-NNP-NNP,6,1
1075,67713.0,50,given,15,12,5,-7,11,44,3,-10,Mohamed ElBaradei,International Atomic Energy Agency,PERSON-PERSON,ORGANIZATION-ORGANIZATION-ORGANIZATION-ORGANIZATION,PROPN-PROPN,PROPN-PROPN-PROPN-PROPN,compound-appos,compound-compound-compound-poss,NNP-NNP,NNP-NNP-NNP-NNP,4,1
1076,1748.0,35,is,2,1,20,19,0,14,1,18,Alexandra Burke,British,PERSON-PERSON,COUNTRY,PROPN-PROPN,ADJ,compound-nsubj,amod,NNP-NNP,JJ,6,1
1077,2331.0,32,won,2,1,9,8,0,22,1,7,Alexandra Burke,British,PERSON-PERSON,NATIONALITY,PROPN-PROPN,ADJ,compound-nsubj,amod,NNP-NNP,JJ,6,1
1078,13673.0,42,made,5,3,1,-2,2,40,2,-4,Alexandra Burke,British,PERSON-PERSON,NATIONALITY,PROPN-PROPN,ADJ,compound-nsubj,amod,NNP-NNP,JJ,1,1
1079,20249.0,30,working,9,14,12,-2,13,17,-5,3,Alexandra Burke,British,PERSON-PERSON,NATIONALITY,PROPN-PROPN,ADJ,compound-pobj,amod,NNP-NNP,JJ,3,1
1080,28140.0,32,mokhal,0,4,2,-2,3,29,-4,2,Alexandra Burke,British,PERSON-PERSON,NATIONALITY,PROPN-PROPN,ADJ,compound-nsubj,amod,NNP-NNP,JJ,1,1
1081,29351.0,29,release,5,3,1,-2,2,27,2,-4,Alexandra Burke,British,PERSON-PERSON,NATIONALITY,PROPN-PROPN,ADJ,compound-nsubj,amod,NNP-NNP,JJ,1,1
1082,58716.0,32,Biff,4,15,13,-2,14,18,-11,9,Alexandra Burke,British,PERSON-PERSON,NATIONALITY,PROPN-PROPN,ADJ,compound-pobj,amod,NNP-NNP,JJ,3,1
1083,67872.0,31,2009-08-04T01,0,14,12,-2,13,18,-14,12,Alexandra Burke,British,PERSON-PERSON,NATIONALITY,PROPN-PROPN,ADJ,compound-nsubj,amod,NNP-NNP,JJ,1,1
1084,1764.0,42,suspended,40,23,10,-13,22,31,17,-30,his,Minister,PERSON,TITLE,DET,PROPN,poss,compound,PRP$,NNP,4,1
1085,5534.0,49,DAMASCUS,0,30,43,13,29,5,-30,43,his,Minister,PERSON,TITLE,DET,PROPN,poss,compound,PRP$,NNP,11,1
1086,29170.0,46,DAMASCUS,0,29,42,13,28,3,-29,42,his,Minister,PERSON,TITLE,DET,PROPN,poss,compound,PRP$,NNP,12,1
1087,63261.0,15,said,6,9,4,-5,8,10,-3,-2,his,Minister,PERSON,TITLE,DET,PROPN,poss,compound,PRP$,NNP,5,1
1088,1777.0,45,JOHANNESBURG,0,43,35,-8,42,9,-43,35,Scorpions,DSO,ORGANIZATION,ORGANIZATION,PROPN,PROPN,pobj,compound,NNPS,NNP,2,1
1089,19359.0,49,Release,2,18,16,-2,17,32,-16,14,Scorpions,DSO,ORGANIZATION,ORGANIZATION,PROPN,PROPN,compound,compound,NNPS,NNP,9,1
1090,47382.0,42,launched,8,6,2,-4,5,39,2,-6,Scorpions,DSO,ORGANIZATION,ORGANIZATION,PROPN,PROPN,oprd,nsubjpass,NNPS,NNP,3,1
1091,1778.0,17,presided,2,1,8,7,0,8,1,6,He,Constitutional Council,PERSON,ORGANIZATION-ORGANIZATION,PRON,PROPN-PROPN,nsubj,compound-pobj,PRP,NNP-NNP,3,1
1092,1779.0,31,said,7,6,2,-4,5,28,1,-5,Manuel Barcena,police chief,PERSON-PERSON,TITLE-TITLE,PROPN-PROPN,NOUN-NOUN,compound-nsubj,compound-compound,NNP-NNP,NN-NN,1,1
1093,14264.0,25,said,15,23,18,-5,22,6,-8,3,Manuel Barcena,police chief,PERSON-PERSON,TITLE-TITLE,PROPN-PROPN,NOUN-NOUN,compound-appos,compound-nsubj,NNP-NNP,NN-NN,3,1
1094,15698.0,33,said,13,3,6,3,2,26,10,-7,Manuel Barcena,police chief,PERSON-PERSON,TITLE-TITLE,PROPN-PROPN,NOUN-NOUN,compound-nsubj,compound-appos,NNP-NNP,NN-NN,1,1
1095,24682.0,36,declined,10,3,8,5,2,27,7,-2,Manuel Barcena,police chief,PERSON-PERSON,TITLE-TITLE,PROPN-PROPN,NOUN-NOUN,compound-nsubj,compound-appos,NNP-NNP,NN-NN,1,1
1096,41645.0,29,said,27,26,22,-4,25,6,1,-5,Manuel Barcena,police chief,PERSON-PERSON,TITLE-TITLE,PROPN-PROPN,NOUN-NOUN,compound-nsubj,compound-compound,NNP-NNP,NN-NN,1,1
1097,1787.0,40,said,20,29,22,-7,28,17,-9,2,New Hampshire Institute of Politics,"Paul Manuel , executive director",ORGANIZATION-ORGANIZATION-ORGANIZATION-ORGANIZATION-ORGANIZATION,PERSON-PERSON-PERSON-PERSON-PERSON,PROPN-PROPN-PROPN-ADP-PROPN,PROPN-PROPN-PUNCT-ADJ-NOUN,compound-compound-pobj-prep-pobj,compound-nsubj-punct-amod-appos,NNP-NNP-NNP-IN-NNP,"NNP-NNP-,-JJ-NN",6,1
1098,1788.0,52,is,17,26,25,-1,25,26,-9,8,John F. Kerry,Senator,PERSON-PERSON-PERSON,TITLE,PROPN-PROPN-PROPN,PROPN,compound-compound-poss,compound,NNP-NNP-NNP,NNP,2,1
1099,1797.0,32,ruled,6,28,1,-27,27,30,-22,-5,Raul Castro,Fidel Castro,PERSON-PERSON,PERSON-PERSON,PROPN-PROPN,PROPN-PROPN,compound-appos,compound-nsubj,NNP-NNP,NNP-NNP,6,1
1100,6186.0,27,brought,15,12,6,-6,11,20,3,-9,Raul Castro,Fidel Castro,PERSON-PERSON,PERSON-PERSON,PROPN-PROPN,PROPN-PROPN,compound-pobj,compound-poss,NNP-NNP,NNP-NNP,5,1
1101,22607.0,33,Urgent,0,3,31,28,2,1,-3,31,Raul Castro,Fidel Castro,PERSON-PERSON,PERSON-PERSON,PROPN-PROPN,PROPN-PROPN,compound-compound,compound-appos,NNP-NNP,NNP-NNP,-1,1
1102,23890.0,33,elected,6,4,16,12,3,16,2,10,Raul Castro,Fidel Castro,PERSON-PERSON,PERSON-PERSON,PROPN-PROPN,PROPN-PROPN,compound-nsubjpass,compound-appos,NNP-NNP,NNP-NNP,4,1
1103,60349.0,24,told,15,14,4,-10,13,19,1,-11,Raul Castro,Fidel Castro,PERSON-PERSON,PERSON-PERSON,PROPN-PROPN,PROPN-PROPN,compound-appos,compound-nsubj,NNP-NNP,NNP-NNP,4,1
1104,1799.0,30,nominated,11,1,1,0,0,28,10,-10,Remy Ma,Remy Smith,PERSON-PERSON,PERSON-PERSON,PROPN-PROPN,PROPN-PROPN,compound-nsubjpass,compound-attr,NNP-NNP,NNP-NNP,0,1
1105,3146.0,31,Ma,1,1,1,0,0,29,0,0,Remy Ma,Remy Smith,PERSON-PERSON,PERSON-PERSON,PROPN-PROPN,PROPN-PROPN,compound-ROOT,compound-attr,NNP-NNP,NNP-NNP,0,1
1106,5317.0,21,charged,11,1,1,0,0,19,10,-10,Remy Ma,Remy Smith,PERSON-PERSON,PERSON-PERSON,PROPN-PROPN,PROPN-PROPN,compound-nsubjpass,compound-attr,NNP-NNP,NNP-NNP,0,1
1107,16466.0,35,said,6,8,8,0,7,26,-2,2,Remy Ma,Remy Smith,PERSON-PERSON,PERSON-PERSON,PROPN-PROPN,PROPN-PROPN,compound-nsubj,compound-attr,NNP-NNP,NNP-NNP,0,1
1108,17624.0,21,charged,14,2,2,0,1,18,12,-12,Remy Ma,Remy Smith,PERSON-PERSON,PERSON-PERSON,PROPN-PROPN,PROPN-PROPN,compound-nsubjpass,compound-attr,NNP-NNP,NNP-NNP,0,1
1109,36054.0,33,said,1,7,7,0,6,25,-6,6,Remy Ma,Remy Smith,PERSON-PERSON,PERSON-PERSON,PROPN-PROPN,PROPN-PROPN,compound-nsubj,compound-attr,NNP-NNP,NNP-NNP,0,1
1110,56354.0,35,convicted,11,1,1,0,0,33,10,-10,Remy Ma,Remy Smith,PERSON-PERSON,PERSON-PERSON,PROPN-PROPN,PROPN-PROPN,compound-nsubjpass,compound-attr,NNP-NNP,NNP-NNP,0,1
1111,59814.0,26,faces,10,1,1,0,0,24,9,-9,Remy Ma,Remy Smith,PERSON-PERSON,PERSON-PERSON,PROPN-PROPN,PROPN-PROPN,compound-nsubj,compound-attr,NNP-NNP,NNP-NNP,0,1
1112,1809.0,46,stated,1,11,1,-10,10,44,-10,0,AMA,She,ORGANIZATION,PERSON,PROPN,PRON,poss,nsubj,NNP,PRP,4,1
1113,1811.0,10,married,4,1,3,2,0,6,3,-1,Jeremy,Andrew,PERSON,PERSON,PROPN,PROPN,nsubj,conj,NNP,NNP,3,1
1114,1818.0,43,is,6,19,26,7,18,16,-13,20,Kennedy Space Center,Florida,ORGANIZATION-ORGANIZATION-ORGANIZATION,STATE_OR_PROVINCE,PROPN-PROPN-PROPN,PROPN,compound-compound-pobj,appos,NNP-NNP-NNP,NNP,2,1
1115,2878.0,24,said,7,19,23,4,18,0,-12,16,Kennedy Space Center,Florida,ORGANIZATION-ORGANIZATION-ORGANIZATION,STATE_OR_PROVINCE,PROPN-PROPN-PROPN,PROPN,compound-compound-pobj,pobj,NNP-NNP-NNP,NNP,3,1
1116,5884.0,16,lifts,1,8,12,4,7,3,-7,11,Kennedy Space Center,Florida,ORGANIZATION-ORGANIZATION-ORGANIZATION,STATE_OR_PROVINCE,PROPN-PROPN-PROPN,PROPN,compound-compound-pobj,pobj,NNP-NNP-NNP,NNP,4,1
1117,8429.0,27,affected,9,19,26,7,18,0,-10,17,Kennedy Space Center,Florida,ORGANIZATION-ORGANIZATION-ORGANIZATION,STATE_OR_PROVINCE,PROPN-PROPN-PROPN,PROPN,compound-compound-pobj,appos,NNP-NNP-NNP,NNP,6,1
1118,8545.0,23,lifts,1,8,12,4,7,10,-7,11,Kennedy Space Center,Florida,ORGANIZATION-ORGANIZATION-ORGANIZATION,STATE_OR_PROVINCE,PROPN-PROPN-PROPN,PROPN,compound-compound-pobj,pobj,NNP-NNP-NNP,NNP,4,1
1119,10192.0,12,reach,3,5,9,4,4,2,-2,6,Kennedy Space Center,Florida,ORGANIZATION-ORGANIZATION-ORGANIZATION,STATE_OR_PROVINCE,PROPN-PROPN-PROPN,PROPN,compound-compound-dobj,pobj,NNP-NNP-NNP,NNP,3,1
1120,11070.0,39,are,5,27,31,4,26,7,-22,26,Kennedy Space Center,Florida,ORGANIZATION-ORGANIZATION-ORGANIZATION,STATE_OR_PROVINCE,PROPN-PROPN-PROPN,PROPN,compound-compound-pobj,pobj,NNP-NNP-NNP,NNP,4,1
1121,15209.0,29,landed,2,15,19,4,14,9,-13,17,Kennedy Space Center,Florida,ORGANIZATION-ORGANIZATION-ORGANIZATION,STATE_OR_PROVINCE,PROPN-PROPN-PROPN,PROPN,compound-compound-pobj,pobj,NNP-NNP-NNP,NNP,4,1
1122,15285.0,29,aim,4,12,16,4,11,12,-8,12,Kennedy Space Center,Florida,ORGANIZATION-ORGANIZATION-ORGANIZATION,STATE_OR_PROVINCE,PROPN-PROPN-PROPN,PROPN,compound-compound-pobj,pobj,NNP-NNP-NNP,NNP,6,1
1123,19919.0,33,prevented,26,20,24,4,19,8,6,-2,Kennedy Space Center,Florida,ORGANIZATION-ORGANIZATION-ORGANIZATION,STATE_OR_PROVINCE,PROPN-PROPN-PROPN,PROPN,compound-compound-pobj,pobj,NNP-NNP-NNP,NNP,8,1
1124,23052.0,44,scheduled,21,32,36,4,31,7,-11,15,Kennedy Space Center,Florida,ORGANIZATION-ORGANIZATION-ORGANIZATION,STATE_OR_PROVINCE,PROPN-PROPN-PROPN,PROPN,compound-compound-pobj,pobj,NNP-NNP-NNP,NNP,6,1
1125,24089.0,50,suffered,11,44,48,4,43,1,-33,37,Kennedy Space Center,Florida,ORGANIZATION-ORGANIZATION-ORGANIZATION,STATE_OR_PROVINCE,PROPN-PROPN-PROPN,PROPN,compound-compound-pobj,pobj,NNP-NNP-NNP,NNP,4,1
1126,24241.0,42,rocket,3,37,41,4,36,0,-34,38,Kennedy Space Center,Florida,ORGANIZATION-ORGANIZATION-ORGANIZATION,STATE_OR_PROVINCE,PROPN-PROPN-PROPN,PROPN,compound-compound-pobj,pobj,NNP-NNP-NNP,NNP,4,1
1127,24749.0,32,arrive,11,15,19,4,14,12,-4,8,Kennedy Space Center,Florida,ORGANIZATION-ORGANIZATION-ORGANIZATION,STATE_OR_PROVINCE,PROPN-PROPN-PROPN,PROPN,compound-compound-pobj,pobj,NNP-NNP-NNP,NNP,5,1
1128,25550.0,30,landed,5,9,13,4,8,16,-4,8,Kennedy Space Center,Florida,ORGANIZATION-ORGANIZATION-ORGANIZATION,STATE_OR_PROVINCE,PROPN-PROPN-PROPN,PROPN,compound-compound-pobj,pobj,NNP-NNP-NNP,NNP,4,1
1129,26733.0,36,outline,9,31,35,4,30,0,-22,26,Kennedy Space Center,Florida,ORGANIZATION-ORGANIZATION-ORGANIZATION,STATE_OR_PROVINCE,PROPN-PROPN-PROPN,PROPN,compound-compound-pobj,pobj,NNP-NNP-NNP,NNP,3,1
1130,32302.0,43,said,8,17,21,4,16,21,-9,13,Kennedy Space Center,Florida,ORGANIZATION-ORGANIZATION-ORGANIZATION,STATE_OR_PROVINCE,PROPN-PROPN-PROPN,PROPN,compound-compound-pobj,pobj,NNP-NNP-NNP,NNP,3,1
1131,39131.0,25,forced,2,13,17,4,12,7,-11,15,Kennedy Space Center,Florida,ORGANIZATION-ORGANIZATION-ORGANIZATION,STATE_OR_PROVINCE,PROPN-PROPN-PROPN,PROPN,compound-compound-pobj,appos,NNP-NNP-NNP,NNP,5,1
1132,39585.0,15,cleared,2,10,14,4,9,0,-8,12,Kennedy Space Center,Florida,ORGANIZATION-ORGANIZATION-ORGANIZATION,STATE_OR_PROVINCE,PROPN-PROPN-PROPN,PROPN,compound-compound-pobj,pobj,NNP-NNP-NNP,NNP,5,1
1133,41882.0,35,lifted,4,11,15,4,10,19,-7,11,Kennedy Space Center,Florida,ORGANIZATION-ORGANIZATION-ORGANIZATION,STATE_OR_PROVINCE,PROPN-PROPN-PROPN,PROPN,compound-compound-pobj,pobj,NNP-NNP-NNP,NNP,4,1
1134,42830.0,37,WASHINGTON,0,20,24,4,19,12,-20,24,Kennedy Space Center,Florida,ORGANIZATION-ORGANIZATION-ORGANIZATION,STATE_OR_PROVINCE,PROPN-PROPN-PROPN,PROPN,compound-compound-pobj,pobj,NNP-NNP-NNP,NNP,5,1
1135,43015.0,28,pad,5,10,14,4,9,13,-5,9,Kennedy Space Center,Florida,ORGANIZATION-ORGANIZATION-ORGANIZATION,STATE_OR_PROVINCE,PROPN-PROPN-PROPN,PROPN,compound-compound-pobj,pobj,NNP-NNP-NNP,NNP,5,1
1136,43958.0,52,be,16,9,13,4,8,38,7,-3,Kennedy Space Center,Florida,ORGANIZATION-ORGANIZATION-ORGANIZATION,STATE_OR_PROVINCE,PROPN-PROPN-PROPN,PROPN,compound-compound-pobj,pobj,NNP-NNP-NNP,NNP,5,1
1137,44037.0,30,notified,4,10,14,4,9,15,-6,10,Kennedy Space Center,Florida,ORGANIZATION-ORGANIZATION-ORGANIZATION,STATE_OR_PROVINCE,PROPN-PROPN-PROPN,PROPN,compound-compound-pobj,pobj,NNP-NNP-NNP,NNP,2,1
1138,46787.0,29,launched,1,4,11,7,3,17,-3,10,Kennedy Space Center,Florida,ORGANIZATION-ORGANIZATION-ORGANIZATION,STATE_OR_PROVINCE,PROPN-PROPN-PROPN,PROPN,compound-compound-pobj,appos,NNP-NNP-NNP,NNP,4,1
1139,51390.0,29,lifted,4,19,23,4,18,5,-15,19,Kennedy Space Center,Florida,ORGANIZATION-ORGANIZATION-ORGANIZATION,STATE_OR_PROVINCE,PROPN-PROPN-PROPN,PROPN,compound-compound-pobj,pobj,NNP-NNP-NNP,NNP,4,1
1140,51451.0,38,estimate,5,8,2,-6,7,35,-3,-3,Kennedy Space Center,Florida,ORGANIZATION-ORGANIZATION-ORGANIZATION,STATE_OR_PROVINCE,PROPN-PROPN-PROPN,PROPN,compound-compound-nsubj,pobj,NNP-NNP-NNP,NNP,4,1
1141,62519.0,43,scheduled,19,25,32,7,24,10,-6,13,Kennedy Space Center,Florida,ORGANIZATION-ORGANIZATION-ORGANIZATION,STATE_OR_PROVINCE,PROPN-PROPN-PROPN,PROPN,compound-compound-pobj,appos,NNP-NNP-NNP,NNP,6,1
1142,64487.0,41,pulls,7,36,40,4,35,0,-29,33,Kennedy Space Center,Florida,ORGANIZATION-ORGANIZATION-ORGANIZATION,STATE_OR_PROVINCE,PROPN-PROPN-PROPN,PROPN,compound-compound-pobj,pobj,NNP-NNP-NNP,NNP,3,1
1143,67053.0,17,scheduled,3,12,16,4,11,0,-9,13,Kennedy Space Center,Florida,ORGANIZATION-ORGANIZATION-ORGANIZATION,STATE_OR_PROVINCE,PROPN-PROPN-PROPN,PROPN,compound-compound-pobj,pobj,NNP-NNP-NNP,NNP,5,1
1144,1825.0,51,said,12,2,8,6,1,42,10,-4,Ali Akbar Salehi,ambassador,PERSON-PERSON-PERSON,TITLE,PROPN-PROPN-PROPN,NOUN,compound-compound-nsubj,appos,NNP-NNP-NNP,NN,3,1
1145,22630.0,31,walked,15,12,7,-5,11,23,3,-8,Ali Akbar Salehi,ambassador,PERSON-PERSON-PERSON,TITLE,PROPN-PROPN-PROPN,NOUN,compound-compound-appos,nsubj,NNP-NNP-NNP,NN,3,1
1146,27255.0,64,admits,1,15,21,6,14,42,-14,20,Ali Akbar Salehi,ambassador,PERSON-PERSON-PERSON,TITLE,PROPN-PROPN-PROPN,NOUN,compound-compound-pobj,appos,NNP-NNP-NNP,NN,3,1
1147,61930.0,51,told,28,25,21,-4,24,29,3,-7,Ali Akbar Salehi,ambassador,PERSON-PERSON-PERSON,TITLE,PROPN-PROPN-PROPN,NOUN,compound-compound-pobj,pobj,NNP-NNP-NNP,NN,2,1
1148,1849.0,29,avoided,10,2,24,22,1,4,8,14,Australian Broadcasting Corporation,ABC,ORGANIZATION-ORGANIZATION-ORGANIZATION,ORGANIZATION,PROPN-PROPN-PROPN,PROPN,compound-compound-appos,compound,NNP-NNP-NNP,NNP,4,1
1149,7079.0,25,killed,6,16,20,4,15,4,-10,14,Australian Broadcasting Corporation,ABC,ORGANIZATION-ORGANIZATION-ORGANIZATION,ORGANIZATION,PROPN-PROPN-PROPN,PROPN,compound-compound-appos,compound,NNP-NNP-NNP,NNP,3,1
1150,18702.0,19,told,4,7,11,4,6,7,-3,7,Australian Broadcasting Corporation,ABC,ORGANIZATION-ORGANIZATION-ORGANIZATION,ORGANIZATION,PROPN-PROPN-PROPN,PROPN,compound-compound-dobj,compound,NNP-NNP-NNP,NNP,4,1
1151,30067.0,53,is,6,39,43,4,38,9,-33,37,Australian Broadcasting Corporation,ABC,ORGANIZATION-ORGANIZATION-ORGANIZATION,ORGANIZATION,PROPN-PROPN-PROPN,PROPN,compound-compound-appos,compound,NNP-NNP-NNP,NNP,2,1
1152,32022.0,39,-LSB-,0,12,4,-8,11,34,-12,4,Australian Broadcasting Corporation,ABC,ORGANIZATION-ORGANIZATION-ORGANIZATION,ORGANIZATION,PROPN-PROPN-PROPN,PROPN,compound-compound-appos,appos,NNP-NNP-NNP,NNP,2,1
1153,43928.0,32,gave,11,24,28,4,23,3,-13,17,Australian Broadcasting Corporation,ABC,ORGANIZATION-ORGANIZATION-ORGANIZATION,ORGANIZATION,PROPN-PROPN-PROPN,PROPN,compound-compound-pobj,compound,NNP-NNP-NNP,NNP,5,1
1154,57358.0,23,raised,20,14,18,4,13,4,6,-2,Australian Broadcasting Corporation,ABC,ORGANIZATION-ORGANIZATION-ORGANIZATION,ORGANIZATION,PROPN-PROPN-PROPN,PROPN,compound-compound-pobj,compound,NNP-NNP-NNP,NNP,6,1
1155,62137.0,28,Corporation,2,1,5,4,0,22,1,3,Australian Broadcasting Corporation,ABC,ORGANIZATION-ORGANIZATION-ORGANIZATION,ORGANIZATION,PROPN-PROPN-PROPN,PROPN,amod-compound-ROOT,compound,NNP-NNP-NNP,NNP,3,1
1156,1856.0,18,Nottingham-Spirk,0,1,3,2,0,14,-1,3,Nottingham-Spirk,http://wwwns-designcom/,ORGANIZATION,URL,ADJ,INTJ,ROOT,punct,JJ,UH,2,1
1157,1863.0,38,DEROUNIAN,2,1,31,30,0,6,1,29,STEVEN B DEROUNIAN,Texas,PERSON-PERSON-PERSON,STATE_OR_PROVINCE,PROPN-PROPN-PROPN,PROPN,compound-compound-ROOT,pobj,NNP-NNP-NNP,NNP,6,1
1158,1864.0,42,wants,26,7,10,3,6,31,19,-16,Barnes Foundation,Pennsylvania,ORGANIZATION-ORGANIZATION,STATE_OR_PROVINCE,PROPN-PROPN,PROPN,compound-dobj,pobj,NNP-NNP,NNP,1,1
1159,1869.0,43,founded,7,1,5,4,0,37,6,-2,Wildmon,Methodist,PERSON,RELIGION,PROPN,ADJ,nsubj,compound,NNP,JJ,2,1
1160,1893.0,23,said,21,12,4,-8,11,18,9,-17,PRCA,Troy,ORGANIZATION,PERSON,PROPN,PROPN,pobj,poss,NNP,NNP,4,1
1161,1894.0,43,meet,13,19,17,-2,18,25,-6,4,Ali Larijani,Iranian,PERSON-PERSON,NATIONALITY,PROPN-PROPN,ADJ,compound-pobj,amod,NNP-NNP,JJ,1,1
1162,12407.0,34,said,32,25,23,-2,24,10,7,-9,Ali Larijani,Iranian,PERSON-PERSON,NATIONALITY,PROPN-PROPN,ADJ,compound-conj,amod,NNP-NNP,JJ,2,1
1163,30085.0,26,said,23,22,16,-6,21,9,1,-7,Ali Larijani,Iranian,PERSON-PERSON,NATIONALITY,PROPN-PROPN,ADJ,compound-nsubj,amod,NNP-NNP,JJ,7,1
1164,53851.0,28,said,5,4,1,-3,3,26,1,-4,Ali Larijani,Iranian,PERSON-PERSON,NATIONALITY,PROPN-PROPN,ADJ,compound-nsubj,amod,NNP-NNP,JJ,2,1
1165,63009.0,34,said,23,22,14,-8,21,19,1,-9,Ali Larijani,Iranian,PERSON-PERSON,NATIONALITY,PROPN-PROPN,ADJ,compound-conj,amod,NNP-NNP,JJ,2,1
1166,67574.0,36,warned,33,32,30,-2,31,5,1,-3,Ali Larijani,Iranian,PERSON-PERSON,NATIONALITY,PROPN-PROPN,ADJ,compound-nsubj,amod,NNP-NNP,JJ,1,1
1167,1896.0,36,boss,29,12,31,19,11,4,17,2,Blackburn Rovers,Paul Ince,ORGANIZATION-ORGANIZATION,PERSON-PERSON,PROPN-PROPN,PROPN-PROPN,compound-pobj,compound-dobj,NNP-NNPS,NNP-NNP,5,1
1168,10724.0,47,Football,4,10,45,35,9,1,-6,41,Blackburn Rovers,Paul Ince,ORGANIZATION-ORGANIZATION,PERSON-PERSON,PROPN-PROPN,PROPN-PROPN,compound-pobj,compound-dobj,NNP-NNPS,NNP-NNP,5,1
1169,37200.0,33,said,5,1,4,3,0,28,4,-1,Blackburn Rovers,Paul Ince,ORGANIZATION-ORGANIZATION,PERSON-PERSON,PROPN-PROPN,PROPN-PROPN,compound-compound,compound-nsubj,NNP-NNP,NNP-NNP,2,1
1170,52093.0,24,announced,2,1,8,7,0,15,1,6,Blackburn Rovers,Paul Ince,ORGANIZATION-ORGANIZATION,PERSON-PERSON,PROPN-PROPN,PROPN-PROPN,compound-nsubj,compound-dobj,NNP-NNP,NNP-NNP,3,1
1171,1904.0,20,was,7,1,4,3,0,15,6,-3,Her,Gaius C. Bolin,PERSON,PERSON-PERSON-PERSON,DET,PROPN-PROPN-PROPN,poss,compound-compound-appos,PRP$,NNP-NNP-NNP,2,1
1172,1906.0,20,said,18,6,15,9,5,4,12,-3,Yoadimnadji,Chad,PERSON,COUNTRY,NOUN,PROPN,dobj,pobj,NNS,NNP,5,1
1173,64054.0,24,hailed,1,1,9,8,0,14,0,8,Yoadimnadji,Chad,PERSON,COUNTRY,NOUN,PROPN,nsubj,pobj,NNS,NNP,5,1
1174,1908.0,38,------,0,8,6,-2,7,31,-8,6,Parren Mitchell,1922,PERSON-PERSON,DATE,PROPN-PROPN,NUM,compound-nsubj,pobj,NNP-NNP,CD,2,1
1175,44202.0,37,was,8,7,5,-2,6,31,1,-3,Parren Mitchell,1922,PERSON-PERSON,DATE,PROPN-PROPN,NUM,compound-nsubj,pobj,NNP-NNP,CD,2,1
1176,1909.0,11,was,1,1,8,7,0,2,0,7,He,Mary M Anderson,PERSON,PERSON-PERSON-PERSON,PRON,PROPN-PROPN-PROPN,nsubj,compound-compound-conj,PRP,NNP-NNP-NNP,5,1
1177,1913.0,33,expressed,12,2,9,7,1,23,10,-3,Carolyn Maloney,House Financial Services Committee,PERSON-PERSON,ORGANIZATION-ORGANIZATION-ORGANIZATION-ORGANIZATION,PROPN-PROPN,PROPN-PROPN-PROPN-PROPN,compound-nsubj,compound-compound-compound-pobj,NNP-NNP,NNP-NNP-NNPS-NNP,5,1
1178,45644.0,33,expressed,12,2,9,7,1,23,10,-3,Carolyn Maloney,House Financial Services Committee,PERSON-PERSON,ORGANIZATION-ORGANIZATION-ORGANIZATION-ORGANIZATION,PROPN-PROPN,PROPN-PROPN-PROPN-PROPN,compound-nsubj,compound-compound-compound-pobj,NNP-NNP,NNP-NNP-NNPS-NNP,5,1
1179,1914.0,33,has,5,4,14,10,3,18,1,9,Paul Sculfor,she,PERSON-PERSON,PERSON,PROPN-PROPN,PRON,compound-dobj,nsubj,NNP-NNP,PRP,5,1
1180,1929.0,31,worked,1,28,13,-15,27,17,-27,12,Old Lane Partners,he,ORGANIZATION-ORGANIZATION-ORGANIZATION,PERSON,PROPN-PROPN-PROPN,PRON,compound-compound-dobj,nsubj,NNP-NNP-NNPS,PRP,6,1
1181,24660.0,29,paid,4,13,20,7,12,8,-9,16,Old Lane Partners,he,ORGANIZATION-ORGANIZATION-ORGANIZATION,PERSON,PROPN-PROPN-PROPN,PRON,compound-compound-dobj,nsubj,NNP-NNP-NNPS,PRP,3,1
1182,39958.0,32,worked,1,29,16,-13,28,15,-28,15,Old Lane Partners,he,ORGANIZATION-ORGANIZATION-ORGANIZATION,PERSON,PROPN-PROPN-PROPN,PRON,compound-compound-dobj,nsubj,NNP-NNP-NNPS,PRP,6,1
1183,1933.0,21,said,18,17,15,-2,16,5,1,-3,William Anderson,Police Chief,PERSON-PERSON,TITLE-TITLE,PROPN-PROPN,PROPN-PROPN,compound-nsubj,compound-compound,NNP-NNP,NNP-NNP,3,1
1184,1934.0,16,represented,2,8,14,6,7,1,-6,12,Central American Parliament,Guatemala,ORGANIZATION-ORGANIZATION-ORGANIZATION,CITY,ADJ-PROPN-PROPN,PROPN,compound-compound-pobj,compound,JJ-NNP-NNP,NNP,6,1
1185,29053.0,27,found,18,10,16,6,9,10,8,-2,Central American Parliament,Guatemala,ORGANIZATION-ORGANIZATION-ORGANIZATION,COUNTRY,ADJ-PROPN-PROPN,PROPN,compound-compound-pobj,pobj,JJ-NNP-NNP,NNP,7,1
1186,39999.0,22,set,12,2,9,7,1,12,10,-3,Central American Parliament,Guatemala,ORGANIZATION-ORGANIZATION-ORGANIZATION,COUNTRY,ADJ-PROPN-PROPN,PROPN,compound-compound-nsubjpass,compound,JJ-NNP-NNP,NNP,5,1
1187,44891.0,52,said,50,19,38,19,18,13,31,-12,Central American Parliament,Guatemala,ORGANIZATION-ORGANIZATION-ORGANIZATION,ORGANIZATION,ADJ-PROPN-PROPN,PROPN,compound-compound-pobj,conj,JJ-NNP-NNP,NNP,20,1
1188,65074.0,39,found,30,20,1,-19,19,37,10,-29,Central American Parliament,Guatemala,ORGANIZATION-ORGANIZATION-ORGANIZATION,COUNTRY,ADJ-PROPN-PROPN,PROPN,compound-compound-pobj,pobj,JJ-NNP-NNP,NNP,10,1
1189,1941.0,44,announced,14,13,11,-2,12,32,1,-3,Ahmad Qattan,Arab League,PERSON-PERSON,ORGANIZATION-ORGANIZATION,PROPN-PROPN,PROPN-PROPN,compound-pobj,compound-compound,NNP-NNP,NNP-NNP,1,1
1190,20251.0,46,DAMASCUS,0,13,8,-5,12,37,-13,8,Ahmad Qattan,Arab League,PERSON-PERSON,ORGANIZATION-ORGANIZATION,PROPN-PROPN,PROPN-PROPN,compound-pobj,compound-compound,NNP-NNP,NNP-NNP,4,1
1191,22423.0,45,said,12,11,6,-5,10,38,1,-6,Ahmad Qattan,Arab League,PERSON-PERSON,ORGANIZATION-ORGANIZATION,PROPN-PROPN,PROPN-PROPN,compound-pobj,compound-compound,NNP-NNP,NNP-NNP,4,1
1192,32997.0,44,said,12,11,9,-2,10,34,1,-3,Ahmad Qattan,Arab League,PERSON-PERSON,ORGANIZATION-ORGANIZATION,PROPN-PROPN,PROPN-PROPN,compound-pobj,compound-compound,NNP-NNP,NNP-NNP,1,1
1193,34455.0,36,represented,3,34,31,-3,33,4,-31,28,Ahmad Qattan,Arab League,PERSON-PERSON,ORGANIZATION-ORGANIZATION,PROPN-PROPN,PROPN-PROPN,compound-dobj,compound-compound,NNP-NNP,NNP-NNP,2,1
1194,37084.0,26,said,11,9,6,-3,8,19,2,-5,Ahmad Qattan,Arab League,PERSON-PERSON,ORGANIZATION-ORGANIZATION,PROPN-PROPN,PROPN-PROPN,compound-appos,compound-pobj,NNP-NNP,NNP-NNP,3,1
1195,58551.0,49,DAMASCUS,0,13,8,-5,12,40,-13,8,Ahmad Qattan,Arab League,PERSON-PERSON,ORGANIZATION-ORGANIZATION,PROPN-PROPN,PROPN-PROPN,compound-pobj,compound-compound,NNP-NNP,NNP-NNP,4,1
1196,1944.0,38,set,5,3,1,-2,2,36,2,-4,Chante Moore,Soul songstress,PERSON-PERSON,TITLE-TITLE,PROPN-PROPN,NOUN-NOUN,compound-nsubj,compound-compound,NNP-NNP,NN-NN,1,1
1197,1948.0,34,defended,9,11,6,-5,10,27,-2,-3,his,manager,PERSON,TITLE,DET,NOUN,poss,appos,PRP$,NN,3,1
1198,49707.0,26,advanced,1,10,5,-5,9,20,-9,4,his,manager,PERSON,TITLE,DET,NOUN,poss,pobj,PRP$,NN,4,1
1199,54595.0,26,advanced,1,10,5,-5,9,20,-9,4,his,manager,PERSON,TITLE,DET,NOUN,poss,pobj,PRP$,NN,4,1
1200,59249.0,36,signed,10,23,9,-14,22,26,-13,-1,his,manager,PERSON,TITLE,DET,NOUN,nsubj,attr,PRP$,NN,6,1
1201,1951.0,22,ANGELES,1,10,9,-1,9,12,-9,8,Johnny Knoxville,star,PERSON-PERSON,TITLE,PROPN-PROPN,NOUN,compound-nsubj,compound,NNP-NNP,NN,2,1
1202,22085.0,20,sold,6,5,4,-1,4,15,1,-2,Johnny Knoxville,star,PERSON-PERSON,TITLE,PROPN-PROPN,NOUN,compound-nsubj,compound,NNP-NNP,NN,2,1
1203,35184.0,17,filed,7,5,4,-1,4,12,2,-3,Johnny Knoxville,star,PERSON-PERSON,TITLE,PROPN-PROPN,NOUN,compound-nsubj,compound,NNP-NNP,NN,3,1
1204,44971.0,49,suing,3,9,8,-1,8,40,-6,5,Johnny Knoxville,star,PERSON-PERSON,TITLE,PROPN-PROPN,NOUN,compound-dobj,compound,NNP-NNP,NN,2,1
1205,56823.0,40,pay,16,7,6,-1,6,33,9,-10,Johnny Knoxville,star,PERSON-PERSON,TITLE,PROPN-PROPN,NOUN,compound-nsubj,compound,NNP-NNP,NN,1,1
1206,60884.0,15,prevented,5,13,12,-1,12,2,-8,7,Johnny Knoxville,star,PERSON-PERSON,TITLE,PROPN-PROPN,NOUN,compound-dobj,compound,NNP-NNP,NN,2,1
1207,1956.0,6,Association,3,1,6,5,0,-1,2,3,Professional Rodeo Cowboys Association,http://www.prorodeo.com,ORGANIZATION-ORGANIZATION-ORGANIZATION-ORGANIZATION,URL,PROPN-PROPN-PROPN-PROPN,X,compound-compound-compound-ROOT,ROOT,NNP-NNP-NNPS-NNP,ADD,-1,1
1208,1959.0,39,was,1,29,13,-16,28,25,-28,12,Fidel Castro,Raul Castro,PERSON-PERSON,PERSON-PERSON,PROPN-PROPN,PROPN-PROPN,compound-appos,compound-pobj,NNP-NNP,NNP-NNP,6,1
1209,1962.0,21,offered,17,4,10,6,3,10,13,-7,M Enkhbold,MPRP,PERSON-PERSON,ORGANIZATION,PROPN-PROPN,PROPN,compound-nsubj,pobj,NNP-NNP,NNP,2,1
1210,34431.0,44,said,24,10,22,12,9,21,14,-2,M Enkhbold,MPRP,PERSON-PERSON,ORGANIZATION,PROPN-PROPN,PROPN,compound-pobj,compound,NNP-NNP,NNP,6,1
1211,59047.0,51,BATOR,1,19,25,6,18,25,-18,24,M Enkhbold,MPRP,PERSON-PERSON,ORGANIZATION,PROPN-PROPN,PROPN,compound-nsubj,pobj,NNP-NNP,NNP,4,1
1212,1979.0,91,have,30,1,61,60,0,29,29,31,Cathleen P. Black,executive,PERSON-PERSON-PERSON,TITLE,PROPN-PROPN-PROPN,NOUN,compound-compound-nsubj,appos,NNP-NNP-NNP,NN,-1,1
1213,4703.0,66,NY-SCHOOLS-CHIEF,0,24,30,6,23,35,-24,30,Cathleen P. Black,executive,PERSON-PERSON-PERSON,TITLE,PROPN-PROPN-PROPN,NOUN,compound-compound-pobj,appos,NNP-NNP-NNP,NN,4,1
1214,16654.0,46,called,13,15,21,6,14,24,-2,8,Cathleen P. Black,executive,PERSON-PERSON-PERSON,TITLE,PROPN-PROPN-PROPN,NOUN,compound-compound-dobj,appos,NNP-NNP-NNP,NN,3,1
1215,23901.0,57,trying,47,19,25,6,18,31,28,-22,Cathleen P. Black,executive,PERSON-PERSON-PERSON,TITLE,PROPN-PROPN-PROPN,NOUN,compound-compound-pobj,appos,NNP-NNP-NNP,NN,7,1
1216,34621.0,26,NY-SCHOOLS-CHIEF,0,15,14,-1,14,11,-15,14,Cathleen P. Black,executive,PERSON-PERSON-PERSON,TITLE,PROPN-PROPN-PROPN,NOUN,compound-compound-pobj,compound,NNP-NNP-NNP,NN,1,1
1217,46398.0,25,NY-SCHOOLS-CHIEF,0,14,13,-1,13,11,-14,13,Cathleen P. Black,executive,PERSON-PERSON-PERSON,TITLE,PROPN-PROPN-PROPN,NOUN,compound-compound-pobj,compound,NNP-NNP-NNP,NN,1,1
1218,67993.0,89,have,30,1,59,58,0,29,29,29,Cathleen P. Black,executive,PERSON-PERSON-PERSON,TITLE,PROPN-PROPN-PROPN,NOUN,compound-compound-nsubj,appos,NNP-NNP-NNP,NN,-1,1
1219,1980.0,34,said,11,22,32,10,21,1,-11,21,Carolyn Maloney,East Side,PERSON-PERSON,LOCATION-LOCATION,PROPN-PROPN,PROPN-PROPN,compound-pobj,compound-pobj,NNP-NNP,NNP-NNP,9,1
1220,1990.0,40,agreed,6,16,16,0,15,23,-10,10,Fyffes PLC,Fyffes,ORGANIZATION-ORGANIZATION,ORGANIZATION,PROPN-PROPN,PROPN,compound-dobj,compound,NNP-NNP,NNP,0,1
1221,2000.0,48,was,20,11,5,-6,10,42,9,-15,KGB,Vladimir Kryuchkov,ORGANIZATION,PERSON-PERSON,PROPN,PROPN-PROPN,compound,compound-pobj,NNP,NNP-NNP,1,1
1222,2001.0,26,ATLANTA,0,8,4,-4,7,21,-8,4,Michael Johns,American,PERSON-PERSON,COUNTRY,PROPN-PROPN,PROPN,compound-nsubj,compound,NNP-NNP,NNP,5,1
1223,38469.0,30,influenced,18,10,6,-4,9,23,8,-12,Michael Johns,American,PERSON-PERSON,NATIONALITY,PROPN-PROPN,PROPN,compound-pobj,compound,NNP-NNP,NNP,4,1
1224,44908.0,27,TV-IDOL-JOHNS,0,10,6,-4,9,20,-10,6,Michael Johns,American,PERSON-PERSON,NATIONALITY,PROPN-PROPN,PROPN,compound-nsubj,compound,NNP-NNP,NNP,3,1
1225,2002.0,35,plots,6,5,2,-3,4,32,1,-4,Susan Boyle,Scottish,PERSON-PERSON,NATIONALITY,PROPN-PROPN,ADJ,compound-nsubj,amod,NNP-NNP,JJ,3,1
1226,36175.0,63,Boyle,2,2,42,40,1,20,0,40,Susan Boyle,Scottish,PERSON-PERSON,NATIONALITY,PROPN-PROPN,ADJ,compound-ROOT,amod,NNP-NNP,JJ,-1,1
1227,40516.0,62,gained,2,33,38,5,32,23,-31,36,Susan Boyle,Scottish,PERSON-PERSON,NATIONALITY,PROPN-PROPN,ADJ,compound-pobj,amod,NNP-NNP,JJ,5,1
1228,40856.0,46,become,22,4,2,-2,3,43,18,-20,Susan Boyle,Scottish,PERSON-PERSON,NATIONALITY,PROPN-PROPN,ADJ,compound-appos,amod,NNP-NNP,JJ,1,1
1229,41349.0,14,got,10,9,5,-4,8,8,1,-5,Susan Boyle,Scottish,PERSON-PERSON,NATIONALITY,PROPN-PROPN,ADJ,compound-nsubj,amod,NNP-NNP,JJ,3,1
1230,59790.0,33,said,30,4,1,-3,3,31,26,-29,Susan Boyle,Scottish,PERSON-PERSON,NATIONALITY,PROPN-PROPN,ADJ,compound-nsubjpass,amod,NNP-NNP,JJ,3,1
1231,2004.0,27,detonated,1,13,26,13,12,0,-12,25,Badr Corps,Iraq,ORGANIZATION-ORGANIZATION,COUNTRY,PROPN-PROPN,PROPN,compound-pobj,pobj,NNP-NNP,NNP,5,1
1232,8956.0,56,said,14,3,12,9,2,43,11,-2,Badr Corps,Iraq,ORGANIZATION-ORGANIZATION,COUNTRY,PROPN-PROPN,PROPN,compound-nsubj,pobj,NNP-NNP,NNP,6,1
1233,14701.0,27,boasted,10,2,16,14,1,10,8,6,Badr Corps,Iraq,ORGANIZATION-ORGANIZATION,COUNTRY,PROPN-PROPN,PROPN,compound-compound,pobj,NNP-NNP,NNP,3,1
1234,2007.0,49,spent,18,6,15,9,5,33,12,-3,American Beverage Association,Coke,ORGANIZATION-ORGANIZATION-ORGANIZATION,ORGANIZATION,PROPN-PROPN-PROPN,PROPN,compound-compound-nsubj,dobj,NNP-NNP-NNP,NNP,5,1
1235,2016.0,18,leaves,2,4,8,4,3,9,-2,6,her,Martin III,PERSON,PERSON-PERSON,DET,PROPN-PROPN,poss,compound-appos,PRP$,NNP-NNP,2,1
1236,47645.0,15,survived,2,5,8,3,4,6,-3,6,her,Martin III,PERSON,PERSON-PERSON,DET,PROPN-PROPN,poss,compound-appos,PRP$,NNP-NNP,3,1
1237,2017.0,37,said,32,30,23,-7,29,13,2,-9,NEC Corp,Yoshikazu Maruyama,ORGANIZATION-ORGANIZATION,PERSON-PERSON,PROPN-PROPN,PROPN-PROPN,compound-pobj,compound-nsubj,NNP-NNP,NNP-NNP,10,1
1238,2020.0,14,born,2,1,8,7,0,5,1,6,Rothman,1932,PERSON,DATE,PROPN,NUM,nsubjpass,pobj,NNP,CD,2,1
1239,2023.0,44,wants,2,1,37,36,0,6,1,35,EnergySolutions Inc.,Utah,ORGANIZATION-ORGANIZATION,STATE_OR_PROVINCE,PROPN-PROPN,PROPN,compound-nsubj,appos,NNP-NNP,NNP,9,1
1240,2025.0,37,harmed,6,13,18,5,12,18,-7,12,National Beef Packing Co.,JBS S.A.,ORGANIZATION-ORGANIZATION-ORGANIZATION-ORGANIZATION,ORGANIZATION-ORGANIZATION,PROPN-PROPN-PROPN-PROPN,PROPN-PROPN,compound-compound-compound-pobj,compound-pobj,NNP-NNP-NNP-NNP,NNP-NNP,5,1
1241,2036.0,33,accused,15,3,30,27,2,2,12,15,Ayatollah Ali Khamenei,Iran,PERSON-PERSON-PERSON,COUNTRY,PROPN-PROPN-PROPN,PROPN,compound-compound-nsubj,poss,NNP-NNP-NNP,NNP,10,1
1242,9847.0,45,imprisoned,2,42,8,-34,41,36,-40,6,Ayatollah Ali Khamenei,Iran,PERSON-PERSON-PERSON,COUNTRY,PROPN-PROPN-PROPN,PROPN,compound-compound-appos,poss,NNP-NNP-NNP,NNP,13,1
1243,11941.0,37,said,2,15,10,-5,14,26,-13,8,Ayatollah Ali Khamenei,Iran,PERSON-PERSON-PERSON,COUNTRY,PROPN-PROPN-PROPN,PROPN,compound-compound-appos,poss,NNP-NNP-NNP,NNP,4,1
1244,14624.0,44,raised,18,15,23,8,14,20,3,5,Ayatollah Ali Khamenei,Iran,PERSON-PERSON-PERSON,COUNTRY,PROPN-PROPN-PROPN,PROPN,compound-compound-nsubj,poss,NNP-NNP-NNP,NNP,7,1
1245,15493.0,32,orders,7,5,1,-4,4,30,2,-6,Ayatollah Ali Khamenei,Iran,PERSON-PERSON-PERSON,COUNTRY,PROPN-PROPN-PROPN,PROPN,compound-compound-appos,poss,NNP-NNP-NNP,NNP,4,1
1246,16319.0,36,said,1,24,1,-23,23,34,-23,0,Ayatollah Ali Khamenei,Iran,PERSON-PERSON-PERSON,COUNTRY,PROPN-PROPN-PROPN,PROPN,compound-compound-appos,nsubj,NNP-NNP-NNP,NNP,5,1
1247,21101.0,33,endorsed,7,5,1,-4,4,31,2,-6,Ayatollah Ali Khamenei,Iran,PERSON-PERSON-PERSON,COUNTRY,PROPN-PROPN-PROPN,PROPN,compound-compound-appos,poss,NNP-NNP-NNP,NNP,4,1
1248,25325.0,41,quoted,31,15,2,-13,14,38,16,-29,Ayatollah Ali Khamenei,Iran,PERSON-PERSON-PERSON,COUNTRY,PROPN-PROPN-PROPN,PROPN,compound-compound-compound,npadvmod,NNP-NNP-NNP,NNP,-1,1
1249,27386.0,22,made,1,11,6,-5,10,15,-10,5,Ayatollah Ali Khamenei,Iran,PERSON-PERSON-PERSON,COUNTRY,PROPN-PROPN-PROPN,PROPN,compound-compound-appos,poss,NNP-NNP-NNP,NNP,4,1
1250,29280.0,39,faced,8,33,27,-6,32,11,-25,19,Ayatollah Ali Khamenei,Iran,PERSON-PERSON-PERSON,COUNTRY,PROPN-PROPN-PROPN,PROPN,compound-compound-pobj,pobj,NNP-NNP-NNP,NNP,5,1
1251,30136.0,32,is,9,29,25,-4,28,6,-20,16,Ayatollah Ali Khamenei,Iran,PERSON-PERSON-PERSON,COUNTRY,PROPN-PROPN-PROPN,PROPN,compound-compound-appos,poss,NNP-NNP-NNP,NNP,3,1
1252,51323.0,30,scheduled,10,6,1,-5,5,28,4,-9,Ayatollah Ali Khamenei,Iran,PERSON-PERSON-PERSON,COUNTRY,PROPN-PROPN-PROPN,PROPN,compound-compound-appos,poss,NNP-NNP-NNP,NNP,4,1
1253,55514.0,34,controlled,6,9,2,-7,8,31,-3,-4,Ayatollah Ali Khamenei,Iran,PERSON-PERSON-PERSON,COUNTRY,PROPN-PROPN-PROPN,PROPN,compound-compound-pobj,pobj,NNP-NNP-NNP,NNP,4,1
1254,66855.0,46,came,2,9,5,-4,8,40,-7,3,Ayatollah Ali Khamenei,Iran,PERSON-PERSON-PERSON,COUNTRY,PROPN-PROPN-PROPN,PROPN,compound-compound-appos,poss,NNP-NNP-NNP,NNP,4,1
1255,2038.0,24,said,17,19,22,3,18,1,-2,5,Tyco,Helena Labaiova,ORGANIZATION,PERSON-PERSON,PROPN,PROPN-PROPN,compound,compound-nsubj,NNP,NNP-NNP,2,1
1256,2041.0,30,reiterated,12,5,1,-4,4,28,7,-11,Nicholas Burns,U.S.,PERSON-PERSON,COUNTRY,PROPN-PROPN,PROPN,compound-nsubj,nmod,NNP-NNP,NNP,1,1
1257,2884.0,46,said,43,42,37,-5,41,8,1,-6,Nicholas Burns,U.S.,PERSON-PERSON,COUNTRY,PROPN-PROPN,PROPN,compound-nsubj,nmod,NNP-NNP,NNP,3,1
1258,4419.0,39,urged,6,5,1,-4,4,37,1,-5,Nicholas Burns,U.S.,PERSON-PERSON,COUNTRY,PROPN-PROPN,PROPN,compound-nsubj,nmod,NNP-NNP,NNP,1,1
1259,6818.0,30,said,23,8,4,-4,7,25,15,-19,Nicholas Burns,U.S.,PERSON-PERSON,COUNTRY,PROPN-PROPN,PROPN,compound-nsubj,compound,NNP-NNP,NNP,1,1
1260,31413.0,46,said,36,35,31,-4,34,14,1,-5,Nicholas Burns,U.S.,PERSON-PERSON,COUNTRY,PROPN-PROPN,PROPN,compound-nsubj,nmod,NNP-NNP,NNP,3,1
1261,50317.0,39,called,8,5,1,-4,4,37,3,-7,Nicholas Burns,U.S.,PERSON-PERSON,COUNTRY,PROPN-PROPN,PROPN,compound-nsubj,nmod,NNP-NNP,NNP,1,1
1262,52695.0,55,said,14,13,6,-7,12,48,1,-8,Nicholas Burns,U.S.,PERSON-PERSON,COUNTRY,PROPN-PROPN,PROPN,compound-nsubj,compound,NNP-NNP,NNP,1,1
1263,57900.0,22,expected,3,20,16,-4,19,5,-17,13,Nicholas Burns,U.S.,PERSON-PERSON,COUNTRY,PROPN-PROPN,PROPN,compound-pobj,nmod,NNP-NNP,NNP,1,1
1264,63968.0,35,reported,33,1,4,3,0,30,32,-29,Nicholas Burns,U.S.,PERSON-PERSON,COUNTRY,PROPN-PROPN,PROPN,compound-nsubj,compound,NNP-NNP,NNP,1,1
1265,65011.0,29,rejected,13,2,6,4,1,22,11,-7,Nicholas Burns,U.S.,PERSON-PERSON,COUNTRY,PROPN-PROPN,PROPN,compound-nsubj,compound,NNP-NNP,NNP,1,1
1266,67270.0,25,told,6,5,1,-4,4,23,1,-5,Nicholas Burns,U.S.,PERSON-PERSON,COUNTRY,PROPN-PROPN,PROPN,compound-nsubj,nmod,NNP-NNP,NNP,1,1
1267,2043.0,40,meet,2,1,6,5,0,33,1,4,Nuclear Supplier Group,Vienna,ORGANIZATION-ORGANIZATION-ORGANIZATION,CITY,PROPN-PROPN-PROPN,PROPN,compound-compound-ROOT,pobj,NNP-NNP-NNP,NNP,2,1
1268,2046.0,31,attend,9,13,1,-12,12,29,-4,-8,Holly Montag,Heidi Montag,PERSON-PERSON,PERSON-PERSON,PROPN-PROPN,PROPN-PROPN,compound-poss,compound-nsubj,NNP-NNP,NNP-NNP,4,1
1269,19724.0,40,been,10,6,1,-5,5,38,4,-9,Holly Montag,Heidi Montag,PERSON-PERSON,PERSON-PERSON,PROPN-PROPN,PROPN-PROPN,compound-appos,compound-poss,NNP-NNP,NNP-NNP,2,1
1270,2048.0,33,co-founded,4,11,7,-4,10,25,-7,3,ICG,International Crisis Group,ORGANIZATION,ORGANIZATION-ORGANIZATION-ORGANIZATION,PROPN,PROPN-PROPN-PROPN,compound,compound-compound-dobj,NNP,NNP-NNP-NNP,4,1
1271,5465.0,36,Group,3,6,2,-4,5,33,-3,-1,ICG,International Crisis Group,ORGANIZATION,ORGANIZATION-ORGANIZATION-ORGANIZATION,PROPN,PROPN-PROPN-PROPN,compound,compound-compound-ROOT,NNP,NNP-NNP-NNP,-1,1
1272,7797.0,53,said,15,14,10,-4,13,42,1,-5,ICG,International Crisis Group,ORGANIZATION,ORGANIZATION-ORGANIZATION-ORGANIZATION,PROPN,PROPN-PROPN-PROPN,compound,compound-compound-appos,NNP,NNP-NNP-NNP,7,1
1273,10038.0,53,Freizer,1,12,8,-4,11,44,-11,7,ICG,International Crisis Group,ORGANIZATION,ORGANIZATION-ORGANIZATION-ORGANIZATION,PROPN,PROPN-PROPN-PROPN,compound,compound-compound-pobj,NNP,NNP-NNP-NNP,5,1
1274,21091.0,52,said,43,50,46,-4,49,5,-7,3,ICG,International Crisis Group,ORGANIZATION,ORGANIZATION-ORGANIZATION-ORGANIZATION,PROPN,PROPN-PROPN-PROPN,compound,compound-compound-nsubj,NNP,NNP-NNP-NNP,1,1
1275,26286.0,36,identified,20,17,13,-4,16,22,3,-7,ICG,International Crisis Group,ORGANIZATION,ORGANIZATION-ORGANIZATION-ORGANIZATION,PROPN,PROPN-PROPN-PROPN,compound,compound-compound-nsubj,NNP,NNP-NNP-NNP,-1,1
1276,34615.0,23,In,0,12,8,-4,11,14,-12,8,ICG,International Crisis Group,ORGANIZATION,ORGANIZATION-ORGANIZATION-ORGANIZATION,PROPN,PROPN-PROPN-PROPN,compound,compound-compound-dobj,NNP,NNP-NNP-NNP,-1,1
1277,45897.0,48,Group,4,7,3,-4,6,44,-3,-1,ICG,International Crisis Group,ORGANIZATION,ORGANIZATION-ORGANIZATION-ORGANIZATION,PROPN,PROPN-PROPN-PROPN,compound,compound-compound-ROOT,NNP,NNP-NNP-NNP,2,1
1278,46567.0,44,are,15,37,33,-4,36,10,-22,18,ICG,International Crisis Group,ORGANIZATION,ORGANIZATION-ORGANIZATION-ORGANIZATION,PROPN,PROPN-PROPN-PROPN,compound,compound-compound-appos,NNP,NNP-NNP-NNP,6,1
1279,50781.0,40,is,1,34,30,-4,33,9,-33,29,ICG,International Crisis Group,ORGANIZATION,ORGANIZATION-ORGANIZATION-ORGANIZATION,PROPN,PROPN-PROPN-PROPN,compound,compound-compound-appos,NNP,NNP-NNP-NNP,6,1
1280,53820.0,36,Group,3,6,2,-4,5,33,-3,-1,ICG,International Crisis Group,ORGANIZATION,ORGANIZATION-ORGANIZATION-ORGANIZATION,PROPN,PROPN-PROPN-PROPN,compound,compound-compound-ROOT,NNP,NNP-NNP-NNP,-1,1
1281,2054.0,51,show,4,6,25,19,5,25,-2,21,Kelly Cutrone,Ava,PERSON-PERSON,PERSON,PROPN-PROPN,PROPN,compound-compound,appos,NNP-NNP,NNP,3,1
1282,2056.0,53,won,8,1,13,12,0,39,7,5,Cathleen P. Black,New York City,PERSON-PERSON-PERSON,CITY-CITY-CITY,PROPN-PROPN-PROPN,PROPN-PROPN-PROPN,compound-compound-nsubj,compound-compound-poss,NNP-NNP-NNP,NNP-NNP-NNP,7,1
1283,3019.0,69,NY-SCHOOLS-CHIEF,0,7,3,-4,6,65,-7,3,Cathleen P. Black,New York City,PERSON-PERSON-PERSON,CITY-CITY-CITY,PROPN-PROPN-PROPN,PROPN-PROPN-PROPN,compound-compound-nsubj,compound-compound-poss,NNP-NNP-NNP,NNP-NNP-NNP,2,1
1284,3098.0,33,tried,13,3,9,6,2,23,10,-4,Cathleen P. Black,New York City,PERSON-PERSON-PERSON,CITY-CITY-CITY,PROPN-PROPN-PROPN,PROPN-PROPN-PROPN,compound-compound-poss,compound-compound-compound,NNP-NNP-NNP,NNP-NNP-NNP,8,1
1285,5952.0,25,NY-SCHOOLS-CHIEF,0,14,3,-11,13,21,-14,3,Cathleen P. Black,New York City,PERSON-PERSON-PERSON,CITY-CITY-CITY,PROPN-PROPN-PROPN,PROPN-PROPN-PROPN,compound-compound-pobj,compound-compound-compound,NNP-NNP-NNP,NNP-NNP-NNP,6,1
1286,9932.0,52,was,22,4,18,14,3,33,18,-4,Cathleen P. Black,New York City,PERSON-PERSON-PERSON,CITY-CITY-CITY,PROPN-PROPN-PROPN,PROPN-PROPN-PROPN,compound-compound-pobj,compound-compound-compound,NNP-NNP-NNP,NNP-NNP-NNP,11,1
1287,22874.0,26,NY-SCHOOLS-CHIEF,0,15,3,-12,14,22,-15,3,Cathleen P. Black,New York City,PERSON-PERSON-PERSON,CITY-CITY-CITY,PROPN-PROPN-PROPN,PROPN-PROPN-PROPN,compound-compound-pobj,compound-compound-compound,NNP-NNP-NNP,NNP-NNP-NNP,-1,1
1288,35103.0,30,NY-SCHOOLS-CHIEF,0,12,3,-9,11,26,-12,3,Cathleen P. Black,New York City,PERSON-PERSON-PERSON,CITY-CITY-CITY,PROPN-PROPN-PROPN,PROPN-PROPN-PROPN,compound-compound-pobj,compound-compound-compound,NNP-NNP-NNP,NNP-NNP-NNP,6,1
1289,37336.0,36,step,19,1,10,9,0,25,18,-9,Cathleen P. Black,New York City,PERSON-PERSON-PERSON,CITY-CITY-CITY,PROPN-PROPN-PROPN,PROPN-PROPN-PROPN,compound-compound-nsubj,compound-compound-poss,NNP-NNP-NNP,NNP-NNP-NNP,7,1
1290,44056.0,37,NY-SCHOOLS-CHIEF,0,12,3,-9,11,33,-12,3,Cathleen P. Black,New York City,PERSON-PERSON-PERSON,CITY-CITY-CITY,PROPN-PROPN-PROPN,PROPN-PROPN-PROPN,compound-compound-pobj,compound-compound-poss,NNP-NNP-NNP,NNP-NNP-NNP,-1,1
1291,46643.0,36,had,26,6,20,14,5,15,20,-6,Cathleen P. Black,New York City,PERSON-PERSON-PERSON,CITY-CITY-CITY,PROPN-PROPN-PROPN,PROPN-PROPN-PROPN,compound-compound-nsubj,compound-compound-compound,NNP-NNP-NNP,NNP-NNP-NNP,6,1
1292,48444.0,47,departed,10,18,42,24,17,4,-8,32,Cathleen P. Black,New York City,PERSON-PERSON-PERSON,CITY-CITY-CITY,PROPN-PROPN-PROPN,PROPN-PROPN-PROPN,compound-compound-dobj,compound-compound-compound,NNP-NNP-NNP,NNP-NNP-NNP,6,1
1293,49076.0,36,filed,8,19,31,12,18,4,-11,23,Cathleen P. Black,New York City,PERSON-PERSON-PERSON,CITY-CITY-CITY,PROPN-PROPN-PROPN,PROPN-PROPN-PROPN,compound-compound-dobj,compound-compound-compound,NNP-NNP-NNP,NNP-NNP-NNP,7,1
1294,67157.0,32,upheld,15,4,10,6,3,21,11,-5,Cathleen P. Black,New York City,PERSON-PERSON-PERSON,CITY-CITY-CITY,PROPN-PROPN-PROPN,PROPN-PROPN-PROPN,compound-compound-pobj,compound-compound-compound,NNP-NNP-NNP,NNP-NNP-NNP,7,1
1295,2058.0,29,reduced,7,7,15,8,6,13,0,8,Inquirer,425,ORGANIZATION,NUMBER,PROPN,NUM,nsubj,pobj,NNP,CD,1,1
1296,27494.0,16,reduced,7,7,15,8,6,0,0,8,Inquirer,425,ORGANIZATION,NUMBER,PROPN,NUM,nsubj,pobj,NNP,CD,1,1
1297,2062.0,40,left,1,1,4,3,0,35,0,3,Buse,commerce committee,PERSON,ORGANIZATION-ORGANIZATION,PROPN,NOUN-NOUN,nsubj,compound-compound,NNP,NN-NN,2,1
1298,2065.0,27,died,6,1,5,4,0,21,5,-1,Mahmood,56,PERSON,NUMBER,PROPN,NUM,nsubj,attr,NNP,CD,2,1
1299,2072.0,45,Bank,3,1,6,5,0,38,2,3,The Asian Development Bank,ADB,ORGANIZATION-ORGANIZATION-ORGANIZATION-ORGANIZATION,ORGANIZATION,DET-PROPN-PROPN-PROPN,PROPN,det-compound-compound-ROOT,compound,DT-NNP-NNP-NNP,NNP,3,1
1300,2073.0,58,said,36,48,38,-10,47,19,-12,2,Manila Economic and Cultural Office,Antonio Basilio,ORGANIZATION-ORGANIZATION-ORGANIZATION-ORGANIZATION-ORGANIZATION,PERSON-PERSON,PROPN-PROPN-CCONJ-PROPN-PROPN,PROPN-PROPN,nmod-nmod-cc-conj-pobj,compound-nsubj,NNP-NNP-CC-NNP-NNP,NNP-NNP,6,1
1301,2248.0,61,joined,18,11,1,-10,10,59,7,-17,Manila Economic and Cultural Office,Antonio Basilio,ORGANIZATION-ORGANIZATION-ORGANIZATION-ORGANIZATION-ORGANIZATION,PERSON-PERSON,PROPN-PROPN-CCONJ-PROPN-PROPN,PROPN-PROPN,nmod-nmod-cc-conj-pobj,compound-nsubj,NNP-NNP-CC-NNP-NNP,NNP-NNP,5,1
1302,22214.0,59,said,39,51,41,-10,50,17,-12,2,Manila Economic and Cultural Office,Antonio Basilio,ORGANIZATION-ORGANIZATION-ORGANIZATION-ORGANIZATION-ORGANIZATION,PERSON-PERSON,PROPN-PROPN-CCONJ-PROPN-PROPN,PROPN-PROPN,nmod-nmod-cc-conj-pobj,compound-nsubj,NNP-NNP-CC-NNP-NNP,NNP-NNP,5,1
1303,24571.0,54,thanked,15,7,1,-6,6,52,8,-14,Manila Economic and Cultural Office,Antonio Basilio,ORGANIZATION-ORGANIZATION-ORGANIZATION-ORGANIZATION-ORGANIZATION,PERSON-PERSON,PROPN-PROPN-CCONJ-PROPN-PROPN,PROPN-PROPN,nmod-nmod-cc-conj-pobj,compound-nsubj,NNP-NNP-CC-NNP-NNP,NNP-NNP,2,1
1304,26992.0,63,said,29,41,31,-10,40,31,-12,2,Manila Economic and Cultural Office,Antonio Basilio,ORGANIZATION-ORGANIZATION-ORGANIZATION-ORGANIZATION-ORGANIZATION,PERSON-PERSON,PROPN-PROPN-CCONJ-PROPN-PROPN,PROPN-PROPN,nmod-nmod-cc-conj-pobj,compound-nsubj,NNP-NNP-CC-NNP-NNP,NNP-NNP,6,1
1305,63956.0,38,said,20,28,22,-6,27,15,-8,2,Manila Economic and Cultural Office,Antonio Basilio,ORGANIZATION-ORGANIZATION-ORGANIZATION-ORGANIZATION-ORGANIZATION,PERSON-PERSON,PROPN-PROPN-CCONJ-PROPN-PROPN,PROPN-PROPN,nmod-nmod-cc-conj-pobj,compound-nsubj,NNP-NNP-CC-NNP-NNP,NNP-NNP,5,1
1306,2074.0,24,said,22,21,20,-1,20,3,1,-2,Li Jie,captain,PERSON-PERSON,TITLE,PROPN-PROPN,NOUN,compound-nsubj,compound,NNP-NNP,NN,1,1
1307,15917.0,45,WUHAN,0,12,15,3,11,29,-12,15,Li Jie,captain,PERSON-PERSON,TITLE,PROPN-PROPN,NOUN,compound-appos,appos,NNP-NNP,NN,2,1
1308,19934.0,57,came,9,39,38,-1,38,18,-30,29,Li Jie,captain,PERSON-PERSON,TITLE,PROPN-PROPN,NOUN,compound-pobj,compound,NNP-NNP,NN,1,1
1309,40236.0,24,said,19,22,21,-1,21,2,-3,2,Li Jie,captain,PERSON-PERSON,TITLE,PROPN-PROPN,NOUN,compound-nsubj,compound,NNP-NNP,NN,1,1
1310,43321.0,31,has,4,25,24,-1,24,6,-21,20,Li Jie,captain,PERSON-PERSON,TITLE,PROPN-PROPN,NOUN,compound-conj,compound,NNP-NNP,NN,1,1
1311,2080.0,37,said,20,4,11,7,3,25,16,-9,Kennedy Space Center,America,ORGANIZATION-ORGANIZATION-ORGANIZATION,COUNTRY,PROPN-PROPN-PROPN,PROPN,compound-compound-pobj,poss,NNP-NNP-NNP,NNP,6,1
1312,2082.0,30,received,24,12,15,3,11,14,12,-9,Forsberg,Boston,PERSON,CITY,PROPN,PROPN,nsubj,pobj,NNP,NNP,6,1
1313,44965.0,30,received,24,12,15,3,11,14,12,-9,Forsberg,Boston,PERSON,CITY,PROPN,PROPN,nsubj,pobj,NNP,NNP,6,1
1314,2097.0,25,include,3,17,8,-9,16,16,-14,5,National Action Network,NAACP,ORGANIZATION-ORGANIZATION-ORGANIZATION,ORGANIZATION,PROPN-PROPN-PROPN,PROPN,compound-compound-conj,pobj,NNP-NNP-NNP,NNP,4,1
1315,2098.0,23,left,11,17,18,1,16,4,-6,7,North Phoenix Baptist Church,Phoenix,ORGANIZATION-ORGANIZATION-ORGANIZATION-ORGANIZATION,CITY,PROPN-PROPN-PROPN-PROPN,PROPN,compound-compound-compound-pobj,pobj,NNP-NNP-NNP-NNP,NNP,2,1
1316,19657.0,40,Religion,0,27,28,1,26,11,-27,28,North Phoenix Baptist Church,Phoenix,ORGANIZATION-ORGANIZATION-ORGANIZATION-ORGANIZATION,CITY,PROPN-PROPN-PROPN-PROPN,PROPN,compound-compound-compound-dobj,compound,NNP-NNP-NNP-NNP,NNP,3,1
1317,2102.0,28,lamented,10,25,12,-13,24,15,-15,2,University of Haifa,Brenda Shaffer,ORGANIZATION-ORGANIZATION-ORGANIZATION,PERSON-PERSON,PROPN-ADP-PROPN,PROPN-PROPN,pobj-prep-pobj,compound-nsubj,NNP-IN-NNP,NNP-NNP,5,1
1318,2103.0,29,UTC,5,25,28,3,24,0,-20,23,EnergySolutions,Utah,ORGANIZATION,STATE_OR_PROVINCE,PROPN,PROPN,compound,pobj,NNP,NNP,3,1
1319,7852.0,23,backed,19,2,8,6,1,14,17,-11,EnergySolutions,Utah,ORGANIZATION,STATE_OR_PROVINCE,PROPN,PROPN,nsubj,pobj,NNP,NNP,2,1
1320,12161.0,29,City,7,4,10,6,3,18,3,3,EnergySolutions,Utah,ORGANIZATION,STATE_OR_PROVINCE,PROPN,PROPN,compound,compound,NNP,NNP,2,1
1321,50883.0,36,shipped,14,19,21,2,18,14,-5,7,EnergySolutions,Utah,ORGANIZATION,STATE_OR_PROVINCE,PROPN,PROPN,poss,compound,NNP,NNP,2,1
1322,2123.0,34,supported,5,5,3,-2,4,30,0,-2,Meskill,congressman,PERSON,TITLE,PROPN,NOUN,nsubj,pobj,NNP,NN,1,1
1323,2124.0,74,In,0,16,13,-3,15,60,-16,13,MAPS,Plasma Science,ORGANIZATION,ORGANIZATION-ORGANIZATION,PROPN,PROPN-PROPN,compound,compound-compound,NNP,NNP-NNP,2,1
1324,2133.0,31,hold,3,13,25,12,12,5,-10,22,NFC South,National Football Conference,ORGANIZATION-ORGANIZATION,ORGANIZATION-ORGANIZATION-ORGANIZATION,PROPN-PROPN,PROPN-PROPN-PROPN,compound-compound,compound-compound-pobj,NNP-NNP,NNP-NNP-NNP,9,1
1325,2134.0,22,Network,3,2,6,4,1,15,1,3,National Action Network,http://wwwnationalactionnetworknet/,ORGANIZATION-ORGANIZATION-ORGANIZATION,URL,PROPN-PROPN-PROPN,PROPN,compound-compound-ROOT,compound,NNP-NNP-NNP,NNP,4,1
1326,2137.0,37,accepts,4,33,23,-10,32,13,-29,19,M Enkhbold,State Great Hural,PERSON-PERSON,ORGANIZATION-ORGANIZATION-ORGANIZATION,PROPN-PROPN,PROPN-PROPN-PROPN,compound-pobj,compound-compound-appos,NNP-NNP,NNP-NNP-NNP,6,1
1327,2144.0,76,is,1,9,7,-2,8,68,-8,6,Richard Perle,Jews,PERSON-PERSON,MISC,PROPN-PROPN,PROPN,compound-pobj,pobj,NNP-NNP,NNPS,1,1
1328,2150.0,48,is,1,10,14,4,9,33,-9,13,his,tool-maker,PERSON,TITLE,DET,NOUN,poss,pobj,PRP$,NN,4,1
1329,2155.0,41,incarcerated,9,1,6,5,0,34,8,-3,Awami League,Hasina,ORGANIZATION-ORGANIZATION,PERSON,PROPN-PROPN,PROPN,compound-compound,nsubj,NNP-NNP,NNP,3,1
1330,4317.0,40,was,11,30,28,-2,29,11,-19,17,Awami League,Hasina,ORGANIZATION-ORGANIZATION,PERSON,PROPN-PROPN,PROPN,compound-compound,poss,NNP-NNP,NNP,3,1
1331,4394.0,37,said,35,7,2,-5,6,34,28,-33,Awami League,Hasina,ORGANIZATION-ORGANIZATION,PERSON,PROPN-PROPN,PROPN,compound-compound,nsubj,NNP-NNP,NNP,5,1
1332,4587.0,29,is,10,7,2,-5,6,26,3,-8,Awami League,Hasina,ORGANIZATION-ORGANIZATION,PERSON,PROPN-PROPN,PROPN,compound-compound,nsubj,NNP-NNP,NNP,5,1
1333,29028.0,55,Urgent,0,8,6,-2,7,48,-8,6,Awami League,Hasina,ORGANIZATION-ORGANIZATION,PERSON,PROPN-PROPN,PROPN,compound-nsubj,poss,NNP-NNP,NNP,2,1
1334,30370.0,50,after,1,29,33,4,28,16,-28,32,Awami League,Hasina,ORGANIZATION-ORGANIZATION,PERSON,PROPN-PROPN,PROPN,compound-appos,pobj,NNP-NNP,NNP,9,1
1335,47007.0,38,been,2,27,25,-2,26,12,-25,23,Awami League,Hasina,ORGANIZATION-ORGANIZATION,PERSON,PROPN-PROPN,PROPN,compound-compound,poss,NNP-NNP,NNP,3,1
1336,62633.0,39,is,4,30,27,-3,29,11,-26,23,Awami League,Hasina,ORGANIZATION-ORGANIZATION,PERSON,PROPN-PROPN,PROPN,compound-compound,nsubj,NNP-NNP,NNP,4,1
1337,2161.0,39,arrested,14,4,9,5,3,29,10,-5,Irene Morgan,Maryland,PERSON-PERSON,STATE_OR_PROVINCE,PROPN-PROPN,PROPN,compound-appos,appos,NNP-NNP,NNP,2,1
1338,2164.0,48,upheld,8,30,28,-2,29,19,-22,20,Hashim Ahmad al-Tai,Minister Sultan,PERSON-PERSON-PERSON,TITLE-TITLE,PROPN-PROPN-X,PROPN-PROPN,compound-subtok-punct,compound-compound,NNP-NNP-ADD,NNP-NNP,2,1
1339,14320.0,49,said,7,13,11,-2,12,37,-6,4,Hashim Ahmad al-Tai,Minister Sultan,PERSON-PERSON-PERSON,TITLE-TITLE,PROPN-PROPN-X,PROPN-PROPN,compound-nsubj-punct,compound-compound,NNP-NNP-ADD,NNP-NNP,3,1
1340,17535.0,16,was,7,13,11,-2,12,4,-6,4,Hashim Ahmad al-Tai,Minister Sultan,PERSON-PERSON-PERSON,TITLE-TITLE,PROPN-PROPN-X,PROPN-PROPN,compound-subtok-attr,compound-compound,NNP-NNP-ADD,NNP-NNP,4,1
1341,23591.0,53,upheld,8,35,33,-2,34,19,-27,25,Hashim Ahmad al-Tai,Minister Sultan,PERSON-PERSON-PERSON,TITLE-TITLE,PROPN-PROPN-X,PROPN-PROPN,compound-subtok-punct,compound-compound,NNP-NNP-ADD,NNP-NNP,1,1
1342,37917.0,29,was,7,13,11,-2,12,17,-6,4,Hashim Ahmad al-Tai,Minister Sultan,PERSON-PERSON-PERSON,TITLE-TITLE,PROPN-PROPN-X,PROPN-PROPN,compound-nsubj-punct,compound-compound,NNP-NNP-ADD,NNP-NNP,4,1
1343,41915.0,26,faces,8,5,3,-2,4,22,3,-5,Hashim Ahmad al-Tai,Minister Sultan,PERSON-PERSON-PERSON,TITLE-TITLE,PROPN-PROPN-PROPN,PROPN-PROPN,compound-nsubj-punct,compound-compound,NNP-NNP-NNP,NNP-NNP,3,1
1344,49207.0,21,said,7,5,3,-2,4,17,2,-4,Hashim Ahmad al-Tai,Minister Sultan,PERSON-PERSON-PERSON,TITLE-TITLE,PROPN-PROPN-PROPN,PROPN-PROPN,compound-nsubj-punct,compound-compound,NNP-NNP-NNP,NNP-NNP,3,1
1345,2168.0,36,TEHRAN,0,28,25,-3,27,10,-28,25,Gholam Ali Haddad Adel,Iranian,PERSON-PERSON-PERSON-PERSON,NATIONALITY,PROPN-PROPN-PROPN-PROPN,ADJ,compound-compound-compound-nsubjpass,amod,NNP-NNP-NNP-NNP,JJ,4,1
1346,4410.0,30,said,12,9,6,-3,8,23,3,-6,Gholam Ali Haddad Adel,Iranian,PERSON-PERSON-PERSON-PERSON,NATIONALITY,PROPN-PROPN-PROPN-PROPN,ADJ,compound-compound-compound-nsubj,amod,NNP-NNP-NNP-NNP,JJ,3,1
1347,9982.0,40,said,14,11,8,-3,10,31,3,-6,Gholam Ali Haddad Adel,Iranian,PERSON-PERSON-PERSON-PERSON,NATIONALITY,PROPN-PROPN-PROPN-PROPN,ADJ,compound-compound-compound-nsubj,amod,NNP-NNP-NNP-NNP,JJ,3,1
1348,30027.0,31,called,10,4,1,-3,3,29,6,-9,Gholam Ali Haddad Adel,Iranian,PERSON-PERSON-PERSON-PERSON,NATIONALITY,PROPN-PROPN-PROPN-PROPN,ADJ,compound-compound-compound-nsubj,amod,NNP-NNP-NNP-NNP,JJ,3,1
1349,35708.0,33,reported,31,4,1,-3,3,31,27,-30,Gholam Ali Haddad Adel,Iranian,PERSON-PERSON-PERSON-PERSON,NATIONALITY,PROPN-PROPN-PROPN-PROPN,ADJ,compound-compound-compound-nsubj,amod,NNP-NNP-NNP-NNP,JJ,3,1
1350,37677.0,53,said,40,49,46,-3,48,6,-9,6,Gholam Ali Haddad Adel,Iranian,PERSON-PERSON-PERSON-PERSON,NATIONALITY,PROPN-PROPN-PROPN-PROPN,ADJ,compound-compound-compound-pobj,amod,NNP-NNP-NNP-NNP,JJ,3,1
1351,50049.0,28,condemned,14,9,4,-5,8,23,5,-10,Gholam Ali Haddad Adel,Iranian,PERSON-PERSON-PERSON-PERSON,NATIONALITY,PROPN-PROPN-PROPN-PROPN,ADJ,compound-compound-compound-appos,amod,NNP-NNP-NNP-NNP,JJ,-1,1
1352,2169.0,38,said,32,36,34,-2,35,3,-4,2,Robert Morgenthau,District Attorney,PERSON-PERSON,TITLE-TITLE,PROPN-PROPN,PROPN-PROPN,compound-nsubj,compound-compound,NNP-NNP,NNP-NNP,3,1
1353,5262.0,25,announced,4,3,1,-2,2,23,1,-3,Robert Morgenthau,District Attorney,PERSON-PERSON,TITLE-TITLE,PROPN-PROPN,PROPN-PROPN,compound-nsubj,compound-compound,NNP-NNP,NNP-NNP,1,1
1354,15484.0,31,said,29,28,26,-2,27,4,1,-3,Robert Morgenthau,District Attorney,PERSON-PERSON,TITLE-TITLE,PROPN-PROPN,PROPN-PROPN,compound-nsubj,compound-compound,NNP-NNP,NNP-NNP,6,1
1355,46146.0,38,said,32,36,34,-2,35,3,-4,2,Robert Morgenthau,District Attorney,PERSON-PERSON,TITLE-TITLE,PROPN-PROPN,PROPN-PROPN,compound-nsubj,compound-compound,NNP-NNP,NNP-NNP,3,1
1356,58184.0,21,said,5,4,2,-2,3,18,1,-3,Robert Morgenthau,District Attorney,PERSON-PERSON,TITLE-TITLE,PROPN-PROPN,PROPN-PROPN,compound-nsubj,compound-compound,NNP-NNP,NNP-NNP,1,1
1357,2172.0,30,died,2,1,8,7,0,21,1,6,Robert Goodman,1969,PERSON-PERSON,DATE,PROPN-PROPN,NUM,compound-nsubj,pobj,NNP-NNP,CD,2,1
1358,2178.0,34,said,6,5,4,-1,4,29,1,-2,Paul Watson,Captain,PERSON-PERSON,TITLE,PROPN-PROPN,NOUN,compound-nsubj,compound,NNP-NNP,NN,1,1
1359,27244.0,53,``,0,9,8,-1,8,44,-9,8,Paul Watson,Captain,PERSON-PERSON,TITLE,PROPN-PROPN,NOUN,compound-ROOT,ROOT,NNP-NNP,NN,1,1
1360,28524.0,31,said,16,29,28,-1,28,2,-13,12,Paul Watson,Captain,PERSON-PERSON,TITLE,PROPN-PROPN,PROPN,compound-appos,compound,NNP-NNP,NNP,2,1
1361,55497.0,25,called,3,2,1,-1,1,23,1,-2,Paul Watson,Captain,PERSON-PERSON,TITLE,PROPN-PROPN,NOUN,compound-nsubj,compound,NNP-NNP,NN,1,1
1362,60539.0,30,said,28,4,3,-1,3,26,24,-25,Paul Watson,Captain,PERSON-PERSON,TITLE,PROPN-PROPN,NOUN,compound-nsubj,compound,NNP-NNP,NN,2,1
1363,62980.0,13,Commentary,0,4,3,-1,3,9,-4,3,Paul Watson,Captain,PERSON-PERSON,TITLE,PROPN-PROPN,PROPN,compound-compound,compound,NNP-NNP,NNP,1,1
1364,65041.0,29,said,27,3,2,-1,2,26,24,-25,Paul Watson,Captain,PERSON-PERSON,TITLE,PROPN-PROPN,NOUN,compound-nsubj,compound,NNP-NNP,NN,2,1
1365,66496.0,40,said,15,2,1,-1,1,38,13,-14,Paul Watson,Captain,PERSON-PERSON,TITLE,PROPN-PROPN,NOUN,compound-nsubj,compound,NNP-NNP,NN,1,1
1366,2179.0,23,WINCHESTER,0,7,19,12,6,3,-7,19,Farland,Navy,PERSON,ORGANIZATION,PROPN,PROPN,nsubj,compound,NNP,NNP,6,1
1367,2194.0,38,*,0,24,18,-6,23,19,-24,18,OIC,Oracle Incentive Compensation,ORGANIZATION,ORGANIZATION-ORGANIZATION-ORGANIZATION,PROPN,PROPN-PROPN-PROPN,compound,compound-compound-pobj,NNP,NNP-NNP-NNP,4,1
1368,2204.0,17,known,10,2,13,11,1,3,8,3,Alcatel-Lucent,Thompson Advisory Group LLC,ORGANIZATION,ORGANIZATION-ORGANIZATION-ORGANIZATION-ORGANIZATION,ADJ,PROPN-PROPN-PROPN-PROPN,amod,compound-compound-compound-pobj,JJ,NNP-NNP-NNP-NNP,4,1
1369,2206.0,56,died,36,2,41,39,1,14,34,5,Jefferson J. DeBlanc Sr.,2007,PERSON-PERSON-PERSON-PERSON,DATE,PROPN-PROPN-PROPN-PROPN,NUM,compound-compound-compound-nsubj,nummod,NNP-NNP-NNP-NNP,CD,-1,1
1370,2209.0,33,told,28,27,6,-21,26,26,1,-22,Chen Zhu,China,PERSON-PERSON,COUNTRY,PROPN-PROPN,PROPN,compound-nsubj,pobj,NNP-NNP,NNP,6,1
1371,4501.0,21,characterized,8,6,1,-5,5,19,2,-7,Chen Zhu,China,PERSON-PERSON,COUNTRY,PROPN-PROPN,PROPN,compound-appos,poss,NNP-NNP,NNP,3,1
1372,4862.0,46,defended,6,5,1,-4,4,44,1,-5,Chen Zhu,China,PERSON-PERSON,COUNTRY,PROPN-PROPN,PROPN,compound-nsubj,poss,NNP-NNP,NNP,3,1
1373,5233.0,39,said,17,16,12,-4,15,26,1,-5,Chen Zhu,China,PERSON-PERSON,COUNTRY,PROPN-PROPN,PROPN,compound-nsubj,nsubj,NNP-NNP,NNP,3,1
1374,10319.0,41,said,38,37,14,-23,36,26,1,-24,Chen Zhu,China,PERSON-PERSON,COUNTRY,PROPN-PROPN,PROPN,compound-nsubj,pobj,NNP-NNP,NNP,4,1
1375,33855.0,40,BEIJING,0,36,9,-27,35,30,-36,9,Chen Zhu,China,PERSON-PERSON,COUNTRY,PROPN-PROPN,PROPN,compound-nsubj,nsubj,NNP-NNP,NNP,4,1
1376,38529.0,37,said,28,26,21,-5,25,15,2,-7,Chen Zhu,China,PERSON-PERSON,COUNTRY,PROPN-PROPN,PROPN,compound-appos,poss,NNP-NNP,NNP,3,1
1377,67575.0,36,BEIJING,0,32,9,-23,31,26,-32,9,Chen Zhu,China,PERSON-PERSON,COUNTRY,PROPN-PROPN,PROPN,compound-nsubj,nsubj,NNP-NNP,NNP,4,1
1378,2218.0,24,said,22,14,3,-11,13,20,8,-19,Opera National de Paris,Philippe Jordan,ORGANIZATION-ORGANIZATION-ORGANIZATION-ORGANIZATION,PERSON-PERSON,PROPN-PROPN-PROPN-PROPN,PROPN-PROPN,compound-compound-compound-pobj,compound-nsubjpass,NNP-NNP-NNP-NNP,NNP-NNP,5,1
1379,2220.0,21,served,1,1,18,17,0,2,0,17,Waldheim,Austrian,PERSON,COUNTRY,PROPN,ADJ,nsubj,amod,NNP,JJ,2,1
1380,31030.0,39,put,8,10,33,23,9,5,-2,25,Waldheim,Austrian,PERSON,NATIONALITY,PROPN,ADJ,dobj,amod,NNP,JJ,5,1
1381,38984.0,38,lost,1,9,20,11,8,17,-8,19,Waldheim,Austrian,PERSON,NATIONALITY,PROPN,ADJ,nsubj,amod,NNP,JJ,3,1
1382,59621.0,26,proved,10,8,25,17,7,0,2,15,Waldheim,Austrian,PERSON,NATIONALITY,PROPN,PROPN,pobj,pobj,NNP,NNP,5,1
1383,2222.0,39,announced,20,35,18,-17,34,20,-15,-2,Focus On The Family,James Dobson,ORGANIZATION-ORGANIZATION-ORGANIZATION-ORGANIZATION,PERSON-PERSON,PROPN-ADP-DET-PROPN,PROPN-PROPN,pobj-prep-det-pobj,compound-nsubj,NNP-IN-DT-NNP,NNP-NNP,6,1
1384,32258.0,43,resigned,16,21,1,-20,20,41,-5,-15,Focus On The Family,James Dobson,ORGANIZATION-ORGANIZATION-ORGANIZATION-ORGANIZATION,PERSON-PERSON,PROPN-ADP-DET-PROPN,PROPN-PROPN,pobj-prep-det-pobj,compound-nsubj,NNP-IN-DT-NNP,NNP-NNP,4,1
1385,47372.0,60,UPDATE,0,3,8,5,2,51,-3,8,Focus On The Family,James Dobson,ORGANIZATION-ORGANIZATION-ORGANIZATION-ORGANIZATION,PERSON-PERSON,PROPN-ADP-DET-PROPN,PROPN-PROPN,ROOT-prep-det-poss,compound-pobj,NNP-IN-DT-NNP,NNP-NNP,1,1
1386,2226.0,38,died,28,1,6,5,0,31,27,-22,Roy Scheider,actor,PERSON-PERSON,TITLE,PROPN-PROPN,NOUN,compound-nsubj,appos,NNP-NNP,NN,2,1
1387,28065.0,17,gives,5,3,2,-1,2,14,2,-3,Roy Scheider,actor,PERSON-PERSON,TITLE,PROPN-PROPN,NOUN,compound-nsubj,compound,NNP-NNP,NN,1,1
1388,29633.0,55,known,35,1,6,5,0,48,34,-29,Roy Scheider,actor,PERSON-PERSON,TITLE,PROPN-PROPN,NOUN,compound-nsubjpass,appos,NNP-NNP,NN,2,1
1389,45509.0,25,died,23,1,5,4,0,19,22,-18,Roy Scheider,actor,PERSON-PERSON,TITLE,PROPN-PROPN,NOUN,compound-nsubj,appos,NNP-NNP,NN,3,1
1390,61373.0,44,died,42,1,24,23,0,19,41,-18,Roy Scheider,actor,PERSON-PERSON,TITLE,PROPN-PROPN,NOUN,compound-pobj,nsubj,NNP-NNP,NN,5,1
1391,61988.0,20,<Chrishelms@yahoocom>,2,6,5,-1,5,14,-4,3,Roy Scheider,actor,PERSON-PERSON,TITLE,PROPN-PROPN,NOUN,compound-nsubj,compound,NNP-NNP,NN,1,1
1392,2228.0,30,Blast,1,27,26,-1,26,3,-26,25,Kelly Cutrone,star,PERSON-PERSON,TITLE,PROPN-PROPN,NOUN,compound-nsubj,compound,NNP-NNP,NN,2,1
1393,41641.0,42,wasting,13,11,10,-1,10,31,2,-3,Kelly Cutrone,star,PERSON-PERSON,TITLE,PROPN-PROPN,NOUN,compound-nsubj,compound,NNP-NNP,NN,1,1
1394,2230.0,7,York,1,4,1,-3,3,5,-3,0,Oxford University Press,New York,ORGANIZATION-ORGANIZATION-ORGANIZATION,STATE_OR_PROVINCE-STATE_OR_PROVINCE,PROPN-PROPN-PROPN,PROPN-PROPN,compound-compound-ROOT,compound-ROOT,NNP-NNP-NNP,NNP-NNP,2,1
1395,4487.0,26,said,18,9,5,-4,8,20,9,-13,Oxford University Press,New York,ORGANIZATION-ORGANIZATION-ORGANIZATION,STATE_OR_PROVINCE-STATE_OR_PROVINCE,PROPN-PROPN-PROPN,PROPN-PROPN,compound-compound-pobj,compound-compound,NNP-NNP-NNP,NNP-NNP,4,1
1396,2235.0,35,said,15,33,21,-12,32,13,-18,6,TSE,Carlos Ayres Brito,ORGANIZATION,PERSON-PERSON-PERSON,PROPN,PROPN-PROPN-PROPN,compound,compound-compound-pobj,NNP,NNP-NNP-NNP,6,1
1397,2240.0,48,said,34,36,40,4,35,7,-2,6,Li Jie,24-year-old,PERSON-PERSON,DURATION,PROPN-PROPN,NUM,compound-nsubj,amod,NNP-NNP,CD,3,1
1398,2247.0,14,explained,2,1,2,1,0,11,1,0,Charles Kaiser,Kaiser,PERSON-PERSON,PERSON,PROPN-PROPN,PROPN,compound-nsubj,poss,NNP-NNP,NNP,1,1
1399,2250.0,32,died,5,5,7,2,4,24,0,2,Bellecourt,Saturday,PERSON,DATE,PROPN,PROPN,nsubj,npadvmod,NNP,NNP,5,1
1400,2590.0,28,died,1,1,3,2,0,24,0,2,Bellecourt,Saturday,PERSON,DATE,PROPN,PROPN,nsubj,npadvmod,NNP,NNP,1,1
1401,2262.0,82,com,1,39,43,4,38,38,-38,42,American Motorcyclist Association,AMA,ORGANIZATION-ORGANIZATION-ORGANIZATION,ORGANIZATION,PROPN-PROPN-PROPN,PROPN,compound-compound-appos,appos,NNP-NNP-NNP,NNP,4,1
1402,9493.0,45,AMA,0,20,1,-19,19,43,-20,1,American Motorcyclist Association,AMA,ORGANIZATION-ORGANIZATION-ORGANIZATION,ORGANIZATION,PROPN-PROPN-PROPN,PROPN,amod-compound-nsubj,compound,NNP-NNP-NNP,NNP,-1,1
1403,28221.0,43,com,0,38,42,4,37,0,-38,42,American Motorcyclist Association,AMA,ORGANIZATION-ORGANIZATION-ORGANIZATION,ORGANIZATION,PROPN-PROPN-PROPN,PROPN,compound-compound-appos,appos,NNP-NNP-NNP,NNP,4,1
1404,2266.0,35,meant,25,20,13,-7,19,21,5,-12,New Jerusalem Foundation,Jerusalem,ORGANIZATION-ORGANIZATION-ORGANIZATION,CITY,PROPN-PROPN-PROPN,PROPN,compound-compound-dobj,pobj,NNP-NNP-NNP,NNP,4,1
1405,2275.0,41,said,26,26,35,9,25,5,0,9,Chen,Information Office of the State Council,PERSON,ORGANIZATION-ORGANIZATION-ORGANIZATION-ORGANIZATION-ORGANIZATION-ORGANIZATION,PROPN,PROPN-PROPN-ADP-DET-PROPN-PROPN,nsubj,compound-pobj-prep-det-compound-pobj,NNP,NNP-NNP-IN-DT-NNP-NNP,7,1
1406,2278.0,52,were,16,1,14,13,0,37,15,-2,Richard Lindzen,climate scientists,PERSON-PERSON,TITLE-TITLE,PROPN-PROPN,NOUN-NOUN,compound-nsubj,compound-pobj,NNP-NNP,NN-NNS,4,1
1407,2280.0,35,believe,4,2,22,20,1,12,2,18,We,Val Christensen,ORGANIZATION,PERSON-PERSON,PRON,PROPN-PROPN,nsubj,compound-nsubj,PRP,NNP-NNP,4,1
1408,2281.0,56,died,36,2,7,5,1,48,34,-29,Jefferson J. DeBlanc Sr.,86,PERSON-PERSON-PERSON-PERSON,NUMBER,PROPN-PROPN-PROPN-PROPN,NUM,compound-compound-compound-nsubj,appos,NNP-NNP-NNP-NNP,CD,4,1
1409,2282.0,47,was,8,8,40,32,7,6,0,32,Obamas,Reggie Love,ORGANIZATION,PERSON-PERSON,PROPN,PROPN-PROPN,nsubj,compound-appos,NNP,NNP-NNP,4,1
1410,2296.0,37,Description,0,31,34,3,30,2,-31,34,Covidien,Tyco Healthcare,ORGANIZATION,ORGANIZATION-ORGANIZATION,PROPN,PROPN-PROPN,pobj,compound-compound,NNP,NNP-NNP,8,1
1411,55466.0,58,splitting,15,30,2,-28,29,55,-15,-13,Covidien,Tyco Healthcare,ORGANIZATION,ORGANIZATION-ORGANIZATION,PROPN,PROPN-PROPN,oprd,compound-appos,NNP,NNP-NNP,4,1
1412,61312.0,26,include,15,17,20,3,16,5,-2,5,Covidien,Tyco Healthcare,ORGANIZATION,ORGANIZATION-ORGANIZATION,PROPN,PROPN-PROPN,dobj,compound-appos,NNP,NNP-NNP,2,1
1413,2297.0,36,Bank,2,1,5,4,0,30,1,3,Asian Development Bank,http://wwwadborg/,ORGANIZATION-ORGANIZATION-ORGANIZATION,URL,PROPN-PROPN-PROPN,PROPN,compound-compound-ROOT,compound,NNP-NNP-NNP,NNP,3,1
1414,2298.0,36,survived,12,11,9,-2,10,26,1,-3,Forsberg,N.Y.,PERSON,STATE_OR_PROVINCE,PROPN,PROPN,nsubjpass,appos,NNP,NNP,6,1
1415,2300.0,20,insures,8,8,5,-3,7,14,0,-3,MBIA,New York,ORGANIZATION,STATE_OR_PROVINCE-STATE_OR_PROVINCE,PROPN,PROPN-PROPN,nsubj,compound-npadvmod,NNP,NNP-NNP,2,1
1416,25051.0,24,returned,20,6,16,10,5,7,14,-4,MBIA,New York,ORGANIZATION,STATE_OR_PROVINCE-STATE_OR_PROVINCE,PROPN,PROPN-PROPN,compound,compound-appos,NNP,NNP-NNP,7,1
1417,2309.0,41,Rothman,3,4,18,14,3,22,-1,15,Rothman,Los Angeles Feminist Women 's Health Center,PERSON,ORGANIZATION-ORGANIZATION-ORGANIZATION-ORGANIZATION-ORGANIZATION-ORGANIZATION-ORGANIZATION,PROPN,PROPN-PROPN-PROPN-PROPN-PART-PROPN-PROPN,ROOT,compound-compound-compound-poss-case-compound-appos,NNP,NNP-NNP-NNP-NNPS-POS-NNP-NNP,6,1
1418,2313.0,27,said,22,19,21,2,18,5,3,-1,FirstGroup,Martin Gilbert,ORGANIZATION,PERSON-PERSON,PROPN,PROPN-PROPN,compound,compound-nsubj,NNP,NNP-NNP,3,1
1419,2323.0,32,halted,24,6,10,4,5,21,18,-14,Ownit Mortgage Solutions,Agoura Hills,ORGANIZATION-ORGANIZATION-ORGANIZATION,CITY-CITY,PROPN-PROPN-PROPN,PROPN-PROPN,compound-compound-nsubj,compound-pobj,NNP-NNP-NNPS,NNP-NNP,3,1
1420,9879.0,47,was,1,12,16,4,11,30,-11,15,Ownit Mortgage Solutions,Agoura Hills,ORGANIZATION-ORGANIZATION-ORGANIZATION,CITY-CITY,PROPN-PROPN-PROPN,PROPN-PROPN,compound-compound-nsubj,compound-pobj,NNP-NNP-NNPS,NNP-NNP,3,1
1421,36108.0,22,provides,17,5,13,8,4,8,12,-4,Ownit Mortgage Solutions,Agoura Hills,ORGANIZATION-ORGANIZATION-ORGANIZATION,CITY-CITY,PROPN-PROPN-PROPN,PROPN-PROPN,compound-compound-pobj,compound-pobj,NNP-NNP-NNPS,NNP-NNP,5,1
1422,57515.0,25,be,2,15,11,-4,14,13,-13,9,Ownit Mortgage Solutions,Agoura Hills,ORGANIZATION-ORGANIZATION-ORGANIZATION,CITY-CITY,PROPN-PROPN-PROPN,PROPN-PROPN,compound-compound-compound,compound-pobj,NNP-NNP-NNPS,NNP-NNP,4,1
1423,2326.0,29,is,2,18,13,-5,17,15,-16,11,he,United States,PERSON,COUNTRY-COUNTRY,PRON,PROPN-PROPN,nsubj,compound-compound,PRP,NNP-NNP,6,1
1424,28189.0,37,said,35,20,30,10,19,6,15,-5,he,United States,PERSON,COUNTRY-COUNTRY,PRON,PROPN-PROPN,nsubj,compound-pobj,PRP,NNP-NNP,7,1
1425,2342.0,44,said,13,22,15,-7,21,28,-9,2,Servicemembers Legal Defense Network,Aubrey Sarvis,ORGANIZATION-ORGANIZATION-ORGANIZATION-ORGANIZATION,PERSON-PERSON,PROPN-PROPN-PROPN-PROPN,PROPN-PROPN,compound-compound-compound-pobj,compound-nsubj,NNP-NNP-NNP-NNP,NNP-NNP,5,1
1426,10463.0,39,said,24,33,26,-7,32,12,-9,2,Servicemembers Legal Defense Network,Aubrey Sarvis,ORGANIZATION-ORGANIZATION-ORGANIZATION-ORGANIZATION,PERSON-PERSON,PROPN-PROPN-PROPN-PROPN,PROPN-PROPN,nmod-compound-compound-compound,compound-nsubj,NNP-NNP-NNP-NNP,NNP-NNP,3,1
1427,12598.0,35,says,14,22,16,-6,21,18,-8,2,Servicemembers Legal Defense Network,Aubrey Sarvis,ORGANIZATION-ORGANIZATION-ORGANIZATION-ORGANIZATION,PERSON-PERSON,PROPN-PROPN-PROPN-PROPN,PROPN-PROPN,compound-compound-compound-appos,compound-nsubj,NNP-NNP-NNP-NNP,NNP-NNP,4,1
1428,16365.0,50,said,37,46,39,-7,45,10,-9,2,Servicemembers Legal Defense Network,Aubrey Sarvis,ORGANIZATION-ORGANIZATION-ORGANIZATION-ORGANIZATION,PERSON-PERSON,PROPN-PROPN-PROPN-PROPN,PROPN-PROPN,compound-compound-compound-pobj,compound-nsubj,NNP-NNP-NNP-NNP,NNP-NNP,5,1
1429,20686.0,36,said,20,29,22,-7,28,13,-9,2,Servicemembers Legal Defense Network,Aubrey Sarvis,ORGANIZATION-ORGANIZATION-ORGANIZATION-ORGANIZATION,PERSON-PERSON,PROPN-PROPN-PROPN-PROPN,PROPN-PROPN,compound-compound-compound-pobj,compound-nsubj,NNP-NNP-NNP-NNP,NNP-NNP,5,1
1430,21477.0,32,says,7,1,6,5,0,25,6,-1,Servicemembers Legal Defense Network,Aubrey Sarvis,ORGANIZATION-ORGANIZATION-ORGANIZATION-ORGANIZATION,PERSON-PERSON,PROPN-PROPN-PROPN-PROPN,PROPN-PROPN,compound-compound-compound-compound,compound-nsubj,NNP-NNP-NNP-NNP,NNP-NNP,3,1
1431,24254.0,60,said,28,37,30,-7,36,29,-9,2,Servicemembers Legal Defense Network,Aubrey Sarvis,ORGANIZATION-ORGANIZATION-ORGANIZATION-ORGANIZATION,PERSON-PERSON,PROPN-PROPN-PROPN-PROPN,PROPN-PROPN,compound-compound-compound-pobj,compound-nsubj,NNP-NNP-NNP-NNP,NNP-NNP,5,1
1432,31603.0,25,said,13,21,15,-6,20,9,-8,2,Servicemembers Legal Defense Network,Aubrey Sarvis,ORGANIZATION-ORGANIZATION-ORGANIZATION-ORGANIZATION,PERSON-PERSON,PROPN-PROPN-PROPN-PROPN,PROPN-PROPN,compound-compound-compound-pobj,compound-nsubj,NNP-NNP-NNP-NNP,NNP-NNP,5,1
1433,31651.0,38,said,14,7,13,6,6,24,7,-1,Servicemembers Legal Defense Network,Aubrey Sarvis,ORGANIZATION-ORGANIZATION-ORGANIZATION-ORGANIZATION,PERSON-PERSON,PROPN-PROPN-PROPN-PROPN,PROPN-PROPN,compound-compound-compound-compound,compound-appos,NNP-NNP-NNP-NNP,NNP-NNP,4,1
1434,37248.0,37,said,12,21,14,-7,20,22,-9,2,Servicemembers Legal Defense Network,Aubrey Sarvis,ORGANIZATION-ORGANIZATION-ORGANIZATION-ORGANIZATION,PERSON-PERSON,PROPN-PROPN-PROPN-PROPN,PROPN-PROPN,compound-compound-compound-pobj,compound-nsubj,NNP-NNP-NNP-NNP,NNP-NNP,5,1
1435,37446.0,54,said,7,1,6,5,0,47,6,-1,Servicemembers Legal Defense Network,Aubrey Sarvis,ORGANIZATION-ORGANIZATION-ORGANIZATION-ORGANIZATION,PERSON-PERSON,PROPN-PROPN-PROPN-PROPN,PROPN-PROPN,compound-compound-compound-compound,compound-nsubj,NNP-NNP-NNP-NNP,NNP-NNP,3,1
1436,38557.0,57,said,34,43,36,-7,42,20,-9,2,Servicemembers Legal Defense Network,Aubrey Sarvis,ORGANIZATION-ORGANIZATION-ORGANIZATION-ORGANIZATION,PERSON-PERSON,PROPN-PROPN-PROPN-PROPN,PROPN-PROPN,compound-compound-compound-pobj,compound-nsubj,NNP-NNP-NNP-NNP,NNP-NNP,5,1
1437,38586.0,34,said,16,24,18,-6,23,15,-8,2,Servicemembers Legal Defense Network,Aubrey Sarvis,ORGANIZATION-ORGANIZATION-ORGANIZATION-ORGANIZATION,PERSON-PERSON,PROPN-PROPN-PROPN-PROPN,PROPN-PROPN,compound-compound-compound-pobj,compound-nsubj,NNP-NNP-NNP-NNP,NNP-NNP,5,1
1438,39587.0,48,said,35,44,37,-7,43,10,-9,2,Servicemembers Legal Defense Network,Aubrey Sarvis,ORGANIZATION-ORGANIZATION-ORGANIZATION-ORGANIZATION,PERSON-PERSON,PROPN-PROPN-PROPN-PROPN,PROPN-PROPN,compound-compound-compound-pobj,compound-nsubj,NNP-NNP-NNP-NNP,NNP-NNP,5,1
1439,42595.0,44,said,28,40,33,-7,39,10,-12,5,Servicemembers Legal Defense Network,Aubrey Sarvis,ORGANIZATION-ORGANIZATION-ORGANIZATION-ORGANIZATION,PERSON-PERSON,PROPN-PROPN-PROPN-PROPN,PROPN-PROPN,compound-compound-compound-pobj,compound-nsubj,NNP-NNP-NNP-NNP,NNP-NNP,5,1
1440,48714.0,54,said,38,50,40,-10,49,13,-12,2,Servicemembers Legal Defense Network,Aubrey Sarvis,ORGANIZATION-ORGANIZATION-ORGANIZATION-ORGANIZATION,PERSON-PERSON,PROPN-PROPN-PROPN-PROPN,PROPN-PROPN,compound-compound-compound-pobj,compound-nsubj,NNP-NNP-NNP-NNP,NNP-NNP,5,1
1441,52094.0,29,called,12,8,1,-7,7,27,4,-11,Servicemembers Legal Defense Network,Aubrey Sarvis,ORGANIZATION-ORGANIZATION-ORGANIZATION-ORGANIZATION,PERSON-PERSON,PROPN-PROPN-PROPN-PROPN,PROPN-PROPN,compound-compound-compound-pobj,compound-nsubj,NNP-NNP-NNP-NNP,NNP-NNP,5,1
1442,2343.0,50,said,27,36,42,6,35,7,-9,15,MECO,Taiwan,ORGANIZATION,COUNTRY,NOUN,PROPN,pobj,pobj,NNS,NNP,5,1
1443,6534.0,42,expressed,21,8,17,9,7,24,13,-4,MECO,Taiwan,ORGANIZATION,COUNTRY,NOUN,PROPN,pobj,pobj,NNS,NNP,4,1
1444,6566.0,63,said,29,47,6,-41,46,56,-18,-23,MECO,Taiwan,ORGANIZATION,COUNTRY,PROPN,PROPN,compound,pobj,NNP,NNP,2,1
1445,31656.0,45,celebrated,11,8,33,25,7,11,3,22,MECO,Taiwan,ORGANIZATION,COUNTRY,PROPN,PROPN,compound,conj,NNP,NNP,-1,1
1446,51792.0,35,appealed,12,8,15,7,7,19,4,3,MECO,Taiwan,ORGANIZATION,COUNTRY,PROPN,PROPN,compound,nmod,NNP,NNP,-1,1
1447,63976.0,30,is,1,1,18,17,0,11,0,17,MECO,Taiwan,ORGANIZATION,COUNTRY,PROPN,PROPN,nsubj,conj,NNP,NNP,7,1
1448,2348.0,45,founded,11,30,37,7,29,7,-19,26,Sean Parker,founder,PERSON-PERSON,TITLE,PROPN-PROPN,NOUN,compound-conj,attr,NNP-NNP,NN,5,1
1449,2350.0,47,buttressed,5,16,15,-1,15,31,-11,10,Al Hubbard,Chairman,PERSON-PERSON,TITLE,PROPN-PROPN,PROPN,compound-pobj,compound,NNP-NNP,NNP,1,1
1450,2352.0,9,be,2,1,5,4,0,3,1,3,She,assistant,PERSON,TITLE,PRON,NOUN,nsubj,attr,PRP,NN,3,1
1451,40807.0,18,get,3,1,9,8,0,8,2,6,She,assistant,PERSON,TITLE,PRON,VERB,nsubj,acl,PRP,VB,5,1
1452,2358.0,25,said,5,3,2,-1,2,22,2,-3,Chen Zhu,Minister,PERSON-PERSON,TITLE,PROPN-PROPN,PROPN,compound-nsubj,compound,NNP-NNP,NNP,1,1
1453,8525.0,38,offered,19,18,17,-1,17,20,1,-2,Chen Zhu,Minister,PERSON-PERSON,TITLE,PROPN-PROPN,PROPN,compound-nsubj,compound,NNP-NNP,NNP,1,1
1454,9046.0,39,said,17,16,15,-1,15,23,1,-2,Chen Zhu,Minister,PERSON-PERSON,TITLE,PROPN-PROPN,PROPN,compound-nsubj,compound,NNP-NNP,NNP,1,1
1455,9610.0,26,told,21,20,19,-1,19,6,1,-2,Chen Zhu,Minister,PERSON-PERSON,TITLE,PROPN-PROPN,PROPN,compound-nsubj,compound,NNP-NNP,NNP,1,1
1456,16936.0,28,adds,3,14,13,-1,13,14,-11,10,Chen Zhu,Minister,PERSON-PERSON,TITLE,PROPN-PROPN,PROPN,compound-pobj,compound,NNP-NNP,NNP,1,1
1457,18266.0,37,donated,16,3,2,-1,2,34,13,-14,Chen Zhu,Minister,PERSON-PERSON,TITLE,PROPN-PROPN,PROPN,compound-nsubj,compound,NNP-NNP,NNP,1,1
1458,25615.0,17,said,6,4,3,-1,3,13,2,-3,Chen Zhu,Minister,PERSON-PERSON,TITLE,PROPN-PROPN,PROPN,compound-nsubj,compound,NNP-NNP,NNP,1,1
1459,30961.0,39,came,3,9,8,-1,8,30,-6,5,Chen Zhu,Minister,PERSON-PERSON,TITLE,PROPN-PROPN,PROPN,compound-nsubj,compound,NNP-NNP,NNP,1,1
1460,35327.0,45,hold,5,13,12,-1,12,32,-8,7,Chen Zhu,Minister,PERSON-PERSON,TITLE,PROPN-PROPN,PROPN,compound-conj,compound,NNP-NNP,NNP,1,1
1461,37017.0,41,said,38,37,36,-1,36,4,1,-2,Chen Zhu,Minister,PERSON-PERSON,TITLE,PROPN-PROPN,PROPN,compound-nsubj,compound,NNP-NNP,NNP,1,1
1462,39711.0,24,quoted,13,17,16,-1,16,7,-4,3,Chen Zhu,Minister,PERSON-PERSON,TITLE,PROPN-PROPN,PROPN,compound-dobj,compound,NNP-NNP,NNP,3,1
1463,40334.0,34,chair,7,32,3,-29,31,30,-25,-4,Chen Zhu,Minister,PERSON-PERSON,TITLE,PROPN-PROPN,PROPN,compound-pobj,compound,NNP-NNP,NNP,6,1
1464,40521.0,57,said,22,21,20,-1,20,36,1,-2,Chen Zhu,Minister,PERSON-PERSON,TITLE,PROPN-PROPN,PROPN,compound-nsubj,compound,NNP-NNP,NNP,1,1
1465,41315.0,27,said,25,8,7,-1,7,19,17,-18,Chen Zhu,Minister,PERSON-PERSON,TITLE,PROPN-PROPN,PROPN,compound-pobj,compound,NNP-NNP,NNP,1,1
1466,48246.0,33,are,4,16,9,-7,15,23,-12,5,Chen Zhu,Minister,PERSON-PERSON,TITLE,PROPN-PROPN,PROPN,compound-conj,appos,NNP-NNP,NNP,3,1
1467,52098.0,22,warned,4,3,2,-1,2,19,1,-2,Chen Zhu,Minister,PERSON-PERSON,TITLE,PROPN-PROPN,PROPN,compound-nsubj,compound,NNP-NNP,NNP,1,1
1468,58559.0,35,reported,7,6,5,-1,5,29,1,-2,Chen Zhu,Minister,PERSON-PERSON,TITLE,PROPN-PROPN,PROPN,compound-nsubj,compound,NNP-NNP,NNP,1,1
1469,59116.0,29,said,20,25,22,-3,24,6,-5,2,Chen Zhu,Minister,PERSON-PERSON,TITLE,PROPN-PROPN,PROPN,compound-nsubj,nmod,NNP-NNP,NNP,4,1
1470,62919.0,28,told,4,3,2,-1,2,25,1,-2,Chen Zhu,Minister,PERSON-PERSON,TITLE,PROPN-PROPN,PROPN,compound-nsubj,compound,NNP-NNP,NNP,1,1
1471,63716.0,34,are,4,18,17,-1,17,16,-14,13,Chen Zhu,Minister,PERSON-PERSON,TITLE,PROPN-PROPN,PROPN,compound-nsubjpass,compound,NNP-NNP,NNP,2,1
1472,65597.0,23,said,4,3,2,-1,2,20,1,-2,Chen Zhu,Minister,PERSON-PERSON,TITLE,PROPN-PROPN,PROPN,compound-nsubj,compound,NNP-NNP,NNP,1,1
1473,2359.0,88,are,1,39,47,8,38,40,-38,46,Jennifer Dunn,Washington,PERSON-PERSON,STATE_OR_PROVINCE,PROPN-PROPN,PROPN,compound-conj,compound,NNP-NNP,NNP,3,1
1474,13314.0,30,said,28,3,9,6,2,20,25,-19,Jennifer Dunn,Washington,PERSON-PERSON,STATE_OR_PROVINCE,PROPN-PROPN,PROPN,compound-nsubj,compound,NNP-NNP,NNP,2,1
1475,47528.0,69,include,5,23,27,4,22,41,-18,22,Jennifer Dunn,Washington,PERSON-PERSON,STATE_OR_PROVINCE,PROPN-PROPN,PROPN,compound-appos,compound,NNP-NNP,NNP,2,1
1476,58215.0,47,died,32,1,5,4,0,41,31,-27,Jennifer Dunn,Washington,PERSON-PERSON,STATE_OR_PROVINCE,PROPN-PROPN,PROPN,compound-nsubj,compound,NNP-NNP,NNP,2,1
1477,2360.0,31,said,8,25,10,-15,24,20,-17,2,Marywood University,Kenneth W. Rundell,ORGANIZATION-ORGANIZATION,PERSON-PERSON-PERSON,PROPN-PROPN,PROPN-PROPN-PROPN,compound-pobj,compound-compound-nsubj,NNP-NNP,NNP-NNP-NNP,5,1
1478,50682.0,39,said,17,33,19,-14,32,19,-16,2,Marywood University,Kenneth W. Rundell,ORGANIZATION-ORGANIZATION,PERSON-PERSON-PERSON,PROPN-PROPN,PROPN-PROPN-PROPN,compound-pobj,compound-compound-nsubj,NNP-NNP,NNP-NNP-NNP,4,1
1479,2362.0,37,Profeile,0,6,10,4,5,26,-6,10,Hugo Chavez,Roman Catholic,PERSON-PERSON,RELIGION-RELIGION,PROPN-PROPN,PROPN-PROPN,compound-ROOT,compound-pobj,NNP-NNP,NNP-NNP,3,1
1480,2365.0,49,seen,3,2,10,8,1,38,1,7,she,McComb,PERSON,CITY,PRON,PROPN,nsubjpass,pobj,PRP,NNP,2,1
1481,2367.0,24,entered,8,1,19,18,0,4,7,11,FirstGroup,Ryder Public Transportation Services Inc.,ORGANIZATION,ORGANIZATION-ORGANIZATION-ORGANIZATION-ORGANIZATION-ORGANIZATION,PROPN,PROPN-PROPN-PROPN-PROPN-PROPN,nsubj,compound-compound-compound-compound-dobj,NNP,NNP-NNP-NNP-NNPS-NNP,5,1
1482,2369.0,32,said,1,1,12,11,0,19,0,11,Sadia,Aracruz,ORGANIZATION,LOCATION,PROPN,PROPN,nsubj,compound,NNP,NNP,4,1
1483,2374.0,15,Maloney,2,2,1,-1,1,13,0,-1,Carolyn Maloney,Rep.,PERSON-PERSON,TITLE,PROPN-PROPN,PROPN,compound-ROOT,compound,NNP-NNP,NNP,1,1
1484,5034.0,36,responded,13,9,8,-1,8,27,4,-5,Carolyn Maloney,Rep.,PERSON-PERSON,TITLE,PROPN-PROPN,PROPN,compound-conj,compound,NNP-NNP,NNP,3,1
1485,12673.0,32,raised,21,2,1,-1,1,30,19,-20,Carolyn Maloney,Rep.,PERSON-PERSON,TITLE,PROPN-PROPN,PROPN,compound-nsubj,compound,NNP-NNP,NNP,1,1
1486,21837.0,17,asked,0,3,2,-1,2,14,-3,2,Carolyn Maloney,Rep.,PERSON-PERSON,TITLE,PROPN-PROPN,PROPN,compound-nsubj,compound,NNP-NNP,NNP,1,1
1487,28756.0,12,introduced,8,2,1,-1,1,10,6,-7,Carolyn Maloney,Rep.,PERSON-PERSON,TITLE,PROPN-PROPN,PROPN,compound-nsubj,compound,NNP-NNP,NNP,1,1
1488,32094.0,6,Written,0,4,3,-1,3,2,-4,3,Carolyn Maloney,Rep.,PERSON-PERSON,TITLE,PROPN-PROPN,PROPN,compound-pobj,compound,NNP-NNP,NNP,1,1
1489,51654.0,46,show,44,2,1,-1,1,44,42,-43,Carolyn Maloney,Rep.,PERSON-PERSON,TITLE,PROPN-PROPN,PROPN,compound-nsubj,compound,NNP-NNP,NNP,1,1
1490,59037.0,36,create,15,4,3,-1,3,32,11,-12,Carolyn Maloney,Rep.,PERSON-PERSON,TITLE,PROPN-PROPN,PROPN,compound-pobj,compound,NNP-NNP,NNP,1,1
1491,2375.0,43,voted,7,21,7,-14,20,35,-14,0,Ospel,UBS,PERSON,ORGANIZATION,PROPN,PROPN,dobj,pobj,NNP,NNP,5,1
1492,4296.0,32,stood,20,5,9,4,4,22,15,-11,Ospel,UBS,PERSON,ORGANIZATION,PROPN,PROPN,dobj,pobj,NNP,NNP,2,1
1493,8347.0,36,hope,2,5,1,-4,4,34,-3,-1,Ospel,UBS,PERSON,ORGANIZATION,PROPN,PROPN,poss,nsubj,NNP,NNP,5,1
1494,19729.0,23,said,19,7,11,4,6,11,12,-8,Ospel,UBS,PERSON,ORGANIZATION,PROPN,PROPN,poss,nsubj,NNP,NNP,4,1
1495,26217.0,24,joined,9,4,8,4,3,15,5,-1,Ospel,UBS,PERSON,ORGANIZATION,PROPN,PROPN,poss,nsubj,NNP,NNP,5,1
1496,35802.0,35,made,19,6,9,3,5,25,13,-10,Ospel,UBS,PERSON,ORGANIZATION,PROPN,PROPN,nsubj,nsubj,NNP,NNP,2,1
1497,63597.0,32,shocked,2,24,9,-15,23,22,-22,7,Ospel,UBS,PERSON,ORGANIZATION,PROPN,PROPN,nsubj,compound,NNP,NNP,7,1
1498,67625.0,47,stand,23,1,40,39,0,6,22,17,Ospel,UBS,PERSON,ORGANIZATION,PROPN,PROPN,nsubj,poss,NNP,NNP,4,1
1499,2388.0,43,won,11,1,4,3,0,38,10,-7,Flowers,attorney general,PERSON,TITLE-TITLE,PROPN,NOUN-NOUN,nsubj,compound-oprd,NNPS,NN-NN,2,1
1500,22000.0,52,took,5,5,2,-3,4,49,0,-3,Flowers,attorney general,PERSON,TITLE-TITLE,PROPN,NOUN-NOUN,nsubj,compound-pobj,NNP,NN-NN,2,1
1501,32820.0,52,took,5,5,2,-3,4,49,0,-3,Flowers,attorney general,PERSON,TITLE-TITLE,PROPN,NOUN-NOUN,nsubj,compound-pobj,NNP,NN-NN,2,1
1502,46577.0,43,won,11,1,4,3,0,38,10,-7,Flowers,attorney general,PERSON,TITLE-TITLE,NOUN,NOUN-NOUN,nsubjpass,compound-oprd,NNS,NN-NN,2,1
1503,50576.0,36,accused,5,4,34,30,3,1,1,29,Flowers,attorney general,PERSON,TITLE-TITLE,PROPN,NOUN-ADJ,nsubjpass,compound-acomp,NNP,NN-JJ,14,1
1504,57597.0,36,accused,5,4,34,30,3,1,1,29,Flowers,attorney general,PERSON,TITLE-TITLE,PROPN,NOUN-ADJ,nsubj,compound-acomp,NNP,NN-JJ,14,1
1505,2392.0,32,considered,21,10,2,-8,9,29,11,-19,IMF,United States,ORGANIZATION,COUNTRY-COUNTRY,PROPN,PROPN-PROPN,pobj,compound-nsubjpass,NNP,NNP-NNP,3,1
1506,2393.0,35,founded,1,1,27,26,0,7,0,26,Forsberg,advisor,PERSON,TITLE,PROPN,NOUN,nsubj,pobj,NNP,NN,5,1
1507,2394.0,30,said,23,28,25,-3,27,4,-5,2,Mohamed ElBaradei,IAEA,PERSON-PERSON,ORGANIZATION,PROPN-PROPN,PROPN,compound-nsubj,compound,NNP-NNP,NNP,4,1
1508,3106.0,37,meeting,10,17,15,-2,16,21,-7,5,Mohamed ElBaradei,IAEA,PERSON-PERSON,ORGANIZATION,PROPN-PROPN,PROPN,compound-pobj,compound,NNP-NNP,NNP,1,1
1509,22448.0,16,IAEA,0,3,1,-2,2,14,-3,1,Mohamed ElBaradei,IAEA,PERSON-PERSON,ORGANIZATION,PROPN-PROPN,PROPN,compound-nsubj,ROOT,NNP-NNP,NNP,1,1
1510,22505.0,49,issued,5,4,2,-2,3,46,1,-3,Mohamed ElBaradei,IAEA,PERSON-PERSON,ORGANIZATION,PROPN-PROPN,PROPN,compound-nsubj,advcl,NNP-NNP,NNP,1,1
1511,22583.0,52,spoke,15,30,28,-2,29,23,-15,13,Mohamed ElBaradei,IAEA,PERSON-PERSON,ORGANIZATION,PROPN-PROPN,PROPN,compound-pobj,nmod,NNP-NNP,NNP,1,1
1512,29494.0,30,told,10,9,7,-2,8,22,1,-3,Mohamed ElBaradei,IAEA,PERSON-PERSON,ORGANIZATION,PROPN-PROPN,PROPN,compound-nsubj,compound,NNP-NNP,NNP,1,1
1513,51117.0,42,staged,7,24,2,-22,23,39,-17,-5,Mohamed ElBaradei,IAEA,PERSON-PERSON,ORGANIZATION,PROPN-PROPN,PROPN,compound-pobj,compound,NNP-NNP,NNP,9,1
1514,54419.0,48,said,45,44,42,-2,43,5,1,-3,Mohamed ElBaradei,IAEA,PERSON-PERSON,ORGANIZATION,PROPN-PROPN,PROPN,compound-nsubj,compound,NNP-NNP,NNP,1,1
1515,57000.0,51,Vienna-based,0,10,7,-3,9,43,-10,7,Mohamed ElBaradei,IAEA,PERSON-PERSON,ORGANIZATION,PROPN-PROPN,PROPN,compound-nsubj,advcl,NNP-NNP,NNP,3,1
1516,57057.0,54,need,22,34,45,11,33,8,-12,23,Mohamed ElBaradei,IAEA,PERSON-PERSON,ORGANIZATION,PROPN-PROPN,PROPN,compound-dobj,ccomp,NNP-NNP,NNP,3,1
1517,57519.0,36,said,4,3,1,-2,2,34,1,-3,Mohamed ElBaradei,IAEA,PERSON-PERSON,ORGANIZATION,PROPN-PROPN,PROPN,compound-nsubj,amod,NNP-NNP,NNP,1,1
1518,58082.0,24,said,22,3,1,-2,2,22,19,-21,Mohamed ElBaradei,IAEA,PERSON-PERSON,ORGANIZATION,PROPN-PROPN,PROPN,compound-dobj,ccomp,NNP-NNP,NNP,1,1
1519,2395.0,33,said,13,11,15,4,10,17,2,2,Vietnam Economic and Cultural Office,Pham Manh Hai,ORGANIZATION-ORGANIZATION-ORGANIZATION-ORGANIZATION-ORGANIZATION,PERSON-PERSON-PERSON,PROPN-PROPN-CCONJ-PROPN-PROPN,PROPN-PROPN-PROPN,nmod-nmod-cc-conj-pobj,compound-compound-nsubj,NNP-NNP-CC-NNP-NNP,NNP-NNP-NNP,3,1
1520,2397.0,32,inherited,6,21,16,-5,20,15,-15,10,Carnival Cruise Lines,Ted Arison,ORGANIZATION-ORGANIZATION-ORGANIZATION,PERSON-PERSON,PROPN-PROPN-NOUN,PROPN-PROPN,compound-compound-dobj,compound-appos,NNP-NNP-NNS,NNP-NNP,3,1
1521,60279.0,52,retiring,5,1,20,19,0,31,4,15,Carnival Cruise Lines,Ted Arison,ORGANIZATION-ORGANIZATION-ORGANIZATION,PERSON-PERSON,PROPN-PROPN-VERB,PROPN-PROPN,compound-compound-compound,compound-pobj,NNP-NNP-VBZ,NNP-NNP,8,1
1522,2398.0,45,urged,9,6,42,36,5,2,3,33,PRC,Mahmoud Abbas,ORGANIZATION,PERSON-PERSON,PROPN,PROPN-PROPN,compound,compound-pobj,NNP,NNP-NNP,-1,1
1523,2404.0,39,died,28,1,38,37,0,0,27,10,Bradford Washburn,Mass.,PERSON-PERSON,STATE_OR_PROVINCE,PROPN-PROPN,PROPN,compound-nsubj,appos,NNP-NNP,NNP,2,1
1524,2406.0,49,opened,21,37,1,-36,36,47,-16,-20,Harry Dent,AdvisorShares Investments,PERSON-PERSON,ORGANIZATION-ORGANIZATION,PROPN-PROPN,PROPN-PROPN,compound-pobj,compound-nsubj,NNP-NNP,NNP-NNP,3,1
1525,2409.0,30,filed,10,21,26,5,20,3,-11,16,National Beef Packing Co.,Kansas City,ORGANIZATION-ORGANIZATION-ORGANIZATION-ORGANIZATION,CITY-CITY,PROPN-PROPN-PROPN-PROPN,PROPN-PROPN,compound-compound-compound-conj,compound-pobj,NNP-NNP-NNP-NNP,NNP-NNP,3,1
1526,16110.0,41,said,4,32,37,5,31,3,-28,33,National Beef Packing Co.,Kansas City,ORGANIZATION-ORGANIZATION-ORGANIZATION-ORGANIZATION,CITY-CITY,PROPN-PROPN-PROPN-PROPN,PROPN-PROPN,compound-compound-compound-appos,compound-pobj,NNP-NNP-NNP-NNP,NNP-NNP,3,1
1527,27121.0,16,returned,14,5,10,5,4,5,9,-4,National Beef Packing Co.,Kansas City,ORGANIZATION-ORGANIZATION-ORGANIZATION-ORGANIZATION,CITY-CITY,PROPN-PROPN-PROPN-PROPN,PROPN-PROPN,compound-compound-compound-pobj,compound-pobj,NNP-NNP-NNP-NNP,NNP-NNP,3,1
1528,2410.0,13,chosen,7,5,4,-1,4,8,2,-3,Kurt Waldheim,diplomat,PERSON-PERSON,TITLE,PROPN-PROPN,NOUN,compound-nsubjpass,compound,NNP-NNP,NN,1,1
1529,2414.0,32,has,6,2,19,17,1,12,4,13,Paul Gillmor,Ohio,PERSON-PERSON,STATE_OR_PROVINCE,PROPN-PROPN,PROPN,compound-nsubj,pobj,NNP-NNP,NNP,4,1
1530,11731.0,20,said,18,3,6,3,2,13,15,-12,Paul Gillmor,Ohio,PERSON-PERSON,STATE_OR_PROVINCE,PROPN-PROPN,PROPN,compound-nsubjpass,pobj,NNP-NNP,NNP,2,1
1531,21538.0,20,Gillmor,6,6,4,-2,5,15,0,-2,Paul Gillmor,Ohio,PERSON-PERSON,STATE_OR_PROVINCE,PROPN-PROPN,PROPN,compound-ROOT,compound,NNP-NNP,NNP,1,1
1532,26687.0,46,COLUMBUS,0,7,3,-4,6,42,-7,3,Paul Gillmor,Ohio,PERSON-PERSON,STATE_OR_PROVINCE,PROPN-PROPN,PROPN,compound-nsubj,compound,NNP-NNP,NNP,3,1
1533,28842.0,42,choosing,11,28,10,-18,27,31,-17,-1,Paul Gillmor,Ohio,PERSON-PERSON,STATE_OR_PROVINCE,PROPN-PROPN,PROPN,compound-dobj,pobj,NNP-NNP,NNP,3,1
1534,39133.0,18,said,16,3,1,-2,2,16,13,-15,Paul Gillmor,Ohio,PERSON-PERSON,STATE_OR_PROVINCE,PROPN-PROPN,PROPN,compound-nsubjpass,compound,NNP-NNP,NNP,1,1
1535,39355.0,20,said,18,3,6,3,2,13,15,-12,Paul Gillmor,Ohio,PERSON-PERSON,STATE_OR_PROVINCE,PROPN-PROPN,PROPN,compound-nsubjpass,pobj,NNP-NNP,NNP,2,1
1536,65921.0,46,introduced,20,10,14,4,9,31,10,-6,Paul Gillmor,Ohio,PERSON-PERSON,STATE_OR_PROVINCE,PROPN-PROPN,PROPN,compound-conj,compound,NNP-NNP,NNP,3,1
1537,2419.0,32,has,1,18,1,-17,17,30,-17,0,Madoff Securities,RMF,ORGANIZATION-ORGANIZATION,ORGANIZATION,PROPN-PROPN,PROPN,compound-pobj,nsubj,NNP-NNPS,NNP,6,1
1538,2422.0,43,be,12,27,41,14,26,1,-15,29,IMF,Spain,ORGANIZATION,COUNTRY,PROPN,PROPN,pobj,conj,NNP,NNP,13,1
1539,2423.0,53,said,34,14,12,-2,13,40,20,-22,Afghan National Police,ANP,ORGANIZATION-ORGANIZATION-ORGANIZATION,ORGANIZATION,PROPN-PROPN-PROPN,PROPN,compound-compound-compound,compound,NNP-NNP-NNPS,NNP,3,1
1540,61754.0,31,stands,7,10,6,-4,9,24,-3,-1,Afghan National Police,ANP,ORGANIZATION-ORGANIZATION-ORGANIZATION,ORGANIZATION,PROPN-PROPN-PROPN,PROPN,compound-compound-pobj,appos,NNP-NNP-NNPS,NNP,4,1
1541,2425.0,34,announced,32,1,32,31,0,1,31,0,David Gregory,NBC,PERSON-PERSON,ORGANIZATION,PROPN-PROPN,PROPN,compound-nsubjpass,nsubj,NNP-NNP,NNP,12,1
1542,3740.0,8,buying,6,3,1,-2,2,6,3,-5,David Gregory,NBC,PERSON-PERSON,ORGANIZATION,PROPN-PROPN,PROPN,compound-nsubj,poss,NNP-NNP,NNP,2,1
1543,8873.0,33,names,1,3,1,-2,2,31,-2,0,David Gregory,NBC,PERSON-PERSON,ORGANIZATION,PROPN-PROPN,PROPN,compound-compound,compound,NNP-NNP,NNP,1,1
1544,16674.0,19,chided,1,5,3,-2,4,15,-4,2,David Gregory,NBC,PERSON-PERSON,ORGANIZATION,PROPN-PROPN,PROPN,compound-dobj,poss,NNP-NNP,NNP,2,1
1545,20369.0,36,said,6,5,1,-4,4,34,1,-5,David Gregory,NBC,PERSON-PERSON,ORGANIZATION,PROPN-PROPN,PROPN,compound-nsubj,nsubj,NNP-NNP,NNP,3,1
1546,31994.0,45,said,1,12,10,-2,11,34,-11,9,David Gregory,NBC,PERSON-PERSON,ORGANIZATION,PROPN-PROPN,PROPN,compound-pobj,compound,NNP-NNP,NNP,1,1
1547,33987.0,24,told,12,16,14,-2,15,9,-4,2,David Gregory,NBC,PERSON-PERSON,ORGANIZATION,PROPN-PROPN,PROPN,compound-dobj,poss,NNP-NNP,NNP,2,1
1548,42284.0,31,hedged,13,12,6,-6,11,24,1,-7,David Gregory,NBC,PERSON-PERSON,ORGANIZATION,PROPN-PROPN,PROPN,compound-pobj,compound,NNP-NNP,NNP,6,1
1549,44669.0,16,asked,4,3,1,-2,2,14,1,-3,David Gregory,NBC,PERSON-PERSON,ORGANIZATION,PROPN-PROPN,PROPN,compound-nsubj,poss,NNP-NNP,NNP,2,1
1550,46793.0,31,blurred,29,15,4,-11,14,26,14,-25,David Gregory,NBC,PERSON-PERSON,ORGANIZATION,PROPN-PROPN,PROPN,compound-conj,compound,NNP-NNP,NNP,5,1
1551,48133.0,28,said,15,2,14,12,1,13,13,-1,David Gregory,NBC,PERSON-PERSON,ORGANIZATION,PROPN-PROPN,PROPN,compound-nsubj,pobj,NNP-NNP,NNP,5,1
1552,49889.0,11,names,1,3,1,-2,2,9,-2,0,David Gregory,NBC,PERSON-PERSON,ORGANIZATION,PROPN-PROPN,PROPN,compound-compound,compound,NNP-NNP,NNP,1,1
1553,52246.0,19,Bush,3,9,7,-2,8,11,-6,4,David Gregory,NBC,PERSON-PERSON,ORGANIZATION,PROPN-PROPN,PROPN,compound-pobj,poss,NNP-NNP,NNP,2,1
1554,55716.0,56,went,30,7,2,-5,6,53,23,-28,David Gregory,NBC,PERSON-PERSON,ORGANIZATION,PROPN-PROPN,PROPN,compound-appos,poss,NNP-NNP,NNP,3,1
1555,63275.0,24,snapped,12,22,20,-2,21,3,-10,8,David Gregory,NBC,PERSON-PERSON,ORGANIZATION,PROPN-PROPN,PROPN,compound-pobj,poss,NNP-NNP,NNP,3,1
1556,2426.0,31,said,29,1,9,8,0,21,28,-20,Vernon Bellecourt,American Indian Movement,PERSON-PERSON,ORGANIZATION-ORGANIZATION-ORGANIZATION,PROPN-PROPN,PROPN-PROPN-PROPN,compound-nsubj,compound-compound-pobj,NNP-NNP,NNP-NNP-NNP,4,1
1557,8559.0,44,said,42,1,6,5,0,37,41,-36,Vernon Bellecourt,American Indian Movement,PERSON-PERSON,ORGANIZATION-ORGANIZATION-ORGANIZATION,PROPN-PROPN,PROPN-PROPN-PROPN,compound-nsubj,compound-compound-pobj,NNP-NNP,NNP-NNP-NNP,4,1
1558,11023.0,48,died,36,1,30,29,0,17,35,-6,Vernon Bellecourt,American Indian Movement,PERSON-PERSON,ORGANIZATION-ORGANIZATION-ORGANIZATION,PROPN-PROPN,PROPN-PROPN-PROPN,compound-nsubj,compound-compound-pobj,NNP-NNP,NNP-NNP-NNP,10,1
1559,2430.0,17,has,11,2,16,14,1,0,9,5,Jamie Lynn,Bryan,PERSON-PERSON,PERSON,PROPN-PROPN,PROPN,compound-nsubj,appos,NNP-NNP,NNP,2,1
1560,2440.0,25,is,8,1,7,6,0,17,7,-1,MTC,Ohio,ORGANIZATION,STATE_OR_PROVINCE,PROPN,PROPN,nsubj,appos,NNP,NNP,3,1
1561,2449.0,20,said,18,18,1,-17,17,18,0,-17,MBIA,Gary C Dunton,ORGANIZATION,PERSON-PERSON-PERSON,PROPN,PROPN-PROPN-PROPN,nsubj,compound-compound-nsubj,NNP,NNP-NNP-NNP,3,1
1562,15509.0,37,said,15,21,17,-4,20,19,-6,2,MBIA,Gary C Dunton,ORGANIZATION,PERSON-PERSON-PERSON,PROPN,PROPN-PROPN-PROPN,poss,compound-compound-nsubj,NNP,NNP-NNP-NNP,3,1
1563,48011.0,66,said,61,55,51,-4,54,14,6,-10,MBIA,Gary C Dunton,ORGANIZATION,PERSON-PERSON-PERSON,PROPN,PROPN-PROPN-PROPN,poss,compound-compound-nsubj,NNP,NNP-NNP-NNP,13,1
1564,2450.0,47,said,28,30,36,6,29,10,-2,8,Lou Ferrara,vice president,PERSON-PERSON,TITLE-TITLE,PROPN-PROPN,NOUN-NOUN,compound-nsubj,compound-appos,NNP-NNP,NN-NN,3,1
1565,2457.0,20,said,7,15,9,-6,14,10,-8,2,Department of Conservation and Recreation,Wendy Fox,ORGANIZATION-ORGANIZATION-ORGANIZATION-ORGANIZATION-ORGANIZATION,PERSON-PERSON,PROPN-ADP-PROPN-CCONJ-PROPN,PROPN-PROPN,pobj-prep-pobj-cc-conj,compound-nsubj,NNP-IN-NNP-CC-NNP,NNP-NNP,4,1
1566,39793.0,20,said,3,6,2,-4,5,17,-3,-1,Department of Conservation and Recreation,Wendy Fox,ORGANIZATION-ORGANIZATION-ORGANIZATION-ORGANIZATION-ORGANIZATION,PERSON-PERSON,PROPN-ADP-PROPN-CCONJ-PROPN,PROPN-PROPN,nsubj-prep-pobj-cc-conj,compound-nsubj,NNP-IN-NNP-CC-NNP,NNP-NNP,4,1
1567,62136.0,22,said,7,17,9,-8,16,12,-10,2,Department of Conservation and Recreation,Wendy Fox,ORGANIZATION-ORGANIZATION-ORGANIZATION-ORGANIZATION-ORGANIZATION,PERSON-PERSON,PROPN-ADP-PROPN-CCONJ-PROPN,PROPN-PROPN,pobj-prep-pobj-cc-conj,compound-nsubj,NNP-IN-NNP-CC-NNP,NNP-NNP,4,1
1568,2462.0,31,says,9,15,17,2,14,13,-6,8,her,David,PERSON,PERSON,DET,PROPN,poss,appos,PRP$,NNP,4,1
1569,18360.0,8,include,1,3,7,4,2,0,-2,6,her,David,PERSON,PERSON,DET,PROPN,poss,conj,PRP$,NNP,2,1
1570,2464.0,44,crashed,5,42,40,-2,41,3,-37,35,Lee Jye,National Defense,PERSON-PERSON,ORGANIZATION-ORGANIZATION,PROPN-PROPN,PROPN-PROPN,compound-pobj,compound-compound,NNP-NNP,NNP-NNP,1,1
1571,21235.0,27,said,6,5,3,-2,4,23,1,-3,Lee Jye,National Defense,PERSON-PERSON,ORGANIZATION-ORGANIZATION,PROPN-PROPN,PROPN-PROPN,compound-nsubj,compound-pobj,NNP-NNP,NNP-NNP,3,1
1572,21425.0,40,arrived,17,7,5,-2,6,34,10,-12,Lee Jye,National Defense,PERSON-PERSON,ORGANIZATION-ORGANIZATION,PROPN-PROPN,PROPN-PROPN,compound-nmod,compound-pobj,NNP-NNP,NNP-NNP,5,1
1573,41166.0,10,Minister,0,6,3,-3,5,6,-6,3,Lee Jye,National Defense,PERSON-PERSON,ORGANIZATION-ORGANIZATION,PROPN-PROPN,PROPN-PROPN,compound-compound,compound-pobj,NNP-NNP,NNP-NNP,5,1
1574,51776.0,75,FAIL,2,42,40,-2,41,34,-40,38,Lee Jye,National Defense,PERSON-PERSON,ORGANIZATION-ORGANIZATION,PROPN-PROPN,PROPN-PROPN,compound-nsubj,compound-pobj,NNP-NNP,NNP-NNP,1,1
1575,64916.0,23,said,20,19,17,-2,18,5,1,-3,Lee Jye,National Defense,PERSON-PERSON,ORGANIZATION-ORGANIZATION,PROPN-PROPN,PROPN-PROPN,compound-nsubj,compound-pobj,NNP-NNP,NNP-NNP,3,1
1576,2471.0,19,was,1,1,16,15,0,2,0,15,He,spokesman,PERSON,TITLE,PRON,NOUN,nsubj,conj,PRP,NN,8,1
1577,24315.0,24,involved,3,1,7,6,0,16,2,4,He,spokesman,PERSON,TITLE,PRON,NOUN,nsubjpass,pobj,PRP,NN,4,1
1578,2473.0,13,worked,1,1,12,11,0,0,0,11,Dent,George HW,PERSON,ORGANIZATION-ORGANIZATION,PROPN,PROPN-PROPN,nsubj,compound-conj,NNP,NNP-NNP,1,1
1579,2484.0,40,said,20,29,39,10,28,0,-9,19,New Hampshire Institute of Politics,Manchester,ORGANIZATION-ORGANIZATION-ORGANIZATION-ORGANIZATION-ORGANIZATION,CITY,PROPN-PROPN-PROPN-ADP-PROPN,PROPN,compound-compound-pobj-prep-pobj,pobj,NNP-NNP-NNP-IN-NNP,NNP,8,1
1580,15729.0,64,put,19,8,18,10,7,45,11,-1,New Hampshire Institute of Politics,Manchester,ORGANIZATION-ORGANIZATION-ORGANIZATION-ORGANIZATION-ORGANIZATION,CITY,PROPN-PROPN-PROPN-ADP-PROPN,PROPN,compound-compound-pobj-prep-pobj,pobj,NNP-NNP-NNP-IN-NNP,NNP,6,1
1581,18762.0,64,put,19,8,18,10,7,45,11,-1,New Hampshire Institute of Politics,Manchester,ORGANIZATION-ORGANIZATION-ORGANIZATION-ORGANIZATION-ORGANIZATION,CITY,PROPN-PROPN-PROPN-ADP-PROPN,PROPN,compound-compound-pobj-prep-pobj,pobj,NNP-NNP-NNP-IN-NNP,NNP,6,1
1582,67782.0,35,said,19,8,18,10,7,16,11,-1,New Hampshire Institute of Politics,Manchester,ORGANIZATION-ORGANIZATION-ORGANIZATION-ORGANIZATION-ORGANIZATION,CITY,PROPN-PROPN-PROPN-ADP-PROPN,PROPN,compound-compound-pobj-prep-pobj,pobj,NNP-NNP-NNP-IN-NNP,NNP,6,1
1583,2487.0,26,started,12,5,10,5,4,15,7,-2,Goodman,Robert Goodman,PERSON,PERSON-PERSON,PROPN,PROPN-PROPN,nsubj,compound-appos,NNP,NNP-NNP,3,1
1584,2500.0,11,Series,0,4,2,-2,3,8,-4,2,Tacuary-Defensor Sporting,6,ORGANIZATION-ORGANIZATION,NUMBER,PROPN-PROPN,NUM,compound-compound,nummod,NNP-NNP,CD,5,1
1585,2506.0,46,said,41,11,6,-5,10,39,30,-35,U.S. Army Medical Command,Army,ORGANIZATION-ORGANIZATION-ORGANIZATION-ORGANIZATION,ORGANIZATION,PROPN-PROPN-PROPN-PROPN,PROPN,compound-compound-compound-pobj,nsubj,NNP-NNP-NNP-NNP,NNP,5,1
1586,44573.0,46,said,41,11,6,-5,10,39,30,-35,U.S. Army Medical Command,Army,ORGANIZATION-ORGANIZATION-ORGANIZATION-ORGANIZATION,ORGANIZATION,PROPN-PROPN-PROPN-PROPN,PROPN,compound-compound-compound-pobj,pobj,NNP-NNP-NNP-NNP,NNP,5,1
1587,2533.0,50,been,5,30,45,15,29,4,-25,40,Sean Preston,Kevin Federline,PERSON-PERSON,PERSON-PERSON,PROPN-PROPN,PROPN-PROPN,compound-appos,compound-pobj,NNP-NNP,NNP-NNP,7,1
1588,52897.0,82,Woods,12,59,68,9,58,13,-47,56,Sean Preston,Kevin Federline,PERSON-PERSON,PERSON-PERSON,PROPN-PROPN,PROPN-PROPN,compound-compound,compound-conj,NNP-NNP,NNP-NNP,5,1
1589,2540.0,28,said,13,10,1,-9,9,26,3,-12,Awami National Party,Abdul Rahman Akhund,ORGANIZATION-ORGANIZATION-ORGANIZATION,PERSON-PERSON-PERSON,PROPN-PROPN-PROPN,PROPN-PROPN-PROPN,compound-compound-pobj,compound-compound-nsubj,NNP-NNP-NNP,NNP-NNP-NNP,6,1
1590,2553.0,44,was,15,15,12,-3,14,31,0,-3,Mitchell,chairman,PERSON,TITLE,PROPN,NOUN,nsubj,conj,NNP,NN,1,1
1591,33241.0,44,was,15,15,12,-3,14,31,0,-3,Mitchell,chairman,PERSON,TITLE,PROPN,NOUN,appos,conj,NNP,NN,3,1
1592,2554.0,45,said,13,7,11,4,6,33,6,-2,All Basotho Convention,ABC,ORGANIZATION-ORGANIZATION-ORGANIZATION,ORGANIZATION,PROPN-PROPN-PROPN,PROPN,compound-compound-pobj,compound,NNP-NNP-NNP,NNP,5,1
1593,3965.0,53,won,21,30,34,4,29,18,-9,13,All Basotho Convention,ABC,ORGANIZATION-ORGANIZATION-ORGANIZATION,ORGANIZATION,DET-PROPN-PROPN,PROPN,det-compound-pobj,compound,DT-NNP-NNP,NNP,5,1
1594,4973.0,41,resigned,2,11,15,4,10,25,-9,13,All Basotho Convention,ABC,ORGANIZATION-ORGANIZATION-ORGANIZATION,ORGANIZATION,PROPN-PROPN-PROPN,PROPN,compound-compound-dobj,compound,NNP-NNP-NNP,NNP,3,1
1595,12132.0,43,is,4,22,26,4,21,16,-18,22,All Basotho Convention,ABC,ORGANIZATION-ORGANIZATION-ORGANIZATION,ORGANIZATION,DET-PROPN-PROPN,PROPN,det-compound-conj,compound,DT-NNP-NNP,NNP,12,1
1596,13554.0,44,told,41,34,38,4,33,5,7,-3,All Basotho Convention,ABC,ORGANIZATION-ORGANIZATION-ORGANIZATION,ORGANIZATION,PROPN-PROPN-PROPN,PROPN,compound-compound-pobj,compound,NNP-NNP-NNP,NNP,5,1
1597,18174.0,51,parties,4,33,37,4,32,13,-29,33,All Basotho Convention,ABC,ORGANIZATION-ORGANIZATION-ORGANIZATION,ORGANIZATION,DET-PROPN-PROPN,PROPN,det-compound-appos,compound,DT-NNP-NNP,NNP,5,1
1598,26233.0,47,failed,11,32,36,4,31,10,-21,25,All Basotho Convention,ABC,ORGANIZATION-ORGANIZATION-ORGANIZATION,ORGANIZATION,PROPN-PROPN-PROPN,PROPN,compound-compound-pobj,compound,NNP-NNP-NNP,NNP,7,1
1599,28534.0,41,won,18,27,31,4,26,9,-9,13,All Basotho Convention,ABC,ORGANIZATION-ORGANIZATION-ORGANIZATION,ORGANIZATION,DET-PROPN-PROPN,PROPN,det-compound-nsubj,compound,DT-NNP-NNP,NNP,5,1
1600,28676.0,43,hoping,6,33,37,4,32,5,-27,31,All Basotho Convention,ABC,ORGANIZATION-ORGANIZATION-ORGANIZATION,ORGANIZATION,PROPN-PROPN-PROPN,PROPN,compound-compound-pobj,compound,NNP-NNP-NNP,NNP,5,1
1601,36437.0,40,comes,12,16,20,4,15,19,-4,8,All Basotho Convention,ABC,ORGANIZATION-ORGANIZATION-ORGANIZATION,ORGANIZATION,PROPN-PROPN-PROPN,PROPN,compound-compound-pobj,compound,NNP-NNP-NNP,NNP,4,1
1602,62600.0,55,takes,2,32,36,4,31,18,-30,34,All Basotho Convention,ABC,ORGANIZATION-ORGANIZATION-ORGANIZATION,ORGANIZATION,DET-PROPN-PROPN,PROPN,det-compound-pobj,compound,DT-NNP-NNP,NNP,6,1
1603,2561.0,39,said,33,37,36,-1,36,2,-4,3,Chris Bentley,spokesman,PERSON-PERSON,TITLE,PROPN-PROPN,NOUN,compound-nsubj,compound,NNP-NNP,NN,1,1
1604,6372.0,18,said,16,15,14,-1,14,3,1,-2,Chris Bentley,spokesman,PERSON-PERSON,TITLE,PROPN-PROPN,NOUN,compound-nsubj,compound,NNP-NNP,NN,1,1
1605,8675.0,22,declined,12,11,10,-1,10,11,1,-2,Chris Bentley,spokesman,PERSON-PERSON,TITLE,PROPN-PROPN,NOUN,compound-nsubj,compound,NNP-NNP,NN,1,1
1606,9221.0,41,said,23,30,29,-1,29,11,-7,6,Chris Bentley,spokesman,PERSON-PERSON,TITLE,PROPN-PROPN,NOUN,compound-nsubj,compound,NNP-NNP,NN,2,1
1607,11621.0,26,said,20,24,23,-1,23,2,-4,3,Chris Bentley,spokesman,PERSON-PERSON,TITLE,PROPN-PROPN,NOUN,compound-nsubj,compound,NNP-NNP,NN,1,1
1608,18366.0,18,said,16,15,14,-1,14,3,1,-2,Chris Bentley,spokesman,PERSON-PERSON,TITLE,PROPN-PROPN,NOUN,compound-nsubj,compound,NNP-NNP,NN,2,1
1609,18782.0,29,said,16,18,22,4,17,6,-2,6,Chris Bentley,spokesman,PERSON-PERSON,TITLE,PROPN-PROPN,NOUN,compound-nsubj,appos,NNP-NNP,NN,3,1
1610,22204.0,16,disputed,12,1,5,4,0,10,11,-7,Chris Bentley,spokesman,PERSON-PERSON,TITLE,PROPN-PROPN,NOUN,compound-nsubj,appos,NNP-NNP,NN,3,1
1611,24313.0,25,declined,4,3,2,-1,2,22,1,-2,Chris Bentley,spokesman,PERSON-PERSON,TITLE,PROPN-PROPN,NOUN,compound-nsubj,compound,NNP-NNP,NN,1,1
1612,29337.0,7,Bentley,1,1,5,4,0,1,0,4,Chris Bentley,spokesman,PERSON-PERSON,TITLE,PROPN-PROPN,NOUN,compound-ROOT,appos,NNP-NNP,NN,2,1
1613,30723.0,23,said,16,21,20,-1,20,2,-5,4,Chris Bentley,spokesman,PERSON-PERSON,TITLE,PROPN-PROPN,NOUN,compound-nsubj,compound,NNP-NNP,NN,1,1
1614,31040.0,35,said,29,33,32,-1,32,2,-4,3,Chris Bentley,spokesman,PERSON-PERSON,TITLE,PROPN-PROPN,NOUN,compound-nsubj,compound,NNP-NNP,NN,1,1
1615,36889.0,34,said,10,1,4,3,0,29,9,-6,Chris Bentley,spokesman,PERSON-PERSON,TITLE,PROPN-PROPN,NOUN,compound-nsubj,appos,NNP-NNP,NN,3,1
1616,41326.0,33,said,31,30,29,-1,29,3,1,-2,Chris Bentley,spokesman,PERSON-PERSON,TITLE,PROPN-PROPN,NOUN,compound-nsubj,compound,NNP-NNP,NN,2,1
1617,41993.0,18,said,7,6,5,-1,5,12,1,-2,Chris Bentley,spokesman,PERSON-PERSON,TITLE,PROPN-PROPN,NOUN,compound-nsubj,compound,NNP-NNP,NN,1,1
1618,42330.0,31,said,21,23,27,4,22,3,-2,6,Chris Bentley,spokesman,PERSON-PERSON,TITLE,PROPN-PROPN,NOUN,compound-nsubj,appos,NNP-NNP,NN,2,1
1619,53541.0,42,said,40,39,38,-1,38,3,1,-2,Chris Bentley,spokesman,PERSON-PERSON,TITLE,PROPN-PROPN,NOUN,compound-nsubj,compound,NNP-NNP,NN,1,1
1620,55630.0,23,said,14,21,20,-1,20,2,-7,6,Chris Bentley,spokesman,PERSON-PERSON,TITLE,PROPN-PROPN,NOUN,compound-nsubj,compound,NNP-NNP,NN,2,1
1621,65088.0,54,said,12,1,5,4,0,48,11,-7,Chris Bentley,spokesman,PERSON-PERSON,TITLE,PROPN-PROPN,NOUN,compound-nsubj,appos,NNP-NNP,NN,3,1
1622,66027.0,26,said,20,24,23,-1,23,2,-4,3,Chris Bentley,spokesman,PERSON-PERSON,TITLE,PROPN-PROPN,NOUN,compound-nsubj,compound,NNP-NNP,NN,2,1
1623,66750.0,21,said,12,19,18,-1,18,2,-7,6,Chris Bentley,spokesman,PERSON-PERSON,TITLE,PROPN-PROPN,NOUN,compound-nsubj,compound,NNP-NNP,NN,2,1
1624,2574.0,39,meet,3,31,30,-1,30,8,-28,27,Gholam-Ali Haddad-Adel,Speaker,PERSON-PERSON,TITLE,PROPN-PROPN,PROPN,compound-ROOT,compound,NNP-NNP,NNP,2,1
1625,39509.0,41,met,5,33,32,-1,32,8,-28,27,Gholam-Ali Haddad-Adel,Speaker,PERSON-PERSON,TITLE,PROPN-PROPN,PROPN,compound-ROOT,compound,NNP-NNP,NNP,2,1
1626,2579.0,29,started,13,6,12,6,5,16,7,-1,Paralyzed Veterans of America,Bulova,ORGANIZATION-ORGANIZATION-ORGANIZATION-ORGANIZATION,ORGANIZATION,PROPN-PROPN-ADP-PROPN,PROPN,compound-pobj-prep-pobj,compound,NNP-NNPS-IN-NNP,NNP,3,1
1627,2583.0,45,said,32,35,22,-13,34,22,-3,-10,Mahmood Shah,Afghan,PERSON-PERSON,NATIONALITY,PROPN-PROPN,ADJ,compound-nsubj,amod,NNP-NNP,JJ,-1,1
1628,2584.0,9,Downing,2,5,1,-4,4,7,-3,-1,CPS,-- Lillian Downing,ORGANIZATION,PERSON-PERSON-PERSON,PROPN,PUNCT-PROPN-PROPN,poss,punct-compound-ROOT,NNP,:-NNP-NNP,4,1
1629,2586.0,56,Bald,1,11,1,-10,10,54,-10,0,Royal Caribbean Cruises Ltd.,Gary Bald,ORGANIZATION-ORGANIZATION-ORGANIZATION-ORGANIZATION,PERSON-PERSON,ADJ-PROPN-PROPN-PROPN,PROPN-PROPN,compound-compound-compound-pobj,compound-ROOT,JJ-NNP-NNPS-NNP,NNP-NNP,6,1
1630,2588.0,40,want,2,6,30,24,5,9,-4,28,Red Sox,Larry Lucchino,ORGANIZATION-ORGANIZATION,PERSON-PERSON,PROPN-PROPN,PROPN-PROPN,compound-compound,compound-nsubj,NNP-NNPS,NNP-NNP,6,1
1631,18823.0,20,said,7,9,14,5,8,5,-2,7,Red Sox,Larry Lucchino,ORGANIZATION-ORGANIZATION,PERSON-PERSON,PROPN-PROPN,PROPN-PROPN,compound-compound,compound-conj,NNP-NNPS,NNP-NNP,4,1
1632,54908.0,22,said,15,17,20,3,16,1,-2,5,Red Sox,Larry Lucchino,ORGANIZATION-ORGANIZATION,PERSON-PERSON,PROPN-PROPN,PROPN-PROPN,compound-compound,compound-nsubj,NNP-NNP,NNP-NNP,4,1
1633,62720.0,41,cited,1,14,8,-6,13,32,-13,7,Red Sox,Larry Lucchino,ORGANIZATION-ORGANIZATION,PERSON-PERSON,PROPN-PROPN,PROPN-PROPN,compound-pobj,compound-pobj,NNP-NNPS,NNP-NNP,7,1
1634,2589.0,29,is,4,3,21,18,2,7,1,17,Andre Carson,Julia Carson,PERSON-PERSON,PERSON-PERSON,PROPN-PROPN,PROPN-PROPN,compound-nsubj,compound-appos,NNP-NNP,NNP-NNP,2,1
1635,6793.0,28,won,5,2,18,16,1,9,3,13,Andre Carson,Julia Carson,PERSON-PERSON,PERSON-PERSON,PROPN-PROPN,PROPN-PROPN,compound-nsubj,compound-appos,NNP-NNP,NNP-NNP,6,1
1636,2592.0,34,announced,7,23,12,-11,22,21,-16,5,Sadia,Luiz Gonzaga Murat Junior,ORGANIZATION,PERSON-PERSON-PERSON-PERSON,PROPN,PROPN-PROPN-PROPN-PROPN,pobj,compound-compound-compound-pobj,NNP,NNP-NNP-NNP-NNP,5,1
1637,2599.0,26,joined,6,5,1,-4,4,24,1,-5,Andre Carson,Reps,PERSON-PERSON,ORGANIZATION,PROPN-PROPN,PROPN,compound-conj,compound,NNP-NNP,NNP,2,1
1638,2605.0,33,told,5,7,27,20,6,5,-2,22,Ellen DeGeneres,Portia de Rossi,PERSON-PERSON,PERSON-PERSON-PERSON,PROPN-PROPN,PROPN-PROPN-PROPN,compound-dobj,compound-compound-appos,NNP-NNP,NNP-NNP-NNP,8,1
1639,16491.0,18,won,8,3,6,3,2,11,5,-2,Ellen DeGeneres,Portia de Rossi,PERSON-PERSON,PERSON-PERSON-PERSON,PROPN-PROPN,PROPN-PROPN-PROPN,compound-nsubj,compound-compound-conj,NNP-NNP,NNP-NNP-NNP,2,1
1640,18658.0,54,said,33,2,10,8,1,43,31,-23,Ellen DeGeneres,Portia de Rossi,PERSON-PERSON,PERSON-PERSON-PERSON,PROPN-PROPN,PROPN-PROPN-PROPN,compound-nsubj,compound-compound-pobj,NNP-NNP,NNP-NNP-NNP,4,1
1641,57738.0,26,HILLS,1,14,17,3,13,8,-13,16,Ellen DeGeneres,Portia de Rossi,PERSON-PERSON,PERSON-PERSON-PERSON,PROPN-PROPN,PROPN-PROPN-PROPN,compound-nsubj,compound-compound-conj,NNP-NNP,NNP-NNP-NNP,-1,1
1642,58665.0,54,said,33,2,10,8,1,43,31,-23,Ellen DeGeneres,Portia de Rossi,PERSON-PERSON,PERSON-PERSON-PERSON,PROPN-PROPN,PROPN-PROPN-PROPN,compound-nsubj,compound-compound-pobj,NNP-NNP,NNP-NNP-NNP,4,1
1643,2631.0,27,Cry,2,1,13,12,0,13,1,11,Susan Boyle,Scotland,PERSON-PERSON,COUNTRY,PROPN-PROPN,PROPN,compound-nsubj,pobj,NNP-NNP,NNP,-1,1
1644,2633.0,16,DATE,1,13,5,-8,12,10,-12,4,naturalized Iranian citizen,1958,PERSON-PERSON-PERSON,DATE,VERB-ADJ-NOUN,NUM,amod-amod-appos,npadvmod,VBN-JJ-NN,CD,5,1
1645,2636.0,49,was,3,15,34,19,14,14,-12,31,Badr Corps,Qom,ORGANIZATION-ORGANIZATION,CITY,PROPN-PROPN,PROPN,compound-pobj,pobj,NNP-NNP,NNP,8,1
1646,2639.0,52,died,37,1,49,48,0,2,36,12,Pamela Gardner Ahearn,Alexandria,PERSON-PERSON-PERSON,CITY,PROPN-PROPN-PROPN,PROPN,compound-compound-nsubj,pobj,NNP-NNP-NNP,NNP,10,1
1647,32922.0,52,died,37,1,49,48,0,2,36,12,Pamela Gardner Ahearn,Alexandria,PERSON-PERSON-PERSON,CITY,PROPN-PROPN-PROPN,PROPN,compound-compound-nsubj,pobj,NNP-NNP-NNP,NNP,10,1
1648,2652.0,61,esquirecom,13,51,39,-12,50,21,-38,26,Steve McPherson,president of entertainment,PERSON-PERSON,TITLE-TITLE-TITLE,PROPN-PROPN,NOUN-ADP-NOUN,compound-pobj,attr-prep-pobj,NNP-NNP,NN-IN-NN,4,1
1649,2653.0,26,retired,2,1,20,19,0,5,1,18,He,Peggy,PERSON,PERSON,PRON,PROPN,nsubj,appos,PRP,NNP,5,1
1650,2684.0,29,is,3,27,25,-2,26,3,-24,22,Frankie Delgado,nightlife impresario,PERSON-PERSON,TITLE-TITLE,PROPN-PROPN,NOUN-NOUN,compound-pobj,conj-compound,NNP-NNP,NN-NN,1,1
1651,2685.0,38,raised,2,28,32,4,27,5,-26,30,Saint Anselm College,Goffstown,ORGANIZATION-ORGANIZATION-ORGANIZATION,CITY,PROPN-PROPN-PROPN,PROPN,compound-compound-pobj,pobj,NNP-NNP-NNP,NNP,4,1
1652,55073.0,11,taped,3,6,10,4,5,0,-3,7,Saint Anselm College,Goffstown,ORGANIZATION-ORGANIZATION-ORGANIZATION,CITY,PROPN-PROPN-PROPN,PROPN,compound-compound-pobj,pobj,NNP-NNP-NNP,NNP,4,1
1653,2689.0,34,said,10,22,8,-14,21,25,-12,-2,MF Global,Kevin Davis,ORGANIZATION-ORGANIZATION,PERSON-PERSON,PROPN-PROPN,PROPN-PROPN,compound-poss,compound-appos,NNP-NNP,NNP-NNP,8,1
1654,58709.0,33,said,10,22,8,-14,21,24,-12,-2,MF Global,Kevin Davis,ORGANIZATION-ORGANIZATION,PERSON-PERSON,PROPN-PROPN,PROPN-PROPN,compound-poss,compound-appos,NNP-NNP,NNP-NNP,8,1
1655,61313.0,33,said,11,20,13,-7,19,19,-9,2,MF Global,Kevin Davis,ORGANIZATION-ORGANIZATION,PERSON-PERSON,PROPN-PROPN,PROPN-PROPN,compound-pobj,compound-nsubj,NNP-NNP,NNP-NNP,5,1
1656,2690.0,29,said,27,20,24,4,19,4,7,-3,Myanmar Timber Enterprise,MTE,ORGANIZATION-ORGANIZATION-ORGANIZATION,ORGANIZATION,PROPN-PROPN-PROPN,PROPN,compound-compound-compound,compound,NNP-NNP-NNP,NNP,9,1
1657,7129.0,58,Dec,2,9,25,16,8,32,-7,23,Myanmar Timber Enterprise,MTE,ORGANIZATION-ORGANIZATION-ORGANIZATION,ORGANIZATION,PROPN-PROPN-PROPN,PROPN,compound-compound-pobj,compound,NNP-NNP-NNP,NNP,4,1
1658,10046.0,24,went,4,9,13,4,8,10,-5,9,Myanmar Timber Enterprise,MTE,ORGANIZATION-ORGANIZATION-ORGANIZATION,ORGANIZATION,PROPN-PROPN-NOUN,PROPN,compound-compound-pobj,compound,NNP-NNP-NN,NNP,5,1
1659,53432.0,58,-LRB-,0,9,25,16,8,32,-9,25,Myanmar Timber Enterprise,MTE,ORGANIZATION-ORGANIZATION-ORGANIZATION,ORGANIZATION,PROPN-PROPN-PROPN,PROPN,compound-compound-pobj,compound,NNP-NNP-NNP,NNP,4,1
1660,60296.0,52,YANGON,0,3,19,16,2,32,-3,19,Myanmar Timber Enterprise,MTE,ORGANIZATION-ORGANIZATION-ORGANIZATION,ORGANIZATION,PROPN-PROPN-PROPN,PROPN,compound-compound-pobj,compound,NNP-NNP-NNP,NNP,4,1
1661,2699.0,30,have,3,11,14,3,10,15,-8,11,Covidien Ltd.,Mansfield,ORGANIZATION-ORGANIZATION,CITY,PROPN-PROPN,PROPN,compound-pobj,pobj,NNP-NNP,NNP,3,1
1662,2701.0,36,said,5,1,3,2,0,32,4,-2,ICG,Gareth Evans,ORGANIZATION,PERSON-PERSON,ADJ,PROPN-PROPN,amod,compound-nsubj,JJ,NNP-NNP,1,1
1663,2702.0,32,bought,12,22,21,-1,21,10,-10,9,leaders from Arizona,Minutemen,PERSON-PERSON-PERSON,ORGANIZATION,NOUN-ADP-PROPN,PROPN,dobj-prep-pobj,compound,NNS-IN-NNP,NNP,2,1
1664,2710.0,12,said,10,7,1,-6,6,10,3,-9,Palestinian Resistance Committees,Abu Mujahid,ORGANIZATION-ORGANIZATION-ORGANIZATION,PERSON-PERSON,PROPN-PROPN-PROPN,PROPN-PROPN,compound-compound-pobj,compound-nsubj,NNP-NNP-NNPS,NNP-NNP,5,1
1665,2714.0,44,given,11,6,39,33,5,4,5,28,movement,Abdelaziz el-Nur Ashr,ORGANIZATION,PERSON-PERSON-PERSON,NOUN,PROPN-X-PROPN,pobj,compound-ROOT-nsubj,NN,NNP-ADD-NNP,6,1
1666,2717.0,42,are,16,29,33,4,28,8,-13,17,Christopher J. Dodd,Connecticut,PERSON-PERSON-PERSON,STATE_OR_PROVINCE,PROPN-PROPN-PROPN,PROPN,compound-compound-conj,pobj,NNP-NNP-NNP,NNP,2,1
1667,18412.0,64,surrounded,2,43,47,4,42,16,-41,45,Christopher J. Dodd,Connecticut,PERSON-PERSON-PERSON,STATE_OR_PROVINCE,PROPN-PROPN-PROPN,PROPN,compound-compound-conj,pobj,NNP-NNP-NNP,NNP,2,1
1668,57985.0,47,were,36,26,30,4,25,16,10,-6,Christopher J. Dodd,Connecticut,PERSON-PERSON-PERSON,STATE_OR_PROVINCE,PROPN-PROPN-PROPN,PROPN,compound-compound-conj,pobj,NNP-NNP-NNP,NNP,2,1
1669,2721.0,40,said,7,16,10,-6,15,29,-9,3,federal motor carrier administration,Kurt Hegmann,ORGANIZATION-ORGANIZATION-ORGANIZATION-ORGANIZATION,PERSON-PERSON,ADJ-NOUN-NOUN-NOUN,PROPN-PROPN,amod-compound-compound-poss,compound-nsubj,JJ-NN-NN-NN,NNP-NNP,6,1
1670,2730.0,41,recommended,30,13,6,-7,12,34,17,-24,Pennsylvania Supreme Court,Arthur A. Grim,ORGANIZATION-ORGANIZATION-ORGANIZATION,PERSON-PERSON-PERSON,PROPN-PROPN-PROPN,PROPN-PROPN-PROPN,compound-compound-pobj,compound-compound-nsubj,NNP-NNP-NNP,NNP-NNP-NNP,5,1
1671,2731.0,26,applied,12,7,10,3,6,15,5,-2,her,Yale,PERSON,ORGANIZATION,DET,PROPN,poss,pobj,PRP$,NNP,3,1
1672,2736.0,46,was,1,1,19,18,0,26,0,18,Bolin,New York City,PERSON,CITY-CITY-CITY,PROPN,PROPN-PROPN-PROPN,nsubj,compound-compound-compound,NNP,NNP-NNP-NNP,6,1
1673,2743.0,35,quoted,17,19,26,7,18,8,-2,9,Li Jie,Shanghai Food and Drug Supervision Institute,PERSON-PERSON,ORGANIZATION-ORGANIZATION-ORGANIZATION-ORGANIZATION-ORGANIZATION-ORGANIZATION,PROPN-PROPN,PROPN-PROPN-CCONJ-PROPN-PROPN-PROPN,compound-dobj,compound-nmod-cc-conj-compound-pobj,NNP-NNP,NNP-NNP-CC-NNP-NNP-NNP,5,1
1674,10051.0,35,tell,4,17,24,7,16,10,-13,20,Li Jie,Shanghai Food and Drug Supervision Institute,PERSON-PERSON,ORGANIZATION-ORGANIZATION-ORGANIZATION-ORGANIZATION-ORGANIZATION-ORGANIZATION,PROPN-PROPN,PROPN-PROPN-CCONJ-PROPN-PROPN-PROPN,compound-nsubjpass,nmod-nmod-cc-conj-conj-pobj,NNP-NNP,NNP-NNP-CC-NNP-NNP-NNP,5,1
1675,2755.0,46,said,30,41,32,-9,40,13,-11,2,MF Global,Andrew Lebow,ORGANIZATION-ORGANIZATION,PERSON-PERSON,PROPN-PROPN,PROPN-PROPN,compound-pobj,compound-nsubj,NNP-NNP,NNP-NNP,5,1
1676,22136.0,36,said,15,10,1,-9,9,34,5,-14,MF Global,Andrew Lebow,ORGANIZATION-ORGANIZATION,PERSON-PERSON,PROPN-PROPN,PROPN-PROPN,compound-pobj,compound-nsubj,NNP-NNP,NNP-NNP,3,1
1677,27331.0,26,said,10,21,12,-9,20,13,-11,2,MF Global,Andrew Lebow,ORGANIZATION-ORGANIZATION,PERSON-PERSON,PROPN-PROPN,PROPN-PROPN,compound-pobj,compound-nsubj,NNP-NNP,NNP-NNP,5,1
1678,42888.0,36,said,22,34,24,-10,33,11,-12,2,MF Global,Andrew Lebow,ORGANIZATION-ORGANIZATION,PERSON-PERSON,PROPN-PROPN,PROPN-PROPN,compound-pobj,compound-nsubj,NNP-NNP,NNP-NNP,3,1
1679,55328.0,47,said,15,10,1,-9,9,45,5,-14,MF Global,Andrew Lebow,ORGANIZATION-ORGANIZATION,PERSON-PERSON,PROPN-PROPN,PROPN-PROPN,compound-pobj,compound-nsubj,NNP-NNP,NNP-NNP,3,1
1680,65798.0,38,said,27,36,29,-7,35,8,-9,2,MF Global,Andrew Lebow,ORGANIZATION-ORGANIZATION,PERSON-PERSON,PROPN-PROPN,PROPN-PROPN,compound-pobj,compound-nsubj,NNP-NNP,NNP-NNP,5,1
1681,2764.0,22,said,9,11,13,2,10,8,-2,4,Bond,70,PERSON,NUMBER,PROPN,NUM,nsubj,appos,NNP,CD,1,1
1682,2770.0,25,required,12,19,17,-2,18,7,-7,5,Philip Chen,chief executive,PERSON-PERSON,TITLE-TITLE,PROPN-PROPN,ADJ-NOUN,compound-nsubjpass,amod-compound,NNP-NNP,JJ-NN,3,1
1683,2781.0,48,led,7,1,5,4,0,42,6,-2,R Nicholas Burns,51,PERSON-PERSON-PERSON,NUMBER,PROPN-PROPN-PROPN,NUM,compound-compound-nsubj,appos,NNP-NNP-NNP,CD,3,1
1684,2801.0,24,supported,6,9,14,5,8,9,-3,8,Inter-American Press Association,IAPA,ORGANIZATION-ORGANIZATION-ORGANIZATION,ORGANIZATION,ADJ-PROPN-PROPN,PROPN,amod-compound-poss,compound,JJ-NNP-NNP,NNP,4,1
1685,34786.0,55,kicks,18,2,7,5,1,47,16,-11,Inter-American Press Association,IAPA,ORGANIZATION-ORGANIZATION-ORGANIZATION,ORGANIZATION,ADJ-PROPN-PROPN,PROPN,amod-compound-nsubj,conj,JJ-NNP-NNP,NNP,2,1
1686,2815.0,36,said,21,10,2,-8,9,33,11,-19,Federal Motor Carrier Safety Administration,Rose A. McMurray,ORGANIZATION-ORGANIZATION-ORGANIZATION-ORGANIZATION-ORGANIZATION,PERSON-PERSON-PERSON,PROPN-PROPN-PROPN-PROPN-PROPN,PROPN-PROPN-PROPN,compound-compound-compound-compound-pobj,compound-compound-nsubj,NNP-NNP-NNP-NNP-NNP,NNP-NNP-NNP,7,1
1687,2817.0,34,buried,14,1,6,5,0,27,13,-8,Teddy Kollek,major,PERSON-PERSON,TITLE,PROPN-PROPN,ADJ,compound-nsubjpass,acomp,NNP-NNP,JJ,3,1
1688,2821.0,16,known,4,15,8,-7,14,7,-11,4,IRGC-QF,Iranian,ORGANIZATION,COUNTRY,NOUN,ADJ,conj,compound,NN,JJ,2,1
1689,59301.0,48,suspected,2,23,7,-16,22,40,-21,5,IRGC-QF,Iranian,ORGANIZATION,COUNTRY,PROPN,ADJ,compound,compound,NNP,JJ,9,1
1690,2823.0,33,announced,4,4,1,-3,3,31,0,-3,FirstGroup,British,ORGANIZATION,COUNTRY,PROPN,ADJ,nsubj,amod,NNP,JJ,2,1
1691,2825.0,16,appointed,2,1,7,6,0,8,1,5,He,Dominican Republic,PERSON,COUNTRY-COUNTRY,PRON,PROPN-PROPN,nsubjpass,compound-pobj,PRP,NNP-NNP,4,1
1692,2826.0,22,played,1,10,17,7,9,4,-9,16,American Basketball Association,1976,ORGANIZATION-ORGANIZATION-ORGANIZATION,DATE,PROPN-PROPN-PROPN,NUM,compound-compound-pobj,nummod,NNP-NNP-NNP,CD,5,1
1693,2845.0,45,said,42,19,41,22,18,3,23,-1,Taiwan Research Institute,TRI,ORGANIZATION-ORGANIZATION-ORGANIZATION,ORGANIZATION,PROPN-PROPN-PROPN,PROPN,compound-compound-pobj,compound,NNP-NNP-NNP,NNP,3,1
1694,9297.0,45,Institute,2,1,5,4,0,39,1,3,Taiwan Research Institute,TRI,ORGANIZATION-ORGANIZATION-ORGANIZATION,MISC,PROPN-PROPN-PROPN,PROPN,compound-compound-ROOT,compound,NNP-NNP-NNP,NNP,2,1
1695,29489.0,29,said,16,23,27,4,22,1,-7,11,Taiwan Research Institute,TRI,ORGANIZATION-ORGANIZATION-ORGANIZATION,ORGANIZATION,PROPN-PROPN-PROPN,PROPN,compound-compound-pobj,compound,NNP-NNP-NNP,NNP,2,1
1696,33679.0,41,said,38,4,37,33,3,3,34,-1,Taiwan Research Institute,TRI,ORGANIZATION-ORGANIZATION-ORGANIZATION,ORGANIZATION,PROPN-PROPN-PROPN,PROPN,compound-compound-nsubj,compound,NNP-NNP-NNP,NNP,8,1
1697,59131.0,59,-RRB-,6,33,55,22,32,3,-27,49,Taiwan Research Institute,TRI,ORGANIZATION-ORGANIZATION-ORGANIZATION,ORGANIZATION,PROPN-PROPN-PROPN,PROPN,compound-compound-pobj,compound,NNP-NNP-NNP,NNP,3,1
1698,2846.0,38,starlet,9,12,30,18,11,7,-3,21,Holly Montag,Spencer Pratt,PERSON-PERSON,PERSON-PERSON,PROPN-PROPN,PROPN-PROPN,compound-npadvmod,compound-conj,NNP-NNP,NNP-NNP,5,1
1699,4300.0,36,Settles,3,2,8,6,1,27,1,5,Holly Montag,Spencer Pratt,PERSON-PERSON,PERSON-PERSON,PROPN-PROPN,PROPN-PROPN,compound-nsubj,compound-compound,NNP-NNP,NNP-NNP,4,1
1700,12038.0,31,attend,9,13,6,-7,12,24,-4,-3,Holly Montag,Spencer Pratt,PERSON-PERSON,PERSON-PERSON,PROPN-PROPN,PROPN-PROPN,compound-poss,compound-conj,NNP-NNP,NNP-NNP,6,1
1701,21391.0,30,face,5,24,18,-6,23,11,-19,13,Holly Montag,Spencer Pratt,PERSON-PERSON,PERSON-PERSON,PROPN-PROPN,PROPN-PROPN,compound-pobj,compound-conj,NNP-NNP,NNP-NNP,5,1
1702,2851.0,25,said,14,4,8,4,3,16,10,-6,his,Toronto,PERSON,CITY,DET,PROPN,poss,compound,PRP$,NNP,2,1
1703,53859.0,24,said,14,4,8,4,3,15,10,-6,his,Toronto,PERSON,CITY,DET,PROPN,poss,compound,PRP$,NNP,2,1
1704,2858.0,29,found,2,13,1,-12,12,27,-11,-1,Morehouse College,Bond,PERSON-PERSON,ORGANIZATION,PROPN-PROPN,NOUN,compound-pobj,nsubj,NNP-NNP,NN,3,1
1705,2859.0,10,LD,1,7,5,-2,6,4,-6,4,Waldheim,U.N.,PERSON,ORGANIZATION,PROPN,PROPN,nsubj,compound,NNP,NNP,2,1
1706,9703.0,38,died,10,1,6,5,0,31,9,-4,Waldheim,U.N.,PERSON,ORGANIZATION,NOUN,PROPN,nsubj,compound,NNS,NNP,3,1
1707,2860.0,35,said,13,12,33,21,11,1,1,20,KGB,communist,ORGANIZATION,RELIGION,PROPN,ADJ,pobj,amod,NNP,JJ,15,1
1708,2866.0,40,Labels,0,7,16,9,6,23,-7,16,Carolyn Maloney,Rep,PERSON-PERSON,TITLE,PROPN-PROPN,PROPN,compound-appos,compound,NNP-NNP,NNP,4,1
1709,10442.0,40,Labels,0,7,16,9,6,23,-7,16,Carolyn Maloney,Rep,PERSON-PERSON,TITLE,PROPN-PROPN,PROPN,compound-conj,compound,NNP-NNP,NNP,4,1
1710,2868.0,25,has,4,1,13,12,0,11,3,9,Khamenei,Iran,PERSON,COUNTRY,PROPN,PROPN,nsubj,pobj,NNP,NNP,6,1
1711,5538.0,12,calls,3,3,1,-2,2,10,0,-2,Khamenei,Iran,PERSON,COUNTRY,PROPN,PROPN,nsubj,poss,NNP,NNP,3,1
1712,22535.0,40,Rafsanjani,2,25,16,-9,24,23,-23,14,Khamenei,Iran,PERSON,COUNTRY,PROPN,PROPN,pobj,poss,NNP,NNP,7,1
1713,55801.0,25,warned,23,23,14,-9,22,10,0,-9,Khamenei,Iran,PERSON,COUNTRY,PROPN,PROPN,nsubj,pobj,NNP,NNP,7,1
1714,2872.0,34,is,4,27,3,-24,26,30,-23,-1,he,57,PERSON,NUMBER,PRON,NUM,nsubj,appos,PRP,CD,6,1
1715,67261.0,35,is,4,28,3,-25,27,31,-24,-1,he,57,PERSON,NUMBER,PRON,NUM,nsubj,appos,PRP,CD,6,1
1716,2873.0,34,was,10,10,29,19,9,4,0,19,Herrera,mechanic,PERSON,TITLE,PROPN,NOUN,nsubj,pobj,NNP,NN,2,1
1717,2874.0,27,arrived,10,9,8,-1,8,18,1,-2,Mohamed ElBaradei,inspector,PERSON-PERSON,TITLE,PROPN-PROPN,NOUN,compound-appos,nsubj,NNP-NNP,NN,1,1
1718,28803.0,38,said,14,11,10,-1,10,27,3,-4,Mohamed ElBaradei,inspector,PERSON-PERSON,TITLE,PROPN-PROPN,NOUN,compound-appos,compound,NNP-NNP,NN,2,1
1719,62436.0,21,scheduled,8,6,5,-1,5,15,2,-3,Mohamed ElBaradei,inspector,PERSON-PERSON,TITLE,PROPN-PROPN,NOUN,compound-dobj,compound,NNP-NNP,NN,1,1
1720,2876.0,44,told,41,33,26,-7,32,17,8,-15,Awami National Party,Asfandyar Wali Khan,ORGANIZATION-ORGANIZATION-ORGANIZATION,PERSON-PERSON-PERSON,PROPN-PROPN-PROPN,PROPN-PROPN-PROPN,compound-compound-pobj,compound-compound-pobj,NNP-NNP-NNP,NNP-NNP-NNP,5,1
1721,30759.0,38,happened,2,24,17,-7,23,20,-22,15,Awami National Party,Asfandyar Wali Khan,ORGANIZATION-ORGANIZATION-ORGANIZATION,PERSON-PERSON-PERSON,PROPN-PROPN-PROPN,PROPN-PROPN-PROPN,compound-compound-pobj,compound-compound-pobj,NNP-NNP-NNP,NNP-NNP-NNP,6,1
1722,35476.0,38,occurred,2,16,9,-7,15,28,-14,7,Awami National Party,Asfandyar Wali Khan,ORGANIZATION-ORGANIZATION-ORGANIZATION,PERSON-PERSON-PERSON,PROPN-PROPN-PROPN,PROPN-PROPN-PROPN,compound-compound-pobj,compound-compound-pobj,NNP-NNP-NNP,NNP-NNP-NNP,6,1
1723,42853.0,42,said,23,32,25,-7,31,16,-9,2,Awami National Party,Asfandyar Wali Khan,ORGANIZATION-ORGANIZATION-ORGANIZATION,PERSON-PERSON-PERSON,PROPN-PROPN-PROPN,PROPN-PROPN-PROPN,compound-compound-pobj,compound-compound-nsubj,NNP-NNP-NNP,NNP-NNP-NNP,5,1
1724,45137.0,44,happened,1,11,4,-7,10,39,-10,3,Awami National Party,Asfandyar Wali Khan,ORGANIZATION-ORGANIZATION-ORGANIZATION,PERSON-PERSON-PERSON,PROPN-PROPN-PROPN,PROPN-PROPN-PROPN,compound-compound-pobj,compound-compound-pobj,NNP-NNP-NNP,NNP-NNP-NNP,6,1
1725,63298.0,22,occurred,2,16,9,-7,15,12,-14,7,Awami National Party,Asfandyar Wali Khan,ORGANIZATION-ORGANIZATION-ORGANIZATION,PERSON-PERSON-PERSON,PROPN-PROPN-PROPN,PROPN-PROPN-PROPN,compound-compound-pobj,compound-compound-pobj,NNP-NNP-NNP,NNP-NNP-NNP,5,1
1726,2900.0,57,declined,28,13,23,10,12,33,15,-5,Lee Jye,minister,PERSON-PERSON,TITLE,PROPN-PROPN,NOUN,compound-dobj,pobj,NNP-NNP,NN,6,1
1727,38740.0,29,reported,4,10,9,-1,9,19,-6,5,Lee Jye,minister,PERSON-PERSON,TITLE,PROPN-PROPN,NOUN,compound-nsubj,compound,NNP-NNP,NN,1,1
1728,42001.0,20,denied,4,3,2,-1,2,17,1,-2,Lee Jye,minister,PERSON-PERSON,TITLE,PROPN-PROPN,NOUN,compound-nsubj,compound,NNP-NNP,NN,1,1
1729,46078.0,35,said,32,4,3,-1,3,31,28,-29,Lee Jye,minister,PERSON-PERSON,TITLE,PROPN-PROPN,NOUN,compound-nsubjpass,compound,NNP-NNP,NN,1,1
1730,2908.0,45,phwoarrrrr,0,8,16,8,7,28,-8,16,Adam Senn,Paris,PERSON-PERSON,CITY,PROPN-PROPN,PROPN,compound-nsubj,pobj,NNP-NNP,NNP,5,1
1731,2919.0,27,spun,3,17,1,-16,16,25,-14,-2,Direct TV,Time Warner,ORGANIZATION-ORGANIZATION,ORGANIZATION-ORGANIZATION,PROPN-PROPN,PROPN-PROPN,compound-dobj,compound-nsubj,NNP-NNP,NNP-NNP,4,1
1732,2929.0,33,died,29,7,16,9,6,16,22,-13,William Robert Anderson,captain,PERSON-PERSON-PERSON,TITLE,PROPN-PROPN-PROPN,NOUN,compound-compound-appos,conj,NNP-NNP-NNP,NN,5,1
1733,2933.0,30,NY-SCHOOLS-CHIEF,0,12,18,6,11,11,-12,18,Cathleen P. Black,Hearst Magazines,PERSON-PERSON-PERSON,ORGANIZATION-ORGANIZATION,PROPN-PROPN-PROPN,PROPN-PROPN,compound-compound-pobj,compound-pobj,NNP-NNP-NNP,NNP-NNPS,4,1
1734,6524.0,47,departed,10,18,14,-4,17,32,-8,4,Cathleen P. Black,Hearst Magazines,PERSON-PERSON-PERSON,ORGANIZATION-ORGANIZATION,PROPN-PROPN-PROPN,PROPN-PROPN,compound-compound-dobj,compound-dobj,NNP-NNP-NNP,NNP-NNP,5,1
1735,35936.0,40,announced,37,29,1,-28,28,38,8,-36,Cathleen P. Black,Hearst Magazines,PERSON-PERSON-PERSON,ORGANIZATION-ORGANIZATION,PROPN-PROPN-PROPN,PROPN-PROPN,compound-compound-nsubj,compound-pobj,NNP-NNP-NNP,NNP-NNP,3,1
1736,40840.0,20,said,9,1,7,6,0,12,8,-2,Cathleen P. Black,Hearst Magazines,PERSON-PERSON-PERSON,ORGANIZATION-ORGANIZATION,PROPN-PROPN-PROPN,PROPN-PROPN,compound-compound-nsubj,compound-appos,NNP-NNP-NNP,NNP-NNP,3,1
1737,42058.0,22,said,11,13,20,7,12,1,-2,9,Cathleen P. Black,Hearst Magazines,PERSON-PERSON-PERSON,ORGANIZATION-ORGANIZATION,PROPN-PROPN-PROPN,PROPN-PROPN,compound-compound-nsubj,compound-pobj,NNP-NNP-NNP,NNP-NNPS,5,1
1738,45377.0,48,NY-SCHOOLS-RESIGN,0,27,34,7,26,13,-27,34,Cathleen P. Black,Hearst Magazines,PERSON-PERSON-PERSON,ORGANIZATION-ORGANIZATION,PROPN-PROPN-PROPN,PROPN-PROPN,compound-compound-pobj,compound-pobj,NNP-NNP-NNP,NNP-NNPS,5,1
1739,46326.0,22,made,3,6,12,6,5,9,-3,9,Cathleen P. Black,Hearst Magazines,PERSON-PERSON-PERSON,ORGANIZATION-ORGANIZATION,PROPN-PROPN-PROPN,PROPN-PROPN,compound-compound-pobj,compound-conj,NNP-NNP-NNP,NNP-NNPS,3,1
1740,49315.0,17,announced,6,4,1,-3,3,15,2,-5,Cathleen P. Black,Hearst Magazines,PERSON-PERSON-PERSON,ORGANIZATION-ORGANIZATION,PROPN-PROPN-PROPN,PROPN-PROPN,compound-compound-nsubj,compound-compound,NNP-NNP-NNP,NNP-NNP,3,1
1741,50982.0,19,appointed,4,6,12,6,5,6,-2,8,Cathleen P. Black,Hearst Magazines,PERSON-PERSON-PERSON,ORGANIZATION-ORGANIZATION,PROPN-PROPN-PROPN,PROPN-PROPN,compound-compound-dobj,compound-pobj,NNP-NNP-NNP,NNP-NNPS,4,1
1742,56009.0,91,have,30,1,74,73,0,16,29,44,Cathleen P. Black,Hearst Magazines,PERSON-PERSON-PERSON,ORGANIZATION-ORGANIZATION,PROPN-PROPN-PROPN,PROPN-PROPN,compound-compound-nsubj,compound-pobj,NNP-NNP-NNP,NNP-NNPS,-1,1
1743,2936.0,38,said,17,30,34,4,29,3,-13,17,American Bar Association,White Collar Crime Committee,ORGANIZATION-ORGANIZATION-ORGANIZATION,ORGANIZATION-ORGANIZATION-ORGANIZATION-ORGANIZATION,PROPN-PROPN-PROPN,PROPN-PROPN-PROPN-PROPN,compound-compound-poss,compound-compound-compound-pobj,NNP-NNP-NNP,NNP-NNP-NNP-NNP,2,1
1744,2940.0,36,overlooks,5,15,15,0,14,20,-10,10,Massachusetts House of Representatives,Massachusetts,ORGANIZATION-ORGANIZATION-ORGANIZATION-ORGANIZATION,STATE_OR_PROVINCE,PROPN-PROPN-ADP-PROPN,PROPN,compound-pobj-prep-pobj,pobj,NNP-NNP-IN-NNPS,NNP,0,1
1745,27319.0,33,recorded,3,17,17,0,16,15,-14,14,Massachusetts House of Representatives,Massachusetts,ORGANIZATION-ORGANIZATION-ORGANIZATION-ORGANIZATION,STATE_OR_PROVINCE,PROPN-PROPN-ADP-PROPN,PROPN,compound-pobj-prep-pobj,pobj,NNP-NNP-IN-NNPS,NNP,0,1
1746,62583.0,40,-LRB-,0,24,24,0,23,15,-24,24,Massachusetts House of Representatives,Massachusetts,ORGANIZATION-ORGANIZATION-ORGANIZATION-ORGANIZATION,STATE_OR_PROVINCE,PROPN-PROPN-ADP-PROPN,PROPN,compound-pobj-prep-pobj,pobj,NNP-NNP-IN-NNPS,NNP,0,1
1747,2947.0,29,said,17,26,19,-7,25,9,-9,2,American Psychological Association,Frank Farley,ORGANIZATION-ORGANIZATION-ORGANIZATION,PERSON-PERSON,PROPN-PROPN-PROPN,PROPN-PROPN,compound-compound-pobj,compound-nsubj,NNP-NNP-NNP,NNP-NNP,4,1
1748,2948.0,29,said,7,5,1,-4,4,27,2,-6,John Negroponte,Top State Department,PERSON-PERSON,ORGANIZATION-ORGANIZATION-ORGANIZATION,PROPN-PROPN,PROPN-PROPN-PROPN,compound-nsubj,amod-compound-compound,NNP-NNP,NNP-NNP-NNP,3,1
1749,2950.0,46,were,25,8,15,7,7,30,17,-10,Gonzales,Rebecca,PERSON,PERSON,PROPN,PROPN,conj,appos,NNP,NNP,4,1
1750,2951.0,18,managed,5,13,3,-10,12,14,-8,-2,Golden Baseball League,Japan,ORGANIZATION-ORGANIZATION-ORGANIZATION,COUNTRY,PROPN-PROPN-PROPN,PROPN,compound-compound-pobj,compound,NNP-NNP-NNP,NNP,5,1
1751,2962.0,30,published,1,7,22,15,6,7,-6,21,his,New England Museum of Natural History,PERSON,ORGANIZATION-ORGANIZATION-ORGANIZATION-ORGANIZATION-ORGANIZATION-ORGANIZATION,DET,PROPN-PROPN-PROPN-ADP-PROPN-PROPN,poss,compound-compound-pobj-prep-compound-pobj,PRP$,NNP-NNP-NNP-IN-NNP-NNP,8,1
1752,2963.0,42,moved,16,11,15,4,10,26,5,-1,he,Paris,PERSON,CITY,PRON,PROPN,nsubj,pobj,PRP,NNP,5,1
1753,2968.0,41,said,4,32,40,8,31,0,-28,36,National Beef Packing Co.,Missouri,ORGANIZATION-ORGANIZATION-ORGANIZATION-ORGANIZATION,STATE_OR_PROVINCE,PROPN-PROPN-PROPN-PROPN,PROPN,compound-compound-compound-appos,appos,NNP-NNP-NNP-NNP,NNP,3,1
1754,22524.0,30,filed,10,21,29,8,20,0,-11,19,National Beef Packing Co.,Missouri,ORGANIZATION-ORGANIZATION-ORGANIZATION-ORGANIZATION,STATE_OR_PROVINCE,PROPN-PROPN-PROPN-PROPN,PROPN,compound-compound-compound-conj,appos,NNP-NNP-NNP-NNP,NNP,5,1
1755,2971.0,22,says,11,10,9,-1,9,12,1,-2,Sean Ross,analyst,PERSON-PERSON,TITLE,PROPN-PROPN,NOUN,compound-nsubj,compound,NNP-NNP,NN,1,1
1756,64218.0,40,said,28,30,35,5,29,4,-2,7,Sean Ross,analyst,PERSON-PERSON,TITLE,PROPN-PROPN,NOUN,compound-nsubj,appos,NNP-NNP,NN,2,1
1757,2973.0,24,said,9,12,18,6,11,5,-3,9,Barbara Boxer,Environment and Public Works Committee,PERSON-PERSON,ORGANIZATION-ORGANIZATION-ORGANIZATION-ORGANIZATION-ORGANIZATION,PROPN-PROPN,PROPN-CCONJ-PROPN-PROPN-PROPN,compound-nsubj,conj-cc-compound-compound-compound,NNP-NNP,NNP-CC-NNP-NNP-NNP,2,1
1758,7282.0,38,gathering,16,3,9,6,2,28,13,-7,Barbara Boxer,Environment and Public Works Committee,PERSON-PERSON,ORGANIZATION-ORGANIZATION-ORGANIZATION-ORGANIZATION-ORGANIZATION,PROPN-PROPN,PROPN-CCONJ-PROPN-PROPN-PROPN,compound-nsubj,pobj-cc-compound-compound-conj,NNP-NNP,NNP-CC-NNP-NNP-NNP,4,1
1759,35195.0,44,say,22,9,17,8,8,26,13,-5,Barbara Boxer,Environment and Public Works Committee,PERSON-PERSON,ORGANIZATION-ORGANIZATION-ORGANIZATION-ORGANIZATION-ORGANIZATION,PROPN-PROPN,PROPN-CCONJ-PROPN-PROPN-PROPN,compound-pobj,pobj-cc-compound-compound-conj,NNP-NNP,NNP-CC-NNP-NNP-NNP,5,1
1760,2995.0,29,premieres,1,19,1,-18,18,27,-18,0,Kelly Cutrone,Bravo,PERSON-PERSON,ORGANIZATION,PROPN-PROPN,PROPN,compound-appos,compound,NNP-NNP,NNP,5,1
1761,2996.0,44,UTC,5,40,41,1,39,2,-35,36,ADB,President Haruhiko Kuroda,ORGANIZATION,PERSON-PERSON-PERSON,PROPN,PROPN-PROPN-PROPN,compound,compound-compound-pobj,NNP,NNP-NNP-NNP,1,1
1762,2997.0,29,Peterborough,0,3,21,18,2,7,-3,21,George Boyd,Stevenage Borough,PERSON-PERSON,ORGANIZATION-ORGANIZATION,PROPN-PROPN,PROPN-PROPN,compound-ROOT,compound-pobj,NNP-NNP,NNP-NNP,-1,1
1763,15528.0,29,Peterborough,0,3,21,18,2,7,-3,21,George Boyd,Stevenage Borough,PERSON-PERSON,ORGANIZATION-ORGANIZATION,PROPN-PROPN,PROPN-PROPN,compound-nsubj,compound-pobj,NNP-NNP,NNP-NNP,-1,1
1764,2999.0,40,be,2,4,39,35,3,0,-2,37,David Gregory,MSNBC,PERSON-PERSON,ORGANIZATION,PROPN-PROPN,PROPN,compound-attr,pobj,NNP-NNP,NNP,5,1
1765,12946.0,43,canceled,18,33,23,-10,32,19,-15,5,David Gregory,MSNBC,PERSON-PERSON,ORGANIZATION,PROPN-PROPN,PROPN,compound-dobj,pobj,NNP-NNP,NNP,5,1
1766,20337.0,14,lose,4,2,13,11,1,0,2,9,David Gregory,MSNBC,PERSON-PERSON,ORGANIZATION,PROPN-PROPN,PROPN,compound-nsubj,pobj,NNP-NNP,NNP,2,1
1767,25904.0,26,given,2,15,1,-14,14,24,-13,-1,David Gregory,MSNBC,PERSON-PERSON,ORGANIZATION,PROPN-PROPN,PROPN,compound-conj,nsubj,NNP-NNP,NNP,4,1
1768,66499.0,45,said,1,12,36,24,11,8,-11,35,David Gregory,MSNBC,PERSON-PERSON,ORGANIZATION,PROPN-PROPN,PROPN,compound-pobj,pobj,NNP-NNP,NNP,5,1
1769,3001.0,30,included,1,4,7,3,3,22,-3,6,George Young,chairman,PERSON-PERSON,TITLE,PROPN-PROPN,NOUN,compound-dobj,appos,NNP-NNP,NN,2,1
1770,3004.0,45,reported,42,3,1,-2,2,43,39,-41,Juliette Binoche,French,PERSON-PERSON,NATIONALITY,PROPN-PROPN,ADJ,compound-pobj,amod,NNP-NNP,JJ,1,1
1771,8258.0,14,is,3,12,10,-2,11,3,-9,7,Juliette Binoche,French,PERSON-PERSON,NATIONALITY,PROPN-PROPN,ADJ,compound-dobj,amod,NNP-NNP,JJ,3,1
1772,10560.0,43,include,17,33,31,-2,32,11,-16,14,Juliette Binoche,French,PERSON-PERSON,NATIONALITY,PROPN-PROPN,ADJ,compound-dobj,amod,NNP-NNP,JJ,5,1
1773,10707.0,17,is,7,6,3,-3,5,13,1,-4,Juliette Binoche,French,PERSON-PERSON,NATIONALITY,PROPN-PROPN,PROPN,compound-nsubj,compound,NNP-NNP,NNP,3,1
1774,24185.0,36,embarked,4,3,1,-2,2,34,1,-3,Juliette Binoche,French,PERSON-PERSON,NATIONALITY,PROPN-PROPN,ADJ,compound-nsubj,amod,NNP-NNP,JJ,1,1
1775,42608.0,15,stars,4,8,6,-2,7,8,-4,2,Juliette Binoche,French,PERSON-PERSON,NATIONALITY,PROPN-PROPN,ADJ,compound-dobj,amod,NNP-NNP,JJ,3,1
1776,48783.0,32,comes,5,30,28,-2,29,3,-25,23,Juliette Binoche,French,PERSON-PERSON,NATIONALITY,PROPN-PROPN,ADJ,compound-pobj,amod,NNP-NNP,JJ,1,1
1777,60585.0,11,making,4,3,1,-2,2,9,1,-3,Juliette Binoche,French,PERSON-PERSON,NATIONALITY,PROPN-PROPN,ADJ,compound-nsubj,amod,NNP-NNP,JJ,1,1
1778,3009.0,31,lamented,15,14,2,-12,13,28,1,-13,Mohamed ElBaradei,Vienna,PERSON-PERSON,CITY,PROPN-PROPN,PROPN,compound-nsubj,pobj,NNP-NNP,NNP,4,1
1779,3026.0,15,born,5,2,14,12,1,0,3,9,Bradford Washburn,Cambridge,PERSON-PERSON,CITY,PROPN-PROPN,PROPN,compound-compound,pobj,NNP-NNP,NNP,3,1
1780,3028.0,51,slams,3,12,17,5,11,33,-9,14,Inter American Press Association,IAPA,ORGANIZATION-ORGANIZATION-ORGANIZATION-ORGANIZATION,ORGANIZATION,PROPN-PROPN-PROPN-PROPN,PROPN,compound-compound-compound-nsubj,compound,NNP-NNP-NNP-NNP,NNP,2,1
1781,6854.0,49,UTC,4,9,15,6,8,33,-5,11,Inter American Press Association,IAPA,ORGANIZATION-ORGANIZATION-ORGANIZATION-ORGANIZATION,ORGANIZATION,PROPN-PROPN-PROPN-PROPN,PROPN,compound-compound-compound-nsubj,conj,NNP-NNP-NNP-NNP,NNP,-1,1
1782,32978.0,43,said,10,3,9,6,2,33,7,-1,Inter American Press Association,IAPA,ORGANIZATION-ORGANIZATION-ORGANIZATION-ORGANIZATION,ORGANIZATION,PROPN-PROPN-PROPN-PROPN,PROPN,compound-compound-compound-nsubj,conj,NNP-NNP-NNP-NNP,NNP,2,1
1783,39216.0,60,Tone,4,38,43,5,37,16,-34,39,Inter American Press Association,IAPA,ORGANIZATION-ORGANIZATION-ORGANIZATION-ORGANIZATION,ORGANIZATION,PROPN-PROPN-PROPN-PROPN,PROPN,compound-compound-compound-appos,compound,NNP-NNP-NNP-NNP,NNP,6,1
1784,42905.0,31,denounced,18,2,7,5,1,23,16,-11,Inter American Press Association,IAPA,ORGANIZATION-ORGANIZATION-ORGANIZATION-ORGANIZATION,ORGANIZATION,PROPN-PROPN-PROPN-PROPN,PROPN,compound-compound-compound-nsubj,compound,NNP-NNP-NNP-NNP,NNP,2,1
1785,3034.0,38,said,36,2,27,25,1,10,34,-9,Paul Gillmor,Arlington,PERSON-PERSON,CITY,PROPN-PROPN,PROPN,compound-nsubjpass,pobj,NNP-NNP,NNP,2,1
1786,3047.0,15,was,1,12,7,-5,11,7,-11,6,American Basketball Association,Beijing Aoshen Olympian,ORGANIZATION-ORGANIZATION-ORGANIZATION,ORGANIZATION-ORGANIZATION-ORGANIZATION,PROPN-PROPN-PROPN,PROPN-PROPN-PROPN,compound-compound-pobj,compound-compound-pobj,NNP-NNP-NNP,NNP-NNP-NNP,4,1
1787,3052.0,16,http://wwwbreitbartcom/articlephp?id=D8R3HME80&show;_article=1,0,2,16,14,1,-1,-2,16,Deaver,Md,PERSON,STATE_OR_PROVINCE,PROPN,PROPN,nsubj,appos,NNP,NNP,-1,1
1788,3054.0,45,said,31,44,35,-9,43,9,-13,4,FMCSA,Brigham A. McCown,ORGANIZATION,PERSON-PERSON-PERSON,PROPN,PROPN-PROPN-PROPN,pobj,compound-compound-nsubj,NNP,NNP-NNP-NNP,5,1
1789,3067.0,18,shared,4,6,16,10,5,1,-2,12,DeGeneres,her,PERSON,PERSON,PROPN,DET,poss,poss,NNP,PRP$,7,1
1790,3069.0,43,said,19,28,21,-7,27,21,-9,2,Mainland Affairs Council,Fu Don-Cheng,ORGANIZATION-ORGANIZATION-ORGANIZATION,PERSON-PERSON,PROPN-PROPN-PROPN,PROPN-PROPN,compound-compound-pobj,compound-nsubj,NNP-NNPS-NNP,NNP-NNP,3,1
1791,3072.0,28,said,26,3,12,9,2,15,23,-14,Pascal Yoadimnadji,Paris,PERSON-PERSON,CITY,PROPN-PROPN,PROPN,compound-nsubj,compound,NNP-NNPS,NNP,3,1
1792,8748.0,11,dies,5,4,8,4,3,2,1,3,Pascal Yoadimnadji,Paris,PERSON-PERSON,CITY,PROPN-PROPN,PROPN,compound-nsubj,pobj,NNP-NNP,NNP,2,1
1793,17684.0,8,dies,5,4,8,4,3,-1,1,3,Pascal Yoadimnadji,Paris,PERSON-PERSON,CITY,PROPN-PROPN,PROPN,compound-nsubj,pobj,NNP-NNP,NNP,-1,1
1794,18876.0,25,said,22,5,10,5,4,14,17,-12,Pascal Yoadimnadji,Paris,PERSON-PERSON,CITY,PROPN-PROPN,PROPN,compound-nsubj,compound,NNP-NNPS,NNP,4,1
1795,23176.0,27,said,25,4,12,8,3,14,21,-13,Pascal Yoadimnadji,Paris,PERSON-PERSON,CITY,PROPN-PROPN,PROPN,compound-nsubj,pobj,NNP-NNP,NNP,5,1
1796,24657.0,19,says,5,11,5,-6,10,13,-6,0,Pascal Yoadimnadji,Paris,PERSON-PERSON,CITY,PROPN-PROPN,PROPN,compound-nsubj,pobj,NNP-NNPS,NNP,2,1
1797,27767.0,27,said,25,4,10,6,3,16,21,-15,Pascal Yoadimnadji,Paris,PERSON-PERSON,CITY,PROPN-PROPN,PROPN,compound-nsubj,compound,NNP-NNP,NNP,3,1
1798,32339.0,25,said,23,4,10,6,3,14,19,-13,Pascal Yoadimnadji,Paris,PERSON-PERSON,CITY,PROPN-PROPN,PROPN,compound-nsubj,compound,NNP-NNP,NNP,3,1
1799,32762.0,40,PARIS,0,34,39,5,33,0,-34,39,Pascal Yoadimnadji,Paris,PERSON-PERSON,CITY,PROPN-PROPN,PROPN,compound-pobj,pobj,NNP-NNPS,NNP,8,1
1800,38247.0,23,says,9,15,9,-6,14,13,-6,0,Pascal Yoadimnadji,Paris,PERSON-PERSON,CITY,PROPN-PROPN,PROPN,compound-nsubj,pobj,NNP-NNPS,NNP,6,1
1801,42182.0,44,said,42,21,29,8,20,14,21,-13,Pascal Yoadimnadji,Paris,PERSON-PERSON,CITY,PROPN-PROPN,PROPN,compound-nsubj,pobj,NNP-NNP,NNP,5,1
1802,42927.0,18,Yoadimnadji,2,2,17,15,1,0,0,15,Pascal Yoadimnadji,Paris,PERSON-PERSON,CITY,PROPN-PROPN,PROPN,compound-ROOT,pobj,NNP-NNPS,NNP,1,1
1803,62226.0,30,said,27,12,6,-6,11,23,15,-21,Pascal Yoadimnadji,Paris,PERSON-PERSON,CITY,PROPN-PROPN,PROPN,compound-pobj,compound,NNP-NNPS,NNP,2,1
1804,3075.0,34,concluded,19,1,17,16,0,16,18,-2,The Tax Policy Center,Urban Institute,ORGANIZATION-ORGANIZATION-ORGANIZATION-ORGANIZATION,ORGANIZATION-ORGANIZATION,DET-PROPN-PROPN-PROPN,PROPN-PROPN,det-compound-compound-nsubj,compound-conj,DT-NNP-NNP-NNP,NNP-NNP,8,1
1805,46616.0,37,gave,19,1,17,16,0,19,18,-2,The Tax Policy Center,Urban Institute,ORGANIZATION-ORGANIZATION-ORGANIZATION-ORGANIZATION,ORGANIZATION-ORGANIZATION,DET-PROPN-PROPN-PROPN,PROPN-PROPN,det-compound-compound-nsubj,compound-conj,DT-NNP-NNP-NNP,NNP-NNP,8,1
1806,3081.0,51,BATOR,1,19,22,3,18,28,-18,21,M Enkhbold,chairman,PERSON-PERSON,TITLE,PROPN-PROPN,NOUN,compound-nsubj,appos,NNP-NNP,NN,2,1
1807,10016.0,44,said,24,10,14,4,9,29,14,-10,M Enkhbold,chairman,PERSON-PERSON,TITLE,PROPN-PROPN,NOUN,compound-pobj,appos,NNP-NNP,NN,4,1
1808,14919.0,34,won,10,20,25,5,19,8,-10,15,M Enkhbold,chairman,PERSON-PERSON,TITLE,PROPN-PROPN,NOUN,compound-dobj,appos,NNP-NNP,NN,2,1
1809,3085.0,35,survived,2,27,30,3,26,4,-25,28,Eleanor Derounian,Austin,PERSON-PERSON,CITY,PROPN-PROPN,PROPN,compound-conj,pobj,NNP-NNP,NNP,1,1
1810,3110.0,49,referring,2,11,5,-6,10,43,-9,3,Taiwan Research Institute,Yu Keli,ORGANIZATION-ORGANIZATION-ORGANIZATION,PERSON-PERSON,PROPN-PROPN-PROPN,PROPN-PROPN,compound-compound-pobj,compound-pobj,NNP-NNP-NNP,NNP-NNP,4,1
1811,3535.0,43,Keli,1,7,1,-6,6,41,-6,0,Taiwan Research Institute,Yu Keli,ORGANIZATION-ORGANIZATION-ORGANIZATION,PERSON-PERSON,PROPN-PROPN-PROPN,PROPN-PROPN,compound-compound-pobj,compound-ROOT,NNP-NNP-NNP,NNP-NNP,4,1
1812,34843.0,76,Keli,1,7,1,-6,6,74,-6,0,Taiwan Research Institute,Yu Keli,ORGANIZATION-ORGANIZATION-ORGANIZATION,PERSON-PERSON,PROPN-PROPN-PROPN,PROPN-PROPN,compound-compound-pobj,compound-ROOT,NNP-NNP-NNP,NNP-NNP,4,1
1813,3111.0,22,received,2,15,21,6,14,0,-13,19,George Kennedy,actor,PERSON-PERSON,TITLE,PROPN-PROPN,NOUN,compound-nsubj,pobj,NNP-NNP,NN,5,1
1814,43629.0,24,nominated,6,14,23,9,13,0,-8,17,George Kennedy,actor,PERSON-PERSON,TITLE,PROPN-PROPN,NOUN,compound-nsubj,pobj,NNP-NNP,NN,4,1
1815,3112.0,54,said,19,36,50,14,35,3,-17,31,Lindsay M. Hayes,Correction Department,PERSON-PERSON-PERSON,ORGANIZATION-ORGANIZATION,PROPN-PROPN-PROPN,PROPN-PROPN,compound-compound-appos,compound-pobj,NNP-NNP-NNP,NNP-NNP,9,1
1816,3114.0,32,know,19,7,4,-3,6,27,12,-15,Bill McAllister,press secretary,PERSON-PERSON,TITLE-TITLE,PROPN-PROPN,NOUN-NOUN,compound-appos,compound-nsubj,NNP-NNP,NN-NN,1,1
1817,66292.0,26,interviewed,8,7,22,15,6,3,1,14,Bill McAllister,press secretary,PERSON-PERSON,TITLE-TITLE,PROPN-PROPN,NOUN-NOUN,compound-nsubj,compound-pobj,NNP-NNP,NN-NN,5,1
1818,3116.0,45,argued,1,20,11,-9,19,33,-19,10,FMCSA,Mexico,ORGANIZATION,COUNTRY,PROPN,PROPN,dobj,pobj,NNP,NNP,4,1
1819,3118.0,39,said,20,30,22,-8,29,16,-10,2,New Hampshire Institute of Politics,Dean Spiliotes,ORGANIZATION-ORGANIZATION-ORGANIZATION-ORGANIZATION-ORGANIZATION,PERSON-PERSON,PROPN-PROPN-PROPN-ADP-PROPN,PROPN-PROPN,compound-compound-pobj-prep-pobj,compound-nsubj,NNP-NNP-NNP-IN-NNP,NNP-NNP,6,1
1820,24654.0,39,said,21,30,23,-7,29,15,-9,2,New Hampshire Institute of Politics,Dean Spiliotes,ORGANIZATION-ORGANIZATION-ORGANIZATION-ORGANIZATION-ORGANIZATION,PERSON-PERSON,PROPN-PROPN-PROPN-ADP-PROPN,PROPN-PROPN,compound-compound-pobj-prep-pobj,compound-nsubj,NNP-NNP-NNP-IN-NNP,NNP-NNP,6,1
1821,38997.0,39,said,20,30,22,-8,29,16,-10,2,New Hampshire Institute of Politics,Dean Spiliotes,ORGANIZATION-ORGANIZATION-ORGANIZATION-ORGANIZATION-ORGANIZATION,PERSON-PERSON,PROPN-PROPN-PROPN-ADP-PROPN,PROPN-PROPN,compound-compound-pobj-prep-pobj,compound-nsubj,NNP-NNP-NNP-IN-NNP,NNP-NNP,6,1
1822,3122.0,28,says,19,9,17,8,8,10,10,-2,Fuller,story teller,PERSON,TITLE-TITLE,PROPN,NOUN-NOUN,poss,compound-pobj,NNP,NN-NN,3,1
1823,3138.0,25,VERITY-OBIT-MCC,0,2,21,19,1,3,-2,21,Verity,Calvin William Verity,PERSON,PERSON-PERSON-PERSON,PROPN,PROPN-PROPN-PROPN,nsubjpass,compound-compound-compound,NNP,NNP-NNP-NNP,9,1
1824,3152.0,42,died,30,1,39,38,0,2,29,9,William R Anderson,Leesburg,PERSON-PERSON-PERSON,CITY,PROPN-PROPN-PROPN,PROPN,compound-compound-nsubj,pobj,NNP-NNP-NNP,NNP,7,1
1825,3167.0,18,is,13,1,7,6,0,10,12,-6,Chante,Kenny Lattimore,PERSON,PERSON-PERSON,PROPN,PROPN-PROPN,poss,compound-pobj,NNP,NNP-NNP,4,1
1826,3183.0,41,is,25,25,23,-2,24,17,0,-2,Zubaydah,25,PERSON,NUMBER,PROPN,NUM,nsubj,attr,NNP,CD,1,1
1827,3188.0,25,said,18,1,4,3,0,20,17,-14,Waldheim,heart failure,PERSON,CAUSE_OF_DEATH-CAUSE_OF_DEATH,PROPN,NOUN-NOUN,nsubj,compound-pobj,NNP,NN-NN,2,1
1828,44767.0,16,quoted,10,1,4,3,0,11,9,-6,Waldheim,heart failure,PERSON,CAUSE_OF_DEATH-CAUSE_OF_DEATH,PROPN,NOUN-NOUN,nsubj,compound-pobj,NNP,NN-NN,2,1
1829,53558.0,26,VIENNA,0,14,21,7,13,4,-14,21,Waldheim,heart failure,PERSON,CAUSE_OF_DEATH-CAUSE_OF_DEATH,PROPN,NOUN-NOUN,nsubj,compound-pobj,NNP,NN-NN,3,1
1830,59159.0,37,died,20,7,23,16,6,13,13,3,Waldheim,heart failure,PERSON,CAUSE_OF_DEATH-CAUSE_OF_DEATH,PROPN,NOUN-NOUN,appos,compound-pobj,NNP,NN-NN,5,1
1831,3192.0,24,said,10,9,18,9,8,5,1,8,his,British,PERSON,NATIONALITY,DET,ADJ,poss,amod,PRP$,JJ,6,1
1832,3199.0,34,allowed,11,17,16,-1,16,17,-6,5,Julian Bond,Chairman,PERSON-PERSON,TITLE,PROPN-PROPN,PROPN,compound-nsubj,compound,NNP-NNP,NNP,1,1
1833,3937.0,56,said,41,40,39,-1,39,16,1,-2,Julian Bond,Chairman,PERSON-PERSON,TITLE,PROPN-PROPN,PROPN,compound-appos,compound,NNP-NNP,NNP,12,1
1834,24182.0,14,endorsed,5,3,2,-1,2,11,2,-3,Julian Bond,Chairman,PERSON-PERSON,TITLE,PROPN-PROPN,PROPN,compound-nsubj,compound,NNP-NNP,NNP,1,1
1835,25726.0,26,repeated,6,5,4,-1,4,21,1,-2,Julian Bond,Chairman,PERSON-PERSON,TITLE,PROPN-PROPN,PROPN,compound-nsubj,compound,NNP-NNP,NNP,1,1
1836,26914.0,25,chosen,11,17,16,-1,16,8,-6,5,Julian Bond,Chairman,PERSON-PERSON,TITLE,PROPN-PROPN,PROPN,compound-pobj,compound,NNP-NNP,NNP,1,1
1837,31514.0,35,said,30,29,28,-1,28,6,1,-2,Julian Bond,Chairman,PERSON-PERSON,TITLE,PROPN-PROPN,PROPN,compound-nsubj,compound,NNP-NNP,NNP,2,1
1838,37028.0,22,went,5,4,3,-1,3,18,1,-2,Julian Bond,Chairman,PERSON-PERSON,TITLE,PROPN-PROPN,PROPN,compound-nsubj,compound,NNP-NNP,NNP,1,1
1839,38504.0,30,wrote,25,24,23,-1,23,6,1,-2,Julian Bond,Chairman,PERSON-PERSON,TITLE,PROPN-PROPN,PROPN,compound-nsubj,compound,NNP-NNP,NNP,2,1
1840,41057.0,44,BEACH,1,31,30,-1,30,13,-30,29,Julian Bond,Chairman,PERSON-PERSON,TITLE,PROPN-PROPN,PROPN,compound-nsubj,compound,NNP-NNP,NNP,2,1
1841,47847.0,22,went,5,4,3,-1,3,18,1,-2,Julian Bond,Chairman,PERSON-PERSON,TITLE,PROPN-PROPN,PROPN,compound-nsubj,compound,NNP-NNP,NNP,1,1
1842,53687.0,44,said,39,27,26,-1,26,17,12,-13,Julian Bond,Chairman,PERSON-PERSON,TITLE,PROPN-PROPN,PROPN,compound-nsubj,compound,NNP-NNP,NNP,2,1
1843,57476.0,22,Bond,4,4,3,-1,3,18,0,-1,Julian Bond,Chairman,PERSON-PERSON,TITLE,PROPN-PROPN,PROPN,compound-ROOT,compound,NNP-NNP,NNP,1,1
1844,58962.0,22,drove,8,7,6,-1,6,15,1,-2,Julian Bond,Chairman,PERSON-PERSON,TITLE,PROPN-PROPN,PROPN,compound-nsubj,compound,NNP-NNP,NNP,1,1
1845,3204.0,64,told,43,41,29,-12,40,34,2,-14,University of Haifa,Dan Schueftan,ORGANIZATION-ORGANIZATION-ORGANIZATION,PERSON-PERSON,PROPN-ADP-PROPN,PROPN-PROPN,pobj-prep-pobj,compound-nsubj,NNP-IN-NNP,NNP-NNP,4,1
1846,3224.0,39,praised,7,18,10,-8,17,28,-11,3,International Crisis Group,Gareth Evans,ORGANIZATION-ORGANIZATION-ORGANIZATION,PERSON-PERSON,PROPN-PROPN-PROPN,PROPN-PROPN,compound-compound-pobj,compound-nsubj,NNP-NNP-NNP,NNP-NNP,4,1
1847,46472.0,44,said,12,7,1,-6,6,42,5,-11,International Crisis Group,Gareth Evans,ORGANIZATION-ORGANIZATION-ORGANIZATION,PERSON-PERSON,PROPN-PROPN-PROPN,PROPN-PROPN,compound-compound-pobj,compound-nsubj,NNP-NNP-NNP,NNP-NNP,4,1
1848,56935.0,60,warned,29,16,22,6,15,37,13,-7,International Crisis Group,Gareth Evans,ORGANIZATION-ORGANIZATION-ORGANIZATION,PERSON-PERSON,PROPN-PROPN-PROPN,PROPN-PROPN,compound-compound-appos,compound-conj,NNP-NNP-NNP,NNP-NNP,-1,1
1849,3229.0,46,...,0,32,43,11,31,2,-32,43,Richard Lindzen,National Academy of Sciences,PERSON-PERSON,ORGANIZATION-ORGANIZATION-ORGANIZATION-ORGANIZATION,PROPN-PROPN,PROPN-PROPN-ADP-PROPN,compound-ROOT,compound-pobj-prep-pobj,NNP-NNP,NNP-NNP-IN-NNPS,4,1
1850,25983.0,41,is,8,27,38,11,26,2,-19,30,Richard Lindzen,National Academy of Sciences,PERSON-PERSON,ORGANIZATION-ORGANIZATION-ORGANIZATION-ORGANIZATION,PROPN-PROPN,PROPN-PROPN-ADP-PROPN,compound-dobj,compound-pobj-prep-pobj,NNP-NNP,NNP-NNP-IN-NNPS,4,1
1851,58126.0,16,Lindzen,2,2,13,11,1,2,0,11,Richard Lindzen,National Academy of Sciences,PERSON-PERSON,ORGANIZATION-ORGANIZATION-ORGANIZATION-ORGANIZATION,PROPN-PROPN,PROPN-PROPN-ADP-PROPN,compound-ROOT,compound-pobj-prep-pobj,NNP-NNP,NNP-NNP-IN-NNPS,4,1
1852,3238.0,58,met,28,43,42,-1,42,15,-15,14,Al Hubbard,Director,PERSON-PERSON,TITLE,PROPN-PROPN,PROPN,compound-conj,compound,NNP-NNP,NNP,2,1
1853,32961.0,50,discussed,30,20,19,-1,19,30,10,-11,Al Hubbard,Director,PERSON-PERSON,TITLE,PROPN-PROPN,PROPN,compound-conj,compound,NNP-NNP,NNP,1,1
1854,3239.0,33,expected,21,3,1,-2,2,31,18,-20,Mia Farrow,American,PERSON-PERSON,NATIONALITY,PROPN-PROPN,ADJ,compound-nsubjpass,amod,NNP-NNP,JJ,1,1
1855,8022.0,38,blocked,2,6,4,-2,5,33,-4,2,Mia Farrow,American,PERSON-PERSON,NATIONALITY,PROPN-PROPN,ADJ,compound-dobj,amod,NNP-NNP,JJ,1,1
1856,26479.0,63,said,58,3,1,-2,2,61,55,-57,Mia Farrow,American,PERSON-PERSON,NATIONALITY,PROPN-PROPN,ADJ,compound-nsubj,amod,NNP-NNP,JJ,1,1
1857,32985.0,32,blocked,2,6,4,-2,5,27,-4,2,Mia Farrow,American,PERSON-PERSON,NATIONALITY,PROPN-PROPN,ADJ,compound-dobj,amod,NNP-NNP,JJ,1,1
1858,51542.0,33,said,4,3,1,-2,2,31,1,-3,Mia Farrow,American,PERSON-PERSON,NATIONALITY,PROPN-PROPN,ADJ,compound-nsubj,amod,NNP-NNP,JJ,1,1
1859,66890.0,41,blocked,5,9,7,-2,8,33,-4,2,Mia Farrow,American,PERSON-PERSON,NATIONALITY,PROPN-PROPN,ADJ,compound-dobj,amod,NNP-NNP,JJ,1,1
1860,3243.0,44,was,14,2,30,28,1,13,12,16,Daily News,September 2003,ORGANIZATION-ORGANIZATION,DATE-DATE,PROPN-PROPN,PROPN-NUM,compound-nsubj,pobj-nummod,NNP-NNP,NNP-CD,6,1
1861,3244.0,21,Truman,3,7,11,4,6,9,-4,8,Jefferson J. DeBlanc,Louise DeBlanc,PERSON-PERSON-PERSON,PERSON-PERSON,PROPN-PROPN-PROPN,PROPN-PROPN,compound-compound-pobj,compound-conj,NNP-NNP-NNP,NNP-NNP,3,1
1862,3245.0,37,said,20,22,32,10,21,4,-2,12,Herb Gibson,Occupational Safety and Health Administration,PERSON-PERSON,ORGANIZATION-ORGANIZATION-ORGANIZATION-ORGANIZATION-ORGANIZATION,PROPN-PROPN,PROPN-PROPN-CCONJ-PROPN-PROPN,compound-nsubj,nmod-nmod-cc-conj-pobj,NNP-NNP,NNP-NNP-CC-NNP-NNP,4,1
1863,63935.0,30,said,19,21,2,-19,20,27,-2,-17,Herb Gibson,Occupational Safety and Health Administration,PERSON-PERSON,ORGANIZATION-ORGANIZATION-ORGANIZATION-ORGANIZATION-ORGANIZATION,PROPN-PROPN,PROPN-PROPN-CCONJ-PROPN-PROPN,compound-nsubj,nmod-nmod-cc-conj-compound,NNP-NNP,NNP-NNP-CC-NNP-NNP,5,1
1864,3250.0,27,said,6,5,1,-4,4,25,1,-5,Konica Minolta,Japanese,ORGANIZATION-ORGANIZATION,COUNTRY,PROPN-PROPN,ADJ,compound-nsubj,amod,NNP-NNP,JJ,3,1
1865,19470.0,27,reported,6,5,1,-4,4,25,1,-5,Konica Minolta,Japanese,ORGANIZATION-ORGANIZATION,COUNTRY,PROPN-PROPN,ADJ,compound-nsubj,amod,NNP-NNP,JJ,3,1
1866,3253.0,50,appointed,17,1,5,4,0,44,16,-12,Chen Zhu,vice president,PERSON-PERSON,TITLE-TITLE,PROPN-PROPN,NOUN-NOUN,compound-nsubjpass,compound-appos,NNP-NNP,NN-NN,1,1
1867,3257.0,45,imagine,15,8,26,18,7,18,7,11,NEC,Ridge Racer,ORGANIZATION,ORGANIZATION-ORGANIZATION,PROPN,PROPN-PROPN,pobj,compound-compound,NNP,NNP-NNP,8,1
1868,3258.0,55,said,38,47,51,4,46,3,-9,13,Saint Anselm College,Manchester,ORGANIZATION-ORGANIZATION-ORGANIZATION,CITY,PROPN-PROPN-PROPN,PROPN,compound-compound-pobj,pobj,NNP-NNP-NNP,NNP,3,1
1869,3335.0,49,noted,34,44,48,4,43,0,-10,14,Saint Anselm College,Manchester,ORGANIZATION-ORGANIZATION-ORGANIZATION,CITY,PROPN-PROPN-PROPN,PROPN,compound-compound-pobj,pobj,NNP-NNP-NNP,NNP,6,1
1870,5836.0,28,held,4,10,15,5,9,12,-6,11,Saint Anselm College,Manchester,ORGANIZATION-ORGANIZATION-ORGANIZATION,CITY,PROPN-PROPN-PROPN,PROPN,compound-compound-pobj,pobj,NNP-NNP-NNP,NNP,4,1
1871,5954.0,12,was,2,7,11,4,6,0,-5,9,Saint Anselm College,Manchester,ORGANIZATION-ORGANIZATION-ORGANIZATION,CITY,PROPN-PROPN-PROPN,PROPN,compound-compound-pobj,pobj,NNP-NNP-NNP,NNP,5,1
1872,15777.0,80,said,33,42,46,4,41,33,-9,13,Saint Anselm College,Manchester,ORGANIZATION-ORGANIZATION-ORGANIZATION,CITY,PROPN-PROPN-PROPN,PROPN,compound-compound-pobj,pobj,NNP-NNP-NNP,NNP,3,1
1873,20866.0,18,held,3,8,15,7,7,2,-5,12,Saint Anselm College,Manchester,ORGANIZATION-ORGANIZATION-ORGANIZATION,CITY,PROPN-PROPN-PROPN,PROPN,compound-compound-poss,pobj,NNP-NNP-NNP,NNP,5,1
1874,24068.0,42,said,25,35,39,4,34,2,-10,14,Saint Anselm College,Manchester,ORGANIZATION-ORGANIZATION-ORGANIZATION,CITY,PROPN-PROPN-PROPN,PROPN,compound-compound-pobj,pobj,NNP-NNP-NNP,NNP,3,1
1875,26415.0,24,held,16,19,23,4,18,0,-3,7,Saint Anselm College,Manchester,ORGANIZATION-ORGANIZATION-ORGANIZATION,CITY,PROPN-PROPN-PROPN,PROPN,compound-compound-pobj,pobj,NNP-NNP-NNP,NNP,4,1
1876,67193.0,8,College,2,1,5,4,0,2,1,3,Saint Anselm College,Manchester,ORGANIZATION-ORGANIZATION-ORGANIZATION,CITY,PROPN-PROPN-PROPN,PROPN,compound-compound-ROOT,pobj,NNP-NNP-NNP,NNP,4,1
1877,67464.0,44,was,14,22,26,4,21,17,-8,12,Saint Anselm College,Manchester,ORGANIZATION-ORGANIZATION-ORGANIZATION,CITY,PROPN-PROPN-PROPN,PROPN,compound-compound-pobj,pobj,NNP-NNP-NNP,NNP,4,1
1878,3259.0,27,put,13,6,11,5,5,15,7,-2,Murat Kurnaz,Turk,PERSON-PERSON,NATIONALITY,PROPN-PROPN,PROPN,compound-pobj,appos,NNP-NNP,NNP,2,1
1879,3264.0,42,resonated,2,39,28,-11,38,13,-37,26,Donald E. Wildmon,American Family Association,PERSON-PERSON-PERSON,ORGANIZATION-ORGANIZATION-ORGANIZATION,PROPN-PROPN-PROPN,PROPN-PROPN-PROPN,compound-compound-appos,compound-compound-pobj,NNP-NNP-NNP,NNP-NNP-NNP,10,1
1880,55710.0,28,scored,4,18,25,7,17,2,-14,21,Donald E. Wildmon,American Family Association,PERSON-PERSON-PERSON,ORGANIZATION-ORGANIZATION-ORGANIZATION,PROPN-PROPN-PROPN,PROPN-PROPN-PROPN,compound-compound-appos,compound-compound-pobj,NNP-NNP-NNP,NNP-NNP-NNP,5,1
1881,3266.0,44,disrupted,12,18,30,12,17,13,-6,18,Sean Parker,entrepreneur,PERSON-PERSON,TITLE,PROPN-PROPN,NOUN,compound-compound,appos,NNP-NNP,NN,9,1
1882,10720.0,28,talking,14,1,5,4,0,22,13,-9,Sean Parker,entrepreneur,PERSON-PERSON,TITLE,PROPN-PROPN,NOUN,compound-nsubj,appos,NNP-NNP,NN,2,1
1883,18044.0,31,-LRB-,1,6,10,4,5,20,-5,9,Sean Parker,entrepreneur,PERSON-PERSON,TITLE,PROPN-PROPN,NOUN,compound-nsubj,appos,NNP-NNP,NN,-1,1
1884,3274.0,33,played,5,4,32,28,3,0,1,27,McNair,Greenville,PERSON,CITY,PROPN,PROPN,nsubj,pobj,NNP,NNP,2,1
1885,3281.0,57,told,5,4,3,-1,3,53,1,-2,Michael Ferrara,Attorney,PERSON-PERSON,TITLE,PROPN-PROPN,PROPN,compound-nsubj,compound,NNP-NNP,NNP,1,1
1886,3284.0,40,said,38,6,8,2,5,31,32,-30,SAC,Tai Hsia-ling,ORGANIZATION,PERSON-PERSON,PROPN,PROPN-NOUN,compound,compound-nsubj,NNP,NNP-NN,2,1
1887,30861.0,54,said,14,11,13,2,10,40,3,-1,SAC,Tai Hsia-ling,ORGANIZATION,PERSON-PERSON,PROPN,PROPN-PROPN,compound,compound-nsubj,NNP,NNP-NNP,2,1
1888,31250.0,54,Bi-ling,1,22,25,3,21,28,-21,24,SAC,Tai Hsia-ling,ORGANIZATION,PERSON-PERSON,PROPN,PROPN-NOUN,compound,compound-ROOT,NNP,NNP-NN,-1,1
1889,53431.0,30,made,2,26,28,2,25,1,-24,26,SAC,Tai Hsia-ling,ORGANIZATION,PERSON-PERSON,PROPN,PROPN-NOUN,compound,compound-conj,NNP,NNP-NN,3,1
1890,64575.0,31,said,4,1,3,2,0,27,3,-1,SAC,Tai Hsia-ling,ORGANIZATION,PERSON-PERSON,PROPN,PROPN-NOUN,compound,compound-nsubj,NNP,NNP-NN,2,1
1891,3286.0,45,say,1,27,21,-6,26,23,-26,20,Samsung Electronics,Jae-yong,ORGANIZATION-ORGANIZATION,PERSON,PROPN-PROPN,PROPN,compound-pobj,appos,NNP-NNPS,NNP,10,1
1892,3287.0,23,was,15,1,5,4,0,17,14,-10,Bolin,"April 11 , 1908",PERSON,DATE-DATE-DATE-DATE,PROPN,PROPN-NUM-PUNCT-NUM,nsubj,pobj-nummod-punct-nummod,NNP,"NNP-CD-,-CD",5,1
1893,3288.0,35,ZUCKERMAN,1,6,1,-5,5,33,-5,0,NY Daily News,MORTIMER ZUCKERMAN,ORGANIZATION-ORGANIZATION-ORGANIZATION,PERSON-PERSON,PROPN-PROPN-PROPN,PROPN-PROPN,compound-compound-pobj,compound-ROOT,NNP-NNP-NNP,NNP-NNP,4,1
1894,3289.0,25,born,4,1,7,6,0,17,3,3,Richmond McDavid,Dothan,PERSON-PERSON,CITY,PROPN-PROPN,PROPN,compound-compound,pobj,NNP-NNP,NNP,3,1
1895,3293.0,34,introduced,8,2,1,-1,1,32,6,-7,Carolyn B. Maloney,Rep.,PERSON-PERSON-PERSON,TITLE,PROPN-PROPN-PROPN,PROPN,compound-compound-nsubj,compound,NNP-NNP-NNP,NNP,2,1
1896,22175.0,68,said,29,32,31,-1,31,36,-3,2,Carolyn B. Maloney,Rep.,PERSON-PERSON-PERSON,TITLE,PROPN-PROPN-PROPN,PROPN,compound-compound-nsubj,compound,NNP-NNP-NNP,NNP,2,1
1897,24003.0,46,endorsed,16,19,18,-1,18,27,-3,2,Carolyn B. Maloney,Rep.,PERSON-PERSON-PERSON,TITLE,PROPN-PROPN-PROPN,PROPN,compound-compound-nsubj,compound,NNP-NNP-NNP,NNP,2,1
1898,29789.0,36,prepared,3,10,9,-1,9,26,-7,6,Carolyn B. Maloney,Rep.,PERSON-PERSON-PERSON,TITLE,PROPN-PROPN-PROPN,PROPN,compound-compound-pobj,compound,NNP-NNP-NNP,NNP,2,1
1899,29908.0,41,said,6,9,8,-1,8,32,-3,2,Carolyn B. Maloney,Rep.,PERSON-PERSON-PERSON,TITLE,PROPN-PROPN-PROPN,PROPN,compound-compound-nsubj,compound,NNP-NNP-NNP,NNP,2,1
1900,3302.0,44,produced,7,5,5,0,4,38,2,-2,China Faw Group,China,ORGANIZATION-ORGANIZATION-ORGANIZATION,COUNTRY,PROPN-PROPN-PROPN,PROPN,compound-compound-nsubj,poss,NNP-NNP-NNP,NNP,0,1
1901,3309.0,29,said,7,6,2,-4,5,26,1,-5,CNB,Czech National Bank,ORGANIZATION,ORGANIZATION-ORGANIZATION-ORGANIZATION,PROPN,PROPN-PROPN-PROPN,compound,compound-compound-compound,NNP,NNP-NNP-NNP,2,1
1902,34731.0,32,said,7,6,2,-4,5,29,1,-5,CNB,Czech National Bank,ORGANIZATION,ORGANIZATION-ORGANIZATION-ORGANIZATION,PROPN,PROPN-PROPN-PROPN,compound,compound-compound-compound,NNP,NNP-NNP-NNP,2,1
1903,38295.0,39,said,7,6,2,-4,5,36,1,-5,CNB,Czech National Bank,ORGANIZATION,ORGANIZATION-ORGANIZATION-ORGANIZATION,PROPN,PROPN-PROPN-PROPN,compound,compound-compound-compound,NNP,NNP-NNP-NNP,3,1
1904,62196.0,29,slashed,7,6,2,-4,5,26,1,-5,CNB,Czech National Bank,ORGANIZATION,ORGANIZATION-ORGANIZATION-ORGANIZATION,PROPN,PROPN-PROPN-PROPN,compound,compound-compound-compound,NNP,NNP-NNP-NNP,4,1
1905,3320.0,31,set,4,2,1,-1,1,29,2,-3,Erika Rose,Singer/songwriter,PERSON-PERSON,TITLE,PROPN-PROPN,PROPN,compound-nsubj,compound,NNP-NNP,NNP,1,1
1906,12440.0,36,putting,5,2,1,-1,1,34,3,-4,Erika Rose,Singer/songwriter,PERSON-PERSON,TITLE,PROPN-PROPN,PROPN,compound-nsubj,compound,NNP-NNP,NNP,1,1
1907,33168.0,25,released,3,2,1,-1,1,23,1,-2,Erika Rose,Singer/songwriter,PERSON-PERSON,TITLE,PROPN-PROPN,PROPN,compound-nsubj,compound,NNP-NNP,NNP,1,1
1908,3325.0,38,add,12,30,6,-24,29,31,-18,-6,USA Network,NBC,ORGANIZATION-ORGANIZATION,ORGANIZATION,PROPN-PROPN,PROPN,compound-dobj,poss,NNP-NNP,NNP,12,1
1909,11399.0,25,shows,16,15,1,-14,14,23,1,-15,USA Network,NBC,ORGANIZATION-ORGANIZATION,ORGANIZATION,PROPN-PROPN,PROPN,compound-pobj,nsubj,NNP-NNP,NNP,5,1
1910,15639.0,30,moving,10,28,1,-27,27,28,-18,-9,USA Network,NBC,ORGANIZATION-ORGANIZATION,ORGANIZATION,PROPN-PROPN,PROPN,compound-appos,nsubj,NNP-NNP,NNP,-1,1
1911,18209.0,28,acquire,3,14,5,-9,13,22,-11,2,USA Network,NBC,ORGANIZATION-ORGANIZATION,ORGANIZATION,PROPN-PROPN,PROPN,compound-conj,poss,NNP-NNP,NNP,5,1
1912,44939.0,27,televised,13,11,5,-6,10,21,2,-8,USA Network,NBC,ORGANIZATION-ORGANIZATION,ORGANIZATION,PROPN-PROPN,PROPN,compound-appos,nsubj,NNP-NNP,NNP,3,1
1913,3327.0,20,performing,5,4,17,13,3,2,1,12,Peterson,Johnny Holmes Orchestra,PERSON,ORGANIZATION-ORGANIZATION-ORGANIZATION,PROPN,PROPN-PROPN-PROPN,nsubj,compound-compound-appos,NNP,NNP-NNP-NNP,5,1
1914,3334.0,41,gained,2,2,14,12,1,26,0,12,Kollek,mayor,PERSON,TITLE,PROPN,NOUN,nsubj,pobj,NNP,NN,5,1
1915,3339.0,27,headed,5,5,8,3,4,18,0,3,she,Institute for Defense and Disarmament Studies,PERSON,ORGANIZATION-ORGANIZATION-ORGANIZATION-ORGANIZATION-ORGANIZATION-ORGANIZATION,PRON,PROPN-ADP-PROPN-CCONJ-PROPN-PROPN,nsubj,dobj-prep-nmod-cc-conj-pobj,PRP,NNP-IN-NNP-CC-NNP-NNPS,2,1
1916,3340.0,36,claim,1,21,16,-5,20,19,-20,15,KGB,Heidar Aliyev,ORGANIZATION,PERSON-PERSON,PROPN,PROPN-PROPN,compound,compound-pobj,NNP,NNP-NNP,3,1
1917,3362.0,26,proposed,14,2,23,21,1,2,12,9,Federal Aviation Administration-controlled,FAA,ORGANIZATION-ORGANIZATION-ORGANIZATION,ORGANIZATION,PROPN-PROPN-VERB,PROPN,compound-nmod-amod,compound,NNP-NNP-VBD,NNP,4,1
1918,3363.0,22,said,13,9,1,-8,8,20,4,-12,Servicemembers Legal Defense Network,Aaron Tax,ORGANIZATION-ORGANIZATION-ORGANIZATION-ORGANIZATION,PERSON-PERSON,PROPN-PROPN-PROPN-PROPN,PROPN-PROPN,compound-compound-compound-pobj,compound-nsubj,NNP-NNP-NNP-NNP,NNP-NNP,5,1
1919,3366.0,88,are,1,39,8,-31,38,79,-38,7,Jennifer Dunn,executive,PERSON-PERSON,TITLE,PROPN-PROPN,NOUN,compound-conj,conj,NNP-NNP,NN,4,1
1920,3367.0,33,called,19,9,15,6,8,17,10,-4,New Hampshire Institute of Politics,Saint Anselm College,ORGANIZATION-ORGANIZATION-ORGANIZATION-ORGANIZATION-ORGANIZATION,ORGANIZATION-ORGANIZATION-ORGANIZATION,PROPN-PROPN-PROPN-ADP-PROPN,PROPN-PROPN-PROPN,compound-compound-pobj-prep-pobj,compound-compound-pobj,NNP-NNP-NNP-IN-NNP,NNP-NNP-NNP,4,1
1921,3371.0,43,urged,17,1,11,10,0,31,16,-6,Khamenei,Commander-in-Chief,PERSON,TITLE,PROPN,PROPN,pobj,appos,NNP,NNP,2,1
1922,3373.0,38,said,36,20,14,-6,19,23,16,-22,TACC,Technical Assistance and Cooperation Committee,ORGANIZATION,ORGANIZATION-ORGANIZATION-ORGANIZATION-ORGANIZATION-ORGANIZATION,PROPN,PROPN-PROPN-CCONJ-PROPN-PROPN,compound,nmod-nmod-cc-conj-pobj,NNP,NNP-NNP-CC-NNP-NNP,5,1
1923,38327.0,48,divided,1,24,18,-6,23,29,-23,17,TACC,Technical Assistance and Cooperation Committee,ORGANIZATION,ORGANIZATION-ORGANIZATION-ORGANIZATION-ORGANIZATION-ORGANIZATION,PROPN,PROPN-PROPN-CCONJ-PROPN-PROPN,compound,nmod-nmod-cc-conj-pobj,NNP,NNP-NNP-CC-NNP-NNP,-1,1
1924,48976.0,29,Committee,10,13,7,-6,12,21,-3,-3,TACC,Technical Assistance and Cooperation Committee,ORGANIZATION,ORGANIZATION-ORGANIZATION-ORGANIZATION-ORGANIZATION-ORGANIZATION,PROPN,PROPN-PROPN-CCONJ-PROPN-PROPN,compound,nmod-nmod-cc-conj-ROOT,NNP,NNP-NNP-CC-NNP-NNP,4,1
1925,3375.0,61,found,34,22,31,9,21,29,12,-3,American Beverage Association,National Soft Drink Association,ORGANIZATION-ORGANIZATION-ORGANIZATION,ORGANIZATION-ORGANIZATION-ORGANIZATION-ORGANIZATION,PROPN-PROPN-PROPN,PROPN-PROPN-PROPN-PROPN,compound-compound-pobj,compound-compound-compound-pobj,NNP-NNP-NNP,NNP-NNP-NNP-NNP,8,1
1926,3378.0,54,cooperate,4,12,15,3,11,38,-8,11,Chunghwa Telecom,CHT,ORGANIZATION-ORGANIZATION,ORGANIZATION,PROPN-PROPN,PROPN,compound-appos,compound,NNP-NNP,NNP,-1,1
1927,30992.0,49,invest,3,1,26,25,0,22,2,23,Chunghwa Telecom,CHT,ORGANIZATION-ORGANIZATION,ORGANIZATION,PROPN-PROPN,PROPN,compound-nsubj,poss,NNP-NNP,NNP,4,1
1928,3381.0,48,died,37,17,6,-11,16,41,20,-31,her,clinical psychologist,PERSON,TITLE-TITLE,DET,ADJ-NOUN,poss,amod-appos,PRP$,JJ-NN,4,1
1929,3382.0,51,*,0,6,2,-4,5,48,-6,2,NSG,Nuclear Suppliers Group,ORGANIZATION,ORGANIZATION-ORGANIZATION-ORGANIZATION,PROPN,PROPN-PROPN-PROPN,compound,compound-compound-ROOT,NNP,NNP-NNPS-NNP,4,1
1930,25748.0,35,needs,3,14,9,-5,13,25,-11,6,NSG,Nuclear Suppliers Group,ORGANIZATION,DATE-DATE-DATE,PROPN,PROPN-PROPN-PROPN,conj,compound-compound-pobj,NNP,NNP-NNPS-NNP,2,1
1931,31905.0,44,*,0,15,11,-4,14,32,-15,11,NSG,Nuclear Suppliers Group,ORGANIZATION,ORGANIZATION-ORGANIZATION-ORGANIZATION,PROPN,PROPN-PROPN-PROPN,compound,compound-compound-conj,NNP,NNP-NNPS-NNP,-1,1
1932,32208.0,50,be,9,19,15,-4,18,34,-10,6,NSG,Nuclear Suppliers Group,ORGANIZATION,ORGANIZATION-ORGANIZATION-ORGANIZATION,PROPN,PROPN-PROPN-PROPN,compound,compound-compound-pobj,NNP,NNP-NNPS-NNP,-1,1
1933,41142.0,35,warned,9,34,29,-5,33,5,-25,20,NSG,Nuclear Suppliers Group,ORGANIZATION,ORGANIZATION-ORGANIZATION-ORGANIZATION,PROPN,PROPN-PROPN-PROPN,conj,compound-compound-pobj,NNP,NNP-NNPS-NNP,8,1
1934,43814.0,47,said,6,21,17,-4,20,29,-15,11,NSG,Nuclear Suppliers Group,ORGANIZATION,ORGANIZATION-ORGANIZATION-ORGANIZATION,PROPN,PROPN-PROPN-PROPN,compound,compound-compound-compound,NNP,NNP-NNPS-NNP,2,1
1935,43919.0,43,had,3,35,31,-4,34,11,-32,28,NSG,Nuclear Suppliers Group,ORGANIZATION,ORGANIZATION-ORGANIZATION-ORGANIZATION,PROPN,PROPN-PROPN-PROPN,compound,compound-compound-compound,NNP,NNP-NNPS-NNP,4,1
1936,53096.0,33,needs,2,14,10,-4,13,22,-12,8,NSG,Nuclear Suppliers Group,ORGANIZATION,ORGANIZATION-ORGANIZATION-ORGANIZATION,PROPN,PROPN-PROPN-PROPN,compound,compound-compound-pobj,NNP,NNP-NNPS-NNP,3,1
1937,56660.0,73,said,18,30,26,-4,29,46,-12,8,NSG,Nuclear Suppliers Group,ORGANIZATION,ORGANIZATION-ORGANIZATION-ORGANIZATION,PROPN,PROPN-PROPN-PROPN,compound,compound-compound-nmod,NNP,NNP-NNPS-NNP,4,1
1938,60252.0,29,added,27,23,19,-4,22,9,4,-8,NSG,Nuclear Suppliers Group,ORGANIZATION,ORGANIZATION-ORGANIZATION-ORGANIZATION,PROPN,PROPN-PROPN-PROPN,compound,compound-compound-compound,NNP,NNP-NNPS-NNP,1,1
1939,3385.0,33,honored,26,8,4,-4,7,28,18,-22,Irene Morgan,Gloucester County,PERSON-PERSON,LOCATION-LOCATION,PROPN-PROPN,PROPN-PROPN,compound-nsubj,compound-nsubj,NNP-NNP,NNP-NNP,2,1
1940,3386.0,35,founded,1,1,6,5,0,28,0,5,Forsberg,Institute for Defense and Disarmament Studies,PERSON,ORGANIZATION-ORGANIZATION-ORGANIZATION-ORGANIZATION-ORGANIZATION-ORGANIZATION,PROPN,PROPN-ADP-PROPN-CCONJ-PROPN-PROPN,nsubj,dobj-prep-pobj-cc-conj-conj,NNP,NNP-IN-NNP-CC-NNP-NNPS,3,1
1941,3387.0,43,obituary,6,9,19,10,8,23,-3,13,Jane Bolin,judge,PERSON-PERSON,TITLE,PROPN-PROPN,NOUN,compound-pobj,attr,NNP-NNP,NN,4,1
1942,3947.0,39,died,33,1,10,9,0,28,32,-23,Jane Bolin,judge,PERSON-PERSON,TITLE,PROPN-PROPN,NOUN,compound-nsubj,attr,NNP-NNP,NN,5,1
1943,25354.0,47,-LRB-,4,26,34,8,25,12,-22,30,Jane Bolin,judge,PERSON-PERSON,TITLE,PROPN-PROPN,NOUN,compound-nsubj,appos,NNP-NNP,NN,2,1
1944,32785.0,30,died,25,1,23,22,0,6,24,-2,Jane Bolin,judge,PERSON-PERSON,TITLE,PROPN-PROPN,NOUN,compound-nsubj,attr,NNP-NNP,NN,2,1
1945,41188.0,38,died,33,9,5,-4,8,32,24,-28,Jane Bolin,judge,PERSON-PERSON,TITLE,PROPN-PROPN,NOUN,compound-pobj,nsubj,NNP-NNP,NN,2,1
1946,3421.0,44,plans,8,2,43,41,1,0,6,35,China National Aviation Corp,Shanghai,ORGANIZATION-ORGANIZATION-ORGANIZATION-ORGANIZATION,CITY,PROPN-PROPN-PROPN-PROPN,PROPN,compound-compound-compound-appos,pobj,NNP-NNP-NNP-NNP,NNP,5,1
1947,3425.0,36,BOGOTA,0,24,23,-1,23,12,-24,23,Hugo Chavez,President,PERSON-PERSON,TITLE,PROPN-PROPN,PROPN,compound-nsubj,compound,NNP-NNP,NNP,2,1
1948,3466.0,43,told,15,19,18,-1,18,24,-4,3,Hugo Chavez,President,PERSON-PERSON,TITLE,PROPN-PROPN,PROPN,compound-dobj,compound,NNP-NNP,NNP,1,1
1949,4659.0,45,US,0,29,28,-1,28,16,-29,28,Hugo Chavez,President,PERSON-PERSON,TITLE,PROPN-PROPN,PROPN,compound-poss,compound,NNP-NNP,NNP,1,1
1950,4928.0,31,said,28,12,11,-1,11,19,16,-17,Hugo Chavez,President,PERSON-PERSON,TITLE,PROPN-PROPN,PROPN,compound-nsubj,compound,NNP-NNP,NNP,1,1
1951,7413.0,25,released,2,15,14,-1,14,10,-13,12,Hugo Chavez,President,PERSON-PERSON,TITLE,PROPN-PROPN,PROPN,compound-pobj,compound,NNP-NNP,NNP,1,1
1952,7833.0,32,announced,30,4,3,-1,3,28,26,-27,Hugo Chavez,President,PERSON-PERSON,TITLE,PROPN-PROPN,PROPN,compound-nsubj,compound,NNP-NNP,NNP,1,1
1953,9595.0,34,interviewed,5,10,9,-1,9,24,-5,4,Hugo Chavez,President,PERSON-PERSON,TITLE,PROPN-PROPN,PROPN,compound-dobj,compound,NNP-NNP,NNP,1,1
1954,10130.0,23,CARACAS,0,8,7,-1,7,15,-8,7,Hugo Chavez,President,PERSON-PERSON,TITLE,PROPN-PROPN,PROPN,compound-nsubj,compound,NNP-NNP,NNP,3,1
1955,15300.0,41,showed,15,11,10,-1,10,30,4,-5,Hugo Chavez,President,PERSON-PERSON,TITLE,PROPN-PROPN,PROPN,compound-conj,compound,NNP-NNP,NNP,1,1
1956,17048.0,34,claims,4,3,2,-1,2,31,1,-2,Hugo Chavez,President,PERSON-PERSON,TITLE,PROPN-PROPN,PROPN,compound-nsubj,compound,NNP-NNP,NNP,1,1
1957,17377.0,38,won,9,7,6,-1,6,31,2,-3,Hugo Chavez,President,PERSON-PERSON,TITLE,PROPN-PROPN,PROPN,compound-pobj,compound,NNP-NNP,NNP,1,1
1958,20288.0,22,CARACAS,0,9,8,-1,8,13,-9,8,Hugo Chavez,President,PERSON-PERSON,TITLE,PROPN-PROPN,PROPN,compound-nsubj,compound,NNP-NNP,NNP,5,1
1959,21077.0,17,warns,3,2,1,-1,1,15,1,-2,Hugo Chavez,President,PERSON-PERSON,TITLE,PROPN-PROPN,PROPN,compound-nsubj,compound,NNP-NNP,NNP,1,1
1960,22898.0,29,said,5,20,2,-18,19,26,-15,-3,Hugo Chavez,President,PERSON-PERSON,TITLE,PROPN-PROPN,PROPN,compound-poss,compound,NNP-NNP,NNP,10,1
1961,27323.0,17,CARACAS,0,8,7,-1,7,9,-8,7,Hugo Chavez,President,PERSON-PERSON,TITLE,PROPN-PROPN,PROPN,compound-nsubjpass,compound,NNP-NNP,NNP,1,1
1962,28475.0,37,plucked,6,5,4,-1,4,32,1,-2,Hugo Chavez,President,PERSON-PERSON,TITLE,PROPN-PROPN,PROPN,compound-pobj,compound,NNP-NNP,NNP,1,1
1963,30614.0,34,said,31,23,22,-1,22,11,8,-9,Hugo Chavez,President,PERSON-PERSON,TITLE,PROPN-PROPN,PROPN,compound-poss,compound,NNP-NNP,NNP,1,1
1964,31854.0,23,called,4,3,2,-1,2,20,1,-2,Hugo Chavez,President,PERSON-PERSON,TITLE,PROPN-PROPN,PROPN,compound-nsubj,compound,NNP-NNP,NNP,1,1
1965,32011.0,21,known,13,8,1,-7,7,19,5,-12,Hugo Chavez,President,PERSON-PERSON,TITLE,PROPN-PROPN,PROPN,compound-conj,compound,NNP-NNP,NNP,2,1
1966,33197.0,13,says,3,2,1,-1,1,11,1,-2,Hugo Chavez,President,PERSON-PERSON,TITLE,PROPN-PROPN,PROPN,compound-nsubj,compound,NNP-NNP,NNP,1,1
1967,33814.0,34,warned,4,3,2,-1,2,31,1,-2,Hugo Chavez,President,PERSON-PERSON,TITLE,PROPN-PROPN,PROPN,compound-nsubj,compound,NNP-NNP,NNP,1,1
1968,34829.0,30,CARACAS,0,10,9,-1,9,20,-10,9,Hugo Chavez,President,PERSON-PERSON,TITLE,PROPN-PROPN,PROPN,compound-conj,compound,NNP-NNP,NNP,1,1
1969,37140.0,19,CARACAS,0,8,7,-1,7,11,-8,7,Hugo Chavez,President,PERSON-PERSON,TITLE,PROPN-PROPN,PROPN,compound-nsubj,compound,NNP-NNP,NNP,2,1
1970,39876.0,42,said,15,14,13,-1,13,28,1,-2,Hugo Chavez,President,PERSON-PERSON,TITLE,PROPN-PROPN,PROPN,compound-nsubj,compound,NNP-NNP,NNP,1,1
1971,41377.0,40,demands,5,14,13,-1,13,26,-9,8,Hugo Chavez,President,PERSON-PERSON,TITLE,PROPN-PROPN,PROPN,compound-nsubj,compound,NNP-NNP,NNP,1,1
1972,41544.0,18,says,3,2,1,-1,1,16,1,-2,Hugo Chavez,President,PERSON-PERSON,TITLE,PROPN-PROPN,PROPN,compound-nsubj,compound,NNP-NNP,NNP,1,1
1973,43249.0,31,spent,1,8,7,-1,7,23,-7,6,Hugo Chavez,President,PERSON-PERSON,TITLE,PROPN-PROPN,PROPN,compound-pobj,compound,NNP-NNP,NNP,1,1
1974,44185.0,34,lobbied,4,24,1,-23,23,32,-20,-3,Hugo Chavez,President,PERSON-PERSON,TITLE,PROPN-PROPN,PROPN,compound-poss,compound,NNP-NNP,NNP,7,1
1975,45374.0,13,calls,4,3,2,-1,2,10,1,-2,Hugo Chavez,President,PERSON-PERSON,TITLE,PROPN-PROPN,PROPN,compound-nsubj,compound,NNP-NNP,NNP,1,1
1976,45614.0,42,sworn,25,12,11,-1,11,30,13,-14,Hugo Chavez,President,PERSON-PERSON,TITLE,PROPN-PROPN,PROPN,compound-pobj,compound,NNP-NNP,NNP,1,1
1977,45658.0,35,announced,15,13,12,-1,12,22,2,-3,Hugo Chavez,President,PERSON-PERSON,TITLE,PROPN-PROPN,PROPN,compound-pobj,compound,NNP-NNP,NNP,1,1
1978,47542.0,41,threatens,5,18,17,-1,17,23,-13,12,Hugo Chavez,President,PERSON-PERSON,TITLE,PROPN-PROPN,PROPN,compound-nsubj,compound,NNP-NNP,NNP,1,1
1979,50207.0,33,admitted,13,12,11,-1,11,21,1,-2,Hugo Chavez,President,PERSON-PERSON,TITLE,PROPN-PROPN,PROPN,compound-pobj,compound,NNP-NNP,NNP,1,1
1980,51163.0,19,says,9,8,7,-1,7,11,1,-2,Hugo Chavez,President,PERSON-PERSON,TITLE,PROPN-PROPN,PROPN,compound-nsubj,compound,NNP-NNP,NNP,2,1
1981,52384.0,24,urged,8,5,4,-1,4,19,3,-4,Hugo Chavez,President,PERSON-PERSON,TITLE,PROPN-PROPN,PROPN,compound-nsubj,compound,NNP-NNP,NNP,1,1
1982,53655.0,29,offered,11,10,9,-1,9,19,1,-2,Hugo Chavez,President,PERSON-PERSON,TITLE,PROPN-PROPN,PROPN,compound-nsubj,compound,NNP-NNP,NNP,2,1
1983,54210.0,25,confirmed,4,3,2,-1,2,22,1,-2,Hugo Chavez,President,PERSON-PERSON,TITLE,PROPN-PROPN,PROPN,compound-nsubj,compound,NNP-NNP,NNP,1,1
1984,55002.0,15,approve,2,11,10,-1,10,4,-9,8,Hugo Chavez,President,PERSON-PERSON,TITLE,PROPN-PROPN,PROPN,compound-poss,compound,NNP-NNP,NNP,1,1
1985,58566.0,30,said,8,7,6,-1,6,23,1,-2,Hugo Chavez,President,PERSON-PERSON,TITLE,PROPN-PROPN,PROPN,compound-nsubj,compound,NNP-NNP,NNP,1,1
1986,59365.0,19,CARACAS,0,9,8,-1,8,10,-9,8,Hugo Chavez,President,PERSON-PERSON,TITLE,PROPN-PROPN,PROPN,compound-nsubj,compound,NNP-NNP,NNP,5,1
1987,63203.0,43,threatens,5,16,15,-1,15,27,-11,10,Hugo Chavez,President,PERSON-PERSON,TITLE,PROPN-PROPN,PROPN,compound-dobj,compound,NNP-NNP,NNP,1,1
1988,68014.0,31,nationalizes,5,11,10,-1,10,20,-6,5,Hugo Chavez,President,PERSON-PERSON,TITLE,PROPN-PROPN,PROPN,compound-nsubj,compound,NNP-NNP,NNP,1,1
1989,3427.0,36,helped,15,11,6,-5,10,29,4,-9,him,judge,PERSON,TITLE,PRON,NOUN,dobj,dobj,PRP,NN,3,1
1990,54621.0,27,was,19,9,22,13,8,4,10,3,him,judge,PERSON,TITLE,PRON,NOUN,dobj,attr,PRP,NN,3,1
1991,3430.0,31,reported,29,3,1,-2,2,29,26,-28,Juanita Millender-McDonald,U.S.,PERSON-PERSON,COUNTRY,PROPN-PROPN,PROPN,compound-nsubj,compound,NNP-NNP,NNP,2,1
1992,55286.0,29,died,16,2,1,-1,1,27,14,-15,Juanita Millender-McDonald,U.S.,PERSON-PERSON,COUNTRY,PROPN-PROPN,PROPN,compound-nsubj,compound,NNP-NNP,NNP,2,1
1993,3431.0,47,granted,11,10,21,11,9,25,1,10,Hussein Kamel,Raghad,PERSON-PERSON,PERSON,PROPN-PROPN,PROPN,compound-pobj,poss,NNP-NNP,NNP,8,1
1994,3432.0,38,said,19,35,21,-14,34,16,-16,2,International Crisis Group,Joost Hiltermann,ORGANIZATION-ORGANIZATION-ORGANIZATION,PERSON-PERSON,PROPN-PROPN-PROPN,PROPN-PROPN,compound-compound-pobj,compound-nsubj,NNP-NNP-NNP,NNP-NNP,5,1
1995,38512.0,46,warned,23,16,8,-8,15,37,7,-15,International Crisis Group,Joost Hiltermann,ORGANIZATION-ORGANIZATION-ORGANIZATION,PERSON-PERSON,PROPN-PROPN-PROPN,PROPN-PROPN,compound-compound-pobj,compound-nsubj,NNP-NNP-NNP,NNP-NNP,4,1
1996,43897.0,38,said,24,32,26,-6,31,11,-8,2,International Crisis Group,Joost Hiltermann,ORGANIZATION-ORGANIZATION-ORGANIZATION,PERSON-PERSON,PROPN-PROPN-PROPN,PROPN-PROPN,compound-compound-pobj,compound-nsubj,NNP-NNP-NNP,NNP-NNP,5,1
1997,65659.0,47,said,33,44,35,-9,43,11,-11,2,International Crisis Group,Joost Hiltermann,ORGANIZATION-ORGANIZATION-ORGANIZATION,PERSON-PERSON,PROPN-PROPN-PROPN,PROPN-PROPN,compound-compound-pobj,compound-nsubj,NNP-NNP-NNP,NNP-NNP,5,1
1998,3435.0,16,is,1,1,7,6,0,8,0,6,He,Founders Fund,PERSON,ORGANIZATION-ORGANIZATION,PRON,PROPN-PROPN,nsubj,compound-pobj,PRP,NNP-NNP,3,1
1999,3440.0,16,Yingling,2,9,2,-7,8,13,-7,0,American Bankers Association,Ed Yingling,ORGANIZATION-ORGANIZATION-ORGANIZATION,PERSON-PERSON,PROPN-PROPN-PROPN,PROPN-PROPN,compound-compound-pobj,compound-ROOT,NNP-NNPS-NNP,NNP-NNP,4,1
2000,9101.0,26,said,15,23,17,-6,22,8,-8,2,American Bankers Association,Ed Yingling,ORGANIZATION-ORGANIZATION-ORGANIZATION,PERSON-PERSON,PROPN-PROPN-PROPN,PROPN-PROPN,compound-compound-pobj,compound-nsubj,NNP-NNPS-NNP,NNP-NNP,5,1
2001,32973.0,24,said,13,21,15,-6,20,8,-8,2,American Bankers Association,Ed Yingling,ORGANIZATION-ORGANIZATION-ORGANIZATION,PERSON-PERSON,PROPN-PROPN-PROPN,PROPN-PROPN,compound-compound-pobj,compound-nsubj,NNP-NNPS-NNP,NNP-NNP,5,1
2002,35681.0,22,said,10,19,12,-7,18,9,-9,2,American Bankers Association,Ed Yingling,ORGANIZATION-ORGANIZATION-ORGANIZATION,PERSON-PERSON,PROPN-PROPN-PROPN,PROPN-PROPN,compound-compound-pobj,compound-nsubj,NNP-NNPS-NNP,NNP-NNP,5,1
2003,47134.0,17,Yingling,2,10,2,-8,9,14,-8,0,American Bankers Association,Ed Yingling,ORGANIZATION-ORGANIZATION-ORGANIZATION,PERSON-PERSON,PROPN-PROPN-PROPN,PROPN-PROPN,compound-compound-pobj,compound-ROOT,NNP-NNPS-NNP,NNP-NNP,4,1
2004,52538.0,29,said,18,26,20,-6,25,8,-8,2,American Bankers Association,Ed Yingling,ORGANIZATION-ORGANIZATION-ORGANIZATION,PERSON-PERSON,PROPN-PROPN-PROPN,PROPN-PROPN,compound-compound-pobj,compound-nsubj,NNP-NNPS-NNP,NNP-NNP,5,1
2005,3442.0,30,approved,3,13,16,3,12,13,-10,13,Aerolineas Argentinas,AA,ORGANIZATION-ORGANIZATION,ORGANIZATION,PROPN-PROPN,PROPN,compound-compound,compound,NNP-NNP,NNP,-1,1
2006,31232.0,29,Delays,0,9,12,3,8,16,-9,12,Aerolineas Argentinas,AA,ORGANIZATION-ORGANIZATION,ORGANIZATION,PROPN-PROPN,PROPN,compound-compound,appos,NNP-NNP,NNP,-1,1
2007,58377.0,36,AIRES,1,11,14,3,10,21,-10,13,Aerolineas Argentinas,AA,ORGANIZATION-ORGANIZATION,ORGANIZATION,PROPN-PROPN,PROPN,compound-appos,compound,NNP-NNP,NNP,-1,1
2008,3444.0,34,was,21,5,15,10,4,18,16,-6,she,Connecticut,PERSON,STATE_OR_PROVINCE,PRON,PROPN,nsubj,compound,PRP,NNP,5,1
2009,3446.0,35,said,12,6,10,4,5,24,6,-2,International Crisis Group,Sophia Cason,ORGANIZATION-ORGANIZATION-ORGANIZATION,PERSON-PERSON,PROPN-PROPN-PROPN,PROPN-PROPN,compound-compound-pobj,compound-appos,NNP-NNP-NNP,NNP-NNP,2,1
2010,3450.0,39,released,15,7,4,-3,6,34,8,-11,Focus Action,Gary Schneeberger,ORGANIZATION-ORGANIZATION,PERSON-PERSON,PROPN-PROPN,PROPN-PROPN,compound-poss,compound-nsubj,NNP-NNP,NNP-NNP,2,1
2011,3462.0,91,Veterans,6,49,54,5,48,36,-43,48,Paralyzed Veterans of America,PAV,ORGANIZATION-ORGANIZATION-ORGANIZATION-ORGANIZATION,ORGANIZATION,PROPN-PROPN-ADP-PROPN,PROPN,compound-oprd-prep-pobj,compound,NNP-NNPS-IN-NNP,NNP,2,1
2012,3464.0,37,said,14,1,11,10,0,25,13,-3,Farrow,UNICEF,PERSON,ORGANIZATION,NOUN,PROPN,nsubj,compound,NN,NNP,5,1
2013,3468.0,17,considered,9,2,15,13,1,1,7,6,he,U.S.,PERSON,COUNTRY,PRON,PROPN,nsubj,compound,PRP,NNP,5,1
2014,5446.0,24,said,4,4,20,16,3,3,0,16,he,U.S.,PERSON,COUNTRY,PRON,PROPN,nsubj,compound,PRP,NNP,7,1
2015,16199.0,24,offer,4,18,9,-9,17,14,-14,5,he,U.S.,PERSON,COUNTRY,PRON,PROPN,nsubj,compound,PRP,NNP,3,1
2016,26998.0,24,said,4,4,20,16,3,3,0,16,he,U.S.,PERSON,COUNTRY,PRON,PROPN,nsubj,compound,PRP,NNP,7,1
2017,35251.0,31,made,1,11,15,4,10,15,-10,14,he,U.S.,PERSON,COUNTRY,PRON,PROPN,nsubj,compound,PRP,NNP,1,1
2018,42143.0,30,continues,8,8,4,-4,7,25,0,-4,he,U.S.,PERSON,COUNTRY,PRON,PROPN,nsubj,pobj,PRP,NNP,3,1
2019,3470.0,53,doing,4,46,42,-4,45,10,-42,38,Paul Watson,founder,PERSON-PERSON,TITLE,PROPN-PROPN,NOUN,compound-appos,pobj,NNP-NNP,NN,2,1
2020,68122.0,34,told,9,7,5,-2,6,28,2,-4,Paul Watson,founder,PERSON-PERSON,TITLE,PROPN-PROPN,NOUN,compound-appos,nsubj,NNP-NNP,NN,2,1
2021,3484.0,72,CHEYENNE,0,42,58,16,41,13,-42,58,Professional Rodeo Cowboys Association,United States,ORGANIZATION-ORGANIZATION-ORGANIZATION-ORGANIZATION,COUNTRY-COUNTRY,PROPN-PROPN-PROPN-PROPN,PROPN-PROPN,compound-compound-compound-pobj,compound-pobj,NNP-NNP-NNPS-NNP,NNP-NNP,6,1
2022,4327.0,66,said,26,36,52,16,35,13,-10,26,Professional Rodeo Cowboys Association,United States,ORGANIZATION-ORGANIZATION-ORGANIZATION-ORGANIZATION,COUNTRY-COUNTRY,PROPN-PROPN-PROPN-PROPN,PROPN-PROPN,compound-compound-compound-pobj,compound-pobj,NNP-NNP-NNPS-NNP,NNP-NNP,6,1
2023,3485.0,40,says,1,12,17,5,11,22,-11,16,Scorpions,National,ORGANIZATION,ORGANIZATION,PROPN,PROPN,nsubj,compound,NNPS,NNP,4,1
2024,3488.0,27,thinks,17,10,1,-9,9,25,7,-16,Zagat,Eric Ripert,ORGANIZATION,PERSON-PERSON,PROPN,PROPN-PROPN,poss,compound-nsubj,NNP,NNP-NNP,6,1
2025,3490.0,17,is,1,6,11,5,5,5,-5,10,George Young,lawmaker,PERSON-PERSON,TITLE,PROPN-PROPN,NOUN,compound-pobj,appos,NNP-NNP,NN,2,1
2026,5208.0,36,beat,2,8,6,-2,7,29,-6,4,George Young,lawmaker,PERSON-PERSON,TITLE,PROPN-PROPN,NOUN,compound-dobj,compound,NNP-NNP,NN,3,1
2027,18270.0,38,beat,4,10,8,-2,9,29,-6,4,George Young,lawmaker,PERSON-PERSON,TITLE,PROPN-PROPN,NOUN,compound-dobj,compound,NNP-NNP,NN,1,1
2028,43196.0,38,repeated,5,25,23,-2,24,14,-20,18,George Young,lawmaker,PERSON-PERSON,TITLE,PROPN-PROPN,NOUN,compound-dobj,compound,NNP-NNP,NN,1,1
2029,3492.0,32,won,12,9,19,10,8,12,3,7,United National Congress,Trinidad and Tobago,ORGANIZATION-ORGANIZATION-ORGANIZATION,COUNTRY-COUNTRY-COUNTRY,PROPN-PROPN-PROPN,PROPN-CCONJ-PROPN,compound-compound-pobj,pobj-cc-conj,NNP-NNP-NNP,NNP-CC-NNP,7,1
2030,20243.0,41,PORT,0,18,28,10,17,12,-18,28,United National Congress,Trinidad and Tobago,ORGANIZATION-ORGANIZATION-ORGANIZATION,COUNTRY-COUNTRY-COUNTRY,PROPN-PROPN-PROPN,PROPN-CCONJ-PROPN,compound-compound-pobj,pobj-cc-conj,NNP-NNP-NNP,NNP-CC-NNP,7,1
2031,37324.0,43,been,23,40,6,-34,39,36,-17,-17,United National Congress,Trinidad and Tobago,ORGANIZATION-ORGANIZATION-ORGANIZATION,COUNTRY-COUNTRY-COUNTRY,PROPN-PROPN-PROPN,PROPN-CCONJ-PROPN,compound-compound-dobj,dobj-cc-conj,NNP-NNP-NNP,NNP-CC-NNP,6,1
2032,3497.0,24,ranked,6,12,5,-7,11,18,-6,-1,Professional Rodeo Cowboys Association,Guthrie,ORGANIZATION-ORGANIZATION-ORGANIZATION-ORGANIZATION,PERSON,PROPN-PROPN-PROPN-PROPN,PROPN,compound-compound-compound-pobj,nsubjpass,NNP-NNP-NNPS-NNP,NNP,4,1
2033,3498.0,42,was,29,36,6,-30,35,35,-7,-23,country,Sheikh Mujibur Rahman,ORGANIZATION,PERSON-PERSON-PERSON,NOUN,PROPN-PROPN-PROPN,poss,compound-compound-appos,NN,NNP-NNP-NNP,6,1
2034,3507.0,32,said,24,18,14,-4,17,17,6,-10,Covidien,Richard J. Meelia,ORGANIZATION,PERSON-PERSON-PERSON,PROPN,PROPN-PROPN-PROPN,poss,compound-compound-nsubj,NNP,NNP-NNP-NNP,3,1
2035,60970.0,26,said,24,19,22,3,18,3,5,-2,Covidien,Richard J. Meelia,ORGANIZATION,PERSON-PERSON-PERSON,ADJ,PROPN-PROPN-PROPN,nmod,compound-compound-nsubj,JJ,NNP-NNP-NNP,3,1
2036,3512.0,33,said,13,6,9,3,5,23,7,-4,CNAC,Air China,ORGANIZATION,ORGANIZATION-ORGANIZATION,NOUN,PROPN-PROPN,dobj,compound-appos,NN,NNP-NNP,3,1
2037,5567.0,39,proposed,15,7,13,6,6,25,8,-2,CNAC,Air China,ORGANIZATION,ORGANIZATION-ORGANIZATION,PROPN,PROPN-PROPN,conj,compound-pobj,NNP,NNP-NNP,4,1
2038,48791.0,32,says,12,10,1,-9,9,30,2,-11,CNAC,Air China,ORGANIZATION,ORGANIZATION-ORGANIZATION,PROPN,PROPN-PROPN,compound,compound-compound,NNP,NNP-NNP,2,1
2039,62914.0,42,said,12,10,1,-9,9,40,2,-11,CNAC,Air China,ORGANIZATION,ORGANIZATION-ORGANIZATION,PROPN,PROPN-PROPN,compound,compound-poss,NNP,NNP-NNP,-1,1
2040,3513.0,38,Goodman,2,2,37,35,1,0,0,35,Carolyn Goodman,Friday,PERSON-PERSON,DATE,PROPN-PROPN,PROPN,compound-ROOT,npadvmod,NNP-NNP,NNP,-1,1
2041,26258.0,38,Goodman,2,2,37,35,1,0,0,35,Carolyn Goodman,Friday,PERSON-PERSON,DATE,PROPN-PROPN,PROPN,compound-nsubj,npadvmod,NNP-NNP,NNP,-1,1
2042,3515.0,31,declined,17,28,16,-12,27,14,-11,-1,IPSCO,Lisle,ORGANIZATION,CITY,PROPN,PROPN,nsubj,pobj,NNP,NNP,14,1
2043,3516.0,31,detained,20,11,7,-4,10,23,9,-13,National Union for the Total Independence of Angola,UNITA,ORGANIZATION-ORGANIZATION-ORGANIZATION-ORGANIZATION-ORGANIZATION-ORGANIZATION-ORGANIZATION-ORGANIZATION,ORGANIZATION,PROPN-PROPN-ADP-DET-PROPN-PROPN-ADP-PROPN,ADJ,compound-nsubjpass-prep-det-compound-pobj-prep-compound,compound,NNP-NNP-IN-DT-NNP-NNP-IN-NNP,JJ,4,1
2044,11429.0,45,party,4,8,17,9,7,27,-4,13,National Union for the Total Independence of Angola,UNITA,ORGANIZATION-ORGANIZATION-ORGANIZATION-ORGANIZATION-ORGANIZATION-ORGANIZATION-ORGANIZATION-ORGANIZATION,ORGANIZATION,PROPN-PROPN-ADP-DET-PROPN-PROPN-ADP-PROPN,PROPN,compound-appos-prep-det-compound-pobj-prep-pobj,compound,NNP-NNP-IN-DT-NNP-NNP-IN-NNP,NNP,2,1
2045,20089.0,49,Union,2,2,11,9,1,37,0,9,National Union for the Total Independence of Angola,UNITA,ORGANIZATION-ORGANIZATION-ORGANIZATION-ORGANIZATION-ORGANIZATION-ORGANIZATION-ORGANIZATION-ORGANIZATION,ORGANIZATION,PROPN-PROPN-ADP-DET-PROPN-PROPN-ADP-PROPN,PROPN,compound-ROOT-prep-det-compound-pobj-prep-pobj,compound,NNP-NNP-IN-DT-NNP-NNP-IN-NNP,NNP,1,1
2046,28074.0,32,broke,1,20,31,11,19,0,-19,30,National Union for the Total Independence of Angola,UNITA,ORGANIZATION-ORGANIZATION-ORGANIZATION-ORGANIZATION-ORGANIZATION-ORGANIZATION-ORGANIZATION-ORGANIZATION,PERSON,PROPN-PROPN-ADP-DET-PROPN-PROPN-ADP-PROPN,PROPN,compound-pobj-prep-det-compound-pobj-prep-pobj,pobj,NNP-NNP-IN-DT-NNP-NNP-IN-NNP,NNP,7,1
2047,33625.0,44,was,10,32,41,9,31,2,-22,31,National Union for the Total Independence of Angola,UNITA,ORGANIZATION-ORGANIZATION-ORGANIZATION-ORGANIZATION-ORGANIZATION-ORGANIZATION-ORGANIZATION-ORGANIZATION,ORGANIZATION,PROPN-PROPN-ADP-DET-PROPN-PROPN-ADP-PROPN,PROPN,compound-conj-prep-det-compound-pobj-prep-pobj,compound,NNP-NNP-IN-DT-NNP-NNP-IN-NNP,NNP,3,1
2048,41982.0,44,chiefs,4,8,17,9,7,26,-4,13,National Union for the Total Independence of Angola,UNITA,ORGANIZATION-ORGANIZATION-ORGANIZATION-ORGANIZATION-ORGANIZATION-ORGANIZATION-ORGANIZATION-ORGANIZATION,ORGANIZATION,PROPN-PROPN-ADP-DET-PROPN-PROPN-ADP-PROPN,PROPN,compound-pobj-prep-det-compound-pobj-prep-pobj,compound,NNP-NNP-IN-DT-NNP-NNP-IN-NNP,NNP,3,1
2049,3519.0,31,arrived,15,15,4,-11,14,26,0,-11,McNair,Democratic National Convention,PERSON,ORGANIZATION-ORGANIZATION-ORGANIZATION,PROPN,PROPN-PROPN-PROPN,nsubj,compound-compound-pobj,NNP,NNP-NNP-NNP,3,1
2050,3525.0,39,said,33,20,20,0,19,18,13,-13,GMAC 's Residential Capital LLC,GMAC,ORGANIZATION-ORGANIZATION-ORGANIZATION-ORGANIZATION-ORGANIZATION,ORGANIZATION,PROPN-PART-PROPN-PROPN-PROPN,PROPN,poss-case-compound-compound-compound,compound,NNP-POS-NNP-NNP-NNP,NNP,0,1
2051,3533.0,36,mandarins,24,2,7,5,1,28,22,-17,Ontario Human Rights Commission,Barbara Hall,ORGANIZATION-ORGANIZATION-ORGANIZATION-ORGANIZATION,PERSON-PERSON,PROPN-PROPN-PROPN-PROPN,PROPN-PROPN,compound-compound-compound-compound,compound-dobj,NNP-NNP-NNPS-NNP,NNP-NNP,4,1
2052,3538.0,30,launched,4,11,13,2,10,16,-7,9,UNC,Winston Dookeran,ORGANIZATION,PERSON-PERSON,PROPN,PROPN-PROPN,compound,compound-pobj,NNP,NNP-NNP,1,1
2053,12290.0,57,launched,4,11,13,2,10,43,-7,9,UNC,Winston Dookeran,ORGANIZATION,PERSON-PERSON,PROPN,PROPN-PROPN,compound,compound-pobj,NNP,NNP-NNP,1,1
2054,41384.0,36,PORT-OF-SPAIN,0,17,19,2,16,16,-17,19,UNC,Winston Dookeran,ORGANIZATION,PERSON-PERSON,PROPN,PROPN-PROPN,compound,compound-pobj,NNP,NNP-NNP,1,1
2055,3543.0,35,said,10,2,24,22,1,10,8,14,China National Aviation Corp.,Air China,ORGANIZATION-ORGANIZATION-ORGANIZATION-ORGANIZATION,ORGANIZATION-ORGANIZATION,PROPN-PROPN-PROPN-PROPN,PROPN-PROPN,compound-compound-compound-dobj,compound-appos,NNP-NNP-NNP-NNP,NNP-NNP,8,1
2056,9698.0,28,rejected,3,1,18,17,0,9,2,15,China National Aviation Corp.,Air China,ORGANIZATION-ORGANIZATION-ORGANIZATION-ORGANIZATION,ORGANIZATION-ORGANIZATION,PROPN-PROPN-PROPN-PROPN,PROPN-PROPN,compound-compound-compound-nsubj,compound-compound,NNP-NNP-NNP-NNP,NNP-NNP,8,1
2057,47776.0,35,voted,4,13,25,12,12,9,-9,21,China National Aviation Corp.,Air China,ORGANIZATION-ORGANIZATION-ORGANIZATION-ORGANIZATION,ORGANIZATION-ORGANIZATION,PROPN-PROPN-PROPN-PROPN,PROPN-PROPN,compound-compound-compound-subtok,compound-pobj,NNP-NNP-NNP-NNP,NNP-NNP,-1,1
2058,3545.0,40,died,32,1,37,36,0,2,31,5,Maj Gen John P Henebry,"Evanston , Ill",PERSON-PERSON-PERSON-PERSON-PERSON,STATE_OR_PROVINCE-STATE_OR_PROVINCE-STATE_OR_PROVINCE,PROPN-PROPN-PROPN-PROPN-PROPN,PROPN-PUNCT-PROPN,compound-compound-compound-compound-nsubj,pobj-punct-appos,NNP-NNP-NNP-NNP-NNP,"NNP-,-NNP",3,1
2059,3549.0,18,Yoadimnadji,2,2,9,7,1,8,0,7,Pascal Yoadimnadji,prime minister,PERSON-PERSON,TITLE-TITLE,PROPN-PROPN,ADJ-NOUN,compound-ROOT,amod-appos,NNP-NNPS,JJ-NN,1,1
2060,3563.0,12,died,8,5,3,-2,4,8,3,-5,Juanita Millender-McDonald,congresswoman,PERSON-PERSON,TITLE,PROPN-PROPN,NOUN,compound-appos,nsubj,NNP-NNP,NN,3,1
2061,3564.0,39,said,14,1,9,8,0,29,13,-5,Mahmood Shah,Pakistan,PERSON-PERSON,COUNTRY,PROPN-PROPN,PROPN,compound-nsubj,poss,NNP-NNP,NNP,5,1
2062,7078.0,44,said,16,1,11,10,0,32,15,-5,Mahmood Shah,Pakistan,PERSON-PERSON,COUNTRY,PROPN-PROPN,PROPN,compound-nsubj,pobj,NNP-NNP,NNP,5,1
2063,9541.0,56,said,20,1,9,8,0,46,19,-11,Mahmood Shah,Pakistan,PERSON-PERSON,COUNTRY,PROPN-PROPN,PROPN,compound-nsubj,nsubj,NNP-NNP,NNP,5,1
2064,13473.0,42,said,15,1,9,8,0,32,14,-6,Mahmood Shah,Pakistan,PERSON-PERSON,ORGANIZATION,PROPN-PROPN,PROPN,compound-nsubj,poss,NNP-NNP,NNP,5,1
2065,15959.0,32,said,13,1,9,8,0,22,12,-4,Mahmood Shah,Pakistan,PERSON-PERSON,COUNTRY,PROPN-PROPN,PROPN,compound-nsubj,poss,NNP-NNP,NNP,5,1
2066,17859.0,24,said,15,17,14,-3,16,9,-2,-1,Mahmood Shah,Pakistan,PERSON-PERSON,COUNTRY,PROPN-PROPN,PROPN,compound-nsubj,conj,NNP-NNP,NNP,2,1
2067,22194.0,46,said,12,1,45,44,0,0,11,33,Mahmood Shah,Pakistan,PERSON-PERSON,COUNTRY,PROPN-PROPN,PROPN,compound-nsubj,pobj,NNP-NNP,NNP,10,1
2068,30689.0,37,said,14,1,9,8,0,27,13,-5,Mahmood Shah,Pakistan,PERSON-PERSON,COUNTRY,PROPN-PROPN,PROPN,compound-nsubj,poss,NNP-NNP,NNP,5,1
2069,37634.0,45,said,14,1,10,9,0,34,13,-4,Mahmood Shah,Pakistan,PERSON-PERSON,COUNTRY,PROPN-PROPN,PROPN,compound-nsubj,poss,NNP-NNP,NNP,5,1
2070,40998.0,36,said,13,1,9,8,0,26,12,-4,Mahmood Shah,Pakistan,PERSON-PERSON,COUNTRY,PROPN-PROPN,PROPN,compound-nsubj,poss,NNP-NNP,NNP,5,1
2071,54895.0,26,called,15,1,11,10,0,14,14,-4,Mahmood Shah,Pakistan,PERSON-PERSON,COUNTRY,PROPN-PROPN,PROPN,compound-nsubj,poss,NNP-NNP,NNP,6,1
2072,55390.0,28,said,14,2,9,7,1,18,12,-5,Mahmood Shah,Pakistan,PERSON-PERSON,COUNTRY,PROPN-PROPN,PROPN,compound-nsubj,poss,NNP-NNP,NNP,5,1
2073,59797.0,56,said,20,1,9,8,0,46,19,-11,Mahmood Shah,Pakistan,PERSON-PERSON,COUNTRY,PROPN-PROPN,PROPN,compound-nsubj,poss,NNP-NNP,NNP,5,1
2074,3576.0,34,called,28,6,15,9,5,18,22,-13,Bolin,judge,PERSON,TITLE,PROPN,NOUN,nsubj,conj,NNP,NN,3,1
2075,7678.0,35,sworn,2,1,22,21,0,12,1,20,Bolin,judge,PERSON,TITLE,PROPN,NOUN,nsubjpass,attr,NNP,NN,4,1
2076,47087.0,34,called,28,6,15,9,5,18,22,-13,Bolin,judge,PERSON,TITLE,PROPN,NOUN,nsubj,pobj,NNP,NN,3,1
2077,3582.0,51,died,41,1,48,47,0,2,40,7,Richmond M. Flowers,Dothan,PERSON-PERSON-PERSON,CITY,PROPN-PROPN-PROPN,PROPN,compound-compound-nsubj,pobj,NNP-NNP-NNP,NNP,7,1
2078,3588.0,18,pictures,4,13,12,-1,12,5,-9,8,Alice Dellal,Model,PERSON-PERSON,TITLE,PROPN-PROPN,PROPN,compound-ROOT,compound,NNP-NNP,NNP,1,1
2079,67446.0,33,Scandal,0,4,3,-1,3,29,-4,3,Alice Dellal,Model,PERSON-PERSON,TITLE,PROPN-PROPN,PROPN,compound-nsubj,compound,NNP-NNP,NNP,1,1
2080,3589.0,48,was,25,14,23,9,13,24,11,-2,Badr Corps,Supreme Council,ORGANIZATION-ORGANIZATION,ORGANIZATION-ORGANIZATION,PROPN-PROPN,PROPN-PROPN,compound-dobj,compound-pobj,NNP-NNP,NNP-NNP,2,1
2081,3592.0,55,said,53,8,20,12,7,34,45,-33,Hubbard,director,PERSON,TITLE,PROPN,NOUN,dobj,conj,NNP,NN,5,1
2082,3593.0,25,see,15,5,21,16,4,3,10,6,Markit,http://www.markit.com,ORGANIZATION,URL,PROPN,X,pobj,pobj,NNP,ADD,7,1
2083,3600.0,44,2008-03-17T15,0,19,31,12,18,12,-19,31,Institute for Diversity and Ethics in Sport,Florida,ORGANIZATION-ORGANIZATION-ORGANIZATION-ORGANIZATION-ORGANIZATION-ORGANIZATION-ORGANIZATION,STATE_OR_PROVINCE,PROPN-ADP-PROPN-CCONJ-PROPN-ADP-PROPN,PROPN,pobj-prep-pobj-cc-conj-prep-pobj,pobj,NNP-IN-NNP-CC-NNP-IN-NNP,NNP,6,1
2084,3601.0,31,said,10,3,7,4,2,23,7,-3,Carolyn Maloney,New York,PERSON-PERSON,STATE_OR_PROVINCE-STATE_OR_PROVINCE,PROPN-PROPN,PROPN-PROPN,compound-nsubj,compound-compound,NNP-NNP,NNP-NNP,2,1
2085,31339.0,33,proposes,6,2,5,3,1,27,4,-1,Carolyn Maloney,New York,PERSON-PERSON,STATE_OR_PROVINCE-STATE_OR_PROVINCE,PROPN-PROPN,PROPN-PROPN,compound-nsubj,compound-pobj,NNP-NNP,NNP-NNP,2,1
2086,55238.0,26,proposing,13,3,6,3,2,19,10,-7,Carolyn Maloney,New York,PERSON-PERSON,STATE_OR_PROVINCE-STATE_OR_PROVINCE,PROPN-PROPN,PROPN-PROPN,compound-nsubj,compound-pobj,NNP-NNP,NNP-NNP,2,1
2087,63011.0,55,are,13,41,15,-26,40,39,-28,2,Carolyn Maloney,New York,PERSON-PERSON,STATE_OR_PROVINCE-STATE_OR_PROVINCE,PROPN-PROPN,PROPN-PROPN,compound-conj,compound-compound,NNP-NNP,NNP-NNP,6,1
2088,63759.0,36,said,28,34,30,-4,33,5,-6,2,Carolyn Maloney,New York,PERSON-PERSON,STATE_OR_PROVINCE-STATE_OR_PROVINCE,PROPN-PROPN,PROPN-PROPN,compound-nsubj,compound-compound,NNP-NNP,NNP-NNP,3,1
2089,66526.0,7,Maloney,3,3,6,3,2,0,0,3,Carolyn Maloney,New York,PERSON-PERSON,STATE_OR_PROVINCE-STATE_OR_PROVINCE,PROPN-PROPN,PROPN-PROPN,compound-ROOT,compound-pobj,NNP-NNP,NNP-NNP,2,1
2090,3612.0,29,retired,20,20,8,-12,19,20,0,-12,he,Marine Air Reserve Group,PERSON,ORGANIZATION-ORGANIZATION-ORGANIZATION-ORGANIZATION,PRON,PROPN-PROPN-PROPN-PROPN,nsubj,compound-compound-compound-pobj,PRP,NNP-NNP-NNP-NNP,8,1
2091,3626.0,49,DAMASCUS,0,13,5,-8,12,43,-13,5,Ahmad Qattan,representative,PERSON-PERSON,TITLE,PROPN-PROPN,NOUN,compound-pobj,nsubj,NNP-NNP,NN,3,1
2092,13789.0,54,-LRB-,0,18,10,-8,17,43,-18,10,Ahmad Qattan,representative,PERSON-PERSON,TITLE,PROPN-PROPN,NOUN,compound-pobj,appos,NNP-NNP,NN,4,1
2093,19395.0,45,said,12,11,3,-8,10,41,1,-9,Ahmad Qattan,representative,PERSON-PERSON,TITLE,PROPN-PROPN,NOUN,compound-pobj,nsubj,NNP-NNP,NN,3,1
2094,29622.0,46,DAMASCUS,0,13,5,-8,12,40,-13,5,Ahmad Qattan,representative,PERSON-PERSON,TITLE,PROPN-PROPN,NOUN,compound-pobj,nsubj,NNP-NNP,NN,3,1
2095,37884.0,44,said,15,14,6,-8,13,37,1,-9,Ahmad Qattan,representative,PERSON-PERSON,TITLE,PROPN-PROPN,NOUN,compound-pobj,nsubj,NNP-NNP,NN,2,1
2096,61598.0,63,DAMASCUS,0,29,21,-8,28,41,-29,21,Ahmad Qattan,representative,PERSON-PERSON,TITLE,PROPN-PROPN,NOUN,compound-pobj,dobj,NNP-NNP,NN,4,1
2097,62082.0,44,announced,14,13,8,-5,12,35,1,-6,Ahmad Qattan,representative,PERSON-PERSON,TITLE,PROPN-PROPN,NOUN,compound-pobj,nsubj,NNP-NNP,NN,1,1
2098,3627.0,13,Leader,1,9,5,-4,8,7,-8,4,George Young,House of Commons,PERSON-PERSON,ORGANIZATION-ORGANIZATION-ORGANIZATION,PROPN-PROPN,PROPN-ADP-PROPN,compound-compound,pobj-prep-pobj,NNP-NNP,NNP-IN-NNP,4,1
2099,49238.0,36,said,12,1,8,7,0,27,11,-4,George Young,House of Commons,PERSON-PERSON,ORGANIZATION-ORGANIZATION-ORGANIZATION,PROPN-PROPN,PROPN-ADP-PROPN,compound-nsubj,pobj-prep-pobj,NNP-NNP,NNP-IN-NNP,4,1
2100,3640.0,15,said,6,6,2,-4,5,12,0,-4,Ospel,executive board president,PERSON,TITLE-TITLE-TITLE,PROPN,ADJ-NOUN-NOUN,nsubj,compound-compound-compound,NNP,JJ-NN-NN,3,1
2101,3643.0,46,performed,12,12,6,-6,11,39,0,-6,she,Atlanta,PERSON,CITY,PRON,PROPN,nsubj,compound,PRP,NNP,2,1
2102,3647.0,31,suffered,2,2,9,7,1,21,0,7,TSE,November 2005,ORGANIZATION,DATE-DATE,PROPN,PROPN-NUM,nsubj,pobj-nummod,NNP,NNP-CD,1,1
2103,3650.0,38,died,28,1,38,37,0,-1,27,10,Bradford Washburn,Mass,PERSON-PERSON,STATE_OR_PROVINCE,PROPN-PROPN,PROPN,compound-nsubj,appos,NNP-NNP,NNP,-1,1
2104,3651.0,30,face,1,26,28,2,25,1,-25,27,UNITA,Jonas Savimbi,ORGANIZATION,PERSON-PERSON,PROPN,PROPN-PROPN,compound,compound-dobj,NNP,NNP-NNP,1,1
2105,52055.0,35,took,3,10,12,2,9,22,-7,9,UNITA,Jonas Savimbi,ORGANIZATION,PERSON-PERSON,PROPN,PROPN-PROPN,compound,compound-nsubj,NNP,NNP-NNP,1,1
2106,3653.0,57,2009-03-06T16,0,13,12,-1,12,44,-13,12,Melanie Fiona,vocalist,PERSON-PERSON,TITLE,PROPN-PROPN,NOUN,compound-nsubj,compound,NNP-NNP,NN,1,1
2107,33069.0,55,talked,12,11,10,-1,10,44,1,-2,Melanie Fiona,vocalist,PERSON-PERSON,TITLE,PROPN-PROPN,NOUN,compound-nsubj,compound,NNP-NNP,NN,1,1
2108,38123.0,51,Visit,1,4,9,5,3,41,-3,8,Melanie Fiona,vocalist,PERSON-PERSON,TITLE,PROPN-PROPN,NOUN,compound-ROOT,compound,NNP-NNP,NN,2,1
2109,3667.0,21,opposed,1,18,11,-7,17,9,-17,10,American Basketball Association,NBA,ORGANIZATION-ORGANIZATION-ORGANIZATION,ORGANIZATION,PROPN-PROPN-PROPN,PROPN,compound-compound-appos,pobj,NNP-NNP-NNP,NNP,3,1
2110,43361.0,31,evolved,2,10,29,19,9,1,-8,27,American Basketball Association,NBA,ORGANIZATION-ORGANIZATION-ORGANIZATION,ORGANIZATION,PROPN-PROPN-PROPN,PROPN,compound-compound-pobj,compound,NNP-NNP-NNP,NNP,10,1
2111,3668.0,42,talked,2,22,20,-2,21,21,-20,18,James B. Stewart,editor,PERSON-PERSON-PERSON,TITLE,PROPN-PROPN-PROPN,NOUN,compound-compound-conj,attr,NNP-NNP-NNP,NN,3,1
2112,3681.0,32,said,7,1,5,4,0,26,6,-2,Shah,security official,PERSON,TITLE-TITLE,PROPN,NOUN-NOUN,nsubj,compound-appos,NNP,NN-NN,2,1
2113,3685.0,92,Weitz,1,7,11,4,6,80,-6,10,Jewish National Fund,JNF,ORGANIZATION-ORGANIZATION-ORGANIZATION,ORGANIZATION,ADJ-PROPN-PROPN,PROPN,amod-compound-pobj,compound,JJ-NNP-NNP,NNP,6,1
2114,16943.0,13,Ø,0,3,7,4,2,5,-3,7,Jewish National Fund,JNF,ORGANIZATION-ORGANIZATION-ORGANIZATION,ORGANIZATION,ADJ-PROPN-PROPN,PROPN,amod-compound-ROOT,compound,JJ-NNP-NNP,NNP,4,1
2115,17763.0,29,JERUSALEM,0,10,14,4,9,14,-10,14,Jewish National Fund,JNF,ORGANIZATION-ORGANIZATION-ORGANIZATION,ORGANIZATION,ADJ-PROPN-PROPN,PROPN,amod-compound-pobj,compound,JJ-NNP-NNP,NNP,3,1
2116,26034.0,25,Still,0,6,10,4,5,14,-6,10,Jewish National Fund,JNF,ORGANIZATION-ORGANIZATION-ORGANIZATION,ORGANIZATION,ADJ-PROPN-PROPN,PROPN,amod-compound-pobj,compound,JJ-NNP-NNP,NNP,4,1
2117,50252.0,38,said,36,10,14,4,9,23,26,-22,Jewish National Fund,JNF,ORGANIZATION-ORGANIZATION-ORGANIZATION,ORGANIZATION,ADJ-PROPN-PROPN,PROPN,amod-compound-pobj,compound,JJ-NNP-NNP,NNP,4,1
2118,53527.0,14,Weitz,1,7,11,4,6,2,-6,10,Jewish National Fund,JNF,ORGANIZATION-ORGANIZATION-ORGANIZATION,ORGANIZATION,ADJ-PROPN-PROPN,PROPN,amod-compound-pobj,compound,JJ-NNP-NNP,NNP,6,1
2119,66077.0,32,Is,1,25,29,4,24,2,-24,28,Jewish National Fund,JNF,ORGANIZATION-ORGANIZATION-ORGANIZATION,ORGANIZATION,ADJ-PROPN-PROPN,PROPN,amod-compound-pobj,compound,JJ-NNP-NNP,NNP,-1,1
2120,67466.0,34,arranged,8,17,21,4,16,12,-9,13,Jewish National Fund,JNF,ORGANIZATION-ORGANIZATION-ORGANIZATION,ORGANIZATION,ADJ-PROPN-PROPN,PROPN,compound-compound-appos,compound,JJ-NNP-NNP,NNP,2,1
2121,3693.0,36,is,15,1,31,30,0,4,14,16,Fyffes,"4,800",ORGANIZATION,NUMBER,ADV,NUM,nsubj,nummod,RB,CD,4,1
2122,39433.0,37,------,0,2,32,30,1,4,-2,32,Fyffes,"4,800",ORGANIZATION,NUMBER,PROPN,NUM,nsubj,nummod,NNP,CD,4,1
2123,3697.0,43,looking,19,13,1,-12,12,41,6,-18,USA Network,NBC Universal,ORGANIZATION-ORGANIZATION,ORGANIZATION-ORGANIZATION,PROPN-PROPN,PROPN-PROPN,compound-pobj,compound-nsubj,NNP-NNP,NNP-NNP,3,1
2124,5800.0,39,said,23,21,11,-10,20,27,2,-12,USA Network,NBC Universal,ORGANIZATION-ORGANIZATION,ORGANIZATION-ORGANIZATION,PROPN-PROPN,PROPN-PROPN,compound-conj,compound-poss,NNP-NNP,NNP-NNP,4,1
2125,8320.0,34,intends,14,2,6,4,1,27,12,-8,USA Network,NBC Universal,ORGANIZATION-ORGANIZATION,ORGANIZATION-ORGANIZATION,PROPN-PROPN,PROPN-PROPN,compound-compound,compound-pobj,NNP-NNP,NNP-NNP,3,1
2126,13801.0,81,be,6,34,4,-30,33,76,-28,-2,USA Network,NBC Universal,ORGANIZATION-ORGANIZATION,ORGANIZATION-ORGANIZATION,PROPN-PROPN,PROPN-PROPN,compound-pobj,compound-nsubj,NNP-NNP,NNP-NNP,4,1
2127,32844.0,25,include,13,18,6,-12,17,18,-5,-7,USA Network,NBC Universal,ORGANIZATION-ORGANIZATION,ORGANIZATION-ORGANIZATION,PROPN-PROPN,PROPN-PROPN,compound-appos,compound-poss,NNP-NNP,NNP-NNP,8,1
2128,35455.0,28,owns,3,15,1,-14,14,26,-12,-2,USA Network,NBC Universal,ORGANIZATION-ORGANIZATION,ORGANIZATION-ORGANIZATION,PROPN-PROPN,PROPN-PROPN,compound-conj,compound-nsubj,NNP-NNP,NNP-NNP,6,1
2129,3709.0,41,died,18,28,10,-18,27,30,-10,-8,his,the last year,PERSON,DATE-DATE-DATE,DET,DET-ADJ-NOUN,poss,det-amod-pobj,PRP$,DT-JJ-NN,11,1
2130,3712.0,46,left,11,11,22,11,10,23,0,11,Ospel,Transvalor,PERSON,ORGANIZATION,PROPN,PROPN,nsubj,compound,NNP,NNP,5,1
2131,3715.0,35,stressed,7,1,6,5,0,28,6,-1,Czech National Bank,Mojmir Hampl,ORGANIZATION-ORGANIZATION-ORGANIZATION,PERSON-PERSON,PROPN-PROPN-PROPN,PROPN-PROPN,compound-compound-compound,compound-nsubj,NNP-NNP-NNP,NNP-NNP,2,1
2132,3716.0,45,said,11,28,7,-21,27,37,-17,-4,he,lawmaker,PERSON,TITLE,PRON,NOUN,nsubj,appos,PRP,NN,6,1
2133,3720.0,43,hosted,5,41,39,-2,40,3,-36,34,Johnny Knoxville,Knoxville,PERSON-PERSON,CITY,PROPN-PROPN,PROPN,compound-conj,nmod,NNP-NNP,NNP,2,1
2134,3726.0,30,feel,14,14,8,-6,13,21,0,-6,Parker,star entrepreneur,PERSON,TITLE-TITLE,PROPN,NOUN-NOUN,nsubj,compound-pobj,NNP,NN-NN,4,1
2135,3731.0,27,said,13,22,15,-7,21,11,-9,2,Federal Motor Carrier Safety Administration,John H. Hill,ORGANIZATION-ORGANIZATION-ORGANIZATION-ORGANIZATION-ORGANIZATION,PERSON-PERSON-PERSON,PROPN-PROPN-PROPN-PROPN-PROPN,PROPN-PROPN-PROPN,compound-compound-compound-compound-pobj,compound-compound-nsubj,NNP-NNP-NNP-NNP-NNP,NNP-NNP-NNP,6,1
2136,48277.0,31,said,14,5,11,6,4,19,9,-3,Federal Motor Carrier Safety Administration,John H. Hill,ORGANIZATION-ORGANIZATION-ORGANIZATION-ORGANIZATION-ORGANIZATION,PERSON-PERSON-PERSON,PROPN-PROPN-PROPN-PROPN-PROPN,PROPN-PROPN-PROPN,compound-compound-compound-compound-pobj,compound-compound-appos,NNP-NNP-NNP-NNP-NNP,NNP-NNP-NNP,6,1
2137,53972.0,28,said,14,23,16,-7,22,11,-9,2,Federal Motor Carrier Safety Administration,John H. Hill,ORGANIZATION-ORGANIZATION-ORGANIZATION-ORGANIZATION-ORGANIZATION,PERSON-PERSON-PERSON,PROPN-PROPN-PROPN-PROPN-PROPN,PROPN-PROPN-PROPN,compound-compound-compound-compound-pobj,compound-compound-nsubj,NNP-NNP-NNP-NNP-NNP,NNP-NNP-NNP,6,1
2138,3737.0,70,DC,0,9,9,0,8,60,-9,9,Servicemembers United,Servicemembers Legal Defense Network,ORGANIZATION-ORGANIZATION,ORGANIZATION-ORGANIZATION-ORGANIZATION-ORGANIZATION,PROPN-PROPN,PROPN-PROPN-PROPN-PROPN,compound-compound,compound-compound-compound-conj,NNP-NNP,NNP-NNP-NNP-NNP,0,1
2139,3745.0,44,formed,3,2,6,4,1,37,1,3,ABC,four months ago,ORGANIZATION,DATE-DATE-DATE,PROPN,NUM-NOUN-ADV,nsubj,nummod-npadvmod-advmod,NNP,CD-NNS-RB,3,1
2140,3746.0,43,Football,0,3,3,0,2,39,-3,3,Blackburn,Blackburn,ORGANIZATION,ORGANIZATION,PROPN,NOUN,nsubj,compound,NNP,NN,0,1
2141,3747.0,40,says,13,1,24,23,0,15,12,11,Mia Farrow,actress,PERSON-PERSON,TITLE,PROPN-PROPN,NOUN,compound-nsubj,compound,NNP-NNP,NN,5,1
2142,21593.0,38,said,4,3,2,-1,2,35,1,-2,Mia Farrow,actress,PERSON-PERSON,TITLE,PROPN-PROPN,NOUN,compound-nsubj,compound,NNP-NNP,NN,1,1
2143,21686.0,52,challenged,23,22,21,-1,21,30,1,-2,Mia Farrow,actress,PERSON-PERSON,TITLE,PROPN-PROPN,NOUN,compound-appos,nsubj,NNP-NNP,NN,1,1
2144,23827.0,22,says,10,9,12,3,8,9,1,2,Mia Farrow,actress,PERSON-PERSON,TITLE,PROPN-PROPN,NOUN,compound-pobj,nsubjpass,NNP-NNP,NN,4,1
2145,24732.0,30,told,7,16,15,-1,15,14,-9,8,Mia Farrow,actress,PERSON-PERSON,TITLE,PROPN-PROPN,NOUN,compound-conj,conj,NNP-NNP,NN,1,1
2146,28257.0,45,said,42,41,40,-1,40,4,1,-2,Mia Farrow,actress,PERSON-PERSON,TITLE,PROPN-PROPN,NOUN,compound-appos,nsubj,NNP-NNP,NN,1,1
2147,32643.0,72,responded,43,5,2,-3,4,69,38,-41,Mia Farrow,actress,PERSON-PERSON,TITLE,PROPN-PROPN,NOUN,compound-appos,nsubj,NNP-NNP,NN,2,1
2148,32698.0,38,says,11,1,23,22,0,14,10,12,Mia Farrow,actress,PERSON-PERSON,TITLE,PROPN-PROPN,NOUN,compound-nsubj,conj,NNP-NNP,NN,7,1
2149,34636.0,40,joined,3,10,9,-1,9,30,-7,6,Mia Farrow,actress,PERSON-PERSON,TITLE,PROPN-PROPN,NOUN,compound-conj,compound,NNP-NNP,NN,1,1
2150,38573.0,21,adopted,4,3,2,-1,2,18,1,-2,Mia Farrow,actress,PERSON-PERSON,TITLE,PROPN-PROPN,NOUN,compound-nsubj,compound,NNP-NNP,NN,1,1
2151,38824.0,30,prodding,16,4,3,-1,3,26,12,-13,Mia Farrow,actress,PERSON-PERSON,TITLE,PROPN-PROPN,NOUN,compound-pobj,compound,NNP-NNP,NN,1,1
2152,44444.0,71,called,6,5,2,-3,4,68,1,-4,Mia Farrow,actress,PERSON-PERSON,TITLE,PROPN-PROPN,NOUN,compound-appos,nsubj,NNP-NNP,NN,2,1
2153,54946.0,37,ended,7,6,5,-1,5,31,1,-2,Mia Farrow,actress,PERSON-PERSON,TITLE,PROPN-PROPN,NOUN,compound-pobj,compound,NNP-NNP,NN,1,1
2154,55833.0,41,have,2,16,15,-1,15,25,-14,13,Mia Farrow,actress,PERSON-PERSON,TITLE,PROPN-PROPN,NOUN,compound-appos,conj,NNP-NNP,NN,1,1
2155,65699.0,51,said,22,4,22,18,3,28,18,0,Mia Farrow,actress,PERSON-PERSON,TITLE,PROPN-PROPN,NOUN,compound-dobj,nsubj,NNP-NNP,NN,3,1
2156,3750.0,25,born,4,1,20,19,0,4,3,16,Richmond McDavid Flowers,John,PERSON-PERSON-PERSON,PERSON,PROPN-PROPN-PROPN,PROPN,compound-compound-nsubjpass,pobj,NNP-NNP-NNP,NNP,10,1
2157,3758.0,49,said,24,39,48,9,38,0,-15,24,International Crisis Group,Washington,ORGANIZATION-ORGANIZATION-ORGANIZATION,STATE_OR_PROVINCE,PROPN-PROPN-PROPN,PROPN,compound-compound-pobj,pobj,NNP-NNP-NNP,NNP,6,1
2158,3761.0,45,realize,20,44,9,-35,43,35,-24,-11,him,air force,PERSON,ORGANIZATION-ORGANIZATION,PRON,NOUN-NOUN,pobj,compound-conj,PRP,NN-NN,7,1
2159,3776.0,28,said,2,18,8,-10,17,19,-16,6,his,68-year-old,PERSON,DURATION,DET,NUM,poss,pobj,PRP$,CD,10,1
2160,26012.0,16,announced,3,9,2,-7,8,13,-6,-1,his,68-year-old,PERSON,DURATION,DET,NUM,poss,nummod,PRP$,CD,6,1
2161,26364.0,42,found,7,15,5,-10,14,36,-8,-2,his,68-year-old,PERSON,DURATION,DET,NUM,poss,compound,PRP$,CD,10,1
2162,3782.0,19,told,2,13,4,-9,12,14,-11,2,Konica Minolta Business Solutions,he,ORGANIZATION-ORGANIZATION-ORGANIZATION-ORGANIZATION,PERSON,PROPN-PROPN-PROPN-PROPN,PRON,compound-compound-compound-compound,nsubj,NNP-NNP-NNP-NNPS,PRP,7,1
2163,3786.0,36,said,18,1,12,11,0,23,17,-6,FirstGroup,Greyhound,ORGANIZATION,ORGANIZATION,PROPN,PROPN,nsubj,compound,NNP,NNP,6,1
2164,10529.0,36,hoped,11,3,6,3,2,29,8,-5,FirstGroup,Greyhound,ORGANIZATION,MISC,PROPN,PROPN,nsubj,compound,NNP,NNP,2,1
2165,18253.0,32,announced,4,4,21,17,3,10,0,17,FirstGroup,Greyhound,ORGANIZATION,ORGANIZATION,PROPN,PROPN,nsubj,appos,NNP,NNP,5,1
2166,3791.0,28,renewed,20,14,7,-7,13,20,6,-13,New South Wales Waratahs,Ewen McKenzie,ORGANIZATION-ORGANIZATION-ORGANIZATION-ORGANIZATION,PERSON-PERSON,PROPN-PROPN-PROPN-PROPN,PROPN-PROPN,compound-compound-compound-pobj,compound-poss,NNP-NNP-NNP-NNP,NNP-NNP,3,1
2167,5250.0,29,reacted,7,4,1,-3,3,27,3,-6,New South Wales Waratahs,Ewen McKenzie,ORGANIZATION-ORGANIZATION-ORGANIZATION-ORGANIZATION,PERSON-PERSON,PROPN-PROPN-PROPN-PROPN,PROPN-PROPN,compound-compound-compound-nsubj,compound-poss,NNP-NNP-NNP-NNP,NNP-NNP,3,1
2168,37297.0,29,announced,26,1,6,5,0,22,25,-20,New South Wales Waratahs,Ewen McKenzie,ORGANIZATION-ORGANIZATION-ORGANIZATION-ORGANIZATION,PERSON-PERSON,PROPN-PROPN-PROPN-PROPN,PROPN-PROPN,compound-compound-compound-compound,compound-poss,NNP-NNP-NNP-NNP,NNP-NNP,4,1
2169,3798.0,52,said,50,19,21,2,18,30,31,-29,Central American,"Parliament , a regional body composed of representatives elected in the member states of El Salvador , Guatemala",ORGANIZATION-ORGANIZATION,ORGANIZATION-ORGANIZATION-ORGANIZATION-ORGANIZATION-ORGANIZATION-ORGANIZATION-ORGANIZATION-ORGANIZATION-ORGANIZATION-ORGANIZATION-ORGANIZATION-ORGANIZATION-ORGANIZATION-ORGANIZATION-ORGANIZATION-ORGANIZATION-ORGANIZATION-ORGANIZATION,ADJ-PROPN,PROPN-PUNCT-DET-ADJ-NOUN-VERB-ADP-NOUN-VERB-ADP-DET-NOUN-NOUN-ADP-PROPN-PROPN-PUNCT-PROPN,compound-compound,pobj-punct-det-amod-appos-acl-prep-pobj-acl-prep-det-compound-pobj-prep-compound-pobj-punct-conj,JJ-NNP,"NNP-,-DT-JJ-NN-VBN-IN-NNS-VBN-IN-DT-NN-NNS-IN-NNP-NNP-,-NNP",10,1
2170,3800.0,28,2010-02-14T22,0,7,17,10,6,10,-7,17,Spencer Pratt,wife,PERSON-PERSON,PERSON,PROPN-PROPN,NOUN,compound-pobj,pobj,NNP-NNP,NN,3,1
2171,3805.0,48,sticking,16,36,33,-3,35,14,-20,17,Focus on the Family,Christian,ORGANIZATION-ORGANIZATION-ORGANIZATION-ORGANIZATION,RELIGION,PROPN-ADP-DET-PROPN,ADJ,appos-prep-det-pobj,amod,NNP-IN-DT-NNP,JJ,7,1
2172,31081.0,44,are,1,39,37,-2,38,6,-38,36,Focus on the Family,Christian,ORGANIZATION-ORGANIZATION-ORGANIZATION-ORGANIZATION,RELIGION,PROPN-ADP-DET-PROPN,ADJ,appos-prep-det-compound,amod,NNP-IN-DT-NNP,JJ,2,1
2173,59268.0,38,provides,1,12,19,7,11,18,-11,18,Focus on the Family,Christian,ORGANIZATION-ORGANIZATION-ORGANIZATION-ORGANIZATION,RELIGION,PROPN-ADP-DET-PROPN,ADJ,appos-prep-det-compound,amod,NNP-IN-DT-NNP,JJ,2,1
2174,3807.0,45,defended,2,8,43,35,7,1,-6,41,KGB,Soviet Union,ORGANIZATION,LOCATION-LOCATION,PROPN,PROPN-PROPN,compound,compound-pobj,NNP,NNP-NNP,12,1
2175,3810.0,46,is,13,36,30,-6,35,15,-23,17,Citibank -LRB- China -RRB- Co,Lee Ah-Boon,ORGANIZATION-ORGANIZATION-ORGANIZATION-ORGANIZATION-ORGANIZATION,PERSON-PERSON,PROPN-PROPN-PROPN-PROPN-PROPN,PROPN-PROPN,compound-compound-compound-compound-pobj,compound-nsubj,NNP-NNP-NNP-NNP-NNP,NNP-NNP,2,1
2176,3816.0,28,said,26,3,20,17,2,7,23,-6,Pascal Yoadimnadji,ambassador,PERSON-PERSON,TITLE,PROPN-PROPN,NOUN,compound-nsubj,nsubj,NNP-NNPS,NN,4,1
2177,3823.0,43,said,33,2,41,39,1,1,31,8,Inter-American Press Association,Gonzalo Marroquin,ORGANIZATION-ORGANIZATION-ORGANIZATION,PERSON-PERSON,ADJ-PROPN-PROPN,PROPN-PROPN,amod-compound-nsubj,compound-appos,JJ-NNP-NNP,NNP-NNP,5,1
2178,3824.0,38,cautioned,18,3,17,14,2,20,15,-1,Andre Carson,Congress,PERSON-PERSON,ORGANIZATION,PROPN-PROPN,PROPN,compound-nsubj,pobj,NNP-NNP,NNP,2,1
2179,47047.0,19,serve,15,11,18,7,10,0,4,3,Andre Carson,Congress,PERSON-PERSON,ORGANIZATION,PROPN-PROPN,PROPN,compound-conj,pobj,NNP-NNP,NNP,4,1
2180,52735.0,33,introduced,7,2,12,10,1,20,5,5,Andre Carson,Congress,PERSON-PERSON,ORGANIZATION,PROPN-PROPN,PROPN,compound-nsubj,pobj,NNP-NNP,NNP,3,1
2181,3831.0,31,said,16,10,14,4,9,16,6,-2,FMF,Justino Compean,ORGANIZATION,PERSON-PERSON,PROPN,PROPN-PROPN,poss,compound-appos,NNP,NNP-NNP,3,1
2182,65431.0,16,directed,3,6,8,2,5,7,-3,5,FMF,Justino Compean,ORGANIZATION,PERSON-PERSON,PROPN,PROPN-PROPN,compound,compound-pobj,NNP,NNP-NNP,1,1
2183,3836.0,47,confirms,36,6,8,2,5,38,30,-28,IAPA,Earl Maucker,ORGANIZATION,PERSON-PERSON,PROPN,PROPN-PROPN,compound,compound-pobj,NNP,NNP-NNP,1,1
2184,14374.0,17,headed,3,6,8,2,5,8,-3,5,IAPA,Earl Maucker,ORGANIZATION,PERSON-PERSON,PROPN,PROPN-PROPN,compound,compound-pobj,NNP,NNP-NNP,1,1
2185,32952.0,21,welcomed,14,1,3,2,0,17,13,-11,IAPA,Earl Maucker,ORGANIZATION,PERSON-PERSON,PROPN,PROPN-PROPN,compound,compound-nsubj,NNP,NNP-NNP,1,1
2186,55411.0,24,denied,14,1,3,2,0,20,13,-11,IAPA,Earl Maucker,ORGANIZATION,PERSON-PERSON,PROPN,PROPN-PROPN,compound,compound-nsubj,NNP,NNP-NNP,1,1
2187,3838.0,18,said,16,15,13,-2,14,4,1,-3,Chris Bentley,USCIS,PERSON-PERSON,ORGANIZATION,PROPN-PROPN,PROPN,compound-nsubj,compound,NNP-NNP,NNP,3,1
2188,60844.0,23,said,9,1,8,7,0,14,8,-1,Chris Bentley,USCIS,PERSON-PERSON,ORGANIZATION,PROPN-PROPN,PROPN,compound-nsubj,pobj,NNP-NNP,NNP,2,1
2189,3850.0,13,2007-08-19T17,0,7,1,-6,6,11,-7,1,Michael Deaver,2007-08-19T17,PERSON-PERSON,DATE,PROPN-PROPN,PUNCT,compound-compound,ROOT,NNP-NNP,LS,5,1
2190,3851.0,38,sparked,16,28,31,3,27,6,-12,15,Binoche,actress,PERSON,TITLE,PROPN,NOUN,nsubj,attr,NNP,NN,3,1
2191,3866.0,25,was,5,5,24,19,4,0,0,19,she,Bronx,PERSON,LOCATION,PRON,PROPN,nsubj,pobj,PRP,NNP,1,1
2192,3867.0,23,survived,7,6,18,12,5,4,1,11,Rothman,Kenneth,PERSON,PERSON,PROPN,PROPN,nsubjpass,conj,NNP,NNP,4,1
2193,3868.0,12,headed,1,1,4,3,0,7,0,3,Waldheim,UN,PERSON,ORGANIZATION,PROPN,PROPN,nsubj,dobj,NNP,NNP,1,1
2194,3873.0,23,died,11,1,21,20,0,1,10,10,Sills,lung cancer,PERSON,CAUSE_OF_DEATH-CAUSE_OF_DEATH,NOUN,NOUN-NOUN,nsubj,compound-pobj,NNS,NN-NN,6,1
2195,63685.0,28,died,21,1,24,23,0,3,20,3,Sills,lung cancer,PERSON,CAUSE_OF_DEATH-CAUSE_OF_DEATH,NOUN,NOUN-NOUN,nsubj,compound-pobj,NNS,NN-NN,4,1
2196,3889.0,32,named,20,1,4,3,0,27,19,-16,Ali Larijani,47,PERSON-PERSON,NUMBER,PROPN-PROPN,NUM,compound-nsubjpass,appos,NNP-NNP,CD,1,1
2197,3890.0,50,include,1,37,45,8,36,4,-36,44,Daniel Gude,Md.,PERSON-PERSON,STATE_OR_PROVINCE,PROPN-PROPN,PROPN,compound-conj,appos,NNP-NNP,NNP,9,1
2198,3891.0,21,said,3,16,13,-3,15,7,-13,10,Lashkar-e-Taiba,Islamist,ORGANIZATION,RELIGION,PROPN,ADJ,dobj,amod,NNP,JJ,1,1
2199,43953.0,43,detained,3,22,25,3,21,17,-19,22,Lashkar-e-Taiba,Islamist,ORGANIZATION,RELIGION,PROPN,ADJ,pobj,amod,NNP,JJ,3,1
2200,64733.0,22,blamed,1,12,10,-2,11,11,-11,9,Lashkar-e-Taiba,Islamist,ORGANIZATION,IDEOLOGY,PROPN,ADJ,pobj,amod,NNP,JJ,1,1
2201,64796.0,33,suspected,11,30,22,-8,29,10,-19,11,Lashkar-e-Taiba,Islamist,ORGANIZATION,IDEOLOGY,PROPN,ADJ,conj,amod,NNP,JJ,4,1
2202,3895.0,37,married,12,12,9,-3,11,27,0,-3,she,Barnard College,PERSON,ORGANIZATION-ORGANIZATION,PRON,PROPN-PROPN,nsubj,compound-pobj,PRP,NNP-NNP,4,1
2203,3907.0,32,told,29,21,2,-19,20,29,8,-27,Arsenal,Mr Fiszman,ORGANIZATION,PERSON-PERSON,PROPN,PROPN-PROPN,compound,compound-nsubj,NNP,NNP-NNP,8,1
2204,3908.0,33,Conrad,0,20,17,-3,19,15,-20,17,Spencer Pratt,Stephanie Pratt,PERSON-PERSON,PERSON-PERSON,PROPN-PROPN,PROPN-PROPN,compound-poss,compound-compound,NNP-NNP,NNP-NNP,6,1
2205,20601.0,15,For,0,6,2,-4,5,12,-6,2,Spencer Pratt,Stephanie Pratt,PERSON-PERSON,PERSON-PERSON,PROPN-PROPN,PROPN-PROPN,compound-dobj,compound-pobj,NNP-NNP,NNP-NNP,4,1
2206,3911.0,33,9,0,7,3,-4,6,29,-7,3,MTC Technologies,BAE System,ORGANIZATION-ORGANIZATION,ORGANIZATION-ORGANIZATION,PROPN-PROPN,PROPN-PROPN,compound-dobj,compound-nsubj,NNP-NNPS,NNP-NNP,2,1
2207,3924.0,11,served,1,1,5,4,0,5,0,4,He,U.S.,PERSON,COUNTRY,PRON,PROPN,nsubj,compound,PRP,NNP,2,1
2208,22507.0,19,released,2,1,8,7,0,10,1,6,He,U.S.,PERSON,COUNTRY,PRON,PROPN,nsubjpass,nmod,PRP,NNP,4,1
2209,3931.0,34,downed,17,2,9,7,1,24,15,-8,DeBlanc,Japanese,PERSON,NATIONALITY,PROPN,ADJ,nsubj,amod,NNP,JJ,3,1
2210,40180.0,29,recalled,2,2,26,24,1,2,0,24,DeBlanc,Japanese,PERSON,NATIONALITY,PROPN,ADJ,nsubj,conj,NNP,JJ,5,1
2211,3935.0,42,said,9,1,7,6,0,34,8,-2,Robert M. Morgenthau,district attorney,PERSON-PERSON-PERSON,TITLE-TITLE,PROPN-PROPN-PROPN,NOUN-NOUN,compound-compound-nsubj,compound-appos,NNP-NNP-NNP,NN-NN,2,1
2212,9885.0,26,described,16,13,10,-3,12,15,3,-6,Robert M. Morgenthau,district attorney,PERSON-PERSON-PERSON,TITLE-TITLE,PROPN-PROPN-PROPN,NOUN-NOUN,compound-compound-appos,compound-pobj,NNP-NNP-NNP,NN-NN,7,1
2213,14225.0,64,said,11,23,20,-3,22,43,-12,9,Robert M. Morgenthau,district attorney,PERSON-PERSON-PERSON,TITLE-TITLE,PROPN-PROPN-PROPN,NOUN-NOUN,compound-compound-appos,compound-pobj,NNP-NNP-NNP,NN-NN,5,1
2214,21661.0,28,reported,3,20,26,6,19,1,-17,23,Robert M. Morgenthau,district attorney,PERSON-PERSON-PERSON,TITLE-TITLE,PROPN-PROPN-PROPN,NOUN-NOUN,compound-compound-pobj,compound-appos,NNP-NNP-NNP,NN-NN,2,1
2215,23275.0,36,followed,4,33,25,-8,32,10,-29,21,Robert M. Morgenthau,district attorney,PERSON-PERSON-PERSON,TITLE-TITLE,PROPN-PROPN-PROPN,NOUN-NOUN,compound-compound-pobj,compound-poss,NNP-NNP-NNP,NN-NN,8,1
2216,24798.0,30,told,12,9,6,-3,8,23,3,-6,Robert M. Morgenthau,district attorney,PERSON-PERSON-PERSON,TITLE-TITLE,PROPN-PROPN-PROPN,NOUN-NOUN,compound-compound-appos,compound-pobj,NNP-NNP-NNP,NN-NN,4,1
2217,40488.0,52,said,44,41,38,-3,40,13,3,-6,Robert M. Morgenthau,district attorney,PERSON-PERSON-PERSON,TITLE-TITLE,PROPN-PROPN-PROPN,NOUN-NOUN,compound-compound-appos,compound-nsubj,NNP-NNP-NNP,NN-NN,3,1
2218,51319.0,26,been,16,23,21,-2,22,4,-7,5,Robert M. Morgenthau,district attorney,PERSON-PERSON-PERSON,TITLE-TITLE,PROPN-PROPN-PROPN,NOUN-NOUN,compound-compound-attr,compound-compound,NNP-NNP-NNP,NN-NN,2,1
2219,60764.0,30,said,17,6,3,-3,5,26,11,-14,Robert M. Morgenthau,district attorney,PERSON-PERSON-PERSON,TITLE-TITLE,PROPN-PROPN-PROPN,NOUN-NOUN,compound-compound-appos,compound-nsubj,NNP-NNP-NNP,NN-NN,2,1
2220,63902.0,57,TV-LETTERMAN-EXTORTION,0,12,9,-3,11,47,-12,9,Robert M. Morgenthau,district attorney,PERSON-PERSON-PERSON,TITLE-TITLE,PROPN-PROPN-PROPN,NOUN-NOUN,compound-compound-appos,compound-appos,NNP-NNP-NNP,NN-NN,-1,1
2221,3938.0,35,replaced,14,18,14,-4,17,20,-4,0,Steve McPherson,Disney,PERSON-PERSON,ORGANIZATION,PROPN-PROPN,PROPN,compound-dobj,nsubj,NNP-NNP,NNP,1,1
2222,3953.0,30,reported,28,11,3,-8,10,26,17,-25,his,Leader,PERSON,TITLE,DET,PROPN,poss,compound,PRP$,NNP,4,1
2223,3958.0,25,espoused,4,10,7,-3,9,17,-6,3,John Dewey,American,PERSON-PERSON,NATIONALITY,PROPN-PROPN,ADJ,compound-pobj,amod,NNP-NNP,JJ,2,1
2224,23215.0,44,stated,5,4,16,12,3,27,1,11,John Dewey,American,PERSON-PERSON,NATIONALITY,PROPN-PROPN,ADJ,compound-nsubj,amod,NNP-NNP,JJ,8,1
2225,41504.0,36,relied,5,21,12,-9,20,23,-16,7,John Dewey,American,PERSON-PERSON,NATIONALITY,PROPN-PROPN,ADJ,compound-pobj,amod,NNP-NNP,JJ,4,1
2226,3966.0,62,organizations,2,15,21,6,14,40,-13,19,Focus on the Family,Colorado Springs,ORGANIZATION-ORGANIZATION-ORGANIZATION-ORGANIZATION,CITY-CITY,PROPN-ADP-DET-PROPN,PROPN-PROPN,appos-prep-det-pobj,compound-nmod,NNP-IN-DT-NNP,NNP-NNP,4,1
2227,15245.0,73,wrote,44,53,59,6,52,13,-9,15,Focus on the Family,Colorado Springs,ORGANIZATION-ORGANIZATION-ORGANIZATION-ORGANIZATION,CITY-CITY,PROPN-ADP-DET-PROPN,PROPN-PROPN,pobj-prep-det-compound,compound-pobj,NNP-IN-DT-NNP,NNP-NNP,3,1
2228,39065.0,40,said,37,2,13,11,1,26,35,-24,Focus on the Family,Colorado Springs,ORGANIZATION-ORGANIZATION-ORGANIZATION-ORGANIZATION,CITY-CITY,PROPN-ADP-DET-PROPN,PROPN-PROPN,nsubj-prep-det-pobj,compound-pobj,NNP-IN-DT-NNP,NNP-NNP,5,1
2229,43544.0,36,conducted,16,7,12,5,6,23,9,-4,Focus on the Family,Colorado Springs,ORGANIZATION-ORGANIZATION-ORGANIZATION-ORGANIZATION,CITY-CITY,PROPN-ADP-DET-PROPN,PROPN-PROPN,appos-prep-det-pobj,compound-pobj,NNP-IN-DT-NNP,NNP-NNP,3,1
2230,49001.0,27,was,5,11,19,8,10,7,-6,14,Focus on the Family,Colorado Springs,ORGANIZATION-ORGANIZATION-ORGANIZATION-ORGANIZATION,CITY-CITY,PROPN-ADP-DET-PROPN,PROPN-PROPN,nsubjpass-prep-det-compound,compound-pobj,NNP-IN-DT-NNP,NNP-NNP,4,1
2231,3969.0,25,keep,2,20,23,3,19,1,-18,21,DCR,Susan Kane,ORGANIZATION,PERSON-PERSON,PROPN,PROPN-PROPN,compound,compound-pobj,NNP,NNP-NNP,2,1
2232,3985.0,33,heads,1,4,1,-3,3,31,-3,0,United National Congress,She,ORGANIZATION-ORGANIZATION-ORGANIZATION,PERSON,PROPN-PROPN-PROPN,PRON,compound-compound-dobj,nsubj,NNP-NNP-NNP,PRP,2,1
2233,3992.0,58,seen,20,48,39,-9,47,18,-28,19,All Basotho Convention,Thomas Thabane,ORGANIZATION-ORGANIZATION-ORGANIZATION,PERSON-PERSON,PROPN-PROPN-PROPN,PROPN-PROPN,compound-compound-dobj,compound-conj,NNP-NNP-NNP,NNP-NNP,4,1
2234,9252.0,47,challenger,2,4,15,11,3,31,-2,13,All Basotho Convention,Thomas Thabane,ORGANIZATION-ORGANIZATION-ORGANIZATION,PERSON-PERSON,DET-PROPN-PROPN,PROPN-PROPN,det-compound-appos,compound-pobj,DT-NNP-NNP,NNP-NNP,6,1
2235,15817.0,52,seen,20,42,33,-9,41,18,-22,13,All Basotho Convention,Thomas Thabane,ORGANIZATION-ORGANIZATION-ORGANIZATION,PERSON-PERSON,PROPN-PROPN-PROPN,PROPN-PROPN,compound-compound-dobj,compound-conj,NNP-NNP-NNP,NNP-NNP,4,1
2236,4027.0,34,said,16,25,29,4,24,4,-9,13,Taiwan Research Institute,Xiamen University,ORGANIZATION-ORGANIZATION-ORGANIZATION,ORGANIZATION-ORGANIZATION,PROPN-PROPN-PROPN,PROPN-PROPN,compound-compound-pobj,compound-pobj,NNP-NNP-NNP,NNP-NNP,3,1
2237,13570.0,35,said,14,8,12,4,7,22,6,-2,Taiwan Research Institute,Xiamen University,ORGANIZATION-ORGANIZATION-ORGANIZATION,ORGANIZATION-ORGANIZATION,PROPN-PROPN-PROPN,PROPN-PROPN,compound-compound-pobj,compound-pobj,NNP-NNP-NNP,NNP-NNP,3,1
2238,4031.0,28,overjoyed,22,18,7,-11,17,20,4,-15,Trista,Blaskesley Grace Sutter,PERSON,PERSON-PERSON-PERSON,PROPN,PROPN-PROPN-PROPN,nsubjpass,compound-compound-pobj,NNP,NNP-NNP-NNP,7,1
2239,4035.0,24,reports,22,18,16,-2,17,7,4,-6,Paul Sculfor,British,PERSON-PERSON,NATIONALITY,PROPN-PROPN,ADJ,compound-nsubj,amod,NNP-NNP,JJ,3,1
2240,11116.0,39,dating,3,13,5,-8,12,33,-10,2,Paul Sculfor,British,PERSON-PERSON,NATIONALITY,PROPN-PROPN,ADJ,compound-dobj,amod,NNP-NNP,JJ,3,1
2241,30395.0,56,Justin,7,6,36,30,5,19,1,29,Paul Sculfor,British,PERSON-PERSON,NATIONALITY,PROPN-PROPN,PROPN,compound-compound,compound,NNP-NNP,NNP,-1,1
2242,67573.0,29,linked,10,19,17,-2,18,11,-9,7,Paul Sculfor,British,PERSON-PERSON,NATIONALITY,PROPN-PROPN,ADJ,compound-appos,amod,NNP-NNP,JJ,1,1
2243,4041.0,26,http://www.hulu.com:,0,24,14,-10,23,11,-24,14,USA Network,Fox,ORGANIZATION-ORGANIZATION,PERSON,PROPN-PROPN,PROPN,compound-conj,pobj,NNP-NNP,NNP,6,1
2244,4049.0,28,elaborate,10,1,7,6,0,20,9,-3,Salehi,vice president,PERSON,TITLE-TITLE,NOUN,NOUN-NOUN,nsubj,compound-attr,NN,NN-NN,2,1
2245,4050.0,8,dies,5,4,1,-3,3,6,1,-4,Pascal Yoadimnadji,Chadian,PERSON-PERSON,NATIONALITY,PROPN-PROPN,ADJ,compound-nsubj,amod,NNP-NNP,JJ,2,1
2246,5869.0,40,PARIS,0,34,22,-12,33,17,-34,22,Pascal Yoadimnadji,Chadian,PERSON-PERSON,NATIONALITY,PROPN-PROPN,ADJ,compound-pobj,amod,NNP-NNPS,JJ,5,1
2247,8070.0,11,dies,5,4,1,-3,3,9,1,-4,Pascal Yoadimnadji,Chadian,PERSON-PERSON,NATIONALITY,PROPN-PROPN,ADJ,compound-nsubj,amod,NNP-NNP,JJ,2,1
2248,13369.0,25,said,22,5,21,16,4,3,17,-1,Pascal Yoadimnadji,Chadian,PERSON-PERSON,NATIONALITY,PROPN-PROPN,ADJ,compound-nsubj,amod,NNP-NNPS,JJ,4,1
2249,20147.0,23,said,20,5,19,14,4,3,15,-1,Pascal Yoadimnadji,Chadian,PERSON-PERSON,NATIONALITY,PROPN-PROPN,ADJ,compound-nsubj,amod,NNP-NNPS,JJ,4,1
2250,22099.0,23,says,9,15,12,-3,14,10,-6,3,Pascal Yoadimnadji,Chadian,PERSON-PERSON,NATIONALITY,PROPN-PROPN,ADJ,compound-nsubj,amod,NNP-NNPS,JJ,7,1
2251,26111.0,25,said,23,4,1,-3,3,23,19,-22,Pascal Yoadimnadji,Chadian,PERSON-PERSON,NATIONALITY,PROPN-PROPN,ADJ,compound-nsubj,amod,NNP-NNP,JJ,2,1
2252,32326.0,40,PARIS,0,34,22,-12,33,17,-34,22,Pascal Yoadimnadji,Chadian,PERSON-PERSON,NATIONALITY,PROPN-PROPN,ADJ,compound-pobj,amod,NNP-NNPS,JJ,5,1
2253,33482.0,38,said,36,4,1,-3,3,36,32,-35,Pascal Yoadimnadji,Chadian,PERSON-PERSON,NATIONALITY,PROPN-PROPN,ADJ,compound-nsubj,amod,NNP-NNP,JJ,2,1
2254,33692.0,30,said,27,12,2,-10,11,27,15,-25,Pascal Yoadimnadji,Chadian,PERSON-PERSON,NATIONALITY,PROPN-PROPN,ADJ,compound-pobj,compound,NNP-NNPS,JJ,3,1
2255,34463.0,27,said,25,4,1,-3,3,25,21,-24,Pascal Yoadimnadji,Chadian,PERSON-PERSON,NATIONALITY,PROPN-PROPN,ADJ,compound-nsubj,amod,NNP-NNP,JJ,2,1
2256,50712.0,40,died,5,4,1,-3,3,38,1,-4,Pascal Yoadimnadji,Chadian,PERSON-PERSON,NATIONALITY,PROPN-PROPN,ADJ,compound-nsubj,amod,NNP-NNP,JJ,2,1
2257,62369.0,18,Yoadimnadji,2,2,8,6,1,9,0,6,Pascal Yoadimnadji,Chadian,PERSON-PERSON,NATIONALITY,PROPN-PROPN,ADJ,compound-ROOT,amod,NNP-NNPS,JJ,2,1
2258,4053.0,24,said,19,21,23,2,20,0,-2,4,Contiero,Greenpeace,PERSON,ORGANIZATION,PROPN,PROPN,nsubj,pobj,NNP,NNP,2,1
2259,4054.0,29,said,14,24,16,-8,23,12,-10,2,Department of Conservation and Recreation,Karl Haglund,ORGANIZATION-ORGANIZATION-ORGANIZATION-ORGANIZATION-ORGANIZATION,PERSON-PERSON,PROPN-ADP-PROPN-CCONJ-PROPN,PROPN-PROPN,pobj-prep-pobj-cc-conj,compound-nsubj,NNP-IN-NNP-CC-NNP,NNP-NNP,4,1
2260,47874.0,30,BOSTON,0,25,17,-8,24,12,-25,17,Department of Conservation and Recreation,Karl Haglund,ORGANIZATION-ORGANIZATION-ORGANIZATION-ORGANIZATION-ORGANIZATION,PERSON-PERSON,PROPN-ADP-PROPN-CCONJ-PROPN,PROPN-PROPN,pobj-prep-pobj-cc-conj,compound-nsubj,NNP-IN-NNP-CC-NNP,NNP-NNP,4,1
2261,4056.0,21,lived,9,8,20,12,7,0,1,11,she,Annapolis,PERSON,CITY,PRON,PROPN,nsubj,conj,PRP,NNP,2,1
2262,4057.0,40,are,4,3,31,28,2,8,1,27,OIC,United Arab Emirates,ORGANIZATION,COUNTRY-COUNTRY-COUNTRY,PROPN,PROPN-PROPN-PROPN,compound,compound-compound-conj,NNP,NNP-NNP-NNP,16,1
2263,4058.0,17,said,14,14,11,-3,13,5,0,-3,Huber,IG Metall,PERSON,ORGANIZATION-ORGANIZATION,PROPN,PROPN-PROPN,nsubj,compound-poss,NNP,NNP-NNP,2,1
2264,4414.0,20,told,16,16,13,-3,15,6,0,-3,Huber,IG Metall,PERSON,ORGANIZATION-ORGANIZATION,PROPN,PROPN-PROPN,nsubj,compound-poss,NNP,NNP-NNP,3,1
2265,66533.0,41,said,39,8,13,5,7,27,31,-26,Huber,IG Metall,PERSON,ORGANIZATION-ORGANIZATION,PROPN,PROPN-PROPN,nsubj,compound-compound,NNP,NNP-NNP,5,1
2266,4059.0,34,became,26,1,19,18,0,14,25,-7,He,general manager,PERSON,TITLE-TITLE,PRON,ADJ-NOUN,nsubj,amod-pobj,PRP,JJ-NN,3,1
2267,4065.0,52,was,6,20,23,3,19,28,-14,17,UNITA,Joseph Savimbi,ORGANIZATION,PERSON-PERSON,PROPN,PROPN-PROPN,appos,compound-pobj,NNP,NNP-NNP,2,1
2268,4075.0,53,include,1,3,26,23,2,26,-2,25,his,Douglas Nolte,PERSON,PERSON-PERSON,DET,PROPN-PROPN,poss,compound-appos,PRP$,NNP-NNP,8,1
2269,4081.0,19,said,4,6,3,-3,5,15,-2,-1,she,26,PERSON,NUMBER,PRON,NUM,nsubjpass,appos,PRP,CD,3,1
2270,4092.0,18,said,6,8,3,-5,7,14,-2,-3,his,complications of pneumonia,PERSON,CAUSE_OF_DEATH-CAUSE_OF_DEATH-CAUSE_OF_DEATH,DET,NOUN-ADP-NOUN,poss,pobj-prep-pobj,PRP$,NNS-IN-NN,4,1
2271,21256.0,15,said,7,9,4,-5,8,10,-2,-3,his,complications of pneumonia,PERSON,CAUSE_OF_DEATH-CAUSE_OF_DEATH-CAUSE_OF_DEATH,DET,NOUN-ADP-NOUN,poss,attr-prep-pobj,PRP$,NNS-IN-NN,4,1
2272,4096.0,31,lived,12,1,29,28,0,1,11,17,Irene Morgan,Stanley Kirkaldy,PERSON-PERSON,PERSON-PERSON,PROPN-PROPN,PROPN-PROPN,compound-compound,compound-appos,NNP-NNP,NNP-NNP,6,1
2273,4098.0,30,said,3,13,16,3,12,13,-10,13,Ospel,executive,PERSON,TITLE,PROPN,ADJ,pobj,amod,NNP,JJ,6,1
2274,4110.0,44,vote,7,17,1,-16,16,42,-10,-6,Independent Steelworkers Union,West Virginia,ORGANIZATION-ORGANIZATION-ORGANIZATION,COUNTRY-COUNTRY,PROPN-PROPN-PROPN,PROPN-PROPN,compound-compound-pobj,compound-compound,NNP-NNPS-NNP,NNP-NNP,9,1
2275,32112.0,23,said,5,3,21,18,2,1,2,16,Independent Steelworkers Union,West Virginia,ORGANIZATION-ORGANIZATION-ORGANIZATION,STATE_OR_PROVINCE-STATE_OR_PROVINCE,PROPN-PROPN-PROPN,PROPN-PROPN,compound-compound-nsubj,compound-pobj,NNP-NNPS-NNP,NNP-NNP,7,1
2276,36245.0,36,voted,24,4,22,18,3,13,20,-2,Independent Steelworkers Union,West Virginia,ORGANIZATION-ORGANIZATION-ORGANIZATION,STATE_OR_PROVINCE-STATE_OR_PROVINCE,PROPN-PROPN-PROPN,PROPN-PROPN,compound-compound-pobj,compound-appos,NNP-NNPS-NNP,NNP-NNP,10,1
2277,38007.0,49,said,20,29,47,18,28,1,-9,27,Independent Steelworkers Union,West Virginia,ORGANIZATION-ORGANIZATION-ORGANIZATION,STATE_OR_PROVINCE-STATE_OR_PROVINCE,PROPN-PROPN-PROPN,PROPN-PROPN,compound-compound-pobj,compound-appos,NNP-NNPS-NNP,NNP-NNP,10,1
2278,4111.0,33,has,5,27,31,4,26,1,-22,26,NFC South,New Orleans,ORGANIZATION-ORGANIZATION,CITY-CITY,PROPN-PROPN,PROPN-PROPN,compound-compound,compound-pobj,NNP-NNP,NNP-NNP,3,1
2279,4113.0,19,continued,9,5,7,2,4,11,4,-2,AMA,Committee on Quackery,ORGANIZATION,ORGANIZATION-ORGANIZATION-ORGANIZATION,PROPN,PROPN-ADP-PROPN,poss,conj-prep-pobj,NNP,NNP-IN-NNP,3,1
2280,56167.0,65,feeding,47,12,22,10,11,42,35,-25,AMA,Committee on Quackery,ORGANIZATION,ORGANIZATION-ORGANIZATION-ORGANIZATION,PROPN,PROPN-ADP-PROPN,poss,nsubj-prep-poss,NNP,NNP-IN-NNP,7,1
2281,4114.0,52,says,24,39,42,3,38,9,-15,18,Northwood University,Midland,ORGANIZATION-ORGANIZATION,CITY,PROPN-PROPN,PROPN,compound-pobj,pobj,NNP-NNP,NNP,3,1
2282,33797.0,36,said,17,5,8,3,4,27,12,-9,Northwood University,Midland,ORGANIZATION-ORGANIZATION,CITY,PROPN-PROPN,PROPN,compound-pobj,pobj,NNP-NNP,NNP,3,1
2283,4116.0,33,read,7,3,1,-2,2,31,4,-6,Gholam Ali Haddad-Adel,Parliament,PERSON-PERSON-PERSON,ORGANIZATION,PROPN-PROPN-PROPN,PROPN,compound-compound-nsubj,compound,NNP-NNP-NNP,NNP,2,1
2284,4122.0,34,Ahmad,2,2,14,12,1,19,0,12,Hashim Ahmad al-Tai,1st Corps,PERSON-PERSON-PERSON,ORGANIZATION-ORGANIZATION,PROPN-PROPN-PROPN,ADJ-PROPN,compound-ROOT-ROOT,amod-pobj,NNP-NNP-NNP,JJ-NNP,6,1
2285,4137.0,43,said,11,9,5,-4,8,37,2,-6,Berthold Huber,IG Metall,PERSON-PERSON,ORGANIZATION-ORGANIZATION,PROPN-PROPN,PROPN-PROPN,compound-appos,compound-compound,NNP-NNP,NNP-NNP,4,1
2286,4897.0,49,Germany,0,29,4,-25,28,44,-29,4,Berthold Huber,IG Metall,PERSON-PERSON,ORGANIZATION-ORGANIZATION,PROPN-PROPN,PROPN-PROPN,compound-dobj,nmod-nmod,NNP-NNP,NNP-NNP,5,1
2287,5087.0,17,said,15,9,12,3,8,4,6,-3,Berthold Huber,IG Metall,PERSON-PERSON,ORGANIZATION-ORGANIZATION,PROPN-PROPN,PROPN-PROPN,compound-npadvmod,compound-poss,NNP-NNP,NNP-NNP,4,1
2288,6561.0,46,want,11,25,30,5,24,15,-14,19,Berthold Huber,IG Metall,PERSON-PERSON,ORGANIZATION-ORGANIZATION,PROPN-PROPN,PROPN-PROPN,compound-nsubj,compound-pobj,NNP-NNP,NNP-NNP,5,1
2289,7599.0,33,be,2,31,26,-5,30,6,-29,24,Berthold Huber,IG Metall,PERSON-PERSON,ORGANIZATION-ORGANIZATION,PROPN-PROPN,PROPN-PROPN,compound-appos,compound-compound,NNP-NNP,NNP-NNP,5,1
2290,7790.0,43,said,11,9,5,-4,8,37,2,-6,Berthold Huber,IG Metall,PERSON-PERSON,ORGANIZATION-ORGANIZATION,PROPN-PROPN,PROPN-PROPN,compound-appos,compound-compound,NNP-NNP,NNP-NNP,4,1
2291,11551.0,37,said,19,11,8,-3,10,28,8,-11,Berthold Huber,IG Metall,PERSON-PERSON,ORGANIZATION-ORGANIZATION,PROPN-PROPN,PROPN-PROPN,compound-dobj,compound-appos,NNP-NNP,NNP-NNP,4,1
2292,11696.0,41,said,24,1,7,6,0,33,23,-17,Berthold Huber,IG Metall,PERSON-PERSON,ORGANIZATION-ORGANIZATION,PROPN-PROPN,PROPN-PROPN,compound-nsubj,compound-pobj,NNP-NNP,NNP-NNP,3,1
2293,13170.0,44,told,28,27,22,-5,26,21,1,-6,Berthold Huber,IG Metall,PERSON-PERSON,ORGANIZATION-ORGANIZATION,PROPN-PROPN,PROPN-PROPN,compound-nsubj,compound-poss,NNP-NNP,NNP-NNP,1,1
2294,13630.0,25,said,18,23,12,-11,22,12,-5,-6,Berthold Huber,IG Metall,PERSON-PERSON,ORGANIZATION-ORGANIZATION,PROPN-PROPN,PROPN-PROPN,compound-nsubj,compound-compound,NNP-NNP,NNP-NNP,7,1
2295,17016.0,22,described,5,4,1,-3,3,20,1,-4,Berthold Huber,IG Metall,PERSON-PERSON,ORGANIZATION-ORGANIZATION,PROPN-PROPN,PROPN-PROPN,compound-nsubj,compound-compound,NNP-NNP,NNP-NNP,2,1
2296,17055.0,45,said,5,4,1,-3,3,43,1,-4,Berthold Huber,IG Metall,PERSON-PERSON,ORGANIZATION-ORGANIZATION,PROPN-PROPN,PROPN-PROPN,compound-nsubj,compound-compound,NNP-NNP,NNP-NNP,2,1
2297,17253.0,34,called,8,7,3,-4,6,30,1,-5,Berthold Huber,IG Metall,PERSON-PERSON,ORGANIZATION-ORGANIZATION,PROPN-PROPN,PROPN-PROPN,compound-nsubj,compound-compound,NNP-NNP,NNP-NNP,2,1
2298,20976.0,29,said,13,11,6,-5,10,22,2,-7,Berthold Huber,IG Metall,PERSON-PERSON,ORGANIZATION-ORGANIZATION,PROPN-PROPN,PROPN-PROPN,compound-appos,compound-compound,NNP-NNP,NNP-NNP,4,1
2299,23325.0,32,said,26,25,22,-3,24,9,1,-4,Berthold Huber,IG Metall,PERSON-PERSON,ORGANIZATION-ORGANIZATION,PROPN-PROPN,PROPN-PROPN,compound-nsubj,compound-compound,NNP-NNP,NNP-NNP,4,1
2300,27512.0,39,said,6,5,1,-4,4,37,1,-5,Berthold Huber,IG Metall,PERSON-PERSON,ORGANIZATION-ORGANIZATION,PROPN-PROPN,PROPN-PROPN,compound-appos,compound-poss,NNP-NNP,NNP-NNP,2,1
2301,42387.0,33,told,17,16,13,-3,15,19,1,-4,Berthold Huber,IG Metall,PERSON-PERSON,ORGANIZATION-ORGANIZATION,PROPN-PROPN,PROPN-PROPN,compound-nsubj,compound-compound,NNP-NNP,NNP-NNP,4,1
2302,43186.0,41,said,39,7,13,6,6,27,32,-26,Berthold Huber,IG Metall,PERSON-PERSON,ORGANIZATION-ORGANIZATION,PROPN-PROPN,PROPN-PROPN,compound-pobj,compound-compound,NNP-NNP,NNP-NNP,4,1
2303,49119.0,24,warned,7,5,1,-4,4,22,2,-6,Berthold Huber,IG Metall,PERSON-PERSON,ORGANIZATION-ORGANIZATION,PROPN-PROPN,PROPN-PROPN,compound-nsubj,compound-compound,NNP-NNP,NNP-NNP,2,1
2304,53271.0,24,said,17,22,19,-3,21,4,-5,2,Berthold Huber,IG Metall,PERSON-PERSON,ORGANIZATION-ORGANIZATION,PROPN-PROPN,PROPN-PROPN,compound-nsubj,compound-compound,NNP-NNP,NNP-NNP,4,1
2305,58532.0,44,told,28,27,22,-5,26,21,1,-6,Berthold Huber,IG Metall,PERSON-PERSON,ORGANIZATION-ORGANIZATION,PROPN-PROPN,PROPN-PROPN,compound-nsubj,compound-poss,NNP-NNP,NNP-NNP,1,1
2306,62110.0,32,told,13,11,6,-5,10,25,2,-7,Berthold Huber,IG Metall,PERSON-PERSON,ORGANIZATION-ORGANIZATION,PROPN-PROPN,PROPN-PROPN,compound-appos,nmod-nmod,NNP-NNP,NNP-NNP,2,1
2307,64839.0,23,said,14,21,16,-5,20,6,-7,2,Berthold Huber,IG Metall,PERSON-PERSON,ORGANIZATION-ORGANIZATION,PROPN-PROPN,PROPN-PROPN,compound-nsubj,compound-poss,NNP-NNP,NNP-NNP,4,1
2308,4138.0,8,is,1,1,4,3,0,3,0,3,She,American,PERSON,NATIONALITY,PRON,ADJ,nsubj,amod,PRP,JJ,1,1
2309,4145.0,38,said,35,1,1,0,0,36,34,-34,Carnival Corp,Carnival Cruise Lines,ORGANIZATION-ORGANIZATION,ORGANIZATION-ORGANIZATION-ORGANIZATION,PROPN-PROPN,PROPN-PROPN-VERB,compound-nsubj,compound-compound-compound,NNP-NNP,NNP-NNP-VBZ,0,1
2310,48884.0,54,told,17,12,12,0,11,41,5,-5,Carnival Corp,Carnival Cruise Lines,ORGANIZATION-ORGANIZATION,ORGANIZATION-ORGANIZATION-ORGANIZATION,PROPN-PROPN,PROPN-PROPN-PROPN,compound-poss,compound-compound-pobj,NNP-NNP,NNP-NNP-NNPS,0,1
2311,60014.0,16,is,3,1,1,0,0,14,2,-2,Carnival Corp,Carnival Cruise Lines,ORGANIZATION-ORGANIZATION,ORGANIZATION-ORGANIZATION-ORGANIZATION,PROPN-PROPN,PROPN-PROPN-PROPN,compound-pobj,compound-compound-nsubj,NNP-NNP,NNP-NNP-NNP,0,1
2312,4150.0,43,held,23,34,38,4,33,4,-11,15,MNLF,Habier Malik,ORGANIZATION,PERSON-PERSON,PROPN,PROPN-PROPN,compound,compound-pobj,NNP,NNP-NNP,-1,1
2313,24465.0,33,said,1,18,20,2,17,12,-17,19,MNLF,Habier Malik,ORGANIZATION,PERSON-PERSON,PROPN,PROPN-PROPN,compound,compound-appos,NNP,NNP-NNP,1,1
2314,4154.0,23,Millender-McDonald,0,1,3,2,0,19,-1,3,Millender-McDonald,68,PERSON,NUMBER,PROPN,NUM,ROOT,appos,NNP,CD,2,1
2315,32491.0,25,said,16,1,5,4,0,19,15,-11,Millender-McDonald,68,PERSON,NUMBER,PROPN,NUM,nsubj,attr,NNP,CD,2,1
2316,4155.0,46,DAMASCUS,0,29,5,-24,28,40,-29,5,his,representative,PERSON,TITLE,DET,NOUN,poss,nsubj,PRP$,NN,8,1
2317,19468.0,49,DAMASCUS,0,30,5,-25,29,43,-30,5,his,representative,PERSON,TITLE,DET,NOUN,poss,nsubj,PRP$,NN,8,1
2318,43909.0,44,said,15,22,6,-16,21,37,-7,-9,his,representative,PERSON,TITLE,DET,NOUN,poss,nsubj,PRP$,NN,5,1
2319,43949.0,45,said,12,28,3,-25,27,41,-16,-9,his,representative,PERSON,TITLE,DET,NOUN,poss,nsubj,PRP$,NN,8,1
2320,46594.0,45,said,11,18,6,-12,17,38,-7,-5,his,representative,PERSON,TITLE,DET,NOUN,poss,nsubj,PRP$,NN,5,1
2321,54764.0,24,holding,3,7,17,10,6,6,-4,14,his,representative,PERSON,TITLE,DET,NOUN,poss,pobj,PRP$,NN,5,1
2322,4161.0,11,Deaver,1,1,11,10,0,-1,0,10,Michael Deaver,69,PERSON-PERSON,NUMBER,PROPN-PROPN,NUM,compound-ROOT,pobj,NNP-NNP,CD,-1,1
2323,4165.0,34,becomes,5,28,26,-2,27,7,-23,21,Paavo Nurmi,Finnish,PERSON-PERSON,NATIONALITY,PROPN-PROPN,ADJ,compound-dobj,amod,NNP-NNP,JJ,1,1
2324,15266.0,34,had,4,32,30,-2,31,3,-28,26,Paavo Nurmi,Finnish,PERSON-PERSON,NATIONALITY,PROPN-PROPN,ADJ,compound-conj,amod,NNP-NNP,JJ,2,1
2325,26142.0,51,claimed,5,42,40,-2,41,10,-37,35,Paavo Nurmi,Finnish,PERSON-PERSON,NATIONALITY,PROPN-PROPN,ADJ,compound-conj,amod,NNP-NNP,JJ,3,1
2326,31021.0,39,put,1,28,26,-2,27,12,-27,25,Paavo Nurmi,Finnish,PERSON-PERSON,NATIONALITY,PROPN-PROPN,ADJ,compound-conj,amod,NNP-NNP,JJ,2,1
2327,41328.0,43,is,1,36,34,-2,35,8,-35,33,Paavo Nurmi,Finnish,PERSON-PERSON,NATIONALITY,PROPN-PROPN,ADJ,compound-conj,amod,NNP-NNP,JJ,1,1
2328,46135.0,44,brought,10,42,40,-2,41,3,-32,30,Paavo Nurmi,Finnish,PERSON-PERSON,NATIONALITY,PROPN-PROPN,ADJ,compound-conj,amod,NNP-NNP,JJ,2,1
2329,50249.0,39,turned,3,30,24,-6,29,14,-27,21,Paavo Nurmi,Finnish,PERSON-PERSON,NATIONALITY,PROPN-PROPN,ADJ,compound-nsubj,amod,NNP-NNP,JJ,4,1
2330,4177.0,50,include,1,3,18,15,2,31,-2,17,his,Sharon Gude,PERSON,PERSON-PERSON,DET,PROPN-PROPN,poss,compound-appos,PRP$,NNP-NNP,2,1
2331,13938.0,45,include,1,3,18,15,2,26,-2,17,his,Sharon Gude,PERSON,PERSON-PERSON,DET,PROPN-PROPN,poss,compound-appos,PRP$,NNP-NNP,2,1
2332,4178.0,24,cancelled,14,11,9,-2,10,14,3,-5,Bryan McFadden,she,PERSON-PERSON,PERSON,PROPN-PROPN,PRON,compound-dobj,nsubj,NNP-NNP,PRP,1,1
2333,4179.0,33,began,4,1,32,31,0,0,3,28,Negroponte,Philippines,PERSON,COUNTRY,PROPN,PROPN,nsubj,pobj,NNP,NNPS,4,1
2334,4184.0,50,survived,9,4,38,34,3,11,5,29,his,Doris Kahme,PERSON,PERSON-PERSON,DET,PROPN-PROPN,poss,compound-conj,PRP$,NNP-NNP,6,1
2335,4185.0,26,said,23,3,1,-2,2,24,20,-22,Gholam Ali Haddad Adel,Parliament,PERSON-PERSON-PERSON-PERSON,ORGANIZATION,PROPN-PROPN-PROPN-PROPN,PROPN,compound-compound-compound-nsubj,compound,NNP-NNP-NNP-NNP,NNP,2,1
2336,20985.0,30,said,12,9,7,-2,8,22,3,-5,Gholam Ali Haddad Adel,Parliament,PERSON-PERSON-PERSON-PERSON,ORGANIZATION,PROPN-PROPN-PROPN-PROPN,PROPN,compound-compound-compound-nsubj,compound,NNP-NNP-NNP-NNP,NNP,2,1
2337,41441.0,40,said,14,11,9,-2,10,30,3,-5,Gholam Ali Haddad Adel,Parliament,PERSON-PERSON-PERSON-PERSON,ORGANIZATION,PROPN-PROPN-PROPN-PROPN,PROPN,compound-compound-compound-nsubj,compound,NNP-NNP-NNP-NNP,NNP,2,1
2338,51569.0,45,TEHRAN,0,6,4,-2,5,40,-6,4,Gholam Ali Haddad Adel,Parliament,PERSON-PERSON-PERSON-PERSON,ORGANIZATION,PROPN-PROPN-PROPN-PROPN,PROPN,compound-compound-compound-nsubj,compound,NNP-NNP-NNP-NNP,NNP,2,1
2339,4189.0,36,reported,6,3,2,-1,2,33,3,-4,Inter-American Press Association,Miami-based,ORGANIZATION-ORGANIZATION-ORGANIZATION,CITY,ADJ-PROPN-PROPN,ADJ,amod-compound-nsubj,amod,JJ-NNP-NNP,JJ,1,1
2340,4192.0,29,reunites,4,20,25,5,19,3,-16,21,Hector Elizondo,Beverly Hills Police Department,PERSON-PERSON,ORGANIZATION-ORGANIZATION-ORGANIZATION-ORGANIZATION,PROPN-PROPN,PROPN-PROPN-PROPN-PROPN,compound-compound,compound-compound-compound-pobj,NNP-NNP,NNP-NNPS-NNP-NNP,5,1
2341,4196.0,56,said,20,1,36,35,0,19,19,16,Mahmood Shah,Pakistani,PERSON-PERSON,NATIONALITY,PROPN-PROPN,PROPN,compound-nsubj,compound,NNP-NNP,NNP,7,1
2342,12525.0,42,said,22,1,6,5,0,35,21,-16,Mahmood Shah,Pakistani,PERSON-PERSON,NATIONALITY,PROPN-PROPN,ADJ,compound-nsubj,amod,NNP-NNP,JJ,2,1
2343,14587.0,19,cost,2,17,12,-5,16,6,-15,10,Mahmood Shah,Pakistani,PERSON-PERSON,NATIONALITY,PROPN-PROPN,ADJ,compound-appos,amod,NNP-NNP,JJ,3,1
2344,14786.0,36,said,16,21,4,-17,20,31,-5,-12,Mahmood Shah,Pakistani,PERSON-PERSON,NATIONALITY,PROPN-PROPN,ADJ,compound-nsubj,amod,NNP-NNP,JJ,5,1
2345,19859.0,38,said,18,20,24,4,19,13,-2,6,Mahmood Shah,Pakistani,PERSON-PERSON,NATIONALITY,PROPN-PROPN,ADJ,compound-nsubj,amod,NNP-NNP,JJ,3,1
2346,31329.0,43,said,19,21,29,8,20,13,-2,10,Mahmood Shah,Pakistani,PERSON-PERSON,NATIONALITY,PROPN-PROPN,ADJ,compound-nsubj,amod,NNP-NNP,JJ,3,1
2347,32555.0,38,said,18,20,24,4,19,13,-2,6,Mahmood Shah,Pakistani,PERSON-PERSON,NATIONALITY,PROPN-PROPN,ADJ,compound-nsubj,amod,NNP-NNP,JJ,3,1
2348,43374.0,37,said,18,21,5,-16,20,31,-3,-13,Mahmood Shah,Pakistani,PERSON-PERSON,NATIONALITY,PROPN-PROPN,PROPN,compound-nsubj,compound,NNP-NNP,NNP,5,1
2349,47249.0,32,said,13,1,16,15,0,15,12,3,Mahmood Shah,Pakistani,PERSON-PERSON,NATIONALITY,PROPN-PROPN,PROPN,compound-nsubj,compound,NNP-NNP,NNP,3,1
2350,4197.0,27,said,25,1,9,8,0,17,24,-16,Bradford Washburn,96,PERSON-PERSON,NUMBER,PROPN-PROPN,NUM,compound-nsubj,pobj,NNP-NNP,CD,3,1
2351,4385.0,9,dies,6,1,9,8,0,-1,5,3,Bradford Washburn,96,PERSON-PERSON,NUMBER,PROPN-PROPN,NUM,compound-nsubj,pobj,NNP-NNP,CD,-1,1
2352,12116.0,35,Washburn,2,2,5,3,1,29,0,3,Bradford Washburn,96,PERSON-PERSON,NUMBER,PROPN-PROPN,NUM,compound-ROOT,appos,NNP-NNP,CD,1,1
2353,4202.0,25,reported,22,7,5,-2,6,19,15,-17,Raul Castro,Cuban,PERSON-PERSON,NATIONALITY,PROPN-PROPN,ADJ,compound-pobj,amod,NNP-NNP,JJ,1,1
2354,13037.0,30,reacted,10,3,1,-2,2,28,7,-9,Raul Castro,Cuban,PERSON-PERSON,NATIONALITY,PROPN-PROPN,ADJ,compound-nsubj,amod,NNP-NNP,JJ,1,1
2355,17814.0,10,meets,5,4,2,-2,3,7,1,-3,Raul Castro,Cuban,PERSON-PERSON,NATIONALITY,PROPN-PROPN,ADJ,compound-nsubj,amod,NNP-NNP,JJ,1,1
2356,34664.0,28,phones,8,3,1,-2,2,26,5,-7,Raul Castro,Cuban,PERSON-PERSON,NATIONALITY,PROPN-PROPN,ADJ,compound-poss,amod,NNP-NNP,JJ,1,1
2357,45609.0,28,reported,25,3,1,-2,2,26,22,-24,Raul Castro,Cuban,PERSON-PERSON,NATIONALITY,PROPN-PROPN,ADJ,compound-nsubj,amod,NNP-NNP,JJ,1,1
2358,49595.0,23,met,5,3,1,-2,2,21,2,-4,Raul Castro,Cuban,PERSON-PERSON,NATIONALITY,PROPN-PROPN,ADJ,compound-nsubj,amod,NNP-NNP,JJ,1,1
2359,50878.0,31,announced,4,3,1,-2,2,29,1,-3,Raul Castro,Cuban,PERSON-PERSON,NATIONALITY,PROPN-PROPN,ADJ,compound-nsubj,amod,NNP-NNP,JJ,1,1
2360,67938.0,10,sent,5,4,2,-2,3,7,1,-3,Raul Castro,Cuban,PERSON-PERSON,NATIONALITY,PROPN-PROPN,ADJ,compound-nsubj,amod,NNP-NNP,JJ,1,1
2361,4205.0,24,born,4,1,2,1,0,21,3,-2,Catherine Gertrude Roraback,Gertrude Dittmars Roraback,PERSON-PERSON-PERSON,PERSON-PERSON-PERSON,PROPN-PROPN-PROPN,PROPN-PROPN-PROPN,compound-compound-nsubjpass,conj-compound-appos,NNP-NNP-NNP,NNP-NNP-NNP,1,1
2362,18368.0,24,born,4,1,2,1,0,21,3,-2,Catherine Gertrude Roraback,Gertrude Dittmars Roraback,PERSON-PERSON-PERSON,PERSON-PERSON-PERSON,PROPN-PROPN-PROPN,PROPN-PROPN-PROPN,compound-compound-nsubjpass,conj-compound-npadvmod,NNP-NNP-NNP,NNP-NNP-NNP,1,1
2363,4212.0,24,worked,1,1,5,4,0,18,0,4,Dent,White House,PERSON,ORGANIZATION-ORGANIZATION,PROPN,PROPN-PROPN,nsubj,compound-pobj,NNP,NNP-NNP,2,1
2364,4213.0,39,weathered,17,1,7,6,0,31,16,-10,Waldheim,secretary general,PERSON,TITLE-TITLE,PROPN,NOUN-NOUN,nsubj,compound-acomp,NNP,NN-NN,3,1
2365,4225.0,18,said,13,10,12,2,9,5,3,-1,FAA,Randy Babbitt,ORGANIZATION,PERSON-PERSON,PROPN,PROPN-PROPN,compound,compound-nsubj,NNP,NNP-NNP,1,1
2366,4238.0,30,began,4,9,15,6,8,14,-5,11,Waldheim,Austria,PERSON,COUNTRY,PROPN,PROPN,poss,pobj,NNP,NNP,3,1
2367,31052.0,11,became,1,1,6,5,0,4,0,5,Waldheim,Austria,PERSON,COUNTRY,PROPN,PROPN,nsubj,poss,NNP,NNP,5,1
2368,33853.0,50,were,9,5,33,28,4,16,4,24,Waldheim,Austria,PERSON,COUNTRY,PROPN,PROPN,pobj,appos,NNP,NNP,6,1
2369,40880.0,34,stood,6,6,12,6,5,21,0,6,Waldheim,Austria,PERSON,COUNTRY,PROPN,PROPN,nsubj,poss,NNP,NNP,6,1
2370,4244.0,26,are,4,12,10,-2,11,15,-8,6,Abdul Rahim Noor,police chief,PERSON-PERSON-PERSON,TITLE-TITLE,PROPN-PROPN-PROPN,NOUN-NOUN,compound-compound-conj,compound-compound,NNP-NNP-NNP,NN-NN,2,1
2371,31457.0,38,alleged,1,35,6,-29,34,31,-34,5,Abdul Rahim Noor,police chief,PERSON-PERSON-PERSON,TITLE-TITLE,PROPN-PROPN-PROPN,NOUN-NOUN,compound-compound-pobj,compound-compound,NNP-NNP-NNP,NN-NN,6,1
2372,50630.0,48,comes,4,45,16,-29,44,31,-41,12,Abdul Rahim Noor,police chief,PERSON-PERSON-PERSON,TITLE-TITLE,PROPN-PROPN-PROPN,NOUN-NOUN,compound-compound-pobj,compound-nsubj,NNP-NNP-NNP,NN-NN,6,1
2373,4245.0,39,is,16,15,7,-8,14,31,1,-9,Abu Zubaydah,al-Qaida,PERSON-PERSON,ORGANIZATION,PROPN-PROPN,ADJ,compound-nsubj,compound,NNP-NNP,JJ,6,1
2374,10394.0,34,knew,21,2,9,7,1,24,19,-12,Abu Zubaydah,al-Qaida,PERSON-PERSON,ORGANIZATION,PROPN-PROPN,NOUN,compound-nsubj,pobj,NNP-NNP,NN,4,1
2375,48630.0,26,told,9,1,7,6,0,18,8,-2,Abu Zubaydah,al-Qaida,PERSON-PERSON,ORGANIZATION,PROPN-PROPN,ADJ,compound-nsubj,compound,NNP-NNP,JJ,3,1
2376,4246.0,31,graduated,19,8,24,16,7,6,11,5,youngest of eight children of Elizabeth Patch and Harry Dent,Oberlin College,PERSON-PERSON-PERSON-PERSON-PERSON-PERSON-PERSON-PERSON-PERSON-PERSON,ORGANIZATION-ORGANIZATION,ADJ-ADP-NUM-NOUN-ADP-PROPN-PROPN-CCONJ-PROPN-PROPN,PROPN-PROPN,appos-prep-nummod-pobj-prep-compound-pobj-cc-compound-conj,compound-pobj,JJS-IN-CD-NNS-IN-NNP-NNP-CC-NNP-NNP,NNP-NNP,8,1
2377,4256.0,27,heads,6,15,4,-11,14,22,-9,-2,JEM,Khalil Ibrahim,ORGANIZATION,PERSON-PERSON,PROPN,PROPN-PROPN,compound,compound-appos,NNP,NNP-NNP,3,1
2378,50969.0,17,denied,13,8,10,2,7,6,5,-3,JEM,Khalil Ibrahim,ORGANIZATION,PERSON-PERSON,PROPN,PROPN-PROPN,compound,compound-pobj,NNP,NNP-NNP,1,1
2379,59911.0,39,is,20,7,11,4,6,27,13,-9,JEM,Khalil Ibrahim,ORGANIZATION,PERSON-PERSON,PROPN,PROPN-PROPN,pobj,compound-pobj,NNP,NNP-NNP,4,1
2380,4268.0,14,said,7,9,12,3,8,1,-2,5,Red Sox,Terry Francona,ORGANIZATION-ORGANIZATION,PERSON-PERSON,PROPN-PROPN,PROPN-PROPN,compound-compound,compound-nsubj,NNP-NNP,NNP-NNP,4,1
2381,36143.0,24,praised,5,1,4,3,0,19,4,-1,Red Sox,Terry Francona,ORGANIZATION-ORGANIZATION,PERSON-PERSON,PROPN-PROPN,PROPN-PROPN,compound-compound,compound-nsubj,NNP-NNP,NNP-NNP,2,1
2382,65650.0,33,tamped,5,1,23,22,0,9,4,18,Red Sox,Terry Francona,ORGANIZATION-ORGANIZATION,PERSON-PERSON,PROPN-PROPN,PROPN-PROPN,compound-nsubjpass,compound-pobj,NNP-NNPS,NNP-NNP,4,1
2383,4270.0,26,was,14,12,3,-9,11,22,2,-11,Tokyo Stock Exchange,Topix,ORGANIZATION-ORGANIZATION-ORGANIZATION,ORGANIZATION,PROPN-PROPN-PROPN,PROPN,compound-compound-pobj,compound,NNP-NNP-NNP,NNP,3,1
2384,6254.0,28,was,14,12,3,-9,11,24,2,-11,Tokyo Stock Exchange,Topix,ORGANIZATION-ORGANIZATION-ORGANIZATION,ORGANIZATION,PROPN-PROPN-PROPN,PROPN,compound-compound-pobj,compound,NNP-NNP-NNP,NNP,3,1
2385,36958.0,26,was,14,12,3,-9,11,22,2,-11,Tokyo Stock Exchange,Topix,ORGANIZATION-ORGANIZATION-ORGANIZATION,ORGANIZATION,PROPN-PROPN-PROPN,PROPN,compound-compound-pobj,compound,NNP-NNP-NNP,NNP,3,1
2386,4272.0,46,have,1,21,6,-15,20,39,-20,5,he,ABC,PERSON,ORGANIZATION,PRON,PROPN,nsubj,nsubj,PRP,NNP,6,1
2387,41739.0,29,said,13,15,9,-6,14,19,-2,-4,he,ABC,PERSON,ORGANIZATION,PRON,PROPN,nsubj,nsubj,PRP,NNP,5,1
2388,64578.0,51,said,5,8,1,-7,7,49,-3,-4,he,ABC,PERSON,ORGANIZATION,PRON,PROPN,nsubj,compound,PRP,NNP,3,1
2389,4274.0,45,include,3,6,16,10,5,28,-3,13,Convocation of Anglicans in North America,Episcopal,ORGANIZATION-ORGANIZATION-ORGANIZATION-ORGANIZATION-ORGANIZATION-ORGANIZATION,RELIGION,PROPN-ADP-PROPN-ADP-PROPN-PROPN,ADJ,dobj-prep-pobj-prep-compound-pobj,amod,NNP-IN-NNPS-IN-NNP-NNP,JJ,4,1
2390,16381.0,49,preside,9,36,27,-9,35,21,-27,18,Convocation of Anglicans in North America,Episcopal,ORGANIZATION-ORGANIZATION-ORGANIZATION-ORGANIZATION-ORGANIZATION-ORGANIZATION,RELIGION,PROPN-ADP-PROPN-ADP-PROPN-PROPN,ADJ,pobj-prep-pobj-prep-compound-pobj,amod,NNP-IN-NNPS-IN-NNP-NNP,JJ,10,1
2391,4282.0,28,Candy,2,5,21,16,4,6,-3,19,Chad White,models,PERSON-PERSON,TITLE,PROPN-PROPN,NOUN,compound-compound,pobj,NNP-NNP,NNS,-1,1
2392,4283.0,38,spent,4,19,1,-18,18,36,-15,-3,Metropolitan District Commission,Gray,ORGANIZATION-ORGANIZATION-ORGANIZATION,PERSON,PROPN-PROPN-PROPN,PROPN,compound-compound-pobj,nsubj,NNP-NNP-NNP,NNP,7,1
2393,4286.0,45,changed,2,22,17,-5,21,27,-20,15,his,Anthony Fortunato,PERSON,PERSON-PERSON,DET,PROPN-PROPN,poss,compound-appos,PRP$,NNP-NNP,5,1
2394,9472.0,45,changed,2,22,17,-5,21,27,-20,15,his,Anthony Fortunato,PERSON,PERSON-PERSON,DET,PROPN-PROPN,poss,compound-appos,PRP$,NNP-NNP,5,1
2395,4291.0,10,was,6,4,9,5,3,0,2,3,Nyanza Hawkins,pharmacist,PERSON-PERSON,TITLE,PROPN-PROPN,NOUN,compound-appos,attr,NNP-NNP,NN,3,1
2396,4306.0,35,said,16,10,4,-6,9,30,6,-12,American Bar Association,Joseph Angland,ORGANIZATION-ORGANIZATION-ORGANIZATION,PERSON-PERSON,PROPN-PROPN-PROPN,PROPN-PROPN,compound-compound-poss,compound-nsubj,NNP-NNP-NNP,NNP-NNP,4,1
2397,4309.0,29,said,7,6,12,6,5,16,1,5,National Beef,Tim Klein,ORGANIZATION-ORGANIZATION,PERSON-PERSON,PROPN-PROPN,PROPN-PROPN,compound-nsubj,compound-appos,NNP-NNP,NNP-NNP,4,1
2398,21815.0,31,said,25,4,1,-3,3,29,21,-24,National Beef,Tim Klein,ORGANIZATION-ORGANIZATION,PERSON-PERSON,PROPN-PROPN,PROPN-PROPN,compound-poss,compound-nsubj,NNP-NNP,NNP-NNP,2,1
2399,4316.0,19,born,2,1,13,12,0,5,1,11,Buchwald,Variety magazine,PERSON,ORGANIZATION-ORGANIZATION,PROPN,PROPN-NOUN,nsubjpass,compound-pobj,NNP,NNP-NN,5,1
2400,4320.0,22,told,17,1,9,8,0,12,16,-8,Buchwald,Washington,PERSON,STATE_OR_PROVINCE,PROPN,PROPN,nsubj,pobj,NNP,NNP,5,1
2401,4321.0,32,features,17,26,19,-7,25,12,-9,2,Sean Parker,pop star,PERSON-PERSON,TITLE-TITLE,PROPN-PROPN,NOUN-NOUN,compound-pobj,compound-compound,NNP-NNP,NN-NN,3,1
2402,4324.0,43,said,24,27,26,-1,26,16,-3,2,Mamoor Khan,Maj,PERSON-PERSON,TITLE,PROPN-PROPN,PROPN,compound-nsubj,compound,NNP-NNP,NNP,1,1
2403,4326.0,23,wrangling,8,17,16,-1,16,6,-9,8,Sean Preston,2-year-old,PERSON-PERSON,NUMBER,PROPN-PROPN,NUM,compound-npadvmod,compound,NNP-NNP,CD,1,1
2404,4332.0,47,said,8,8,16,8,7,30,0,8,Chen,Hong Kong Asia,PERSON,LOCATION-LOCATION-LOCATION,PROPN,PROPN-PROPN-PROPN,nsubj,compound-compound-poss,NNP,NNP-NNP-NNP,6,1
2405,4334.0,43,said,21,19,16,-3,18,26,2,-5,John Negroponte,State Department,PERSON-PERSON,ORGANIZATION-ORGANIZATION,PROPN-PROPN,PROPN-PROPN,compound-pobj,compound-compound,NNP-NNP,NNP-NNP,2,1
2406,50176.0,71,said,66,6,5,-1,5,65,60,-61,John Negroponte,State Department,PERSON-PERSON,ORGANIZATION-ORGANIZATION,PROPN-PROPN,PROPN-PROPN,compound-nsubj,compound-nsubj,NNP-NNP,NNP-NNP,1,1
2407,4339.0,29,developed,2,1,20,19,0,8,1,18,SLDN,Obama,ORGANIZATION,PERSON,PROPN,PROPN,nsubj,nsubjpass,NNP,NNP,7,1
2408,4344.0,24,gets,8,12,8,-4,11,15,-4,0,DHS,Iowa,ORGANIZATION,STATE_OR_PROVINCE,PROPN,PROPN,compound,pobj,NNP,NNP,8,1
2409,4346.0,28,told,8,12,5,-7,11,22,-4,-3,he,police Chief,PERSON,TITLE-TITLE,PRON,NOUN-PROPN,nsubj,compound-compound,PRP,NN-NNP,4,1
2410,4349.0,42,criticizes,2,20,25,5,19,16,-18,23,Korean Central News Agency,KCNA,ORGANIZATION-ORGANIZATION-ORGANIZATION-ORGANIZATION,ORGANIZATION,PROPN-PROPN-PROPN-PROPN,PROPN,compound-compound-compound-pobj,compound,NNP-NNP-NNP-NNP,NNP,5,1
2411,13741.0,41,Agency,4,2,7,5,1,33,2,3,Korean Central News Agency,KCNA,ORGANIZATION-ORGANIZATION-ORGANIZATION-ORGANIZATION,ORGANIZATION,PROPN-PROPN-PROPN-PROPN,PROPN,compound-compound-compound-ROOT,compound,NNP-NNP-NNP-NNP,NNP,4,1
2412,55586.0,29,is,4,22,27,5,21,1,-18,23,Korean Central News Agency,KCNA,ORGANIZATION-ORGANIZATION-ORGANIZATION-ORGANIZATION,ORGANIZATION,PROPN-PROPN-PROPN-PROPN,PROPN,compound-compound-compound-pobj,compound,NNP-NNP-NNP-NNP,NNP,6,1
2413,61283.0,34,said,24,27,32,5,26,1,-3,8,Korean Central News Agency,KCNA,ORGANIZATION-ORGANIZATION-ORGANIZATION-ORGANIZATION,ORGANIZATION,PROPN-PROPN-PROPN-PROPN,PROPN,compound-compound-compound-nsubj,compound,NNP-NNP-NNP-NNP,NNP,1,1
2414,62973.0,47,Agency,7,5,10,5,4,36,2,3,Korean Central News Agency,KCNA,ORGANIZATION-ORGANIZATION-ORGANIZATION-ORGANIZATION,ORGANIZATION,PROPN-PROPN-PROPN-PROPN,PROPN,compound-compound-compound-ROOT,compound,NNP-NNP-NNP-NNP,NNP,3,1
2415,65289.0,43,BAGHDAD,0,14,41,27,13,1,-14,41,Korean Central News Agency,KCNA,ORGANIZATION-ORGANIZATION-ORGANIZATION-ORGANIZATION,ORGANIZATION,PROPN-PROPN-PROPN-PROPN,PROPN,compound-compound-compound-pobj,compound,NNP-NNP-NNP-NNP,NNP,5,1
2416,4352.0,62,turns,4,20,43,23,19,18,-16,39,Thomas J Meskill,governor,PERSON-PERSON-PERSON,TITLE,PROPN-PROPN-PROPN,NOUN,compound-compound-dobj,pobj,NNP-NNP-NNP,NN,6,1
2417,4362.0,27,said,12,8,25,17,7,1,4,13,Peterson,player,PERSON,TITLE,PROPN,NOUN,poss,dobj,NNP,NN,8,1
2418,4375.0,41,978,0,9,12,3,8,28,-9,12,Room 222,State,ORGANIZATION-ORGANIZATION,CITY,PROPN-NUM,PROPN,appos-nummod,compound,NNP-CD,NNP,2,1
2419,4388.0,29,agreed,4,11,27,16,10,1,-7,23,DirecTV,News Corp,ORGANIZATION,PERSON-PERSON,NOUN,PROPN-PROPN,pobj,compound-pobj,NN,NNP-NNP,7,1
2420,18674.0,28,Feds,0,8,5,-3,7,22,-8,5,DirecTV,News Corp,ORGANIZATION,ORGANIZATION-ORGANIZATION,VERB,PROPN-PROPN,conj,compound-pobj,VBD,NNP-NNP,3,1
2421,26991.0,11,controlled,3,1,9,8,0,1,2,6,DirecTV,News Corp,ORGANIZATION,ORGANIZATION-ORGANIZATION,PROPN,PROPN-PROPN,nsubjpass,compound-pobj,NNP,NNP-NNP,3,1
2422,47170.0,41,owns,2,38,1,-37,37,39,-36,-1,DirecTV,News Corp,ORGANIZATION,ORGANIZATION-ORGANIZATION,VERB,PROPN-PROPN,punct,compound-nsubj,VBP,NNP-NNP,2,1
2423,4400.0,57,Buse,1,1,32,31,0,24,0,31,Mark Buse,Cablevision,PERSON-PERSON,ORGANIZATION,PROPN-PROPN,PROPN,compound-ROOT,conj,NNP-NNP,NNP,6,1
2424,4401.0,45,is,4,9,26,17,8,18,-5,22,Carnival Corporation,Ocean Conservation & Tourism Alliance,ORGANIZATION-ORGANIZATION,ORGANIZATION-ORGANIZATION-ORGANIZATION-ORGANIZATION-ORGANIZATION,PROPN-PROPN,PROPN-PROPN-CCONJ-PROPN-PROPN,compound-pobj,nmod-nmod-cc-conj-dobj,NNP-NNP,NNP-NNP-CC-NNP-NNP,6,1
2425,4402.0,22,says,10,19,12,-7,18,9,-9,2,American Bankers Association,Bob Seiwert,ORGANIZATION-ORGANIZATION-ORGANIZATION,PERSON-PERSON,PROPN-PROPN-PROPN,PROPN-PROPN,compound-compound-pobj,compound-nsubj,NNP-NNP-NNP,NNP-NNP,3,1
2426,4416.0,22,went,5,4,1,-3,3,20,1,-4,Barbara Boxer,California,PERSON-PERSON,STATE_OR_PROVINCE,PROPN-PROPN,PROPN,compound-nsubj,compound,NNP-NNP,NNP,2,1
2427,7855.0,27,supporting,17,9,1,-8,8,25,8,-16,Barbara Boxer,California,PERSON-PERSON,STATE_OR_PROVINCE,PROPN-PROPN,PROPN,compound-conj,poss,NNP-NNP,NNP,4,1
2428,9326.0,26,said,8,5,8,3,4,17,3,0,Barbara Boxer,California,PERSON-PERSON,STATE_OR_PROVINCE,PROPN-PROPN,PROPN,compound-pobj,pobj,NNP-NNP,NNP,3,1
2429,14558.0,15,continues,4,3,1,-2,2,13,1,-3,Barbara Boxer,California,PERSON-PERSON,STATE_OR_PROVINCE,PROPN-PROPN,PROPN,compound-nsubj,compound,NNP-NNP,NNP,1,1
2430,26922.0,22,heckled,5,18,21,3,17,0,-13,16,Barbara Boxer,California,PERSON-PERSON,STATE_OR_PROVINCE,PROPN-PROPN,PROPN,compound-pobj,pobj,NNP-NNP,NNP,7,1
2431,29606.0,24,introduced,1,8,6,-2,7,17,-7,5,Barbara Boxer,California,PERSON-PERSON,STATE_OR_PROVINCE,PROPN-PROPN,PROPN,compound-nsubj,compound,NNP-NNP,NNP,1,1
2432,30299.0,17,struggling,11,1,4,3,0,12,10,-7,Barbara Boxer,California,PERSON-PERSON,STATE_OR_PROVINCE,PROPN-PROPN,PROPN,compound-nsubj,pobj,NNP-NNP,NNP,1,1
2433,33405.0,57,Labels,0,3,8,5,2,48,-3,8,Barbara Boxer,California,PERSON-PERSON,STATE_OR_PROVINCE,PROPN-PROPN,PROPN,compound-nsubj,conj,NNP-NNP,NNP,3,1
2434,34630.0,54,Boxer,3,3,1,-2,2,52,0,-2,Barbara Boxer,California,PERSON-PERSON,STATE_OR_PROVINCE,PROPN-PROPN,PROPN,compound-ROOT,compound,NNP-NNP,NNP,1,1
2435,36170.0,57,included,1,22,16,-6,21,40,-21,15,Barbara Boxer,California,PERSON-PERSON,STATE_OR_PROVINCE,PROPN-PROPN,PROPN,compound-nsubj,appos,NNP-NNP,NNP,3,1
2436,38449.0,41,said,15,19,22,3,18,18,-4,7,Barbara Boxer,California,PERSON-PERSON,STATE_OR_PROVINCE,PROPN-PROPN,PROPN,compound-nsubj,pobj,NNP-NNP,NNP,3,1
2437,41336.0,46,calls,19,35,45,10,34,0,-16,26,Barbara Boxer,California,PERSON-PERSON,STATE_OR_PROVINCE,PROPN-PROPN,PROPN,compound-pobj,pobj,NNP-NNP,NNP,3,1
2438,43163.0,30,SACRAMENTO,0,18,25,7,17,4,-18,25,Barbara Boxer,California,PERSON-PERSON,STATE_OR_PROVINCE,PROPN-PROPN,PROPN,compound-conj,dobj,NNP-NNP,NNP,3,1
2439,43718.0,25,introduced,8,1,7,6,0,17,7,-1,Barbara Boxer,California,PERSON-PERSON,STATE_OR_PROVINCE,PROPN-PROPN,PROPN,compound-nsubj,pobj,NNP-NNP,NNP,2,1
2440,56595.0,45,declared,17,20,24,4,19,20,-3,7,Barbara Boxer,California,PERSON-PERSON,STATE_OR_PROVINCE,PROPN-PROPN,PROPN,compound-nsubj,compound,NNP-NNP,NNP,3,1
2441,57352.0,32,said,26,30,28,-2,29,3,-4,2,Barbara Boxer,California,PERSON-PERSON,STATE_OR_PROVINCE,PROPN-PROPN,PROPN,compound-nsubj,compound,NNP-NNP,NNP,3,1
2442,65637.0,59,administration,3,15,13,-2,14,45,-12,10,Barbara Boxer,California,PERSON-PERSON,STATE_OR_PROVINCE,PROPN-PROPN,PROPN,compound-nsubj,compound,NNP-NNP,NNP,1,1
2443,4422.0,21,was,4,9,7,-2,8,13,-5,3,John Kerry,Navy,PERSON-PERSON,ORGANIZATION,PROPN-PROPN,PROPN,compound-nsubj,compound,NNP-NNP,NNP,1,1
2444,4428.0,22,continued,5,5,11,6,4,10,0,6,Kollek,Jerusalem Foundation,PERSON,ORGANIZATION-ORGANIZATION,PROPN,PROPN-PROPN,nsubj,compound-pobj,NNP,NNP-NNP,3,1
2445,4435.0,39,said,33,31,29,-2,30,9,2,-4,Robert M. Morgenthau,District Attorney,PERSON-PERSON-PERSON,TITLE-TITLE,PROPN-PROPN-PROPN,PROPN-PROPN,compound-compound-nsubj,compound-compound,NNP-NNP-NNP,NNP-NNP,3,1
2446,4440.0,28,arrives,1,1,12,11,0,15,0,11,Kelly,Roxy,PERSON,PERSON,PROPN,PROPN,nsubj,conj,NNP,NNP,2,1
2447,4445.0,16,backed,11,8,4,-4,7,11,3,-7,Nicholas Burns,US,PERSON-PERSON,COUNTRY,PROPN-PROPN,PROPN,compound-nsubj,nmod,NNP-NNP,NNP,1,1
2448,16774.0,40,said,12,10,1,-9,9,38,2,-11,Nicholas Burns,US,PERSON-PERSON,COUNTRY,PROPN-PROPN,PROPN,compound-appos,nmod,NNP-NNP,NNP,2,1
2449,26689.0,57,met,30,8,1,-7,7,55,22,-29,Nicholas Burns,US,PERSON-PERSON,COUNTRY,PROPN-PROPN,PROPN,compound-nsubj,compound,NNP-NNP,NNP,1,1
2450,42415.0,35,hailed,11,1,4,3,0,30,10,-7,Nicholas Burns,US,PERSON-PERSON,COUNTRY,PROPN-PROPN,PROPN,compound-nsubj,compound,NNP-NNP,NNP,1,1
2451,49498.0,41,said,26,25,17,-8,24,23,1,-9,Nicholas Burns,US,PERSON-PERSON,COUNTRY,PROPN-PROPN,PROPN,compound-nsubj,nmod,NNP-NNP,NNP,2,1
2452,61248.0,31,meet,3,23,18,-5,22,12,-20,15,Nicholas Burns,US,PERSON-PERSON,COUNTRY,PROPN-PROPN,PROPN,compound-pobj,compound,NNP-NNP,NNP,1,1
2453,4446.0,53,is,31,1,29,28,0,23,30,-2,Covidien,Fenway Park,ORGANIZATION,LOCATION-LOCATION,PROPN,PROPN-PROPN,nsubj,compound-pobj,NNP,NNP-NNP,5,1
2454,4460.0,19,are,1,15,18,3,14,0,-14,17,Andre Carson,Indiana,PERSON-PERSON,STATE_OR_PROVINCE,PROPN-PROPN,PROPN,compound-conj,pobj,NNP-NNP,NNP,4,1
2455,5664.0,39,picked,6,26,29,3,25,9,-20,23,Andre Carson,Indiana,PERSON-PERSON,STATE_OR_PROVINCE,PROPN-PROPN,PROPN,compound-appos,pobj,NNP-NNP,NNP,1,1
2456,24905.0,38,cautioned,18,3,7,4,2,30,15,-11,Andre Carson,Indiana,PERSON-PERSON,STATE_OR_PROVINCE,PROPN-PROPN,PROPN,compound-nsubj,compound,NNP-NNP,NNP,1,1
2457,27332.0,24,are,4,17,23,6,16,0,-13,19,Andre Carson,Indiana,PERSON-PERSON,STATE_OR_PROVINCE,PROPN-PROPN,PROPN,compound-conj,pobj,NNP-NNP,NNP,4,1
2458,28142.0,29,elected,10,16,23,7,15,5,-6,13,Andre Carson,Indiana,PERSON-PERSON,STATE_OR_PROVINCE,PROPN-PROPN,PROPN,compound-nsubjpass,pobj,NNP-NNP,NNP,2,1
2459,32991.0,19,serve,15,11,14,3,10,4,4,-1,Andre Carson,Indiana,PERSON-PERSON,STATE_OR_PROVINCE,PROPN-PROPN,PROPN,compound-conj,pobj,NNP-NNP,NNP,4,1
2460,4461.0,18,is,2,9,15,6,8,2,-7,13,Berthold Huber,president,PERSON-PERSON,TITLE,PROPN-PROPN,NOUN,compound-nsubj,appos,NNP-NNP,NN,2,1
2461,9949.0,17,said,15,9,15,6,8,1,6,0,Berthold Huber,president,PERSON-PERSON,TITLE,PROPN-PROPN,NOUN,compound-npadvmod,nsubj,NNP-NNP,NN,2,1
2462,16003.0,25,said,20,19,18,-1,18,6,1,-2,Berthold Huber,president,PERSON-PERSON,TITLE,PROPN-PROPN,NOUN,compound-nsubj,compound,NNP-NNP,NN,2,1
2463,29454.0,22,argued,20,19,18,-1,18,3,1,-2,Berthold Huber,president,PERSON-PERSON,TITLE,PROPN-PROPN,NOUN,compound-nsubj,compound,NNP-NNP,NN,2,1
2464,34908.0,37,said,19,11,16,5,10,20,8,-3,Berthold Huber,president,PERSON-PERSON,TITLE,PROPN-PROPN,NOUN,compound-dobj,pobj,NNP-NNP,NN,3,1
2465,35482.0,29,soared,3,20,19,-1,19,9,-17,16,Berthold Huber,president,PERSON-PERSON,TITLE,PROPN-PROPN,NOUN,compound-nsubjpass,compound,NNP-NNP,NN,2,1
2466,4464.0,21,is,1,17,1,-16,16,19,-16,0,Canadian National Railway Co.,Lamphere,ORGANIZATION-ORGANIZATION-ORGANIZATION-ORGANIZATION,PERSON,PROPN-PROPN-PROPN-PROPN,PROPN,compound-compound-compound-pobj,nsubj,NNP-NNP-NNP-NNP,NNP,8,1
2467,4467.0,45,became,3,32,1,-31,31,43,-29,-2,International Monetary Fund,Ireland,ORGANIZATION-ORGANIZATION-ORGANIZATION,COUNTRY,PROPN-PROPN-PROPN,NOUN,compound-compound-conj,nsubj,NNP-NNP-NNP,NN,7,1
2468,4468.0,60,survived,2,21,16,-5,20,43,-19,14,Robert E. Jr.,Columbia,PERSON-PERSON-PERSON,CITY,PROPN-PROPN-PROPN,PROPN,compound-compound-appos,pobj,NNP-NNP-NNP,NNP,4,1
2469,4473.0,21,says,14,2,19,17,1,1,12,5,ADB,Peter Pedersen,ORGANIZATION,PERSON-PERSON,PROPN,PROPN-PROPN,compound,compound-nsubj,NNP,NNP-NNP,5,1
2470,4476.0,25,credited,9,7,6,-1,6,18,2,-3,Juanita Millender-McDonald,Rep,PERSON-PERSON,TITLE,PROPN-PROPN,PROPN,compound-pobj,compound,NNP-NNP,NNP,2,1
2471,34464.0,51,likes,17,1,5,4,0,45,16,-12,Juanita Millender-McDonald,Rep,PERSON-PERSON,TITLE,PROPN-PROPN,PROPN,compound-conj,compound,NNP-NNP,NNP,3,1
2472,4477.0,37,became,18,9,1,-8,8,35,9,-17,Samsung,Lee Byung - Chull,ORGANIZATION,PERSON-PERSON-PERSON-PERSON,PROPN,PROPN-PROPN-PUNCT-PROPN,amod,compound-compound-punct-appos,NNP,NNP-NNP-HYPH-NNP,6,1
2473,4482.0,49,died,39,1,48,47,0,0,38,9,Harry Shuler Dent,SC,PERSON-PERSON-PERSON,STATE_OR_PROVINCE,PROPN-PROPN-PROPN,PROPN,compound-compound-nsubj,appos,NNP-NNP-NNP,NNP,3,1
2474,4506.0,53,said,35,1,3,2,0,49,34,-32,His,Anthony Hamilton,PERSON,PERSON-PERSON,DET,PROPN-PROPN,poss,compound-appos,PRP$,NNP-NNP,1,1
2475,4508.0,16,like,6,1,5,4,0,10,5,-1,Ellen DeGeneres,Betty,PERSON-PERSON,PERSON,PROPN-PROPN,PROPN,compound-poss,nsubj,NNP-NNP,NNP,4,1
2476,4519.0,21,offered,17,4,12,8,3,8,13,-5,M Enkhbold,Mongolia,PERSON-PERSON,ORGANIZATION,PROPN-PROPN,PROPN,compound-nsubj,conj,NNP-NNP,NNP,3,1
2477,14377.0,37,accepts,4,33,18,-15,32,18,-29,14,M Enkhbold,Mongolia,PERSON-PERSON,COUNTRY,PROPN-PROPN,PROPN,compound-pobj,poss,NNP-NNP,NNP,6,1
2478,37422.0,29,said,5,4,10,6,3,18,1,5,M Enkhbold,Mongolia,PERSON-PERSON,COUNTRY,PROPN-PROPN,PROPN,compound-nsubj,nsubj,NNP-NNP,NNP,3,1
2479,39845.0,20,met,2,9,5,-4,8,14,-7,3,M Enkhbold,Mongolia,PERSON-PERSON,COUNTRY,PROPN-PROPN,PROPN,compound-pobj,poss,NNP-NNP,NNP,3,1
2480,4525.0,29,found,13,9,12,3,8,16,4,-1,William Anderson,Virgina,PERSON-PERSON,LOCATION,PROPN-PROPN,PROPN,compound-compound,compound,NNP-NNP,NNP,-1,1
2481,4537.0,26,passed,13,23,10,-13,22,15,-10,-3,Carolyn Maloney,United States,PERSON-PERSON,COUNTRY-COUNTRY,PROPN-PROPN,PROPN-PROPN,compound-pobj,compound-pobj,NNP-NNP,NNP-NNP,8,1
2482,65328.0,42,said,24,27,8,-19,26,33,-3,-16,Carolyn Maloney,United States,PERSON-PERSON,COUNTRY-COUNTRY,PROPN-PROPN,PROPN-PROPN,compound-nsubj,compound-pobj,NNP-NNP,NNP-NNP,4,1
2483,4540.0,43,said,15,3,2,-1,2,40,12,-13,Mahmood Shah,Brig.,PERSON-PERSON,TITLE,PROPN-PROPN,PROPN,compound-nsubj,compound,NNP-NNP,NNP,-1,1
2484,27718.0,33,tribe,1,31,30,-1,30,2,-30,29,Mahmood Shah,Brig.,PERSON-PERSON,TITLE,PROPN-PROPN,PROPN,compound-appos,compound,NNP-NNP,NNP,-1,1
2485,51052.0,37,said,18,21,20,-1,20,16,-3,2,Mahmood Shah,Brig.,PERSON-PERSON,TITLE,PROPN-PROPN,PROPN,compound-nsubj,compound,NNP-NNP,NNP,1,1
2486,62269.0,48,said,19,2,1,-1,1,46,17,-18,Mahmood Shah,Brig.,PERSON-PERSON,TITLE,PROPN-PROPN,PROPN,compound-nsubj,compound,NNP-NNP,NNP,-1,1
2487,4542.0,26,called,20,4,2,-2,3,23,16,-18,Ali Akbar Salehi,Vice President,PERSON-PERSON-PERSON,TITLE-TITLE,PROPN-PROPN-PROPN,PROPN-PROPN,compound-compound-nsubj,compound-compound,NNP-NNP-NNP,NNP-NNP,2,1
2488,5783.0,49,expected,14,34,32,-2,33,16,-20,18,Ali Akbar Salehi,Vice President,PERSON-PERSON-PERSON,TITLE-TITLE,PROPN-PROPN-PROPN,PROPN-PROPN,compound-compound-pobj,compound-compound,NNP-NNP-NNP,NNP-NNP,2,1
2489,24082.0,48,accused,14,9,7,-2,8,40,5,-7,Ali Akbar Salehi,Vice President,PERSON-PERSON-PERSON,TITLE-TITLE,PROPN-PROPN-PROPN,PROPN-PROPN,compound-compound-appos,compound-compound,NNP-NNP-NNP,NNP-NNP,2,1
2490,25594.0,31,said,9,6,4,-2,5,26,3,-5,Ali Akbar Salehi,Vice President,PERSON-PERSON-PERSON,TITLE-TITLE,PROPN-PROPN-PROPN,PROPN-PROPN,compound-compound-appos,compound-compound,NNP-NNP-NNP,NNP-NNP,2,1
2491,53339.0,38,told,5,3,1,-2,2,36,2,-4,Ali Akbar Salehi,Vice President,PERSON-PERSON-PERSON,TITLE-TITLE,PROPN-PROPN-PROPN,PROPN-PROPN,compound-compound-nsubj,compound-compound,NNP-NNP-NNP,NNP-NNP,2,1
2492,54630.0,40,told,5,3,1,-2,2,38,2,-4,Ali Akbar Salehi,Vice President,PERSON-PERSON-PERSON,TITLE-TITLE,PROPN-PROPN-PROPN,PROPN-PROPN,compound-compound-nsubj,compound-compound,NNP-NNP-NNP,NNP-NNP,2,1
2493,68101.0,34,said,13,3,1,-2,2,32,10,-12,Ali Akbar Salehi,Vice President,PERSON-PERSON-PERSON,TITLE-TITLE,PROPN-PROPN-PROPN,PROPN-PROPN,compound-compound-nsubj,compound-compound,NNP-NNP-NNP,NNP-NNP,2,1
2494,4543.0,21,found,9,1,13,12,0,7,8,4,Abu Zubaydah,conspiracy to carry out terror attacks,PERSON-PERSON,CRIMINAL_CHARGE-CRIMINAL_CHARGE-CRIMINAL_CHARGE-CRIMINAL_CHARGE-CRIMINAL_CHARGE-CRIMINAL_CHARGE,PROPN-PROPN,NOUN-PART-VERB-PART-NOUN-NOUN,compound-nsubjpass,pobj-aux-acl-prt-compound-dobj,NNP-NNP,NN-TO-VB-RP-NN-NNS,6,1
2495,4546.0,19,traded,2,16,12,-4,15,6,-14,10,Golden Baseball League,Laredo Broncos,ORGANIZATION-ORGANIZATION-ORGANIZATION,ORGANIZATION-ORGANIZATION,PROPN-PROPN-PROPN,PROPN-PROPN,compound-compound-pobj,compound-pobj,NNP-NNP-NNP,NNP-NNPS,3,1
2496,4547.0,21,faces,10,1,13,12,0,7,9,3,Remy Smith,assault,PERSON-PERSON,CRIMINAL_CHARGE,PROPN-PROPN,NOUN,compound-attr,dobj,NNP-NNP,NN,3,1
2497,57779.0,35,convicted,11,1,16,15,0,18,10,5,Remy Smith,assault,PERSON-PERSON,CRIMINAL_CHARGE,PROPN-PROPN,NOUN,compound-attr,pobj,NNP-NNP,NN,5,1
2498,4550.0,57,said,20,4,10,6,3,46,16,-10,Chunghwa Telecom,Mao,ORGANIZATION-ORGANIZATION,PERSON,PROPN-PROPN,PROPN,compound-nsubj,dobj,NNP-NNP,NNP,3,1
2499,4553.0,32,created,14,2,8,6,1,23,12,-6,Central American Parliament,132,ORGANIZATION-ORGANIZATION-ORGANIZATION,NUMBER,ADJ-PROPN-PROPN,NUM,compound-compound-nsubjpass,nummod,JJ-NNP-NNP,CD,3,1
2500,28226.0,28,represented,6,12,21,9,11,6,-6,15,Central American Parliament,132,ORGANIZATION-ORGANIZATION-ORGANIZATION,NUMBER,ADJ-PROPN-PROPN,NUM,compound-compound-pobj,nummod,JJ-NNP-NNP,CD,3,1
2501,35030.0,41,represented,13,19,31,12,18,9,-6,18,Central American Parliament,132,ORGANIZATION-ORGANIZATION-ORGANIZATION,NUMBER,ADJ-PROPN-PROPN,NUM,compound-compound-pobj,nummod,JJ-NNP-NNP,CD,4,1
2502,4555.0,28,said,15,24,17,-7,23,10,-9,2,New York Immigration Coalition,Chung-Wha Hong,ORGANIZATION-ORGANIZATION-ORGANIZATION-ORGANIZATION,PERSON-PERSON,PROPN-PROPN-PROPN-PROPN,PROPN-PROPN,compound-compound-compound-pobj,compound-nsubj,NNP-NNP-NNP-NNP,NNP-NNP,6,1
2503,9374.0,28,said,15,24,17,-7,23,10,-9,2,New York Immigration Coalition,Chung-Wha Hong,ORGANIZATION-ORGANIZATION-ORGANIZATION-ORGANIZATION,PERSON-PERSON,PROPN-PROPN-PROPN-PROPN,PROPN-PROPN,compound-compound-compound-pobj,compound-nsubj,NNP-NNP-NNP-NNP,NNP-NNP,3,1
2504,10096.0,23,called,12,8,1,-7,7,21,4,-11,New York Immigration Coalition,Chung-Wha Hong,ORGANIZATION-ORGANIZATION-ORGANIZATION-ORGANIZATION,PERSON-PERSON,PROPN-PROPN-PROPN-PROPN,PROPN-PROPN,compound-compound-compound-pobj,compound-nsubj,NNP-NNP-NNP-NNP,NNP-NNP,6,1
2505,15317.0,26,said,12,8,1,-7,7,24,4,-11,New York Immigration Coalition,Chung-Wha Hong,ORGANIZATION-ORGANIZATION-ORGANIZATION-ORGANIZATION,PERSON-PERSON,PROPN-PROPN-PROPN-PROPN,PROPN-PROPN,compound-compound-compound-pobj,compound-nsubj,NNP-NNP-NNP-NNP,NNP-NNP,6,1
2506,17593.0,56,said,30,39,32,-7,38,23,-9,2,New York Immigration Coalition,Chung-Wha Hong,ORGANIZATION-ORGANIZATION-ORGANIZATION-ORGANIZATION,PERSON-PERSON,PROPN-PROPN-PROPN-PROPN,PROPN-PROPN,compound-compound-compound-pobj,compound-nsubj,NNP-NNP-NNP-NNP,NNP-NNP,3,1
2507,29307.0,43,said,18,27,20,-7,26,22,-9,2,New York Immigration Coalition,Chung-Wha Hong,ORGANIZATION-ORGANIZATION-ORGANIZATION-ORGANIZATION,PERSON-PERSON,PROPN-PROPN-PROPN-PROPN,PROPN-PROPN,compound-compound-compound-pobj,compound-nsubj,NNP-NNP-NNP-NNP,NNP-NNP,3,1
2508,31169.0,60,said,36,45,38,-7,44,21,-9,2,New York Immigration Coalition,Chung-Wha Hong,ORGANIZATION-ORGANIZATION-ORGANIZATION-ORGANIZATION,PERSON-PERSON,PROPN-PROPN-PROPN-PROPN,PROPN-PROPN,compound-compound-compound-pobj,compound-nsubj,NNP-NNP-NNP-NNP,NNP-NNP,3,1
2509,31947.0,29,said,16,25,18,-7,24,10,-9,2,New York Immigration Coalition,Chung-Wha Hong,ORGANIZATION-ORGANIZATION-ORGANIZATION-ORGANIZATION,PERSON-PERSON,PROPN-PROPN-PROPN-PROPN,PROPN-PROPN,compound-compound-compound-pobj,compound-nsubj,NNP-NNP-NNP-NNP,NNP-NNP,2,1
2510,34620.0,41,says,13,19,15,-4,18,25,-6,2,New York Immigration Coalition,Chung-Wha Hong,ORGANIZATION-ORGANIZATION-ORGANIZATION-ORGANIZATION,PERSON-PERSON,PROPN-PROPN-PROPN-PROPN,PROPN-PROPN,compound-compound-compound-pobj,compound-nsubj,NNP-NNP-NNP-NNP,NNP-NNP,5,1
2511,34663.0,31,said,18,27,20,-7,26,10,-9,2,New York Immigration Coalition,Chung-Wha Hong,ORGANIZATION-ORGANIZATION-ORGANIZATION-ORGANIZATION,PERSON-PERSON,PROPN-PROPN-PROPN-PROPN,PROPN-PROPN,compound-compound-compound-pobj,compound-nsubj,NNP-NNP-NNP-NNP,NNP-NNP,3,1
2512,34975.0,21,said,8,17,10,-7,16,10,-9,2,New York Immigration Coalition,Chung-Wha Hong,ORGANIZATION-ORGANIZATION-ORGANIZATION-ORGANIZATION,PERSON-PERSON,PROPN-PROPN-PROPN-PROPN,PROPN-PROPN,compound-compound-compound-pobj,compound-nsubj,NNP-NNP-NNP-NNP,NNP-NNP,3,1
2513,47417.0,34,noted,12,8,1,-7,7,32,4,-11,New York Immigration Coalition,Chung-Wha Hong,ORGANIZATION-ORGANIZATION-ORGANIZATION-ORGANIZATION,PERSON-PERSON,PROPN-PROPN-PROPN-PROPN,PROPN-PROPN,compound-compound-compound-pobj,compound-nsubj,NNP-NNP-NNP-NNP,NNP-NNP,6,1
2514,57637.0,42,said,12,8,1,-7,7,40,4,-11,New York Immigration Coalition,Chung-Wha Hong,ORGANIZATION-ORGANIZATION-ORGANIZATION-ORGANIZATION,PERSON-PERSON,PROPN-PROPN-PROPN-PROPN,PROPN-PROPN,compound-compound-compound-pobj,compound-nsubj,NNP-NNP-NNP-NNP,NNP-NNP,6,1
2515,57792.0,24,has,12,8,1,-7,7,22,4,-11,New York Immigration Coalition,Chung-Wha Hong,ORGANIZATION-ORGANIZATION-ORGANIZATION-ORGANIZATION,PERSON-PERSON,PROPN-PROPN-PROPN-PROPN,PROPN-PROPN,compound-compound-compound-pobj,compound-nsubj,NNP-NNP-NNP-NNP,NNP-NNP,6,1
2516,58399.0,38,said,20,29,22,-7,28,15,-9,2,New York Immigration Coalition,Chung-Wha Hong,ORGANIZATION-ORGANIZATION-ORGANIZATION-ORGANIZATION,PERSON-PERSON,PROPN-PROPN-PROPN-PROPN,PROPN-PROPN,compound-compound-compound-pobj,compound-nsubj,NNP-NNP-NNP-NNP,NNP-NNP,3,1
2517,62763.0,23,said,10,19,12,-7,18,10,-9,2,New York Immigration Coalition,Chung-Wha Hong,ORGANIZATION-ORGANIZATION-ORGANIZATION-ORGANIZATION,PERSON-PERSON,PROPN-PROPN-PROPN-PROPN,PROPN-PROPN,compound-compound-compound-pobj,compound-nsubj,NNP-NNP-NNP-NNP,NNP-NNP,3,1
2518,65014.0,54,said,41,50,43,-7,49,10,-9,2,New York Immigration Coalition,Chung-Wha Hong,ORGANIZATION-ORGANIZATION-ORGANIZATION-ORGANIZATION,PERSON-PERSON,PROPN-PROPN-PROPN-PROPN,PROPN-PROPN,compound-compound-compound-pobj,compound-nsubj,NNP-NNP-NNP-NNP,NNP-NNP,4,1
2519,4573.0,38,said,28,20,25,5,19,12,8,-3,Carolyn B. Maloney,New York,PERSON-PERSON-PERSON,STATE_OR_PROVINCE-STATE_OR_PROVINCE,PROPN-PROPN-PROPN,PROPN-PROPN,compound-compound-nsubj,compound-compound,NNP-NNP-NNP,NNP-NNP,4,1
2520,4575.0,31,imposed,20,10,6,-4,9,24,10,-14,PRC,Popular Resistance Committees,ORGANIZATION,ORGANIZATION-ORGANIZATION-ORGANIZATION,PROPN,PROPN-PROPN-PROPN,compound,compound-compound-compound,NNP,NNP-NNP-NNPS,5,1
2521,13579.0,45,GAZA,0,21,17,-4,20,27,-21,17,PRC,Popular Resistance Committees,ORGANIZATION,ORGANIZATION-ORGANIZATION-ORGANIZATION,PROPN,PROPN-PROPN-PROPN,compound,compound-compound-compound,NNP,NNP-NNP-NNPS,7,1
2522,20712.0,34,Dec,2,14,10,-4,13,23,-12,8,PRC,Popular Resistance Committees,ORGANIZATION,ORGANIZATION-ORGANIZATION-ORGANIZATION,PROPN,PROPN-PROPN-PROPN,compound,compound-compound-appos,NNP,NNP-NNP-NNPS,2,1
2523,31504.0,34,killed,17,15,11,-4,14,22,2,-6,PRC,Popular Resistance Committees,ORGANIZATION,ORGANIZATION-ORGANIZATION-ORGANIZATION,PROPN,PROPN-PROPN-PROPN,compound,compound-compound-compound,NNP,NNP-NNP-NNPS,5,1
2524,40866.0,43,GAZA,0,13,9,-4,12,33,-13,9,PRC,Popular Resistance Committees,ORGANIZATION,ORGANIZATION-ORGANIZATION-ORGANIZATION,PROPN,PROPN-PROPN-PROPN,compound,compound-compound-compound,NNP,NNP-NNP-NNPS,2,1
2525,60792.0,55,said,29,41,37,-4,40,17,-12,8,PRC,Popular Resistance Committees,ORGANIZATION,ORGANIZATION-ORGANIZATION-ORGANIZATION,PROPN,PROPN-PROPN-PROPN,compound,compound-compound-compound,NNP,NNP-NNP-NNPS,7,1
2526,4580.0,18,is,1,10,9,-1,9,8,-9,8,Andre Carson,Congressman,PERSON-PERSON,TITLE,PROPN-PROPN,PROPN,compound-pobj,compound,NNP-NNP,NNP,1,1
2527,42046.0,10,said,3,2,1,-1,1,8,1,-2,Andre Carson,Congressman,PERSON-PERSON,TITLE,PROPN-PROPN,PROPN,compound-nsubj,compound,NNP-NNP,NNP,1,1
2528,4594.0,64,signed,3,20,15,-5,19,48,-17,12,Alcatel-Lucent,Etienne Fouques,ORGANIZATION,PERSON-PERSON,PROPN,PROPN-PROPN,poss,compound-conj,NNP,NNP-NNP,5,1
2529,4595.0,44,is,11,17,11,-6,16,32,-6,0,Dan Abrams,She,PERSON-PERSON,PERSON,PROPN-PROPN,PRON,compound-pobj,nsubj,NNP-NNP,PRP,3,1
2530,4597.0,40,reveals,13,11,7,-4,10,32,2,-6,ABA,American Bankers Association,ORGANIZATION,ORGANIZATION-ORGANIZATION-ORGANIZATION,PROPN,PROPN-PROPN-PROPN,compound,compound-compound-pobj,NNP,NNP-NNPS-NNP,2,1
2531,29325.0,38,dropped,12,36,32,-4,35,5,-24,20,ABA,American Bankers Association,ORGANIZATION,ORGANIZATION-ORGANIZATION-ORGANIZATION,PROPN,PROPN-PROPN-PROPN,compound,compound-compound-pobj,NNP,NNP-NNPS-NNP,8,1
2532,40342.0,33,issued,10,17,7,-10,16,25,-7,-3,ABA,American Bankers Association,ORGANIZATION,ORGANIZATION-ORGANIZATION-ORGANIZATION,PROPN,PROPN-PROPN-PROPN,nsubj,compound-compound-pobj,NNP,NNP-NNPS-NNP,8,1
2533,4614.0,33,splitting,3,2,13,11,1,19,1,10,Tyco Healthcare,Covidien,ORGANIZATION-ORGANIZATION,ORGANIZATION,PROPN-PROPN,PROPN,compound-pobj,oprd,NNP-NNP,NNP,5,1
2534,52952.0,26,include,15,20,17,-3,19,8,-5,2,Tyco Healthcare,Covidien,ORGANIZATION-ORGANIZATION,ORGANIZATION,PROPN-PROPN,PROPN,compound-conj,dobj,NNP-NNP,NNP,2,1
2535,57603.0,58,splitting,15,2,30,28,1,27,13,15,Tyco Healthcare,Covidien,ORGANIZATION-ORGANIZATION,ORGANIZATION,PROPN-PROPN,PROPN,compound-appos,oprd,NNP-NNP,NNP,4,1
2536,4616.0,22,renewed,4,14,21,7,13,0,-10,17,she,70,PERSON,NUMBER,PRON,NUM,nsubj,pobj,PRP,CD,3,1
2537,4620.0,27,said,16,15,1,-14,14,25,1,-15,Scorpions,Mokotedi Mpshe,ORGANIZATION,PERSON-PERSON,PROPN,PROPN-PROPN,dobj,compound-nsubj,NNPS,NNP-NNP,2,1
2538,4621.0,47,survived,2,1,7,6,0,39,1,5,Henebry,John Jr,PERSON,PERSON-PERSON,NOUN,PROPN-PROPN,nsubjpass,compound-appos,NN,NNP-NNP,4,1
2539,4637.0,18,graduated,1,1,4,3,0,13,0,3,She,Mount Holyoke College,PERSON,ORGANIZATION-ORGANIZATION-ORGANIZATION,PRON,PROPN-PROPN-PROPN,nsubj,compound-compound-pobj,PRP,NNP-NNP-NNP,3,1
2540,4654.0,62,said,36,38,46,8,37,15,-2,10,Khamenei,military chief,PERSON,TITLE-TITLE,PROPN,ADJ-NOUN,nsubj,conj-appos,NNP,JJ-NN,4,1
2541,4658.0,60,PROJECT,1,14,11,-3,13,48,-13,10,Chris Simcox,Co - founder,PERSON-PERSON,TITLE-TITLE-TITLE,PROPN-PROPN,NOUN-NOUN-NOUN,compound-nsubj,subtok-subtok-compound,NNP-NNP,NN-NN-NN,2,1
2542,4660.0,37,issued,14,28,31,3,27,5,-14,17,Simon Cowell,American Idol,PERSON-PERSON,ORGANIZATION-ORGANIZATION,PROPN-PROPN,PROPN-PROPN,compound-pobj,compound-poss,NNP-NNP,NNP-NNP,2,1
2543,19811.0,33,offered,4,19,16,-3,18,16,-15,12,Simon Cowell,American Idol,PERSON-PERSON,ORGANIZATION-ORGANIZATION,PROPN-PROPN,PROPN-PROPN,compound-appos,compound-compound,NNP-NNP,NNP-NNP,4,1
2544,4661.0,36,said,18,20,29,9,19,6,-2,11,Mahmood Shah,head of security,PERSON-PERSON,TITLE-TITLE-TITLE,PROPN-PROPN,NOUN-ADP-NOUN,compound-nsubj,conj-prep-pobj,NNP-NNP,NN-IN-NN,3,1
2545,4666.0,31,said,29,25,16,-9,24,14,4,-13,Badr Corps,Supreme Council for Islamic Revolution,ORGANIZATION-ORGANIZATION,ORGANIZATION-ORGANIZATION-ORGANIZATION-ORGANIZATION-ORGANIZATION,PROPN-PROPN,PROPN-PROPN-ADP-PROPN-PROPN,compound-conj,compound-pobj-prep-compound-pobj,NNP-NNP,NNP-NNP-IN-NNP-NNP,3,1
2546,4667.0,82,introduced,21,72,6,-66,71,75,-51,-15,he,President,PERSON,TITLE,PRON,PROPN,nsubj,compound,PRP,NNP,12,1
2547,11356.0,51,said,5,8,2,-6,7,48,-3,-3,he,President,PERSON,TITLE,PRON,PROPN,nsubj,compound,PRP,NNP,3,1
2548,16147.0,37,said,24,27,29,2,26,7,-3,5,he,President,PERSON,TITLE,PRON,PROPN,nsubj,compound,PRP,NNP,2,1
2549,4670.0,61,made,29,1,8,7,0,52,28,-21,The Manila Economic and Cultural Office,MECO,ORGANIZATION-ORGANIZATION-ORGANIZATION-ORGANIZATION-ORGANIZATION-ORGANIZATION,ORGANIZATION,DET-PROPN-PROPN-CCONJ-PROPN-PROPN,PROPN,det-nmod-nmod-cc-conj-compound,compound,DT-NNP-NNP-CC-NNP-NNP,NNP,2,1
2550,4672.0,61,said,14,11,1,-10,10,59,3,-13,American Beverage Association,Susan K. Neely,ORGANIZATION-ORGANIZATION-ORGANIZATION,PERSON-PERSON-PERSON,PROPN-PROPN-PROPN,PROPN-PROPN-PROPN,compound-compound-pobj,compound-compound-nsubj,NNP-NNP-NNP,NNP-NNP-NNP,5,1
2551,45381.0,33,said,19,7,11,4,6,21,12,-8,American Beverage Association,Susan K. Neely,ORGANIZATION-ORGANIZATION-ORGANIZATION,PERSON-PERSON-PERSON,PROPN-PROPN-PROPN,PROPN-PROPN-PROPN,compound-compound-pobj,compound-compound-appos,NNP-NNP-NNP,NNP-NNP-NNP,8,1
2552,4677.0,18,born,5,1,8,7,0,9,4,3,Thomas Joseph Meskill,New Britain,PERSON-PERSON-PERSON,CITY-CITY,PROPN-PROPN-PROPN,PROPN-PROPN,compound-compound-compound,compound-pobj,NNP-NNP-NNP,NNP-NNP,4,1
2553,4695.0,56,said,26,1,6,5,0,49,25,-20,Lindsay M. Hayes,specialist,PERSON-PERSON-PERSON,TITLE,PROPN-PROPN-PROPN,NOUN,compound-compound-nsubj,appos,NNP-NNP-NNP,NN,3,1
2554,11362.0,27,said,16,1,7,6,0,19,15,-9,Lindsay M. Hayes,specialist,PERSON-PERSON-PERSON,TITLE,PROPN-PROPN-PROPN,NOUN,compound-compound-nsubj,appos,NNP-NNP-NNP,NN,3,1
2555,14189.0,39,are,3,17,23,6,16,15,-14,20,Lindsay M. Hayes,specialist,PERSON-PERSON-PERSON,TITLE,PROPN-PROPN-PROPN,NOUN,compound-compound-pobj,appos,NNP-NNP-NNP,NN,3,1
2556,27897.0,41,done,2,8,14,6,7,26,-6,12,Lindsay M. Hayes,specialist,PERSON-PERSON-PERSON,TITLE,PROPN-PROPN-PROPN,NOUN,compound-compound-pobj,appos,NNP-NNP-NNP,NN,3,1
2557,32100.0,29,made,19,3,10,7,2,18,16,-9,Lindsay M. Hayes,specialist,PERSON-PERSON-PERSON,TITLE,PROPN-PROPN-PROPN,NOUN,compound-compound-pobj,appos,NNP-NNP-NNP,NN,3,1
2558,37813.0,54,said,19,36,34,-2,35,19,-17,15,Lindsay M. Hayes,specialist,PERSON-PERSON-PERSON,TITLE,PROPN-PROPN-PROPN,NOUN,compound-compound-appos,dobj,NNP-NNP-NNP,NN,2,1
2559,4697.0,11,was,1,8,1,-7,7,9,-7,0,Awami League,Hossain,ORGANIZATION-ORGANIZATION,PERSON,PROPN-PROPN,PROPN,compound-compound,nsubj,NNP-NNP,NNP,5,1
2560,4698.0,20,was,7,4,1,-3,3,18,3,-6,Gaius C. Bolin,Her,PERSON-PERSON-PERSON,PERSON,PROPN-PROPN-PROPN,DET,compound-compound-appos,poss,NNP-NNP-NNP,PRP$,2,1
2561,4707.0,43,is,16,4,2,-2,3,40,12,-14,CNAC,Hong Kong-based,ORGANIZATION,STATE_OR_PROVINCE-STATE_OR_PROVINCE,PROPN,PROPN-PROPN,nsubj,compound-compound,NNP,NNP-NNP,1,1
2562,4730.0,33,faces,5,2,4,2,1,28,3,-1,Alcatel-Lucent,Ben Verwaayen,ORGANIZATION,PERSON-PERSON,ADJ,PROPN-PROPN,amod,compound-nsubj,JJ,NNP-NNP,2,1
2563,9743.0,30,said,2,1,10,9,0,19,1,8,Alcatel-Lucent,Ben Verwaayen,ORGANIZATION,PERSON-PERSON,ADJ,PROPN-PROPN,amod,compound-appos,JJ,NNP-NNP,6,1
2564,14943.0,40,highlighted,11,13,10,-3,12,29,-2,-1,Alcatel-Lucent,Ben Verwaayen,ORGANIZATION,PERSON-PERSON,PROPN,PROPN-PROPN,poss,compound-nsubj,NNP,NNP-NNP,4,1
2565,29573.0,19,said,1,1,11,10,0,7,0,10,Alcatel-Lucent,Ben Verwaayen,ORGANIZATION,PERSON-PERSON,PROPN,PROPN-PROPN,nsubj,compound-dobj,NNP,NNP-NNP,5,1
2566,58395.0,45,said,19,11,21,10,10,23,8,2,Alcatel-Lucent,Ben Verwaayen,ORGANIZATION,PERSON-PERSON,ADJ,PROPN-PROPN,amod,compound-nsubj,JJ,NNP-NNP,5,1
2567,4732.0,33,says,18,31,26,-5,30,6,-13,8,Haifa University,Centre for Kibbutz Studies,ORGANIZATION-ORGANIZATION,ORGANIZATION-ORGANIZATION-ORGANIZATION-ORGANIZATION,PROPN-PROPN,PROPN-ADP-PROPN-PROPN,compound-pobj,pobj-prep-compound-pobj,NNP-NNP,NNP-IN-NNP-NNP,3,1
2568,4733.0,56,said,39,12,18,6,11,37,27,-21,National Center for Disaster Preparedness,NCDP,ORGANIZATION-ORGANIZATION-ORGANIZATION-ORGANIZATION-ORGANIZATION,ORGANIZATION,PROPN-PROPN-ADP-PROPN-PROPN,PROPN,compound-pobj-prep-compound-pobj,ccomp,NNP-NNP-IN-NNP-NNP,NNP,-1,1
2569,5234.0,42,NCDP,36,31,37,6,30,4,5,1,National Center for Disaster Preparedness,NCDP,ORGANIZATION-ORGANIZATION-ORGANIZATION-ORGANIZATION-ORGANIZATION,ORGANIZATION,PROPN-PROPN-ADP-PROPN-PROPN,PROPN,compound-pobj-prep-compound-pobj,ROOT,NNP-NNP-IN-NNP-NNP,NNP,-1,1
2570,28644.0,47,remain,10,36,42,6,35,4,-26,32,National Center for Disaster Preparedness,NCDP,ORGANIZATION-ORGANIZATION-ORGANIZATION-ORGANIZATION-ORGANIZATION,ORGANIZATION,PROPN-PROPN-ADP-PROPN-PROPN,PROPN,compound-pobj-prep-compound-pobj,ROOT,NNP-NNP-IN-NNP-NNP,NNP,-1,1
2571,41475.0,41,said,25,12,18,6,11,22,13,-7,National Center for Disaster Preparedness,NCDP,ORGANIZATION-ORGANIZATION-ORGANIZATION-ORGANIZATION-ORGANIZATION,ORGANIZATION,PROPN-PROPN-ADP-PROPN-PROPN,PROPN,compound-pobj-prep-compound-pobj,ccomp,NNP-NNP-IN-NNP-NNP,NNP,-1,1
2572,4746.0,42,forming,20,1,9,8,0,32,19,-11,Dan Abrams,NBC,PERSON-PERSON,ORGANIZATION,PROPN-PROPN,PROPN,compound-nsubj,compound,NNP-NNP,NNP,3,1
2573,15175.0,36,continue,20,1,23,22,0,12,19,3,Dan Abrams,NBC,PERSON-PERSON,ORGANIZATION,PROPN-PROPN,PROPN,compound-nsubj,poss,NNP-NNP,NNP,4,1
2574,15573.0,43,continue,20,1,23,22,0,19,19,3,Dan Abrams,NBC,PERSON-PERSON,ORGANIZATION,PROPN-PROPN,PROPN,compound-nsubj,poss,NNP-NNP,NNP,4,1
2575,4757.0,58,PLANS,7,54,32,-22,53,25,-47,25,Hu Sheng-cheng,the Council for Economic Planning and Development,PERSON-PERSON,ORGANIZATION-ORGANIZATION-ORGANIZATION-ORGANIZATION-ORGANIZATION-ORGANIZATION-ORGANIZATION,PROPN-PROPN,DET-PROPN-ADP-PROPN-PROPN-CCONJ-PROPN,compound-nsubj,det-appos-prep-compound-pobj-cc-conj,NNP-NNP,DT-NNP-IN-NNP-NNP-CC-NNP,8,1
2576,4767.0,25,announced,21,8,1,-7,7,23,13,-20,Blackburn Rovers,Steve Kean,ORGANIZATION-ORGANIZATION,PERSON-PERSON,PROPN-PROPN,PROPN-PROPN,compound-pobj,compound-nsubj,NNP-NNPS,NNP-NNP,5,1
2577,4770.0,30,reports,2,12,5,-7,11,24,-10,3,John Kerry,Cameron Kerry,PERSON-PERSON,PERSON-PERSON,PROPN-PROPN,PROPN-PROPN,compound-pobj,compound-nsubj,NNP-NNP,NNP-NNP,3,1
2578,4775.0,56,said,14,10,1,-9,9,54,4,-13,National Military Family Association,Joyce Wessel Raezer,ORGANIZATION-ORGANIZATION-ORGANIZATION-ORGANIZATION,PERSON-PERSON-PERSON,PROPN-PROPN-PROPN-PROPN,PROPN-PROPN-PROPN,compound-compound-compound-pobj,compound-compound-nsubj,NNP-NNP-NNP-NNP,NNP-NNP-NNP,6,1
2579,4776.0,16,was,3,9,14,5,8,1,-6,11,Moro National Liberation Front,Habier Malik,ORGANIZATION-ORGANIZATION-ORGANIZATION-ORGANIZATION,PERSON-PERSON,PROPN-PROPN-PROPN-PROPN,PROPN-PROPN,compound-compound-compound-compound,compound-pobj,NNP-NNP-NNP-NNP,NNP-NNP,3,1
2580,26085.0,52,became,27,32,37,5,31,14,-5,10,Moro National Liberation Front,Habier Malik,ORGANIZATION-ORGANIZATION-ORGANIZATION-ORGANIZATION,PERSON-PERSON,PROPN-PROPN-PROPN-PROPN,PROPN-PROPN,compound-compound-compound-compound,compound-nsubj,NNP-NNP-NNP-NNP,NNP-NNP,3,1
2581,30109.0,48,said,2,22,29,7,21,18,-20,27,Moro National Liberation Front,Habier Malik,ORGANIZATION-ORGANIZATION-ORGANIZATION-ORGANIZATION,PERSON-PERSON,PROPN-PROPN-PROPN-PROPN,PROPN-PROPN,compound-compound-compound-compound,compound-pobj,NNP-NNP-NNP-NNP,NNP-NNP,5,1
2582,35202.0,43,held,23,29,38,9,28,4,-6,15,Moro National Liberation Front,Habier Malik,ORGANIZATION-ORGANIZATION-ORGANIZATION-ORGANIZATION,PERSON-PERSON,PROPN-PROPN-PROPN-PROPN,PROPN-PROPN,compound-compound-compound-pobj,compound-pobj,NNP-NNP-NNP-NNP,NNP-NNP,-1,1
2583,4778.0,24,played,1,1,7,6,0,16,0,6,He,Football League,PERSON,ORGANIZATION-ORGANIZATION,PRON,PROPN-PROPN,nsubj,compound-pobj,PRP,NNP-NNP,2,1
2584,4780.0,76,is,5,58,61,3,57,14,-53,56,Richard Perle,chairman,PERSON-PERSON,TITLE,PROPN-PROPN,NOUN,compound-attr,appos,NNP-NNP,NN,2,1
2585,40241.0,24,2008-03-31T11,0,3,16,13,2,7,-3,16,Richard Perle,chairman,PERSON-PERSON,TITLE,PROPN-PROPN,NOUN,compound-ROOT,attr,NNP-NNP,NN,4,1
2586,54509.0,22,is,11,1,14,13,0,7,10,3,Richard Perle,chairman,PERSON-PERSON,TITLE,PROPN-PROPN,NOUN,compound-dep,attr,NNP-NNP,NN,3,1
2587,4785.0,18,was,1,1,7,6,0,10,0,6,He,Jewish,PERSON,RELIGION,PRON,ADJ,nsubj,amod,PRP,JJ,4,1
2588,22481.0,41,fought,1,1,25,24,0,15,0,24,He,Jewish,PERSON,RELIGION,PRON,ADJ,nsubj,amod,PRP,JJ,5,1
2589,52555.0,19,was,1,1,17,16,0,1,0,16,He,Jewish,PERSON,RELIGION,PRON,ADJ,nsubj,amod,PRP,JJ,7,1
2590,4792.0,54,reported,16,11,15,4,10,38,5,-1,American Automobile Association,AAA,ORGANIZATION-ORGANIZATION-ORGANIZATION,ORGANIZATION,PROPN-PROPN-PROPN,PROPN,compound-compound-nsubj,compound,NNP-NNP-NNP,NNP,2,1
2591,21633.0,44,travel,7,38,42,4,37,1,-31,35,American Automobile Association,AAA,ORGANIZATION-ORGANIZATION-ORGANIZATION,ORGANIZATION,PROPN-PROPN-PROPN,PROPN,compound-compound-pobj,compound,NNP-NNP-NNP,NNP,4,1
2592,39243.0,51,WASHINGTON,0,9,13,4,8,37,-9,13,American Automobile Association,AAA,ORGANIZATION-ORGANIZATION-ORGANIZATION,ORGANIZATION,PROPN-PROPN-PROPN,PROPN,compound-compound-nsubj,compound,NNP-NNP-NNP,NNP,2,1
2593,40519.0,44,travel,7,38,42,4,37,1,-31,35,American Automobile Association,AAA,ORGANIZATION-ORGANIZATION-ORGANIZATION,ORGANIZATION,PROPN-PROPN-PROPN,PROPN,compound-compound-pobj,compound,NNP-NNP-NNP,NNP,4,1
2594,64349.0,36,was,9,23,27,4,22,8,-14,18,American Automobile Association,AAA,ORGANIZATION-ORGANIZATION-ORGANIZATION,ORGANIZATION,PROPN-PROPN-PROPN,PROPN,compound-compound-compound,compound,NNP-NNP-NNP,NNP,2,1
2595,65738.0,40,said,7,2,6,4,1,33,5,-1,American Automobile Association,AAA,ORGANIZATION-ORGANIZATION-ORGANIZATION,ORGANIZATION,PROPN-PROPN-PROPN,PROPN,compound-compound-nsubj,compound,NNP-NNP-NNP,NNP,3,1
2596,4795.0,35,was,1,1,12,11,0,22,0,11,She,National Society of Colonial Dames,PERSON,ORGANIZATION-ORGANIZATION-ORGANIZATION-ORGANIZATION-ORGANIZATION,PRON,PROPN-PROPN-ADP-PROPN-PROPN,nsubj,compound-pobj-prep-compound-pobj,PRP,NNP-NNP-IN-NNP-NNP,4,1
2597,4799.0,13,was,1,1,7,6,0,5,0,6,Verity,US Navy,PERSON,ORGANIZATION-ORGANIZATION,PROPN,PROPN-PROPN,nsubj,compound-pobj,NNP,NNP-NNP,3,1
2598,4808.0,24,born,4,1,9,8,0,14,3,5,Catherine Gertrude Roraback,"Sept. 17 , 1920",PERSON-PERSON-PERSON,DATE-DATE-DATE-DATE,PROPN-PROPN-PROPN,PROPN-NUM-PUNCT-NUM,compound-compound-nsubjpass,pobj-nummod-punct-nummod,NNP-NNP-NNP,"NNP-CD-,-CD",5,1
2599,4810.0,25,started,11,9,4,-5,8,20,2,-7,Robert Goodman,Goodman,PERSON-PERSON,PERSON,PROPN-PROPN,PROPN,compound-appos,nsubj,NNP-NNP,NNP,3,1
2600,30020.0,26,started,12,10,5,-5,9,20,2,-7,Robert Goodman,Goodman,PERSON-PERSON,PERSON,PROPN-PROPN,PROPN,compound-appos,nsubj,NNP-NNP,NNP,3,1
2601,46826.0,30,died,2,1,2,1,0,27,1,0,Robert Goodman,Goodman,PERSON-PERSON,PERSON,PROPN-PROPN,PROPN,compound-nsubj,poss,NNP-NNP,NNP,1,1
2602,4822.0,7,Spears,1,5,1,-4,4,5,-4,0,Jamie Lynn,Britney Spears,PERSON-PERSON,PERSON-PERSON,PROPN-PROPN,PROPN-PROPN,compound-compound,compound-ROOT,NNP-NNP,NNP-NNPS,2,1
2603,4827.0,32,hit,3,26,24,-2,25,7,-23,21,Tianjin Lions,China,ORGANIZATION-ORGANIZATION,COUNTRY,PROPN-PROPN,PROPN,compound-pobj,poss,NNP-NNPS,NNP,3,1
2604,27473.0,38,hit,2,28,26,-2,27,11,-26,24,Tianjin Lions,China,ORGANIZATION-ORGANIZATION,COUNTRY,PROPN-PROPN,PROPN,compound-pobj,poss,NNP-NNPS,NNP,1,1
2605,4829.0,61,said,20,58,3,-55,57,57,-38,-17,National Action Network,Al Sharpton,ORGANIZATION-ORGANIZATION-ORGANIZATION,PERSON-PERSON,PROPN-PROPN-PROPN,PROPN-PROPN,compound-compound-pobj,compound-nsubj,NNP-NNP-NNP,NNP-NNP,9,1
2606,23586.0,33,were,25,23,19,-4,22,13,2,-6,National Action Network,Al Sharpton,ORGANIZATION-ORGANIZATION-ORGANIZATION,PERSON-PERSON,PROPN-PROPN-PROPN,PROPN-PROPN,compound-compound-conj,compound-nsubj,NNP-NNP-NNP,NNP-NNP,2,1
2607,24308.0,32,is,7,29,26,-3,28,5,-22,19,National Action Network,Al Sharpton,ORGANIZATION-ORGANIZATION-ORGANIZATION,PERSON-PERSON,PROPN-PROPN-PROPN,PROPN-PROPN,compound-compound-appos,compound-poss,NNP-NNP-NNP,NNP-NNP,2,1
2608,24801.0,18,Stop,0,8,5,-3,7,12,-8,5,National Action Network,Al Sharpton,ORGANIZATION-ORGANIZATION-ORGANIZATION,PERSON-PERSON,PROPN-PROPN-PROPN,PROPN-PROPN,compound-compound-conj,compound-poss,NNP-NNP-NNP,NNP-NNP,2,1
2609,27505.0,43,headed,3,14,8,-6,13,34,-11,5,National Action Network,Al Sharpton,ORGANIZATION-ORGANIZATION-ORGANIZATION,PERSON-PERSON,PROPN-PROPN-PROPN,PROPN-PROPN,compound-compound-pobj,compound-pobj,NNP-NNP-NNP,NNP-NNP,4,1
2610,32805.0,31,said,13,28,22,-6,27,8,-15,9,National Action Network,Al Sharpton,ORGANIZATION-ORGANIZATION-ORGANIZATION,PERSON-PERSON,PROPN-PROPN-PROPN,PROPN-PROPN,compound-compound-appos,compound-poss,NNP-NNP-NNP,NNP-NNP,4,1
2611,33849.0,22,spoke,1,9,20,11,8,1,-8,19,National Action Network,Al Sharpton,ORGANIZATION-ORGANIZATION-ORGANIZATION,PERSON-PERSON,PROPN-PROPN-PROPN,PROPN-PROPN,compound-compound-pobj,compound-pobj,NNP-NNP-NNP,NNP-NNP,7,1
2612,38745.0,26,said,23,19,10,-9,18,15,4,-13,National Action Network,Al Sharpton,ORGANIZATION-ORGANIZATION-ORGANIZATION,PERSON-PERSON,PROPN-PROPN-PROPN,PROPN-PROPN,compound-compound-pobj,compound-nsubj,NNP-NNP-NNP,NNP-NNP,6,1
2613,48465.0,36,Sharpton,1,7,1,-6,6,34,-6,0,National Action Network,Al Sharpton,ORGANIZATION-ORGANIZATION-ORGANIZATION,PERSON-PERSON,PROPN-PROPN-PROPN,PROPN-PROPN,compound-compound-pobj,compound-ROOT,NNP-NNP-NNP,NNP-NNP,4,1
2614,49714.0,62,said,20,59,3,-56,58,58,-39,-17,National Action Network,Al Sharpton,ORGANIZATION-ORGANIZATION-ORGANIZATION,PERSON-PERSON,PROPN-PROPN-PROPN,PROPN-PROPN,compound-compound-pobj,compound-nsubj,NNP-NNP-NNP,NNP-NNP,9,1
2615,57595.0,33,WASHINGTON,0,12,9,-3,11,23,-12,9,National Action Network,Al Sharpton,ORGANIZATION-ORGANIZATION-ORGANIZATION,PERSON-PERSON,PROPN-PROPN-PROPN,PROPN-PROPN,compound-compound-pobj,compound-poss,NNP-NNP-NNP,NNP-NNP,2,1
2616,59578.0,21,expected,9,6,3,-3,5,17,3,-6,National Action Network,Al Sharpton,ORGANIZATION-ORGANIZATION-ORGANIZATION,PERSON-PERSON,PROPN-PROPN-PROPN,PROPN-PROPN,compound-compound-nsubjpass,compound-poss,NNP-NNP-NNP,NNP-NNP,2,1
2617,61698.0,64,_,1,57,20,-37,56,43,-56,19,National Action Network,Al Sharpton,ORGANIZATION-ORGANIZATION-ORGANIZATION,PERSON-PERSON,PROPN-PROPN-PROPN,PROPN-PROPN,compound-compound-compound,compound-nsubj,NNP-NNP-NNP,NNP-NNP,5,1
2618,67085.0,40,said,21,31,25,-6,30,14,-10,4,National Action Network,Al Sharpton,ORGANIZATION-ORGANIZATION-ORGANIZATION,PERSON-PERSON,PROPN-PROPN-PROPN,PROPN-PROPN,compound-compound-pobj,compound-nsubj,NNP-NNP-NNP,NNP-NNP,4,1
2619,4837.0,28,assumed,6,13,17,4,12,10,-7,11,Central American Parliament,Parlacen,ORGANIZATION-ORGANIZATION-ORGANIZATION,ORGANIZATION,ADJ-ADJ-PROPN,PROPN,compound-compound-pobj,compound,JJ-JJ-NNP,NNP,5,1
2620,5966.0,22,signed,6,16,20,4,15,1,-10,14,Central American Parliament,Parlacen,ORGANIZATION-ORGANIZATION-ORGANIZATION,ORGANIZATION,ADJ-ADJ-PROPN,PROPN,compound-compound-pobj,compound,JJ-JJ-NNP,NNP,6,1
2621,13591.0,50,plan,3,1,29,28,0,20,2,26,Central American Parliament,Parlacen,ORGANIZATION-ORGANIZATION-ORGANIZATION,ORGANIZATION,ADJ-ADJ-PROPN,PROPN,compound-compound-pobj,compound,JJ-JJ-NNP,NNP,4,1
2622,55227.0,25,urged,8,2,6,4,1,18,6,-2,Central American Parliament,Parlacen,ORGANIZATION-ORGANIZATION-ORGANIZATION,ORGANIZATION,ADJ-ADJ-PROPN,PROPN,amod-compound-nsubj,compound,JJ-JJ-NNP,NNP,-1,1
2623,4841.0,55,focuses,2,24,46,22,23,8,-22,44,the Starr Foundation,Maurice R Greenberg,ORGANIZATION-ORGANIZATION-ORGANIZATION,PERSON-PERSON-PERSON,DET-PROPN-PROPN,PROPN-PROPN-PROPN,det-compound-pobj,compound-compound-pobj,DT-NNP-NNP,NNP-NNP-NNP,7,1
2624,4844.0,18,Labels,0,3,6,3,2,11,-3,6,Brandon McInerney,California,PERSON-PERSON,STATE_OR_PROVINCE,PROPN-PROPN,PROPN,compound-nsubj,appos,NNP-NNP,NNP,2,1
2625,9679.0,36,arrested,18,4,8,4,3,27,14,-10,Brandon McInerney,California,PERSON-PERSON,STATE_OR_PROVINCE,PROPN-PROPN,PROPN,compound-pobj,compound,NNP-NNP,NNP,1,1
2626,36468.0,15,Labels,0,3,6,3,2,8,-3,6,Brandon McInerney,California,PERSON-PERSON,STATE_OR_PROVINCE,PROPN-PROPN,PROPN,compound-ROOT,appos,NNP-NNP,NNP,2,1
2627,42992.0,37,pleaded,26,3,35,32,2,1,23,9,Brandon McInerney,California,PERSON-PERSON,STATE_OR_PROVINCE,PROPN-PROPN,PROPN,compound-nsubj,compound,NNP-NNP,NNP,6,1
2628,4863.0,25,2007-11-18T01,0,3,6,3,2,18,-3,6,Natives,Boston,PERSON,CITY,NOUN,PROPN,nsubj,compound,NNS,NNP,4,1
2629,4874.0,38,faces,14,32,26,-6,31,11,-18,12,United National Congress,Kamla Persad-Bissessar,ORGANIZATION-ORGANIZATION-ORGANIZATION,PERSON-PERSON,PROPN-PROPN-PROPN,PROPN-PROPN,compound-compound-appos,compound-pobj,NNP-NNP-NNP,NNP-NNP,4,1
2630,4885.0,29,said,4,3,1,-2,2,27,1,-3,Simon Cowell,British,PERSON-PERSON,NATIONALITY,PROPN-PROPN,ADJ,compound-nsubj,amod,NNP-NNP,JJ,1,1
2631,38419.0,29,declared,4,3,1,-2,2,27,1,-3,Simon Cowell,British,PERSON-PERSON,NATIONALITY,PROPN-PROPN,ADJ,compound-nsubj,amod,NNP-NNP,JJ,1,1
2632,40950.0,27,------,0,20,18,-2,19,8,-20,18,Simon Cowell,British,PERSON-PERSON,NATIONALITY,PROPN-PROPN,ADJ,compound-appos,amod,NNP-NNP,JJ,1,1
2633,45826.0,38,renewed,8,22,26,4,21,11,-14,18,Simon Cowell,British,PERSON-PERSON,NATIONALITY,PROPN-PROPN,ADJ,compound-dobj,amod,NNP-NNP,JJ,1,1
2634,4887.0,29,said,27,26,25,-1,25,3,1,-2,Manuel Barcena,Superintendent,PERSON-PERSON,TITLE,PROPN-PROPN,PROPN,compound-nsubj,compound,NNP-NNP,NNP,1,1
2635,12775.0,4,Barcena,2,2,1,-1,1,2,0,-1,Manuel Barcena,Superintendent,PERSON-PERSON,TITLE,PROPN-PROPN,PROPN,compound-ROOT,compound,NNP-NNP,NNP,1,1
2636,18055.0,33,said,13,3,2,-1,2,30,10,-11,Manuel Barcena,Superintendent,PERSON-PERSON,TITLE,PROPN-PROPN,PROPN,compound-nsubj,compound,NNP-NNP,NNP,1,1
2637,21328.0,31,said,7,6,5,-1,5,25,1,-2,Manuel Barcena,Superintendent,PERSON-PERSON,TITLE,PROPN-PROPN,PROPN,compound-nsubj,compound,NNP-NNP,NNP,1,1
2638,24894.0,35,said,5,4,3,-1,3,31,1,-2,Manuel Barcena,Superintendent,PERSON-PERSON,TITLE,PROPN-PROPN,PROPN,compound-nsubj,compound,NNP-NNP,NNP,1,1
2639,39725.0,25,said,15,23,22,-1,22,2,-8,7,Manuel Barcena,Superintendent,PERSON-PERSON,TITLE,PROPN-PROPN,PROPN,compound-appos,compound,NNP-NNP,NNP,2,1
2640,41931.0,36,declined,10,3,2,-1,2,33,7,-8,Manuel Barcena,Superintendent,PERSON-PERSON,TITLE,PROPN-PROPN,PROPN,compound-nsubj,compound,NNP-NNP,NNP,1,1
2641,4896.0,81,MANILA,0,11,77,66,10,3,-11,77,ADB,Regional Sustainable Development Department,ORGANIZATION,ORGANIZATION-ORGANIZATION-ORGANIZATION-ORGANIZATION,PROPN,PROPN-PROPN-PROPN-PROPN,compound,compound-compound-compound-pobj,NNP,NNP-NNP-NNP-NNP,8,1
2642,4899.0,45,Library,2,8,13,5,7,31,-6,11,Chelsea District Library,Michigan,ORGANIZATION-ORGANIZATION-ORGANIZATION,STATE_OR_PROVINCE,PROPN-PROPN-PROPN,PROPN,compound-compound-compound,compound,NNP-NNP-NNP,NNP,2,1
2643,4900.0,39,named,3,1,6,5,0,32,2,3,David Gregory,host,PERSON-PERSON,TITLE,PROPN-PROPN,NOUN,compound-nsubjpass,pobj,NNP-NNP,NN,4,1
2644,8047.0,31,told,14,22,21,-1,21,9,-8,7,David Gregory,host,PERSON-PERSON,TITLE,PROPN-PROPN,NOUN,compound-dobj,compound,NNP-NNP,NN,1,1
2645,20919.0,42,said,13,26,25,-1,25,16,-13,12,David Gregory,host,PERSON-PERSON,TITLE,PROPN-PROPN,NOUN,compound-nsubj,compound,NNP-NNP,NN,2,1
2646,26815.0,48,responded,18,25,24,-1,24,23,-7,6,David Gregory,host,PERSON-PERSON,TITLE,PROPN-PROPN,NOUN,compound-pobj,compound,NNP-NNP,NN,1,1
2647,36605.0,41,said,7,15,13,-2,14,27,-8,6,David Gregory,host,PERSON-PERSON,TITLE,PROPN-PROPN,NOUN,compound-appos,nsubj,NNP-NNP,NN,2,1
2648,37583.0,19,said,1,6,10,4,5,8,-5,9,David Gregory,host,PERSON-PERSON,TITLE,PROPN-PROPN,NOUN,compound-pobj,appos,NNP-NNP,NN,2,1
2649,52779.0,43,is,1,3,10,7,2,32,-2,9,David Gregory,host,PERSON-PERSON,TITLE,PROPN-PROPN,NOUN,compound-poss,nsubj,NNP-NNP,NN,4,1
2650,61446.0,39,takes,2,29,32,3,28,6,-27,30,David Gregory,host,PERSON-PERSON,TITLE,PROPN-PROPN,NOUN,compound-dobj,pobj,NNP-NNP,NN,4,1
2651,67748.0,34,announced,32,1,9,8,0,24,31,-23,David Gregory,host,PERSON-PERSON,TITLE,PROPN-PROPN,NOUN,compound-nsubjpass,nsubj,NNP-NNP,NN,5,1
2652,4904.0,22,recruited,6,3,20,17,2,1,3,14,Britney Spears,Jive Records,PERSON-PERSON,ORGANIZATION-ORGANIZATION,PROPN-PROPN,PROPN-PROPN,compound-nsubj,compound-pobj,NNP-NNPS,NNP-NNPS,4,1
2653,4905.0,38,died,28,1,36,35,0,1,27,8,Bradford Washburn,Lexington,PERSON-PERSON,CITY,PROPN-PROPN,PROPN,compound-nsubj,pobj,NNP-NNP,NNP,6,1
2654,4912.0,38,guided,3,3,5,2,2,32,0,2,he,AZ Alkmaar,PERSON,ORGANIZATION-ORGANIZATION,PRON,PROPN-PROPN,nsubj,compound-dobj,PRP,NNP-NNP,1,1
2655,4914.0,26,said,17,11,14,3,10,11,6,-3,her,Carson,PERSON,CITY,DET,PROPN,poss,pobj,PRP$,NNP,2,1
2656,62773.0,25,said,16,10,13,3,9,11,6,-3,her,Carson,PERSON,CITY,DET,PROPN,poss,pobj,PRP$,NNP,2,1
2657,4933.0,48,order,11,39,43,4,38,4,-28,32,International Crisis Group,ICG,ORGANIZATION-ORGANIZATION-ORGANIZATION,ORGANIZATION,PROPN-PROPN-PROPN,PROPN,compound-compound-pobj,compound,NNP-NNP-NNP,NNP,-1,1
2658,12092.0,35,warned,15,10,14,4,9,20,5,-1,International Crisis Group,ICG,ORGANIZATION-ORGANIZATION-ORGANIZATION,ORGANIZATION,PROPN-PROPN-PROPN,PROPN,compound-compound-nsubj,compound,NNP-NNP-NNP,NNP,4,1
2659,16973.0,38,studied,2,32,36,4,31,1,-30,34,International Crisis Group,ICG,ORGANIZATION-ORGANIZATION-ORGANIZATION,ORGANIZATION,PROPN-PROPN-PROPN,PROPN,compound-compound-pobj,compound,NNP-NNP-NNP,NNP,4,1
2660,17900.0,37,said,35,27,31,4,26,5,8,-4,International Crisis Group,ICG,ORGANIZATION-ORGANIZATION-ORGANIZATION,ORGANIZATION,PROPN-PROPN-PROPN,PROPN,compound-compound-npadvmod,compound,NNP-NNP-NNP,NNP,7,1
2661,35556.0,28,herald,14,20,24,4,19,3,-6,10,International Crisis Group,ICG,ORGANIZATION-ORGANIZATION-ORGANIZATION,ORGANIZATION,PROPN-PROPN-PROPN,PROPN,compound-compound-appos,compound,NNP-NNP-NNP,NNP,4,1
2662,39925.0,37,said,35,30,34,4,29,2,5,-1,International Crisis Group,ICG,ORGANIZATION-ORGANIZATION-ORGANIZATION,ORGANIZATION,PROPN-PROPN-PROPN,PROPN,compound-compound-pobj,compound,NNP-NNP-NNP,NNP,-1,1
2663,40440.0,32,is,2,24,28,4,23,3,-22,26,International Crisis Group,ICG,ORGANIZATION-ORGANIZATION-ORGANIZATION,ORGANIZATION,PROPN-PROPN-PROPN,PROPN,compound-compound-pobj,compound,NNP-NNP-NNP,NNP,-1,1
2664,45692.0,44,is,1,36,40,4,35,3,-35,39,International Crisis Group,ICG,ORGANIZATION-ORGANIZATION-ORGANIZATION,ORGANIZATION,PROPN-PROPN-PROPN,PROPN,compound-compound-pobj,compound,NNP-NNP-NNP,NNP,4,1
2665,48351.0,37,Group,3,2,6,4,1,30,1,3,International Crisis Group,ICG,ORGANIZATION-ORGANIZATION-ORGANIZATION,ORGANIZATION,PROPN-PROPN-PROPN,PROPN,compound-compound-ROOT,compound,NNP-NNP-NNP,NNP,-1,1
2666,52329.0,39,appeared,8,17,21,4,16,17,-9,13,International Crisis Group,ICG,ORGANIZATION-ORGANIZATION-ORGANIZATION,ORGANIZATION,PROPN-PROPN-PROPN,PROPN,compound-compound-pobj,compound,NNP-NNP-NNP,NNP,-1,1
2667,53549.0,86,links,1,23,27,4,22,58,-22,26,International Crisis Group,ICG,ORGANIZATION-ORGANIZATION-ORGANIZATION,ORGANIZATION,PROPN-PROPN-PROPN,PROPN,compound-compound-appos,compound,NNP-NNP-NNP,NNP,-1,1
2668,53949.0,30,Group,4,3,7,4,2,22,1,3,International Crisis Group,ICG,ORGANIZATION-ORGANIZATION-ORGANIZATION,ORGANIZATION,PROPN-PROPN-PROPN,PROPN,compound-compound-ROOT,compound,NNP-NNP-NNP,NNP,2,1
2669,65689.0,31,said,14,9,13,4,8,17,5,-1,International Crisis Group,ICG,ORGANIZATION-ORGANIZATION-ORGANIZATION,ORGANIZATION,PROPN-PROPN-PROPN,PROPN,compound-compound-pobj,compound,NNP-NNP-NNP,NNP,-1,1
2670,4935.0,47,survived,2,1,17,16,0,29,1,15,Henebry,Walter,PERSON,PERSON,NOUN,PROPN,nsubjpass,conj,NN,NNP,8,1
2671,4939.0,66,comes,2,47,56,9,46,9,-45,54,Donald Wildmon,chairman,PERSON-PERSON,TITLE,PROPN-PROPN,NOUN,compound-pobj,conj,NNP-NNP,NN,2,1
2672,56314.0,26,said,8,17,13,-4,16,12,-9,5,Donald Wildmon,chairman,PERSON-PERSON,TITLE,PROPN-PROPN,NOUN,compound-appos,nsubj,NNP-NNP,NN,2,1
2673,64022.0,66,comes,2,47,56,9,46,9,-45,54,Donald Wildmon,chairman,PERSON-PERSON,TITLE,PROPN-PROPN,NOUN,compound-pobj,conj,NNP-NNP,NN,2,1
2674,4944.0,40,Credit,0,20,37,17,19,2,-20,37,Olivia Palermo,modeling,PERSON-PERSON,TITLE,PROPN-PROPN,NOUN,compound-pobj,compound,NNP-NNP,NN,11,1
2675,4947.0,28,said,12,4,1,-3,3,26,8,-11,MNLF,Almujahid Biao,ORGANIZATION,PERSON-PERSON,PROPN,PROPN-PROPN,compound,compound-nsubj,NNP,NNP-NNP,1,1
2676,4961.0,31,drawn,3,1,21,20,0,9,2,18,Abu Zubaydah,Islamic,PERSON-PERSON,RELIGION,PROPN-PROPN,ADJ,compound-nsubjpass,amod,NNP-NNP,JJ,6,1
2677,4965.0,19,said,1,1,17,16,0,1,0,16,Alcatel-Lucent,Patricia Russo,ORGANIZATION,PERSON-PERSON,PROPN,PROPN-PROPN,nsubj,compound-dobj,NNP,NNP-NNP,6,1
2678,5051.0,26,said,8,1,24,23,0,1,7,16,Alcatel-Lucent,Patricia Russo,ORGANIZATION,PERSON-PERSON,ADJ,PROPN-PROPN,amod,compound-dobj,JJ,NNP-NNP,5,1
2679,16542.0,35,said,7,1,4,3,0,30,6,-3,Alcatel-Lucent,Patricia Russo,ORGANIZATION,PERSON-PERSON,ADJ,PROPN-PROPN,amod,compound-nsubj,JJ,NNP-NNP,2,1
2680,41551.0,36,said,17,12,15,3,11,20,5,-2,Alcatel-Lucent,Patricia Russo,ORGANIZATION,PERSON-PERSON,ADJ,PROPN-PROPN,amod,compound-pobj,JJ,NNP-NNP,2,1
2681,4967.0,24,liked,1,1,6,5,0,17,0,5,Kollek,Teddy,PERSON,PERSON,PROPN,PROPN,nsubj,oprd,NNP,NNP,2,1
2682,4985.0,52,died,37,1,51,50,0,0,36,14,Pamela Gardner Ahearn,Va.,PERSON-PERSON-PERSON,STATE_OR_PROVINCE,PROPN-PROPN-PROPN,PROPN,compound-compound-nsubj,appos,NNP-NNP-NNP,NNP,2,1
2683,4986.0,42,said,35,1,12,11,0,29,34,-23,Aerolineas Argentinas,the Argentine,ORGANIZATION-ORGANIZATION,COUNTRY-COUNTRY,PROPN-PROPN,DET-ADJ,compound-nmod,det-amod,NNP-NNP,DT-JJ,2,1
2684,4993.0,32,gave,4,17,2,-15,16,29,-13,-2,American Basketball Association,Bobcats,ORGANIZATION-ORGANIZATION-ORGANIZATION,ORGANIZATION,PROPN-PROPN-PROPN,PROPN,compound-compound-conj,poss,NNP-NNP-NNP,NNPS,6,1
2685,4994.0,9,meets,4,4,2,-2,3,6,0,-2,Negroponte,US,PERSON,COUNTRY,PROPN,PROPN,nsubj,compound,NNP,NNP,2,1
2686,5086.0,35,served,6,6,10,4,5,24,0,4,Negroponte,US,PERSON,COUNTRY,PROPN,PROPN,nsubj,compound,NNP,NNP,2,1
2687,48566.0,19,visits,4,4,2,-2,3,16,0,-2,Negroponte,US,PERSON,COUNTRY,PROPN,PROPN,nsubj,compound,NNP,NNP,2,1
2688,4997.0,24,condemned,11,10,3,-7,9,20,1,-8,organization,Abdoulaye Wade,ORGANIZATION,PERSON-PERSON,NOUN,PROPN-PROPN,dobj,compound-nsubj,NN,NNP-NNP,2,1
2689,4998.0,30,reported,28,13,18,5,12,11,15,-10,Awami National Party,ANP,ORGANIZATION-ORGANIZATION-ORGANIZATION,ORGANIZATION,PROPN-PROPN-PROPN,PROPN,compound-compound-poss,compound,NNP-NNP-NNP,NNP,3,1
2690,11745.0,59,emphasized,7,35,39,4,34,19,-28,32,Awami National Party,ANP,ORGANIZATION-ORGANIZATION-ORGANIZATION,ORGANIZATION,PROPN-PROPN-PROPN,PROPN,compound-compound-conj,compound,NNP-NNP-NNP,NNP,4,1
2691,11869.0,37,believe,2,24,28,4,23,8,-22,26,Awami National Party,ANP,ORGANIZATION-ORGANIZATION-ORGANIZATION,ORGANIZATION,PROPN-PROPN-PROPN,PROPN,compound-compound-pobj,compound,NNP-NNP-NNP,NNP,10,1
2692,29184.0,35,happened,2,9,13,4,8,21,-7,11,Awami National Party,ANP,ORGANIZATION-ORGANIZATION-ORGANIZATION,ORGANIZATION,PROPN-PROPN-PROPN,PROPN,compound-compound-pobj,compound,NNP-NNP-NNP,NNP,2,1
2693,33507.0,43,decided,3,32,36,4,31,6,-29,33,Awami National Party,ANP,ORGANIZATION-ORGANIZATION-ORGANIZATION,ORGANIZATION,PROPN-PROPN-PROPN,PROPN,compound-compound-conj,compound,NNP-NNP-NNP,NNP,4,1
2694,38138.0,28,hit,2,8,12,4,7,15,-6,10,Awami National Party,ANP,ORGANIZATION-ORGANIZATION-ORGANIZATION,ORGANIZATION,PROPN-PROPN-PROPN,PROPN,compound-compound-pobj,compound,NNP-NNP-NNP,NNP,7,1
2695,40879.0,26,linked,3,13,17,4,12,8,-10,14,Awami National Party,ANP,ORGANIZATION-ORGANIZATION-ORGANIZATION,ORGANIZATION,PROPN-PROPN-PROPN,PROPN,compound-compound-pobj,compound,NNP-NNP-NNP,NNP,2,1
2696,46941.0,38,happened,2,24,28,4,23,9,-22,26,Awami National Party,ANP,ORGANIZATION-ORGANIZATION-ORGANIZATION,ORGANIZATION,PROPN-PROPN-PROPN,PROPN,compound-compound-pobj,compound,NNP-NNP-NNP,NNP,2,1
2697,50609.0,39,barged,7,14,18,4,13,20,-7,11,Awami National Party,ANP,ORGANIZATION-ORGANIZATION-ORGANIZATION,ORGANIZATION,PROPN-PROPN-PROPN,PROPN,compound-compound-pobj,compound,NNP-NNP-NNP,NNP,2,1
2698,5008.0,30,believes,14,12,2,-10,11,27,2,-12,University of Haifa,Gabriel Ben-Dor,ORGANIZATION-ORGANIZATION-ORGANIZATION,PERSON-PERSON,PROPN-ADP-PROPN,PROPN-PROPN,pobj-prep-pobj,compound-nsubj,NNP-IN-NNP,NNP-NNP,4,1
2699,5010.0,51,WASHINGTON,0,15,11,-4,14,39,-15,11,Millender-McDonald,Congress,PERSON,ORGANIZATION,PROPN,PROPN,pobj,pobj,NNP,NNP,3,1
2700,5737.0,14,is,1,1,7,6,0,6,0,6,Millender-McDonald,Congress,PERSON,ORGANIZATION,PROPN,PROPN,nsubj,pobj,NNP,NNP,4,1
2701,5016.0,42,approved,12,18,21,3,17,20,-6,9,Chen Zhu,54,PERSON-PERSON,NUMBER,PROPN-PROPN,NUM,compound-pobj,appos,NNP-NNP,CD,1,1
2702,13226.0,54,reported,52,12,15,3,11,38,40,-37,Chen Zhu,54,PERSON-PERSON,NUMBER,PROPN-PROPN,NUM,compound-pobj,appos,NNP-NNP,CD,2,1
2703,15782.0,34,approved,7,13,16,3,12,17,-6,9,Chen Zhu,54,PERSON-PERSON,NUMBER,PROPN-PROPN,NUM,compound-pobj,appos,NNP-NNP,CD,1,1
2704,19762.0,31,said,25,4,8,4,3,22,21,-17,Chen Zhu,54,PERSON-PERSON,NUMBER,PROPN-PROPN,NUM,compound-nsubj,npadvmod,NNP-NNP,CD,3,1
2705,27329.0,30,said,24,4,8,4,3,21,20,-16,Chen Zhu,54,PERSON-PERSON,NUMBER,PROPN-PROPN,NUM,compound-nsubjpass,npadvmod,NNP-NNP,CD,2,1
2706,46529.0,43,reported,41,1,4,3,0,38,40,-37,Chen Zhu,54,PERSON-PERSON,NUMBER,PROPN-PROPN,NUM,compound-nsubj,appos,NNP-NNP,CD,2,1
2707,5020.0,81,said,1,24,31,7,23,49,-23,30,Taiwan Research Institute,People 's Republic of China,ORGANIZATION-ORGANIZATION-ORGANIZATION,LOCATION-LOCATION-LOCATION-LOCATION-LOCATION,PROPN-PROPN-PROPN,PROPN-PART-PROPN-ADP-PROPN,compound-compound-pobj,poss-case-nmod-prep-pobj,NNP-NNP-NNP,NNPS-POS-NNP-IN-NNP,8,1
2708,32638.0,35,said,14,8,17,9,7,17,6,3,Taiwan Research Institute,People 's Republic of China,ORGANIZATION-ORGANIZATION-ORGANIZATION,LOCATION-LOCATION-LOCATION-LOCATION-LOCATION,PROPN-PROPN-PROPN,PROPN-PART-PROPN-ADP-PROPN,compound-compound-pobj,poss-case-nsubj-prep-pobj,NNP-NNP-NNP,NNPS-POS-NNP-IN-NNP,9,1
2709,5041.0,16,joined,4,4,11,7,3,4,0,7,he,Maryland,PERSON,STATE_OR_PROVINCE,PRON,PROPN,nsubj,compound,PRP,NNP,5,1
2710,5046.0,50,rising,19,41,29,-12,40,20,-22,10,AAA,U.S.,ORGANIZATION,COUNTRY,PROPN,PROPN,pobj,compound,NNP,NNP,6,1
2711,5050.0,39,caused,35,19,25,6,18,13,16,-10,Hamilton,Afro - Carribean,PERSON,NATIONALITY-NATIONALITY-NATIONALITY,PROPN,PROPN-PUNCT-ADJ,appos,compound-punct-amod,NNP,NNP-HYPH-JJ,6,1
2712,5054.0,60,survived,9,8,47,39,7,12,1,38,Nolte,Jameson,PERSON,PERSON,PROPN,PROPN,nsubjpass,conj,NNP,NNP,11,1
2713,5057.0,23,returned,5,17,3,-14,16,19,-12,-2,Millonarios,Juan Carlos Osorio,ORGANIZATION,PERSON-PERSON-PERSON,PROPN,PROPN-PROPN-PROPN,pobj,compound-compound-nsubj,NNP,NNP-NNP-NNP,5,1
2714,61033.0,27,said,5,5,24,19,4,2,0,19,Millonarios,Juan Carlos Osorio,ORGANIZATION,PERSON-PERSON-PERSON,PROPN,PROPN-PROPN-PROPN,nsubj,compound-compound-pobj,NNP,NNP-NNP-NNP,4,1
2715,5063.0,20,Gillmor,6,6,5,-1,5,14,0,-1,Paul Gillmor,Congressman,PERSON-PERSON,TITLE,PROPN-PROPN,PROPN,compound-ROOT,compound,NNP-NNP,NNP,1,1
2716,20788.0,18,tell,3,11,10,-1,10,7,-8,7,Paul Gillmor,Congressman,PERSON-PERSON,TITLE,PROPN-PROPN,PROPN,compound-pobj,compound,NNP-NNP,NNP,1,1
2717,30107.0,17,Wednesday,2,6,5,-1,5,11,-4,3,Paul Gillmor,Congressman,PERSON-PERSON,TITLE,PROPN-PROPN,PROPN,compound-conj,compound,NNP-NNP,NNP,1,1
2718,5074.0,8,profit,6,4,1,-3,3,6,2,-5,Hindalco Q1,India,ORGANIZATION-ORGANIZATION,COUNTRY,PROPN-PROPN,PROPN,nmod-nmod,amod,NNP-NNP,NNP,3,1
2719,5078.0,41,said,24,9,2,-7,8,38,15,-22,Ownit Mortgage Solutions,December 2006,ORGANIZATION-ORGANIZATION-ORGANIZATION,DATE-DATE,PROPN-PROPN-PROPN,PROPN-NUM,compound-compound-pobj,pobj-nummod,NNP-NNP-NNPS,NNP-CD,7,1
2720,5084.0,19,announced,5,1,12,11,0,6,4,7,CMA,Country Music Hall of Fame,ORGANIZATION,ORGANIZATION-ORGANIZATION-ORGANIZATION-ORGANIZATION-ORGANIZATION,PROPN,PROPN-PROPN-PROPN-ADP-PROPN,compound,compound-compound-pobj-prep-pobj,NNP,NNP-NNP-NNP-IN-NNP,6,1
2721,5085.0,26,added,15,4,13,9,3,12,11,-2,Covidien,last year,ORGANIZATION,DATE-DATE,PROPN,ADJ-NOUN,pobj,amod-npadvmod,NNP,JJ-NN,6,1
2722,5092.0,23,worked,1,3,15,12,2,7,-2,14,his,Fordham University Law School,PERSON,ORGANIZATION-ORGANIZATION-ORGANIZATION-ORGANIZATION,DET,PROPN-PROPN-PROPN-PROPN,poss,compound-compound-compound-conj,PRP$,NNP-NNP-NNP-NNP,3,1
2723,5096.0,36,raised,25,9,14,5,8,21,16,-11,Arsenal Football Club,Alisher Usmanov,ORGANIZATION-ORGANIZATION-ORGANIZATION,PERSON-PERSON,PROPN-PROPN-PROPN,PROPN-PROPN,nmod-nmod-nmod,compound-pobj,NNP-NNP-NNP,NNP-NNP,2,1
2724,5097.0,19,was,2,1,4,3,0,14,1,2,Al Hubbard,director,PERSON-PERSON,TITLE,PROPN-PROPN,NOUN,compound-nsubj,attr,NNP-NNP,NN,3,1
2725,18838.0,37,wants,8,10,14,4,9,22,-2,6,Al Hubbard,director,PERSON-PERSON,TITLE,PROPN-PROPN,NOUN,compound-dobj,appos,NNP-NNP,NN,2,1
2726,26708.0,20,*,0,2,5,3,1,14,-2,5,Al Hubbard,director,PERSON-PERSON,TITLE,PROPN-PROPN,NOUN,compound-nsubj,attr,NNP-NNP,NN,3,1
2727,41431.0,29,nominated,5,21,14,-7,20,14,-16,9,Al Hubbard,director,PERSON-PERSON,TITLE,PROPN-PROPN,NOUN,compound-appos,dobj,NNP-NNP,NN,2,1
2728,57895.0,16,replaced,8,5,4,-1,4,11,3,-4,Al Hubbard,director,PERSON-PERSON,TITLE,PROPN-PROPN,NOUN,compound-nsubjpass,compound,NNP-NNP,NN,1,1
2729,65034.0,32,said,17,19,22,3,18,9,-2,5,Al Hubbard,director,PERSON-PERSON,TITLE,PROPN-PROPN,NOUN,compound-nsubj,appos,NNP-NNP,NN,2,1
2730,65962.0,65,told,41,7,10,3,6,54,34,-31,Al Hubbard,director,PERSON-PERSON,TITLE,PROPN-PROPN,NOUN,compound-nsubj,appos,NNP-NNP,NN,2,1
2731,5098.0,29,married,4,24,10,-14,23,18,-20,6,his,journalist,PERSON,TITLE,DET,NOUN,poss,appos,PRP$,NN,5,1
2732,12549.0,66,survived,12,2,9,7,1,56,10,-3,his,journalist,PERSON,TITLE,DET,NOUN,poss,conj,PRP$,NN,3,1
2733,56941.0,66,survived,12,2,9,7,1,56,10,-3,his,journalist,PERSON,TITLE,DET,NOUN,poss,conj,PRP$,NN,3,1
2734,5099.0,27,said,4,1,3,2,0,23,3,-1,ANP,Amin Khattak,ORGANIZATION,PERSON-PERSON,PROPN,PROPN-PROPN,compound,compound-nsubj,NNP,NNP-NNP,1,1
2735,37268.0,42,put,9,6,8,2,5,33,3,-1,ANP,Amin Khattak,ORGANIZATION,PERSON-PERSON,PROPN,PROPN-PROPN,compound,compound-nsubj,NNP,NNP-NNP,1,1
2736,5103.0,37,Writethru,2,7,5,-2,6,31,-5,3,Awami League,Bangladesh,ORGANIZATION-ORGANIZATION,COUNTRY,PROPN-PROPN,PROPN,compound-nsubj,poss,NNP-NNP,NNP,2,1
2737,7385.0,26,is,11,3,9,6,2,16,8,-2,Awami League,Bangladesh,ORGANIZATION-ORGANIZATION,COUNTRY,PROPN-PROPN,PROPN,compound-nsubj,compound,NNP-NNP,NNP,4,1
2738,15428.0,31,imposed,3,14,8,-6,13,22,-11,5,Awami League,Bangladesh,ORGANIZATION-ORGANIZATION,COUNTRY,PROPN-PROPN,PROPN,compound-appos,poss,NNP-NNP,NNP,5,1
2739,15918.0,25,is,1,23,1,-22,22,23,-22,0,Awami League,Bangladesh,ORGANIZATION-ORGANIZATION,COUNTRY,PROPN-PROPN,PROPN,compound-pobj,nsubj,NNP-NNP,NNP,10,1
2740,16201.0,44,warned,16,30,18,-12,29,25,-14,2,Awami League,Bangladesh,ORGANIZATION-ORGANIZATION,COUNTRY,PROPN-PROPN,PROPN,compound-pobj,dobj,NNP-NNP,NNP,7,1
2741,19269.0,38,made,7,4,1,-3,3,36,3,-6,Awami League,Bangladesh,ORGANIZATION-ORGANIZATION,COUNTRY,PROPN-PROPN,PROPN,compound-compound,poss,NNP-NNP,NNP,3,1
2742,40419.0,40,blamed,18,13,24,11,12,15,5,6,Awami League,Bangladesh,ORGANIZATION-ORGANIZATION,COUNTRY,PROPN-PROPN,PROPN,compound-compound,poss,NNP-NNP,NNP,5,1
2743,46782.0,9,Profile,0,3,9,6,2,-1,-3,9,Awami League,Bangladesh,ORGANIZATION-ORGANIZATION,COUNTRY,PROPN-PROPN,PROPN,compound-appos,pobj,NNP-NNP,NNP,-1,1
2744,62746.0,27,secured,4,3,2,-1,2,24,1,-2,Awami League,Bangladesh,ORGANIZATION-ORGANIZATION,COUNTRY,PROPN-PROPN,PROPN,compound-nsubj,compound,NNP-NNP,NNP,1,1
2745,5108.0,23,survived,7,6,13,7,5,9,1,6,Rothman,Theresa,PERSON,PERSON,PROPN,PROPN,nsubjpass,appos,NNP,NNP,4,1
2746,5110.0,29,was,12,1,8,7,0,20,11,-4,Mohamed El Baradei,International Atomic Energy Agency,PERSON-PERSON-PERSON,ORGANIZATION-ORGANIZATION-ORGANIZATION-ORGANIZATION,PROPN-PROPN-PROPN,PROPN-PROPN-PROPN-PROPN,compound-compound-nsubj,compound-compound-compound-pobj,NNP-NNP-NNP,NNP-NNP-NNP-NNP,5,1
2747,5126.0,25,says,7,5,1,-4,4,23,2,-6,Country Music Association,Tammy Genovese,ORGANIZATION-ORGANIZATION-ORGANIZATION,PERSON-PERSON,PROPN-PROPN-PROPN,PROPN-PROPN,compound-compound-pobj,compound-nsubj,NNP-NNP-NNP,NNP-NNP,3,1
2748,5131.0,29,known,7,6,3,-3,5,25,1,-4,JNF,1901,ORGANIZATION,DATE,PROPN,NUM,nsubjpass,pobj,NNP,CD,2,1
2749,12990.0,18,founded,3,2,6,4,1,11,1,3,JNF,1901,ORGANIZATION,DATE,PROPN,NUM,nsubjpass,pobj,NNP,CD,3,1
2750,36230.0,26,contained,12,8,2,-6,7,23,4,-10,JNF,1901,ORGANIZATION,DATE,PROPN,NUM,nsubjpass,pobj,NNP,CD,4,1
2751,5138.0,43,founded,7,1,15,14,0,27,6,8,Wildmon,Tupelo,PERSON,CITY,PROPN,PROPN,nsubj,compound,NNP,NNP,4,1
2752,5139.0,45,said,26,26,22,-4,25,22,0,-4,he,Taiwan,PERSON,COUNTRY,PRON,PROPN,nsubj,compound,PRP,NNP,6,1
2753,5142.0,33,became,6,6,26,20,5,6,0,20,he,Los Angeles,PERSON,CITY-CITY,PRON,PROPN-PROPN,nsubj,compound-pobj,PRP,NNP-NNP,10,1
2754,5145.0,40,LONDON,0,14,1,-13,13,38,-14,1,she,LONDON,PERSON,CITY,PRON,PROPN,nsubjpass,ROOT,PRP,NNP,5,1
2755,5152.0,34,drove,3,11,10,-1,10,23,-8,7,DeBlanc,Lt.,PERSON,TITLE,PROPN,PROPN,nsubj,compound,NNP,NNP,1,1
2756,20122.0,20,watched,10,2,1,-1,1,18,8,-9,DeBlanc,Lt.,PERSON,TITLE,PROPN,PROPN,nsubj,compound,NNP,NNP,1,1
2757,25644.0,33,radioed,22,22,21,-1,21,11,0,-1,DeBlanc,Lt.,PERSON,TITLE,PROPN,PROPN,nsubj,compound,NNP,NNP,1,1
2758,38507.0,9,saw,2,2,1,-1,1,7,0,-1,DeBlanc,Lt.,PERSON,TITLE,PROPN,PROPN,nsubj,compound,NNP,NNP,1,1
2759,49272.0,32,paddled,22,25,24,-1,24,7,-3,2,DeBlanc,Lt.,PERSON,TITLE,PROPN,PROPN,dobj,compound,NNP,NNP,1,1
2760,65401.0,29,bailed,2,2,1,-1,1,27,0,-1,DeBlanc,Lt.,PERSON,TITLE,PROPN,PROPN,nsubj,compound,NNP,NNP,1,1
2761,5157.0,36,said,22,16,11,-5,15,24,6,-11,CPC,Communist Party of China,ORGANIZATION,ORGANIZATION-ORGANIZATION-ORGANIZATION-ORGANIZATION,PROPN,PROPN-PROPN-ADP-PROPN,nsubj,compound-pobj-prep-pobj,NNP,NNP-NNP-IN-NNP,6,1
2762,11591.0,33,Party,2,7,2,-5,6,30,-5,0,CPC,Communist Party of China,ORGANIZATION,ORGANIZATION-ORGANIZATION-ORGANIZATION-ORGANIZATION,PROPN,PROPN-PROPN-ADP-PROPN,compound,compound-ROOT-prep-pobj,NNP,NNP-NNP-IN-NNP,1,1
2763,19561.0,52,said,12,11,6,-5,10,45,1,-6,CPC,Communist Party of China,ORGANIZATION,ORGANIZATION-ORGANIZATION-ORGANIZATION-ORGANIZATION,PROPN,PROPN-PROPN-ADP-PROPN,compound,compound-pobj-prep-pobj,NNP,NNP-NNP-IN-NNP,4,1
2764,23962.0,34,Party,2,7,2,-5,6,31,-5,0,CPC,Communist Party of China,ORGANIZATION,ORGANIZATION-ORGANIZATION-ORGANIZATION-ORGANIZATION,PROPN,PROPN-PROPN-ADP-PROPN,compound,compound-ROOT-prep-pobj,NNP,NNP-NNP-IN-NNP,1,1
2765,30374.0,54,attended,30,21,16,-5,20,37,9,-14,CPC,Communist Party of China,ORGANIZATION,ORGANIZATION-ORGANIZATION-ORGANIZATION-ORGANIZATION,PROPN,PROPN-PROPN-ADP-PROPN,compound,compound-pobj-prep-pobj,NNP,NNP-NNP-IN-NNP,7,1
2766,33096.0,42,said,22,40,35,-5,39,6,-18,13,CPC,Communist Party of China,ORGANIZATION,ORGANIZATION-ORGANIZATION-ORGANIZATION-ORGANIZATION,PROPN,PROPN-PROPN-ADP-PROPN,compound,compound-pobj-prep-pobj,NNP,NNP-NNP-IN-NNP,8,1
2767,34681.0,61,Jia,0,34,29,-5,33,31,-34,29,CPC,Communist Party of China,ORGANIZATION,ORGANIZATION-ORGANIZATION-ORGANIZATION-ORGANIZATION,PROPN,PROPN-PROPN-ADP-PROPN,compound,compound-pobj-prep-pobj,NNP,NNP-NNP-IN-NNP,6,1
2768,41535.0,35,said,21,16,11,-5,15,23,5,-10,CPC,Communist Party of China,ORGANIZATION,ORGANIZATION-ORGANIZATION-ORGANIZATION-ORGANIZATION,PROPN,PROPN-PROPN-ADP-PROPN,nmod,compound-pobj-prep-pobj,NNP,NNP-NNP-IN-NNP,6,1
2769,55132.0,43,Changchun,1,14,9,-5,13,33,-13,8,CPC,Communist Party of China,ORGANIZATION,ORGANIZATION-ORGANIZATION-ORGANIZATION-ORGANIZATION,PROPN,PROPN-PROPN-ADP-PROPN,compound,compound-pobj-prep-pobj,NNP,NNP-NNP-IN-NNP,4,1
2770,56726.0,49,said,47,25,20,-5,24,28,22,-27,CPC,Communist Party of China,ORGANIZATION,ORGANIZATION-ORGANIZATION-ORGANIZATION-ORGANIZATION,PROPN,PROPN-PROPN-ADP-PROPN,compound,compound-pobj-prep-pobj,NNP,NNP-NNP-IN-NNP,9,1
2771,61765.0,54,proceed,20,43,38,-5,42,15,-23,18,CPC,Communist Party of China,ORGANIZATION,ORGANIZATION-ORGANIZATION-ORGANIZATION-ORGANIZATION,PROPN,PROPN-PROPN-ADP-PROPN,compound,compound-conj-prep-pobj,NNP,NNP-NNP-IN-NNP,2,1
2772,62501.0,33,reelected,6,17,12,-5,16,20,-11,6,CPC,Communist Party of China,ORGANIZATION,ORGANIZATION-ORGANIZATION-ORGANIZATION-ORGANIZATION,PROPN,PROPN-PROPN-ADP-PROPN,compound,compound-pobj-prep-pobj,NNP,NNP-NNP-IN-NNP,4,1
2773,5160.0,42,said,14,11,7,-4,10,34,3,-7,International Crisis Group,Sidney Jones,ORGANIZATION-ORGANIZATION-ORGANIZATION,PERSON-PERSON,PROPN-PROPN-PROPN,PROPN-PROPN,compound-compound-pobj,compound-appos,NNP-NNP-NNP,NNP-NNP,3,1
2774,5161.0,10,lives,1,1,9,8,0,0,0,8,He,Bremen,PERSON,CITY,PRON,PROPN,nsubj,pobj,PRP,NNP,1,1
2775,5164.0,50,include,1,34,18,-16,33,31,-33,17,Gregory Gude,Sharon Gude,PERSON-PERSON,PERSON-PERSON,PROPN-PROPN,PROPN-PROPN,compound-conj,compound-appos,NNP-NNP,NNP-NNP,5,1
2776,5167.0,34,oppose,14,10,17,7,9,16,4,3,Barbara Boxer,House,PERSON-PERSON,ORGANIZATION,PROPN-PROPN,PROPN,compound-pobj,compound,NNP-NNP,NNP,5,1
2777,55129.0,26,is,2,8,25,17,7,0,-6,23,Barbara Boxer,House,PERSON-PERSON,ORGANIZATION,PROPN-PROPN,PROPN,compound-pobj,pobj,NNP-NNP,NNP,-1,1
2778,5171.0,38,WELLINGTON,0,8,11,3,7,26,-8,11,Watson,founder,PERSON,TITLE,PROPN,NOUN,appos,appos,NNP,NN,-1,1
2779,5173.0,22,was,1,17,12,-5,16,9,-16,11,he,University of Maryland,PERSON,ORGANIZATION-ORGANIZATION-ORGANIZATION,PRON,PROPN-ADP-PROPN,nsubj,pobj-prep-pobj,PRP,NNP-IN-NNP,6,1
2780,5180.0,68,says,6,26,20,-6,25,47,-20,14,Moro National Liberation Front,Nur Misuari,ORGANIZATION-ORGANIZATION-ORGANIZATION-ORGANIZATION,PERSON-PERSON,PROPN-PROPN-PROPN-PROPN,PROPN-PROPN,compound-compound-compound-pobj,compound-pobj,NNP-NNP-NNP-NNP,NNP-NNP,5,1
2781,8503.0,51,asks,1,13,21,8,12,29,-12,20,Moro National Liberation Front,Nur Misuari,ORGANIZATION-ORGANIZATION-ORGANIZATION-ORGANIZATION,PERSON-PERSON,PROPN-PROPN-PROPN-PROPN,PROPN-PROPN,compound-compound-compound-dobj,compound-poss,NNP-NNP-NNP-NNP,NNP-NNP,3,1
2782,12356.0,25,said,13,21,15,-6,20,9,-8,2,Moro National Liberation Front,Nur Misuari,ORGANIZATION-ORGANIZATION-ORGANIZATION-ORGANIZATION,PERSON-PERSON,PROPN-PROPN-PROPN-PROPN,PROPN-PROPN,compound-compound-compound-pobj,compound-nsubj,NNP-NNP-NNP-NNP,NNP-NNP,4,1
2783,29547.0,47,want,1,15,9,-6,14,37,-14,8,Moro National Liberation Front,Nur Misuari,ORGANIZATION-ORGANIZATION-ORGANIZATION-ORGANIZATION,PERSON-PERSON,PROPN-PROPN-PROPN-PROPN,PROPN-PROPN,compound-compound-compound-pobj,compound-dobj,NNP-NNP-NNP-NNP,NNP-NNP,4,1
2784,37704.0,45,MANILA,0,15,20,5,14,24,-15,20,Moro National Liberation Front,Nur Misuari,ORGANIZATION-ORGANIZATION-ORGANIZATION-ORGANIZATION,PERSON-PERSON,PROPN-PROPN-PROPN-PROPN,PROPN-PROPN,compound-compound-compound-compound,compound-pobj,NNP-NNP-NNP-NNP,NNP-NNP,6,1
2785,37967.0,16,founded,2,5,1,-4,4,14,-3,-1,Moro National Liberation Front,Nur Misuari,ORGANIZATION-ORGANIZATION-ORGANIZATION-ORGANIZATION,PERSON-PERSON,PROPN-PROPN-PROPN-PROPN,PROPN-PROPN,compound-compound-compound-dobj,compound-nsubj,NNP-NNP-NNP-NNP,NNP-NNP,3,1
2786,39934.0,39,allowed,19,9,1,-8,8,37,10,-18,Moro National Liberation Front,Nur Misuari,ORGANIZATION-ORGANIZATION-ORGANIZATION-ORGANIZATION,PERSON-PERSON,PROPN-PROPN-PROPN-PROPN,PROPN-PROPN,compound-compound-compound-pobj,compound-nsubjpass,NNP-NNP-NNP-NNP,NNP-NNP,4,1
2787,5196.0,28,died,23,1,27,26,0,0,22,4,Randall Forsberg,64,PERSON-PERSON,NUMBER,PROPN-PROPN,NUM,compound-nsubj,nummod,NNP-NNP,CD,3,1
2788,25596.0,12,dies,9,1,12,11,0,-1,8,3,Randall Forsberg,64,PERSON-PERSON,NUMBER,PROPN-PROPN,NUM,compound-nsubj,pobj,NNP-NNP,CD,-1,1
2789,45236.0,8,Forsberg,3,3,6,3,2,1,0,3,Randall Forsberg,64,PERSON-PERSON,NUMBER,PROPN-PROPN,NUM,compound-ROOT,appos,NNP-NNP,CD,2,1
2790,49591.0,68,Forsberg,3,3,6,3,2,61,0,3,Randall Forsberg,64,PERSON-PERSON,NUMBER,PROPN-PROPN,NUM,compound-ROOT,appos,NNP-NNP,CD,2,1
2791,5224.0,38,said,7,17,13,-4,16,24,-10,6,International Crisis Group,Brussels-based,ORGANIZATION-ORGANIZATION-ORGANIZATION,CITY,PROPN-PROPN-PROPN,VERB,compound-compound-appos,nsubj,NNP-NNP-NNP,VBN,2,1
2792,26767.0,34,said,14,2,7,5,1,26,12,-7,International Crisis Group,Brussels-based,ORGANIZATION-ORGANIZATION-ORGANIZATION,CITY,PROPN-PROPN-PROPN,VERB,compound-compound-nsubj,amod,NNP-NNP-NNP,VBN,4,1
2793,5226.0,26,lost,15,14,6,-8,13,19,1,-9,he,House,PERSON,ORGANIZATION,PRON,PROPN,nsubj,compound,PRP,NNP,4,1
2794,20758.0,20,became,9,2,19,17,1,0,7,10,he,House,PERSON,TITLE,PRON,PROPN,nsubjpass,pobj,PRP,NNP,3,1
2795,5230.0,22,is,1,1,8,7,0,13,0,7,Huber,Social Democrats,PERSON,ORGANIZATION-ORGANIZATION,PROPN,PROPN-PROPN,nsubj,compound-pobj,NNP,NNP-NNPS,4,1
2796,5231.0,33,said,13,1,9,8,0,23,12,-4,M. Enkhbold,prime minister,PERSON-PERSON,TITLE-TITLE,PROPN-PROPN,ADJ-NOUN,compound-nsubj,amod-conj,NNP-NNP,JJ-NN,3,1
2797,47029.0,34,won,10,20,32,12,19,1,-10,22,M. Enkhbold,prime minister,PERSON-PERSON,TITLE-TITLE,PROPN-PROPN,ADJ-NOUN,compound-dobj,amod-conj,NNP-NNP,JJ-NN,2,1
2798,5236.0,27,RICHMOND,0,8,6,-2,7,20,-8,6,Jo Ann Davis,U.S.,PERSON-PERSON-PERSON,COUNTRY,PROPN-PROPN-PROPN,PROPN,compound-compound-nsubj,compound,NNP-NNP-NNP,NNP,2,1
2799,13032.0,35,selected,6,32,29,-3,31,5,-26,23,Jo Ann Davis,U.S.,PERSON-PERSON-PERSON,COUNTRY,PROPN-PROPN-PROPN,PROPN,compound-compound-appos,compound,NNP-NNP-NNP,NNP,2,1
2800,17315.0,34,said,32,3,1,-2,2,32,29,-31,Jo Ann Davis,U.S.,PERSON-PERSON-PERSON,COUNTRY,PROPN-PROPN-PROPN,PROPN,compound-compound-nsubj,compound,NNP-NNP-NNP,NNP,2,1
2801,45239.0,41,said,39,6,4,-2,5,36,33,-35,Jo Ann Davis,U.S.,PERSON-PERSON-PERSON,COUNTRY,PROPN-PROPN-PROPN,PROPN,compound-compound-pobj,compound,NNP-NNP-NNP,NNP,2,1
2802,51544.0,30,In,0,16,14,-2,15,15,-16,14,Jo Ann Davis,U.S.,PERSON-PERSON-PERSON,COUNTRY,PROPN-PROPN-PROPN,PROPN,compound-compound-pobj,compound,NNP-NNP-NNP,NNP,2,1
2803,5249.0,38,has,15,34,29,-5,33,8,-19,14,FMF,Mexican Association Football Federation,ORGANIZATION,ORGANIZATION-ORGANIZATION-ORGANIZATION-ORGANIZATION,PROPN,PROPN-PROPN-PROPN-PROPN,compound,compound-compound-compound-pobj,NNP,NNP-NNP-NNP-NNP,3,1
2804,5260.0,30,said,1,25,3,-22,24,26,-24,2,Kollek,Israel,PERSON,COUNTRY,PROPN,PROPN,nsubj,poss,NNP,NNP,5,1
2805,5261.0,21,confirmed,3,19,11,-8,18,9,-16,8,Peterson,Mississauga,PERSON,CITY,PROPN,PROPN,nsubj,pobj,NNP,NNP,6,1
2806,33133.0,35,cut,10,1,6,5,0,28,9,-4,Peterson,Mississauga,PERSON,CITY,PROPN,PROPN,nsubj,pobj,NNP,NNP,5,1
2807,50980.0,24,said,14,1,11,10,0,12,13,-3,Peterson,Mississauga,PERSON,CITY,PROPN,PROPN,nsubj,pobj,NNP,NNP,1,1
2808,5266.0,31,said,20,28,22,-6,27,8,-8,2,American Bankers Association,Peter Garuccio,ORGANIZATION-ORGANIZATION-ORGANIZATION,PERSON-PERSON,PROPN-PROPN-PROPN,PROPN-PROPN,compound-compound-pobj,compound-nsubj,NNP-NNPS-NNP,NNP-NNP,5,1
2809,40893.0,34,think,17,8,1,-7,7,32,9,-16,American Bankers Association,Peter Garuccio,ORGANIZATION-ORGANIZATION-ORGANIZATION,PERSON-PERSON,PROPN-PROPN-PROPN,PROPN-PROPN,compound-compound-pobj,compound-nsubj,NNP-NNPS-NNP,NNP-NNP,4,1
2810,5269.0,31,was,1,1,30,29,0,0,0,29,Hassan,Jordan,PERSON,COUNTRY,PROPN,PROPN,nsubj,pobj,NNP,NNP,1,1
2811,5271.0,31,said,27,18,25,7,17,5,9,-2,International Monetary Fund,Simon Johnson,ORGANIZATION-ORGANIZATION-ORGANIZATION,PERSON-PERSON,PROPN-PROPN-PROPN,PROPN-PROPN,compound-compound-poss,compound-appos,NNP-NNP-NNP,NNP-NNP,3,1
2812,25042.0,31,said,17,28,19,-9,27,11,-11,2,International Monetary Fund,Simon Johnson,ORGANIZATION-ORGANIZATION-ORGANIZATION,PERSON-PERSON,PROPN-PROPN-PROPN,PROPN-PROPN,compound-compound-pobj,compound-nsubj,NNP-NNP-NNP,NNP-NNP,5,1
2813,52430.0,47,said,21,32,23,-9,31,23,-11,2,International Monetary Fund,Simon Johnson,ORGANIZATION-ORGANIZATION-ORGANIZATION,PERSON-PERSON,PROPN-PROPN-PROPN,PROPN-PROPN,compound-compound-pobj,compound-nsubj,NNP-NNP-NNP,NNP-NNP,5,1
2814,5272.0,28,said,9,11,16,5,10,11,-2,7,Abdul Jalil Jan,spokesman,PERSON-PERSON-PERSON,TITLE,PROPN-PROPN-PROPN,NOUN,compound-compound-nsubj,appos,NNP-NNP-NNP,NN,2,1
2815,6642.0,29,said,14,12,11,-1,11,17,2,-3,Abdul Jalil Jan,spokesman,PERSON-PERSON-PERSON,TITLE,PROPN-PROPN-PROPN,NOUN,compound-compound-nsubj,compound,NNP-NNP-NNP,NN,1,1
2816,13259.0,19,said,5,3,2,-1,2,16,2,-3,Abdul Jalil Jan,spokesman,PERSON-PERSON-PERSON,TITLE,PROPN-PROPN-PROPN,NOUN,compound-compound-nsubj,compound,NNP-NNP-NNP,NN,1,1
2817,53639.0,26,told,14,12,11,-1,11,14,2,-3,Abdul Jalil Jan,spokesman,PERSON-PERSON-PERSON,TITLE,PROPN-PROPN-PROPN,NOUN,compound-compound-nsubj,compound,NNP-NNP-NNP,NN,1,1
2818,53822.0,20,said,5,3,2,-1,2,17,2,-3,Abdul Jalil Jan,spokesman,PERSON-PERSON-PERSON,TITLE,PROPN-PROPN-PROPN,NOUN,compound-compound-nsubj,compound,NNP-NNP-NNP,NN,1,1
2819,5283.0,17,appointed,4,6,9,3,5,7,-2,5,Yoadimnadji,lawyer,PERSON,TITLE,PROPN,NOUN,dobj,appos,NNPS,NN,3,1
2820,13298.0,21,played,4,4,2,-2,3,18,0,-2,Yoadimnadji,lawyer,PERSON,TITLE,PROPN,NOUN,nsubj,npadvmod,NNPS,NN,1,1
2821,5286.0,38,sprayed,32,17,8,-9,16,29,15,-24,Hamilton,Nicolas,PERSON,PERSON,PROPN,PROPN,appos,appos,NNP,NNP,4,1
2822,54201.0,23,said,8,11,18,7,10,4,-3,10,Hamilton,Nicolas,PERSON,PERSON,PROPN,PROPN,nsubj,appos,NNP,NNP,5,1
2823,5289.0,21,Court,4,7,1,-6,6,19,-3,-3,TSE,Brazil,ORGANIZATION,COUNTRY,PROPN,PROPN,compound,poss,NNP,NNP,3,1
2824,12584.0,35,said,15,33,27,-6,32,7,-18,12,TSE,Brazil,ORGANIZATION,COUNTRY,PROPN,PROPN,compound,poss,NNP,NNP,9,1
2825,5291.0,27,accused,8,12,23,11,11,3,-4,15,Murat Kurnaz,Cuba,PERSON-PERSON,COUNTRY,PROPN-PROPN,PROPN,compound-dobj,pobj,NNP-NNP,NNP,5,1
2826,26704.0,32,detained,7,1,27,26,0,4,6,20,Murat Kurnaz,Cuba,PERSON-PERSON,COUNTRY,PROPN-PROPN,PROPN,compound-nsubjpass,pobj,NNP-NNP,NNP,4,1
2827,63565.0,40,weathering,2,13,25,12,12,14,-11,23,Murat Kurnaz,Cuba,PERSON-PERSON,COUNTRY,PROPN-PROPN,PROPN,compound-dobj,pobj,NNP-NNP,NNP,3,1
2828,5299.0,25,gained,14,9,13,4,8,11,5,-1,Tokyo Stock Exchange,Nikkei,ORGANIZATION-ORGANIZATION-ORGANIZATION,ORGANIZATION,PROPN-PROPN-PROPN,PROPN,compound-compound-poss,compound,NNP-NNP-NNP,NNP,2,1
2829,25729.0,21,rose,4,18,2,-16,17,18,-14,-2,Tokyo Stock Exchange,Nikkei,ORGANIZATION-ORGANIZATION-ORGANIZATION,ORGANIZATION,PROPN-PROPN-PROPN,PROPN,compound-compound-pobj,nmod,NNP-NNP-NNP,NNP,8,1
2830,47142.0,23,added,4,20,2,-18,19,20,-16,-2,Tokyo Stock Exchange,Nikkei,ORGANIZATION-ORGANIZATION-ORGANIZATION,ORGANIZATION,PROPN-PROPN-PROPN,PROPN,compound-compound-pobj,nmod,NNP-NNP-NNP,NNP,7,1
2831,5313.0,17,served,5,2,14,12,1,2,3,9,Babyshambles,his,ORGANIZATION,PERSON,PROPN,DET,compound,poss,NNPS,PRP$,2,1
2832,6594.0,31,had,4,2,8,6,1,22,2,4,Babyshambles,his,PERSON,PERSON,PROPN,DET,nmod,poss,NNPS,PRP$,4,1
2833,28650.0,53,abend,30,36,34,-2,35,18,-6,4,Babyshambles,his,ORGANIZATION,PERSON,PROPN,DET,nsubj,poss,NNPS,PRP$,5,1
2834,5319.0,31,said,29,4,23,19,3,7,25,-6,Cathleen P Black,chairwoman,PERSON-PERSON-PERSON,TITLE,PROPN-PROPN-PROPN,NOUN,compound-compound-dobj,pobj,NNP-NNP-NNP,NN,7,1
2835,36329.0,19,appointed,4,6,10,4,5,8,-2,6,Cathleen P Black,chairwoman,PERSON-PERSON-PERSON,TITLE,PROPN-PROPN-PROPN,NOUN,compound-compound-dobj,appos,NNP-NNP-NNP,NN,3,1
2836,41579.0,26,is,1,15,20,5,14,5,-14,19,Cathleen P Black,chairwoman,PERSON-PERSON-PERSON,TITLE,PROPN-PROPN-PROPN,NOUN,compound-compound-appos,appos,NNP-NNP-NNP,NN,3,1
2837,5323.0,52,said,10,6,1,-5,5,50,4,-9,International Monetary Fund,Robert Cardarelli,ORGANIZATION-ORGANIZATION-ORGANIZATION,PERSON-PERSON,PROPN-PROPN-PROPN,PROPN-PROPN,compound-compound-compound,compound-nsubj,NNP-NNP-NNP,NNP-NNP,3,1
2838,5332.0,60,met,1,3,4,1,2,55,-2,3,Fidel Castro,Castro,PERSON-PERSON,PERSON,PROPN-PROPN,PROPN,compound-dobj,poss,NNP-NNP,NNP,2,1
2839,29520.0,30,was,7,26,11,-15,25,18,-19,4,Fidel Castro,Castro,PERSON-PERSON,PERSON,PROPN-PROPN,PROPN,compound-appos,attr,NNP-NNP,NNP,5,1
2840,5338.0,35,said,29,1,33,32,0,1,28,4,Pentax,Akiko Maeyama,ORGANIZATION,PERSON-PERSON,ADJ,PROPN-PROPN,compound,compound-nsubj,JJ,NNP-NNP,4,1
2841,5345.0,50,YORK,1,6,12,6,5,37,-5,11,National Center for Disaster Preparedness,http://wwwncdpmailmancolumbiaedu,ORGANIZATION-ORGANIZATION-ORGANIZATION-ORGANIZATION-ORGANIZATION,URL,PROPN-PROPN-ADP-PROPN-PROPN,PUNCT,compound-appos-prep-compound-pobj,ROOT,NNP-NNP-IN-NNP-NNP,``,7,1
2842,5347.0,60,said,14,8,11,3,7,48,6,-3,Northland Church,Longwood,ORGANIZATION-ORGANIZATION,CITY,PROPN-PROPN,PROPN,compound-pobj,pobj,NNP-NNP,NNP,1,1
2843,11059.0,28,said,10,18,25,7,17,2,-8,15,Northland Church,Longwood,ORGANIZATION-ORGANIZATION,CITY,PROPN-PROPN,PROPN,compound-pobj,pobj,NNP-NNP,NNP,4,1
2844,36810.0,27,carries,15,2,5,3,1,21,13,-10,Northland Church,Longwood,ORGANIZATION-ORGANIZATION,CITY,PROPN-PROPN,PROPN,compound-pobj,pobj,NNP-NNP,NNP,3,1
2845,65016.0,28,numbered,2,22,25,3,21,2,-20,23,Northland Church,Longwood,ORGANIZATION-ORGANIZATION,CITY,PROPN-PROPN,PROPN,compound-pobj,pobj,NNP-NNP,NNP,3,1
2846,5350.0,25,remember,16,23,22,-1,22,2,-7,6,Art Buchwald,columnist,PERSON-PERSON,TITLE,PROPN-PROPN,NOUN,compound-pobj,compound,NNP-NNP,NN,1,1
2847,18131.0,33,died,30,1,10,9,0,22,29,-20,Art Buchwald,columnist,PERSON-PERSON,TITLE,PROPN-PROPN,NOUN,compound-nsubj,conj,NNP-NNP,NN,2,1
2848,28797.0,43,gestured,21,18,17,-1,17,25,3,-4,Art Buchwald,columnist,PERSON-PERSON,TITLE,PROPN-PROPN,NOUN,compound-appos,dobj,NNP-NNP,NN,1,1
2849,39463.0,26,said,23,2,9,7,1,16,21,-14,Art Buchwald,columnist,PERSON-PERSON,TITLE,NOUN-PROPN,NOUN,compound-nsubj,pobj,NN-NNP,NN,4,1
2850,64375.0,42,obituary,6,12,11,-1,11,30,-6,5,Art Buchwald,columnist,PERSON-PERSON,TITLE,PROPN-PROPN,NOUN,compound-appos,pobj,NNP-NNP,NN,1,1
2851,67808.0,14,recall,3,12,11,-1,11,2,-9,8,Art Buchwald,columnist,PERSON-PERSON,TITLE,PROPN-PROPN,NOUN,compound-conj,compound,NNP-NNP,NN,1,1
2852,5364.0,15,acquire,6,8,10,2,7,4,-2,4,IPSCO,SSAB,ORGANIZATION,ORGANIZATION,PROPN,PROPN,dobj,pobj,NNP,NNP,3,1
2853,27511.0,26,said,7,16,7,-9,15,18,-9,0,IPSCO,SSAB,ORGANIZATION,ORGANIZATION,PROPN,PROPN,dobj,pobj,NNP,NNP,3,1
2854,47339.0,17,said,4,1,9,8,0,7,3,5,IPSCO,SSAB,ORGANIZATION,ORGANIZATION,NOUN,PROPN,compound,nmod,NN,NNP,6,1
2855,60918.0,39,said,7,17,7,-10,16,31,-10,0,IPSCO,SSAB,ORGANIZATION,ORGANIZATION,PROPN,PROPN,dobj,pobj,NNP,NNP,3,1
2856,62241.0,23,said,1,15,1,-14,14,21,-14,0,IPSCO,SSAB,ORGANIZATION,ORGANIZATION,PROPN,PROPN,compound,nsubj,NNP,NNP,8,1
2857,66762.0,19,MOSCOW,0,12,14,2,11,4,-12,14,IPSCO,SSAB,ORGANIZATION,ORGANIZATION,PROPN,PROPN,dobj,pobj,NNP,NNP,1,1
2858,5380.0,26,said,5,1,3,2,0,22,4,-2,IMF,Rodrigo de Rato,ORGANIZATION,PERSON-PERSON-PERSON,PROPN,PROPN-PROPN-PROPN,compound,nmod-compound-nsubj,NNP,NNP-NNP-NNP,2,1
2859,5383.0,20,asked,0,5,2,-3,4,17,-5,2,Arsenal,Nigel Phillips,ORGANIZATION,PERSON-PERSON,PROPN,PROPN-PROPN,compound,compound-dobj,NNP,NNP-NNP,1,1
2860,5385.0,39,seized,2,1,8,7,0,30,1,6,Kurnaz,Pakistan,PERSON,COUNTRY,PROPN,PROPN,nsubjpass,pobj,NNP,NNP,3,1
2861,51518.0,45,arrested,2,1,5,4,0,39,1,3,Kurnaz,Pakistan,PERSON,COUNTRY,PROPN,PROPN,nsubjpass,pobj,NNP,NNP,4,1
2862,5393.0,28,said,10,18,22,4,17,5,-8,12,Northland Church,evangelical,ORGANIZATION-ORGANIZATION,RELIGION,PROPN-PROPN,ADJ,compound-pobj,amod,NNP-NNP,JJ,3,1
2863,5403.0,40,came,20,4,26,22,3,13,16,6,Dewey,Iowa,PERSON,STATE_OR_PROVINCE,PROPN,PROPN,dobj,compound,NNP,NNP,4,1
2864,5409.0,8,include,1,3,5,2,2,2,-2,4,her,Jonathan,PERSON,PERSON,DET,PROPN,poss,appos,PRP$,NNP,2,1
2865,5971.0,29,survived,2,5,17,12,4,11,-3,15,her,Jonathan,PERSON,PERSON,DET,PROPN,poss,conj,PRP$,NNP,3,1
2866,5413.0,36,Neddo,1,9,1,-8,8,34,-8,0,Manila Economic and Cultural Office,Yvonne Neddo,ORGANIZATION-ORGANIZATION-ORGANIZATION-ORGANIZATION-ORGANIZATION,PERSON-PERSON,PROPN-PROPN-CCONJ-PROPN-PROPN,PROPN-PROPN,nmod-nmod-cc-conj-pobj,compound-ROOT,NNP-NNP-CC-NNP-NNP,NNP-NNP,4,1
2867,5428.0,45,WASHINGTON,0,20,25,5,19,19,-20,25,Carson,police officer,PERSON,TITLE-TITLE,PROPN,NOUN-NOUN,nsubj,compound-appos,NNP,NN-NN,7,1
2868,59623.0,41,said,14,16,21,5,15,19,-2,7,Carson,police officer,PERSON,TITLE-TITLE,PROPN,NOUN-NOUN,nsubj,compound-appos,NNP,NN-NN,2,1
2869,5429.0,31,reported,29,3,2,-1,2,28,26,-27,Juanita Millender-McDonald,Representative,PERSON-PERSON,TITLE,PROPN-PROPN,PROPN,compound-nsubj,compound,NNP-NNP,NNP,2,1
2870,13527.0,31,reported,29,3,2,-1,2,28,26,-27,Juanita Millender-McDonald,Representative,PERSON-PERSON,TITLE,PROPN-PROPN,PROPN,compound-nsubj,compound,NNP-NNP,NNP,2,1
2871,63357.0,39,replied,13,12,11,-1,11,27,1,-2,Juanita Millender-McDonald,Representative,PERSON-PERSON,TITLE,PROPN-PROPN,PROPN,compound-nsubj,compound,NNP-NNP,NNP,2,1
2872,5439.0,24,said,7,5,1,-4,4,22,2,-6,G. Gary Kirchner,Lancaster County,PERSON-PERSON-PERSON,LOCATION-LOCATION,PROPN-PROPN-PROPN,PROPN-PROPN,compound-compound-nsubj,compound-compound,NNP-NNP-NNP,NNP-NNP,3,1
2873,5451.0,27,took,1,6,1,-5,5,25,-5,0,Samsung,Lee,ORGANIZATION,PERSON,PROPN,PROPN,pobj,nsubj,NNP,NNP,3,1
2874,5462.0,26,was,1,1,6,5,0,19,0,5,She,Larkin Douglass Watson,PERSON,PERSON-PERSON-PERSON,PRON,PROPN-PROPN-PROPN,nsubj,compound-compound-pobj,PRP,NNP-NNP-NNP,4,1
2875,5464.0,27,commissioned,3,7,13,6,6,13,-4,10,National Center for Disaster Preparedness,Columbia University,ORGANIZATION-ORGANIZATION-ORGANIZATION-ORGANIZATION-ORGANIZATION,ORGANIZATION-ORGANIZATION,PROPN-PROPN-ADP-PROPN-PROPN,PROPN-PROPN,compound-pobj-prep-compound-pobj,compound-poss,NNP-NNP-IN-NNP-NNP,NNP-NNP,5,1
2876,18834.0,41,said,25,12,21,9,11,19,13,-4,National Center for Disaster Preparedness,Columbia University,ORGANIZATION-ORGANIZATION-ORGANIZATION-ORGANIZATION-ORGANIZATION,ORGANIZATION-ORGANIZATION,PROPN-PROPN-ADP-PROPN-PROPN,PROPN-PROPN,compound-pobj-prep-compound-pobj,compound-pobj,NNP-NNP-IN-NNP-NNP,NNP-NNP,-1,1
2877,20320.0,53,said,23,34,31,-3,33,21,-11,8,National Center for Disaster Preparedness,Columbia University,ORGANIZATION-ORGANIZATION-ORGANIZATION-ORGANIZATION-ORGANIZATION,ORGANIZATION-ORGANIZATION,PROPN-PROPN-ADP-PROPN-PROPN,PROPN-PROPN,compound-pobj-prep-compound-pobj,compound-poss,NNP-NNP-IN-NNP-NNP,NNP-NNP,1,1
2878,22292.0,31,said,14,22,29,7,21,1,-8,15,National Center for Disaster Preparedness,Columbia University,ORGANIZATION-ORGANIZATION-ORGANIZATION-ORGANIZATION-ORGANIZATION,ORGANIZATION-ORGANIZATION,PROPN-PROPN-ADP-PROPN-PROPN,PROPN-PROPN,compound-pobj-prep-compound-pobj,compound-pobj,NNP-NNP-IN-NNP-NNP,NNP-NNP,7,1
2879,23564.0,27,said,11,19,25,6,18,1,-8,14,National Center for Disaster Preparedness,Columbia University,ORGANIZATION-ORGANIZATION-ORGANIZATION-ORGANIZATION-ORGANIZATION,ORGANIZATION-ORGANIZATION,PROPN-PROPN-ADP-PROPN-PROPN,PROPN-PROPN,compound-pobj-prep-compound-pobj,compound-pobj,NNP-NNP-IN-NNP-NNP,NNP-NNP,4,1
2880,38523.0,57,said,20,28,34,6,27,22,-8,14,National Center for Disaster Preparedness,Columbia University,ORGANIZATION-ORGANIZATION-ORGANIZATION-ORGANIZATION-ORGANIZATION,ORGANIZATION-ORGANIZATION,PROPN-PROPN-ADP-PROPN-PROPN,PROPN-PROPN,compound-pobj-prep-compound-pobj,compound-pobj,NNP-NNP-IN-NNP-NNP,NNP-NNP,6,1
2881,42581.0,45,said,36,22,10,-12,21,34,14,-26,National Center for Disaster Preparedness,Columbia University,ORGANIZATION-ORGANIZATION-ORGANIZATION-ORGANIZATION-ORGANIZATION,ORGANIZATION-ORGANIZATION,PROPN-PROPN-ADP-PROPN-PROPN,PROPN-PROPN,compound-pobj-prep-compound-pobj,compound-poss,NNP-NNP-IN-NNP-NNP,NNP-NNP,5,1
2882,5468.0,40,conducted,3,9,22,13,8,17,-6,19,Tax Policy Center,Brookings Institution,ORGANIZATION-ORGANIZATION-ORGANIZATION,ORGANIZATION-ORGANIZATION,PROPN-PROPN-PROPN,PROPN-PROPN,compound-compound-pobj,compound-conj,NNP-NNP-NNP,NNP-NNP,5,1
2883,5470.0,71,realized,9,5,70,65,4,0,4,61,his,California,PERSON,STATE_OR_PROVINCE,DET,PROPN,poss,pobj,PRP$,NNP,4,1
2884,9003.0,82,introduced,21,9,16,7,8,65,12,-5,his,California,PERSON,STATE_OR_PROVINCE,DET,PROPN,poss,compound,PRP$,NNP,8,1
2885,17228.0,47,said,41,43,13,-30,42,33,-2,-28,his,California,PERSON,STATE_OR_PROVINCE,DET,PROPN,poss,compound,PRP$,NNP,6,1
2886,58926.0,54,were,19,2,10,8,1,43,17,-9,his,California,PERSON,STATE_OR_PROVINCE,DET,PROPN,poss,compound,PRP$,NNP,4,1
2887,5476.0,46,are,18,18,13,-5,17,32,0,-5,Jaguars,AFC,ORGANIZATION,ORGANIZATION,PROPN,PROPN,nsubj,compound,NNPS,NNP,7,1
2888,5477.0,7,reports,4,3,1,-2,2,5,1,-3,Konica Minolta,Japan,ORGANIZATION-ORGANIZATION,COUNTRY,PROPN-PROPN,PROPN,compound-nsubj,poss,NNP-NNP,NNP,2,1
2889,11723.0,30,said,4,3,1,-2,2,28,1,-3,Konica Minolta,Japan,ORGANIZATION-ORGANIZATION,COUNTRY,PROPN-PROPN,PROPN,compound-nsubj,poss,NNP-NNP,NNP,2,1
2890,16662.0,10,says,4,3,1,-2,2,8,1,-3,Konica Minolta,Japan,ORGANIZATION-ORGANIZATION,COUNTRY,PROPN-PROPN,PROPN,compound-nsubj,poss,NNP-NNP,NNP,2,1
2891,18625.0,32,said,4,3,1,-2,2,30,1,-3,Konica Minolta,Japan,ORGANIZATION-ORGANIZATION,COUNTRY,PROPN-PROPN,PROPN,compound-nsubj,poss,NNP-NNP,NNP,2,1
2892,22134.0,38,jumps,4,1,9,8,0,28,3,5,Konica Minolta,Japan,ORGANIZATION-ORGANIZATION,COUNTRY,PROPN-PROPN,PROPN,compound-nmod,poss,NNP-NNP,NNP,5,1
2893,38307.0,36,said,4,3,1,-2,2,34,1,-3,Konica Minolta,Japan,ORGANIZATION-ORGANIZATION,COUNTRY,PROPN-PROPN,PROPN,compound-nsubj,poss,NNP-NNP,NNP,2,1
2894,52527.0,28,reported,4,3,1,-2,2,26,1,-3,Konica Minolta,Japan,ORGANIZATION-ORGANIZATION,COUNTRY,PROPN-PROPN,PROPN,compound-nsubj,poss,NNP-NNP,NNP,2,1
2895,5481.0,19,drove,5,14,18,4,13,0,-9,13,his,Okeechobee,PERSON,LOCATION,DET,PROPN,poss,pobj,PRP$,NNP,4,1
2896,5483.0,36,arrested,18,4,2,-2,3,33,14,-16,Brandon McInerney,father,PERSON-PERSON,PERSON,PROPN-PROPN,NOUN,compound-pobj,nsubjpass,NNP-NNP,NN,1,1
2897,5486.0,36,said,15,12,7,-5,11,28,3,-8,Crown Prosecution Service,Special Crime Division,ORGANIZATION-ORGANIZATION-ORGANIZATION,ORGANIZATION-ORGANIZATION-ORGANIZATION,PROPN-PROPN-PROPN,PROPN-PROPN-PROPN,compound-compound-pobj,compound-compound-pobj,NNP-NNP-NNP,NNP-NNP-NNP,4,1
2898,5487.0,57,came,9,39,1,-38,38,55,-30,-8,Li Jie,China,PERSON-PERSON,COUNTRY,PROPN-PROPN,PROPN,compound-pobj,poss,NNP-NNP,NNP,13,1
2899,5703.0,8,Jie,1,1,4,3,0,3,0,3,Li Jie,China,PERSON-PERSON,COUNTRY,PROPN-PROPN,PROPN,compound-ROOT,appos,NNP-NNP,NNP,2,1
2900,11845.0,30,downed,8,4,16,12,3,13,4,8,Li Jie,China,PERSON-PERSON,COUNTRY,PROPN-PROPN,PROPN,compound-pobj,poss,NNP-NNP,NNP,4,1
2901,13136.0,57,came,9,39,1,-38,38,55,-30,-8,Li Jie,China,PERSON-PERSON,COUNTRY,PROPN-PROPN,PROPN,compound-pobj,compound,NNP-NNP,NNP,13,1
2902,38932.0,17,scored,7,6,12,6,5,4,1,5,Li Jie,China,PERSON-PERSON,COUNTRY,PROPN-PROPN,PROPN,compound-nsubj,pobj,NNP-NNP,NNP,2,1
2903,47982.0,30,told,8,6,12,6,5,17,2,4,Li Jie,China,PERSON-PERSON,COUNTRY,PROPN-PROPN,PROPN,compound-appos,poss,NNP-NNP,NNP,4,1
2904,55274.0,32,scored,5,1,14,13,0,17,4,9,Li Jie,China,PERSON-PERSON,COUNTRY,PROPN-PROPN,PROPN,compound-nsubj,dobj,NNP-NNP,NNP,3,1
2905,5489.0,39,is,2,9,26,17,8,12,-7,24,her,SRC,PERSON,ORGANIZATION,DET,PROPN,poss,nmod,PRP$,NNP,12,1
2906,5490.0,9,dies,6,1,5,4,0,3,5,-1,Bradford Washburn,explorer,PERSON-PERSON,TITLE,PROPN-PROPN,NOUN,compound-nsubj,appos,NNP-NNP,NN,2,1
2907,10944.0,27,said,25,1,5,4,0,21,24,-20,Bradford Washburn,explorer,PERSON-PERSON,TITLE,PROPN-PROPN,NOUN,compound-nsubj,appos,NNP-NNP,NN,2,1
2908,55062.0,39,died,28,1,5,4,0,33,27,-23,Bradford Washburn,explorer,PERSON-PERSON,TITLE,PROPN-PROPN,NOUN,compound-nsubj,appos,NNP-NNP,NN,2,1
2909,55887.0,38,died,28,1,5,4,0,32,27,-23,Bradford Washburn,explorer,PERSON-PERSON,TITLE,PROPN-PROPN,NOUN,compound-nsubj,appos,NNP-NNP,NN,2,1
2910,67928.0,43,shows,27,8,14,6,7,28,19,-13,Bradford Washburn,explorer,PERSON-PERSON,TITLE,PROPN-PROPN,NOUN,compound-nsubj,conj,NNP-NNP,NN,3,1
2911,5500.0,34,born,4,26,1,-25,25,32,-22,-3,Tema Sloven Kaiser,Philip Mayer Kaiser,PERSON-PERSON-PERSON,PERSON-PERSON-PERSON,PROPN-PROPN-PROPN,PROPN-PROPN-PROPN,compound-compound-conj,compound-compound-nsubjpass,NNP-NNP-NNP,NNP-NNP-NNP,9,1
2912,5502.0,35,survived,2,27,12,-15,26,22,-25,10,Eleanor Derounian,Ann Banks,PERSON-PERSON,PERSON-PERSON,PROPN-PROPN,PROPN-PROPN,compound-conj,compound-conj,NNP-NNP,NNP-NNP,4,1
2913,5504.0,49,gave,30,1,24,23,0,24,29,-6,Richard Perle,US,PERSON-PERSON,COUNTRY,PROPN-PROPN,PROPN,compound-nsubj,pobj,NNP-NNP,NNP,3,1
2914,5531.0,44,says,3,5,43,38,4,0,-2,40,Boyle,Blackburn,PERSON,CITY,PROPN,PROPN,nsubj,pobj,NNP,NNP,10,1
2915,14687.0,11,born,2,1,5,4,0,5,1,3,Boyle,Blackburn,PERSON,CITY,PROPN,PROPN,nsubjpass,pobj,NNP,NNP,4,1
2916,36545.0,42,gathered,4,19,10,-9,18,31,-15,6,Boyle,Blackburn,PERSON,CITY,PROPN,PROPN,dobj,pobj,NNP,NNP,6,1
2917,5532.0,53,told,50,46,49,3,45,3,4,-1,Awami League,Zillur Rahman,ORGANIZATION-ORGANIZATION,PERSON-PERSON,PROPN-PROPN,PROPN-PROPN,compound-compound,compound-nsubj,NNP-NNP,NNP-NNP,4,1
2918,39804.0,31,protested,6,1,5,4,0,25,5,-1,Awami League,Zillur Rahman,ORGANIZATION-ORGANIZATION,PERSON-PERSON,PROPN-PROPN,PROPN-PROPN,compound-compound,compound-nsubj,NNP-NNP,NNP-NNP,2,1
2919,61186.0,43,told,40,36,39,3,35,3,4,-1,Awami League,Zillur Rahman,ORGANIZATION-ORGANIZATION,PERSON-PERSON,PROPN-PROPN,PROPN-PROPN,compound-compound,compound-nsubj,NNP-NNP,NNP-NNP,4,1
2920,66640.0,33,termed,9,2,8,6,1,24,7,-1,Awami League,Zillur Rahman,ORGANIZATION-ORGANIZATION,PERSON-PERSON,PROPN-PROPN,PROPN-PROPN,compound-compound,compound-conj,NNP-NNP,NNP-NNP,2,1
2921,5536.0,26,noticed,1,9,5,-4,8,20,-8,4,he,Jake,PERSON,PERSON,PRON,PROPN,nsubj,compound,PRP,NNP,2,1
2922,5539.0,31,is,2,12,1,-11,11,29,-10,-1,American Bar Association,Her,ORGANIZATION-ORGANIZATION-ORGANIZATION,PERSON,PROPN-PROPN-PROPN,DET,compound-compound-pobj,poss,NNP-NNP-NNP,PRP$,8,1
2923,5542.0,29,said,14,7,13,6,6,15,7,-1,BNC Mortgage,Lehman Brothers,ORGANIZATION-ORGANIZATION,ORGANIZATION-ORGANIZATION,PROPN-PROPN,PROPN-PROPN,compound-compound,compound-nsubj,NNP-NNP,NNP-NNPS,6,1
2924,15392.0,29,undertook,2,20,1,-19,19,27,-18,-1,BNC Mortgage,Lehman Brothers,ORGANIZATION-ORGANIZATION,ORGANIZATION-ORGANIZATION,PROPN-PROPN,PROPN-PROPN,compound-appos,compound-nsubj,NNP-NNP,NNP-NNPS,4,1
2925,32975.0,39,gone,13,20,24,4,19,14,-7,11,BNC Mortgage,Lehman Brothers,ORGANIZATION-ORGANIZATION,ORGANIZATION-ORGANIZATION,PROPN-PROPN,PROPN-PROPN,compound-pobj,compound-nsubj,NNP-NNP,NNP-NNPS,2,1
2926,48743.0,29,said,9,19,8,-11,18,20,-10,-1,BNC Mortgage,Lehman Brothers,ORGANIZATION-ORGANIZATION,ORGANIZATION-ORGANIZATION,PROPN-PROPN,PROPN-PROPN,compound-compound,compound-nsubj,NNP-NNP,NNP-NNPS,5,1
2927,5564.0,46,instituted,23,1,17,16,0,28,22,-6,Thomas J. Meskill,Connecticut,PERSON-PERSON-PERSON,STATE_OR_PROVINCE,PROPN-PROPN-PROPN,PROPN,compound-compound-nsubj,dobj,NNP-NNP-NNP,NNP,3,1
2928,5571.0,31,told,8,27,2,-25,26,28,-19,-6,her,48-year-old,PERSON,DURATION,DET,NUM,poss,amod,PRP$,CD,6,1
2929,5582.0,24,purchased,9,21,1,-20,20,22,-12,-8,ConAgra Foods,Swift,ORGANIZATION-ORGANIZATION,ORGANIZATION,PROPN-PROPN,PROPN,compound-compound,nsubjpass,NNP-NNP,NNP,5,1
2930,5583.0,30,allowed,3,1,20,19,0,9,2,17,Hamilton,McLaren,PERSON,ORGANIZATION,PROPN,PROPN,poss,compound,NNP,NNP,7,1
2931,9091.0,42,Formula,0,4,25,21,3,16,-4,25,Hamilton,McLaren,PERSON,ORGANIZATION,PROPN,PROPN,nsubj,appos,NNP,NNP,7,1
2932,5591.0,19,says,14,4,1,-3,3,17,10,-13,John Negroponte,National Intelligence,PERSON-PERSON,ORGANIZATION-ORGANIZATION,PROPN-PROPN,PROPN-PROPN,compound-nsubj,compound-compound,NNP-NNP,NNP-NNP,2,1
2933,5593.0,37,met,13,11,8,-3,10,28,2,-5,Ali Akbar Salehi,Atomic Energy Organization,PERSON-PERSON-PERSON,ORGANIZATION-ORGANIZATION-ORGANIZATION,PROPN-PROPN-PROPN,PROPN-PROPN-PROPN,compound-compound-pobj,compound-compound-compound,NNP-NNP-NNP,NNP-NNP-NNP,3,1
2934,52071.0,44,said,9,7,3,-4,6,40,2,-6,Ali Akbar Salehi,Atomic Energy Organization,PERSON-PERSON-PERSON,ORGANIZATION-ORGANIZATION-ORGANIZATION,PROPN-PROPN-PROPN,PROPN-PROPN-PROPN,compound-compound-nsubj,compound-compound-compound,NNP-NNP-NNP,NNP-NNP-NNP,3,1
2935,5608.0,32,distanced,14,24,7,-17,23,24,-10,-7,he,Brazilian,PERSON,NATIONALITY,PRON,ADJ,nsubj,amod,PRP,JJ,4,1
2936,5609.0,34,succeed,5,7,30,23,6,3,-2,25,Sheik Abbas Musawi,"February 16 , 1992",PERSON-PERSON-PERSON,DATE-DATE-DATE-DATE,PROPN-PROPN-PROPN,PROPN-NUM-PUNCT-NUM,compound-compound-dobj,pobj-nummod-punct-nummod,NNP-NNP-NNP,"NNP-CD-,-CD",3,1
2937,5610.0,39,said,13,5,1,-4,4,37,8,-12,University of Haifa,Abraham Haim,ORGANIZATION-ORGANIZATION-ORGANIZATION,PERSON-PERSON,PROPN-ADP-PROPN,PROPN-PROPN,nmod-prep-pobj,compound-nsubj,NNP-IN-NNP,NNP-NNP,3,1
2938,5633.0,22,said,13,9,18,9,8,3,4,5,Servicemembers Legal Defense Network,Justice Department,ORGANIZATION-ORGANIZATION-ORGANIZATION-ORGANIZATION,ORGANIZATION-ORGANIZATION,PROPN-PROPN-PROPN-PROPN,PROPN-PROPN,compound-compound-compound-pobj,compound-nsubj,NNP-NNP-NNP-NNP,NNP-NNP,9,1
2939,5639.0,14,Dies,11,1,14,13,0,-1,10,3,Robert McNair,83,PERSON-PERSON,NUMBER,PROPN-PROPN,NUM,compound-nsubj,pobj,NNP-NNP,CD,3,1
2940,33543.0,12,McNair,1,1,12,11,0,-1,0,11,Robert McNair,83,PERSON-PERSON,NUMBER,PROPN-PROPN,NUM,compound-ROOT,appos,NNP-NNP,CD,-1,1
2941,47386.0,73,McNair,1,1,12,11,0,60,0,11,Robert McNair,83,PERSON-PERSON,NUMBER,PROPN-PROPN,NUM,compound-ROOT,dep,NNP-NNP,CD,-1,1
2942,5643.0,17,try,3,2,1,-1,1,15,1,-2,It,http://wwwhongkongdisneylandcom,ORGANIZATION,URL,PRON,X,nsubj,npadvmod,PRP,ADD,2,1
2943,5658.0,32,told,13,7,12,5,6,19,6,-1,Northland Church,Fla.,ORGANIZATION-ORGANIZATION,STATE_OR_PROVINCE,PROPN-PROPN,PROPN,compound-pobj,appos,NNP-NNP,NNP,4,1
2944,32301.0,62,said,16,10,15,5,9,46,6,-1,Northland Church,Fla.,ORGANIZATION-ORGANIZATION,STATE_OR_PROVINCE,PROPN-PROPN,PROPN,compound-pobj,appos,NNP-NNP,NNP,4,1
2945,65082.0,20,advised,15,8,13,5,7,6,7,-2,Northland Church,Fla.,ORGANIZATION-ORGANIZATION,STATE_OR_PROVINCE,PROPN-PROPN,PROPN,compound-pobj,appos,NNP-NNP,NNP,5,1
2946,5663.0,62,told,35,31,34,3,30,27,4,-1,Raul Castro,76,PERSON-PERSON,NUMBER,PROPN-PROPN,NUM,compound-nsubj,appos,NNP-NNP,CD,2,1
2947,18710.0,24,underwent,1,20,23,3,19,0,-19,22,Raul Castro,76,PERSON-PERSON,NUMBER,PROPN-PROPN,NUM,compound-appos,appos,NNP-NNP,CD,5,1
2948,40456.0,25,used,5,1,4,3,0,20,4,-1,Raul Castro,76,PERSON-PERSON,NUMBER,PROPN-PROPN,NUM,compound-nsubj,appos,NNP-NNP,CD,2,1
2949,59437.0,41,touched,7,36,33,-3,35,7,-29,26,Raul Castro,76,PERSON-PERSON,NUMBER,PROPN-PROPN,NUM,compound-dobj,nummod,NNP-NNP,CD,3,1
2950,61200.0,29,is,1,5,8,3,4,20,-4,7,Raul Castro,76,PERSON-PERSON,NUMBER,PROPN-PROPN,NUM,compound-pobj,appos,NNP-NNP,CD,3,1
2951,5668.0,40,said,10,7,38,31,6,1,3,28,Fidelity,Rodger Lawson,ORGANIZATION,PERSON-PERSON,PROPN,PROPN-PROPN,compound,compound-appos,NNP,NNP-NNP,12,1
2952,5677.0,28,said,18,26,20,-6,25,7,-8,2,Medina Hospital,Sheikhdon Salad Elmi,ORGANIZATION-ORGANIZATION,PERSON-PERSON-PERSON,PROPN-PROPN,PROPN-PROPN-PROPN,compound-pobj,compound-compound-nsubj,NNP-NNP,NNP-NNP-NNP,5,1
2953,5696.0,36,filed,8,19,13,-6,18,22,-11,5,Cathleen P. Black,state education,PERSON-PERSON-PERSON,ORGANIZATION-ORGANIZATION,PROPN-PROPN-PROPN,NOUN-NOUN,compound-compound-dobj,compound-compound,NNP-NNP-NNP,NN-NN,7,1
2954,5701.0,42,said,5,1,4,3,0,37,4,-1,MAC,Liu Teh-hsun,ORGANIZATION,PERSON-PERSON,PROPN,PROPN-PROPN,compound,compound-nsubj,NNP,NNP-NNP,3,1
2955,65437.0,55,said,5,1,4,3,0,50,4,-1,MAC,Liu Teh-hsun,ORGANIZATION,PERSON-PERSON,PROPN,PROPN-PROPN,compound,compound-nsubj,NNP,NNP-NNP,3,1
2956,5702.0,47,said,26,36,28,-8,35,18,-10,2,NSC,Liao Ping-hui,ORGANIZATION,PERSON-PERSON,PROPN,PROPN-PROPN,pobj,compound-nsubj,NNP,NNP-NNP,3,1
2957,5706.0,28,was,1,1,5,4,0,22,0,4,Dent,adviser,PERSON,TITLE,PROPN,NOUN,nsubj,attr,NNP,NN,2,1
2958,5713.0,14,received,1,1,11,10,0,2,0,10,Nolte,Yale,PERSON,ORGANIZATION,PROPN,PROPN,nsubj,pobj,NNP,NNP,1,1
2959,5725.0,31,killed,5,1,4,3,0,26,4,-1,Goodman,Andrew,PERSON,PERSON,PROPN,PROPN,poss,appos,NNP,NNP,4,1
2960,29654.0,32,killed,5,1,4,3,0,27,4,-1,Goodman,Andrew,PERSON,PERSON,PROPN,PROPN,poss,appos,NNP,NNP,4,1
2961,36000.0,30,killed,5,1,4,3,0,25,4,-1,Goodman,Andrew,PERSON,PERSON,PROPN,PROPN,poss,appos,NNP,NNP,4,1
2962,5735.0,12,survives,9,11,6,-5,10,5,-2,-3,him,Barbara Teel Polk,PERSON,PERSON-PERSON-PERSON,PRON,PROPN-PROPN-PROPN,dobj,compound-compound-appos,PRP,NNP-NNP-NNP,4,1
2963,5736.0,29,said,2,1,13,12,0,15,1,11,FirstGroup PLC,Laidlaw International,ORGANIZATION-ORGANIZATION,ORGANIZATION-ORGANIZATION,PROPN-PROPN,PROPN-PROPN,compound-nsubj,compound-dobj,NNP-NNP,NNP-NNP,4,1
2964,28463.0,46,says,12,3,23,20,2,22,9,11,FirstGroup PLC,Laidlaw International,ORGANIZATION-ORGANIZATION,ORGANIZATION-ORGANIZATION,PROPN-PROPN,PROPN-PROPN,compound-appos,compound-dobj,NNP-NNP,NNP-NNP,5,1
2965,32213.0,45,says,7,6,14,8,5,30,1,7,FirstGroup PLC,Laidlaw International,ORGANIZATION-ORGANIZATION,ORGANIZATION-ORGANIZATION,PROPN-PROPN,PROPN-PROPN,compound-nsubj,compound-dobj,NNP-NNP,NNP-NNP,4,1
2966,5738.0,27,said,14,22,16,-6,21,10,-8,2,Federal Motor Carrier Safety Administration,John Hill,ORGANIZATION-ORGANIZATION-ORGANIZATION-ORGANIZATION-ORGANIZATION,PERSON-PERSON,PROPN-PROPN-PROPN-PROPN-PROPN,PROPN-PROPN,compound-compound-compound-compound-dobj,compound-nsubj,NNP-NNP-NNP-NNP-NNP,NNP-NNP,5,1
2967,7969.0,48,conceded,26,21,15,-6,20,32,5,-11,Federal Motor Carrier Safety Administration,John Hill,ORGANIZATION-ORGANIZATION-ORGANIZATION-ORGANIZATION-ORGANIZATION,PERSON-PERSON,PROPN-PROPN-PROPN-PROPN-PROPN,PROPN-PROPN,compound-compound-compound-compound-pobj,compound-nsubj,NNP-NNP-NNP-NNP-NNP,NNP-NNP,6,1
2968,20042.0,22,said,11,16,13,-3,15,8,-5,2,Federal Motor Carrier Safety Administration,John Hill,ORGANIZATION-ORGANIZATION-ORGANIZATION-ORGANIZATION-ORGANIZATION,PERSON-PERSON,PROPN-PROPN-PROPN-PROPN-PROPN,PROPN-PROPN,compound-compound-compound-compound-compound,compound-nsubj,NNP-NNP-NNP-NNP-NNP,NNP-NNP,4,1
2969,21211.0,29,says,12,7,1,-6,6,27,5,-11,Federal Motor Carrier Safety Administration,John Hill,ORGANIZATION-ORGANIZATION-ORGANIZATION-ORGANIZATION-ORGANIZATION,PERSON-PERSON,PROPN-PROPN-PROPN-PROPN-PROPN,PROPN-PROPN,compound-compound-compound-compound-pobj,compound-nsubj,NNP-NNP-NNP-NNP-NNP,NNP-NNP,5,1
2970,23043.0,47,testified,34,42,36,-6,41,10,-8,2,Federal Motor Carrier Safety Administration,John Hill,ORGANIZATION-ORGANIZATION-ORGANIZATION-ORGANIZATION-ORGANIZATION,PERSON-PERSON,PROPN-PROPN-PROPN-PROPN-PROPN,PROPN-PROPN,compound-compound-compound-compound-pobj,compound-nsubj,NNP-NNP-NNP-NNP-NNP,NNP-NNP,5,1
2971,43262.0,37,said,24,32,26,-6,31,10,-8,2,Federal Motor Carrier Safety Administration,John Hill,ORGANIZATION-ORGANIZATION-ORGANIZATION-ORGANIZATION-ORGANIZATION,PERSON-PERSON,PROPN-PROPN-PROPN-PROPN-PROPN,PROPN-PROPN,compound-compound-compound-compound-pobj,compound-nsubj,NNP-NNP-NNP-NNP-NNP,NNP-NNP,5,1
2972,55977.0,29,called,13,8,1,-7,7,27,5,-12,Federal Motor Carrier Safety Administration,John Hill,ORGANIZATION-ORGANIZATION-ORGANIZATION-ORGANIZATION-ORGANIZATION,PERSON-PERSON,PROPN-PROPN-PROPN-PROPN-PROPN,PROPN-PROPN,compound-compound-compound-compound-pobj,compound-nsubj,NNP-NNP-NNP-NNP-NNP,NNP-NNP,6,1
2973,57043.0,32,decried,12,7,1,-6,6,30,5,-11,Federal Motor Carrier Safety Administration,John Hill,ORGANIZATION-ORGANIZATION-ORGANIZATION-ORGANIZATION-ORGANIZATION,PERSON-PERSON,PROPN-PROPN-PROPN-PROPN-PROPN,PROPN-PROPN,compound-compound-compound-compound-pobj,compound-nsubj,NNP-NNP-NNP-NNP-NNP,NNP-NNP,5,1
2974,63852.0,38,said,25,33,27,-6,32,10,-8,2,Federal Motor Carrier Safety Administration,John Hill,ORGANIZATION-ORGANIZATION-ORGANIZATION-ORGANIZATION-ORGANIZATION,PERSON-PERSON,PROPN-PROPN-PROPN-PROPN-PROPN,PROPN-PROPN,compound-compound-compound-compound-pobj,compound-nsubj,NNP-NNP-NNP-NNP-NNP,NNP-NNP,5,1
2975,5744.0,7,Corps,6,1,3,2,0,3,5,-3,Chris Simcox,President,PERSON-PERSON,TITLE,PROPN-PROPN,PROPN,compound-compound,compound,NNP-NNP,NNP,3,1
2976,28279.0,21,said,19,18,17,-1,17,3,1,-2,Chris Simcox,President,PERSON-PERSON,TITLE,PROPN-PROPN,PROPN,compound-nsubj,compound,NNP-NNP,NNP,2,1
2977,5751.0,26,collected,3,13,3,-10,12,22,-10,0,Old Lane Partners,Pandit,ORGANIZATION-ORGANIZATION-ORGANIZATION,PERSON,PROPN-PROPN-PROPN,PROPN,compound-compound-appos,nsubj,NNP-NNP-NNPS,NNP,2,1
2978,13306.0,32,bought,5,11,7,-4,10,24,-6,2,Old Lane Partners,Pandit,ORGANIZATION-ORGANIZATION-ORGANIZATION,PERSON,PROPN-PROPN-PROPN,PROPN,compound-compound-appos,poss,NNP-NNP-NNPS,NNP,4,1
2979,24346.0,31,bought,5,11,7,-4,10,23,-6,2,Old Lane Partners,Pandit,ORGANIZATION-ORGANIZATION-ORGANIZATION,PERSON,PROPN-PROPN-PROPN,PROPN,compound-compound-appos,poss,NNP-NNP-NNPS,NNP,4,1
2980,43100.0,32,worked,1,29,1,-28,28,30,-28,0,Old Lane Partners,Pandit,ORGANIZATION-ORGANIZATION-ORGANIZATION,PERSON,PROPN-PROPN-PROPN,NOUN,compound-compound-dobj,nsubj,NNP-NNP-NNPS,NNS,5,1
2981,44196.0,42,said,1,18,4,-14,17,37,-17,3,Old Lane Partners,Pandit,ORGANIZATION-ORGANIZATION-ORGANIZATION,PERSON,PROPN-PROPN-PROPN,PROPN,compound-compound-dobj,nsubj,NNP-NNP-NNPS,NNP,8,1
2982,5755.0,20,Gillmor,6,6,16,10,5,3,0,10,Paul Gillmor,"Washington , DC",PERSON-PERSON,STATE_OR_PROVINCE-STATE_OR_PROVINCE-STATE_OR_PROVINCE,PROPN-PROPN,PROPN-PUNCT-PROPN,compound-ROOT,pobj-punct-compound,NNP-NNP,"NNP-,-NNP",-1,1
2983,5782.0,38,died,33,1,37,36,0,0,32,4,Philip M. Kaiser,Washington,PERSON-PERSON-PERSON,STATE_OR_PROVINCE,PROPN-PROPN-PROPN,PROPN,compound-compound-nsubj,pobj,NNP-NNP-NNP,NNP,3,1
2984,5789.0,32,began,2,25,29,4,24,2,-23,27,Electoral Superior Tribunal,TSE,ORGANIZATION-ORGANIZATION-ORGANIZATION,ORGANIZATION,PROPN-PROPN-PROPN,PROPN,compound-compound-appos,compound,NNP-NNP-NNP,NNP,-1,1
2985,5790.0,41,described,32,12,18,6,11,22,20,-14,Dan Abrams,analyst,PERSON-PERSON,TITLE,PROPN-PROPN,NOUN,compound-pobj,appos,NNP-NNP,NN,2,1
2986,34809.0,51,seems,1,18,23,5,17,27,-17,22,Dan Abrams,analyst,PERSON-PERSON,TITLE,PROPN-PROPN,NOUN,compound-dobj,appos,NNP-NNP,NN,3,1
2987,5793.0,20,said,13,18,17,-1,17,2,-5,4,Herb Gibson,administrator,PERSON-PERSON,TITLE,PROPN-PROPN,NOUN,compound-nsubj,compound,NNP-NNP,NN,2,1
2988,5794.0,47,said,41,1,18,17,0,28,40,-23,Hawkins,Congress,PERSON,ORGANIZATION,PROPN,PROPN,nsubj,pobj,NNP,NNP,2,1
2989,5815.0,31,oversaw,7,3,6,3,2,24,4,-1,FAA,Sharon Pinkerton,ORGANIZATION,PERSON-PERSON,PROPN,PROPN-PROPN,compound,compound-nsubj,NNP,NNP-NNP,2,1
2990,5821.0,22,urged,10,5,4,-1,4,17,5,-6,Barbara Boxer,Chairwoman,PERSON-PERSON,TITLE,PROPN-PROPN,PROPN,compound-nsubj,compound,NNP-NNP,NNP,1,1
2991,5842.0,16,organizing,9,7,14,7,6,1,2,5,he,GOP,PERSON,ORGANIZATION,PRON,PROPN,nsubj,compound,PRP,NNP,4,1
2992,5844.0,29,seem,8,3,21,18,2,7,5,13,Simcox,MCDC,PERSON,ORGANIZATION,PROPN,PROPN,nsubj,compound,NNP,NNP,9,1
2993,5850.0,32,died,6,1,12,11,0,19,5,6,Yolanda Denise King,Santa Monica,PERSON-PERSON-PERSON,CITY-CITY,PROPN-PROPN-PROPN,PROPN-PROPN,compound-compound-nsubj,compound-pobj,NNP-NNP-NNP,NNP-NNP,4,1
2994,5855.0,32,said,22,13,24,11,12,7,9,2,Samsung,Kwon Gye-hyun,ORGANIZATION,PERSON-PERSON,PROPN,PROPN-PROPN,poss,compound-nsubj,NNP,NNP-NNP,6,1
2995,5856.0,85,Sutter,1,1,46,45,0,38,0,45,Trista Sutter,ABC,PERSON-PERSON,ORGANIZATION,PROPN-PROPN,PROPN,compound-ROOT,poss,NNP-NNP,NNP,-1,1
2996,12856.0,69,reporting,36,24,30,6,23,38,12,-6,Trista Sutter,ABC,PERSON-PERSON,ORGANIZATION,PROPN-PROPN,PROPN,compound-conj,poss,NNP-NNP,NNP,8,1
2997,5859.0,40,said,33,2,38,36,1,1,31,5,FirstGroup,Moir Lockhead,ORGANIZATION,PERSON-PERSON,PROPN,PROPN-PROPN,compound,compound-nsubj,NNP,NNP-NNP,5,1
2998,13647.0,40,said,33,2,38,36,1,1,31,5,FirstGroup,Moir Lockhead,ORGANIZATION,PERSON-PERSON,PROPN,PROPN-PROPN,poss,compound-nsubj,NNP,NNP-NNP,5,1
2999,37830.0,35,said,30,26,28,2,25,6,4,-2,FirstGroup,Moir Lockhead,ORGANIZATION,PERSON-PERSON,PROPN,PROPN-PROPN,pobj,compound-appos,NNP,NNP-NNP,2,1
3000,42566.0,34,said,4,1,3,2,0,30,3,-1,FirstGroup,Moir Lockhead,ORGANIZATION,PERSON-PERSON,PROPN,PROPN-PROPN,compound,compound-nsubj,NNP,NNP-NNP,1,1
3001,51737.0,40,said,33,2,38,36,1,1,31,5,FirstGroup,Moir Lockhead,ORGANIZATION,PERSON-PERSON,PROPN,PROPN-PROPN,poss,compound-nsubj,NNP,NNP-NNP,5,1
3002,5865.0,30,show,10,1,4,3,0,25,9,-6,Jake Pavelka,Bachelor,PERSON-PERSON,TITLE,PROPN-PROPN,PROPN,compound-nsubj,nsubj,NNP-NNP,NNP,2,1
3003,9239.0,10,Bachelor,1,4,2,-2,3,7,-3,1,Jake Pavelka,Bachelor,PERSON-PERSON,TITLE,PROPN-PROPN,PROPN,compound-nsubj,ROOT,NNP-NNP,NNP,3,1
3004,32077.0,51,found,37,27,49,22,26,1,10,12,Jake Pavelka,Bachelor,PERSON-PERSON,TITLE,PROPN-PROPN,PROPN,compound-pobj,pobj,NNP-NNP,NNP,14,1
3005,43395.0,17,announces,2,15,14,-1,14,2,-13,12,Jake Pavelka,Bachelor,PERSON-PERSON,TITLE,PROPN-PROPN,PROPN,compound-pobj,compound,NNP-NNP,NNP,1,1
3006,67907.0,49,Weekly,1,47,7,-40,46,41,-46,6,Jake Pavelka,Bachelor,PERSON-PERSON,TITLE,PROPN-PROPN,PROPN,compound-pobj,pobj,NNP-NNP,NNP,9,1
3007,5867.0,27,been,2,10,6,-4,9,20,-8,4,Thomas Ferrara,misconduct,PERSON-PERSON,CRIMINAL_CHARGE,PROPN-PROPN,NOUN,compound-pobj,compound,NNP-NNP,NN,4,1
3008,5870.0,18,forwarded,3,17,12,-5,16,5,-14,9,Bond,executive,PERSON,TITLE,PROPN,ADJ,pobj,amod,NNP,JJ,5,1
3009,5871.0,40,said,19,8,1,-7,7,38,11,-18,National Union for the Total Independence of Angola,Angola,ORGANIZATION-ORGANIZATION-ORGANIZATION-ORGANIZATION-ORGANIZATION-ORGANIZATION-ORGANIZATION-ORGANIZATION,COUNTRY,PROPN-PROPN-ADP-DET-PROPN-PROPN-ADP-PROPN,PROPN,compound-appos-prep-det-compound-pobj-prep-pobj,poss,NNP-NNP-IN-DT-NNP-NNP-IN-NNP,NNP,3,1
3010,51740.0,45,party,4,8,1,-7,7,43,-4,-3,National Union for the Total Independence of Angola,Angola,ORGANIZATION-ORGANIZATION-ORGANIZATION-ORGANIZATION-ORGANIZATION-ORGANIZATION-ORGANIZATION-ORGANIZATION,COUNTRY,PROPN-PROPN-ADP-DET-PROPN-PROPN-ADP-PROPN,PROPN,compound-appos-prep-det-compound-pobj-prep-pobj,poss,NNP-NNP-IN-DT-NNP-NNP-IN-NNP,NNP,3,1
3011,55078.0,42,war,4,21,1,-20,20,40,-17,-3,National Union for the Total Independence of Angola,Angola,ORGANIZATION-ORGANIZATION-ORGANIZATION-ORGANIZATION-ORGANIZATION-ORGANIZATION-ORGANIZATION-ORGANIZATION,COUNTRY,PROPN-PROPN-ADP-DET-PROPN-PROPN-ADP-PROPN,PROPN,compound-conj-prep-det-compound-pobj-prep-pobj,poss,NNP-NNP-IN-DT-NNP-NNP-IN-NNP,NNP,5,1
3012,5875.0,27,gained,16,3,3,0,2,23,13,-13,Tokyo Stock Exchange,Tokyo,ORGANIZATION-ORGANIZATION-ORGANIZATION,CITY,PROPN-PROPN-PROPN,PROPN,compound-compound-pobj,compound,NNP-NNP-NNP,NNP,0,1
3013,5883.0,60,survived,2,1,45,44,0,14,1,43,He,Claudia Crawford McNair,PERSON,PERSON-PERSON-PERSON,PRON,PROPN-PROPN-PROPN,nsubjpass,compound-compound-conj,PRP,NNP-NNP-NNP,11,1
3014,62235.0,60,survived,2,1,45,44,0,14,1,43,He,Claudia Crawford McNair,PERSON,PERSON-PERSON-PERSON,PRON,PROPN-PROPN-PROPN,nsubjpass,compound-compound-conj,PRP,NNP-NNP-NNP,8,1
3015,5892.0,30,said,7,1,3,2,0,26,6,-4,Sheldon,DCF,PERSON,ORGANIZATION,PROPN,PROPN,nsubj,poss,NNP,NNP,4,1
3016,10350.0,26,been,5,10,16,6,9,9,-5,11,Sheldon,DCF,PERSON,ORGANIZATION,PROPN,PROPN,pobj,dobj,NNP,NNP,3,1
3017,24800.0,43,appointed,14,1,18,17,0,24,13,4,Sheldon,DCF,PERSON,ORGANIZATION,PROPN,PROPN,poss,poss,NNP,NNP,-1,1
3018,5902.0,40,died,18,3,15,12,2,24,15,-3,Paul Gillmor,Washington,PERSON-PERSON,STATE_OR_PROVINCE,PROPN-PROPN,PROPN,compound-nsubj,pobj,NNP-NNP,NNP,5,1
3019,20205.0,20,Gillmor,6,6,16,10,5,3,0,10,Paul Gillmor,Washington,PERSON-PERSON,STATE_OR_PROVINCE,PROPN-PROPN,PROPN,compound-ROOT,pobj,NNP-NNP,NNP,-1,1
3020,45200.0,42,choosing,11,28,40,12,27,1,-17,29,Paul Gillmor,Washington,PERSON-PERSON,STATE_OR_PROVINCE,PROPN-PROPN,PROPN,compound-dobj,compound,NNP-NNP,NNP,5,1
3021,5907.0,19,has,1,12,10,-2,11,8,-11,9,Lewis Hamilton,McLaren,PERSON-PERSON,ORGANIZATION,PROPN-PROPN,PROPN,compound-pobj,poss,NNP-NNP,NNP,3,1
3022,25050.0,24,walked,7,6,1,-5,5,22,1,-6,Lewis Hamilton,McLaren,PERSON-PERSON,ORGANIZATION,PROPN-PROPN,PROPN,compound-appos,poss,NNP-NNP,NNP,3,1
3023,26037.0,25,won,4,16,14,-2,15,10,-12,10,Lewis Hamilton,McLaren,PERSON-PERSON,ORGANIZATION,PROPN-PROPN,PROPN,compound-pobj,pobj,NNP-NNP,NNP,1,1
3024,39740.0,38,driven,21,3,1,-2,2,36,18,-20,Lewis Hamilton,McLaren,PERSON-PERSON,ORGANIZATION,PROPN-PROPN,PROPN,compound-nsubj,compound,NNP-NNP,NNP,1,1
3025,43333.0,18,wins,4,3,1,-2,2,16,1,-3,Lewis Hamilton,McLaren,PERSON-PERSON,ORGANIZATION,PROPN-PROPN,PROPN,compound-nsubj,compound,NNP-NNP,NNP,1,1
3026,48670.0,20,leads,4,3,1,-2,2,18,1,-3,Lewis Hamilton,McLaren,PERSON-PERSON,ORGANIZATION,PROPN-PROPN,PROPN,compound-nsubj,poss,NNP-NNP,NNP,2,1
3027,58786.0,37,took,3,12,15,3,11,21,-9,12,Lewis Hamilton,McLaren,PERSON-PERSON,ORGANIZATION,PROPN-PROPN,PROPN,compound-poss,compound,NNP-NNP,NNP,2,1
3028,5917.0,38,called,14,36,12,-24,35,25,-22,-2,Red Cross,Bonnie McElveen-Hunter,ORGANIZATION-ORGANIZATION,PERSON-PERSON,PROPN-PROPN,PROPN-NOUN,compound-pobj,appos-appos,NNP-NNP,NNP-NN,5,1
3029,49524.0,39,Faces,4,2,33,31,1,5,2,29,Red Cross,Bonnie McElveen-Hunter,ORGANIZATION-ORGANIZATION,PERSON-PERSON,PROPN-PROPN,PROPN-NOUN,compound-compound,compound-nsubj,NNP-NNP,NNP-NN,6,1
3030,5939.0,22,stars,8,20,18,-2,19,3,-12,10,Sean Parker,Napster,PERSON-PERSON,ORGANIZATION,PROPN-PROPN,PROPN,compound-pobj,compound,NNP-NNP,NNP,3,1
3031,6029.0,32,features,17,26,24,-2,25,7,-9,7,Sean Parker,Napster,PERSON-PERSON,ORGANIZATION,PROPN-PROPN,PROPN,compound-pobj,compound,NNP-NNP,NNP,1,1
3032,8083.0,34,played,9,7,5,-2,6,28,2,-4,Sean Parker,Napster,PERSON-PERSON,ORGANIZATION,PROPN-PROPN,PROPN,compound-pobj,compound,NNP-NNP,NNP,1,1
3033,13207.0,28,talking,14,1,7,6,0,20,13,-7,Sean Parker,Napster,PERSON-PERSON,ORGANIZATION,PROPN-PROPN,PROPN,compound-nsubj,pobj,NNP-NNP,NNP,4,1
3034,13588.0,18,portrays,4,6,11,5,5,6,-2,7,Sean Parker,Napster,PERSON-PERSON,ORGANIZATION,PROPN-PROPN,PROPN,compound-dobj,pobj,NNP-NNP,NNP,1,1
3035,17045.0,31,-LRB-,1,6,12,6,5,18,-5,11,Sean Parker,Napster,PERSON-PERSON,ORGANIZATION,PROPN-PROPN,PROPN,compound-nsubj,pobj,NNP-NNP,NNP,-1,1
3036,17807.0,36,founded,2,21,30,9,20,5,-19,28,Sean Parker,Napster,PERSON-PERSON,ORGANIZATION,PROPN-PROPN,PROPN,compound-conj,pobj,NNP-NNP,NNP,3,1
3037,25521.0,9,co-stars,2,7,5,-2,6,3,-5,3,Sean Parker,Napster,PERSON-PERSON,ORGANIZATION,PROPN-PROPN,PROPN,compound-pobj,compound,NNP-NNP,NNP,2,1
3038,44536.0,25,stars,5,19,17,-2,18,7,-14,12,Sean Parker,Napster,PERSON-PERSON,ORGANIZATION,PROPN-PROPN,PROPN,compound-pobj,compound,NNP-NNP,NNP,3,1
3039,48024.0,41,was,1,39,37,-2,38,3,-38,36,Sean Parker,Napster,PERSON-PERSON,ORGANIZATION,PROPN-PROPN,PROPN,compound-conj,compound,NNP-NNP,NNP,9,1
3040,48343.0,53,has,1,41,39,-2,40,13,-40,38,Sean Parker,Napster,PERSON-PERSON,ORGANIZATION,PROPN-PROPN,PROPN,compound-pobj,compound,NNP-NNP,NNP,3,1
3041,53022.0,54,shown,6,34,32,-2,33,21,-28,26,Sean Parker,Napster,PERSON-PERSON,ORGANIZATION,PROPN-PROPN,PROPN,compound-pobj,compound,NNP-NNP,NNP,1,1
3042,55729.0,28,began,13,23,19,-4,22,8,-10,6,Sean Parker,Napster,PERSON-PERSON,ORGANIZATION,PROPN-PROPN,NOUN,compound-dobj,compound,NNP-NNP,NN,3,1
3043,5953.0,64,recalled,27,1,25,24,0,38,26,-2,Mark Buse,Senate,PERSON-PERSON,ORGANIZATION,PROPN-PROPN,PROPN,compound-nsubj,compound,NNP-NNP,NNP,4,1
3044,24262.0,38,contacted,7,33,28,-5,32,9,-26,21,Mark Buse,Senate,PERSON-PERSON,ORGANIZATION,PROPN-PROPN,PROPN,compound-appos,compound,NNP-NNP,NNP,3,1
3045,43843.0,36,'s,1,22,26,4,21,9,-21,25,Mark Buse,Senate,PERSON-PERSON,ORGANIZATION,PROPN-PROPN,PROPN,compound-dobj,compound,NNP-NNP,NNP,1,1
3046,53643.0,31,registered,23,8,3,-5,7,27,15,-20,Mark Buse,Senate,PERSON-PERSON,ORGANIZATION,PROPN-PROPN,PROPN,compound-appos,compound,NNP-NNP,NNP,1,1
3047,58286.0,14,operative,1,9,6,-3,8,7,-8,5,Mark Buse,Senate,PERSON-PERSON,ORGANIZATION,PROPN-PROPN,PROPN,compound-appos,compound,NNP-NNP,NNP,3,1
3048,5955.0,74,included,22,67,64,-3,66,9,-45,42,Asian Development Bank,McDonald,ORGANIZATION-ORGANIZATION-ORGANIZATION,ORGANIZATION,PROPN-PROPN-PROPN,PROPN,compound-compound-conj,npadvmod,NNP-NNP-NNP,NNP,3,1
3049,5958.0,43,are,2,31,34,3,30,8,-29,32,AQR,Clifford S Asness,ORGANIZATION,PERSON-PERSON-PERSON,PROPN,PROPN-PROPN-PROPN,pobj,compound-compound-conj,NNP,NNP-NNP-NNP,3,1
3050,5974.0,69,confirmed,22,10,21,11,9,47,12,-1,NSC,Chen Chien-jen,ORGANIZATION,PERSON-PERSON,PROPN,PROPN-PROPN,compound,appos-punct,NNP,NNP-NNP,4,1
3051,61997.0,56,presented,4,1,3,2,0,52,3,-1,NSC,Chen Chien-jen,ORGANIZATION,PERSON-PERSON,PROPN,PROPN-PROPN,compound,nsubj-punct,NNP,NNP-NNP,2,1
3052,63279.0,56,said,33,45,35,-10,44,20,-12,2,NSC,Chen Chien-jen,ORGANIZATION,PERSON-PERSON,PROPN,PROPN-PROPN,compound,compound-nsubj,NNP,NNP-NNP,3,1
3053,5975.0,42,lost,4,18,1,-17,17,40,-14,-3,Arsenal,Wenger,ORGANIZATION,PERSON,PROPN,PROPN,compound,poss,NNP,NNP,7,1
3054,5977.0,20,oversee,12,1,6,5,0,13,11,-6,Kelly Cutrone,publicist,PERSON-PERSON,TITLE,PROPN-PROPN,NOUN,compound-nsubj,appos,NNP-NNP,NN,2,1
3055,5996.0,86,YORK,1,17,63,46,16,22,-16,62,Zagat,Nicholas Negroponte,ORGANIZATION,PERSON-PERSON,PROPN,PROPN-PROPN,pobj,compound-conj,NNP,NNP-NNP,6,1
3056,5999.0,41,continue,20,32,8,-24,31,32,-12,-12,Dan Abrams,host,PERSON-PERSON,TITLE,PROPN-PROPN,NOUN,compound-pobj,pobj,NNP-NNP,NN,8,1
3057,36260.0,48,slammed,11,10,26,16,9,21,1,15,Dan Abrams,host,PERSON-PERSON,TITLE,PROPN-PROPN,NOUN,compound-pobj,compound,NNP-NNP,NN,9,1
3058,57347.0,23,announced,19,3,6,3,2,16,16,-13,Dan Abrams,host,PERSON-PERSON,TITLE,PROPN-PROPN,NOUN,compound-dobj,appos,NNP-NNP,NN,2,1
3059,6000.0,28,party,4,7,16,9,6,11,-3,12,National Union of the Total Independence of Angola,UNIYA,ORGANIZATION-ORGANIZATION-ORGANIZATION-ORGANIZATION-ORGANIZATION-ORGANIZATION-ORGANIZATION-ORGANIZATION,ORGANIZATION,PROPN-PROPN-ADP-DET-PROPN-PROPN-ADP-PROPN,PROPN,compound-appos-prep-det-compound-pobj-prep-pobj,compound,NNP-NNP-IN-DT-NNP-NNP-IN-NNP,NNP,-1,1
3060,6004.0,30,focus,19,10,16,6,9,13,9,-3,USA Network,Bonnie Hammer,ORGANIZATION-ORGANIZATION,PERSON-PERSON,PROPN-PROPN,PROPN-PROPN,compound-pobj,compound-conj,NNP-NNP,NNP-NNP,1,1
3061,6339.0,29,said,1,19,22,3,18,6,-18,21,USA Network,Bonnie Hammer,ORGANIZATION-ORGANIZATION,PERSON-PERSON,PROPN-PROPN,PROPN-PROPN,compound-compound,compound-pobj,NNP-NNP,NNP-NNP,2,1
3062,47808.0,40,said,27,34,29,-5,33,10,-7,2,USA Network,Bonnie Hammer,ORGANIZATION-ORGANIZATION,PERSON-PERSON,PROPN-PROPN,PROPN-PROPN,compound-pobj,compound-nsubj,NNP-NNP,NNP-NNP,3,1
3063,6016.0,66,said,61,55,7,-48,54,58,6,-54,MBIA,Warburg Pincus,ORGANIZATION,ORGANIZATION-ORGANIZATION,PROPN,PROPN-PROPN,poss,compound-pobj,NNP,NNP-NNP,8,1
3064,52643.0,23,said,1,3,11,8,2,11,-2,10,MBIA,Warburg Pincus,ORGANIZATION,PERSON-PERSON,PROPN,PROPN-PROPN,nsubj,compound-pobj,NNP,NNP-NNP,3,1
3065,6034.0,39,convicted,17,9,25,16,8,13,8,8,he,perjury,PERSON,CRIMINAL_CHARGE,PRON,NOUN,nsubjpass,pobj,PRP,NN,8,1
3066,44059.0,35,indicted,3,8,12,4,7,22,-5,9,he,perjury,PERSON,CRIMINAL_CHARGE,PRON,NOUN,nsubjpass,pobj,PRP,NN,2,1
3067,6035.0,39,provided,4,36,28,-8,35,10,-32,24,Red Cross,Clara Barton,ORGANIZATION-ORGANIZATION,PERSON-PERSON,PROPN-PROPN,PROPN-PROPN,compound-compound,compound-conj,NNP-NNP,NNP-NNP,-1,1
3068,6036.0,26,performed,7,3,7,4,2,18,4,0,Washburn,he,PERSON,PERSON,PROPN,PRON,pobj,nsubj,NNP,PRP,4,1
3069,6048.0,35,accused,3,5,9,4,4,25,-2,6,him,her,PERSON,PERSON,PRON,DET,dobj,poss,PRP,PRP$,2,1
3070,15194.0,27,elected,24,16,13,-3,15,13,8,-11,him,her,PERSON,PERSON,PRON,DET,pobj,poss,PRP,PRP$,2,1
3071,46706.0,14,said,1,10,4,-6,9,9,-9,3,him,her,PERSON,PERSON,PRON,DET,dobj,poss,PRP,PRP$,3,1
3072,6054.0,37,married,12,12,21,9,11,15,0,9,she,Stockholm,PERSON,CITY,PRON,PROPN,nsubj,pobj,PRP,NNP,4,1
3073,40865.0,37,married,12,12,21,9,11,15,0,9,she,Stockholm,PERSON,CITY,PRON,PROPN,nsubj,pobj,PRP,NNP,4,1
3074,6057.0,19,attended,1,1,3,2,0,15,0,2,He,Oxford University,PERSON,ORGANIZATION-ORGANIZATION,PRON,PROPN-PROPN,nsubj,compound-dobj,PRP,NNP-NNP,1,1
3075,6058.0,27,married,12,12,9,-3,11,17,0,-3,he,Yale University,PERSON,ORGANIZATION-ORGANIZATION,PRON,PROPN-PROPN,nsubj,compound-conj,PRP,NNP-NNP,3,1
3076,6066.0,34,told,5,1,4,3,0,29,4,-1,IMF,Ajai Chopra,ORGANIZATION,PERSON-PERSON,PROPN,PROPN-PROPN,compound,compound-nsubj,NNP,NNP-NNP,2,1
3077,6078.0,43,approve,6,14,21,7,13,21,-8,15,Nuclear Suppliers Group,U.S.,ORGANIZATION-ORGANIZATION-ORGANIZATION,COUNTRY,PROPN-PROPN-PROPN,PROPN,compound-compound-nsubj,compound,NNP-NNPS-NNP,NNP,2,1
3078,6083.0,17,investigating,13,12,8,-4,11,8,1,-5,Gillmor,House Finance Committee,PERSON,ORGANIZATION-ORGANIZATION-ORGANIZATION,PROPN,PROPN-PROPN-PROPN,nsubj,compound-compound-pobj,NNP,NNP-NNP-NNP,8,1
3079,6084.0,52,live,5,3,5,2,2,46,2,0,she,Ryan,PERSON,PERSON,PRON,PROPN,nsubj,conj,PRP,NNP,2,1
3080,6089.0,16,retired,1,1,4,3,0,11,0,3,He,director,PERSON,TITLE,PRON,NOUN,nsubj,pobj,PRP,NN,1,1
3081,20007.0,31,was,1,1,3,2,0,27,0,2,He,director,PERSON,TITLE,PRON,NOUN,nsubj,attr,PRP,NN,2,1
3082,53052.0,21,served,2,1,5,4,0,15,1,3,He,director,PERSON,TITLE,PRON,NOUN,nsubj,pobj,PRP,NN,4,1
3083,66596.0,25,said,21,2,17,15,1,7,19,-4,He,director,PERSON,TITLE,PRON,NOUN,nsubj,pobj,PRP,NN,6,1
3084,6090.0,40,said,32,34,38,4,33,1,-2,6,Red Cross,Joseph Becker,ORGANIZATION-ORGANIZATION,PERSON-PERSON,PROPN-PROPN,PROPN-PROPN,compound-compound,compound-nsubj,NNP-NNP,NNP-NNP,2,1
3085,6092.0,64,recalled,27,1,10,9,0,53,26,-17,Mark Buse,chief of staff,PERSON-PERSON,TITLE-TITLE-TITLE,PROPN-PROPN,ADJ-ADP-NOUN,compound-nsubj,acomp-prep-pobj,NNP-NNP,JJ-IN-NN,4,1
3086,16664.0,64,recalled,27,1,10,9,0,53,26,-17,Mark Buse,chief of staff,PERSON-PERSON,TITLE-TITLE-TITLE,PROPN-PROPN,NOUN-ADP-NOUN,compound-nsubj,pobj-prep-pobj,NNP-NNP,NN-IN-NN,4,1
3087,19263.0,48,Labels,0,12,43,31,11,4,-12,43,Mark Buse,chief of staff,PERSON-PERSON,TITLE-TITLE-TITLE,PROPN-PROPN,NOUN-ADP-NOUN,compound-appos,dobj-prep-pobj,NNP-NNP,NN-IN-NN,9,1
3088,6110.0,46,called,2,7,5,-2,6,40,-5,3,Farrow,American,PERSON,NATIONALITY,PROPN,ADJ,appos,amod,NNP,JJ,2,1
3089,6117.0,22,said,4,3,16,13,2,5,1,12,Hugo Chavez,Venezuela,PERSON-PERSON,COUNTRY,PROPN-PROPN,PROPN,compound-nsubj,pobj,NNP-NNP,NNP,3,1
3090,10614.0,31,nationalized,5,2,7,5,1,23,3,2,Hugo Chavez,Venezuela,PERSON-PERSON,COUNTRY,PROPN-PROPN,PROPN,compound-poss,poss,NNP-NNP,NNP,5,1
3091,16017.0,33,reported,30,17,6,-11,16,26,13,-24,Hugo Chavez,Venezuela,PERSON-PERSON,COUNTRY,PROPN-PROPN,PROPN,compound-poss,poss,NNP-NNP,NNP,9,1
3092,23051.0,32,shed,7,23,3,-20,22,28,-16,-4,Hugo Chavez,Venezuela,PERSON-PERSON,NATIONALITY,PROPN-PROPN,PROPN,compound-nsubj,poss,NNP-NNP,NNP,8,1
3093,29759.0,34,appointed,6,5,11,6,4,22,1,5,Hugo Chavez,Venezuela,PERSON-PERSON,COUNTRY,PROPN-PROPN,PROPN,compound-pobj,poss,NNP-NNP,NNP,8,1
3094,31382.0,34,announced,3,2,9,7,1,24,1,6,Hugo Chavez,Venezuela,PERSON-PERSON,ORGANIZATION,PROPN-PROPN,PROPN,compound-nsubj,poss,NNP-NNP,NNP,5,1
3095,34876.0,23,CARACAS,0,8,20,12,7,2,-8,20,Hugo Chavez,Venezuela,PERSON-PERSON,COUNTRY,PROPN-PROPN,PROPN,compound-nsubjpass,poss,NNP-NNP,NNP,5,1
3096,47263.0,41,used,18,1,7,6,0,33,17,-11,Hugo Chavez,Venezuela,PERSON-PERSON,COUNTRY,PROPN-PROPN,PROPN,compound-nsubj,pobj,NNP-NNP,NNP,2,1
3097,52768.0,39,Venezuela,1,12,2,-10,11,36,-11,1,Hugo Chavez,Venezuela,PERSON-PERSON,ORGANIZATION,PROPN-PROPN,PROPN,compound-nsubj,ROOT,NNP-NNP,NNP,3,1
3098,59707.0,56,escalated,3,26,29,3,25,26,-23,26,Hugo Chavez,Venezuela,PERSON-PERSON,COUNTRY,PROPN-PROPN,PROPN,compound-pobj,pobj,NNP-NNP,NNP,6,1
3099,64968.0,36,said,3,2,33,31,1,2,1,30,Hugo Chavez,Venezuela,PERSON-PERSON,COUNTRY,PROPN-PROPN,PROPN,compound-nsubj,pobj,NNP-NNP,NNP,9,1
3100,6121.0,52,parties,3,19,15,-4,18,36,-16,12,ANP,Awami National Party,ORGANIZATION,ORGANIZATION-ORGANIZATION-ORGANIZATION,PROPN,PROPN-PROPN-PROPN,compound,compound-compound-conj,NNP,NNP-NNP-NNP,4,1
3101,9468.0,40,Party,3,6,2,-4,5,37,-3,-1,ANP,Awami National Party,ORGANIZATION,ORGANIZATION-ORGANIZATION-ORGANIZATION,PROPN,PROPN-PROPN-PROPN,compound,compound-compound-ROOT,NNP,NNP-NNP-NNP,3,1
3102,24944.0,43,sprinted,5,41,37,-4,40,5,-36,32,ANP,Awami National Party,ORGANIZATION,ORGANIZATION-ORGANIZATION-ORGANIZATION,PROPN,PROPN-PROPN-PROPN,compound,compound-compound-conj,NNP,NNP-NNP-NNP,5,1
3103,43916.0,26,linked,3,17,13,-4,16,12,-14,10,ANP,Awami National Party,ORGANIZATION,ORGANIZATION-ORGANIZATION-ORGANIZATION,PROPN,PROPN-PROPN-PROPN,compound,compound-compound-pobj,NNP,NNP-NNP-NNP,2,1
3104,54706.0,21,killed,2,11,7,-4,10,13,-9,5,ANP,Awami National Party,ORGANIZATION,ORGANIZATION-ORGANIZATION-ORGANIZATION,PROPN,PROPN-PROPN-PROPN,compound,compound-compound-pobj,NNP,NNP-NNP-NNP,6,1
3105,60783.0,40,is,1,13,9,-4,12,30,-12,8,ANP,Awami National Party,ORGANIZATION,ORGANIZATION-ORGANIZATION-ORGANIZATION,PROPN,PROPN-PROPN-PROPN,compound,compound-compound-pobj,NNP,NNP-NNP-NNP,2,1
3106,66025.0,33,seen,4,12,8,-4,11,24,-8,4,ANP,Awami National Party,ORGANIZATION,ORGANIZATION-ORGANIZATION-ORGANIZATION,PROPN,PROPN-PROPN-PROPN,compound,compound-compound-dobj,NNP,NNP-NNP-NNP,3,1
3107,6141.0,45,KYOTO,0,6,3,-3,5,41,-6,3,Asian Development Bank,Japan,ORGANIZATION-ORGANIZATION-ORGANIZATION,COUNTRY,PROPN-PROPN-PROPN,PROPN,compound-compound-nsubj,conj,NNP-NNP-NNP,NNP,4,1
3108,20750.0,66,says,1,3,19,16,2,46,-2,18,Asian Development Bank,Japan,ORGANIZATION-ORGANIZATION-ORGANIZATION,PERSON,PROPN-PROPN-PROPN,PROPN,compound-compound-nsubj,pobj,NNP-NNP-NNP,NNP,3,1
3109,6146.0,35,sponsored,7,21,15,-6,20,19,-14,8,his,president,PERSON,TITLE,DET,NOUN,poss,dobj,PRP$,NN,6,1
3110,15461.0,46,Party,3,18,9,-9,17,36,-15,6,his,president,PERSON,TITLE,DET,NOUN,poss,nsubjpass,PRP$,NN,6,1
3111,17271.0,28,had,13,15,21,6,14,6,-2,8,his,president,PERSON,TITLE,DET,NOUN,poss,attr,PRP$,NN,5,1
3112,46153.0,26,was,1,17,25,8,16,0,-16,24,his,president,PERSON,TITLE,DET,NOUN,poss,pobj,PRP$,NN,5,1
3113,60142.0,41,told,16,10,25,15,9,15,6,9,his,president,PERSON,TITLE,DET,NOUN,poss,nsubj,PRP$,NN,8,1
3114,6148.0,29,said,18,26,20,-6,25,8,-8,2,Federal Election Commission,Michael Toner,ORGANIZATION-ORGANIZATION-ORGANIZATION,PERSON-PERSON,PROPN-PROPN-PROPN,PROPN-PROPN,compound-compound-pobj,compound-nsubj,NNP-NNP-NNP,NNP-NNP,5,1
3115,18370.0,28,told,24,19,23,4,18,4,5,-1,Federal Election Commission,Michael Toner,ORGANIZATION-ORGANIZATION-ORGANIZATION,PERSON-PERSON,PROPN-PROPN-PROPN,PROPN-PROPN,compound-compound-compound,compound-nsubj,NNP-NNP-NNP,NNP-NNP,4,1
3116,21276.0,37,said,8,18,10,-8,17,26,-10,2,Federal Election Commission,Michael Toner,ORGANIZATION-ORGANIZATION-ORGANIZATION,PERSON-PERSON,PROPN-PROPN-PROPN,PROPN-PROPN,compound-compound-pobj,compound-nsubj,NNP-NNP-NNP,NNP-NNP,4,1
3117,50473.0,31,said,19,28,21,-7,27,9,-9,2,Federal Election Commission,Michael Toner,ORGANIZATION-ORGANIZATION-ORGANIZATION,PERSON-PERSON,PROPN-PROPN-PROPN,PROPN-PROPN,compound-compound-pobj,compound-nsubj,NNP-NNP-NNP,NNP-NNP,4,1
3118,6153.0,31,launched,12,5,2,-3,4,28,7,-10,Robert Morgenthau,Manhattan,PERSON-PERSON,CITY,PROPN-PROPN,PROPN,compound-nsubj,compound,NNP-NNP,NNP,2,1
3119,19350.0,39,admired,2,10,4,-6,9,34,-8,2,Robert Morgenthau,Manhattan,PERSON-PERSON,CITY,PROPN-PROPN,PROPN,compound-appos,poss,NNP-NNP,NNP,3,1
3120,27480.0,31,announced,5,4,1,-3,3,29,1,-4,Robert Morgenthau,Manhattan,PERSON-PERSON,ORGANIZATION,PROPN-PROPN,PROPN,compound-nsubj,compound,NNP-NNP,NNP,2,1
3121,6171.0,34,died,28,1,5,4,0,28,27,-23,Vernon Bellecourt,Ojibwa Indian,PERSON-PERSON,NATIONALITY-NATIONALITY,PROPN-PROPN,PROPN-PROPN,compound-nsubj,compound-appos,NNP-NNP,NNP-NNP,1,1
3122,6180.0,17,is,10,13,16,3,12,0,-3,6,Barbara Boxer,D-Calif,PERSON-PERSON,LOCATION,PROPN-PROPN,PROPN,compound-attr,appos,NNP-NNP,NNP,1,1
3123,6182.0,37,said,35,27,34,7,26,2,8,-1,New South Wales Rugby Union,Jim L'Estrange,ORGANIZATION-ORGANIZATION-ORGANIZATION-ORGANIZATION-ORGANIZATION,PERSON-PERSON,PROPN-PROPN-PROPN-PROPN-PROPN,PROPN-PROPN,compound-compound-compound-nmod-nmod,compound-nsubj,NNP-NNP-NNP-NNP-NNP,NNP-NNP,4,1
3124,36163.0,50,confirm,1,12,19,7,11,30,-11,18,New South Wales Rugby Union,Jim L'Estrange,ORGANIZATION-ORGANIZATION-ORGANIZATION-ORGANIZATION-ORGANIZATION,PERSON-PERSON,PROPN-PROPN-PROPN-PROPN-PROPN,PROPN-PROPN,compound-compound-compound-nmod-nmod,compound-nsubj,NNP-NNP-NNP-NNP-NNP,NNP-NNP,4,1
3125,59780.0,39,confirmed,9,1,8,7,0,30,8,-1,New South Wales Rugby Union,Jim L'Estrange,ORGANIZATION-ORGANIZATION-ORGANIZATION-ORGANIZATION-ORGANIZATION,PERSON-PERSON,PROPN-PROPN-PROPN-PROPN-PROPN,PROPN-PROPN,compound-compound-compound-nmod-nmod,compound-nsubj,NNP-NNP-NNP-NNP-NNP,NNP-NNP,4,1
3126,6194.0,35,challenging,30,25,16,-9,24,18,5,-14,United National Congress,Winston Dookeran,ORGANIZATION-ORGANIZATION-ORGANIZATION,PERSON-PERSON,PROPN-PROPN-PROPN,PROPN-PROPN,compound-compound-compound,compound-pobj,NNP-NNP-NNP,NNP-NNP,5,1
3127,31902.0,33,launched,20,27,31,4,26,1,-7,11,United National Congress,Winston Dookeran,ORGANIZATION-ORGANIZATION-ORGANIZATION,PERSON-PERSON,PROPN-PROPN-PROPN,PROPN-PROPN,compound-compound-compound,compound-pobj,NNP-NNP-NNP,NNP-NNP,1,1
3128,6197.0,34,was,10,6,29,23,5,4,4,19,his,mechanic,PERSON,TITLE,DET,NOUN,poss,pobj,PRP$,NN,5,1
3129,6199.0,35,needs,3,9,2,-7,8,32,-6,-1,Nuclear Suppliers Group,India,ORGANIZATION-ORGANIZATION-ORGANIZATION,COUNTRY,PROPN-PROPN-PROPN,PROPN,compound-compound-pobj,nsubj,NNP-NNPS-NNP,NNP,5,1
3130,6201.0,36,made,2,15,21,6,14,14,-13,19,SAC,Taipei City,ORGANIZATION,LOCATION-LOCATION,PROPN,PROPN-PROPN,pobj,compound-pobj,NNP,NNP-NNP,4,1
3131,6204.0,38,came,2,22,25,3,21,12,-20,23,Paul Kim,24,PERSON-PERSON,NUMBER,PROPN-PROPN,NUM,compound-appos,appos,NNP-NNP,CD,2,1
3132,6206.0,34,said,32,3,15,12,2,18,29,-17,Jo Ann Davis,Representatives,PERSON-PERSON-PERSON,TITLE,PROPN-PROPN-PROPN,PROPN,compound-compound-nsubj,pobj,NNP-NNP-NNP,NNPS,3,1
3133,6213.0,69,include,5,23,17,-6,22,51,-18,12,Jennifer Dunn,Associated Press,PERSON-PERSON,ORGANIZATION-ORGANIZATION,PROPN-PROPN,PROPN-PROPN,compound-appos,compound-pobj,NNP-NNP,NNP-NNP,4,1
3134,6217.0,29,UTC,5,22,27,5,21,1,-17,22,Mamoor Khan,police official,PERSON-PERSON,TITLE-TITLE,PROPN-PROPN,NOUN-NOUN,compound-nsubj,compound-appos,NNP-NNP,NN-NN,3,1
3135,6228.0,21,alleged,5,8,3,-5,7,17,-3,-2,he,Iraqi,PERSON,NATIONALITY,PRON,ADJ,nsubjpass,amod,PRP,JJ,3,1
3136,6232.0,27,retired,1,1,25,24,0,1,0,24,Sills,City Opera,PERSON,ORGANIZATION-ORGANIZATION,NOUN,PROPN-PROPN,nsubj,compound-pobj,NNS,NNP-NNP,5,1
3137,25540.0,21,joined,3,3,5,2,2,15,0,2,Sills,City Opera,PERSON,ORGANIZATION-ORGANIZATION,PROPN,PROPN-PROPN,nsubj,compound-dobj,NNP,NNP-NNP,1,1
3138,6234.0,39,announced,2,14,22,8,13,16,-12,20,Cathleen P Black,chairman,PERSON-PERSON-PERSON,TITLE,PROPN-PROPN-PROPN,NOUN,compound-compound-appos,pobj,NNP-NNP-NNP,NN,6,1
3139,6241.0,27,Council,3,6,9,3,5,17,-3,6,NSC,Taiwan,ORGANIZATION,STATE_OR_PROVINCE,PROPN,PROPN,compound,pobj,NNP,NNP,1,1
3140,7870.0,33,reported,30,8,1,-7,7,31,22,-29,NSC,Taiwan,ORGANIZATION,STATE_OR_PROVINCE,PROPN,PROPN,compound,poss,NNP,NNP,4,1
3141,25046.0,42,said,39,7,1,-6,6,40,32,-38,NSC,Taiwan,ORGANIZATION,COUNTRY,PROPN,PROPN,compound,poss,NNP,NNP,3,1
3142,6242.0,35,is,4,10,3,-7,9,31,-6,-1,his,57,PERSON,NUMBER,DET,NUM,poss,appos,PRP$,CD,3,1
3143,51639.0,34,is,4,9,3,-6,8,30,-5,-1,his,57,PERSON,NUMBER,DET,NUM,poss,appos,PRP$,CD,3,1
3144,55034.0,26,considered,5,15,3,-12,14,22,-10,-2,his,57,PERSON,NUMBER,DET,NUM,poss,appos,PRP$,CD,5,1
3145,6249.0,37,unveil,17,2,1,-1,1,35,15,-16,John Kerry,Senator,PERSON-PERSON,TITLE,PROPN-PROPN,PROPN,compound-nsubj,compound,NNP-NNP,NNP,1,1
3146,13719.0,34,announced,17,2,1,-1,1,32,15,-16,John Kerry,Senator,PERSON-PERSON,TITLE,PROPN-PROPN,PROPN,compound-nsubj,compound,NNP-NNP,NNP,1,1
3147,46190.0,44,said,31,42,41,-1,41,2,-11,10,John Kerry,Senator,PERSON-PERSON,TITLE,PROPN-PROPN,PROPN,compound-appos,compound,NNP-NNP,NNP,2,1
3148,66123.0,30,noted,16,13,12,-1,12,17,3,-4,John Kerry,Senator,PERSON-PERSON,TITLE,PROPN-PROPN,PROPN,compound-pobj,compound,NNP-NNP,NNP,1,1
3149,6256.0,26,vowed,4,13,10,-3,12,15,-9,6,Lewis Hamilton,McLaren Mercedes-Benz,PERSON-PERSON,ORGANIZATION-ORGANIZATION,PROPN-PROPN,PROPN-PROPN,compound-dative,compound-compound,NNP-NNP,NNP-NNP,2,1
3150,6257.0,20,said,8,6,5,-1,5,14,2,-3,Brian McFadden,singer,PERSON-PERSON,TITLE,PROPN-PROPN,NOUN,compound-appos,nsubj,NNP-NNP,NN,1,1
3151,6260.0,13,was,8,1,5,4,0,7,7,-3,Buchwald,recently,PERSON,DATE,PROPN,ADV,nsubj,advmod,NNP,RB,3,1
3152,6261.0,35,said,19,14,18,4,13,16,5,-1,Oxford University Press,Pakistan,ORGANIZATION-ORGANIZATION-ORGANIZATION,COUNTRY,PROPN-PROPN-PROPN,PROPN,compound-compound-appos,appos,NNP-NNP-NNP,NNP,4,1
3153,6264.0,18,has,2,2,1,-1,1,16,0,-1,IPSCO,Illinois-based,ORGANIZATION,STATE_OR_PROVINCE,PROPN,VERB,nsubj,amod,NNP,VBN,1,1
3154,6269.0,30,said,4,1,3,2,0,26,3,-1,ANP,Shahi Syed,ORGANIZATION,PERSON-PERSON,PROPN,PROPN-PROPN,compound,compound-nsubj,NNP,NNP-NNP,1,1
3155,6278.0,41,thanked,14,26,16,-10,25,24,-12,2,his,President,PERSON,TITLE,DET,PROPN,poss,compound,PRP$,NNP,5,1
3156,25628.0,29,said,2,24,20,-4,23,8,-22,18,his,President,PERSON,TITLE,DET,PROPN,poss,compound,PRP$,NNP,5,1
3157,29455.0,42,led,4,12,2,-10,11,39,-8,-2,his,President,PERSON,TITLE,DET,PROPN,poss,compound,PRP$,NNP,5,1
3158,37404.0,52,were,32,27,23,-4,26,28,5,-9,his,President,PERSON,TITLE,DET,PROPN,poss,compound,PRP$,NNP,4,1
3159,42492.0,40,inaugurated,16,10,5,-5,9,34,6,-11,his,President,PERSON,TITLE,DET,PROPN,poss,compound,PRP$,NNP,5,1
3160,6279.0,38,join,21,2,7,5,1,30,19,-14,Andre Carson,Indianapolis,PERSON-PERSON,NATIONALITY,PROPN-PROPN,PROPN,compound-nsubj,compound,NNP-NNP,NNP,3,1
3161,10478.0,87,picked,7,45,48,3,44,38,-38,41,Andre Carson,Indianapolis,PERSON-PERSON,CITY,PROPN-PROPN,PROPN,compound-pobj,pobj,NNP-NNP,NNP,2,1
3162,15580.0,38,has,26,5,2,-3,4,35,21,-24,Andre Carson,Indianapolis,PERSON-PERSON,CITY,PROPN-PROPN,PROPN,compound-nsubj,pobj,NNP-NNP,NNP,2,1
3163,22990.0,23,-LRB-,0,7,13,6,6,9,-7,13,Andre Carson,Indianapolis,PERSON-PERSON,CITY,PROPN-PROPN,PROPN,compound-nsubjpass,pobj,NNP-NNP,NNP,1,1
3164,6283.0,47,died,41,1,12,11,0,34,40,-29,Parren J. Mitchell,Congress,PERSON-PERSON-PERSON,ORGANIZATION,PROPN-PROPN-PROPN,PROPN,compound-compound-nsubj,pobj,NNP-NNP-NNP,NNP,6,1
3165,6286.0,49,IN,0,45,24,-21,44,24,-45,24,he,biologist,PERSON,TITLE,PRON,NOUN,nsubj,compound,PRP,NN,3,1
3166,6290.0,32,created,14,2,17,15,1,14,12,3,Central American Parliament,1986,ORGANIZATION-ORGANIZATION-ORGANIZATION,DATE,ADJ-PROPN-PROPN,NUM,compound-compound-nsubjpass,pobj,JJ-NNP-NNP,CD,4,1
3167,36664.0,24,created,5,2,8,6,1,15,3,3,Central American Parliament,1986,ORGANIZATION-ORGANIZATION-ORGANIZATION,DATE,ADJ-PROPN-PROPN,NUM,compound-compound-nsubjpass,pobj,JJ-NNP-NNP,CD,4,1
3168,38640.0,22,set,12,2,16,14,1,5,10,4,Central American Parliament,1986,ORGANIZATION-ORGANIZATION-ORGANIZATION,DATE,ADJ-PROPN-PROPN,NUM,compound-compound-nsubjpass,pobj,JJ-NNP-NNP,CD,4,1
3169,6292.0,29,announced,12,18,1,-17,17,27,-6,-11,national financial services,Liu Mingkang,ORGANIZATION-ORGANIZATION-ORGANIZATION,PERSON-PERSON,ADJ-ADJ-NOUN,PROPN-PROPN,amod-amod-compound,compound-nsubj,JJ-JJ-NNS,NNP-NNP,6,1
3170,6295.0,25,announced,10,12,8,-4,11,16,-2,-2,his,Chairman,PERSON,TITLE,DET,PROPN,poss,compound,PRP$,NNP,3,1
3171,6298.0,20,took,9,4,2,-2,3,17,5,-7,KGB,Andropov,ORGANIZATION,PERSON,PROPN,PROPN,compound,nsubj,NNP,NNP,1,1
3172,6311.0,19,PARIS,0,8,10,2,7,8,-8,10,Yoadimnadji,56,PERSON,NUMBER,PROPN,NUM,nsubj,appos,NNP,CD,3,1
3173,12590.0,26,died,4,1,3,2,0,22,3,-1,Yoadimnadji,56,PERSON,NUMBER,NOUN,NUM,nsubj,appos,NNS,CD,3,1
3174,47610.0,15,was,12,1,14,13,0,0,11,2,Yoadimnadji,56,PERSON,NUMBER,NOUN,NUM,nsubj,attr,NNS,CD,3,1
3175,53518.0,16,airlifted,5,1,3,2,0,12,4,-2,Yoadimnadji,56,PERSON,NUMBER,NOUN,NUM,nsubjpass,appos,NNS,CD,3,1
3176,6317.0,37,began,9,26,18,-8,25,18,-17,9,he,Lancaster,PERSON,CITY,PRON,PROPN,nsubj,pobj,PRP,NNP,10,1
3177,6321.0,42,said,30,26,29,3,25,12,4,-1,NSC,Tai Chein,ORGANIZATION,PERSON-PERSON,PROPN,PROPN-PROPN,compound,compound-nsubj,NNP,NNP-NNP,8,1
3178,6322.0,24,born,5,1,8,7,0,15,4,3,Jefferson Joseph DeBlanc Sr.,Lockport,PERSON-PERSON-PERSON-PERSON,CITY,PROPN-PROPN-PROPN-PROPN,PROPN,compound-compound-compound-nsubjpass,pobj,NNP-NNP-NNP-NNP,NNP,4,1
3179,6336.0,36,says,2,13,19,6,12,16,-11,17,Pavelka,32-year-old,PERSON,NUMBER,PROPN,NUM,poss,nummod,NNP,CD,7,1
3180,59661.0,40,2010-02-11T13,0,21,20,-1,20,19,-21,20,Pavelka,32-year-old,PERSON,NUMBER,PROPN,NUM,nsubj,compound,NNP,CD,1,1
3181,6343.0,17,Corporation,6,9,4,-5,8,12,-3,-2,CNAC,China National Aviation Corporation,ORGANIZATION,ORGANIZATION-ORGANIZATION-ORGANIZATION-ORGANIZATION,PROPN,PROPN-PROPN-PROPN-PROPN,compound,compound-compound-compound-ROOT,NNP,NNP-NNP-NNP-NNP,2,1
3182,6354.0,47,said,19,13,9,-4,12,37,6,-10,Marywood University,Human Performance Laboratory,ORGANIZATION-ORGANIZATION,ORGANIZATION-ORGANIZATION-ORGANIZATION,PROPN-PROPN,PROPN-PROPN-PROPN,compound-pobj,compound-compound-pobj,NNP-NNP,NNP-NNP-NNP,3,1
3183,31109.0,33,said,14,27,23,-4,26,9,-13,9,Marywood University,Human Performance Laboratory,ORGANIZATION-ORGANIZATION,ORGANIZATION-ORGANIZATION-ORGANIZATION,PROPN-PROPN,PROPN-PROPN-PROPN,compound-pobj,compound-compound-pobj,NNP-NNP,NNP-NNP-NNP,3,1
3184,57032.0,33,said,13,27,23,-4,26,9,-14,10,Marywood University,Human Performance Laboratory,ORGANIZATION-ORGANIZATION,ORGANIZATION-ORGANIZATION-ORGANIZATION,PROPN-PROPN,PROPN-PROPN-PROPN,compound-pobj,compound-compound-pobj,NNP-NNP,NNP-NNP-NNP,5,1
3185,6355.0,47,failed,11,36,32,-4,35,14,-25,21,ABC,All Basotho Convention,ORGANIZATION,ORGANIZATION-ORGANIZATION-ORGANIZATION,PROPN,PROPN-PROPN-PROPN,compound,compound-compound-pobj,NNP,NNP-NNP-NNP,7,1
3186,24304.0,52,won,20,33,29,-4,32,22,-13,9,ABC,All Basotho Convention,ORGANIZATION,ORGANIZATION-ORGANIZATION-ORGANIZATION,PROPN,DET-PROPN-PROPN,compound,det-compound-pobj,NNP,DT-NNP-NNP,5,1
3187,30612.0,40,comes,12,20,16,-4,19,23,-8,4,ABC,All Basotho Convention,ORGANIZATION,ORGANIZATION-ORGANIZATION-ORGANIZATION,PROPN,PROPN-PROPN-PROPN,compound,compound-compound-pobj,NNP,NNP-NNP-NNP,4,1
3188,37041.0,40,party,4,14,10,-4,13,29,-10,6,ABC,All Basotho Convention,ORGANIZATION,ORGANIZATION-ORGANIZATION-ORGANIZATION,PROPN,DET-PROPN-PROPN,compound,det-compound-appos,NNP,DT-NNP-NNP,5,1
3189,45672.0,45,won,18,35,31,-4,34,13,-17,13,ABC,All Basotho Convention,ORGANIZATION,ORGANIZATION-ORGANIZATION-ORGANIZATION,PROPN,DET-PROPN-PROPN,compound,det-compound-pobj,NNP,DT-NNP-NNP,4,1
3190,46700.0,39,challenger,2,8,4,-4,7,34,-6,2,ABC,All Basotho Convention,ORGANIZATION,ORGANIZATION-ORGANIZATION-ORGANIZATION,PROPN,DET-PROPN-PROPN,compound,det-compound-appos,NNP,DT-NNP-NNP,3,1
3191,48567.0,44,told,41,38,34,-4,37,9,3,-7,ABC,All Basotho Convention,ORGANIZATION,ORGANIZATION-ORGANIZATION-ORGANIZATION,PROPN,PROPN-PROPN-PROPN,compound,compound-compound-pobj,NNP,NNP-NNP-NNP,5,1
3192,49187.0,41,resigned,2,15,11,-4,14,29,-13,9,ABC,All Basotho Convention,ORGANIZATION,ORGANIZATION-ORGANIZATION-ORGANIZATION,PROPN,PROPN-PROPN-PROPN,compound,compound-compound-dobj,NNP,NNP-NNP-NNP,3,1
3193,53526.0,43,hoping,6,37,33,-4,36,9,-31,27,ABC,All Basotho Convention,ORGANIZATION,ORGANIZATION-ORGANIZATION-ORGANIZATION,PROPN,PROPN-PROPN-PROPN,compound,compound-compound-pobj,NNP,NNP-NNP-NNP,5,1
3194,54574.0,52,seen,20,46,42,-4,45,9,-26,22,ABC,All Basotho Convention,ORGANIZATION,ORGANIZATION-ORGANIZATION-ORGANIZATION,PROPN,PROPN-PROPN-PROPN,compound,compound-compound-dobj,NNP,NNP-NNP-NNP,9,1
3195,6360.0,27,founded,5,2,8,6,1,18,3,3,African Prosecutors Association,August 2004,ORGANIZATION-ORGANIZATION-ORGANIZATION,DATE-DATE,PROPN-PROPN-PROPN,PROPN-NUM,compound-compound-nsubjpass,pobj-nummod,NNP-NNPS-NNP,NNP-CD,5,1
3196,6374.0,20,arrested,10,5,9,4,4,10,5,-1,Spencer Pratt,Stephanie,PERSON-PERSON,PERSON,PROPN-PROPN,PROPN,compound-poss,appos,NNP-NNP,NNP,4,1
3197,6376.0,33,Committee,2,11,2,-9,10,30,-9,0,CPC,Central Committee,ORGANIZATION,ORGANIZATION-ORGANIZATION,PROPN,PROPN-PROPN,compound,compound-ROOT,NNP,NNP-NNP,1,1
3198,57369.0,52,said,28,48,50,2,47,1,-20,22,CPC,Central Committee,ORGANIZATION,ORGANIZATION-ORGANIZATION,PROPN,PROPN-PROPN,compound,compound-ROOT,NNP,NNP-NNP,12,1
3199,6381.0,19,was,9,9,7,-2,8,11,0,-2,Buse,lobbyist,PERSON,TITLE,PROPN,NOUN,nsubj,attr,NNP,NN,1,1
3200,6581.0,50,worked,9,9,14,5,8,35,0,5,Buse,lobbyist,PERSON,TITLE,PROPN,NOUN,nsubj,pobj,NNP,NN,3,1
3201,6386.0,60,says,29,17,17,0,16,42,12,-12,Ontario Human Rights Commission,Ontario,ORGANIZATION-ORGANIZATION-ORGANIZATION-ORGANIZATION,STATE_OR_PROVINCE,PROPN-PROPN-PROPN-PROPN,PROPN,compound-compound-compound-nsubj,pobj,NNP-NNP-NNPS-NNP,NNP,0,1
3202,6389.0,34,elevated,23,3,30,27,2,3,20,7,Myers,assistant,PERSON,TITLE,PROPN,NOUN,nsubjpass,pobj,NNP,NN,6,1
3203,6390.0,38,said,28,28,37,9,27,0,0,9,ADB,Manila,ORGANIZATION,CITY,PROPN,PROPN,nsubj,pobj,NNP,NNP,1,1
3204,17385.0,30,dedicated,7,1,5,4,0,24,6,-2,ADB,Manila,ORGANIZATION,CITY,PROPN,PROPN,nsubjpass,pobj,NNP,NNP,3,1
3205,42210.0,59,said,53,9,13,4,8,45,44,-40,ADB,Manila,ORGANIZATION,CITY,PROPN,PROPN,poss,pobj,NNP,NNP,6,1
3206,6391.0,86,YORK,1,17,47,30,16,38,-16,46,Zagat,"Nancy Peretsman , executive vice president at Allen",ORGANIZATION,PERSON-PERSON-PERSON-PERSON-PERSON-PERSON-PERSON-PERSON,PROPN,PROPN-PROPN-PUNCT-ADJ-NOUN-NOUN-ADP-PROPN,pobj,compound-conj-punct-amod-compound-appos-prep-pobj,NNP,"NNP-NNP-,-JJ-NN-NN-IN-NNP",6,1
3207,6396.0,14,-RRB-,1,3,9,6,2,4,-2,8,Michael Sandy,Long Island,PERSON-PERSON,LOCATION-LOCATION,PROPN-PROPN,PROPN-PROPN,compound-appos,compound-appos,NNP-NNP,NNP-NNP,2,1
3208,6397.0,23,born,2,1,4,3,0,18,1,2,Ahearn,"Oct 7 , 1954",PERSON,DATE-DATE-DATE-DATE,PROPN,PROPN-NUM-PUNCT-NUM,nsubjpass,npadvmod-nummod-punct-nummod,NNP,"NNP-CD-,-CD",3,1
3209,6399.0,38,broke,7,14,23,9,13,14,-7,16,Awami National Party,Ubaidullah Yousufzai,ORGANIZATION-ORGANIZATION-ORGANIZATION,PERSON-PERSON,PROPN-PROPN-PROPN,PROPN-PROPN,compound-compound-pobj,compound-appos,NNP-NNP-NNP,NNP-NNP,3,1
3210,6400.0,18,given,3,1,17,16,0,0,2,14,Trista Sutter,Colorado,PERSON-PERSON,STATE_OR_PROVINCE,PROPN-PROPN,PROPN,compound-nsubj,appos,NNP-NNP,NNP,2,1
3211,6404.0,25,born,3,1,6,5,0,18,2,3,Raul Castro,June 3,PERSON-PERSON,DATE-DATE,PROPN-PROPN,PROPN-NUM,compound-nsubjpass,pobj-nummod,NNP-NNP,NNP-CD,4,1
3212,6409.0,34,working,6,17,3,-14,16,30,-11,-3,Energy Solutions,US,ORGANIZATION-ORGANIZATION,COUNTRY,PROPN-PROPN,PROPN,compound-pobj,pobj,NNP-NNPS,NNP,4,1
3213,49385.0,34,working,6,17,3,-14,16,30,-11,-3,Energy Solutions,US,ORGANIZATION-ORGANIZATION,COUNTRY,PROPN-PROPN,PROPN,compound-pobj,compound,NNP-NNPS,NNP,4,1
3214,6411.0,9,became,5,5,8,3,4,0,0,3,she,co-chairwoman,PERSON,TITLE,PRON,NOUN,nsubj,attr,PRP,NN,1,1
3215,6413.0,30,wanted,16,22,4,-18,21,25,-6,-12,her,27-year-old,PERSON,DURATION,DET,NUM,poss,amod,PRP$,CD,6,1
3216,6417.0,36,was,11,2,11,9,1,24,9,0,ADB,1966,ORGANIZATION,DATE,PROPN,NUM,poss,pobj,NNP,CD,3,1
3217,6423.0,56,'m,1,13,12,-1,12,43,-12,11,Cowell,judge,PERSON,TITLE,PROPN,NOUN,npadvmod,appos,NNP,NN,6,1
3218,55620.0,36,caught,2,4,11,7,3,24,-2,9,Cowell,judge,PERSON,TITLE,PROPN,NOUN,poss,nsubj,NNP,NN,5,1
3219,6435.0,27,snapped,8,4,21,17,3,5,4,13,Paul Sculfor,Malibu,PERSON-PERSON,CITY,PROPN-PROPN,PROPN,compound-pobj,dobj,NNP-NNP,NNP,7,1
3220,12269.0,61,saw,2,11,23,12,10,37,-9,21,Paul Sculfor,Malibu,PERSON-PERSON,CITY,PROPN-PROPN,PROPN,compound-appos,pobj,NNP-NNP,NNP,7,1
3221,6437.0,38,died,33,1,7,6,0,30,32,-26,Philip M. Kaiser,ambassador,PERSON-PERSON-PERSON,TITLE,PROPN-PROPN-PROPN,NOUN,compound-compound-nsubj,appos,NNP-NNP-NNP,NN,3,1
3222,6449.0,37,BRIGADE,1,4,20,16,3,16,-3,19,Badr Organisation,Shia,ORGANIZATION-ORGANIZATION,RELIGION,PROPN-PROPN,PROPN,compound-oprd,compound,NNP-NNP,NNP,5,1
3223,6450.0,36,served,2,8,1,-7,7,34,-6,-1,Association for Behavior Analysis,She,ORGANIZATION-ORGANIZATION-ORGANIZATION-ORGANIZATION,PERSON,PROPN-ADP-PROPN-PROPN,PRON,pobj-prep-compound-pobj,nsubj,NNP-IN-NNP-NNP,PRP,6,1
3224,6454.0,52,said,40,49,42,-7,48,9,-9,2,American Bankers Association,Edward L. Yingling,ORGANIZATION-ORGANIZATION-ORGANIZATION,PERSON-PERSON-PERSON,PROPN-PROPN-PROPN,PROPN-PROPN-PROPN,compound-compound-pobj,compound-compound-nsubj,NNP-NNPS-NNP,NNP-NNP-NNP,5,1
3225,18922.0,37,said,32,29,19,-10,28,17,3,-13,American Bankers Association,Edward L. Yingling,ORGANIZATION-ORGANIZATION-ORGANIZATION,PERSON-PERSON-PERSON,PROPN-PROPN-PROPN,PROPN-PROPN-PROPN,compound-compound-pobj,compound-compound-nsubj,NNP-NNPS-NNP,NNP-NNP-NNP,4,1
3226,20869.0,34,said,18,8,1,-7,7,32,10,-17,American Bankers Association,Edward L. Yingling,ORGANIZATION-ORGANIZATION-ORGANIZATION,PERSON-PERSON-PERSON,PROPN-PROPN-PROPN,PROPN-PROPN-PROPN,compound-compound-pobj,compound-compound-nsubj,NNP-NNPS-NNP,NNP-NNP-NNP,5,1
3227,53017.0,50,said,38,47,40,-7,46,9,-9,2,American Bankers Association,Edward L. Yingling,ORGANIZATION-ORGANIZATION-ORGANIZATION,PERSON-PERSON-PERSON,PROPN-PROPN-PROPN,PROPN-PROPN-PROPN,compound-compound-pobj,compound-compound-nsubj,NNP-NNPS-NNP,NNP-NNP-NNP,5,1
3228,61289.0,23,said,11,20,13,-7,19,9,-9,2,American Bankers Association,Edward L. Yingling,ORGANIZATION-ORGANIZATION-ORGANIZATION,PERSON-PERSON-PERSON,PROPN-PROPN-PROPN,PROPN-PROPN-PROPN,compound-compound-pobj,compound-compound-nsubj,NNP-NNPS-NNP,NNP-NNP-NNP,5,1
3229,6467.0,20,survived,2,1,13,12,0,6,1,11,Kollek,Amos,PERSON,PERSON,PROPN,PROPN,nsubjpass,conj,NNP,NNP,7,1
3230,6471.0,43,is,7,12,4,-8,11,38,-5,-3,Fidelity,Robert C. Ketterson,ORGANIZATION,PERSON-PERSON-PERSON,PROPN,PROPN-PROPN-PROPN,compound,compound-compound-appos,NNP,NNP-NNP-NNP,6,1
3231,6474.0,40,includes,1,12,19,7,11,20,-11,18,Northland,Fla,ORGANIZATION,STATE_OR_PROVINCE,PROPN,PROPN,pobj,appos,NNP,NNP,6,1
3232,6481.0,19,issued,7,14,6,-8,13,12,-7,-1,Oscar Peterson,Canadian,PERSON-PERSON,NATIONALITY,PROPN-PROPN,ADJ,compound-poss,amod,NNP-NNP,JJ,2,1
3233,49680.0,40,dies,6,5,2,-3,4,37,1,-4,Oscar Peterson,Canadian,PERSON-PERSON,NATIONALITY,PROPN-PROPN,ADJ,compound-nsubj,amod,NNP-NNP,JJ,2,1
3234,6509.0,23,established,1,4,13,9,3,9,-3,12,Barnes Foundation,Philadelphia,ORGANIZATION-ORGANIZATION,CITY,PROPN-PROPN,PROPN,compound-dobj,pobj,NNP-NNP,NNP,2,1
3235,12095.0,18,inspired,3,8,17,9,7,0,-5,14,Barnes Foundation,Philadelphia,ORGANIZATION-ORGANIZATION,CITY,PROPN-PROPN,PROPN,compound-pobj,appos,NNP-NNP,NNP,3,1
3236,35444.0,15,studied,3,8,14,6,7,0,-5,11,Barnes Foundation,Philadelphia,ORGANIZATION-ORGANIZATION,CITY,PROPN-PROPN,PROPN,compound-compound,pobj,NNP-NNP,NNP,6,1
3237,54836.0,40,exist,17,36,39,3,35,0,-19,22,Barnes Foundation,Philadelphia,ORGANIZATION-ORGANIZATION,CITY,PROPN-PROPN,PROPN,compound-conj,pobj,NNP-NNP,NNP,4,1
3238,6527.0,49,opened,21,37,36,-1,36,12,-16,15,Harry Dent,forecaster,PERSON-PERSON,TITLE,PROPN-PROPN,NOUN,compound-pobj,compound,NNP-NNP,NN,1,1
3239,6539.0,35,Definitions,2,34,28,-6,33,6,-32,26,APA,UK Association of Public Analysts,ORGANIZATION,ORGANIZATION-ORGANIZATION-ORGANIZATION-ORGANIZATION-ORGANIZATION,PROPN,PROPN-PROPN-ADP-PROPN-PROPN,compound,compound-conj-prep-compound-compound,NNP,NNP-NNP-IN-NNP-NNPS,-1,1
3240,6555.0,45,spotted,6,4,27,23,3,17,2,21,Spencer Pratt,MTV,PERSON-PERSON,ORGANIZATION,PROPN-PROPN,PROPN,compound-conj,compound,NNP-NNP,NNP,8,1
3241,7920.0,13,is,8,2,5,3,1,7,6,-3,Spencer Pratt,MTV,PERSON-PERSON,ORGANIZATION,PROPN-PROPN,PROPN,compound-nsubj,poss,NNP-NNP,NNP,4,1
3242,35614.0,39,2009-10-26T13,0,6,17,11,5,21,-6,17,Spencer Pratt,MTV,PERSON-PERSON,ORGANIZATION,PROPN-PROPN,PROPN,compound-conj,compound,NNP-NNP,NNP,4,1
3243,45597.0,50,proven,7,33,41,8,32,8,-26,34,Spencer Pratt,MTV,PERSON-PERSON,ORGANIZATION,PROPN-PROPN,PROPN,conj-dobj,pobj,NNP-NNP,NNP,5,1
3244,6568.0,31,lived,12,1,29,28,0,1,11,17,Irene Morgan Kirkaldy,Stanley Kirkaldy,PERSON-PERSON-PERSON,PERSON-PERSON,PROPN-PROPN-PROPN,PROPN-PROPN,compound-compound-nsubj,compound-appos,NNP-NNP-NNP,NNP-NNP,6,1
3245,6571.0,54,said,29,15,22,7,14,31,14,-7,Gholam Ali Haddad Adel,lawmaker,PERSON-PERSON-PERSON-PERSON,TITLE,PROPN-PROPN-PROPN-PROPN,NOUN,compound-compound-compound-nsubj,appos,NNP-NNP-NNP-NNP,NN,2,1
3246,29131.0,15,said,6,3,2,-1,2,12,3,-4,Gholam Ali Haddad Adel,lawmaker,PERSON-PERSON-PERSON-PERSON,TITLE,PROPN-PROPN-PROPN-PROPN,NOUN,compound-compound-compound-nsubj,compound,NNP-NNP-NNP-NNP,NN,2,1
3247,35728.0,22,denounced,11,7,6,-1,6,15,4,-5,Gholam Ali Haddad Adel,lawmaker,PERSON-PERSON-PERSON-PERSON,TITLE,PROPN-PROPN-PROPN-PROPN,NOUN,compound-compound-compound-appos,compound,NNP-NNP-NNP-NNP,NN,1,1
3248,48598.0,38,protect,4,15,22,7,14,15,-11,18,Gholam Ali Haddad Adel,lawmaker,PERSON-PERSON-PERSON-PERSON,TITLE,PROPN-PROPN-PROPN-PROPN,NOUN,compound-compound-compound-nsubj,appos,NNP-NNP-NNP-NNP,NN,2,1
3249,6572.0,39,Share,0,9,7,-2,8,31,-9,7,Focus On The Family,Christianist,ORGANIZATION-ORGANIZATION-ORGANIZATION-ORGANIZATION,RELIGION,PROPN-ADP-DET-PROPN,ADJ,ROOT-prep-det-pobj,compound,NNP-IN-DT-NNP,JJ,2,1
3250,6577.0,27,said,25,4,7,3,3,19,21,-18,Pascal Yoadimnadji,Friday,PERSON-PERSON,DATE,PROPN-PROPN,PROPN,compound-nsubj,npadvmod,NNP-NNP,NNP,2,1
3251,31342.0,25,said,22,5,24,19,4,0,17,2,Pascal Yoadimnadji,Friday,PERSON-PERSON,DATE,PROPN-PROPN,PROPN,compound-nsubj,npadvmod,NNP-NNPS,NNP,4,1
3252,61572.0,25,said,23,4,7,3,3,17,19,-16,Pascal Yoadimnadji,Friday,PERSON-PERSON,DATE,PROPN-PROPN,PROPN,compound-nsubj,npadvmod,NNP-NNP,NNP,2,1
3253,6583.0,40,died,18,3,1,-2,2,38,15,-17,Paul Gillmor,US,PERSON-PERSON,COUNTRY,PROPN-PROPN,PROPN,compound-nsubj,compound,NNP-NNP,NNP,1,1
3254,6586.0,22,died,18,4,6,2,3,15,14,-12,he,Virginia Christopher,PERSON,PERSON-PERSON,PRON,PROPN-PROPN,nsubj,compound-dobj,PRP,NNP-NNP,1,1
3255,6587.0,31,By,0,14,10,-4,13,20,-14,10,National Action Network,Decency Initiative,ORGANIZATION-ORGANIZATION-ORGANIZATION,ORGANIZATION-ORGANIZATION,PROPN-PROPN-PROPN,PROPN-PROPN,compound-compound-compound,compound-nsubj,NNP-NNP-NNP,NNP-NNP,3,1
3256,66087.0,40,UPDATE,0,17,24,7,16,15,-17,24,National Action Network,Decency Initiative,ORGANIZATION-ORGANIZATION-ORGANIZATION,MISC-MISC,PROPN-PROPN-PROPN,PROPN-PROPN,compound-compound-nsubj,compound-conj,NNP-NNP-NNP,NNP-NNP,2,1
3257,6593.0,46,said,17,8,14,6,7,31,9,-3,New Hampshire Institute of Politics,St. Anselm College,ORGANIZATION-ORGANIZATION-ORGANIZATION-ORGANIZATION-ORGANIZATION,ORGANIZATION-ORGANIZATION-ORGANIZATION,PROPN-PROPN-PROPN-ADP-PROPN,PROPN-PROPN-PROPN,compound-compound-pobj-prep-pobj,compound-compound-pobj,NNP-NNP-NNP-IN-NNP,NNP-NNP-NNP,4,1
3258,13653.0,42,said,18,33,39,6,32,2,-15,21,New Hampshire Institute of Politics,St. Anselm College,ORGANIZATION-ORGANIZATION-ORGANIZATION-ORGANIZATION-ORGANIZATION,ORGANIZATION-ORGANIZATION-ORGANIZATION,PROPN-PROPN-PROPN-ADP-PROPN,PROPN-PROPN-PROPN,compound-compound-pobj-prep-pobj,compound-compound-pobj,NNP-NNP-NNP-IN-NNP,NNP-NNP-NNP,5,1
3259,21093.0,40,said,20,29,35,6,28,4,-9,15,New Hampshire Institute of Politics,St. Anselm College,ORGANIZATION-ORGANIZATION-ORGANIZATION-ORGANIZATION-ORGANIZATION,ORGANIZATION-ORGANIZATION-ORGANIZATION,PROPN-PROPN-PROPN-ADP-PROPN,PROPN-PROPN-PROPN,compound-compound-pobj-prep-pobj,compound-compound-pobj,NNP-NNP-NNP-IN-NNP,NNP-NNP-NNP,5,1
3260,48528.0,39,said,20,30,36,6,29,2,-10,16,New Hampshire Institute of Politics,St. Anselm College,ORGANIZATION-ORGANIZATION-ORGANIZATION-ORGANIZATION-ORGANIZATION,ORGANIZATION-ORGANIZATION-ORGANIZATION,PROPN-PROPN-PROPN-ADP-PROPN,PROPN-PROPN-PROPN,compound-compound-pobj-prep-pobj,compound-compound-pobj,NNP-NNP-NNP-IN-NNP,NNP-NNP-NNP,5,1
3261,6606.0,46,instituted,23,1,45,44,0,0,22,22,Thomas J. Meskill,Fla.,PERSON-PERSON-PERSON,STATE_OR_PROVINCE,PROPN-PROPN-PROPN,PROPN,compound-compound-nsubj,appos,NNP-NNP-NNP,NNP,3,1
3262,6608.0,37,upheld,9,18,16,-2,17,20,-9,7,Hashim Ahmad al-Tai,minister Sultan,PERSON-PERSON-PERSON,TITLE-TITLE,PROPN-PROPN-X,NOUN-PROPN,compound-subtok-punct,compound-compound,NNP-NNP-ADD,NN-NNP,3,1
3263,6628.0,38,invest,23,5,19,14,4,18,18,-4,DMC,Midtown,ORGANIZATION,LOCATION,PROPN,PROPN,poss,compound,NNP,NNP,11,1
3264,22661.0,38,invest,23,5,19,14,4,18,18,-4,DMC,Midtown,ORGANIZATION,LOCATION,PROPN,PROPN,compound,compound,NNP,NNP,11,1
3265,6634.0,38,is,1,7,17,10,6,20,-6,16,Moro National Liberation Front,Muslim,ORGANIZATION-ORGANIZATION-ORGANIZATION-ORGANIZATION,RELIGION,PROPN-PROPN-PROPN-PROPN,ADJ,compound-compound-compound-pobj,amod,NNP-NNP-NNP-NNP,JJ,7,1
3266,9369.0,36,is,2,15,10,-5,14,25,-13,8,Moro National Liberation Front,Muslim,ORGANIZATION-ORGANIZATION-ORGANIZATION-ORGANIZATION,RELIGION,PROPN-PROPN-PROPN-PROPN,PROPN,compound-compound-compound-appos,amod,NNP-NNP-NNP-NNP,NNP,3,1
3267,65514.0,36,began,4,11,17,6,10,18,-7,13,Moro National Liberation Front,Muslim,ORGANIZATION-ORGANIZATION-ORGANIZATION-ORGANIZATION,RELIGION,PROPN-PROPN-PROPN-PROPN,ADJ,compound-compound-compound-pobj,amod,NNP-NNP-NNP-NNP,JJ,5,1
3268,6661.0,50,won,9,31,3,-28,30,46,-22,-6,USA Network,GE,ORGANIZATION-ORGANIZATION,ORGANIZATION,PROPN-PROPN,PROPN,compound-dobj,compound,NNP-NNP,NNP,8,1
3269,27267.0,42,acquired,5,24,5,-19,23,36,-19,0,USA Network,GE,ORGANIZATION-ORGANIZATION,ORGANIZATION,PROPN-PROPN,PROPN,compound-appos,nsubj,NNP-NNP,NNP,6,1
3270,6665.0,35,BEIRUT,0,8,33,25,7,1,-8,33,Abbas Musawi,southern Lebanon,PERSON-PERSON,COUNTRY-COUNTRY,PROPN-PROPN,ADJ-PROPN,compound-nsubjpass,amod-pobj,NNP-NNP,JJ-NNP,5,1
3271,6669.0,26,Season,0,18,25,7,17,0,-18,25,her,him,PERSON,PERSON,DET,PRON,poss,dobj,PRP$,PRP,6,1
3272,6678.0,39,arrested,14,1,7,6,0,31,13,-7,Kirkaldy,Baltimore,PERSON,CITY,PROPN,PROPN,nsubjpass,pobj,NNP,NNP,5,1
3273,6679.0,34,formed,1,3,29,26,2,4,-2,28,his,Washington,PERSON,STATE_OR_PROVINCE,DET,PROPN,poss,pobj,PRP$,NNP,5,1
3274,23243.0,50,include,1,3,13,10,2,36,-2,12,his,Washington,PERSON,STATE_OR_PROVINCE,DET,PROPN,poss,pobj,PRP$,NNP,2,1
3275,6681.0,54,survived,2,47,53,6,46,0,-45,51,Charles Kaiser,journalist,PERSON-PERSON,TITLE,PROPN-PROPN,NOUN,compound-conj,conj,NNP-NNP,NN,8,1
3276,6698.0,41,said,39,10,9,-1,9,31,29,-30,Raul Castro Ruz,leader,PERSON-PERSON-PERSON,TITLE,PROPN-PROPN-PROPN,NOUN,compound-compound-poss,compound,NNP-NNP-NNP,NN,2,1
3277,6699.0,25,said,10,7,1,-6,6,23,3,-9,American Beverage Association,Susan Neely,ORGANIZATION-ORGANIZATION-ORGANIZATION,PERSON-PERSON,PROPN-PROPN-PROPN,PROPN-PROPN,compound-compound-pobj,compound-nsubj,NNP-NNP-NNP,NNP-NNP,4,1
3278,7735.0,37,said,22,34,24,-10,33,12,-12,2,American Beverage Association,Susan Neely,ORGANIZATION-ORGANIZATION-ORGANIZATION,PERSON-PERSON,PROPN-PROPN-PROPN,PROPN-PROPN,compound-compound-pobj,compound-nsubj,NNP-NNP-NNP,NNP-NNP,5,1
3279,12859.0,35,said,24,32,26,-6,31,8,-8,2,American Beverage Association,Susan Neely,ORGANIZATION-ORGANIZATION-ORGANIZATION,PERSON-PERSON,PROPN-PROPN-PROPN,PROPN-PROPN,compound-compound-pobj,compound-nsubj,NNP-NNP-NNP,NNP-NNP,5,1
3280,18397.0,45,said,18,28,20,-8,27,24,-10,2,American Beverage Association,Susan Neely,ORGANIZATION-ORGANIZATION-ORGANIZATION,PERSON-PERSON,PROPN-PROPN-PROPN,PROPN-PROPN,compound-compound-pobj,compound-nsubj,NNP-NNP-NNP,NNP-NNP,5,1
3281,22021.0,49,says,35,46,40,-6,45,8,-11,5,American Beverage Association,Susan Neely,ORGANIZATION-ORGANIZATION-ORGANIZATION,PERSON-PERSON,PROPN-PROPN-PROPN,PROPN-PROPN,compound-compound-pobj,compound-pobj,NNP-NNP-NNP,NNP-NNP,5,1
3282,22236.0,29,'s,2,23,27,4,22,1,-21,25,American Beverage Association,Susan Neely,ORGANIZATION-ORGANIZATION-ORGANIZATION,PERSON-PERSON,PROPN-PROPN-PROPN,PROPN-PROPN,compound-compound-pobj,compound-appos,NNP-NNP-NNP,NNP-NNP,7,1
3283,22655.0,25,said,10,7,1,-6,6,23,3,-9,American Beverage Association,Susan Neely,ORGANIZATION-ORGANIZATION-ORGANIZATION,PERSON-PERSON,PROPN-PROPN-PROPN,PROPN-PROPN,compound-compound-pobj,compound-nsubj,NNP-NNP-NNP,NNP-NNP,4,1
3284,42725.0,30,said,18,24,28,4,23,1,-6,10,American Beverage Association,Susan Neely,ORGANIZATION-ORGANIZATION-ORGANIZATION,PERSON-PERSON,PROPN-PROPN-PROPN,PROPN-PROPN,compound-compound-pobj,compound-appos,NNP-NNP-NNP,NNP-NNP,5,1
3285,53183.0,39,posed,10,7,1,-6,6,37,3,-9,American Beverage Association,Susan Neely,ORGANIZATION-ORGANIZATION-ORGANIZATION,PERSON-PERSON,PROPN-PROPN-PROPN,PROPN-PROPN,compound-compound-pobj,compound-nsubj,NNP-NNP-NNP,NNP-NNP,4,1
3286,54788.0,43,Pop,2,12,6,-6,11,36,-10,4,American Beverage Association,Susan Neely,ORGANIZATION-ORGANIZATION-ORGANIZATION,PERSON-PERSON,PROPN-PROPN-PROPN,PROPN-PROPN,compound-compound-pobj,compound-dobj,NNP-NNP-NNP,NNP-NNP,4,1
3287,6708.0,40,said,1,32,36,4,31,3,-31,35,Mainland Affairs Council,MAC,ORGANIZATION-ORGANIZATION-ORGANIZATION,ORGANIZATION,PROPN-PROPN-PROPN,PROPN,compound-compound-pobj,compound,NNP-NNPS-NNP,NNP,1,1
3288,8184.0,28,Council,3,2,6,4,1,21,1,3,Mainland Affairs Council,MAC,ORGANIZATION-ORGANIZATION-ORGANIZATION,ORGANIZATION,PROPN-PROPN-PROPN,PROPN,compound-compound-ROOT,compound,NNP-NNPS-NNP,NNP,2,1
3289,16644.0,63,include,4,36,41,5,35,21,-32,37,Mainland Affairs Council,MAC,ORGANIZATION-ORGANIZATION-ORGANIZATION,ORGANIZATION,PROPN-PROPN-PROPN,PROPN,compound-compound-poss,poss,NNP-NNPS-NNP,NNP,3,1
3290,16855.0,32,Council,3,2,6,4,1,25,1,3,Mainland Affairs Council,MAC,ORGANIZATION-ORGANIZATION-ORGANIZATION,ORGANIZATION,PROPN-PROPN-PROPN,PROPN,compound-compound-ROOT,compound,NNP-NNPS-NNP,NNP,2,1
3291,17479.0,38,said,13,25,29,4,24,8,-12,16,Mainland Affairs Council,MAC,ORGANIZATION-ORGANIZATION-ORGANIZATION,ORGANIZATION,PROPN-PROPN-PROPN,PROPN,compound-compound-pobj,compound,NNP-NNPS-NNP,NNP,5,1
3292,18180.0,49,do,3,37,41,4,36,7,-34,38,Mainland Affairs Council,MAC,ORGANIZATION-ORGANIZATION-ORGANIZATION,ORGANIZATION,PROPN-PROPN-PROPN,PROPN,compound-compound-appos,compound,NNP-NNPS-NNP,NNP,2,1
3293,19997.0,31,Council,2,1,5,4,0,25,1,3,Mainland Affairs Council,MAC,ORGANIZATION-ORGANIZATION-ORGANIZATION,ORGANIZATION,PROPN-PROPN-PROPN,PROPN,compound-compound-ROOT,compound,NNP-NNPS-NNP,NNP,3,1
3294,20743.0,53,added,35,7,11,4,6,41,28,-24,Mainland Affairs Council,MAC,ORGANIZATION-ORGANIZATION-ORGANIZATION,ORGANIZATION,PROPN-PROPN-PROPN,PROPN,compound-compound-compound,compound,NNP-NNPS-NNP,NNP,8,1
3295,27655.0,16,visit,3,5,9,4,4,6,-2,6,Mainland Affairs Council,MAC,ORGANIZATION-ORGANIZATION-ORGANIZATION,ORGANIZATION,PROPN-PROPN-PROPN,PROPN,compound-compound-compound,compound,NNP-NNPS-NNP,NNP,3,1
3296,32342.0,38,Council,2,1,5,4,0,32,1,3,Mainland Affairs Council,MAC,ORGANIZATION-ORGANIZATION-ORGANIZATION,ORGANIZATION,PROPN-PROPN-PROPN,PROPN,compound-compound-ROOT,compound,NNP-NNPS-NNP,NNP,3,1
3297,33134.0,49,show,16,40,44,4,39,4,-24,28,Mainland Affairs Council,MAC,ORGANIZATION-ORGANIZATION-ORGANIZATION,ORGANIZATION,PROPN-PROPN-PROPN,PROPN,compound-compound-appos,compound,NNP-NNPS-NNP,NNP,2,1
3298,34000.0,36,Council,4,3,7,4,2,28,1,3,Mainland Affairs Council,MAC,ORGANIZATION-ORGANIZATION-ORGANIZATION,ORGANIZATION,PROPN-PROPN-PROPN,PROPN,compound-compound-ROOT,compound,NNP-NNPS-NNP,NNP,3,1
3299,35759.0,28,Council,2,1,5,4,0,22,1,3,Mainland Affairs Council,MAC,ORGANIZATION-ORGANIZATION-ORGANIZATION,ORGANIZATION,PROPN-PROPN-PROPN,PROPN,compound-compound-ROOT,compound,NNP-NNPS-NNP,NNP,3,1
3300,37088.0,49,said,27,37,41,4,36,7,-10,14,Mainland Affairs Council,MAC,ORGANIZATION-ORGANIZATION-ORGANIZATION,ORGANIZATION,PROPN-PROPN-PROPN,PROPN,compound-compound-nsubj,compound,NNP-NNPS-NNP,NNP,2,1
3301,43368.0,39,noted,25,29,33,4,28,5,-4,8,Mainland Affairs Council,MAC,ORGANIZATION-ORGANIZATION-ORGANIZATION,ORGANIZATION,PROPN-PROPN-PROPN,PROPN,compound-compound-dobj,compound,NNP-NNPS-NNP,NNP,4,1
3302,50172.0,46,Council,2,1,5,4,0,40,1,3,Mainland Affairs Council,MAC,ORGANIZATION-ORGANIZATION-ORGANIZATION,ORGANIZATION,PROPN-PROPN-PROPN,PROPN,compound-compound-ROOT,compound,NNP-NNPS-NNP,NNP,3,1
3303,53091.0,52,-RRB-,1,9,13,4,8,38,-8,12,Mainland Affairs Council,MAC,ORGANIZATION-ORGANIZATION-ORGANIZATION,ORGANIZATION,PROPN-PROPN-PROPN,PROPN,compound-compound-appos,compound,NNP-NNPS-NNP,NNP,2,1
3304,61236.0,37,charts,17,9,13,4,8,23,8,-4,Mainland Affairs Council,MAC,ORGANIZATION-ORGANIZATION-ORGANIZATION,ORGANIZATION,PROPN-PROPN-PROPN,PROPN,compound-compound-appos,compound,NNP-NNPS-NNP,NNP,3,1
3305,63139.0,47,sign,6,36,40,4,35,6,-30,34,Mainland Affairs Council,MAC,ORGANIZATION-ORGANIZATION-ORGANIZATION,ORGANIZATION,PROPN-PROPN-PROPN,PROPN,compound-compound-dep,compound,NNP-NNPS-NNP,NNP,3,1
3306,63479.0,51,made,16,10,14,4,9,36,6,-2,Mainland Affairs Council,MAC,ORGANIZATION-ORGANIZATION-ORGANIZATION,ORGANIZATION,PROPN-PROPN-PROPN,PROPN,compound-compound-pobj,compound,NNP-NNPS-NNP,NNP,5,1
3307,65660.0,42,Responding,0,7,11,4,6,30,-7,11,Mainland Affairs Council,MAC,ORGANIZATION-ORGANIZATION-ORGANIZATION,ORGANIZATION,PROPN-PROPN-PROPN,PROPN,compound-compound-dep,compound,NNP-NNPS-NNP,NNP,3,1
3308,66632.0,49,Council,3,2,6,4,1,42,1,3,Mainland Affairs Council,MAC,ORGANIZATION-ORGANIZATION-ORGANIZATION,ORGANIZATION,PROPN-PROPN-PROPN,PROPN,compound-compound-ROOT,compound,NNP-NNPS-NNP,NNP,3,1
3309,6712.0,11,visits,9,8,3,-5,7,7,1,-6,John Negroponte,U.S.,PERSON-PERSON,COUNTRY,PROPN-PROPN,PROPN,compound-nsubj,nmod,NNP-NNP,NNP,2,1
3310,10914.0,51,said,48,22,17,-5,21,33,26,-31,John Negroponte,U.S.,PERSON-PERSON,COUNTRY,PROPN-PROPN,PROPN,compound-conj,nmod,NNP-NNP,NNP,5,1
3311,14985.0,12,'m,1,3,6,3,2,5,-2,5,John Negroponte,U.S.,PERSON-PERSON,COUNTRY,PROPN-PROPN,PROPN,compound-attr,compound,NNP-NNP,NNP,3,1
3312,21007.0,31,reported,28,6,1,-5,5,29,22,-27,John Negroponte,U.S.,PERSON-PERSON,COUNTRY,PROPN-PROPN,PROPN,compound-nsubj,nmod,NNP-NNP,NNP,2,1
3313,48917.0,53,wrote,46,35,40,5,34,12,11,-6,John Negroponte,U.S.,PERSON-PERSON,COUNTRY,PROPN-PROPN,PROPN,compound-nsubj,compound,NNP-NNP,NNP,4,1
3314,6717.0,31,said,9,12,21,9,11,9,-3,12,Denso,China,ORGANIZATION,COUNTRY,PROPN,PROPN,compound,pobj,NNP,NNP,6,1
3315,46024.0,10,Denso,0,1,8,7,0,1,-1,8,Denso,China,ORGANIZATION,COUNTRY,VERB,PROPN,ROOT,pobj,VB,NNP,3,1
3316,6719.0,30,said,10,18,12,-6,17,17,-8,2,American Bar Association,Karen Mathis,ORGANIZATION-ORGANIZATION-ORGANIZATION,PERSON-PERSON,PROPN-PROPN-PROPN,PROPN-PROPN,compound-compound-pobj,compound-nsubj,NNP-NNP-NNP,NNP-NNP,5,1
3317,17270.0,41,called,16,10,14,4,9,26,6,-2,American Bar Association,Karen Mathis,ORGANIZATION-ORGANIZATION-ORGANIZATION,PERSON-PERSON,PROPN-PROPN-PROPN,PROPN-PROPN,compound-compound-pobj,compound-appos,NNP-NNP-NNP,NNP-NNP,4,1
3318,22024.0,40,said,22,30,24,-6,29,15,-8,2,American Bar Association,Karen Mathis,ORGANIZATION-ORGANIZATION-ORGANIZATION,PERSON-PERSON,PROPN-PROPN-PROPN,PROPN-PROPN,compound-compound-pobj,compound-nsubj,NNP-NNP-NNP,NNP-NNP,5,1
3319,6725.0,82,introduced,21,9,17,8,8,64,12,-4,his,governor,PERSON,TITLE,DET,NOUN,poss,poss,PRP$,NN,9,1
3320,35604.0,43,won,11,13,17,4,12,25,-2,6,his,governor,PERSON,TITLE,DET,NOUN,poss,pobj,PRP$,NN,3,1
3321,6727.0,45,won,5,34,27,-7,33,17,-29,22,International Monetary Fund,Rodrigo de Rato,ORGANIZATION-ORGANIZATION-ORGANIZATION,PERSON-PERSON-PERSON,PROPN-PROPN-PROPN,PROPN-PROPN-PROPN,compound-compound-pobj,compound-compound-dobj,NNP-NNP-NNP,NNP-NNP-NNP,7,1
3322,6733.0,31,said,11,1,6,5,0,24,10,-5,Sadia SA,Brazil,ORGANIZATION-ORGANIZATION,COUNTRY,PROPN-PROPN,PROPN,compound-nsubj,poss,NNP-NNP,NNP,5,1
3323,6736.0,23,meets,5,13,15,2,12,7,-8,10,UNITA,Paulo Lukamba,ORGANIZATION,PERSON-PERSON,PROPN,PROPN-PROPN,pobj,compound-appos,NNP,NNP-NNP,2,1
3324,6739.0,43,said,24,5,9,4,4,33,19,-15,Christopher Dodd,Connecticut,PERSON-PERSON,STATE_OR_PROVINCE,PROPN-PROPN,PROPN,compound-nsubj,compound,NNP-NNP,NNP,1,1
3325,6850.0,66,underscored,25,32,35,3,31,30,-7,10,Christopher Dodd,Connecticut,PERSON-PERSON,STATE_OR_PROVINCE,PROPN-PROPN,PROPN,compound-nsubj,pobj,NNP-NNP,NNP,3,1
3326,60423.0,39,said,27,12,34,22,11,4,15,7,Christopher Dodd,Connecticut,PERSON-PERSON,STATE_OR_PROVINCE,PROPN-PROPN,PROPN,compound-nsubj,appos,NNP-NNP,NNP,5,1
3327,6742.0,36,said,33,2,5,3,1,30,31,-28,NEC Corp,Tadahiro Sekimoto,ORGANIZATION-ORGANIZATION,PERSON-PERSON,PROPN-PROPN,PROPN-PROPN,compound-compound,compound-nsubj,NNP-NNP,NNP-NNP,2,1
3328,6744.0,25,is,2,12,9,-3,11,15,-10,7,Joseph Farland,ambassador,PERSON-PERSON,TITLE,PROPN-PROPN,NOUN,compound-pobj,nsubj,NNP-NNP,NN,1,1
3329,65890.0,11,dies,8,1,4,3,0,6,7,-4,Joseph Farland,ambassador,PERSON-PERSON,TITLE,PROPN-PROPN,NOUN,compound-nsubj,appos,NNP-NNP,NN,2,1
3330,6747.0,40,touched,5,9,36,27,8,3,-4,31,Kennedy Space Center,NASA,ORGANIZATION-ORGANIZATION-ORGANIZATION,ORGANIZATION,PROPN-PROPN-PROPN,PROPN,compound-compound-pobj,compound,NNP-NNP-NNP,NNP,6,1
3331,11804.0,30,WASHINGTON,0,14,12,-2,13,17,-14,12,Kennedy Space Center,NASA,ORGANIZATION-ORGANIZATION-ORGANIZATION,ORGANIZATION,PROPN-PROPN-PROPN,PROPN,compound-compound-pobj,poss,NNP-NNP-NNP,NNP,3,1
3332,17612.0,68,is,2,15,13,-2,14,54,-13,11,Kennedy Space Center,NASA,ORGANIZATION-ORGANIZATION-ORGANIZATION,ORGANIZATION,PROPN-PROPN-PROPN,PROPN,compound-compound-conj,compound,NNP-NNP-NNP,NNP,3,1
3333,18878.0,37,waved,2,11,1,-10,10,35,-9,-1,Kennedy Space Center,NASA,ORGANIZATION-ORGANIZATION-ORGANIZATION,ORGANIZATION,PROPN-PROPN-PROPN,PROPN,compound-compound-pobj,compound,NNP-NNP-NNP,NNP,5,1
3334,22182.0,38,was,8,18,16,-2,17,21,-10,8,Kennedy Space Center,NASA,ORGANIZATION-ORGANIZATION-ORGANIZATION,ORGANIZATION,PROPN-PROPN-PROPN,PROPN,compound-compound-pobj,poss,NNP-NNP-NNP,NNP,3,1
3335,27875.0,15,cleared,2,10,8,-2,9,6,-8,6,Kennedy Space Center,NASA,ORGANIZATION-ORGANIZATION-ORGANIZATION,ORGANIZATION,PROPN-PROPN-PROPN,PROPN,compound-compound-pobj,poss,NNP-NNP-NNP,NNP,3,1
3336,35641.0,25,touched,10,16,14,-2,15,10,-6,4,Kennedy Space Center,NASA,ORGANIZATION-ORGANIZATION-ORGANIZATION,ORGANIZATION,PROPN-PROPN-PROPN,PROPN,compound-compound-pobj,poss,NNP-NNP-NNP,NNP,3,1
3337,46278.0,52,been,7,34,22,-12,33,29,-27,15,Kennedy Space Center,NASA,ORGANIZATION-ORGANIZATION-ORGANIZATION,ORGANIZATION,PROPN-PROPN-PROPN,PROPN,compound-compound-appos,compound,NNP-NNP-NNP,NNP,5,1
3338,49423.0,33,said,30,24,30,6,23,2,6,0,Kennedy Space Center,NASA,ORGANIZATION-ORGANIZATION-ORGANIZATION,ORGANIZATION,PROPN-PROPN-PROPN,PROPN,compound-compound-pobj,nsubj,NNP-NNP-NNP,NNP,8,1
3339,50810.0,32,said,4,21,1,-20,20,30,-17,-3,Kennedy Space Center,NASA,ORGANIZATION-ORGANIZATION-ORGANIZATION,ORGANIZATION,PROPN-PROPN-PROPN,PROPN,compound-compound-pobj,compound,NNP-NNP-NNP,NNP,9,1
3340,55302.0,36,are,3,23,21,-2,22,14,-20,18,Kennedy Space Center,NASA,ORGANIZATION-ORGANIZATION-ORGANIZATION,ORGANIZATION,PROPN-PROPN-PROPN,PROPN,compound-compound-pobj,poss,NNP-NNP-NNP,NNP,3,1
3341,59113.0,23,is,1,20,18,-2,19,4,-19,17,Kennedy Space Center,NASA,ORGANIZATION-ORGANIZATION-ORGANIZATION,ORGANIZATION,PROPN-PROPN-PROPN,PROPN,compound-compound-pobj,poss,NNP-NNP-NNP,NNP,3,1
3342,61145.0,37,said,20,4,32,28,3,4,16,12,Kennedy Space Center,NASA,ORGANIZATION-ORGANIZATION-ORGANIZATION,ORGANIZATION,PROPN-PROPN-PROPN,PROPN,compound-compound-pobj,pobj,NNP-NNP-NNP,NNP,10,1
3343,65546.0,29,aim,4,12,10,-2,11,18,-8,6,Kennedy Space Center,NASA,ORGANIZATION-ORGANIZATION-ORGANIZATION,ORGANIZATION,PROPN-PROPN-PROPN,PROPN,compound-compound-pobj,poss,NNP-NNP-NNP,NNP,3,1
3344,6752.0,16,said,5,4,2,-2,3,13,1,-3,Chris Bentley,Attorney General,PERSON-PERSON,TITLE-TITLE,PROPN-PROPN,PROPN-PROPN,compound-nsubj,compound-compound,NNP-NNP,NNP-NNP,1,1
3345,9958.0,26,hate,4,22,20,-2,21,5,-18,16,Chris Bentley,Attorney General,PERSON-PERSON,TITLE-TITLE,PROPN-PROPN,PROPN-PROPN,compound-pobj,compound-compound,NNP-NNP,NNP-NNP,1,1
3346,18498.0,26,Note,0,12,10,-2,11,15,-12,10,Chris Bentley,Attorney General,PERSON-PERSON,TITLE-TITLE,PROPN-PROPN,PROPN-PROPN,compound-pobj,compound-compound,NNP-NNP,NNP-NNP,1,1
3347,18765.0,11,announced,5,4,2,-2,3,8,1,-3,Chris Bentley,Attorney General,PERSON-PERSON,TITLE-TITLE,PROPN-PROPN,PROPN-PROPN,compound-nsubj,compound-compound,NNP-NNP,NNP-NNP,1,1
3348,41514.0,39,said,5,4,2,-2,3,36,1,-3,Chris Bentley,Attorney General,PERSON-PERSON,TITLE-TITLE,PROPN-PROPN,PROPN-PROPN,compound-nsubj,compound-compound,NNP-NNP,NNP-NNP,1,1
3349,57707.0,66,proves,3,8,6,-2,7,59,-5,3,Chris Bentley,Attorney General,PERSON-PERSON,TITLE-TITLE,PROPN-PROPN,PROPN-PROPN,compound-nsubj,compound-compound,NNP-NNP,NNP-NNP,1,1
3350,65194.0,27,said,22,21,19,-2,20,7,1,-3,Chris Bentley,Attorney General,PERSON-PERSON,TITLE-TITLE,PROPN-PROPN,PROPN-PROPN,compound-nsubj,compound-compound,NNP-NNP,NNP-NNP,4,1
3351,6754.0,46,said,26,35,17,-18,34,28,-9,-9,Konica Minolta,Danka,ORGANIZATION-ORGANIZATION,ORGANIZATION,PROPN-PROPN,PROPN,compound-compound,poss,NNP-NNP,NNP,12,1
3352,6768.0,15,said,7,9,12,3,8,2,-2,5,his,Barbara DeBlanc Romero,PERSON,PERSON-PERSON-PERSON,DET,PROPN-PROPN-PROPN,poss,compound-compound-appos,PRP$,NNP-NNP-NNP,2,1
3353,6774.0,58,stay,11,1,6,5,0,51,10,-5,Burns,52,PERSON,NUMBER,PROPN,NUM,nsubj,attr,NNP,CD,3,1
3354,6781.0,26,want,2,21,15,-6,20,10,-19,13,Citibank,Richard D Stanley,ORGANIZATION,PERSON-PERSON-PERSON,PROPN,PROPN-PROPN-PROPN,compound,compound-compound-dobj,NNP,NNP-NNP-NNP,3,1
3355,6787.0,38,told,12,3,7,4,2,30,9,-5,St. Anselm College,Goffstown,ORGANIZATION-ORGANIZATION-ORGANIZATION,CITY,PROPN-PROPN-PROPN,PROPN,compound-compound-pobj,pobj,NNP-NNP-NNP,NNP,4,1
3356,14120.0,34,face,7,22,30,8,21,3,-15,23,St. Anselm College,Goffstown,ORGANIZATION-ORGANIZATION-ORGANIZATION,CITY,PROPN-PROPN-PROPN,PROPN,compound-compound-pobj,pobj,NNP-NNP-NNP,NNP,11,1
3357,6792.0,24,said,21,1,18,17,0,5,20,-3,Flowers,Richmond Flowers Jr.,PERSON,PERSON-PERSON-PERSON,NOUN,PROPN-PROPN-PROPN,nsubj,compound-compound-appos,NNS,NNP-NNP-NNP,5,1
3358,6809.0,49,said,10,2,1,-1,1,47,8,-9,Abdullahi Hassan Garweyne,Col.,PERSON-PERSON-PERSON,TITLE,PROPN-PROPN-PROPN,PROPN,compound-compound-nsubj,compound,NNP-NNP-NNP,NNP,2,1
3359,38006.0,50,said,10,2,1,-1,1,48,8,-9,Abdullahi Hassan Garweyne,Col.,PERSON-PERSON-PERSON,TITLE,PROPN-PROPN-PROPN,PROPN,compound-compound-nsubj,compound,NNP-NNP-NNP,NNP,2,1
3360,6810.0,57,said,10,20,3,-17,19,53,-10,-7,Old Lane Partners,Citigroup,ORGANIZATION-ORGANIZATION-ORGANIZATION,ORGANIZATION,PROPN-PROPN-PROPN,PROPN,compound-compound-dobj,nsubj,NNP-NNP-NNP,NNP,5,1
3361,8395.0,26,collected,3,13,18,5,12,7,-10,15,Old Lane Partners,Citigroup,ORGANIZATION-ORGANIZATION-ORGANIZATION,ORGANIZATION,PROPN-PROPN-PROPN,PROPN,compound-compound-appos,pobj,NNP-NNP-NNPS,NNP,5,1
3362,10550.0,29,paid,4,13,4,-9,12,24,-9,0,Old Lane Partners,Citigroup,ORGANIZATION-ORGANIZATION-ORGANIZATION,ORGANIZATION,PROPN-PROPN-PROPN,PROPN,compound-compound-dobj,nsubj,NNP-NNP-NNPS,NNP,3,1
3363,16798.0,16,bought,11,3,1,-2,2,14,8,-10,Old Lane Partners,Citigroup,ORGANIZATION-ORGANIZATION-ORGANIZATION,ORGANIZATION,PROPN-PROPN-PROPN,PROPN,compound-compound-dobj,nsubj,NNP-NNP-NNPS,NNP,2,1
3364,21009.0,37,bought,20,13,20,7,12,16,7,0,Old Lane Partners,Citigroup,ORGANIZATION-ORGANIZATION-ORGANIZATION,ORGANIZATION,PROPN-PROPN-PROPN,PROPN,compound-compound-pobj,appos,NNP-NNP-NNPS,NNP,8,1
3365,40875.0,37,bought,20,13,20,7,12,16,7,0,Old Lane Partners,Citigroup,ORGANIZATION-ORGANIZATION-ORGANIZATION,ORGANIZATION,PROPN-PROPN-PROPN,PROPN,compound-compound-pobj,appos,NNP-NNP-NNPS,NNP,8,1
3366,54813.0,31,bought,5,11,5,-6,10,25,-6,0,Old Lane Partners,Citigroup,ORGANIZATION-ORGANIZATION-ORGANIZATION,ORGANIZATION,PROPN-PROPN-PROPN,PROPN,compound-compound-appos,nsubj,NNP-NNP-NNPS,NNP,3,1
3367,65334.0,46,intended,3,17,26,9,16,19,-14,23,Old Lane Partners,Citigroup,ORGANIZATION-ORGANIZATION-ORGANIZATION,ORGANIZATION,PROPN-PROPN-PROPN,PROPN,compound-compound-dobj,nsubj,NNP-NNP-NNPS,NNP,3,1
3368,6812.0,32,dominated,15,6,5,-1,5,26,9,-10,Country Music Association,US,ORGANIZATION-ORGANIZATION-ORGANIZATION,COUNTRY,PROPN-PROPN-PROPN,PROPN,compound-compound-poss,compound,NNP-NNP-NNP,NNP,2,1
3369,6817.0,33,tells,5,1,4,3,0,28,4,-1,Ali Fedotowsky,25,PERSON-PERSON,NUMBER,PROPN-PROPN,NUM,compound-nsubj,appos,NNP-NNP,CD,2,1
3370,20006.0,40,complained,13,26,29,3,25,10,-13,16,Ali Fedotowsky,25,PERSON-PERSON,NUMBER,PROPN-PROPN,NUM,compound-appos,npadvmod,NNP-NNP,CD,4,1
3371,43764.0,7,tells,5,1,4,3,0,2,4,-1,Ali Fedotowsky,25,PERSON-PERSON,NUMBER,PROPN-PROPN,NUM,compound-nsubj,appos,NNP-NNP,CD,2,1
3372,6836.0,4,was,1,1,3,2,0,0,0,2,She,66,PERSON,NUMBER,PRON,NUM,nsubj,attr,PRP,CD,1,1
3373,6839.0,18,is,2,12,6,-6,11,11,-10,4,his,musician,PERSON,TITLE,DET,NOUN,poss,amod,PRP$,NN,5,1
3374,6847.0,23,occurred,6,11,22,11,10,0,-5,16,Jo Ann Davis,October,PERSON-PERSON-PERSON,DATE,PROPN-PROPN-PROPN,PROPN,compound-compound-nsubj,pobj,NNP-NNP-NNP,NNP,4,1
3375,6855.0,37,warns,22,1,6,5,0,30,21,-16,Paul Watson,president,PERSON-PERSON,TITLE,PROPN-PROPN,NOUN,compound-nsubj,conj,NNP-NNP,NN,2,1
3376,26867.0,39,told,5,4,3,-1,3,35,1,-2,Paul Watson,president,PERSON-PERSON,TITLE,PROPN-PROPN,NOUN,compound-nsubj,compound,NNP-NNP,NN,1,1
3377,59477.0,22,charges,1,10,13,3,9,8,-9,12,Paul Watson,president,PERSON-PERSON,TITLE,PROPN-PROPN,NOUN,compound-pobj,appos,NNP-NNP,NN,2,1
3378,6857.0,22,said,14,8,16,8,7,5,6,2,his,Mona Kempfer,PERSON,PERSON-PERSON,DET,PROPN-PROPN,poss,compound-nsubj,PRP$,NNP-NNP,2,1
3379,17538.0,22,said,14,8,16,8,7,5,6,2,his,Mona Kempfer,PERSON,PERSON-PERSON,DET,PROPN-PROPN,poss,compound-nsubj,PRP$,NNP-NNP,2,1
3380,6873.0,30,died,25,1,13,12,0,16,24,-12,Jane Bolin,Yale Law School,PERSON-PERSON,ORGANIZATION-ORGANIZATION-ORGANIZATION,PROPN-PROPN,PROPN-PROPN-PROPN,compound-nsubj,compound-compound-pobj,NNP-NNP,NNP-NNP-NNP,6,1
3381,18308.0,38,died,33,9,21,12,8,16,24,-12,Jane Bolin,Yale Law School,PERSON-PERSON,ORGANIZATION-ORGANIZATION-ORGANIZATION,PROPN-PROPN,PROPN-PROPN-PROPN,compound-pobj,compound-compound-pobj,NNP-NNP,NNP-NNP-NNP,6,1
3382,6877.0,22,was,1,1,4,3,0,17,0,3,He,chairman,PERSON,TITLE,PRON,NOUN,nsubj,attr,PRP,NN,2,1
3383,13622.0,24,elected,2,1,14,13,0,9,1,12,He,chairman,PERSON,TITLE,PRON,NOUN,nsubjpass,pobj,PRP,NN,5,1
3384,41730.0,27,DIES,4,8,23,15,7,3,-4,19,He,chairman,PERSON,TITLE,PRON,NOUN,nsubj,conj,PRP,NN,6,1
3385,51321.0,8,served,2,1,5,4,0,2,1,3,He,chairman,PERSON,TITLE,PRON,NOUN,nsubj,pobj,PRP,NN,2,1
3386,6882.0,25,Title,0,13,16,3,12,8,-13,16,Covidien,Boulder,ORGANIZATION,CITY,PROPN,PROPN,compound,appos,NNP,NNP,5,1
3387,6898.0,32,agrees,5,4,1,-3,3,30,1,-4,First Group,UK,ORGANIZATION-ORGANIZATION,COUNTRY,PROPN-PROPN,PROPN,compound-nsubj,poss,NNP-NNP,NNP,2,1
3388,16700.0,14,agrees,5,4,1,-3,3,12,1,-4,First Group,UK,ORGANIZATION-ORGANIZATION,COUNTRY,PROPN-PROPN,PROPN,compound-nsubj,poss,NNP-NNP,NNP,2,1
3389,6916.0,56,resulted,11,20,40,20,19,15,-9,29,National Beef Packing Co.,California,ORGANIZATION-ORGANIZATION-ORGANIZATION-ORGANIZATION,STATE_OR_PROVINCE,PROPN-PROPN-PROPN-PROPN,PROPN,compound-compound-compound-compound,appos,NNP-NNP-NNP-NNP,NNP,8,1
3390,6922.0,46,was,12,10,1,-9,9,44,2,-11,Hussein Kamel,His,PERSON-PERSON,PERSON,PROPN-PROPN,DET,compound-appos,poss,NNP-NNP,PRP$,1,1
3391,6935.0,37,known,8,7,20,13,6,16,1,12,he,chairman,PERSON,TITLE,PRON,NOUN,nsubjpass,pobj,PRP,NN,5,1
3392,7086.0,34,said,18,22,33,11,21,0,-4,15,he,chairman,PERSON,TITLE,PRON,NOUN,nsubj,attr,PRP,NN,3,1
3393,13842.0,32,continued,4,4,20,16,3,11,0,16,he,chairman,PERSON,TITLE,PRON,NOUN,nsubj,pobj,PRP,NN,4,1
3394,15146.0,28,says,2,4,27,23,3,0,-2,25,he,chairman,PERSON,TITLE,PRON,NOUN,nsubj,dobj,PRP,NN,3,1
3395,32048.0,42,said,9,15,5,-10,14,36,-6,-4,he,chairman,PERSON,TITLE,PRON,NOUN,nsubj,appos,PRP,NN,4,1
3396,38893.0,13,was,6,6,8,2,5,4,0,2,he,chairman,PERSON,TITLE,PRON,NOUN,nsubj,attr,PRP,NN,2,1
3397,6943.0,42,says,21,37,40,3,36,1,-16,19,he,MSNBC,PERSON,ORGANIZATION,PRON,PROPN,nsubj,compound,PRP,NNP,3,1
3398,51054.0,46,started,1,11,20,9,10,25,-10,19,he,MSNBC,PERSON,ORGANIZATION,PRON,PROPN,nsubj,pobj,PRP,NNP,2,1
3399,6946.0,36,says,6,2,5,3,1,30,4,-1,Sean Ross,Edison Research,PERSON-PERSON,ORGANIZATION-ORGANIZATION,PROPN-PROPN,PROPN-PROPN,compound-nsubj,compound-pobj,NNP-NNP,NNP-NNP,2,1
3400,42398.0,39,says,27,29,32,3,28,6,-2,5,Sean Ross,Edison Research,PERSON-PERSON,ORGANIZATION-ORGANIZATION,PROPN-PROPN,PROPN-PROPN,compound-nsubj,compound-pobj,NNP-NNP,NNP-NNP,3,1
3401,6951.0,40,SHENG-CHENG,1,8,11,3,7,28,-7,10,Hu Sheng-cheng,chairman,PERSON-PERSON,TITLE,PROPN-PROPN,NOUN,compound-nsubj,appos,NNP-NNP,NN,2,1
3402,6956.0,21,says,11,9,7,-2,8,13,2,-4,Chris Ivery,record producer,PERSON-PERSON,TITLE-TITLE,PROPN-PROPN,VERB-NOUN,compound-dobj,compound-compound,NNP-NNP,VB-NN,5,1
3403,13583.0,39,tied,13,20,18,-2,19,20,-7,5,Chris Ivery,record producer,PERSON-PERSON,TITLE-TITLE,PROPN-PROPN,NOUN-NOUN,compound-pobj,compound-compound,NNP-NNP,NN-NN,1,1
3404,22761.0,64,Radiates,2,59,57,-2,58,6,-57,55,Chris Ivery,record producer,PERSON-PERSON,TITLE-TITLE,PROPN-PROPN,NOUN-NOUN,compound-conj,compound-compound,NNP-NNP,NN-NN,2,1
3405,36089.0,24,marry,14,22,20,-2,21,3,-8,6,Chris Ivery,record producer,PERSON-PERSON,TITLE-TITLE,PROPN-PROPN,NOUN-NOUN,compound-appos,compound-compound,NNP-NNP,NN-NN,2,1
3406,63941.0,39,tied,13,20,18,-2,19,20,-7,5,Chris Ivery,record producer,PERSON-PERSON,TITLE-TITLE,PROPN-PROPN,NOUN-NOUN,compound-pobj,compound-compound,NNP-NNP,NN-NN,1,1
3407,6957.0,12,died,8,5,10,5,4,1,3,2,Fannie Lee Chaney,May 22,PERSON-PERSON-PERSON,DATE-DATE,PROPN-PROPN-PROPN,PROPN-NUM,compound-compound-appos,npadvmod-nummod,NNP-NNP-NNP,NNP-CD,5,1
3408,6960.0,43,closed,7,3,17,14,2,25,4,10,Department of Conservation and Recreation,Boston Harbor Islands National Park,ORGANIZATION-ORGANIZATION-ORGANIZATION-ORGANIZATION-ORGANIZATION,LOCATION-LOCATION-LOCATION-LOCATION-LOCATION,PROPN-ADP-PROPN-CCONJ-PROPN,PROPN-PROPN-PROPN-PROPN-PROPN,nsubj-prep-pobj-cc-conj,compound-compound-compound-compound-pobj,NNP-IN-NNP-CC-NNP,NNP-NNP-NNP-NNP-NNP,6,1
3409,6971.0,52,said,29,14,20,6,13,31,15,-9,Carnival Corp.,Costa Cruises,ORGANIZATION-ORGANIZATION,ORGANIZATION-ORGANIZATION,PROPN-PROPN,PROPN-PROPN,compound-appos,compound-pobj,NNP-NNP,NNP-NNPS,4,1
3410,6974.0,36,worked,1,1,23,22,0,12,0,22,He,Morgan State,PERSON,ORGANIZATION-ORGANIZATION,PRON,PROPN-PROPN,nsubj,compound-pobj,PRP,NNP-NNP,5,1
3411,6976.0,25,read,6,6,2,-4,5,22,0,-4,Goodman,his,PERSON,PERSON,PROPN,DET,nsubj,poss,NNP,PRP$,2,1
3412,6977.0,87,picked,7,45,44,-1,44,42,-38,37,Andre Carson,Rep.,PERSON-PERSON,TITLE,PROPN-PROPN,PROPN,compound-pobj,compound,NNP-NNP,NNP,2,1
3413,27721.0,20,is,5,15,14,-1,14,5,-10,9,Andre Carson,Rep.,PERSON-PERSON,TITLE,PROPN-PROPN,PROPN,compound-compound,compound,NNP-NNP,NNP,1,1
3414,31278.0,28,called,10,6,5,-1,5,22,4,-5,Andre Carson,Rep.,PERSON-PERSON,TITLE,PROPN-PROPN,PROPN,compound-nsubj,compound,NNP-NNP,NNP,1,1
3415,31607.0,19,Carson,2,2,1,-1,1,17,0,-1,Andre Carson,Rep.,PERSON-PERSON,TITLE,PROPN-PROPN,PROPN,compound-ROOT,compound,NNP-NNP,NNP,1,1
3416,31814.0,33,proposed,7,2,1,-1,1,31,5,-6,Andre Carson,Rep.,PERSON-PERSON,TITLE,PROPN-PROPN,PROPN,compound-nsubj,compound,NNP-NNP,NNP,1,1
3417,32756.0,44,said,4,2,1,-1,1,42,2,-3,Andre Carson,Rep.,PERSON-PERSON,TITLE,PROPN-PROPN,PROPN,compound-nsubj,compound,NNP-NNP,NNP,1,1
3418,46635.0,38,has,26,5,4,-1,4,33,21,-22,Andre Carson,Rep.,PERSON-PERSON,TITLE,PROPN-PROPN,PROPN,compound-nsubj,compound,NNP-NNP,NNP,1,1
3419,54146.0,37,has,27,5,4,-1,4,32,22,-23,Andre Carson,Rep.,PERSON-PERSON,TITLE,PROPN-PROPN,PROPN,compound-nsubj,compound,NNP-NNP,NNP,1,1
3420,6989.0,23,becoming,13,10,7,-3,9,15,3,-6,Alice Dellal,Agent Provocateur,PERSON-PERSON,MISC-MISC,PROPN-PROPN,PROPN-PROPN,compound-nsubj,compound-pobj,NNP-NNP,NNP-NNP,5,1
3421,6990.0,20,said,18,4,3,-1,3,16,14,-15,Jo Ann Davis,Rep.,PERSON-PERSON-PERSON,TITLE,PROPN-PROPN-PROPN,PROPN,compound-compound-nsubj,compound,NNP-NNP-NNP,NNP,2,1
3422,32825.0,37,complete,3,26,8,-18,25,28,-23,5,Jo Ann Davis,Rep.,PERSON-PERSON-PERSON,TITLE,PROPN-PROPN-PROPN,PROPN,compound-compound-conj,compound,NNP-NNP-NNP,NNP,6,1
3423,37296.0,30,In,0,16,15,-1,15,14,-16,15,Jo Ann Davis,Rep.,PERSON-PERSON-PERSON,TITLE,PROPN-PROPN-PROPN,PROPN,compound-compound-pobj,compound,NNP-NNP-NNP,NNP,2,1
3424,47384.0,41,said,39,6,5,-1,5,35,33,-34,Jo Ann Davis,Rep.,PERSON-PERSON-PERSON,TITLE,PROPN-PROPN-PROPN,PROPN,compound-compound-pobj,compound,NNP-NNP-NNP,NNP,2,1
3425,49491.0,23,occurred,6,11,10,-1,10,12,-5,4,Jo Ann Davis,Rep.,PERSON-PERSON-PERSON,TITLE,PROPN-PROPN-PROPN,PROPN,compound-compound-nsubj,compound,NNP-NNP-NNP,NNP,2,1
3426,54476.0,27,RICHMOND,0,8,7,-1,7,19,-8,7,Jo Ann Davis,Rep.,PERSON-PERSON-PERSON,TITLE,PROPN-PROPN-PROPN,PROPN,compound-compound-nsubj,compound,NNP-NNP-NNP,NNP,2,1
3427,57949.0,30,*,0,17,16,-1,16,13,-17,16,Jo Ann Davis,Rep.,PERSON-PERSON-PERSON,TITLE,PROPN-PROPN-PROPN,PROPN,compound-compound-nsubj,compound,NNP-NNP-NNP,NNP,2,1
3428,6993.0,45,reported,43,18,16,-2,17,28,25,-27,Ali Larijani,parliament speaker,PERSON-PERSON,TITLE-TITLE,PROPN-PROPN,NOUN-NOUN,compound-pobj,compound-compound,NNP-NNP,NN-NN,1,1
3429,6994.0,20,donates,6,5,15,10,4,4,1,9,Roy Scheider,Feb. 10,PERSON-PERSON,DATE-DATE,PROPN-PROPN,PROPN-NUM,compound-nsubj,npadvmod-nummod,NNP-NNP,NNP-CD,4,1
3430,6995.0,47,told,27,3,7,4,2,39,24,-20,APA,Iran,ORGANIZATION,COUNTRY,PROPN,PROPN,compound,pobj,NNP,NNP,3,1
3431,6998.0,26,said,13,22,15,-7,21,10,-9,2,National Military Family Association,Raezer,ORGANIZATION-ORGANIZATION-ORGANIZATION-ORGANIZATION,PERSON,PROPN-PROPN-PROPN-PROPN,PROPN,compound-compound-compound-pobj,nsubj,NNP-NNP-NNP-NNP,NNP,6,1
3432,7003.0,32,praised,4,14,29,15,13,2,-10,25,Hu Sheng-cheng,financial supervisor,PERSON-PERSON,TITLE-TITLE,PROPN-PROPN,ADJ-NOUN,compound-poss,amod-compound,NNP-NNP,JJ-NN,6,1
3433,7005.0,49,were,41,17,20,3,16,28,24,-21,Blackburn Rovers,Brett Emerton,ORGANIZATION-ORGANIZATION,PERSON-PERSON,PROPN-PROPN,PROPN-PROPN,compound-conj,compound-dobj,NNP-NNPS,NNP-NNP,4,1
3434,7012.0,39,said,17,33,38,5,32,0,-16,21,Marywood University,Pa.,ORGANIZATION-ORGANIZATION,STATE_OR_PROVINCE,PROPN-PROPN,PROPN,compound-pobj,appos,NNP-NNP,NNP,2,1
3435,22252.0,23,describes,4,9,14,5,8,8,-5,10,Marywood University,Pa.,ORGANIZATION-ORGANIZATION,STATE_OR_PROVINCE,PROPN-PROPN,PROPN,compound-pobj,appos,NNP-NNP,NNP,4,1
3436,32466.0,36,manage,22,15,20,5,14,15,7,-2,Marywood University,Pa.,ORGANIZATION-ORGANIZATION,STATE_OR_PROVINCE,PROPN-PROPN,PROPN,compound-pobj,appos,NNP-NNP,NNP,6,1
3437,35228.0,33,said,13,27,32,5,26,0,-14,19,Marywood University,Pa.,ORGANIZATION-ORGANIZATION,STATE_OR_PROVINCE,PROPN-PROPN,PROPN,compound-pobj,appos,NNP-NNP,NNP,6,1
3438,59651.0,31,said,8,25,30,5,24,0,-17,22,Marywood University,Pa.,ORGANIZATION-ORGANIZATION,STATE_OR_PROVINCE,PROPN-PROPN,PROPN,compound-pobj,appos,NNP-NNP,NNP,6,1
3439,7018.0,28,canceled,8,1,4,3,0,23,7,-4,Royal Caribbean,Mariner of the Seas,ORGANIZATION-ORGANIZATION,ORGANIZATION-ORGANIZATION-ORGANIZATION-ORGANIZATION,PROPN-PROPN,PROPN-ADP-DET-PROPN,compound-poss,nsubj-prep-det-pobj,NNP-NNP,NNP-IN-DT-NNPS,2,1
3440,7021.0,29,receive,9,7,6,-1,6,22,2,-3,Danny Glover,producer,PERSON-PERSON,TITLE,PROPN-PROPN,NOUN,compound-appos,conj,NNP-NNP,NN,1,1
3441,7029.0,19,made,11,2,1,-1,1,17,9,-10,Barbara Boxer,Senator,PERSON-PERSON,TITLE,PROPN-PROPN,PROPN,compound-compound,compound,NNP-NNP,NNP,1,1
3442,7324.0,32,evaded,28,4,3,-1,3,28,24,-25,Barbara Boxer,Senator,PERSON-PERSON,TITLE,PROPN-PROPN,PROPN,compound-nsubj,compound,NNP-NNP,NNP,1,1
3443,9020.0,45,BEIJING,0,16,15,-1,15,29,-16,15,Barbara Boxer,Senator,PERSON-PERSON,TITLE,PROPN-PROPN,PROPN,compound-pobj,compound,NNP-NNP,NNP,1,1
3444,11366.0,30,lent,2,12,11,-1,11,18,-10,9,Barbara Boxer,Senator,PERSON-PERSON,TITLE,PROPN-PROPN,PROPN,compound-pobj,compound,NNP-NNP,NNP,1,1
3445,11735.0,26,was,7,24,23,-1,23,2,-17,16,Barbara Boxer,Senator,PERSON-PERSON,TITLE,PROPN-PROPN,PROPN,compound-pobj,compound,NNP-NNP,NNP,1,1
3446,16484.0,43,reported,31,6,5,-1,5,37,25,-26,Barbara Boxer,Senator,PERSON-PERSON,TITLE,PROPN-PROPN,PROPN,compound-nsubjpass,compound,NNP-NNP,NNP,1,1
3447,19593.0,23,said,3,2,1,-1,1,21,1,-2,Barbara Boxer,Senator,PERSON-PERSON,TITLE,PROPN-PROPN,PROPN,compound-nsubj,compound,NNP-NNP,NNP,1,1
3448,25155.0,23,got,15,21,20,-1,20,2,-6,5,Barbara Boxer,Senator,PERSON-PERSON,TITLE,PROPN-PROPN,PROPN,compound-pobj,compound,NNP-NNP,NNP,1,1
3449,28947.0,60,focused,11,2,1,-1,1,58,9,-10,Barbara Boxer,Senator,PERSON-PERSON,TITLE,PROPN-PROPN,PROPN,compound-nsubj,compound,NNP-NNP,NNP,1,1
3450,30194.0,12,noted,3,2,1,-1,1,10,1,-2,Barbara Boxer,Senator,PERSON-PERSON,TITLE,PROPN-PROPN,PROPN,compound-nsubj,compound,NNP-NNP,NNP,1,1
3451,30593.0,19,doing,4,15,14,-1,14,4,-11,10,Barbara Boxer,Senator,PERSON-PERSON,TITLE,PROPN-PROPN,PROPN,compound-pobj,compound,NNP-NNP,NNP,1,1
3452,34167.0,39,wrote,4,3,2,-1,2,36,1,-2,Barbara Boxer,Senator,PERSON-PERSON,TITLE,PROPN-PROPN,PROPN,compound-nsubj,compound,NNP-NNP,NNP,1,1
3453,43193.0,15,From,0,10,9,-1,9,5,-10,9,Barbara Boxer,Senator,PERSON-PERSON,TITLE,PROPN-PROPN,PROPN,compound-nsubj,compound,NNP-NNP,NNP,1,1
3454,54092.0,49,said,20,7,6,-1,6,42,13,-14,Barbara Boxer,Senator,PERSON-PERSON,TITLE,PROPN-PROPN,PROPN,compound-nsubj,compound,NNP-NNP,NNP,1,1
3455,54152.0,21,re-elected,3,8,6,-2,7,14,-5,3,Barbara Boxer,Senator,PERSON-PERSON,TITLE,PROPN-PROPN,PROPN,compound-dobj,nmod,NNP-NNP,NNP,2,1
3456,55895.0,33,crafted,1,13,12,-1,12,20,-12,11,Barbara Boxer,Senator,PERSON-PERSON,TITLE,PROPN-PROPN,PROPN,compound-appos,compound,NNP-NNP,NNP,1,1
3457,7047.0,25,LD,1,6,5,-1,5,19,-5,4,Waldheim,chief,PERSON,TITLE,PROPN,NOUN,nsubj,compound,NNP,NN,1,1
3458,30702.0,21,served,1,1,5,4,0,15,0,4,Waldheim,chief,PERSON,TITLE,PROPN,NOUN,nsubj,pobj,NNP,NN,1,1
3459,40752.0,22,served,1,1,5,4,0,16,0,4,Waldheim,chief,PERSON,TITLE,PROPN,NOUN,nsubj,pobj,NNP,NN,1,1
3460,7051.0,36,are,6,26,10,-16,25,25,-20,4,Noordhoff Craniofacial Foundation,Taiwan,ORGANIZATION-ORGANIZATION-ORGANIZATION,COUNTRY,PROPN-PROPN-PROPN,PROPN,compound-compound-conj,compound,NNP-NNP-NNP,NNP,5,1
3461,14220.0,36,are,6,26,10,-16,25,25,-20,4,Noordhoff Craniofacial Foundation,Taiwan,ORGANIZATION-ORGANIZATION-ORGANIZATION,COUNTRY,PROPN-PROPN-PROPN,PROPN,compound-compound-conj,attr,NNP-NNP-NNP,NNP,5,1
3462,32733.0,45,promised,2,24,22,-2,23,22,-22,20,Noordhoff Craniofacial Foundation,Taiwan,ORGANIZATION-ORGANIZATION-ORGANIZATION,COUNTRY,PROPN-PROPN-PROPN,PROPN,compound-compound-pobj,poss,NNP-NNP-NNP,NNP,3,1
3463,60733.0,22,transferred,3,19,17,-2,18,4,-16,14,Noordhoff Craniofacial Foundation,Taiwan,ORGANIZATION-ORGANIZATION-ORGANIZATION,COUNTRY,PROPN-PROPN-PROPN,PROPN,compound-compound-conj,poss,NNP-NNP-NNP,NNP,3,1
3464,7052.0,59,Agency,3,8,6,-2,7,52,-5,3,Mohamed ElBaradei,Director General,PERSON-PERSON,TITLE-TITLE,PROPN-PROPN,PROPN-PROPN,compound-nsubj,compound-compound,NNP-NNP,NNP-NNP,3,1
3465,65333.0,42,welcomed,1,16,14,-2,15,27,-15,13,Mohamed ElBaradei,Director General,PERSON-PERSON,TITLE-TITLE,PROPN-PROPN,PROPN-PROPN,compound-dobj,compound-compound,NNP-NNP,NNP-NNP,1,1
3466,66284.0,20,told,17,7,5,-2,6,14,10,-12,Mohamed ElBaradei,Director General,PERSON-PERSON,TITLE-TITLE,PROPN-PROPN,PROPN-PROPN,compound-compound,compound-compound,NNP-NNP,NNP-NNP,1,1
3467,7054.0,10,was,2,2,7,5,1,2,0,5,he,Fordham Law Review,PERSON,ORGANIZATION-ORGANIZATION-ORGANIZATION,PRON,PROPN-PROPN-PROPN,nsubj,compound-compound-pobj,PRP,NNP-NNP-NNP,4,1
3468,7055.0,32,had,2,1,31,30,0,0,1,29,Lewis Hamilton,England,PERSON-PERSON,COUNTRY,PROPN-PROPN,PROPN,compound-nsubj,pobj,NNP-NNP,NNP,2,1
3469,35370.0,18,features,2,13,11,-2,12,6,-11,9,Lewis Hamilton,England,PERSON-PERSON,COUNTRY,PROPN-PROPN,PROPN,compound-conj,conj,NNP-NNP,NNP,2,1
3470,62368.0,29,considering,10,1,15,14,0,13,9,5,Lewis Hamilton,England,PERSON-PERSON,COUNTRY,PROPN-PROPN,PROPN,compound-nsubj,pobj,NNP-NNP,NNP,4,1
3471,7059.0,24,fought,5,5,3,-2,4,20,0,-2,he,congressman,PERSON,TITLE,PRON,NOUN,nsubj,pobj,PRP,NN,1,1
3472,41759.0,39,spoke,3,20,12,-8,19,26,-17,9,he,congressman,PERSON,TITLE,PRON,NOUN,nsubj,nsubj,PRP,NN,4,1
3473,7061.0,47,reported,33,15,41,26,14,5,18,8,Philadelphia Inquirer,Philly.com,ORGANIZATION-ORGANIZATION,ORGANIZATION,PROPN-PROPN,PROPN,nmod-pobj,pobj,NNP-NNP,NNP,13,1
3474,21764.0,40,said,22,16,10,-6,15,29,6,-12,Philadelphia Inquirer,Philly.com,ORGANIZATION-ORGANIZATION,ORGANIZATION,PROPN-PROPN,PROPN,nmod-nmod,pobj,NNP-NNP,NNP,5,1
3475,7062.0,73,survived,9,2,20,18,1,52,7,11,his,Jeanne McQuarrie,PERSON,PERSON-PERSON,DET,PROPN-PROPN,poss,compound-appos,PRP$,NNP-NNP,4,1
3476,7072.0,16,August,0,5,1,-4,4,14,-5,1,Carolyn Goodman,"August 18 , 2007",PERSON-PERSON,DATE-DATE-DATE-DATE,PROPN-PROPN,PROPN-NUM-PUNCT-NUM,compound-appos,ROOT-nummod-punct-nummod,NNP-NNP,"NNP-CD-,-CD",2,1
3477,7077.0,40,won,8,28,32,4,27,7,-20,24,Nuclear Suppliers Group,NSG,ORGANIZATION-ORGANIZATION-ORGANIZATION,ORGANIZATION,PROPN-PROPN-PROPN,PROPN,compound-compound-compound,compound,NNP-NNPS-NNP,NNP,2,1
3478,44848.0,53,report,11,14,18,4,13,34,-3,7,Nuclear Suppliers Group,NSG,ORGANIZATION-ORGANIZATION-ORGANIZATION,ORGANIZATION,PROPN-PROPN-PROPN,PROPN,compound-compound-compound,compound,NNP-NNPS-NNP,NNP,2,1
3479,45372.0,47,said,6,17,21,4,16,25,-11,15,Nuclear Suppliers Group,NSG,ORGANIZATION-ORGANIZATION-ORGANIZATION,ORGANIZATION,PROPN-PROPN-PROPN,PROPN,compound-compound-compound,compound,NNP-NNPS-NNP,NNP,2,1
3480,61474.0,30,is,1,9,13,4,8,16,-8,12,Nuclear Suppliers Group,NSG,ORGANIZATION-ORGANIZATION-ORGANIZATION,ORGANIZATION,PROPN-PROPN-PROPN,PROPN,compound-compound-pobj,compound,NNP-NNPS-NNP,NNP,3,1
3481,65015.0,52,recommended,31,35,39,4,34,12,-4,8,Nuclear Suppliers Group,NSG,ORGANIZATION-ORGANIZATION-ORGANIZATION,ORGANIZATION,PROPN-PROPN-PROPN,PROPN,compound-compound-compound,compound,NNP-NNPS-NNP,NNP,3,1
3482,67233.0,53,said,51,44,48,4,43,4,7,-3,Nuclear Suppliers Group,NSG,ORGANIZATION-ORGANIZATION-ORGANIZATION,ORGANIZATION,PROPN-PROPN-PROPN,PROPN,compound-compound-pobj,compound,NNP-NNPS-NNP,NNP,5,1
3483,7081.0,33,said,10,9,2,-7,8,30,1,-8,Carnival,David Bernstein,ORGANIZATION,PERSON-PERSON,PROPN,PROPN-PROPN,pobj,compound-nsubj,NNP,NNP-NNP,2,1
3484,7083.0,29,say,1,3,7,4,2,21,-2,6,Lashkar-e-Taiba,the 1980s,ORGANIZATION,DATE-DATE,PROPN,DET-NUM,nsubjpass,det-pobj,NNP,DT-CD,2,1
3485,33503.0,38,said,2,9,19,10,8,18,-7,17,Lashkar-e-Taiba,the 1980s,ORGANIZATION,DATE-DATE,PROPN,DET-NUM,pobj,det-pobj,NNP,DT-CD,5,1
3486,7088.0,11,make,5,5,4,-1,4,6,0,-1,Montag,25-year-old,PERSON,NUMBER,PROPN,NUM,compound,amod,NNP,CD,1,1
3487,7095.0,30,said,3,7,2,-5,6,27,-4,-1,she,49-year-old,PERSON,DURATION,PRON,NUM,nsubj,compound,PRP,CD,4,1
3488,39693.0,31,scotched,5,9,2,-7,8,28,-4,-3,she,49-year-old,PERSON,DURATION,PRON,NUM,nsubj,amod,PRP,CD,4,1
3489,7096.0,40,set,18,2,7,5,1,32,16,-11,Scorpions,Directorate of Special Operations,ORGANIZATION,ORGANIZATION-ORGANIZATION-ORGANIZATION-ORGANIZATION,PROPN,PROPN-ADP-PROPN-PROPN,nsubjpass,oprd-prep-compound-pobj,NNPS,NNP-IN-NNP-NNPS,3,1
3490,25600.0,47,disclosure,2,21,16,-5,20,30,-19,14,Scorpions,Directorate of Special Operations,ORGANIZATION,ORGANIZATION-ORGANIZATION-ORGANIZATION-ORGANIZATION,PROPN,PROPN-ADP-PROPN-PROPN,nsubj,pobj-prep-compound-pobj,NNPS,NNP-IN-NNP-NNPS,9,1
3491,46836.0,31,welcomes,1,5,21,16,4,9,-4,20,Scorpions,Directorate of Special Operations,ORGANIZATION,ORGANIZATION-ORGANIZATION-ORGANIZATION-ORGANIZATION,PROPN,PROPN-ADP-PROPN-PROPN,pobj,dobj-prep-compound-pobj,NNPS,NNP-IN-NNP-NNPS,6,1
3492,66853.0,38,set,13,2,8,6,1,29,11,-5,Scorpions,Directorate of Special Operations,ORGANIZATION,ORGANIZATION-ORGANIZATION-ORGANIZATION-ORGANIZATION,PROPN,PROPN-ADP-PROPN-PROPN,nsubjpass,pobj-prep-compound-pobj,NNPS,NNP-IN-NNP-NNPS,5,1
3493,7100.0,36,said,10,1,8,7,0,27,9,-2,Sen Chris Dodd,Banking Committee,PERSON-PERSON-PERSON,ORGANIZATION-ORGANIZATION,PROPN-PROPN-PROPN,PROPN-PROPN,compound-compound-nsubj,compound-pobj,NNP-NNP-NNP,NNP-NNP,4,1
3494,7102.0,10,was,4,4,9,5,3,0,0,5,Kerry,campaign,PERSON,TITLE,PROPN,NOUN,nsubj,pobj,NNP,NN,1,1
3495,7104.0,46,was,12,10,20,10,9,25,2,8,Hussein Kamel,Iraq,PERSON-PERSON,COUNTRY,PROPN-PROPN,PROPN,compound-appos,poss,NNP-NNP,NNP,3,1
3496,23759.0,66,lifted,3,37,42,5,36,23,-34,39,Hussein Kamel,Iraq,PERSON-PERSON,COUNTRY,PROPN-PROPN,PROPN,compound-nsubj,poss,NNP-NNP,NNP,5,1
3497,32669.0,47,granted,11,10,31,21,9,15,1,20,Hussein Kamel,Iraq,PERSON-PERSON,COUNTRY,PROPN-PROPN,PROPN,compound-pobj,pobj,NNP-NNP,NNP,11,1
3498,39980.0,66,lifted,3,37,42,5,36,23,-34,39,Hussein Kamel,Iraq,PERSON-PERSON,COUNTRY,PROPN-PROPN,PROPN,compound-nsubj,poss,NNP-NNP,NNP,5,1
3499,45761.0,40,indicated,4,25,31,6,24,8,-21,27,Hussein Kamel,Iraq,PERSON-PERSON,COUNTRY,PROPN-PROPN,PROPN,compound-appos,pobj,NNP-NNP,NNP,4,1
3500,48182.0,21,returns,12,4,15,11,3,5,8,3,Hussein Kamel,Iraq,PERSON-PERSON,COUNTRY,PROPN-PROPN,PROPN,compound-nsubj,pobj,NNP-NNP,NNP,2,1
3501,7105.0,27,written,10,19,16,-3,18,10,-9,6,Alexandra,singer,PERSON,TITLE,PROPN,NOUN,nsubj,pobj,NNP,NN,4,1
3502,7108.0,42,worked,1,20,15,-5,19,26,-19,14,Carnival Corp.,Micky,ORGANIZATION-ORGANIZATION,PERSON,PROPN-PROPN,PROPN,compound-dobj,appos,NNP-NNP,NNP,3,1
3503,7120.0,56,remembered,2,1,7,6,0,48,1,5,McNair,governor,PERSON,TITLE,PROPN,NOUN,nsubjpass,pobj,NNP,NN,2,1
3504,7124.0,39,censured,23,1,5,4,0,33,22,-18,Dodd,Thomas,PERSON,PERSON,PROPN,PROPN,poss,appos,NNP,NNP,4,1
3505,7127.0,39,bounded,7,2,32,30,1,6,5,25,Kerry,Vietnam,PERSON,COUNTRY,PROPN,PROPN,poss,pobj,NNP,NNP,9,1
3506,7133.0,30,working,9,14,28,14,13,1,-5,19,Alexandra Burke,Epic Records,PERSON-PERSON,ORGANIZATION-ORGANIZATION,PROPN-PROPN,PROPN-PROPN,compound-pobj,compound-pobj,NNP-NNP,NNP-NNPS,5,1
3507,7142.0,38,is,2,9,5,-4,8,32,-7,3,Andre Carson,Muslim,PERSON-PERSON,RELIGION,PROPN-PROPN,ADJ,compound-conj,amod,NNP-NNP,JJ,1,1
3508,7699.0,33,Note,0,26,16,-10,25,16,-26,16,Andre Carson,Muslim,PERSON-PERSON,RELIGION,PROPN-PROPN,PROPN,compound-nsubj,acomp,NNP-NNP,NNP,4,1
3509,14547.0,19,are,1,15,4,-11,14,14,-14,3,Andre Carson,Muslim,PERSON-PERSON,RELIGION,PROPN-PROPN,ADJ,compound-conj,amod,NNP-NNP,JJ,2,1
3510,7146.0,49,said,32,29,25,-4,28,23,3,-7,Chunghwa Telecom,Ho Cheng-tan,ORGANIZATION-ORGANIZATION,PERSON-PERSON,PROPN-PROPN,PROPN-PROPN,compound-compound,compound-appos,NNP-NNP,NNP-NNP,2,1
3511,7158.0,23,said,5,17,20,3,16,2,-12,15,Samsung,Sang Wan Lee,ORGANIZATION,PERSON-PERSON-PERSON,PROPN,PROPN-PROPN-PROPN,amod,compound-compound-appos,NNP,NNP-NNP-NNP,6,1
3512,7173.0,22,was,5,1,4,3,0,17,4,-1,Hubbard,Indiana,PERSON,STATE_OR_PROVINCE,PROPN,PROPN,nsubj,pobj,NNP,NNP,3,1
3513,7178.0,28,founded,1,4,15,11,3,12,-3,14,Multidisciplinary Association for Psychedelic Studies,1986,ORGANIZATION-ORGANIZATION-ORGANIZATION-ORGANIZATION-ORGANIZATION,DATE,PROPN-PROPN-ADP-PROPN-PROPN,NUM,compound-dobj-prep-compound-pobj,pobj,NNP-NNP-IN-NNP-NNPS,CD,2,1
3514,7182.0,37,joined,2,2,4,2,1,32,0,2,ANP,Pakistan 's coalition government,ORGANIZATION,ORGANIZATION-ORGANIZATION-ORGANIZATION-ORGANIZATION,PROPN,PROPN-PART-NOUN-NOUN,nsubj,poss-case-compound-dobj,NNP,NNP-POS-NN-NN,3,1
3515,7186.0,32,said,14,25,29,4,24,2,-11,15,International Crisis Group,Amman,ORGANIZATION-ORGANIZATION-ORGANIZATION,LOCATION,PROPN-PROPN-PROPN,PROPN,compound-compound-pobj,pobj,NNP-NNP-NNP,NNP,3,1
3516,7193.0,30,replaced,10,12,26,14,11,3,-2,16,Al Hubbard,Harvard Business School,PERSON-PERSON,ORGANIZATION-ORGANIZATION-ORGANIZATION,PROPN-PROPN,PROPN-PROPN-PROPN,compound-dobj,compound-compound-pobj,NNP-NNP,NNP-NNP-NNP,7,1
3517,7199.0,41,http://www.variety.com/index.asp?layout=print_story&articleid;=VR11179,7,26,23,-3,25,17,-19,16,Steve McPherson,ABC Entertainment,PERSON-PERSON,ORGANIZATION-ORGANIZATION,PROPN-PROPN,PROPN-PROPN,compound-appos,compound-compound,NNP-NNP,NNP-NNP,2,1
3518,9388.0,22,said,20,19,16,-3,18,5,1,-4,Steve McPherson,ABC Entertainment,PERSON-PERSON,ORGANIZATION-ORGANIZATION,PROPN-PROPN,PROPN-PROPN,compound-nsubj,compound-compound,NNP-NNP,NNP-NNP,4,1
3519,15584.0,14,seemed,1,8,5,-3,7,8,-7,4,Steve McPherson,ABC Entertainment,PERSON-PERSON,ORGANIZATION-ORGANIZATION,PROPN-PROPN,PROPN-PROPN,compound-dobj,compound-compound,NNP-NNP,NNP-NNP,2,1
3520,17618.0,34,said,9,1,7,6,0,26,8,-2,Steve McPherson,ABC Entertainment,PERSON-PERSON,ORGANIZATION-ORGANIZATION,PROPN-PROPN,PROPN-PROPN,compound-nsubj,compound-pobj,NNP-NNP,NNP-NNP,3,1
3521,28911.0,69,said,1,7,3,-4,6,65,-6,2,Steve McPherson,ABC Entertainment,PERSON-PERSON,ORGANIZATION-ORGANIZATION,PROPN-PROPN,PROPN-PROPN,compound-nsubj,compound-compound,NNP-NNP,NNP-NNP,3,1
3522,31160.0,46,cut,40,13,10,-3,12,35,27,-30,Steve McPherson,ABC Entertainment,PERSON-PERSON,ORGANIZATION-ORGANIZATION,PROPN-PROPN,PROPN-PROPN,compound-nsubj,compound-compound,NNP-NNP,NNP-NNP,2,1
3523,59491.0,41,said,18,1,5,4,0,35,17,-13,Steve McPherson,ABC Entertainment,PERSON-PERSON,ORGANIZATION-ORGANIZATION,PROPN-PROPN,PROPN-PROPN,compound-nsubj,compound-compound,NNP-NNP,NNP-NNP,2,1
3524,59829.0,48,had,3,45,42,-3,44,5,-42,39,Steve McPherson,ABC Entertainment,PERSON-PERSON,ORGANIZATION-ORGANIZATION,PROPN-PROPN,PROPN-PROPN,compound-nsubj,compound-compound,NNP-NNP,NNP-NNP,4,1
3525,62708.0,32,reported,4,17,14,-3,16,17,-13,10,Steve McPherson,ABC Entertainment,PERSON-PERSON,ORGANIZATION-ORGANIZATION,PROPN-PROPN,PROPN-PROPN,compound-dobj,compound-compound,NNP-NNP,NNP-NNP,2,1
3526,7204.0,16,founded,2,5,11,6,4,4,-3,9,Moro National Liberation Front,Philippines,ORGANIZATION-ORGANIZATION-ORGANIZATION-ORGANIZATION,COUNTRY,PROPN-PROPN-PROPN-PROPN,PROPN,compound-compound-compound-dobj,poss,NNP-NNP-NNP-NNP,NNPS,4,1
3527,49850.0,45,Established,0,12,35,23,11,9,-12,35,Moro National Liberation Front,Philippines,ORGANIZATION-ORGANIZATION-ORGANIZATION-ORGANIZATION,COUNTRY,PROPN-PROPN-PROPN-PROPN,PROPN,compound-compound-compound-conj,pobj,NNP-NNP-NNP-NNP,NNP,10,1
3528,7207.0,11,died,7,1,4,3,0,6,6,-3,Her,Coretta Scott King,PERSON,PERSON-PERSON-PERSON,DET,PROPN-PROPN-PROPN,poss,compound-compound-appos,PRP$,NNP-NNP-NNP,2,1
3529,7213.0,26,arrested,12,15,20,5,14,5,-3,8,Lashkar-e-Tayyeba,Lucknow,PERSON,CITY,PROPN,PROPN,compound,pobj,NNP,NNP,-1,1
3530,7216.0,20,considered,13,13,4,-9,12,15,0,-9,he,Methodist,PERSON,RELIGION,PRON,ADJ,nsubj,compound,PRP,JJ,3,1
3531,7229.0,34,said,8,4,7,3,3,26,4,-1,ConAgra,Stephanie Childs,ORGANIZATION,PERSON-PERSON,PROPN,PROPN-PROPN,nmod,compound-nsubj,NNP,NNP-NNP,2,1
3532,25688.0,29,said,16,4,18,14,3,10,12,2,ConAgra,Stephanie Childs,ORGANIZATION,PERSON-PERSON,PROPN,PROPN-PROPN,pobj,compound-nsubj,NNP,NNP-NNP,8,1
3533,29039.0,33,said,4,1,3,2,0,29,3,-1,ConAgra,Stephanie Childs,ORGANIZATION,PERSON-PERSON,PROPN,PROPN-PROPN,compound,compound-nsubj,NNP,NNP-NNP,1,1
3534,56584.0,26,said,4,1,3,2,0,22,3,-1,ConAgra,Stephanie Childs,ORGANIZATION,PERSON-PERSON,PROPN,PROPN-PROPN,compound,compound-nsubj,NNP,NNP-NNP,1,1
3535,60972.0,29,said,4,1,3,2,0,25,3,-1,ConAgra,Stephanie Childs,ORGANIZATION,PERSON-PERSON,PROPN,PROPN-PROPN,compound,compound-nsubj,NNP,NNP-NNP,1,1
3536,7230.0,37,asserted,11,16,28,12,15,8,-5,17,KGB,Russia,ORGANIZATION,COUNTRY,PROPN,PROPN,compound,dobj,NNP,NNP,1,1
3537,17747.0,36,sentenced,19,6,14,8,5,21,13,-5,KGB,Russia,ORGANIZATION,COUNTRY,PROPN,PROPN,compound,poss,NNP,NNP,5,1
3538,27533.0,29,said,27,8,3,-5,7,25,19,-24,KGB,Russia,ORGANIZATION,COUNTRY,PROPN,PROPN,compound,nsubj,NNP,NNP,3,1
3539,41172.0,20,run,15,19,11,-8,18,8,-4,-4,KGB,Russia,ORGANIZATION,COUNTRY,PROPN,PROPN,pobj,nsubj,NNP,NNP,4,1
3540,45747.0,26,said,16,15,3,-12,14,22,1,-13,KGB,Russia,ORGANIZATION,COUNTRY,PROPN,PROPN,pobj,poss,NNP,NNP,4,1
3541,55745.0,50,made,1,10,27,17,9,22,-9,26,KGB,Russia,ORGANIZATION,COUNTRY,PROPN,PROPN,compound,nsubj,NNP,NNP,6,1
3542,7238.0,29,represent,1,9,10,1,8,18,-8,9,Jerome Robbins,Robbins,PERSON-PERSON,PERSON,PROPN-PROPN,PROPN,compound-compound,poss,NNP-NNP,NNP,1,1
3543,7239.0,32,said,7,1,3,2,0,28,6,-4,Babyshambles,Adrian Hunter,ORGANIZATION,PERSON-PERSON,NOUN,PROPN-PROPN,compound,compound-appos,NNS,NNP-NNP,4,1
3544,7241.0,28,was,4,2,27,25,1,0,2,23,Jerome Robbins,choreographer,PERSON-PERSON,TITLE,PROPN-PROPN,NOUN,compound-compound,pobj,NNP-NNP,NN,-1,1
3545,20886.0,36,came,4,34,33,-1,33,2,-30,29,Jerome Robbins,choreographer,PERSON-PERSON,TITLE,PROPN-PROPN,NOUN,compound-conj,compound,NNP-NNP,NN,2,1
3546,45474.0,34,was,2,21,6,-15,20,27,-19,4,Jerome Robbins,choreographer,PERSON-PERSON,TITLE,PROPN-PROPN,NOUN,compound-pobj,attr,NNP-NNP,NN,6,1
3547,7245.0,30,said,19,14,21,7,13,8,5,2,JNF,Mike Nitzan,ORGANIZATION,PERSON-PERSON,PROPN,PROPN-PROPN,compound,compound-nsubj,NNP,NNP-NNP,8,1
3548,7251.0,49,suing,3,9,2,-7,8,46,-6,-1,Johnny Knoxville,actor,PERSON-PERSON,TITLE,PROPN-PROPN,NOUN,compound-dobj,nsubj,NNP-NNP,NN,3,1
3549,7258.0,59,concentrated,19,8,12,4,7,46,11,-7,American Bar Association,Standing Committee on Ethics and Professional Responsibility,ORGANIZATION-ORGANIZATION-ORGANIZATION,ORGANIZATION-ORGANIZATION-ORGANIZATION-ORGANIZATION-ORGANIZATION-ORGANIZATION-ORGANIZATION,PROPN-PROPN-PROPN,PROPN-PROPN-ADP-PROPN-CCONJ-PROPN-PROPN,compound-compound-poss,compound-pobj-prep-pobj-cc-compound-conj,NNP-NNP-NNP,NNP-NNP-IN-NNP-CC-NNP-NNP,2,1
3550,7260.0,29,are,2,12,17,5,11,11,-10,15,Focus on the Family,James C Dobson,ORGANIZATION-ORGANIZATION-ORGANIZATION-ORGANIZATION,PERSON-PERSON-PERSON,PROPN-ADP-DET-PROPN,PROPN-PROPN-PROPN,ROOT-prep-det-compound,compound-compound-nsubj,NNP-IN-DT-NNP,NNP-NNP-NNP,2,1
3551,12234.0,36,2009-11-02T00,0,3,8,5,2,27,-3,8,Focus on the Family,James C Dobson,ORGANIZATION-ORGANIZATION-ORGANIZATION-ORGANIZATION,PERSON-PERSON-PERSON,PROPN-ADP-DET-PROPN,PROPN-PROPN-PROPN,nsubj-prep-det-compound,compound-compound-pobj,NNP-IN-DT-NNP,NNP-NNP-NNP,4,1
3552,7264.0,19,was,9,9,12,3,8,6,0,3,Buse,director,PERSON,TITLE,PROPN,NOUN,nsubj,attr,NNP,NN,2,1
3553,7267.0,45,said,31,43,33,-10,42,11,-12,2,MF Global,John Kilduff,ORGANIZATION-ORGANIZATION,PERSON-PERSON,PROPN-PROPN,PROPN-PROPN,compound-pobj,compound-nsubj,NNP-NNP,NNP-NNP,4,1
3554,13043.0,38,says,12,10,1,-9,9,36,2,-11,MF Global,John Kilduff,ORGANIZATION-ORGANIZATION,PERSON-PERSON,PROPN-PROPN,PROPN-PROPN,compound-pobj,compound-nsubj,NNP-NNP,NNP-NNP,3,1
3555,19630.0,22,said,5,4,1,-3,3,20,1,-4,MF Global,John Kilduff,ORGANIZATION-ORGANIZATION,PERSON-PERSON,PROPN-PROPN,PROPN-PROPN,compound-pobj,compound-nsubj,NNP-NNP,NNP-NNP,2,1
3556,26637.0,30,said,23,28,25,-3,27,4,-5,2,MF Global,John Kilduff,ORGANIZATION-ORGANIZATION,PERSON-PERSON,PROPN-PROPN,PROPN-PROPN,compound-pobj,compound-nsubj,NNP-NNP,NNP-NNP,4,1
3557,36785.0,30,said,20,28,22,-6,27,7,-8,2,MF Global,John Kilduff,ORGANIZATION-ORGANIZATION,PERSON-PERSON,PROPN-PROPN,PROPN-PROPN,compound-pobj,compound-nsubj,NNP-NNP,NNP-NNP,5,1
3558,42115.0,47,joked,45,41,44,3,40,2,4,-1,MF Global,John Kilduff,ORGANIZATION-ORGANIZATION,PERSON-PERSON,PROPN-PROPN,PROPN-PROPN,compound-poss,compound-nsubj,NNP-NNP,NNP-NNP,3,1
3559,45383.0,35,found,28,23,14,-9,22,20,5,-14,MF Global,John Kilduff,ORGANIZATION-ORGANIZATION,PERSON-PERSON,PROPN-PROPN,PROPN-PROPN,compound-pobj,compound-conj,NNP-NNP,NNP-NNP,6,1
3560,52063.0,19,said,10,17,12,-5,16,6,-7,2,MF Global,John Kilduff,ORGANIZATION-ORGANIZATION,PERSON-PERSON,PROPN-PROPN,PROPN-PROPN,compound-pobj,compound-nsubj,NNP-NNP,NNP-NNP,3,1
3561,52622.0,43,said,5,4,1,-3,3,41,1,-4,MF Global,John Kilduff,ORGANIZATION-ORGANIZATION,PERSON-PERSON,PROPN-PROPN,PROPN-PROPN,compound-pobj,compound-nsubj,NNP-NNP,NNP-NNP,2,1
3562,7270.0,57,Before,0,19,18,-1,18,38,-19,18,Bryan Fuller,writer,PERSON-PERSON,TITLE,PROPN-PROPN,NOUN,compound-nsubj,conj,NNP-NNP,NN,2,1
3563,14913.0,62,APRIL,0,6,12,6,5,49,-6,12,Bryan Fuller,writer,PERSON-PERSON,TITLE,PROPN-PROPN,NOUN,compound-nsubj,appos,NNP-NNP,NN,2,1
3564,28057.0,52,Mahandra,0,15,19,4,14,32,-15,19,Bryan Fuller,writer,PERSON-PERSON,TITLE,PROPN-PROPN,NOUN,compound-nsubj,appos,NNP-NNP,NN,2,1
3565,34660.0,15,reveals,4,3,2,-1,2,12,1,-2,Bryan Fuller,writer,PERSON-PERSON,TITLE,PROPN-PROPN,VERB,compound-nsubj,compound,NNP-NNP,VBP,1,1
3566,48338.0,49,believed,3,47,46,-1,46,2,-44,43,Bryan Fuller,writer,PERSON-PERSON,TITLE,PROPN-PROPN,NOUN,compound-dobj,compound,NNP-NNP,NN,5,1
3567,52177.0,53,'s,1,13,19,6,12,33,-12,18,Bryan Fuller,writer,PERSON-PERSON,TITLE,PROPN-PROPN,NOUN,compound-compound,appos,NNP-NNP,NN,-1,1
3568,60345.0,42,Well-received,0,11,10,-1,10,31,-11,10,Bryan Fuller,writer,PERSON-PERSON,TITLE,PROPN-PROPN,NOUN,compound-nsubj,compound,NNP-NNP,NN,1,1
3569,7272.0,25,Works,4,3,7,4,2,17,1,3,First Automobile Works,FAW,ORGANIZATION-ORGANIZATION-ORGANIZATION,ORGANIZATION,PROPN-PROPN-PROPN,PROPN,compound-compound-ROOT,compound,NNP-NNP-NNPS,NNP,2,1
3570,14949.0,43,sellers,3,16,20,4,15,22,-13,17,First Automobile Works,FAW,ORGANIZATION-ORGANIZATION-ORGANIZATION,ORGANIZATION,PROPN-PROPN-PROPN,PROPN,compound-compound-appos,compound,NNP-NNP-NNPS,NNP,2,1
3571,27592.0,54,produced,4,23,27,4,22,26,-19,23,First Automobile Works,FAW,ORGANIZATION-ORGANIZATION-ORGANIZATION,ORGANIZATION,PROPN-PROPN-PROPN,PROPN,compound-compound-appos,compound,NNP-NNP-NNPS,NNP,-1,1
3572,52375.0,41,said,38,1,6,5,0,34,37,-32,First Automobile Works,FAW,ORGANIZATION-ORGANIZATION-ORGANIZATION,ORGANIZATION,PROPN-PROPN-PROPN,PROPN,compound-compound-nsubj,conj,NNP-NNP-NNPS,NNP,2,1
3573,61214.0,47,were,1,11,15,4,10,31,-10,14,First Automobile Works,FAW,ORGANIZATION-ORGANIZATION-ORGANIZATION,ORGANIZATION,PROPN-PROPN-PROPN,PROPN,compound-compound-appos,compound,NNP-NNP-NNPS,NNP,-1,1
3574,7273.0,41,is,2,37,26,-11,36,14,-35,24,his,General,PERSON,TITLE,DET,PROPN,poss,oprd,PRP$,NNP,4,1
3575,7277.0,41,is,1,28,25,-3,27,15,-27,24,Alcatel,Serge Tchuruk,ORGANIZATION,PERSON-PERSON,PROPN,PROPN-PROPN,pobj,compound-appos,NNP,NNP-NNP,4,1
3576,33938.0,29,named,10,25,27,2,24,1,-15,17,Alcatel,Serge Tchuruk,ORGANIZATION,PERSON-PERSON,PROPN,PROPN-PROPN,compound,compound-dobj,NNP,NNP-NNP,5,1
3577,7284.0,56,reshaped,7,7,36,29,6,19,0,29,Washburn,Charles River,PERSON,LOCATION-LOCATION,PROPN,PROPN-PROPN,nsubj,compound-pobj,NNP,NNP-NNP,5,1
3578,7289.0,25,is,12,1,1,0,0,23,11,-11,Carnival Cruise Lines,Carnival Corporation,ORGANIZATION-ORGANIZATION-ORGANIZATION,ORGANIZATION-ORGANIZATION,PROPN-PROPN-PROPN,PROPN-PROPN,compound-compound-nsubj,compound-pobj,NNP-NNP-NNPS,NNP-NNP,0,1
3579,45697.0,34,Lines,2,1,1,0,0,32,1,-1,Carnival Cruise Lines,Carnival Corporation,ORGANIZATION-ORGANIZATION-ORGANIZATION,ORGANIZATION-ORGANIZATION,PROPN-PROPN-PROPN,PROPN-PROPN,compound-compound-ROOT,compound-pobj,NNP-NNP-NNPS,NNP-NNP,0,1
3580,7294.0,33,began,9,11,8,-3,10,24,-2,-1,his,42-year-old,PERSON,DURATION,DET,NUM,poss,compound,PRP$,CD,2,1
3581,7297.0,32,hometown,1,1,6,5,0,25,0,5,Her,Scotland,PERSON,COUNTRY,DET,PROPN,poss,appos,PRP$,NNP,3,1
3582,7311.0,16,were,5,5,3,-2,4,12,0,-2,Blackburn,1875,ORGANIZATION,DATE,PROPN,NUM,nsubj,pobj,NNP,CD,1,1
3583,7312.0,47,URGENT,0,43,42,-1,42,4,-43,42,Chris Dodd,chairman,PERSON-PERSON,TITLE,PROPN-PROPN,NOUN,compound-nsubj,compound,NNP-NNP,NN,1,1
3584,29207.0,21,lamented,11,2,5,3,1,15,9,-6,Chris Dodd,chairman,PERSON-PERSON,TITLE,PROPN-PROPN,NOUN,compound-nsubj,appos,NNP-NNP,NN,2,1
3585,64376.0,36,said,6,5,4,-1,4,31,1,-2,Chris Dodd,chairman,PERSON-PERSON,TITLE,PROPN-PROPN,NOUN,compound-nsubj,compound,NNP-NNP,NN,1,1
3586,7319.0,20,shows,11,9,3,-6,8,16,2,-8,Paul Watson,President,PERSON-PERSON,TITLE,PROPN-PROPN,PROPN,compound-appos,conj,NNP-NNP,NNP,3,1
3587,7843.0,26,said,14,17,22,5,16,3,-3,8,Paul Watson,President,PERSON-PERSON,TITLE,PROPN-PROPN,PROPN,compound-nsubj,conj,NNP-NNP,NNP,3,1
3588,56659.0,51,Master,4,3,12,9,2,38,1,8,Paul Watson,President,PERSON-PERSON,TITLE,PROPN-PROPN,PROPN,compound-compound,conj,NNP-NNP,NNP,5,1
3589,60043.0,12,Commentary,0,3,7,4,2,4,-3,7,Paul Watson,President,PERSON-PERSON,TITLE,PROPN-PROPN,PROPN,compound-compound,conj,NNP-NNP,NNP,3,1
3590,7328.0,49,opposes,22,46,14,-32,45,34,-24,-8,Chen,Nationalist Party,PERSON,ORGANIZATION-ORGANIZATION,PROPN,PROPN-PROPN,nsubj,compound-dobj,NNP,NNP-NNP,11,1
3591,7337.0,22,reported,20,1,15,14,0,6,19,-5,His,Susan Jefferson,PERSON,PERSON-PERSON,DET,PROPN-PROPN,poss,compound-appos,PRP$,NNP-NNP,3,1
3592,7341.0,69,include,5,23,59,36,22,9,-18,54,Jennifer Dunn,chairman,PERSON-PERSON,TITLE,PROPN-PROPN,NOUN,compound-conj,appos,NNP-NNP,NN,5,1
3593,7361.0,58,said,46,12,48,36,11,9,34,2,National Military Family Association,Patricia Barron,ORGANIZATION-ORGANIZATION-ORGANIZATION-ORGANIZATION,PERSON-PERSON,PROPN-PROPN-PROPN-PROPN,PROPN-PROPN,compound-compound-compound-pobj,compound-nsubj,NNP-NNP-NNP-NNP,NNP-NNP,11,1
3594,7371.0,46,Wife,3,9,12,3,8,33,-6,9,USA Network,Debra Messing,ORGANIZATION-ORGANIZATION,ORGANIZATION-ORGANIZATION,PROPN-PROPN,PROPN-PROPN,compound-appos,compound-ROOT,NNP-NNP,NNP-NNP,4,1
3595,48906.0,47,be,7,15,11,-4,14,35,-8,4,USA Network,Debra Messing,ORGANIZATION-ORGANIZATION,PERSON-PERSON,PROPN-PROPN,PROPN-PROPN,compound-compound,compound-poss,NNP-NNP,NNP-NNP,2,1
3596,66957.0,31,is,8,10,29,19,9,1,-2,21,USA Network,Debra Messing,ORGANIZATION-ORGANIZATION,ORGANIZATION-ORGANIZATION,PROPN-PROPN,PROPN-PROPN,compound-poss,compound-dobj,NNP-NNP,NNP-NNP,5,1
3597,7394.0,37,be,10,22,34,12,21,2,-12,24,Golden Baseball League,Victoria,ORGANIZATION-ORGANIZATION-ORGANIZATION,CITY,PROPN-PROPN-PROPN,PROPN,compound-compound-conj,conj,NNP-NNP-NNP,NNP,7,1
3598,7396.0,44,helped,25,25,11,-14,24,32,0,-14,he,operations officer,PERSON,TITLE-TITLE,PRON,NOUN-NOUN,nsubj,compound-pobj,PRP,NNS-NN,3,1
3599,7399.0,49,acquired,7,5,3,-2,4,45,2,-4,Jackson Hewitt,1982,ORGANIZATION-ORGANIZATION,DATE,PROPN-PROPN,NUM,compound-nsubjpass,pobj,NNP-NNP,CD,2,1
3600,7405.0,27,said,16,3,6,3,2,20,13,-10,Mahmood Shah,secretary for security affairs,PERSON-PERSON,TITLE-TITLE-TITLE-TITLE,PROPN-PROPN,NOUN-ADP-NOUN-NOUN,compound-nsubj,appos-prep-compound-pobj,NNP-NNP,NN-IN-NN-NNS,2,1
3601,7423.0,69,confirmed,9,13,17,4,12,51,-4,8,American Psychiatric Association,APA,ORGANIZATION-ORGANIZATION-ORGANIZATION,ORGANIZATION,PROPN-PROPN-PROPN,PROPN,compound-compound-nsubj,compound,NNP-NNP-NNP,NNP,2,1
3602,40679.0,29,alleged,2,12,10,-2,11,18,-10,8,American Psychiatric Association,APA,ORGANIZATION-ORGANIZATION-ORGANIZATION,ORGANIZATION,PROPN-PROPN-PROPN,PROPN,compound-compound-compound,compound,NNP-NNP-NNP,NNP,3,1
3603,47225.0,46,sent,19,25,30,5,24,15,-6,11,American Psychiatric Association,APA,ORGANIZATION-ORGANIZATION-ORGANIZATION,ORGANIZATION,PROPN-PROPN-PROPN,PROPN,compound-compound-pobj,compound,NNP-NNP-NNP,NNP,5,1
3604,7429.0,40,said,19,28,22,-6,27,17,-9,3,National Center for Disaster Preparedness,Irwin Redlener,ORGANIZATION-ORGANIZATION-ORGANIZATION-ORGANIZATION-ORGANIZATION,PERSON-PERSON,PROPN-PROPN-ADP-PROPN-PROPN,PROPN-PROPN,compound-pobj-prep-compound-pobj,compound-nsubj,NNP-NNP-IN-NNP-NNP,NNP-NNP,3,1
3605,9415.0,46,told,25,20,2,-18,19,43,5,-23,National Center for Disaster Preparedness,Irwin Redlener,ORGANIZATION-ORGANIZATION-ORGANIZATION-ORGANIZATION-ORGANIZATION,PERSON-PERSON,PROPN-PROPN-ADP-PROPN-PROPN,PROPN-PROPN,compound-pobj-prep-compound-pobj,compound-nsubj,NNP-NNP-IN-NNP-NNP,NNP-NNP,4,1
3606,12630.0,27,said,11,19,13,-6,18,13,-8,2,National Center for Disaster Preparedness,Irwin Redlener,ORGANIZATION-ORGANIZATION-ORGANIZATION-ORGANIZATION-ORGANIZATION,PERSON-PERSON,PROPN-PROPN-ADP-PROPN-PROPN,PROPN-PROPN,compound-pobj-prep-compound-pobj,compound-nsubj,NNP-NNP-IN-NNP-NNP,NNP-NNP,3,1
3607,16141.0,45,said,36,22,2,-20,21,42,14,-34,National Center for Disaster Preparedness,Irwin Redlener,ORGANIZATION-ORGANIZATION-ORGANIZATION-ORGANIZATION-ORGANIZATION,PERSON-PERSON,PROPN-PROPN-ADP-PROPN-PROPN,PROPN-PROPN,compound-pobj-prep-compound-pobj,compound-nsubj,NNP-NNP-IN-NNP-NNP,NNP-NNP,7,1
3608,16684.0,38,said,15,23,17,-6,22,20,-8,2,National Center for Disaster Preparedness,Irwin Redlener,ORGANIZATION-ORGANIZATION-ORGANIZATION-ORGANIZATION-ORGANIZATION,PERSON-PERSON,PROPN-PROPN-ADP-PROPN-PROPN,PROPN-PROPN,compound-pobj-prep-compound-pobj,compound-nsubj,NNP-NNP-IN-NNP-NNP,NNP-NNP,5,1
3609,20781.0,53,said,26,9,2,-7,8,50,17,-24,National Center for Disaster Preparedness,Irwin Redlener,ORGANIZATION-ORGANIZATION-ORGANIZATION-ORGANIZATION-ORGANIZATION,PERSON-PERSON,PROPN-PROPN-ADP-PROPN-PROPN,PROPN-PROPN,compound-pobj-prep-compound-pobj,compound-nsubj,NNP-NNP-IN-NNP-NNP,NNP-NNP,3,1
3610,21966.0,52,said,31,39,33,-6,38,18,-8,2,National Center for Disaster Preparedness,Irwin Redlener,ORGANIZATION-ORGANIZATION-ORGANIZATION-ORGANIZATION-ORGANIZATION,PERSON-PERSON,PROPN-PROPN-ADP-PROPN-PROPN,PROPN-PROPN,compound-pobj-prep-compound-pobj,compound-nsubj,NNP-NNP-IN-NNP-NNP,NNP-NNP,5,1
3611,23061.0,49,said,16,30,19,-11,29,29,-14,3,National Center for Disaster Preparedness,Irwin Redlener,ORGANIZATION-ORGANIZATION-ORGANIZATION-ORGANIZATION-ORGANIZATION,PERSON-PERSON,PROPN-PROPN-ADP-PROPN-PROPN,PROPN-PROPN,compound-pobj-prep-compound-pobj,compound-nsubj,NNP-NNP-IN-NNP-NNP,NNP-NNP,6,1
3612,24999.0,31,said,14,22,16,-6,21,14,-8,2,National Center for Disaster Preparedness,Irwin Redlener,ORGANIZATION-ORGANIZATION-ORGANIZATION-ORGANIZATION-ORGANIZATION,PERSON-PERSON,PROPN-PROPN-ADP-PROPN-PROPN,PROPN-PROPN,compound-pobj-prep-compound-pobj,compound-nsubj,NNP-NNP-IN-NNP-NNP,NNP-NNP,5,1
3613,27805.0,35,said,16,27,18,-9,26,16,-11,2,National Center for Disaster Preparedness,Irwin Redlener,ORGANIZATION-ORGANIZATION-ORGANIZATION-ORGANIZATION-ORGANIZATION,PERSON-PERSON,PROPN-PROPN-ADP-PROPN-PROPN,PROPN-PROPN,compound-pobj-prep-compound-pobj,compound-nsubj,NNP-NNP-IN-NNP-NNP,NNP-NNP,5,1
3614,29640.0,45,said,21,38,24,-14,37,20,-17,3,National Center for Disaster Preparedness,Irwin Redlener,ORGANIZATION-ORGANIZATION-ORGANIZATION-ORGANIZATION-ORGANIZATION,PERSON-PERSON,PROPN-PROPN-ADP-PROPN-PROPN,PROPN-PROPN,compound-pobj-prep-compound-pobj,compound-nsubj,NNP-NNP-IN-NNP-NNP,NNP-NNP,6,1
3615,49733.0,34,said,9,18,12,-6,17,21,-9,3,National Center for Disaster Preparedness,Irwin Redlener,ORGANIZATION-ORGANIZATION-ORGANIZATION-ORGANIZATION-ORGANIZATION,PERSON-PERSON,PROPN-PROPN-ADP-PROPN-PROPN,PROPN-PROPN,compound-pobj-prep-compound-pobj,compound-nsubj,NNP-NNP-IN-NNP-NNP,NNP-NNP,5,1
3616,52791.0,57,said,20,28,22,-6,27,34,-8,2,National Center for Disaster Preparedness,Irwin Redlener,ORGANIZATION-ORGANIZATION-ORGANIZATION-ORGANIZATION-ORGANIZATION,PERSON-PERSON,PROPN-PROPN-ADP-PROPN-PROPN,PROPN-PROPN,compound-pobj-prep-compound-pobj,compound-nsubj,NNP-NNP-IN-NNP-NNP,NNP-NNP,5,1
3617,54245.0,34,said,9,18,12,-6,17,21,-9,3,National Center for Disaster Preparedness,Irwin Redlener,ORGANIZATION-ORGANIZATION-ORGANIZATION-ORGANIZATION-ORGANIZATION,PERSON-PERSON,PROPN-PROPN-ADP-PROPN-PROPN,PROPN-PROPN,compound-pobj-prep-compound-pobj,compound-nsubj,NNP-NNP-IN-NNP-NNP,NNP-NNP,5,1
3618,58535.0,25,said,8,17,11,-6,16,13,-9,3,National Center for Disaster Preparedness,Irwin Redlener,ORGANIZATION-ORGANIZATION-ORGANIZATION-ORGANIZATION-ORGANIZATION,PERSON-PERSON,PROPN-PROPN-ADP-PROPN-PROPN,PROPN-PROPN,compound-pobj-prep-compound-pobj,compound-nsubj,NNP-NNP-IN-NNP-NNP,NNP-NNP,5,1
3619,59252.0,50,said,27,36,30,-6,35,19,-9,3,National Center for Disaster Preparedness,Irwin Redlener,ORGANIZATION-ORGANIZATION-ORGANIZATION-ORGANIZATION-ORGANIZATION,PERSON-PERSON,PROPN-PROPN-ADP-PROPN-PROPN,PROPN-PROPN,compound-pobj-prep-compound-pobj,compound-nsubj,NNP-NNP-IN-NNP-NNP,NNP-NNP,5,1
3620,7432.0,27,said,16,3,6,3,2,20,13,-10,Mahmood Shah,secretary,PERSON-PERSON,TITLE,PROPN-PROPN,NOUN,compound-nsubj,appos,NNP-NNP,NN,2,1
3621,7446.0,53,said,51,30,9,-21,29,43,21,-42,FMF,Mexican Federation of Football,ORGANIZATION,ORGANIZATION-ORGANIZATION-ORGANIZATION-ORGANIZATION,PROPN,PROPN-PROPN-ADP-PROPN,compound,compound-pobj-prep-pobj,NNP,NNP-NNP-IN-NNP,7,1
3622,7452.0,35,recalled,10,16,20,4,15,14,-6,10,his,Clarence M. Mitchell Jr.,PERSON,PERSON-PERSON-PERSON-PERSON,DET,PROPN-PROPN-PROPN-PROPN,poss,compound-compound-compound-appos,PRP$,NNP-NNP-NNP-NNP,3,1
3623,7453.0,25,said,8,16,19,3,15,5,-8,11,Fuller,Fox,PERSON,ORGANIZATION,PROPN,PROPN,poss,compound,NNP,NNP,3,1
3624,7458.0,55,presented,14,42,51,9,41,3,-28,37,Manila Economic and Cultural Office,Taipei,ORGANIZATION-ORGANIZATION-ORGANIZATION-ORGANIZATION-ORGANIZATION,CITY,PROPN-PROPN-CCONJ-PROPN-PROPN,PROPN,nmod-nmod-cc-conj-pobj,pobj,NNP-NNP-CC-NNP-NNP,NNP,-1,1
3625,22652.0,35,appealed,12,2,11,9,1,23,10,-1,Manila Economic and Cultural Office,Taipei,ORGANIZATION-ORGANIZATION-ORGANIZATION-ORGANIZATION-ORGANIZATION,CITY,PROPN-PROPN-CCONJ-PROPN-PROPN,PROPN,nmod-nmod-cc-conj-compound,pobj,NNP-NNP-CC-NNP-NNP,NNP,-1,1
3626,37470.0,38,said,20,28,37,9,27,0,-8,17,Manila Economic and Cultural Office,Taipei,ORGANIZATION-ORGANIZATION-ORGANIZATION-ORGANIZATION-ORGANIZATION,COUNTRY,PROPN-PROPN-CCONJ-PROPN-PROPN,PROPN,nmod-nmod-cc-conj-pobj,pobj,NNP-NNP-CC-NNP-NNP,NNP,-1,1
3627,7459.0,16,say,3,8,14,6,7,1,-5,11,he,Nabors Industries,PERSON,ORGANIZATION-ORGANIZATION,PRON,PROPN-PROPN,nsubj,compound-appos,PRP,NNPS-NNP,3,1
3628,7465.0,4,was,1,1,3,2,0,0,0,2,She,90,PERSON,NUMBER,PRON,NUM,nsubj,attr,PRP,CD,1,1
3629,7470.0,41,had,1,14,11,-3,13,29,-13,10,Brian McFadden,Westlife,PERSON-PERSON,ORGANIZATION,PROPN-PROPN,NOUN,compound-appos,compound,NNP-NNP,NN,5,1
3630,24040.0,33,sung,6,9,31,22,8,1,-3,25,Brian McFadden,Westlife,PERSON-PERSON,ORGANIZATION,PROPN-PROPN,NOUN,compound-pobj,appos,NNP-NNP,NN,8,1
3631,44743.0,88,say,24,84,4,-80,83,83,-60,-20,Brian McFadden,Westlife,PERSON-PERSON,ORGANIZATION,PROPN-PROPN,NOUN,compound-nsubj,nsubj,NNP-NNP,NN,-1,1
3632,7479.0,33,announced,4,4,12,8,3,20,0,8,FirstGroup,Laidlaw International,ORGANIZATION,ORGANIZATION-ORGANIZATION,PROPN,PROPN-PROPN,nsubj,compound-pobj,NNP,NNP-NNP,3,1
3633,28346.0,37,operated,4,11,19,8,10,17,-7,15,FirstGroup,Laidlaw International,ORGANIZATION,ORGANIZATION-ORGANIZATION,PROPN,PROPN-PROPN,pobj,compound-appos,NNP,NNP-NNP,3,1
3634,29108.0,18,is,4,4,14,10,3,3,0,10,FirstGroup,Laidlaw International,ORGANIZATION,ORGANIZATION-ORGANIZATION,PROPN,PROPN-PROPN,nsubj,compound-dobj,NNP,NNP-NNP,3,1
3635,35785.0,49,said,37,7,5,-2,6,43,30,-32,FirstGroup,Laidlaw International,ORGANIZATION,ORGANIZATION-ORGANIZATION,PROPN,PROPN-PROPN,conj,compound-pobj,NNP,NNP-NNP,1,1
3636,37238.0,34,announced,11,11,18,7,10,15,0,7,FirstGroup,Laidlaw International,ORGANIZATION,ORGANIZATION-ORGANIZATION,PROPN,PROPN-PROPN,appos,compound-dobj,NNP,NNP-NNP,3,1
3637,7481.0,38,*,0,17,15,-2,16,22,-17,15,Beyonce Knowles,R&B star,PERSON-PERSON,TITLE-TITLE,PROPN-PROPN,PROPN-NOUN,compound-nsubj,compound-compound,NNP-NNP,NNP-NN,1,1
3638,7485.0,79,survived,8,7,57,50,6,21,1,49,Meskill,"Ruth Prior of Naples , Fla , and Sister Laura Marie of Portland , Conn",PERSON,PERSON-PERSON-PERSON-PERSON-PERSON-PERSON-PERSON-PERSON-PERSON-PERSON-PERSON-PERSON-PERSON-PERSON-PERSON,PROPN,PROPN-PROPN-ADP-PROPN-PUNCT-PROPN-PUNCT-CCONJ-PROPN-PROPN-PROPN-ADP-PROPN-PUNCT-PROPN,nsubjpass,compound-conj-prep-pobj-punct-conj-punct-cc-compound-compound-conj-prep-pobj-punct-appos,NNP,"NNP-NNP-IN-NNP-,-NNP-,-CC-NNP-NNP-NNP-IN-NNP-,-NNP",2,1
3639,7495.0,27,represented,4,23,14,-9,22,12,-19,10,he,Conn.,PERSON,STATE_OR_PROVINCE,PRON,PROPN,nsubj,appos,PRP,NNP,6,1
3640,7499.0,46,ruled,4,8,16,8,7,29,-4,12,JNF,Jewish,ORGANIZATION,RELIGION,PROPN,ADJ,pobj,amod,NNP,JJ,3,1
3641,42519.0,38,said,36,14,10,-4,13,27,22,-26,JNF,Jewish,ORGANIZATION,RELIGION,PROPN,ADJ,compound,amod,NNP,JJ,4,1
3642,7501.0,16,served,3,1,9,8,0,6,2,6,Yoadimnadji,president,PERSON,TITLE,NOUN,NOUN,nsubj,conj,NNS,NN,5,1
3643,7513.0,30,became,1,15,10,-5,14,19,-14,9,she,Congress,PERSON,ORGANIZATION,PRON,PROPN,nsubj,pobj,PRP,NNP,4,1
3644,7526.0,23,said,9,7,1,-6,6,21,2,-8,Medina hospital,Mohamed Mohamud,ORGANIZATION-ORGANIZATION,PERSON-PERSON,PROPN-NOUN,PROPN-PROPN,compound-pobj,compound-nsubj,NNP-NN,NNP-NNP,3,1
3645,7550.0,49,said,7,13,10,-3,12,38,-6,3,Hashim Ahmad al-Tai,Defense,PERSON-PERSON-PERSON,ORGANIZATION,PROPN-PROPN-X,PROPN,compound-nsubj-punct,compound,NNP-NNP-ADD,NNP,2,1
3646,15304.0,48,upheld,8,30,27,-3,29,20,-22,19,Hashim Ahmad al-Tai,Defense,PERSON-PERSON-PERSON,ORGANIZATION,PROPN-PROPN-X,PROPN,compound-subtok-punct,compound,NNP-NNP-ADD,NNP,3,1
3647,64917.0,29,was,7,13,10,-3,12,18,-6,3,Hashim Ahmad al-Tai,Defense,PERSON-PERSON-PERSON,ORGANIZATION,PROPN-PROPN-X,PROPN,compound-nsubj-punct,compound,NNP-NNP-ADD,NNP,4,1
3648,7555.0,38,DEROUNIAN,2,1,14,13,0,23,1,12,STEVEN B DEROUNIAN,Austin,PERSON-PERSON-PERSON,CITY,PROPN-PROPN-PROPN,PROPN,compound-compound-ROOT,pobj,NNP-NNP-NNP,NNP,4,1
3649,7562.0,21,elected,2,1,6,5,0,14,1,4,Mitchell,US,PERSON,COUNTRY,PROPN,PROPN,nsubjpass,compound,NNP,NNP,3,1
3650,7570.0,33,said,13,10,1,-9,9,31,3,-12,MBIA,James A. Lebenthal,ORGANIZATION,PERSON-PERSON-PERSON,PROPN,PROPN-PROPN-PROPN,compound,compound-compound-nsubj,NNP,NNP-NNP-NNP,4,1
3651,7578.0,32,survived,7,16,18,2,15,13,-9,11,Silvestre,Elva Corrales,PERSON,PERSON-PERSON,PROPN,PROPN-PROPN,appos,compound-conj,NNP,NNP-NNP,2,1
3652,7582.0,44,was,15,15,6,-9,14,37,0,-9,Mitchell,Congressional Black Caucus,PERSON,ORGANIZATION-ORGANIZATION-ORGANIZATION,PROPN,PROPN-PROPN-PROPN,appos,compound-compound-pobj,NNP,NNP-NNP-NNP,4,1
3653,26616.0,34,worked,18,18,6,-12,17,27,0,-12,Mitchell,Congressional Black Caucus,PERSON,ORGANIZATION-ORGANIZATION-ORGANIZATION,PROPN,PROPN-PROPN-PROPN,nsubj,compound-compound-pobj,NNP,NNP-NNP-NNP,4,1
3654,7585.0,26,invited,3,21,1,-20,20,24,-18,-2,her,Scary Boss Lady,PERSON,PERSON-PERSON-PERSON,PRON,PROPN-PROPN-PROPN,dobj,compound-compound-nsubj,PRP,NNP-NNP-NNP,5,1
3655,7596.0,45,became,9,7,6,-1,6,38,2,-3,Nolte,Charles Nolte,PERSON,PERSON-PERSON,PROPN,PROPN-PROPN,nsubj,compound-appos,NNP,NNP-NNP,5,1
3656,7601.0,54,said,15,6,30,24,5,23,9,15,FEC,he,ORGANIZATION,PERSON,PROPN,PRON,compound,nsubj,NNP,PRP,6,1
3657,7604.0,44,spoke,6,20,18,-2,19,25,-14,12,Teddy Kollek,mayor,PERSON-PERSON,TITLE,PROPN-PROPN,NOUN,compound-appos,pobj,NNP-NNP,NN,2,1
3658,7723.0,45,died,37,1,6,5,0,38,36,-31,Teddy Kollek,mayor,PERSON-PERSON,TITLE,PROPN-PROPN,NOUN,compound-nsubj,appos,NNP-NNP,NN,3,1
3659,21034.0,35,died,32,1,8,7,0,26,31,-24,Teddy Kollek,mayor,PERSON-PERSON,TITLE,PROPN-PROPN,NOUN,compound-nsubj,appos,NNP-NNP,NN,2,1
3660,41039.0,11,dies,8,1,5,4,0,5,7,-3,Teddy Kollek,mayor,PERSON-PERSON,TITLE,PROPN-PROPN,NOUN,compound-nsubj,appos,NNP-NNP,NN,2,1
3661,45870.0,15,JERUSALEM,0,3,8,5,2,6,-3,8,Teddy Kollek,mayor,PERSON-PERSON,TITLE,PROPN-PROPN,NOUN,compound-nsubj,appos,NNP-NNP,NN,2,1
3662,50629.0,56,consulted,13,33,32,-1,32,23,-20,19,Teddy Kollek,mayor,PERSON-PERSON,TITLE,PROPN-PROPN,NOUN,compound-pobj,conj,NNP-NNP,NN,1,1
3663,53195.0,42,bring,9,27,26,-1,26,15,-18,17,Teddy Kollek,mayor,PERSON-PERSON,TITLE,PROPN-PROPN,NOUN,compound-appos,pobj,NNP-NNP,NN,2,1
3664,60617.0,35,NY-HOTLINE-MISTAKES,0,21,26,5,20,8,-21,26,Teddy Kollek,mayor,PERSON-PERSON,TITLE,PROPN-PROPN,NOUN,compound-pobj,appos,NNP-NNP,NN,5,1
3665,7606.0,26,include,2,4,20,16,3,5,-2,18,his,Janice Denny,PERSON,PERSON-PERSON,DET,PROPN-PROPN,poss,compound-conj,PRP$,NNP-NNP,2,1
3666,31083.0,30,survived,2,5,21,16,4,8,-3,19,his,Janice Denny,PERSON,PERSON-PERSON,DET,PROPN-PROPN,poss,compound-appos,PRP$,NNP-NNP,2,1
3667,7611.0,13,took,7,7,9,2,6,3,0,2,he,command,PERSON,TITLE,PRON,NOUN,nsubj,dobj,PRP,NN,2,1
3668,7625.0,20,received,8,8,18,10,7,1,0,10,she,Queens College,PERSON,ORGANIZATION-ORGANIZATION,PRON,PROPN-PROPN,nsubj,compound-pobj,PRP,NNP-NNP,4,1
3669,56022.0,33,received,5,5,31,26,4,1,0,26,she,Queens College,PERSON,ORGANIZATION-ORGANIZATION,PRON,PROPN-PROPN,nsubj,compound-pobj,PRP,NNP-NNP,5,1
3670,7633.0,34,received,3,32,30,-2,31,3,-29,27,George Young,parliament,PERSON-PERSON,ORGANIZATION,PROPN-PROPN,NOUN,compound-pobj,compound,NNP-NNP,NN,2,1
3671,35927.0,37,received,3,35,30,-5,34,6,-32,27,George Young,parliament,PERSON-PERSON,ORGANIZATION,PROPN-PROPN,NOUN,compound-ROOT,pobj,NNP-NNP,NN,7,1
3672,54998.0,37,said,14,16,34,18,15,2,-2,20,George Young,parliament,PERSON-PERSON,ORGANIZATION,PROPN-PROPN,NOUN,compound-nsubj,poss,NNP-NNP,NN,6,1
3673,7634.0,54,were,19,46,10,-36,45,43,-27,-9,he,California,PERSON,STATE_OR_PROVINCE,PRON,PROPN,nsubj,compound,PRP,NNP,5,1
3674,32940.0,24,attended,17,13,5,-8,12,18,4,-12,he,California,PERSON,STATE_OR_PROVINCE,PRON,PROPN,nsubj,pobj,PRP,NNP,4,1
3675,62904.0,24,attended,17,13,5,-8,12,18,4,-12,he,California,PERSON,STATE_OR_PROVINCE,PRON,PROPN,nsubj,pobj,PRP,NNP,4,1
3676,7644.0,41,said,35,25,21,-4,24,19,10,-14,Chunghwa Telecom,Taiwan,ORGANIZATION-ORGANIZATION,COUNTRY,PROPN-PROPN,PROPN,compound-nsubj,poss,NNP-NNP,NNP,6,1
3677,12968.0,47,began,7,6,1,-5,5,45,1,-6,Chunghwa Telecom,Taiwan,ORGANIZATION-ORGANIZATION,COUNTRY,PROPN-PROPN,PROPN,compound-nsubj,poss,NNP-NNP,NNP,3,1
3678,14664.0,46,said,43,3,1,-2,2,44,40,-42,Chunghwa Telecom,Taiwan,ORGANIZATION-ORGANIZATION,STATE_OR_PROVINCE,PROPN-PROPN,PROPN,compound-compound,poss,NNP-NNP,NNP,3,1
3679,16657.0,38,announced,14,24,27,3,23,10,-10,13,Chunghwa Telecom,Taiwan,ORGANIZATION-ORGANIZATION,COUNTRY,PROPN-PROPN,PROPN,compound-pobj,poss,NNP-NNP,NNP,2,1
3680,22290.0,44,said,22,11,2,-9,10,41,11,-20,Chunghwa Telecom,Taiwan,ORGANIZATION-ORGANIZATION,STATE_OR_PROVINCE,PROPN-PROPN,PROPN,compound-nsubj,poss,NNP-NNP,NNP,5,1
3681,23177.0,50,said,47,1,4,3,0,45,46,-43,Chunghwa Telecom,Taiwan,ORGANIZATION-ORGANIZATION,COUNTRY,PROPN-PROPN,PROPN,compound-poss,poss,NNP-NNP,NNP,3,1
3682,28709.0,41,said,35,25,21,-4,24,19,10,-14,Chunghwa Telecom,Taiwan,ORGANIZATION-ORGANIZATION,COUNTRY,PROPN-PROPN,PROPN,compound-nsubj,pobj,NNP-NNP,NNP,6,1
3683,31043.0,50,set,9,34,32,-2,33,17,-25,23,Chunghwa Telecom,Taiwan,ORGANIZATION-ORGANIZATION,STATE_OR_PROVINCE,PROPN-PROPN,PROPN,compound-conj,poss,NNP-NNP,NNP,4,1
3684,33534.0,31,said,10,1,5,4,0,25,9,-5,Chunghwa Telecom,Taiwan,ORGANIZATION-ORGANIZATION,COUNTRY,PROPN-PROPN,PROPN,compound-compound,poss,NNP-NNP,NNP,4,1
3685,36857.0,30,made,21,19,13,-6,18,16,2,-8,Chunghwa Telecom,Taiwan,ORGANIZATION-ORGANIZATION,COUNTRY,PROPN-PROPN,PROPN,compound-appos,poss,NNP-NNP,NNP,2,1
3686,40045.0,44,is,2,12,9,-3,11,34,-10,7,Chunghwa Telecom,Taiwan,ORGANIZATION-ORGANIZATION,COUNTRY,PROPN-PROPN,PROPN,compound-compound,pobj,NNP-NNP,NNP,5,1
3687,46172.0,20,established,12,11,9,-2,10,10,1,-3,Chunghwa Telecom,Taiwan,ORGANIZATION-ORGANIZATION,COUNTRY,PROPN-PROPN,PROPN,compound-conj,poss,NNP-NNP,NNP,2,1
3688,47181.0,10,set,5,3,1,-2,2,8,2,-4,Chunghwa Telecom,Taiwan,ORGANIZATION-ORGANIZATION,COUNTRY,PROPN-PROPN,PROPN,compound-nsubj,poss,NNP-NNP,NNP,2,1
3689,49083.0,30,totaled,15,3,1,-2,2,28,12,-14,Chunghwa Telecom,Taiwan,ORGANIZATION-ORGANIZATION,STATE_OR_PROVINCE,PROPN-PROPN,PROPN,compound-nsubj,poss,NNP-NNP,NNP,2,1
3690,52648.0,30,totaled,15,3,1,-2,2,28,12,-14,Chunghwa Telecom,Taiwan,ORGANIZATION-ORGANIZATION,CITY,PROPN-PROPN,PROPN,compound-compound,poss,NNP-NNP,NNP,2,1
3691,57867.0,50,set,9,34,32,-2,33,17,-25,23,Chunghwa Telecom,Taiwan,ORGANIZATION-ORGANIZATION,CITY,PROPN-PROPN,PROPN,compound-conj,conj,NNP-NNP,NNP,4,1
3692,67789.0,22,said,5,1,12,11,0,9,4,7,Chunghwa Telecom,Taiwan,ORGANIZATION-ORGANIZATION,COUNTRY,PROPN-PROPN,PROPN,compound-compound,nsubj,NNP-NNP,NNP,5,1
3693,7647.0,32,reveals,8,14,11,-3,13,20,-6,3,Spencer Pratt,Heidi,PERSON-PERSON,PERSON,PROPN-PROPN,PROPN,compound-conj,nsubj,NNP-NNP,NNP,2,1
3694,31069.0,9,Heidi,0,3,1,-2,2,7,-3,1,Spencer Pratt,Heidi,PERSON-PERSON,PERSON,PROPN-PROPN,PROPN,compound-nsubj,ROOT,NNP-NNP,NNP,4,1
3695,53740.0,31,arrived,9,7,22,15,6,8,2,13,Spencer Pratt,Heidi,PERSON-PERSON,PERSON,PROPN-PROPN,PROPN,compound-appos,nsubj,NNP-NNP,NNP,-1,1
3696,63393.0,21,spotted,14,11,6,-5,10,14,3,-8,Spencer Pratt,Heidi,PERSON-PERSON,PERSON,PROPN-PROPN,PROPN,compound-appos,nsubjpass,NNP-NNP,NNP,3,1
3697,7651.0,35,said,6,8,4,-4,7,30,-2,-2,Remy Smith,New York City,PERSON-PERSON,CITY-CITY-CITY,PROPN-PROPN,PROPN-PROPN-PROPN,compound-attr,compound-compound-pobj,NNP-NNP,NNP-NNP-NNP,6,1
3698,7655.0,34,studied,4,4,12,8,3,21,0,8,he,Balliol College,PERSON,ORGANIZATION-ORGANIZATION,PRON,PROPN-PROPN,nsubj,compound-pobj,PRP,NNP-NNP,3,1
3699,7657.0,24,is,11,1,10,9,0,13,10,-1,Glover,Venezuela,PERSON,COUNTRY,PROPN,PROPN,nsubj,pobj,NNP,NNP,3,1
3700,38361.0,20,is,1,1,7,6,0,12,0,6,Glover,Venezuela,PERSON,COUNTRY,PROPN,PROPN,nsubj,poss,NNP,NNP,5,1
3701,7670.0,42,was,17,1,35,34,0,6,16,18,Buse,Cablevision,PERSON,ORGANIZATION,PROPN,PROPN,nsubj,conj,NNP,NNP,7,1
3702,7679.0,37,attributed,2,1,1,0,0,35,1,-1,NEC,NEC Tokin Corp,ORGANIZATION,ORGANIZATION-ORGANIZATION-ORGANIZATION,PROPN,PROPN-PROPN-PROPN,nsubj,compound-compound-appos,NNP,NNP-NNP-NNP,0,1
3703,54627.0,36,TOKYO,0,9,9,0,8,26,-9,9,NEC,NEC Tokin Corp,ORGANIZATION,ORGANIZATION-ORGANIZATION-ORGANIZATION,PROPN,PROPN-PROPN-PROPN,pobj,compound-compound-nsubj,NNP,NNP-NNP-NNP,0,1
3704,7681.0,44,Lan,1,7,7,0,6,36,-6,6,Tianjin Lions,Tianjin,ORGANIZATION-ORGANIZATION,CITY,PROPN-PROPN,PROPN,compound-pobj,pobj,NNP-NNP,NNP,0,1
3705,7684.0,25,founded,4,4,9,5,3,15,0,5,he,National Environmental Trust,PERSON,ORGANIZATION-ORGANIZATION-ORGANIZATION,PRON,PROPN-PROPN-PROPN,nsubj,compound-compound-dobj,PRP,NNP-NNP-NNP,3,1
3706,7689.0,31,ran,20,9,25,16,8,5,11,5,Anderson,Tennessee,PERSON,STATE_OR_PROVINCE,PROPN,PROPN,nsubj,pobj,NNP,NNP,2,1
3707,7694.0,46,rates,34,6,2,-4,5,43,28,-32,Zagat,New York City,PERSON,CITY-CITY-CITY,PROPN,PROPN-PROPN-PROPN,poss,compound-compound-pobj,NNP,NNP-NNP-NNP,4,1
3708,7717.0,23,said,6,1,5,4,0,17,5,-1,Chunghwa,Lee Yen-sung,ORGANIZATION,PERSON-PERSON,PROPN,PROPN-PROPN,compound,compound-nsubj,NNP,NNP-NNP,3,1
3709,7720.0,40,meet,2,1,16,15,0,23,1,14,Nuclear Supplier Group,NSG,ORGANIZATION-ORGANIZATION-ORGANIZATION,ORGANIZATION,PROPN-PROPN-PROPN,PROPN,compound-compound-ROOT,compound,NNP-NNP-NNP,NNP,2,1
3710,27235.0,30,Group,3,2,6,4,1,23,1,3,Nuclear Supplier Group,NSG,ORGANIZATION-ORGANIZATION-ORGANIZATION,ORGANIZATION,PROPN-PROPN-PROPN,PROPN,compound-compound-ROOT,compound,NNP-NNP-NNP,NNP,3,1
3711,48547.0,30,failed,7,2,6,4,1,23,5,-1,Nuclear Supplier Group,NSG,ORGANIZATION-ORGANIZATION-ORGANIZATION,ORGANIZATION,PROPN-PROPN-PROPN,PROPN,compound-compound-nsubj,compound,NNP-NNP-NNP,NNP,3,1
3712,7721.0,18,leader,1,1,4,3,0,13,0,3,JEM,Dr Khalil,ORGANIZATION,PERSON-PERSON,PROPN,PROPN-PROPN,compound,compound-appos,NNP,NNP-NNP,2,1
3713,7731.0,26,said,17,25,19,-6,24,6,-8,2,ConAgra,Michael Locascio,ORGANIZATION,PERSON-PERSON,PROPN,PROPN-PROPN,pobj,compound-nsubj,NNP,NNP-NNP,3,1
3714,7744.0,36,overlooks,5,15,31,16,14,4,-10,26,Massachusetts House of Representatives,Charles Flaherty,ORGANIZATION-ORGANIZATION-ORGANIZATION-ORGANIZATION,PERSON-PERSON,PROPN-PROPN-ADP-PROPN,PROPN-PROPN,compound-pobj-prep-pobj,compound-conj,NNP-NNP-IN-NNPS,NNP-NNP,6,1
3715,7749.0,26,says,4,16,24,8,15,1,-12,20,John Negroponte,United States,PERSON-PERSON,COUNTRY-COUNTRY,PROPN-PROPN,PROPN-PROPN,compound-dobj,compound-pobj,NNP-NNP,NNP-NNP,5,1
3716,7754.0,44,said,41,39,35,-4,38,8,2,-6,MAC,Mainland Affairs Council,ORGANIZATION,ORGANIZATION-ORGANIZATION-ORGANIZATION,PROPN,PROPN-PROPN-PROPN,compound,compound-compound-appos,NNP,NNP-NNPS-NNP,3,1
3717,7958.0,52,After,0,21,17,-4,20,34,-21,17,MAC,Mainland Affairs Council,ORGANIZATION,ORGANIZATION-ORGANIZATION-ORGANIZATION,PROPN,PROPN-PROPN-PROPN,compound,compound-compound-pobj,NNP,NNP-NNPS-NNP,7,1
3718,9137.0,39,said,37,6,2,-4,5,36,31,-35,MAC,Mainland Affairs Council,ORGANIZATION,ORGANIZATION-ORGANIZATION-ORGANIZATION,PROPN,PROPN-PROPN-PROPN,compound,compound-compound-nsubj,NNP,NNP-NNPS-NNP,2,1
3719,11829.0,43,expected,8,36,32,-4,35,10,-28,24,MAC,Mainland Affairs Council,ORGANIZATION,ORGANIZATION-ORGANIZATION-ORGANIZATION,PROPN,PROPN-PROPN-PROPN,compound,compound-compound-appos,NNP,NNP-NNPS-NNP,5,1
3720,20467.0,44,chairwoman,1,9,5,-4,8,38,-8,4,MAC,Mainland Affairs Council,ORGANIZATION,ORGANIZATION-ORGANIZATION-ORGANIZATION,PROPN,PROPN-PROPN-PROPN,compound,compound-compound-pobj,NNP,NNP-NNPS-NNP,4,1
3721,21627.0,35,added,1,25,21,-4,24,13,-24,20,MAC,Mainland Affairs Council,ORGANIZATION,ORGANIZATION-ORGANIZATION-ORGANIZATION,PROPN,PROPN-PROPN-PROPN,compound,compound-compound-pobj,NNP,NNP-NNPS-NNP,8,1
3722,22665.0,53,said,9,19,15,-4,18,37,-10,6,MAC,Mainland Affairs Council,ORGANIZATION,ORGANIZATION-ORGANIZATION-ORGANIZATION,PROPN,PROPN-PROPN-PROPN,compound,compound-compound-nsubjpass,NNP,NNP-NNPS-NNP,4,1
3723,22960.0,37,Council,3,6,2,-4,5,34,-3,-1,MAC,Mainland Affairs Council,ORGANIZATION,ORGANIZATION-ORGANIZATION-ORGANIZATION,PROPN,PROPN-PROPN-PROPN,compound,compound-compound-ROOT,NNP,NNP-NNPS-NNP,2,1
3724,23497.0,44,Council,3,6,2,-4,5,41,-3,-1,MAC,Mainland Affairs Council,ORGANIZATION,ORGANIZATION-ORGANIZATION-ORGANIZATION,PROPN,PROPN-PROPN-PROPN,compound,compound-compound-ROOT,NNP,NNP-NNPS-NNP,2,1
3725,26955.0,35,signed,9,31,27,-4,30,7,-22,18,MAC,Mainland Affairs Council,ORGANIZATION,ORGANIZATION-ORGANIZATION-ORGANIZATION,PROPN,PROPN-PROPN-PROPN,compound,compound-compound-appos,NNP,NNP-NNPS-NNP,2,1
3726,30465.0,28,said,18,25,21,-4,24,6,-7,3,MAC,Mainland Affairs Council,ORGANIZATION,ORGANIZATION-ORGANIZATION-ORGANIZATION,PROPN,PROPN-PROPN-PROPN,compound,compound-compound-nsubj,NNP,NNP-NNPS-NNP,3,1
3727,7755.0,49,said,33,27,21,-6,26,27,6,-12,Mainland Affairs Council,Lai Shin-yuan,ORGANIZATION-ORGANIZATION-ORGANIZATION,PERSON-PERSON,PROPN-PROPN-PROPN,PROPN-NOUN,compound-compound-pobj,compound-appos,NNP-NNPS-NNP,NNP-NN,5,1
3728,12942.0,35,said,10,7,1,-6,6,33,3,-9,Mainland Affairs Council,Lai Shin-yuan,ORGANIZATION-ORGANIZATION-ORGANIZATION,PERSON-PERSON,PROPN-PROPN-PROPN,PROPN-NOUN,compound-compound-pobj,compound-nsubj,NNP-NNPS-NNP,NNP-NN,5,1
3729,13876.0,38,said,29,23,17,-6,22,20,6,-12,Mainland Affairs Council,Lai Shin-yuan,ORGANIZATION-ORGANIZATION-ORGANIZATION,PERSON-PERSON,PROPN-PROPN-PROPN,PROPN-NOUN,compound-compound-pobj,compound-nsubj,NNP-NNPS-NNP,NNP-NN,5,1
3730,16377.0,50,vented,19,35,39,4,34,10,-16,20,Mainland Affairs Council,Lai Shin-yuan,ORGANIZATION-ORGANIZATION-ORGANIZATION,PERSON-PERSON,PROPN-PROPN-PROPN,PROPN-NOUN,compound-compound-compound,compound-nsubj,NNP-NNPS-NNP,NNP-NN,11,1
3731,33175.0,37,Council,2,1,8,7,0,28,1,6,Mainland Affairs Council,Lai Shin-yuan,ORGANIZATION-ORGANIZATION-ORGANIZATION,PERSON-PERSON,PROPN-PROPN-PROPN,PROPN-NOUN,compound-compound-ROOT,compound-nsubj,NNP-NNPS-NNP,NNP-NN,-1,1
3732,39397.0,37,model,2,26,30,4,25,6,-24,28,Mainland Affairs Council,Lai Shin-yuan,ORGANIZATION-ORGANIZATION-ORGANIZATION,PERSON-PERSON,PROPN-PROPN-PROPN,PROPN-NOUN,compound-compound-compound,compound-appos,NNP-NNPS-NNP,NNP-NN,8,1
3733,7778.0,46,announce,11,1,3,2,0,42,10,-8,Hubbard,assistant,PERSON,TITLE,PROPN,NOUN,nsubj,appos,NNP,NN,3,1
3734,33313.0,41,submit,11,1,3,2,0,37,10,-8,Hubbard,assistant,PERSON,TITLE,PROPN,NOUN,nsubj,appos,NNP,NN,3,1
3735,57812.0,63,announce,28,18,20,2,17,42,10,-8,Hubbard,assistant,PERSON,TITLE,PROPN,NOUN,dobj,npadvmod,NNP,NN,3,1
3736,7793.0,34,review,4,11,10,-1,10,23,-7,6,Jerome Robbins,director-choreographer,PERSON-PERSON,TITLE,PROPN-PROPN,ADJ,compound-pobj,amod,NNP-NNP,JJ,1,1
3737,26777.0,32,use,2,19,18,-1,18,13,-17,16,Jerome Robbins,director-choreographer,PERSON-PERSON,TITLE,PROPN-PROPN,ADJ,compound-pobj,amod,NNP-NNP,JJ,1,1
3738,52822.0,34,review,4,11,10,-1,10,23,-7,6,Jerome Robbins,director-choreographer,PERSON-PERSON,TITLE,PROPN-PROPN,ADJ,compound-pobj,amod,NNP-NNP,JJ,1,1
3739,54273.0,33,Reminds,0,24,23,-1,23,9,-24,23,Jerome Robbins,director-choreographer,PERSON-PERSON,TITLE,PROPN-PROPN,ADJ,compound-nsubj,amod,NNP-NNP,JJ,1,1
3740,7794.0,29,named,10,25,15,-10,24,13,-15,5,Alcatel,Philippe Camus,ORGANIZATION,PERSON-PERSON,PROPN,PROPN-PROPN,compound,compound-oprd,NNP,NNP-NNP,4,1
3741,7802.0,55,said,25,36,27,-9,35,27,-11,2,American Psychiatric Association,Nada L Stotland,ORGANIZATION-ORGANIZATION-ORGANIZATION,PERSON-PERSON-PERSON,PROPN-PROPN-PROPN,PROPN-PROPN-PROPN,compound-compound-pobj,compound-compound-nsubj,NNP-NNP-NNP,NNP-NNP-NNP,5,1
3742,7810.0,19,develop,6,5,3,-2,4,15,1,-3,Parker,19,PERSON,NUMBER,PROPN,NUM,nsubj,nummod,NNP,CD,1,1
3743,7812.0,33,were,1,23,20,-3,22,12,-22,19,MBIA,US,ORGANIZATION,COUNTRY,PROPN,PROPN,compound,compound,NNP,NNP,2,1
3744,40721.0,40,spread,3,16,8,-8,15,31,-13,5,MBIA,US,ORGANIZATION,COUNTRY,PROPN,PROPN,compound,compound,NNP,NNP,7,1
3745,57921.0,38,said,5,5,2,-3,4,35,0,-3,MBIA,US,ORGANIZATION,COUNTRY,PROPN,PROPN,nsubj,compound,NNP,NNP,3,1
3746,65382.0,33,posted,6,5,2,-3,4,30,1,-4,MBIA,US,ORGANIZATION,COUNTRY,PROPN,PROPN,compound,compound,NNP,NNP,2,1
3747,7819.0,42,said,39,7,3,-4,6,38,32,-36,NSC,National Science Council,ORGANIZATION,ORGANIZATION-ORGANIZATION-ORGANIZATION,PROPN,PROPN-PROPN-PROPN,compound,compound-compound-nsubj,NNP,NNP-NNP-NNP,2,1
3748,10454.0,39,scheduled,8,29,25,-4,28,13,-21,17,NSC,National Science Council,ORGANIZATION,ORGANIZATION-ORGANIZATION-ORGANIZATION,PROPN,PROPN-PROPN-PROPN,compound,compound-compound-pobj,NNP,NNP-NNP-NNP,2,1
3749,27145.0,40,Chairman,1,9,5,-4,8,34,-8,4,NSC,National Science Council,ORGANIZATION,ORGANIZATION-ORGANIZATION-ORGANIZATION,PROPN,PROPN-PROPN-PROPN,compound,compound-compound-pobj,NNP,NNP-NNP-NNP,4,1
3750,35453.0,41,held,29,12,8,-4,11,32,17,-21,NSC,National Science Council,ORGANIZATION,ORGANIZATION-ORGANIZATION-ORGANIZATION,PROPN,PROPN-PROPN-PROPN,compound,compound-compound-pobj,NNP,NNP-NNP-NNP,5,1
3751,37531.0,63,seems,3,59,55,-4,58,7,-56,52,NSC,National Science Council,ORGANIZATION,ORGANIZATION-ORGANIZATION-ORGANIZATION,PROPN,PROPN-PROPN-PROPN,compound,compound-compound-dobj,NNP,NNP-NNP-NNP,3,1
3752,38366.0,49,set,5,45,41,-4,44,7,-40,36,NSC,National Science Council,ORGANIZATION,ORGANIZATION-ORGANIZATION-ORGANIZATION,PROPN,PROPN-PROPN-PROPN,compound,compound-compound-pobj,NNP,NNP-NNP-NNP,5,1
3753,59524.0,53,ordered,12,27,23,-4,26,29,-15,11,NSC,National Science Council,ORGANIZATION,ORGANIZATION-ORGANIZATION-ORGANIZATION,PROPN,PROPN-PROPN-PROPN,compound,compound-compound-appos,NNP,NNP-NNP-NNP,3,1
3754,67038.0,49,program,1,24,20,-4,23,28,-23,19,NSC,National Science Council,ORGANIZATION,ORGANIZATION-ORGANIZATION-ORGANIZATION,PROPN,PROPN-PROPN-PROPN,compound,compound-compound-pobj,NNP,NNP-NNP-NNP,2,1
3755,7831.0,29,defended,9,5,1,-4,4,27,4,-8,Seyed Ali Khamenei,Iranian,PERSON-PERSON-PERSON,ORGANIZATION,PROPN-PROPN-PROPN,ADJ,compound-compound-nsubj,amod,NNP-NNP-NNP,JJ,3,1
3756,7839.0,32,survived,7,12,16,4,11,15,-5,9,his,Silvestre,PERSON,PERSON,DET,PROPN,poss,appos,PRP$,NNP,3,1
3757,7844.0,44,shaking,25,3,5,2,2,38,22,-20,Sheldon,62,PERSON,NUMBER,PROPN,NUM,nsubj,appos,NNP,CD,3,1
3758,7846.0,52,said,31,39,45,6,38,6,-8,14,National Center for Disaster Preparedness,Columbia University Mailman School of Public Health,ORGANIZATION-ORGANIZATION-ORGANIZATION-ORGANIZATION-ORGANIZATION,ORGANIZATION-ORGANIZATION-ORGANIZATION-ORGANIZATION-ORGANIZATION-ORGANIZATION-ORGANIZATION,PROPN-PROPN-ADP-PROPN-PROPN,PROPN-PROPN-PROPN-PROPN-ADP-PROPN-PROPN,compound-pobj-prep-compound-pobj,compound-compound-compound-pobj-prep-compound-pobj,NNP-NNP-IN-NNP-NNP,NNP-NNP-NNP-NNP-IN-NNP-NNP,6,1
3759,7853.0,34,said,22,1,6,5,0,27,21,-16,R Nicholas Burns,State Department,PERSON-PERSON-PERSON,ORGANIZATION-ORGANIZATION,PROPN-PROPN-PROPN,PROPN-PROPN,compound-compound-nsubj,compound-poss,NNP-NNP-NNP,NNP-NNP,3,1
3760,20201.0,34,said,20,22,32,10,21,1,-2,12,R Nicholas Burns,State Department,PERSON-PERSON-PERSON,ORGANIZATION-ORGANIZATION,NOUN-PROPN-PROPN,PROPN-PROPN,compound-compound-nsubj,compound-pobj,NN-NNP-NNP,NNP-NNP,5,1
3761,51194.0,31,said,28,1,13,12,0,17,27,-15,R Nicholas Burns,State Department,PERSON-PERSON-PERSON,ORGANIZATION-ORGANIZATION,PROPN-PROPN-PROPN,PROPN-PROPN,compound-compound-nsubj,compound-nsubj,NNP-NNP-NNP,NNP-NNP,6,1
3762,58011.0,57,spoke,13,1,11,10,0,45,12,-2,R Nicholas Burns,State Department,PERSON-PERSON-PERSON,ORGANIZATION-ORGANIZATION,PROPN-PROPN-PROPN,PROPN-PROPN,compound-compound-nsubj,compound-pobj,NNP-NNP-NNP,NNP-NNP,4,1
3763,66525.0,52,spoke,13,1,11,10,0,40,12,-2,R Nicholas Burns,State Department,PERSON-PERSON-PERSON,ORGANIZATION-ORGANIZATION,PROPN-PROPN-PROPN,PROPN-PROPN,compound-compound-nsubj,compound-pobj,NNP-NNP-NNP,NNP-NNP,4,1
3764,7874.0,15,Report,0,6,3,-3,5,11,-6,3,Pentax,Japan,ORGANIZATION,COUNTRY,ADJ,PROPN,compound,appos,JJ,NNP,3,1
3765,24705.0,59,Report,0,6,3,-3,5,55,-6,3,Pentax,Japan,ORGANIZATION,COUNTRY,ADJ,PROPN,compound,appos,JJ,NNP,3,1
3766,60171.0,8,ready,3,3,1,-2,2,6,0,-2,Pentax,Japan,ORGANIZATION,COUNTRY,PROPN,PROPN,nsubj,poss,NNP,NNP,3,1
3767,7878.0,46,decided,20,33,17,-16,32,28,-13,-3,David Gregory,NBC News,PERSON-PERSON,ORGANIZATION-ORGANIZATION,PROPN-PROPN,PROPN-PROPN,compound-appos,compound-compound,NNP-NNP,NNP-NNP,4,1
3768,20416.0,42,testified,7,40,37,-3,39,4,-33,30,David Gregory,NBC News,PERSON-PERSON,ORGANIZATION-ORGANIZATION,PROPN-PROPN,PROPN-PROPN,compound-conj,compound-poss,NNP-NNP,NNP-NNP,1,1
3769,29914.0,47,includes,12,36,25,-11,35,21,-24,13,David Gregory,NBC News,PERSON-PERSON,ORGANIZATION-ORGANIZATION,PROPN-PROPN,PROPN-PROPN,compound-pobj,compound-pobj,NNP-NNP,NNP-NNP,6,1
3770,61682.0,34,settled,3,6,1,-5,5,32,-3,-2,David Gregory,NBC News,PERSON-PERSON,ORGANIZATION-ORGANIZATION,PROPN-PROPN,PROPN-PROPN,compound-pobj,compound-nsubj,NNP-NNP,NNP-NNP,3,1
3771,7890.0,94,redemption,1,8,36,28,7,57,-7,35,Paul Kim,asian,PERSON-PERSON,NATIONALITY,PROPN-PROPN,ADJ,compound-nsubj,amod,NNP-NNP,JJ,9,1
3772,43220.0,94,redemption,1,8,36,28,7,57,-7,35,Paul Kim,asian,PERSON-PERSON,NATIONALITY,PROPN-PROPN,ADJ,compound-nsubj,amod,NNP-NNP,JJ,9,1
3773,7895.0,65,Hopes,1,17,16,-1,16,48,-16,15,Steve McPherson,President,PERSON-PERSON,TITLE,PROPN-PROPN,PROPN,compound-nsubj,compound,NNP-NNP,NNP,2,1
3774,10493.0,57,said,44,8,7,-1,7,49,36,-37,Steve McPherson,President,PERSON-PERSON,TITLE,PROPN-PROPN,PROPN,compound-nsubj,compound,NNP-NNP,NNP,1,1
3775,20013.0,33,posed,12,24,21,-3,23,11,-12,9,Steve McPherson,President,PERSON-PERSON,TITLE,PROPN-PROPN,PROPN,compound-pobj,pobj,NNP-NNP,NNP,1,1
3776,20831.0,51,said,5,3,2,-1,2,48,2,-3,Steve McPherson,President,PERSON-PERSON,TITLE,PROPN-PROPN,PROPN,compound-nsubj,compound,NNP-NNP,NNP,1,1
3777,21534.0,35,diva,3,12,11,-1,11,23,-9,8,Steve McPherson,President,PERSON-PERSON,TITLE,PROPN-PROPN,PROPN,compound-pobj,compound,NNP-NNP,NNP,1,1
3778,31569.0,48,disguised,2,38,37,-1,37,10,-36,35,Steve McPherson,President,PERSON-PERSON,TITLE,PROPN-PROPN,PROPN,compound-poss,compound,NNP-NNP,NNP,4,1
3779,32736.0,61,caused,9,28,27,-1,27,33,-19,18,Steve McPherson,President,PERSON-PERSON,TITLE,PROPN-PROPN,PROPN,compound-pobj,compound,NNP-NNP,NNP,1,1
3780,33530.0,51,was,1,16,15,-1,15,35,-15,14,Steve McPherson,President,PERSON-PERSON,TITLE,PROPN-PROPN,PROPN,compound-pobj,compound,NNP-NNP,NNP,1,1
3781,37306.0,32,reported,4,17,16,-1,16,15,-13,12,Steve McPherson,President,PERSON-PERSON,TITLE,PROPN-PROPN,PROPN,compound-dobj,compound,NNP-NNP,NNP,1,1
3782,66063.0,36,promised,10,9,8,-1,8,27,1,-2,Steve McPherson,President,PERSON-PERSON,TITLE,PROPN-PROPN,PROPN,compound-nsubj,compound,NNP-NNP,NNP,1,1
3783,68096.0,41,http://www.variety.com/index.asp?layout=print_story&articleid;=VR11179,7,26,25,-1,25,15,-19,18,Steve McPherson,President,PERSON-PERSON,TITLE,PROPN-PROPN,PROPN,compound-appos,compound,NNP-NNP,NNP,1,1
3784,7907.0,33,said,2,26,25,-1,25,7,-24,23,Ayatollah Ali Khamenei,leader,PERSON-PERSON-PERSON,TITLE,PROPN-PROPN-PROPN,NOUN,compound-compound-appos,pobj,NNP-NNP-NNP,NN,2,1
3785,14013.0,33,signed,8,30,29,-1,29,3,-22,21,Ayatollah Ali Khamenei,leader,PERSON-PERSON-PERSON,TITLE,PROPN-PROPN-PROPN,NOUN,compound-compound-appos,dobj,NNP-NNP-NNP,NN,2,1
3786,24936.0,45,called,18,1,7,6,0,37,17,-11,Ayatollah Ali Khamenei,leader,PERSON-PERSON-PERSON,TITLE,PROPN-PROPN-PROPN,NOUN,compound-compound-nsubj,appos,NNP-NNP-NNP,NN,4,1
3787,30780.0,35,said,13,10,8,-2,9,26,3,-5,Ayatollah Ali Khamenei,leader,PERSON-PERSON-PERSON,TITLE,PROPN-PROPN-PROPN,NOUN,compound-compound-appos,nsubj,NNP-NNP-NNP,NN,3,1
3788,35144.0,39,hit,7,15,14,-1,14,24,-8,7,Ayatollah Ali Khamenei,leader,PERSON-PERSON-PERSON,TITLE,PROPN-PROPN-PROPN,NOUN,compound-compound-pobj,compound,NNP-NNP-NNP,NN,2,1
3789,41040.0,35,earned,9,19,18,-1,18,16,-10,9,Ayatollah Ali Khamenei,leader,PERSON-PERSON-PERSON,TITLE,PROPN-PROPN-PROPN,NOUN,compound-compound-pobj,compound,NNP-NNP-NNP,NN,2,1
3790,44294.0,44,criticized,19,16,14,-2,15,29,3,-5,Ayatollah Ali Khamenei,leader,PERSON-PERSON-PERSON,TITLE,PROPN-PROPN-PROPN,NOUN,compound-compound-appos,pobj,NNP-NNP-NNP,NN,3,1
3791,48443.0,58,ended,10,6,4,-2,5,53,4,-6,Ayatollah Ali Khamenei,leader,PERSON-PERSON-PERSON,TITLE,PROPN-PROPN-PROPN,NOUN,compound-compound-appos,nsubj,NNP-NNP-NNP,NN,3,1
3792,49209.0,24,came,2,10,8,-2,9,15,-8,6,Ayatollah Ali Khamenei,leader,PERSON-PERSON-PERSON,TITLE,PROPN-PROPN-PROPN,NOUN,compound-compound-appos,nsubj,NNP-NNP-NNP,NN,3,1
3793,55065.0,41,appeared,9,21,6,-15,20,34,-12,-3,Ayatollah Ali Khamenei,leader,PERSON-PERSON-PERSON,TITLE,PROPN-PROPN-PROPN,NOUN,compound-compound-appos,pobj,NNP-NNP-NNP,NN,9,1
3794,57957.0,30,are,1,17,29,12,16,0,-16,28,Ayatollah Ali Khamenei,leader,PERSON-PERSON-PERSON,TITLE,PROPN-PROPN-PROPN,NOUN,compound-compound-pobj,pobj,NNP-NNP-NNP,NN,7,1
3795,61739.0,33,reiterated,2,13,12,-1,12,20,-11,10,Ayatollah Ali Khamenei,leader,PERSON-PERSON-PERSON,TITLE,PROPN-PROPN-PROPN,NOUN,compound-compound-pobj,compound,NNP-NNP-NNP,NN,2,1
3796,64223.0,16,said,9,6,4,-2,5,11,3,-5,Ayatollah Ali Khamenei,leader,PERSON-PERSON-PERSON,TITLE,PROPN-PROPN-PROPN,NOUN,compound-compound-appos,nsubj,NNP-NNP-NNP,NN,3,1
3797,66283.0,48,said,11,22,20,-2,21,27,-11,9,Ayatollah Ali Khamenei,leader,PERSON-PERSON-PERSON,TITLE,PROPN-PROPN-PROPN,NOUN,compound-compound-appos,nsubj,NNP-NNP-NNP,NN,3,1
3798,7928.0,17,was,1,1,5,4,0,11,0,4,He,Canada,PERSON,COUNTRY,PRON,PROPN,nsubj,pobj,PRP,NNP,1,1
3799,7935.0,26,said,10,21,12,-9,20,13,-11,2,Department of Conservation and Recreation,Rick Sullivan Jr.,ORGANIZATION-ORGANIZATION-ORGANIZATION-ORGANIZATION-ORGANIZATION,PERSON-PERSON-PERSON,PROPN-ADP-PROPN-CCONJ-PROPN,PROPN-PROPN-PROPN,pobj-prep-pobj-cc-conj,compound-compound-nsubj,NNP-IN-NNP-CC-NNP,NNP-NNP-NNP,4,1
3800,7960.0,32,sack,1,1,5,4,0,26,0,4,Jaguars,Jacksonville,ORGANIZATION,ORGANIZATION,NOUN,PROPN,nsubj,nsubj,NNS,NNP,1,1
3801,43035.0,25,coming,2,16,1,-15,15,23,-14,-1,Jaguars,Jacksonville,ORGANIZATION,CITY,PROPN,PROPN,compound,nsubj,NNPS,NNP,9,1
3802,58738.0,37,defenders,1,33,17,-16,32,19,-32,16,Jaguars,Jacksonville,ORGANIZATION,CITY,PROPN,PROPN,compound,compound,NNP,NNP,7,1
3803,7966.0,30,prepared,8,2,12,10,1,17,6,4,Britney,her,PERSON,PERSON,PROPN,DET,poss,poss,NNP,PRP$,6,1
3804,7975.0,58,highlights,1,49,18,-31,48,39,-48,17,she,Virginia,PERSON,STATE_OR_PROVINCE,PRON,PROPN,nsubj,compound,PRP,NNP,9,1
3805,18023.0,30,became,1,15,3,-12,14,26,-14,2,she,Virginia,PERSON,STATE_OR_PROVINCE,PRON,PROPN,nsubj,poss,PRP,NNP,4,1
3806,7982.0,49,died,39,1,48,47,0,0,38,9,Joseph S Farland,Va,PERSON-PERSON-PERSON,STATE_OR_PROVINCE,PROPN-PROPN-PROPN,PROPN,compound-compound-nsubj,appos,NNP-NNP-NNP,NNP,3,1
3807,7989.0,29,said,16,23,18,-5,22,10,-7,2,Taiwan Research Institute,Liu Tai-ying,ORGANIZATION-ORGANIZATION-ORGANIZATION,PERSON-PERSON,PROPN-PROPN-PROPN,PROPN-PROPN,compound-compound-pobj,compound-nsubj,NNP-NNP-NNP,NNP-NNP,3,1
3808,7994.0,11,named,4,1,8,7,0,2,3,4,Dan Abrams,manager,PERSON-PERSON,TITLE,PROPN-PROPN,NOUN,compound-nsubjpass,oprd,NNP-NNP,NN,3,1
3809,7996.0,54,is,3,33,24,-9,32,29,-30,21,Aerolineas Argentinas,Marsans Travel Group,ORGANIZATION-ORGANIZATION,ORGANIZATION-ORGANIZATION-ORGANIZATION,PROPN-PROPN,PROPN-PROPN-PROPN,compound-compound,compound-compound-compound,NNP-NNP,NNPS-NNP-NNP,11,1
3810,7998.0,31,told,22,19,21,2,18,9,3,-1,MNLF,Parouk Hussin,ORGANIZATION,PERSON-PERSON,PROPN,PROPN-PROPN,compound,compound-appos,NNP,NNP-NNP,3,1
3811,8001.0,14,thought,3,2,1,-1,1,12,1,-2,Simon Cowell,Judge,PERSON-PERSON,TITLE,PROPN-PROPN,PROPN,compound-nsubj,compound,NNP-NNP,NNP,1,1
3812,35845.0,23,said,15,2,1,-1,1,21,13,-14,Simon Cowell,Judge,PERSON-PERSON,TITLE,PROPN-PROPN,PROPN,compound-nsubj,compound,NNP-NNP,NNP,1,1
3813,50012.0,13,predicted,3,2,1,-1,1,11,1,-2,Simon Cowell,Judge,PERSON-PERSON,TITLE,PROPN-PROPN,PROPN,compound-nsubj,compound,NNP-NNP,NNP,1,1
3814,8003.0,41,pronounced,2,1,14,13,0,26,1,12,Bellecourt,spokesman,PERSON,TITLE,PROPN,NOUN,compound,pobj,NNP,NN,5,1
3815,8008.0,39,denied,9,2,7,5,1,31,7,-2,IAPA,Julio Munoz,ORGANIZATION,PERSON-PERSON,PROPN,PROPN-PROPN,poss,compound-appos,NNP,NNP-NNP,3,1
3816,8010.0,20,approved,4,12,11,-1,11,8,-8,7,boy,Malawian,PERSON,NATIONALITY,NOUN,ADJ,pobj,amod,NN,JJ,5,1
3817,8012.0,40,Football,0,21,23,2,20,16,-21,23,Rovers,Mark Hughes,ORGANIZATION,PERSON-PERSON,PROPN,PROPN-PROPN,nsubj,compound-nsubj,NNPS,NNP-NNP,1,1
3818,8023.0,38,handed,3,9,1,-8,8,36,-6,-2,Raul,Fidel Castro,PERSON,PERSON-PERSON,PROPN,PROPN-PROPN,appos,compound-nsubj,NNP,NNP-NNP,4,1
3819,33415.0,40,handed,3,9,1,-8,8,38,-6,-2,Raul,Fidel Castro,PERSON,PERSON-PERSON,PROPN,PROPN-PROPN,appos,compound-nsubj,NNP,NNP-NNP,4,1
3820,8030.0,37,called,16,9,31,22,8,5,7,15,Kelly Cutrone,Jane,PERSON-PERSON,PERSON,PROPN-PROPN,PROPN,compound-pobj,attr,NNP-NNP,NNP,8,1
3821,8034.0,42,acquired,38,27,27,0,26,14,11,-11,Old Lane,Old Lane LP,ORGANIZATION-ORGANIZATION,ORGANIZATION-ORGANIZATION-ORGANIZATION,PROPN-PROPN,PROPN-PROPN-PROPN,compound-dobj,compound-compound-appos,NNP-NNP,NNP-NNP-NNP,0,1
3822,8058.0,22,argue,5,17,2,-15,16,19,-12,-3,his,Vilma,PERSON,PERSON,DET,VERB,poss,nsubj,PRP$,VB,5,1
3823,8059.0,39,told,18,15,17,2,14,21,3,-1,Pavelka,32,PERSON,NUMBER,PROPN,NUM,conj,appos,NNP,CD,1,1
3824,8060.0,39,BATOR,1,9,31,22,8,7,-8,30,Enkhbold,Mongolian People 's Revolutionary Party,PERSON,ORGANIZATION-ORGANIZATION-ORGANIZATION-ORGANIZATION-ORGANIZATION,PROPN,PROPN-PROPN-PART-PROPN-PROPN,nsubj,compound-poss-case-compound-pobj,NNP,NNP-NNPS-POS-NNP-NNP,9,1
3825,8061.0,9,.,2,5,9,4,4,-1,-3,7,Gilbert Gude,84,PERSON-PERSON,NUMBER,PROPN-PROPN,NUM,compound-compound,pobj,NNP-NNP,CD,-1,1
3826,8069.0,40,said,33,2,6,4,1,33,31,-27,FirstGroup,Laidlaw,ORGANIZATION,ORGANIZATION,PROPN,PROPN,compound,pobj,NNP,NNP,3,1
3827,19338.0,23,acquired,10,13,4,-9,12,18,-3,-6,FirstGroup,Laidlaw,ORGANIZATION,ORGANIZATION,PROPN,PROPN,pobj,nsubjpass,NNP,NNP,5,1
3828,21062.0,49,said,37,7,5,-2,6,43,30,-32,FirstGroup,Laidlaw,ORGANIZATION,ORGANIZATION,PROPN,PROPN,conj,pobj,NNP,NNP,1,1
3829,42469.0,6,buys,1,1,6,5,0,-1,0,5,FirstGroup,Laidlaw,ORGANIZATION,ORGANIZATION,PROPN,PROPN,nsubj,appos,NNP,NNP,-1,1
3830,46952.0,40,said,33,2,6,4,1,33,31,-27,FirstGroup,Laidlaw,ORGANIZATION,ORGANIZATION,PROPN,PROPN,poss,pobj,NNP,NNP,3,1
3831,8074.0,27,headed,5,5,24,19,4,2,0,19,she,Brookline,PERSON,CITY,PRON,PROPN,nsubj,pobj,PRP,NNP,6,1
3832,59433.0,27,headed,5,5,24,19,4,2,0,19,she,Brookline,PERSON,CITY,PRON,PROPN,nsubj,pobj,PRP,NNP,6,1
3833,8082.0,30,said,28,18,27,9,17,2,10,-1,Hong Kong Disneyland,Bill Ernest,ORGANIZATION-ORGANIZATION-ORGANIZATION,PERSON-PERSON,PROPN-PROPN-PROPN,PROPN-PROPN,compound-compound-compound,compound-nsubj,NNP-NNP-NNP,NNP-NNP,8,1
3834,56811.0,40,pay,7,27,32,5,26,7,-20,25,Hong Kong Disneyland,Bill Ernest,ORGANIZATION-ORGANIZATION-ORGANIZATION,PERSON-PERSON,PROPN-PROPN-PROPN,PROPN-PROPN,compound-compound-compound,compound-dobj,NNP-NNP-NNP,NNP-NNP,5,1
3835,64786.0,37,takes,16,24,29,5,23,7,-8,13,Hong Kong Disneyland,Bill Ernest,ORGANIZATION-ORGANIZATION-ORGANIZATION,PERSON-PERSON,PROPN-PROPN-PROPN,PROPN-PROPN,compound-compound-compound,compound-nsubj,NNP-NNP-NNP,NNP-NNP,5,1
3836,8085.0,25,sent,7,1,4,3,0,20,6,-3,George Sheldon,DCF,PERSON-PERSON,ORGANIZATION,PROPN-PROPN,PROPN,compound-nsubj,compound,NNP-NNP,NNP,1,1
3837,14353.0,27,said,5,4,1,-3,3,25,1,-4,George Sheldon,DCF,PERSON-PERSON,ORGANIZATION,PROPN-PROPN,PROPN,compound-nsubj,compound,NNP-NNP,NNP,2,1
3838,25832.0,18,said,9,11,16,5,10,1,-2,7,George Sheldon,DCF,PERSON-PERSON,ORGANIZATION,PROPN-PROPN,PROPN,compound-nsubj,compound,NNP-NNP,NNP,4,1
3839,28531.0,31,said,23,25,29,4,24,1,-2,6,George Sheldon,DCF,PERSON-PERSON,ORGANIZATION,PROPN-PROPN,PROPN,compound-nsubj,compound,NNP-NNP,NNP,3,1
3840,8091.0,40,said,37,1,16,15,0,23,36,-21,Hong Kong Disneyland,Disney,ORGANIZATION-ORGANIZATION-ORGANIZATION,ORGANIZATION,PROPN-PROPN-PROPN,PROPN,compound-compound-compound,dobj,NNP-NNP-NNP,NNP,7,1
3841,40526.0,37,takes,16,24,10,-14,23,26,-8,-6,Hong Kong Disneyland,Disney,ORGANIZATION-ORGANIZATION-ORGANIZATION,ORGANIZATION,PROPN-PROPN-PROPN,PROPN,compound-compound-compound,compound,NNP-NNP-NNP,NNP,10,1
3842,8096.0,44,slated,12,3,7,4,2,36,9,-5,healthcare,Tyco International Ltd,ORGANIZATION,ORGANIZATION-ORGANIZATION-ORGANIZATION,NOUN,PROPN-PROPN-PROPN,compound,compound-compound-pobj,NN,NNP-NNP-NNP,3,1
3843,8102.0,38,dies,12,3,1,-2,2,36,9,-11,Parren Mitchell,US Rep,PERSON-PERSON,TITLE-TITLE,PROPN-PROPN,PROPN-PROPN,compound-nsubj,compound-compound,NNP-NNP,NNP-NNP,1,1
3844,8118.0,38,said,35,8,15,7,7,22,27,-20,Nicholas Burns,diplomat,PERSON-PERSON,TITLE,PROPN-PROPN,NOUN,compound-nsubj,appos,NNP-NNP,NN,2,1
3845,8123.0,53,For,0,23,9,-14,22,43,-23,9,Metro Atlanta Chamber of Commerce,Atlanta Sports Council,ORGANIZATION-ORGANIZATION-ORGANIZATION-ORGANIZATION-ORGANIZATION,ORGANIZATION-ORGANIZATION-ORGANIZATION,PROPN-PROPN-PROPN-ADP-PROPN,PROPN-PROPN-PROPN,compound-compound-pobj-prep-compound,compound-compound-compound,NNP-NNP-NNP-IN-NNP,NNP-NNPS-NNP,7,1
3846,8128.0,24,conceal,16,12,2,-10,11,21,4,-14,Ghent University,Lesage,ORGANIZATION-ORGANIZATION,PERSON,PROPN-PROPN,PROPN,compound-pobj,nsubj,NNP-NNP,NNP,5,1
3847,8134.0,44,2008-03-17T15,0,19,28,9,18,15,-19,28,Institute for Diversity and Ethics,University of Central Florida,ORGANIZATION-ORGANIZATION-ORGANIZATION-ORGANIZATION-ORGANIZATION,ORGANIZATION-ORGANIZATION-ORGANIZATION-ORGANIZATION,PROPN-ADP-PROPN-CCONJ-PROPN,PROPN-ADP-PROPN-PROPN,pobj-prep-pobj-cc-conj,pobj-prep-compound-pobj,NNP-IN-NNP-CC-NNP,NNP-IN-NNP-NNP,8,1
3848,8137.0,6,said,0,2,4,2,1,1,-2,4,Waratahs,Adam Freier,ORGANIZATION,PERSON-PERSON,PROPN,PROPN-PROPN,compound,compound-nsubj,NNP,NNP-NNP,1,1
3849,16032.0,18,said,10,14,16,2,13,1,-4,6,Waratahs,Adam Freier,ORGANIZATION,PERSON-PERSON,PROPN,PROPN-PROPN,compound,compound-nsubj,NNP,NNP-NNP,3,1
3850,8138.0,33,signed,18,18,15,-3,17,17,0,-3,he,Lafayette,PERSON,CITY,PRON,PROPN,nsubj,compound,PRP,NNP,4,1
3851,8139.0,46,started,1,1,20,19,0,25,0,19,Abrams,MSNBC,PERSON,ORGANIZATION,PROPN,PROPN,nsubj,pobj,NNP,NNP,2,1
3852,46887.0,14,Abrams,2,3,1,-2,2,12,-1,-1,Abrams,MSNBC,PERSON,ORGANIZATION,PROPN,PROPN,ROOT,poss,NNP,NNP,3,1
3853,8141.0,61,attended,3,29,36,7,28,24,-26,33,Paul Kim,Stanford University School,PERSON-PERSON,ORGANIZATION-ORGANIZATION-ORGANIZATION,PROPN-PROPN,PROPN-PROPN-PROPN,compound-appos,compound-compound-compound,NNP-NNP,NNP-NNP-NNP,3,1
3854,8142.0,29,was,1,1,25,24,0,3,0,24,GMAC,Cerberus Capital Management LP,ORGANIZATION,ORGANIZATION-ORGANIZATION-ORGANIZATION-ORGANIZATION,PROPN,PROPN-PROPN-PROPN-PROPN,nsubj,compound-compound-compound-pobj,NNP,NNP-NNP-NNP-NNP,9,1
3855,8145.0,32,beat,14,4,3,-1,3,28,10,-11,George Sheldon,legislator,PERSON-PERSON,TITLE,PROPN-PROPN,NOUN,compound-nsubj,compound,NNP-NNP,NN,1,1
3856,44975.0,38,named,21,2,16,14,1,21,19,-5,George Sheldon,legislator,PERSON-PERSON,TITLE,PROPN-PROPN,NOUN,compound-nsubjpass,pobj,NNP-NNP,NN,5,1
3857,8155.0,24,said,7,1,6,5,0,17,6,-1,Detroit Medical Center,Mike Duggan,ORGANIZATION-ORGANIZATION-ORGANIZATION,PERSON-PERSON,PROPN-PROPN-PROPN,PROPN-PROPN,compound-compound-compound,compound-nsubj,NNP-NNP-NNP,NNP-NNP,5,1
3858,48665.0,30,said,10,4,1,-3,3,28,6,-9,Detroit Medical Center,Mike Duggan,ORGANIZATION-ORGANIZATION-ORGANIZATION,PERSON-PERSON,PROPN-PROPN-PROPN,PROPN-PROPN,compound-compound-compound,compound-nsubj,NNP-NNP-NNP,NNP-NNP,3,1
3859,8180.0,56,was,2,19,17,-2,18,38,-17,15,Ellen DeGeneres,host,PERSON-PERSON,TITLE,PROPN-PROPN,NOUN,compound-attr,nsubj,NNP-NNP,NN,1,1
3860,34346.0,14,spawned,1,12,4,-8,11,9,-11,3,Ellen DeGeneres,host,PERSON-PERSON,TITLE,PROPN-PROPN,NOUN,compound-pobj,dobj,NNP-NNP,NN,4,1
3861,58975.0,28,announced,4,26,25,-1,25,2,-22,21,Ellen DeGeneres,host,PERSON-PERSON,TITLE,PROPN-PROPN,NOUN,compound-conj,compound,NNP-NNP,NN,2,1
3862,64451.0,14,'s,3,8,7,-1,7,6,-5,4,Ellen DeGeneres,host,PERSON-PERSON,TITLE,PROPN-PROPN,NOUN,compound-attr,compound,NNP-NNP,NN,1,1
3863,8182.0,19,spotted,3,12,18,6,11,0,-9,15,Sean Preston,Allie,PERSON-PERSON,PERSON,PROPN-PROPN,PROPN,compound-appos,appos,NNP-NNP,NNP,5,1
3864,8188.0,36,said,4,1,3,2,0,32,3,-1,Wildmon,72,PERSON,NUMBER,PROPN,NUM,nsubj,appos,NNP,CD,3,1
3865,8190.0,26,ATLANTA,0,8,1,-7,7,24,-8,1,Michael Johns,ATLANTA,PERSON-PERSON,CITY,PROPN-PROPN,NOUN,compound-nsubj,ROOT,NNP-NNP,NN,4,1
3866,28821.0,25,ATLANTA,0,8,1,-7,7,23,-8,1,Michael Johns,ATLANTA,PERSON-PERSON,CITY,PROPN-PROPN,NOUN,compound-nsubj,ROOT,NNP-NNP,NN,4,1
3867,36559.0,32,TV-IDOL-JOHNS,5,15,8,-7,14,23,-10,3,Michael Johns,ATLANTA,PERSON-PERSON,CITY,PROPN-PROPN,NOUN,compound-nsubj,ROOT,NNP-NNP,NN,3,1
3868,44859.0,27,TV-IDOL-JOHNS,0,10,3,-7,9,23,-10,3,Michael Johns,ATLANTA,PERSON-PERSON,CITY,PROPN-PROPN,NOUN,compound-nsubj,ROOT,NNP-NNP,NN,3,1
3869,8192.0,25,born,4,22,12,-10,21,12,-18,8,Mildred Miller Nolte,"Dec. 27 , 1920",PERSON-PERSON-PERSON,DATE-DATE-DATE-DATE,PROPN-PROPN-PROPN,PROPN-NUM-PUNCT-NUM,compound-compound-conj,pobj-nummod-punct-nummod,NNP-NNP-NNP,"NNP-CD-,-CD",7,1
3870,8193.0,49,writing,4,44,46,2,43,2,-40,42,House,Robert A DeLeo,ORGANIZATION,PERSON-PERSON-PERSON,PROPN,PROPN-PROPN-PROPN,compound,compound-compound-conj,NNP,NNP-NNP-NNP,3,1
3871,8194.0,47,Movement,3,39,37,-2,38,9,-36,34,Union for the Total Independence of Angola,UNITA,ORGANIZATION-ORGANIZATION-ORGANIZATION-ORGANIZATION-ORGANIZATION-ORGANIZATION-ORGANIZATION,ORGANIZATION,PROPN-ADP-DET-PROPN-PROPN-ADP-PROPN,PROPN,appos-prep-det-compound-pobj-prep-compound,compound,NNP-IN-DT-NNP-NNP-IN-NNP,NNP,-1,1
3872,8195.0,34,outlined,2,20,16,-4,19,17,-18,14,Communist Party of China,Central Committee,ORGANIZATION-ORGANIZATION-ORGANIZATION-ORGANIZATION,ORGANIZATION-ORGANIZATION,PROPN-PROPN-ADP-PROPN,PROPN-PROPN,compound-pobj-prep-pobj,compound-dobj,NNP-NNP-IN-NNP,NNP-NNP,2,1
3873,64067.0,42,told,1,14,10,-4,13,31,-13,9,Communist Party of China,Central Committee,ORGANIZATION-ORGANIZATION-ORGANIZATION-ORGANIZATION,ORGANIZATION-ORGANIZATION,PROPN-PROPN-ADP-PROPN,PROPN-PROPN,compound-pobj-prep-pobj,compound-pobj,NNP-NNP-IN-NNP,NNP-NNP,4,1
3874,64679.0,48,Qi,1,11,18,7,10,29,-10,17,Communist Party of China,Central Committee,ORGANIZATION-ORGANIZATION-ORGANIZATION-ORGANIZATION,ORGANIZATION-ORGANIZATION,PROPN-PROPN-ADP-PROPN,PROPN-PROPN,compound-pobj-prep-pobj,compound-nsubj,NNP-NNP-IN-NNP,NNP-NNP,6,1
3875,65672.0,40,Bureau,2,6,13,7,5,26,-4,11,Communist Party of China,Central Committee,ORGANIZATION-ORGANIZATION-ORGANIZATION-ORGANIZATION,ORGANIZATION-ORGANIZATION,PROPN-PROPN-ADP-PROPN,PROPN-PROPN,compound-pobj-prep-pobj,compound-nsubj,NNP-NNP-IN-NNP,NNP-NNP,-1,1
3876,8197.0,41,said,22,24,17,-7,23,23,-2,-5,Richard Perle,American Enterprise Institute,PERSON-PERSON,ORGANIZATION-ORGANIZATION-ORGANIZATION,PROPN-PROPN,PROPN-PROPN-PROPN,compound-nsubj,compound-compound-pobj,NNP-NNP,NNP-NNP-NNP,11,1
3877,8198.0,38,said,1,23,29,6,22,8,-22,28,Chen,Hong Kong,PERSON,CITY-CITY,PROPN,PROPN-PROPN,dobj,compound-pobj,NNP,NNP-NNP,3,1
3878,32886.0,38,said,1,23,29,6,22,8,-22,28,Chen,Hong Kong,PERSON,CITY-CITY,PROPN,PROPN-PROPN,dobj,compound-pobj,NNP,NNP-NNP,3,1
3879,8208.0,17,visit,14,5,16,11,4,0,9,2,DCR,www.mass.gov/dcr,ORGANIZATION,URL,PROPN,PROPN,pobj,dobj,NNP,NNP,6,1
3880,8210.0,29,led,8,8,14,6,7,14,0,6,DeBlanc,Marine Fighting Squadron,PERSON,ORGANIZATION-ORGANIZATION-ORGANIZATION,PROPN,PROPN-PROPN-PROPN,nsubj,compound-compound-pobj,NNP,NNP-NNP-NNP,3,1
3881,60293.0,35,took,16,8,31,23,7,3,8,15,DeBlanc,Marine Fighting Squadron,PERSON,ORGANIZATION-ORGANIZATION-ORGANIZATION,PROPN,PROPN-PROPN-PROPN,nsubj,compound-compound-pobj,NNP,NNP-NNP-NNP,5,1
3882,8217.0,39,working,3,10,1,-9,9,37,-7,-2,Option One Mortgage,NovaStar,ORGANIZATION-ORGANIZATION-ORGANIZATION,ORGANIZATION,PROPN-PROPN-PROPN,PROPN,pobj-nummod-appos,nsubj,NNP-NNP-NNP,NNP,7,1
3883,8219.0,20,said,13,9,18,9,8,1,4,5,Kollek,natural causes,PERSON,CAUSE_OF_DEATH-CAUSE_OF_DEATH,PROPN,ADJ-NOUN,pobj,amod-pobj,NNP,JJ-NNS,9,1
3884,21651.0,14,said,2,9,12,3,8,1,-7,10,Kollek,natural causes,PERSON,CAUSE_OF_DEATH-CAUSE_OF_DEATH,PROPN,ADJ-NOUN,nsubj,amod-pobj,NNP,JJ-NNS,2,1
3885,8223.0,21,nominated,3,1,11,10,0,9,2,8,Remy Ma,Terror Squad,PERSON-PERSON,ORGANIZATION-ORGANIZATION,PROPN-PROPN,PROPN-PROPN,compound-nsubjpass,compound-pobj,NNP-NNP,NNP-NNP,5,1
3886,8224.0,23,established,1,4,7,3,3,15,-3,6,Barnes Foundation,1922,ORGANIZATION-ORGANIZATION,DATE,PROPN-PROPN,NUM,compound-dobj,pobj,NNP-NNP,CD,2,1
3887,8233.0,28,http://wwwchristmastreeorg/,4,1,5,4,0,22,3,1,National Christmas Tree Association,http://wwwchristmastreeorg/,ORGANIZATION-ORGANIZATION-ORGANIZATION-ORGANIZATION,URL,PROPN-PROPN-PROPN-PROPN,PROPN,amod-compound-compound-compound,ROOT,NNP-NNP-NNP-NNP,NNP,5,1
3888,8241.0,23,graduated,1,1,20,19,0,2,0,19,She,IBM,PERSON,ORGANIZATION,PRON,PROPN,nsubj,compound,PRP,NNP,4,1
3889,8250.0,33,conceded,8,2,6,4,1,26,6,-2,Royal Caribbean,Lyan Sierra-Caro,ORGANIZATION-ORGANIZATION,PERSON-PERSON,PROPN-PROPN,PROPN-PROPN,compound-amod,compound-appos,NNP-NNP,NNP-NNP,3,1
3890,8269.0,45,planning,32,15,13,-2,14,31,17,-19,Olivia Palermo,London,PERSON-PERSON,CITY,PROPN-PROPN,PROPN,compound-nsubj,pobj,NNP-NNP,NNP,5,1
3891,8278.0,31,took,15,4,18,14,3,12,11,3,FirstGroup PLC,Laidlaw,ORGANIZATION-ORGANIZATION,ORGANIZATION,PROPN-PROPN,PROPN,compound-nsubj,dobj,NNP-NNP,NNP,2,1
3892,21121.0,31,took,15,4,18,14,3,12,11,3,FirstGroup PLC,Laidlaw,ORGANIZATION-ORGANIZATION,ORGANIZATION,PROPN-PROPN,PROPN,compound-nsubj,dobj,NNP-NNP,NNP,2,1
3893,8293.0,27,said,22,21,2,-19,20,24,1,-20,Chris Bentley,Ontario,PERSON-PERSON,STATE_OR_PROVINCE,PROPN-PROPN,PROPN,compound-nsubj,nsubj,NNP-NNP,NNP,5,1
3894,30098.0,39,said,5,4,1,-3,3,37,1,-4,Chris Bentley,Ontario,PERSON-PERSON,STATE_OR_PROVINCE,PROPN-PROPN,PROPN,compound-nsubj,compound,NNP-NNP,NNP,2,1
3895,41917.0,27,said,22,21,2,-19,20,24,1,-20,Chris Bentley,Ontario,PERSON-PERSON,STATE_OR_PROVINCE,PROPN-PROPN,PROPN,compound-nsubj,compound,NNP-NNP,NNP,5,1
3896,63786.0,16,said,5,4,1,-3,3,14,1,-4,Chris Bentley,Ontario,PERSON-PERSON,STATE_OR_PROVINCE,PROPN-PROPN,PROPN,compound-nsubj,compound,NNP-NNP,NNP,2,1
3897,8302.0,59,addressing,10,20,25,5,19,33,-10,15,her,Jon,PERSON,PERSON,DET,PROPN,poss,appos,PRP$,NNP,2,1
3898,8303.0,29,said,7,2,6,4,1,22,5,-1,Czech National Bank,CNB,ORGANIZATION-ORGANIZATION-ORGANIZATION,ORGANIZATION,PROPN-PROPN-PROPN,PROPN,compound-compound-compound,compound,NNP-NNP-NNP,NNP,2,1
3899,34317.0,29,slashed,7,2,6,4,1,22,5,-1,Czech National Bank,CNB,ORGANIZATION-ORGANIZATION-ORGANIZATION,ORGANIZATION,PROPN-PROPN-PROPN,PROPN,compound-compound-compound,compound,NNP-NNP-NNP,NNP,4,1
3900,40467.0,32,said,7,2,6,4,1,25,5,-1,Czech National Bank,CNB,ORGANIZATION-ORGANIZATION-ORGANIZATION,ORGANIZATION,PROPN-PROPN-PROPN,PROPN,compound-compound-compound,compound,NNP-NNP-NNP,NNP,2,1
3901,57591.0,39,said,7,2,6,4,1,32,5,-1,Czech National Bank,CNB,ORGANIZATION-ORGANIZATION-ORGANIZATION,ORGANIZATION,PROPN-PROPN-PROPN,PROPN,compound-compound-compound,compound,NNP-NNP-NNP,NNP,3,1
3902,59606.0,39,said,7,2,6,4,1,32,5,-1,Czech National Bank,CNB,ORGANIZATION-ORGANIZATION-ORGANIZATION,ORGANIZATION,PROPN-PROPN-PROPN,PROPN,compound-compound-compound,compound,NNP-NNP-NNP,NNP,3,1
3903,65837.0,25,appointed,4,1,10,9,0,14,3,6,Czech National Bank,CNB,ORGANIZATION-ORGANIZATION-ORGANIZATION,ORGANIZATION,PROPN-PROPN-PROPN,PROPN,compound-compound-compound,compound,NNP-NNP-NNP,NNP,5,1
3904,8308.0,25,lives,11,1,21,20,0,3,10,10,Sculfor,New York Model Management,PERSON,ORGANIZATION-ORGANIZATION-ORGANIZATION-ORGANIZATION,PROPN,PROPN-PROPN-PROPN-PROPN,nsubj,compound-compound-compound-pobj,NNP,NNP-NNP-NNP-NNP,6,1
3905,48490.0,28,lives,14,4,24,20,3,3,10,10,Sculfor,New York Model Management,PERSON,ORGANIZATION-ORGANIZATION-ORGANIZATION-ORGANIZATION,PROPN,PROPN-PROPN-PROPN-PROPN,nsubj,compound-compound-compound-pobj,NNP,NNP-NNP-NNP-NNP,6,1
3906,8310.0,26,worked,10,7,5,-2,6,20,3,-5,he,8,PERSON,NUMBER,PRON,NUM,nsubj,pobj,PRP,CD,1,1
3907,52753.0,26,worked,10,7,5,-2,6,20,3,-5,he,8,PERSON,NUMBER,PRON,NUM,nsubj,pobj,PRP,CD,1,1
3908,8323.0,34,bought,16,13,10,-3,12,23,3,-6,Focus on the Family,conservative,ORGANIZATION-ORGANIZATION-ORGANIZATION-ORGANIZATION,IDEOLOGY,PROPN-ADP-DET-PROPN,ADJ,appos-prep-det-pobj,amod,NNP-IN-DT-NNP,JJ,3,1
3909,10263.0,34,serves,15,12,10,-2,11,23,3,-5,Focus on the Family,conservative,ORGANIZATION-ORGANIZATION-ORGANIZATION-ORGANIZATION,IDEOLOGY,PROPN-ADP-DET-PROPN,ADJ,appos-prep-det-pobj,amod,NNP-IN-DT-NNP,JJ,2,1
3910,38049.0,45,said,39,35,33,-2,34,11,4,-6,Focus on the Family,conservative,ORGANIZATION-ORGANIZATION-ORGANIZATION-ORGANIZATION,IDEOLOGY,PROPN-ADP-DET-PROPN,ADJ,appos-prep-det-pobj,amod,NNP-IN-DT-NNP,JJ,2,1
3911,39569.0,22,cited,5,10,16,6,9,5,-5,11,Focus on the Family,conservative,ORGANIZATION-ORGANIZATION-ORGANIZATION-ORGANIZATION,IDEOLOGY,PROPN-ADP-DET-PROPN,ADJ,pobj-prep-det-pobj,amod,NNP-IN-DT-NNP,JJ,5,1
3912,48240.0,29,took,5,17,15,-2,16,13,-12,10,Focus on the Family,conservative,ORGANIZATION-ORGANIZATION-ORGANIZATION-ORGANIZATION,IDEOLOGY,PROPN-ADP-DET-PROPN,ADJ,appos-prep-det-pobj,amod,NNP-IN-DT-NNP,JJ,3,1
3913,65653.0,34,said,16,11,8,-3,10,25,5,-8,Focus on the Family,conservative,ORGANIZATION-ORGANIZATION-ORGANIZATION-ORGANIZATION,IDEOLOGY,PROPN-ADP-DET-PROPN,ADJ,appos-prep-det-pobj,amod,NNP-IN-DT-NNP,JJ,1,1
3914,8328.0,39,used,17,16,5,-11,15,33,1,-12,JNF,Theodor Herzl,ORGANIZATION,PERSON-PERSON,PROPN,PROPN-PROPN,nsubj,compound-pobj,NNP,NNP-NNP,5,1
3915,8330.0,18,Speaking,0,7,18,11,6,-1,-7,18,National Action Network,Rev,ORGANIZATION-ORGANIZATION-ORGANIZATION,PERSON,PROPN-PROPN-PROPN,PROPN,compound-compound-pobj,pobj,NNP-NNP-NNP,NNP,-1,1
3916,8337.0,63,struck,11,11,10,-1,10,52,0,-1,Zubaydah,Abu Zubaydah,PERSON,PERSON-PERSON,PROPN,PROPN-PROPN,nsubjpass,compound-pobj,NNP,NNP-NNP,5,1
3917,8343.0,6,Association,3,1,6,5,0,-1,2,3,National Christmas Tree Association,http://www.christmastree.org,ORGANIZATION-ORGANIZATION-ORGANIZATION-ORGANIZATION,URL,PROPN-PROPN-PROPN-PROPN,X,compound-compound-compound-ROOT,punct,NNP-NNP-NNP-NNP,ADD,-1,1
3918,8345.0,10,married,4,1,7,6,0,2,3,3,Jeremy,Connecticut,PERSON,STATE_OR_PROVINCE,PROPN,PROPN,nsubj,pobj,NNP,NNP,3,1
3919,8353.0,36,fill,31,3,1,-2,2,34,28,-30,Raul Castro,Interim president,PERSON-PERSON,TITLE-TITLE,PROPN-PROPN,ADJ-NOUN,compound-nsubj,amod-compound,NNP-NNP,JJ-NN,1,1
3920,8375.0,39,said,20,36,22,-14,35,16,-16,2,St. Anselm College,Dean Spiliotes,ORGANIZATION-ORGANIZATION-ORGANIZATION,PERSON-PERSON,PROPN-PROPN-PROPN,PROPN-PROPN,compound-compound-pobj,compound-nsubj,NNP-NNP-NNP,NNP-NNP,7,1
3921,12412.0,38,said,22,32,24,-8,31,13,-10,2,St. Anselm College,Dean Spiliotes,ORGANIZATION-ORGANIZATION-ORGANIZATION,PERSON-PERSON,PROPN-PROPN-PROPN,PROPN-PROPN,compound-compound-pobj,compound-nsubj,NNP-NNP-NNP,NNP-NNP,5,1
3922,47928.0,34,said,15,31,17,-14,30,16,-16,2,St. Anselm College,Dean Spiliotes,ORGANIZATION-ORGANIZATION-ORGANIZATION,PERSON-PERSON,PROPN-PROPN-PROPN,PROPN-PROPN,compound-compound-pobj,compound-nsubj,NNP-NNP-NNP,NNP-NNP,7,1
3923,63981.0,32,says,30,24,17,-7,23,14,6,-13,St. Anselm College,Dean Spiliotes,ORGANIZATION-ORGANIZATION-ORGANIZATION,PERSON-PERSON,PROPN-PROPN-PROPN,PROPN-PROPN,compound-compound-pobj,compound-nsubj,NNP-NNP-NNP,NNP-NNP,5,1
3924,8386.0,49,kept,14,14,34,20,13,14,0,20,he,Dodgers,PERSON,ORGANIZATION,PRON,PROPN,nsubj,pobj,PRP,NNPS,6,1
3925,8387.0,38,join,21,20,7,-13,19,30,1,-14,he,Indianapolis,PERSON,CITY,PRON,PROPN,nsubj,compound,PRP,NNP,4,1
3926,8388.0,30,said,8,26,28,2,25,1,-18,20,KGB,Alexander Litvinenko,ORGANIZATION,PERSON-PERSON,PROPN,PROPN-PROPN,compound,compound-pobj,NNP,NNP-NNP,1,1
3927,8389.0,45,said,16,18,20,2,17,24,-2,4,Farrow,chairwoman,PERSON,TITLE,PROPN,NOUN,nsubj,appos,NNP,NN,1,1
3928,8396.0,23,said,20,4,18,14,3,4,16,-2,Hussein Kamel,Jordan,PERSON-PERSON,COUNTRY,PROPN-PROPN,PROPN,compound-compound,pobj,NNP-NNP,NNP,5,1
3929,29046.0,46,was,12,10,30,20,9,15,2,18,Hussein Kamel,Jordan,PERSON-PERSON,COUNTRY,PROPN-PROPN,PROPN,compound-appos,pobj,NNP-NNP,NNP,4,1
3930,8399.0,64,edited,25,28,61,33,27,2,-3,36,William Anderson,Warner Independent Pictures,PERSON-PERSON,ORGANIZATION-ORGANIZATION-ORGANIZATION,PROPN-PROPN,PROPN-PROPN-PROPN,compound-pobj,compound-compound-pobj,NNP-NNP,NNP-NNP-NNPS,8,1
3931,8403.0,11,acquired,4,3,10,7,2,0,1,6,it,Iberia,ORGANIZATION,ORGANIZATION,PRON,PROPN,nsubjpass,appos,PRP,NNP,2,1
3932,8416.0,24,joined,11,9,7,-2,8,16,2,-4,Julian Bond,NAACP,PERSON-PERSON,ORGANIZATION,PROPN-PROPN,PROPN,compound-nsubj,compound,NNP-NNP,NNP,1,1
3933,8907.0,32,said,23,25,31,6,24,0,-2,8,Julian Bond,NAACP,PERSON-PERSON,ORGANIZATION,PROPN-PROPN,PROPN,compound-nsubj,pobj,NNP-NNP,NNP,4,1
3934,15241.0,39,expressed,15,14,12,-2,13,26,1,-3,Julian Bond,NAACP,PERSON-PERSON,ORGANIZATION,PROPN-PROPN,PROPN,compound-nsubj,compound,NNP-NNP,NNP,1,1
3935,27785.0,37,said,32,27,16,-11,26,20,5,-16,Julian Bond,NAACP,PERSON-PERSON,ORGANIZATION,PROPN-PROPN,PROPN,compound-nsubj,pobj,NNP-NNP,NNP,9,1
3936,28834.0,26,said,11,1,7,6,0,18,10,-4,Julian Bond,NAACP,PERSON-PERSON,ORGANIZATION,PROPN-PROPN,PROPN,compound-nsubj,compound,NNP-NNP,NNP,3,1
3937,46550.0,56,said,41,40,8,-32,39,47,1,-33,Julian Bond,NAACP,PERSON-PERSON,ORGANIZATION,PROPN-PROPN,PROPN,compound-appos,pobj,NNP-NNP,NNP,8,1
3938,46748.0,41,said,36,31,20,-11,30,20,5,-16,Julian Bond,NAACP,PERSON-PERSON,ORGANIZATION,PROPN-PROPN,PROPN,compound-nsubj,poss,NNP-NNP,NNP,9,1
3939,47708.0,22,went,5,4,1,-3,3,20,1,-4,Julian Bond,NAACP,PERSON-PERSON,ORGANIZATION,PROPN-PROPN,PROPN,compound-nsubj,compound,NNP-NNP,NNP,2,1
3940,48804.0,39,expressed,15,14,12,-2,13,26,1,-3,Julian Bond,NAACP,PERSON-PERSON,ORGANIZATION,PROPN-PROPN,PROPN,compound-nsubj,compound,NNP-NNP,NNP,1,1
3941,54228.0,35,said,24,26,33,7,25,1,-2,9,Julian Bond,NAACP,PERSON-PERSON,ORGANIZATION,PROPN-PROPN,PROPN,compound-nsubj,compound,NNP-NNP,NNP,5,1
3942,59379.0,17,Labels,0,11,17,6,10,-1,-11,17,Julian Bond,NAACP,PERSON-PERSON,ORGANIZATION,PROPN-PROPN,PROPN,compound-conj,intj,NNP-NNP,NNP,6,1
3943,63167.0,35,said,26,25,18,-7,24,16,1,-8,Julian Bond,NAACP,PERSON-PERSON,ORGANIZATION,PROPN-PROPN,PROPN,compound-nsubj,poss,NNP-NNP,NNP,10,1
3944,8424.0,25,said,1,10,22,12,9,2,-9,21,Cowell,American Idol,PERSON,ORGANIZATION-ORGANIZATION,PROPN,PROPN-PROPN,nsubj,compound-pobj,NNP,NNP-NNP,8,1
3945,8426.0,45,was,3,13,17,4,12,27,-10,14,Lewis Hamilton,Anthony Hamilton,PERSON-PERSON,PERSON-PERSON,PROPN-PROPN,PROPN-PROPN,compound-poss,compound-appos,NNP-NNP,NNP-NNP,2,1
3946,8427.0,19,came,1,16,14,-2,15,4,-15,13,Illinois Tool Works,U.S.,ORGANIZATION-ORGANIZATION-ORGANIZATION,COUNTRY,PROPN-PROPN-PROPN,PROPN,compound-compound-pobj,compound,NNP-NNP-NNP,NNP,2,1
3947,10086.0,20,kept,14,10,8,-2,9,11,4,-6,Illinois Tool Works,U.S.,ORGANIZATION-ORGANIZATION-ORGANIZATION,COUNTRY,PROPN-PROPN-PROPN,PROPN,compound-compound-pobj,compound,NNP-NNP-NNP,NNP,2,1
3948,8428.0,67,-LRB-,4,19,1,-18,18,65,-15,-3,Chris Dodd,US,PERSON-PERSON,COUNTRY,PROPN-PROPN,PROPN,compound-compound,compound,NNP-NNP,NNP,-1,1
3949,8436.0,47,Council,2,1,29,28,0,17,1,27,Sports Affairs Council,her,ORGANIZATION-ORGANIZATION-ORGANIZATION,PERSON,PROPN-PROPN-PROPN,PRON,compound-compound-ROOT,poss,NNPS-NNPS-NNP,PRP,-1,1
3950,8450.0,25,spoke,20,1,13,12,0,11,19,-7,The American Bar Association,United States,ORGANIZATION-ORGANIZATION-ORGANIZATION-ORGANIZATION,COUNTRY-COUNTRY,DET-PROPN-PROPN-PROPN,PROPN-PROPN,det-compound-compound-nsubj,compound-pobj,DT-NNP-NNP-NNP,NNP-NNP,7,1
3951,8452.0,20,helped,2,1,6,5,0,13,1,4,He,Congressional Black Caucus,PERSON,ORGANIZATION-ORGANIZATION-ORGANIZATION,PRON,PROPN-PROPN-PROPN,nsubj,compound-compound-dobj,PRP,NNP-NNP-NNP,4,1
3952,8455.0,38,said,35,1,1,0,0,36,34,-34,Carnival Cruise,Carnival Corp,ORGANIZATION-ORGANIZATION,ORGANIZATION-ORGANIZATION,PROPN-PROPN,PROPN-PROPN,compound-compound,compound-nsubj,NNP-NNP,NNP-NNP,0,1
3953,39299.0,16,is,3,1,1,0,0,14,2,-2,Carnival Cruise,Carnival Corp,ORGANIZATION-ORGANIZATION,ORGANIZATION-ORGANIZATION,PROPN-PROPN,PROPN-PROPN,compound-compound,compound-pobj,NNP-NNP,NNP-NNP,0,1
3954,8456.0,33,said,31,1,10,9,0,22,30,-21,ITW,Duo-Fast,ORGANIZATION,LOCATION,PROPN,VERB,nsubj,nmod,NNP,VB,7,1
3955,8457.0,35,caught,3,13,1,-12,12,33,-10,-2,MF Global,Man Group,ORGANIZATION-ORGANIZATION,ORGANIZATION-ORGANIZATION,PROPN-PROPN,PROPN-PROPN,compound-pobj,compound-compound,NNP-NNP,NNP-NNP,7,1
3956,23776.0,29,split,10,1,8,7,0,20,9,-2,MF Global,Man Group,ORGANIZATION-ORGANIZATION,ORGANIZATION-ORGANIZATION,PROPN-PROPN,PROPN-PROPN,compound-poss,compound-appos,NNP-NNP,NNP-NNP,2,1
3957,8464.0,49,gobsmacked,3,28,20,-8,27,28,-25,17,his,Pennsylvania,PERSON,STATE_OR_PROVINCE,DET,PROPN,poss,dobj,PRP$,NNP,1,1
3958,20264.0,19,claims,1,16,9,-7,15,9,-15,8,his,Pennsylvania,PERSON,STATE_OR_PROVINCE,DET,PROPN,poss,poss,PRP$,NNP,7,1
3959,8476.0,44,said,29,9,31,22,8,12,20,2,SAC,Luo Yang,ORGANIZATION,PERSON-PERSON,PROPN,PROPN-PROPN,nsubj,compound-nsubj,NNP,NNP-NNP,8,1
3960,57216.0,42,BEIJING,0,8,10,2,7,31,-8,10,SAC,Luo Yang,ORGANIZATION,PERSON-PERSON,PROPN,PROPN-PROPN,nsubj,compound-nsubj,NNP,NNP-NNP,1,1
3961,8481.0,38,blocks,1,32,23,-9,31,14,-31,22,Ayatollah Ali Khamenei,Dictator,PERSON-PERSON-PERSON,TITLE,PROPN-PROPN-PROPN,PROPN,compound-compound-pobj,pobj,NNP-NNP-NNP,NNP,6,1
3962,8484.0,32,are,3,27,31,4,26,0,-24,28,Kerry,Nantucket,PERSON,CITY,PROPN,PROPN,poss,pobj,NNP,NNP,9,1
3963,8486.0,53,said,40,42,49,7,41,3,-2,9,R Nicholas Burns,state,PERSON-PERSON-PERSON,ORGANIZATION,NOUN-PROPN-PROPN,NOUN,compound-compound-nsubj,pobj,NN-NNP-NNP,NN,3,1
3964,8488.0,26,interviewed,8,7,6,-1,6,19,1,-2,Bill McAllister,reporter,PERSON-PERSON,TITLE,PROPN-PROPN,NOUN,compound-nsubj,compound,NNP-NNP,NN,1,1
3965,8489.0,45,URGES,1,10,14,4,9,30,-9,13,Mainland Affairs Council,Chen Ming-tong,ORGANIZATION-ORGANIZATION-ORGANIZATION,PERSON-PERSON,PROPN-PROPN-PROPN,PROPN-PROPN,compound-compound-compound,compound-nsubj,NNP-NNPS-NNP,NNP-NNP,5,1
3966,10655.0,49,serve,32,10,1,-9,9,47,22,-31,Mainland Affairs Council,Chen Ming-tong,ORGANIZATION-ORGANIZATION-ORGANIZATION,PERSON-PERSON,PROPN-PROPN-PROPN,PROPN-PROPN,compound-compound-pobj,compound-nsubj,NNP-NNPS-NNP,NNP-NNP,5,1
3967,29405.0,74,told,13,7,1,-6,6,72,6,-12,Mainland Affairs Council,Chen Ming-tong,ORGANIZATION-ORGANIZATION-ORGANIZATION,PERSON-PERSON,PROPN-PROPN-PROPN,PROPN-PROPN,compound-compound-pobj,compound-nsubj,NNP-NNPS-NNP,NNP-NNP,5,1
3968,8491.0,46,said,18,26,20,-6,25,25,-8,2,Inter American Press Association,Alejandro Aguirre,ORGANIZATION-ORGANIZATION-ORGANIZATION-ORGANIZATION,PERSON-PERSON,PROPN-PROPN-PROPN-PROPN,PROPN-PROPN,compound-compound-compound-pobj,compound-nsubj,NNP-NNP-NNP-NNP,NNP-NNP,5,1
3969,17498.0,25,singled,11,7,1,-6,6,23,4,-10,Inter American Press Association,Alejandro Aguirre,ORGANIZATION-ORGANIZATION-ORGANIZATION-ORGANIZATION,PERSON-PERSON,PROPN-PROPN-PROPN-PROPN,PROPN-PROPN,compound-compound-compound-pobj,compound-nsubj,NNP-NNP-NNP-NNP,NNP-NNP,4,1
3970,50602.0,31,Aguirre,1,7,1,-6,6,29,-6,0,Inter American Press Association,Alejandro Aguirre,ORGANIZATION-ORGANIZATION-ORGANIZATION-ORGANIZATION,PERSON-PERSON,PROPN-PROPN-PROPN-PROPN,PROPN-PROPN,compound-compound-compound-pobj,compound-ROOT,NNP-NNP-NNP-NNP,NNP-NNP,4,1
3971,67075.0,34,said,12,7,1,-6,6,32,5,-11,Inter American Press Association,Alejandro Aguirre,ORGANIZATION-ORGANIZATION-ORGANIZATION-ORGANIZATION,PERSON-PERSON,PROPN-PROPN-PROPN-PROPN,PROPN-PROPN,compound-compound-compound-pobj,compound-nsubj,NNP-NNP-NNP-NNP,NNP-NNP,4,1
3972,8504.0,36,-LRB-,0,23,5,-18,22,30,-23,5,Mahdi,Sudan,PERSON,COUNTRY,PROPN,PROPN,poss,poss,NNP,NNP,12,1
3973,55456.0,19,be,4,16,9,-7,15,9,-12,5,Mahdi,Sudan,PERSON,COUNTRY,PROPN,PROPN,dobj,pobj,NNP,NNP,3,1
3974,8509.0,29,founded,3,7,2,-5,6,26,-4,-1,Safe Passage,1999,ORGANIZATION-ORGANIZATION,DATE,PROPN-PROPN,NUM,compound-compound,pobj,NNP-NNP,CD,3,1
3975,29878.0,7,founded,1,3,6,3,2,0,-2,5,Safe Passage,1999,ORGANIZATION-ORGANIZATION,DATE,PROPN-PROPN,NUM,compound-dobj,pobj,NNP-NNP,CD,2,1
3976,8511.0,45,said,1,3,31,28,2,13,-2,30,his,United States,PERSON,COUNTRY-COUNTRY,DET,PROPN-PROPN,poss,compound-conj,PRP$,NNP-NNP,9,1
3977,8514.0,54,had,2,19,10,-9,18,43,-17,8,he,Secretary,PERSON,TITLE,PRON,PROPN,nsubj,compound,PRP,NNP,5,1
3978,8515.0,41,said,39,1,13,12,0,27,38,-26,Randall Caroline Watson,Huntsville,PERSON-PERSON-PERSON,CITY,PROPN-PROPN-PROPN,PROPN,compound-compound-nsubjpass,pobj,NNP-NNP-NNP,NNP,5,1
3979,8516.0,34,said,16,10,6,-4,9,27,6,-10,Alcatel - Lucent 's,Patricia F Russo,ORGANIZATION-ORGANIZATION-ORGANIZATION-ORGANIZATION,PERSON-PERSON-PERSON,PROPN-PUNCT-PROPN-PART,PROPN-PROPN-PROPN,compound-punct-poss-case,compound-compound-nsubj,NNP-HYPH-NNP-POS,NNP-NNP-NNP,4,1
3980,8529.0,61,made,29,2,14,12,1,46,27,-15,Manila Economic and Cultural Office,Philippines,ORGANIZATION-ORGANIZATION-ORGANIZATION-ORGANIZATION-ORGANIZATION,COUNTRY,PROPN-PROPN-CCONJ-PROPN-PROPN,PROPN,nmod-nmod-cc-conj-compound,poss,NNP-NNP-CC-NNP-NNP,NNPS,5,1
3981,8575.0,63,said,29,41,4,-37,40,58,-12,-25,Manila Economic and Cultural Office,Philippines,ORGANIZATION-ORGANIZATION-ORGANIZATION-ORGANIZATION-ORGANIZATION,COUNTRY,PROPN-PROPN-CCONJ-PROPN-PROPN,PROPN,nmod-nmod-cc-conj-pobj,poss,NNP-NNP-CC-NNP-NNP,NNPS,11,1
3982,33813.0,28,was,22,7,20,13,6,7,15,-2,Manila Economic and Cultural Office,Philippines,ORGANIZATION-ORGANIZATION-ORGANIZATION-ORGANIZATION-ORGANIZATION,COUNTRY,PROPN-PROPN-CCONJ-PROPN-PROPN,PROPN,nmod-nmod-cc-conj-pobj,pobj,NNP-NNP-CC-NNP-NNP,NNP,12,1
3983,57639.0,45,cast,7,36,13,-23,35,31,-29,6,Manila Economic and Cultural Office,Philippines,ORGANIZATION-ORGANIZATION-ORGANIZATION-ORGANIZATION-ORGANIZATION,COUNTRY,PROPN-PROPN-CCONJ-PROPN-PROPN,PROPN,nmod-amod-cc-conj-appos,poss,NNP-NNP-CC-NNP-NNP,NNP,9,1
3984,63514.0,76,said,54,66,2,-64,65,73,-12,-52,Manila Economic and Cultural Office,Philippines,ORGANIZATION-ORGANIZATION-ORGANIZATION-ORGANIZATION-ORGANIZATION,COUNTRY,PROPN-PROPN-CCONJ-PROPN-PROPN,PROPN,nmod-nmod-cc-conj-pobj,pobj,NNP-NNP-CC-NNP-NNP,NNPS,8,1
3985,8535.0,28,killed,10,8,25,17,7,2,2,15,Lashkar-e-Taiba,Pakistan,ORGANIZATION,COUNTRY,PROPN,PROPN,compound,pobj,NNP,NNP,7,1
3986,29853.0,40,reiterated,6,33,30,-3,32,9,-27,24,Lashkar-e-Taiba,Pakistan,ORGANIZATION,COUNTRY,PROPN,PROPN,compound,npadvmod,NNP,NNP,3,1
3987,58613.0,38,continued,2,37,29,-8,36,8,-35,27,Lashkar-e-Taiba,Pakistan,ORGANIZATION,COUNTRY,PROPN,PROPN,appos,pobj,NNP,NNP,4,1
3988,8550.0,33,issued,10,6,17,11,5,15,4,7,the American Bankers Association,ABA,ORGANIZATION-ORGANIZATION-ORGANIZATION-ORGANIZATION,ORGANIZATION,DET-PROPN-PROPN-PROPN,PROPN,det-compound-compound-pobj,nsubj,DT-NNP-NNPS-NNP,NNP,8,1
3989,8552.0,19,said,5,3,12,9,2,6,2,7,Abdul Jalil Jan,Islamization,PERSON-PERSON-PERSON,RELIGION,PROPN-PROPN-PROPN,NOUN,compound-compound-nsubj,pobj,NNP-NNP-NNP,NN,6,1
3990,8555.0,29,comes,8,11,6,-5,10,22,-3,-2,Hong Kong Disneyland,Kam,ORGANIZATION-ORGANIZATION-ORGANIZATION,PERSON,PROPN-PROPN-PROPN,PROPN,compound-compound-nsubj,poss,NNP-NNP-NNP,NNP,6,1
3991,8557.0,35,mourned,29,10,9,-1,9,25,19,-20,Raul Castro,president,PERSON-PERSON,TITLE,PROPN-PROPN,NOUN,compound-pobj,compound,NNP-NNP,NN,1,1
3992,11871.0,38,freed,6,9,22,13,8,15,-3,16,Raul Castro,president,PERSON-PERSON,TITLE,PROPN-PROPN,NOUN,compound-nsubj,pobj,NNP-NNP,NN,6,1
3993,12911.0,19,serving,6,1,10,9,0,8,5,4,Raul Castro,president,PERSON-PERSON,TITLE,PROPN-PROPN,NOUN,compound-nsubj,pobj,NNP-NNP,NN,4,1
3994,22355.0,16,Espin,3,10,9,-1,9,6,-7,6,Raul Castro,president,PERSON-PERSON,TITLE,PROPN-PROPN,NOUN,compound-pobj,compound,NNP-NNP,NN,1,1
3995,41201.0,36,been,2,7,11,4,6,24,-5,9,Raul Castro,president,PERSON-PERSON,TITLE,PROPN-PROPN,NOUN,compound-nsubj,attr,NNP-NNP,NN,2,1
3996,48842.0,37,admitted,21,2,10,8,1,26,19,-11,Raul Castro,president,PERSON-PERSON,TITLE,PROPN-PROPN,NOUN,compound-nsubj,attr,NNP-NNP,NN,3,1
3997,49473.0,26,criticized,5,15,14,-1,14,11,-10,9,Raul Castro,president,PERSON-PERSON,TITLE,PROPN-PROPN,NOUN,compound-pobj,compound,NNP-NNP,NN,1,1
3998,51536.0,33,Urgent,0,3,6,3,2,26,-3,6,Raul Castro,president,PERSON-PERSON,TITLE,PROPN-PROPN,NOUN,compound-compound,appos,NNP-NNP,NN,3,1
3999,60748.0,31,was,7,1,7,6,0,23,6,0,Raul Castro,president,PERSON-PERSON,TITLE,PROPN-PROPN,NOUN,compound-poss,pobj,NNP-NNP,NN,2,1
4000,66558.0,20,serving,13,1,10,9,0,9,12,-3,Raul Castro,president,PERSON-PERSON,TITLE,PROPN-PROPN,NOUN,compound-nsubj,pobj,NNP-NNP,NN,2,1
4001,8560.0,39,said,37,18,32,14,17,6,19,-5,Hussein Kamel,Military Industrialization Organization,PERSON-PERSON,ORGANIZATION-ORGANIZATION-ORGANIZATION,PROPN-PROPN,PROPN-PROPN-PROPN,compound-compound,compound-compound-pobj,NNP-NNP,NNP-NNP-NNP,8,1
4002,8569.0,18,fell,3,3,2,-1,2,15,0,-1,Hindalco,producer,PERSON,TITLE,PROPN,NOUN,nsubj,compound,NNP,NN,1,1
4003,10813.0,32,advanced,19,14,18,4,13,13,5,-1,Hindalco,producer,PERSON,TITLE,PROPN,NOUN,conj,compound,NNP,NN,5,1
4004,8585.0,45,changed,23,1,19,18,0,25,22,-4,Irene Morgan Kirkaldy,Gloucester,PERSON-PERSON-PERSON,CITY,PROPN-PROPN-PROPN,PROPN,compound-compound-nsubj,pobj,NNP-NNP-NNP,NNP,7,1
4005,8589.0,30,flying,3,19,2,-17,18,27,-16,-1,Jamie Lynn Spears,Brit,PERSON-PERSON-PERSON,PERSON,PROPN-PROPN-PROPN,PROPN,compound-compound-appos,nsubj,NNP-NNP-NNPS,NNP,5,1
4006,8592.0,37,managed,10,9,5,-4,8,31,1,-5,Art Buchwald,US,PERSON-PERSON,NATIONALITY,PROPN-PROPN,PROPN,compound-conj,compound,NNP-NNP,NNP,1,1
4007,59483.0,27,said,24,2,8,6,1,18,22,-16,Art Buchwald,US,PERSON-PERSON,NATIONALITY,NOUN-PROPN,PROPN,compound-nsubj,compound,NN-NNP,NNP,4,1
4008,8598.0,32,said,17,29,19,-10,28,12,-12,2,Highland Capital Partners,Bob Davis,ORGANIZATION-ORGANIZATION-ORGANIZATION,PERSON-PERSON,PROPN-PROPN-PROPN,PROPN-PROPN,compound-compound-pobj,compound-nsubj,NNP-NNP-NNPS,NNP-NNP,7,1
4009,8617.0,37,Title,0,13,16,3,12,20,-13,16,Universiteit Gent,Faculty of Engineering,ORGANIZATION-ORGANIZATION,ORGANIZATION-ORGANIZATION-ORGANIZATION,PROPN-PROPN,PROPN-ADP-PROPN,compound-ROOT,appos-prep-pobj,NNP-NNP,NNP-IN-NNP,2,1
4010,8634.0,30,mock,7,21,1,-20,20,28,-14,-6,Dan Abrams,MSNBC,PERSON-PERSON,ORGANIZATION,PROPN-PROPN,PROPN,compound-nsubj,nmod,NNP-NNP,NNP,6,1
4011,11600.0,12,is,4,3,11,8,2,0,1,7,Dan Abrams,MSNBC,PERSON-PERSON,ORGANIZATION,PROPN-PROPN,PROPN,compound-nsubj,pobj,NNP-NNP,NNP,2,1
4012,23627.0,48,slammed,11,10,6,-4,9,41,1,-5,Dan Abrams,MSNBC,PERSON-PERSON,ORGANIZATION,PROPN-PROPN,PROPN,compound-nsubj,poss,NNP-NNP,NNP,4,1
4013,28227.0,26,surprised,4,9,6,-3,8,19,-5,2,Dan Abrams,MSNBC,PERSON-PERSON,ORGANIZATION,PROPN-PROPN,PROPN,compound-dobj,nmod,NNP-NNP,NNP,2,1
4014,29293.0,45,dumped,1,32,6,-26,31,38,-31,5,Dan Abrams,MSNBC,PERSON-PERSON,ORGANIZATION,PROPN-PROPN,PROPN,compound-conj,compound,NNP-NNP,NNP,3,1
4015,30498.0,53,saying,4,2,15,13,1,37,2,11,Dan Abrams,MSNBC,PERSON-PERSON,ORGANIZATION,PROPN-PROPN,PROPN,compound-nsubj,compound,NNP-NNP,NNP,3,1
4016,36364.0,43,continue,20,1,6,5,0,36,19,-14,Dan Abrams,MSNBC,PERSON-PERSON,ORGANIZATION,PROPN-PROPN,PROPN,compound-nsubj,pobj,NNP-NNP,NNP,2,1
4017,44972.0,39,told,12,17,15,-2,16,23,-5,3,Dan Abrams,MSNBC,PERSON-PERSON,ORGANIZATION,PROPN-PROPN,PROPN,compound-dobj,compound,NNP-NNP,NNP,1,1
4018,49625.0,22,offered,18,11,9,-2,10,12,7,-9,Dan Abrams,MSNBC,PERSON-PERSON,ORGANIZATION,PROPN-PROPN,PROPN,compound-appos,poss,NNP-NNP,NNP,2,1
4019,56994.0,50,presents,8,35,7,-28,34,42,-27,-1,Dan Abrams,MSNBC,PERSON-PERSON,ORGANIZATION,PROPN-PROPN,PROPN,compound-pobj,nsubj,NNP-NNP,NNP,3,1
4020,57472.0,11,named,4,1,10,9,0,0,3,6,Dan Abrams,MSNBC,PERSON-PERSON,ORGANIZATION,PROPN-PROPN,PROPN,compound-nsubjpass,pobj,NNP-NNP,NNP,2,1
4021,8639.0,31,gained,2,29,20,-9,28,10,-27,18,Michael Mitchell,his,PERSON-PERSON,PERSON,PROPN-PROPN,DET,compound-conj,poss,NNP-NNP,PRP$,6,1
4022,8650.0,41,said,15,1,11,10,0,29,14,-4,Covidien,nearly three years ago,ORGANIZATION,DATE-DATE-DATE-DATE,PROPN,ADV-NUM-NOUN-ADV,npadvmod,advmod-nummod-npadvmod-advmod,NNP,RB-CD-NNS-RB,4,1
4023,8658.0,31,was,1,1,4,3,0,26,0,3,He,lieutenant,PERSON,TITLE,PRON,NOUN,nsubj,attr,PRP,NN,2,1
4024,8659.0,33,died,30,1,12,11,0,20,29,-18,Art Buchwald,author,PERSON-PERSON,TITLE,PROPN-PROPN,NOUN,compound-nsubj,conj,NNP-NNP,NN,3,1
4025,8664.0,44,said,39,1,5,4,0,38,38,-34,Abdul Karim al-Khawinay,editor,PERSON-PERSON-PERSON,TITLE,PROPN-PROPN-PROPN,NOUN,compound-compound-nsubjpass,appos,NNP-NNP-NNP,NN,2,1
4026,30545.0,47,found,19,9,13,4,8,33,10,-6,Abdul Karim al-Khawinay,editor,PERSON-PERSON-PERSON,TITLE,PROPN-PROPN-PROPN,NOUN,compound-compound-nsubjpass,appos,NNP-NNP-NNP,NN,7,1
4027,40823.0,44,gathered,3,31,29,-2,30,14,-28,26,Abdul Karim al-Khawinay,editor,PERSON-PERSON-PERSON,TITLE,PROPN-PROPN-PROPN,NOUN,compound-compound-pobj,compound,NNP-NNP-NNP,NN,4,1
4028,8665.0,31,was,1,9,1,-8,8,29,-8,0,National Union for the Total Independence of Angola,Savimbi,ORGANIZATION-ORGANIZATION-ORGANIZATION-ORGANIZATION-ORGANIZATION-ORGANIZATION-ORGANIZATION-ORGANIZATION,PERSON,PROPN-PROPN-ADP-DET-PROPN-PROPN-ADP-PROPN,PROPN,compound-pobj-prep-det-compound-pobj-prep-pobj,nsubj,NNP-NNP-IN-DT-NNP-NNP-IN-NNP,NNP,3,1
4029,8666.0,61,said,58,14,7,-7,13,53,44,-51,Bernama,http://wwwbernamacom/bernama/v3/news_litephp?id=111574,ORGANIZATION,URL,PROPN,PROPN,compound,compound,NNP,NNP,2,1
4030,8673.0,48,promised,20,6,11,5,5,36,14,-9,China National Aviation Corp.,CNAC,ORGANIZATION-ORGANIZATION-ORGANIZATION-ORGANIZATION,ORGANIZATION,PROPN-PROPN-PROPN-PROPN,PROPN,compound-compound-compound-subtok,compound,NNP-NNP-NNP-NNP,NNP,-1,1
4031,17628.0,39,said,21,1,10,9,0,28,20,-11,China National Aviation Corp.,CNAC,ORGANIZATION-ORGANIZATION-ORGANIZATION-ORGANIZATION,ORGANIZATION,PROPN-PROPN-PROPN-PROPN,PROPN,compound-subtok-subtok-subtok,conj,NNP-NNP-NNP-NNP,NNP,4,1
4032,30616.0,35,said,10,2,8,6,1,26,8,-2,China National Aviation Corp.,CNAC,ORGANIZATION-ORGANIZATION-ORGANIZATION-ORGANIZATION,ORGANIZATION,PROPN-PROPN-PROPN-PROPN,PROPN,compound-compound-compound-dobj,conj,NNP-NNP-NNP-NNP,NNP,2,1
4033,45277.0,35,voted,4,13,18,5,12,16,-9,14,China National Aviation Corp.,CNAC,ORGANIZATION-ORGANIZATION-ORGANIZATION-ORGANIZATION,ORGANIZATION,PROPN-PROPN-PROPN-PROPN,PROPN,compound-compound-compound-subtok,compound,NNP-NNP-NNP-NNP,NNP,-1,1
4034,55939.0,63,voted,2,16,24,8,15,38,-14,22,China National Aviation Corp.,CNAC,ORGANIZATION-ORGANIZATION-ORGANIZATION-ORGANIZATION,ORGANIZATION,PROPN-PROPN-PROPN-PROPN,PROPN,compound-compound-compound-subtok,compound,NNP-NNP-NNP-NNP,NNP,-1,1
4035,8685.0,34,added,32,3,9,6,2,24,29,-23,Old Lane 's founding partners,Vikram Pandit,ORGANIZATION-ORGANIZATION-ORGANIZATION-ORGANIZATION-ORGANIZATION,PERSON-PERSON,PROPN-PROPN-PART-VERB-NOUN,PROPN-PROPN,compound-poss-case-amod-pobj,compound-appos,NNP-NNP-POS-VBG-NNS,NNP-NNP,4,1
4036,8689.0,36,known,2,1,29,28,0,6,1,27,Saeed,Muridke,ORGANIZATION,CITY,PROPN,PROPN,nsubjpass,pobj,NNP,NNP,7,1
4037,8695.0,69,said,41,40,37,-3,39,31,1,-4,CC,Competition Commission,ORGANIZATION,ORGANIZATION-ORGANIZATION,PROPN,PROPN-PROPN,compound,compound-appos,NNP,NNP-NNP,2,1
4038,27815.0,49,hits,3,14,2,-12,13,46,-11,-1,CC,Competition Commission,ORGANIZATION,ORGANIZATION-ORGANIZATION,PROPN,PROPN-PROPN,compound,compound-ROOT,NNP,NNP-NNP,5,1
4039,8696.0,54,survived,2,5,8,3,4,45,-3,6,his,Hannah Greeley Kaiser,PERSON,PERSON-PERSON-PERSON,DET,PROPN-PROPN-PROPN,poss,compound-compound-appos,PRP$,NNP-NNP-NNP,2,1
4040,17022.0,66,survived,12,2,21,19,1,44,10,9,his,Hannah Greeley Kaiser,PERSON,PERSON-PERSON-PERSON,DET,PROPN-PROPN-PROPN,poss,compound-compound-appos,PRP$,NNP-NNP-NNP,4,1
4041,40396.0,66,survived,12,2,21,19,1,44,10,9,his,Hannah Greeley Kaiser,PERSON,PERSON-PERSON-PERSON,DET,PROPN-PROPN-PROPN,poss,compound-compound-appos,PRP$,NNP-NNP-NNP,4,1
4042,8701.0,27,died,25,21,1,-20,20,25,4,-24,George Roy Hill,Louisa Horton Hill,PERSON-PERSON-PERSON,PERSON-PERSON-PERSON,PROPN-PROPN-PROPN,PROPN-PROPN-PROPN,compound-compound-pobj,compound-compound-nsubj,NNP-NNP-NNP,NNP-NNP-NNP,6,1
4043,8704.0,18,served,1,13,5,-8,12,12,-12,4,she,U.S.,PERSON,COUNTRY,PRON,PROPN,nsubj,compound,PRP,NNP,4,1
4044,60941.0,23,said,9,17,5,-12,16,17,-8,-4,she,U.S.,PERSON,COUNTRY,PRON,PROPN,nsubjpass,compound,PRP,NNP,7,1
4045,8707.0,32,survived,7,16,23,7,15,8,-9,16,Silvestre,Kelly Harris,PERSON,PERSON-PERSON,PROPN,PROPN-PROPN,appos,compound-conj,NNP,NNP-NNP,4,1
4046,8713.0,17,Wednesday,2,15,5,-10,14,11,-13,3,his,Congressman,PERSON,TITLE,DET,PROPN,poss,compound,PRP$,NNP,3,1
4047,32426.0,20,Gillmor,6,15,5,-10,14,14,-9,-1,his,Congressman,PERSON,TITLE,DET,PROPN,poss,compound,PRP$,NNP,-1,1
4048,8720.0,21,vanished,8,7,5,-2,6,15,1,-3,Murat Kurnaz,19,PERSON-PERSON,NUMBER,PROPN-PROPN,NUM,compound-nsubj,pobj,NNP-NNP,CD,2,1
4049,8724.0,21,was,9,5,9,4,4,11,4,0,Country Music Association,Nelson,ORGANIZATION-ORGANIZATION-ORGANIZATION,PERSON,PROPN-PROPN-PROPN,PROPN,compound-compound-pobj,nsubj,NNP-NNP-NNP,NNP,6,1
4050,8728.0,37,said,17,4,10,6,3,26,13,-7,Julian Bond,American University,PERSON-PERSON,ORGANIZATION-ORGANIZATION,PROPN-PROPN,PROPN-PROPN,compound-nsubj,compound-pobj,NNP-NNP,NNP-NNP,3,1
4051,8733.0,58,authorized,4,36,13,-23,35,44,-32,9,Fyffes,DCC,ORGANIZATION,ORGANIZATION,PROPN,PROPN,compound,nsubj,NNP,NNP,6,1
4052,11679.0,18,used,5,16,5,-11,15,12,-11,0,Fyffes,DCC,ORGANIZATION,ORGANIZATION,PROPN,PROPN,compound,nsubj,NNP,NNP,3,1
4053,16313.0,43,agreed,4,17,4,-13,16,38,-13,0,Fyffes,DCC,ORGANIZATION,ORGANIZATION,PROPN,PROPN,pobj,nsubj,NNP,NNP,2,1
4054,28193.0,58,authorized,4,36,13,-23,35,44,-32,9,Fyffes,DCC,ORGANIZATION,ORGANIZATION,PROPN,PROPN,pobj,poss,NNP,NNP,6,1
4055,28253.0,31,said,1,22,16,-6,21,14,-21,15,Fyffes,DCC,ORGANIZATION,ORGANIZATION,PROPN,PROPN,pobj,poss,NNPS,NNP,3,1
4056,37640.0,43,agreed,4,17,4,-13,16,38,-13,0,Fyffes,DCC,ORGANIZATION,ORGANIZATION,PROPN,PROPN,compound,nsubj,NNP,NNP,2,1
4057,67969.0,21,declined,17,1,8,7,0,12,16,-9,Fyffes,DCC,ORGANIZATION,ORGANIZATION,NOUN,PROPN,nsubj,poss,NNS,NNP,7,1
4058,67996.0,18,includes,3,14,2,-12,13,15,-11,-1,Fyffes,DCC,ORGANIZATION,PERSON,PROPN,PROPN,poss,compound,NNP,NNP,6,1
4059,8736.0,37,obtained,1,1,22,21,0,14,0,21,He,Institute of Hematology of Hospital Saint-Louis,PERSON,ORGANIZATION-ORGANIZATION-ORGANIZATION-ORGANIZATION-ORGANIZATION-ORGANIZATION,PRON,PROPN-ADP-PROPN-ADP-PROPN-PROPN,nsubj,pobj-prep-pobj-prep-compound-pobj,PRP,NNP-IN-NNP-IN-NNP-NNP,4,1
4060,54686.0,22,received,1,1,7,6,0,14,0,6,He,Institute of Hematology of Hospital Saint-Louis,PERSON,ORGANIZATION-ORGANIZATION-ORGANIZATION-ORGANIZATION-ORGANIZATION-ORGANIZATION,PRON,PROPN-ADP-PROPN-ADP-PROPN-PROPN,nsubj,pobj-prep-pobj-prep-compound-pobj,PRP,NNP-IN-NNP-IN-NNP-NNP,3,1
4061,8750.0,26,born,14,10,21,11,9,4,4,7,"Theodor Herzl , Kollek",1911,PERSON-PERSON-PERSON-PERSON,DATE,PROPN-PROPN-PUNCT-PROPN,NUM,compound-npadvmod-punct-nsubjpass,pobj,"NNP-NNP-,-NNP",CD,3,1
4062,8751.0,47,said,25,40,44,4,39,2,-15,19,Golden Baseball League,California,ORGANIZATION-ORGANIZATION-ORGANIZATION,STATE_OR_PROVINCE,PROPN-PROPN-PROPN,PROPN,compound-compound-pobj,pobj,NNP-NNP-NNP,NNP,4,1
4063,29414.0,19,is,5,3,14,11,2,4,2,9,Golden Baseball League,California,ORGANIZATION-ORGANIZATION-ORGANIZATION,STATE_OR_PROVINCE,PROPN-PROPN-PROPN,PROPN,compound-compound-nsubj,pobj,NNP-NNP-NNP,NNP,6,1
4064,8766.0,68,2007-11-27T21,0,20,27,7,19,40,-20,27,American Psychiatric Association,Steven Sharfstein,ORGANIZATION-ORGANIZATION-ORGANIZATION,PERSON-PERSON,PROPN-PROPN-PROPN,PROPN-PROPN,compound-compound-poss,compound-appos,NNP-NNP-NNP,NNP-NNP,4,1
4065,8799.0,25,continues,1,19,1,-18,18,23,-18,0,Chavez,Venezuela,PERSON,COUNTRY,PROPN,PROPN,pobj,nsubj,NNP,NNP,12,1
4066,14685.0,30,Venez,0,3,8,5,2,21,-3,8,Chavez,Venezuela,PERSON,COUNTRY,PROPN,PROPN,compound,compound,NNP,NNP,2,1
4067,27268.0,20,warned,3,3,19,16,2,0,0,16,Chavez,Venezuela,PERSON,COUNTRY,PROPN,PROPN,nsubj,pobj,NNP,NNP,1,1
4068,30298.0,23,paid,11,2,10,8,1,12,9,-1,Chavez,Venezuela,PERSON,COUNTRY,PROPN,PROPN,nsubj,nsubj,NNP,NNP,2,1
4069,32483.0,16,Venezuela,0,4,1,-3,3,14,-4,1,Chavez,Venezuela,PERSON,COUNTRY,PROPN,PROPN,nsubj,ROOT,NNP,NNP,4,1
4070,44905.0,24,rebuked,1,1,15,14,0,8,0,14,Chavez,Venezuela,PERSON,COUNTRY,PROPN,PROPN,nsubj,pobj,NNP,NNP,7,1
4071,46037.0,19,say,1,18,11,-7,17,7,-17,10,Chavez,Venezuela,PERSON,COUNTRY,PROPN,PROPN,pobj,pobj,NNP,NNP,2,1
4072,50286.0,7,mediates,3,3,1,-2,2,5,0,-2,Chavez,Venezuela,PERSON,COUNTRY,PROPN,PROPN,nsubj,poss,NNP,NNP,3,1
4073,8806.0,41,Association,2,1,5,4,0,35,1,3,Inter-American Press Association,http://wwwsipiapacom/defaultcfm,ORGANIZATION-ORGANIZATION-ORGANIZATION,URL,ADJ-PROPN-PROPN,X,amod-compound-ROOT,mark,JJ-NNP-NNP,ADD,2,1
4074,8810.0,50,bought,3,44,3,-41,43,46,-41,0,USA Network,Vivendi Universal,ORGANIZATION-ORGANIZATION,ORGANIZATION-ORGANIZATION,PROPN-PROPN,PROPN-PROPN,compound-pobj,compound-dobj,NNP-NNP,NNP-NNP,8,1
4075,8813.0,47,said,11,9,7,-2,8,39,2,-4,Steve McPherson,ABS,PERSON-PERSON,ORGANIZATION,PROPN-PROPN,NOUN,compound-nsubj,compound,NNP-NNP,NN,1,1
4076,8823.0,43,say,3,35,37,2,34,5,-32,34,IAPA,press freedom commission,ORGANIZATION,ORGANIZATION-ORGANIZATION-ORGANIZATION,PROPN,NOUN-NOUN-NOUN,poss,compound-compound-pobj,NNP,NN-NN-NN,3,1
4077,34140.0,42,said,12,7,9,2,6,32,5,-3,IAPA,press freedom commission,ORGANIZATION,ORGANIZATION-ORGANIZATION-ORGANIZATION,PROPN,NOUN-NOUN-NOUN,poss,compound-compound-pobj,NNP,NN-NN-NN,3,1
4078,8835.0,31,was,4,2,15,13,1,15,2,11,his,Switzerland,PERSON,COUNTRY,DET,PROPN,poss,pobj,PRP$,NNP,4,1
4079,8838.0,52,drawn,4,13,17,4,12,34,-9,13,American Bar Association,Talbot,ORGANIZATION-ORGANIZATION-ORGANIZATION,PERSON,PROPN-PROPN-PROPN,PROPN,compound-compound-compound,nmod,NNP-NNP-NNP,NNP,5,1
4080,8839.0,30,survived,2,14,1,-13,13,28,-12,-1,he,Bellecourt,PERSON,PERSON,PRON,PROPN,nsubjpass,nsubjpass,PRP,NNP,5,1
4081,8841.0,29,is,1,11,6,-5,10,22,-10,5,Moro National Liberation Front,Misuari,ORGANIZATION-ORGANIZATION-ORGANIZATION-ORGANIZATION,PERSON,PROPN-PROPN-PROPN-PROPN,PROPN,compound-compound-compound-appos,poss,NNP-NNP-NNP-NNP,NNP,4,1
4082,8843.0,15,joined,9,3,14,11,2,0,6,5,Kollek,Austria,PERSON,COUNTRY,PROPN,PROPN,nsubj,pobj,NNP,NNP,3,1
4083,9325.0,17,emigrated,7,7,5,-2,6,11,0,-2,Kollek,Austria,PERSON,NATIONALITY,PROPN,PROPN,nsubj,pobj,NNP,NNP,1,1
4084,8848.0,30,said,23,1,15,14,0,14,22,-8,Forsberg,Oct. 19,PERSON,DATE-DATE,PROPN,PROPN-NUM,nsubj,npadvmod-nummod,NNP,NNP-CD,4,1
4085,8850.0,44,said,39,1,8,7,0,35,38,-31,Abdul Karim al-Khawinay,Al-Shura,PERSON-PERSON-PERSON,ORGANIZATION,PROPN-PROPN-PROPN,PROPN,compound-compound-nsubjpass,compound,NNP-NNP-NNP,NNP,5,1
4086,8868.0,24,cancelled,14,11,1,-10,10,22,3,-13,Bryan McFadden,Kerry,PERSON-PERSON,PERSON,PROPN-PROPN,PROPN,compound-dobj,nsubj,NNP-NNP,NNP,3,1
4087,8877.0,31,said,28,1,9,8,0,21,27,-19,R Nicholas Burns,diplomat,PERSON-PERSON-PERSON,TITLE,PROPN-PROPN-PROPN,NOUN,compound-compound-nsubj,appos,NNP-NNP-NNP,NN,3,1
4088,8880.0,34,reported,32,5,4,-1,4,29,27,-28,Ayatollah Seyyed Ali Khamenei,Leader,PERSON-PERSON-PERSON-PERSON,TITLE,PROPN-PROPN-PROPN-PROPN,PROPN,compound-compound-compound-nsubj,compound,NNP-NNP-NNP-NNP,NNP,2,1
4089,8883.0,36,aired,7,13,20,7,12,15,-6,13,Holly Montag,Spencer,PERSON-PERSON,PERSON,PROPN-PROPN,PROPN,compound-dobj,poss,NNP-NNP,NNP,7,1
4090,8892.0,36,came,2,18,24,6,17,11,-16,22,Bangladesh Awami League,Syed Ashraful Islam,ORGANIZATION-ORGANIZATION-ORGANIZATION,PERSON-PERSON-PERSON,PROPN-PROPN-PROPN,PROPN-PROPN-PROPN,compound-compound-pobj,compound-compound-ROOT,NNP-NNP-NNP,NNP-NNP-NNP,-1,1
4091,8902.0,40,said,14,34,16,-18,33,23,-20,2,Mainland Affairs Council,David Huang,ORGANIZATION-ORGANIZATION-ORGANIZATION,PERSON-PERSON,PROPN-PROPN-PROPN,PROPN-PROPN,compound-compound-pobj,compound-nsubj,NNP-NNPS-NNP,NNP-NNP,7,1
4092,8909.0,20,said,18,11,15,4,10,4,7,-3,Kurnaz,Turkish,PERSON,NATIONALITY,PROPN,ADJ,pobj,amod,NNP,JJ,3,1
4093,20177.0,30,was,11,1,4,3,0,25,10,-7,Kurnaz,Turkish,PERSON,NATIONALITY,PROPN,ADJ,nsubj,amod,NNP,JJ,2,1
4094,27876.0,41,detained,16,1,13,12,0,27,15,-3,Kurnaz,Turkish,PERSON,NATIONALITY,PROPN,ADJ,nsubjpass,amod,NNP,JJ,4,1
4095,42474.0,56,told,5,1,37,36,0,18,4,32,Kurnaz,Turkish,PERSON,NATIONALITY,PROPN,ADJ,poss,amod,NNP,JJ,9,1
4096,8911.0,15,JERUSALEM,0,3,1,-2,2,13,-3,1,Teddy Kollek,JERUSALEM,PERSON-PERSON,CITY,PROPN-PROPN,PROPN,compound-nsubj,ROOT,NNP-NNP,NNP,-1,1
4097,41297.0,44,JERUSALEM,0,3,1,-2,2,42,-3,1,Teddy Kollek,JERUSALEM,PERSON-PERSON,CITY,PROPN-PROPN,PROPN,compound-nsubj,ROOT,NNP-NNP,NNP,-1,1
4098,8914.0,70,was,3,27,32,5,26,37,-24,29,Chris Simcox,kindergarten teacher,PERSON-PERSON,TITLE-TITLE,PROPN-PROPN,NOUN-NOUN,compound-conj,compound-appos,NNP-NNP,NN-NN,1,1
4099,8916.0,41,served,2,1,7,6,0,33,1,5,Hubbard,U.S.,PERSON,COUNTRY,PROPN,PROPN,nsubj,compound,NNP,NNP,3,1
4100,8927.0,17,died,12,8,5,-3,7,11,4,-7,he,Elsie,PERSON,PERSON,PRON,PROPN,nsubj,appos,PRP,NNP,2,1
4101,8929.0,33,named,24,21,27,6,20,5,3,3,Itochu Corp.,Japan,ORGANIZATION-ORGANIZATION,COUNTRY,PROPN-PROPN,PROPN,compound-pobj,poss,NNP-NNP,NNP,12,1
4102,17353.0,28,named,5,12,15,3,11,12,-7,10,Itochu Corp.,Japan,ORGANIZATION-ORGANIZATION,COUNTRY,PROPN-PROPN,PROPN,compound-pobj,poss,NNP-NNP,NNP,5,1
4103,28852.0,17,owns,3,15,13,-2,14,3,-12,10,Itochu Corp.,Japan,ORGANIZATION-ORGANIZATION,COUNTRY,PROPN-PROPN,PROPN,compound-appos,poss,NNP-NNP,NNP,4,1
4104,50087.0,39,said,15,30,2,-28,29,36,-15,-13,Itochu Corp.,Japan,ORGANIZATION-ORGANIZATION,COUNTRY,PROPN-PROPN,PROPN,compound-pobj,nsubj,NNP-NNP,NNP,9,1
4105,63243.0,28,said,15,24,2,-22,23,25,-9,-13,Itochu Corp.,Japan,ORGANIZATION-ORGANIZATION,COUNTRY,PROPN-PROPN,PROPN,compound-pobj,poss,NNP-NNP,NNP,8,1
4106,8934.0,42,found,2,6,9,3,5,32,-4,7,agency,Federal Motor Carrier Safety Administration,ORGANIZATION,ORGANIZATION-ORGANIZATION-ORGANIZATION-ORGANIZATION-ORGANIZATION,NOUN,PROPN-PROPN-PROPN-PROPN-PROPN,nsubj,compound-compound-compound-compound-conj,NN,NNP-NNP-NNP-NNP-NNP,5,1
4107,8950.0,65,Directed,0,9,25,16,8,39,-9,25,Theroux,director of photography,PERSON,TITLE-TITLE-TITLE,PROPN,NOUN-ADP-NOUN,conj,npadvmod-prep-pobj,NNP,NN-IN-NN,5,1
4108,8961.0,38,Share,0,7,20,13,6,17,-7,20,Brandon McInerney,14 years old,PERSON-PERSON,NUMBER-NUMBER-NUMBER,PROPN-PROPN,NUM-NOUN-ADJ,compound-ROOT,nummod-npadvmod-acomp,NNP-NNP,CD-NNS-JJ,-1,1
4109,8970.0,34,became,2,29,11,-18,28,22,-27,9,George Young,Giants,PERSON-PERSON,ORGANIZATION,PROPN-PROPN,PROPN,compound-appos,poss,NNP-NNP,NNPS,9,1
4110,9048.0,15,was,2,13,11,-2,12,3,-11,9,George Young,Giants,PERSON-PERSON,ORGANIZATION,PROPN-PROPN,PROPN,compound-conj,dobj,NNP-NNP,NNPS,2,1
4111,13243.0,47,wanted,12,1,5,4,0,41,11,-7,George Young,Giants,PERSON-PERSON,ORGANIZATION,PROPN-PROPN,PROPN,compound-nsubj,poss,NNP-NNP,NNPS,3,1
4112,28814.0,31,said,1,11,17,6,10,13,-10,16,George Young,Giants,PERSON-PERSON,ORGANIZATION,PROPN-PROPN,PROPN,compound-pobj,nmod,NNP-NNP,NNP,4,1
4113,8972.0,31,reported,29,3,17,14,2,13,26,-12,Juanita Millender-McDonald,cancer,PERSON-PERSON,CAUSE_OF_DEATH,PROPN-PROPN,NOUN,compound-nsubj,pobj,NNP-NNP,NN,3,1
4114,41375.0,12,died,8,5,11,6,4,0,3,3,Juanita Millender-McDonald,cancer,PERSON-PERSON,CAUSE_OF_DEATH,PROPN-PROPN,NOUN,compound-appos,pobj,NNP-NNP,NN,4,1
4115,43245.0,29,died,16,2,19,17,1,9,14,3,Juanita Millender-McDonald,cancer,PERSON-PERSON,CAUSE_OF_DEATH,PROPN-PROPN,NOUN,compound-nsubj,pobj,NNP-NNP,NN,3,1
4116,51839.0,29,died,16,2,19,17,1,9,14,3,Juanita Millender-McDonald,cancer,PERSON-PERSON,CAUSE_OF_DEATH,PROPN-PROPN,NOUN,compound-nsubj,pobj,NNP-NNP,NN,3,1
4117,8974.0,41,drove,2,13,12,-1,12,28,-11,10,Justin Theroux,actor,PERSON-PERSON,TITLE,PROPN-PROPN,NOUN,compound-appos,compound,NNP-NNP,NN,1,1
4118,10131.0,34,Dr,11,3,2,-1,2,31,8,-9,Justin Theroux,actor,PERSON-PERSON,TITLE,PROPN-PROPN,NOUN,compound-poss,compound,NNP-NNP,NN,1,1
4119,12614.0,29,saved,14,7,6,-1,6,22,7,-8,Justin Theroux,actor,PERSON-PERSON,TITLE,PROPN-PROPN,NOUN,compound-pobj,compound,NNP-NNP,NN,1,1
4120,13936.0,46,is,22,3,2,-1,2,43,19,-20,Justin Theroux,actor,PERSON-PERSON,TITLE,PROPN-PROPN,NOUN,compound-appos,nsubj,NNP-NNP,NN,1,1
4121,14476.0,66,send,23,31,5,-26,30,60,-8,-18,Justin Theroux,actor,PERSON-PERSON,TITLE,PROPN-PROPN,NOUN,compound-compound,pobj,NNP-NNP,NN,5,1
4122,53090.0,23,is,17,8,7,-1,7,15,9,-10,Justin Theroux,actor,PERSON-PERSON,TITLE,PROPN-PROPN,NOUN,compound-pobj,compound,NNP-NNP,NN,1,1
4123,58294.0,46,make,23,15,14,-1,14,31,8,-9,Justin Theroux,actor,PERSON-PERSON,TITLE,PROPN-PROPN,NOUN,compound-appos,conj,NNP-NNP,NN,1,1
4124,8983.0,24,warned,7,5,3,-2,4,20,2,-4,Berthold Huber,vice president,PERSON-PERSON,TITLE-TITLE,PROPN-PROPN,NOUN-NOUN,compound-nsubj,compound-compound,NNP-NNP,NN-NN,1,1
4125,8986.0,31,became,13,25,28,3,24,2,-12,15,Marywood University,Scranton,ORGANIZATION-ORGANIZATION,CITY,PROPN-PROPN,PROPN,compound-pobj,pobj,NNP-NNP,NNP,6,1
4126,21341.0,45,says,28,43,4,-39,42,40,-15,-24,Marywood University,Scranton,ORGANIZATION-ORGANIZATION,CITY,PROPN-PROPN,PROPN,compound-pobj,pobj,NNP-NNP,NNP,12,1
4127,26211.0,31,worked,12,6,9,3,5,21,6,-3,Marywood University,Scranton,ORGANIZATION-ORGANIZATION,CITY,PROPN-PROPN,PROPN,compound-pobj,pobj,NNP-NNP,NNP,1,1
4128,26984.0,23,describes,4,9,12,3,8,10,-5,8,Marywood University,Scranton,ORGANIZATION-ORGANIZATION,CITY,PROPN-PROPN,PROPN,compound-pobj,pobj,NNP-NNP,NNP,2,1
4129,31864.0,31,said,8,25,28,3,24,2,-17,20,Marywood University,Scranton,ORGANIZATION-ORGANIZATION,CITY,PROPN-PROPN,PROPN,compound-pobj,pobj,NNP-NNP,NNP,1,1
4130,33105.0,33,said,13,27,30,3,26,2,-14,17,Marywood University,Scranton,ORGANIZATION-ORGANIZATION,CITY,PROPN-PROPN,PROPN,compound-pobj,pobj,NNP-NNP,NNP,3,1
4131,35511.0,39,said,17,33,36,3,32,2,-16,19,Marywood University,Scranton,ORGANIZATION-ORGANIZATION,CITY,PROPN-PROPN,PROPN,compound-pobj,pobj,NNP-NNP,NNP,2,1
4132,44186.0,50,said,22,33,36,3,32,13,-11,14,Marywood University,Scranton,ORGANIZATION-ORGANIZATION,CITY,PROPN-PROPN,PROPN,compound-pobj,pobj,NNP-NNP,NNP,3,1
4133,53843.0,36,manage,22,15,18,3,14,17,7,-4,Marywood University,Scranton,ORGANIZATION-ORGANIZATION,CITY,PROPN-PROPN,PROPN,compound-pobj,pobj,NNP-NNP,NNP,1,1
4134,55775.0,14,was,1,8,11,3,7,2,-7,10,Marywood University,Scranton,ORGANIZATION-ORGANIZATION,CITY,PROPN-PROPN,PROPN,compound-pobj,pobj,NNP-NNP,NNP,1,1
4135,58426.0,47,said,19,13,16,3,12,30,6,-3,Marywood University,Scranton,ORGANIZATION-ORGANIZATION,CITY,PROPN-PROPN,PROPN,compound-pobj,pobj,NNP-NNP,NNP,1,1
4136,8992.0,50,brought,18,18,11,-7,17,38,0,-7,Negroponte,Mexico,PERSON,COUNTRY,PROPN,PROPN,nsubj,pobj,NNP,NNP,8,1
4137,8998.0,24,resigned,15,7,1,-6,6,22,8,-14,National Museum of Women in the Arts,Judy Larson,ORGANIZATION-ORGANIZATION-ORGANIZATION-ORGANIZATION-ORGANIZATION-ORGANIZATION-ORGANIZATION,PERSON-PERSON,PROPN-PROPN-ADP-PROPN-ADP-DET-NOUN,PROPN-PROPN,compound-pobj-prep-pobj-prep-det-pobj,compound-nsubj,NNP-NNP-IN-NNPS-IN-DT-NNS,NNP-NNP,3,1
4138,9015.0,33,Brody,3,6,27,21,5,5,-3,24,Roy Scheider,Lorraine Gary,PERSON-PERSON,PERSON-PERSON,PROPN-PROPN,PROPN-PROPN,compound-compound,compound-compound,NNP-NNP,NNP-NNP,9,1
4139,9018.0,15,was,1,12,7,-5,11,7,-11,6,American Basketball Association,Beijing,ORGANIZATION-ORGANIZATION-ORGANIZATION,CITY,PROPN-PROPN-PROPN,PROPN,compound-compound-pobj,compound,NNP-NNP-NNP,NNP,4,1
4140,9027.0,37,said,13,15,18,3,14,18,-2,5,ADB,Jong-Wha Lee,ORGANIZATION,PERSON-PERSON,PROPN,PROPN-PROPN,nmod,compound-nsubj,NNP,NNP-NNP,3,1
4141,9029.0,48,argued,20,6,9,3,5,38,14,-11,Carolyn Maloney,D-N.Y.,PERSON-PERSON,LOCATION,PROPN-PROPN,PROPN,compound-nsubj,appos,NNP-NNP,NNP,2,1
4142,18508.0,34,working,13,2,5,3,1,28,11,-8,Carolyn Maloney,D-N.Y.,PERSON-PERSON,LOCATION,PROPN-PROPN,PROPN,compound-nsubj,conj,NNP-NNP,NNP,2,1
4143,9034.0,55,meet,6,34,31,-3,33,23,-28,25,Mainland Affairs Council,Lien Chan,ORGANIZATION-ORGANIZATION-ORGANIZATION,PERSON-PERSON,PROPN-PROPN-PROPN,PROPN-PROPN,compound-compound-compound,compound-conj,NNP-NNPS-NNP,NNP-NNP,4,1
4144,9067.0,40,is,15,19,34,15,18,5,-4,19,Adam Senn,MTV,PERSON-PERSON,ORGANIZATION,PROPN-PROPN,PROPN,compound-attr,poss,NNP-NNP,NNP,5,1
4145,9071.0,37,is,1,11,32,21,10,4,-10,31,Melanie Fiona,SRC / Universal Motown Records,PERSON-PERSON,ORGANIZATION-ORGANIZATION-ORGANIZATION-ORGANIZATION-ORGANIZATION,PROPN-PROPN,PROPN-SYM-PROPN-PROPN-PROPN,compound-poss,nmod-punct-compound-compound-pobj,NNP-NNP,NNP-SYM-NNP-NNP-NNPS,10,1
4146,9074.0,33,said,26,15,12,-3,14,20,11,-14,her,Monday,PERSON,DATE,DET,PROPN,poss,compound,PRP$,NNP,4,1
4147,9080.0,26,Hamilton,2,2,23,21,1,2,0,21,Lewis Hamilton,British,PERSON-PERSON,NATIONALITY,PROPN-PROPN,ADJ,compound-ROOT,amod,NNP-NNP,JJ,4,1
4148,17544.0,46,Formula,0,27,22,-5,26,23,-27,22,Lewis Hamilton,British,PERSON-PERSON,NATIONALITY,PROPN-PROPN,ADJ,compound-pobj,amod,NNP-NNP,JJ,3,1
4149,21147.0,32,Olympics,0,12,6,-6,11,25,-12,6,Lewis Hamilton,British,PERSON-PERSON,COUNTRY,PROPN-PROPN,ADJ,compound-nsubj,amod,NNP-NNP,JJ,3,1
4150,21520.0,51,happened,3,22,20,-2,21,30,-19,17,Lewis Hamilton,British,PERSON-PERSON,NATIONALITY,PROPN-PROPN,ADJ,compound-pobj,amod,NNP-NNP,JJ,2,1
4151,35496.0,14,Hamilton,1,1,7,6,0,6,0,6,Lewis Hamilton,British,PERSON-PERSON,COUNTRY,PROPN-PROPN,ADJ,compound-ROOT,amod,NNP-NNP,JJ,3,1
4152,40270.0,24,walked,7,6,4,-2,5,19,1,-3,Lewis Hamilton,British,PERSON-PERSON,NATIONALITY,PROPN-PROPN,ADJ,compound-appos,amod,NNP-NNP,JJ,1,1
4153,43507.0,61,Formula,0,32,30,-2,31,30,-32,30,Lewis Hamilton,British,PERSON-PERSON,NATIONALITY,PROPN-PROPN,ADJ,compound-pobj,amod,NNP-NNP,JJ,2,1
4154,63066.0,29,delivered,7,20,18,-2,19,10,-13,11,Lewis Hamilton,British,PERSON-PERSON,NATIONALITY,PROPN-PROPN,ADJ,compound-nsubj,amod,NNP-NNP,JJ,1,1
4155,9081.0,32,served,1,1,21,20,0,10,0,20,He,United Nations,PERSON,ORGANIZATION-ORGANIZATION,PRON,PROPN-PROPN,nsubj,compound-pobj,PRP,NNP-NNP,5,1
4156,9082.0,16,appointing,10,1,4,3,0,11,9,-6,Dan Abrams,attorney,PERSON-PERSON,TITLE,PROPN-PROPN,NOUN,compound-nsubj,appos,NNP-NNP,NN,2,1
4157,9083.0,8,died,1,1,4,3,0,3,0,3,Gillmor,a fall,PERSON,CAUSE_OF_DEATH-CAUSE_OF_DEATH,PROPN,DET-NOUN,nsubj,det-pobj,NNP,DT-NN,2,1
4158,9088.0,41,said,21,23,24,1,22,16,-2,3,Jerry Robbins,Robbins Diamonds,PERSON-PERSON,ORGANIZATION-ORGANIZATION,PROPN-PROPN,PROPN-PROPN,compound-nsubj,compound-pobj,NNP-NNP,NNP-NNP,6,1
4159,9104.0,25,made,3,19,15,-4,18,9,-16,12,Bernama,Hishamuddin Tun Hussein,ORGANIZATION,PERSON-PERSON-PERSON,PROPN,PROPN-PROPN-PROPN,compound,compound-compound-nmod,NNP,NNP-NNP-NNP,4,1
4160,9131.0,29,spending,19,10,14,4,9,14,9,-5,he,NBC,PERSON,ORGANIZATION,PRON,PROPN,nsubj,pobj,PRP,NNP,3,1
4161,52961.0,36,wrote,1,24,17,-7,23,18,-23,16,he,NBC,PERSON,ORGANIZATION,PRON,PROPN,nsubj,pobj,PRP,NNP,9,1
4162,9136.0,66,is,4,16,7,-9,15,58,-12,3,APA,American Psychological Association,ORGANIZATION,ORGANIZATION-ORGANIZATION-ORGANIZATION,PROPN,PROPN-PROPN-PROPN,compound,compound-compound-attr,NNP,NNP-NNP-NNP,5,1
4163,9143.0,23,called,9,8,1,-7,7,21,1,-8,Danny Glover,American,PERSON-PERSON,NATIONALITY,PROPN-PROPN,ADJ,compound-appos,amod,NNP-NNP,JJ,3,1
4164,36031.0,23,co-star,13,6,1,-5,5,21,7,-12,Danny Glover,American,PERSON-PERSON,NATIONALITY,PROPN-PROPN,ADJ,compound-conj,amod,NNP-NNP,JJ,2,1
4165,49843.0,30,plays,11,3,1,-2,2,28,8,-10,Danny Glover,American,PERSON-PERSON,NATIONALITY,PROPN-PROPN,ADJ,compound-nsubj,amod,NNP-NNP,JJ,1,1
4166,9145.0,31,opened,2,2,11,9,1,19,0,9,museum,Wilhelmina Cole Holladay,ORGANIZATION,PERSON-PERSON-PERSON,NOUN,PROPN-PROPN-PROPN,nsubj,compound-compound-pobj,NN,NNP-NNP-NNP,4,1
4167,9159.0,20,is,12,12,8,-4,11,11,0,-4,Larijani,Najaf,PERSON,CITY,PROPN,PROPN,nsubj,pobj,NNP,NNP,4,1
4168,20072.0,20,is,12,12,8,-4,11,11,0,-4,Larijani,Najaf,PERSON,CITY,PROPN,PROPN,nsubj,pobj,NNP,NNP,4,1
4169,9160.0,40,produced,9,28,32,4,27,7,-19,23,Lee Jye,chief of general staff,PERSON-PERSON,TITLE-TITLE-TITLE-TITLE,PROPN-PROPN,NOUN-ADP-ADJ-NOUN,compound-pobj,appos-prep-amod-pobj,NNP-NNP,NN-IN-JJ-NN,2,1
4170,9163.0,32,credits,17,8,2,-6,7,29,9,-15,New Hampshire Institute of Politics,Paul Manuel,ORGANIZATION-ORGANIZATION-ORGANIZATION-ORGANIZATION-ORGANIZATION,PERSON-PERSON,PROPN-PROPN-PROPN-ADP-PROPN,PROPN-PROPN,compound-compound-pobj-prep-pobj,compound-nsubj,NNP-NNP-NNP-IN-NNP,NNP-NNP,4,1
4171,26192.0,48,said,17,8,1,-7,7,46,9,-16,New Hampshire Institute of Politics,Paul Manuel,ORGANIZATION-ORGANIZATION-ORGANIZATION-ORGANIZATION-ORGANIZATION,PERSON-PERSON,PROPN-PROPN-PROPN-ADP-PROPN,PROPN-PROPN,compound-compound-pobj-prep-pobj,compound-nsubj,NNP-NNP-NNP-IN-NNP,NNP-NNP,4,1
4172,51434.0,35,said,19,8,1,-7,7,33,11,-18,New Hampshire Institute of Politics,Paul Manuel,ORGANIZATION-ORGANIZATION-ORGANIZATION-ORGANIZATION-ORGANIZATION,PERSON-PERSON,PROPN-PROPN-PROPN-ADP-PROPN,PROPN-PROPN,compound-compound-pobj-prep-pobj,compound-nsubj,NNP-NNP-NNP-IN-NNP,NNP-NNP,4,1
4173,9170.0,12,deblanc,3,2,1,-1,1,10,1,-2,Jefferson J. deblanc,Col.,PERSON-PERSON-PERSON,TITLE,PROPN-PROPN-NOUN,PROPN,compound-nsubj-ROOT,compound,NNP-NNP-NN,NNP,2,1
4174,26126.0,14,deblanc,3,2,1,-1,1,12,1,-2,Jefferson J. deblanc,Col.,PERSON-PERSON-PERSON,TITLE,PROPN-PROPN-NOUN,PROPN,compound-nsubj-ROOT,compound,NNP-NNP-NN,NNP,2,1
4175,9171.0,42,presented,1,40,37,-3,39,4,-39,36,Philip Chen,Chief Executive Officer,PERSON-PERSON,TITLE-TITLE-TITLE,PROPN-PROPN,PROPN-PROPN-PROPN,compound-conj,compound-compound-compound,NNP-NNP,NNP-NNP-NNP,3,1
4176,9173.0,12,dies,6,4,1,-3,3,10,2,-5,Jo Ann Davis,US,PERSON-PERSON-PERSON,COUNTRY,PROPN-PROPN-PROPN,PROPN,compound-compound-nsubj,compound,NNP-NNP-NNP,NNP,3,1
4177,26272.0,25,dies,6,4,1,-3,3,23,2,-5,Jo Ann Davis,US,PERSON-PERSON-PERSON,STATE_OR_PROVINCE,PROPN-PROPN-PROPN,PROPN,compound-compound-nsubj,compound,NNP-NNP-NNP,NNP,3,1
4178,35204.0,30,announced,28,4,1,-3,3,28,24,-27,Jo Ann Davis,US,PERSON-PERSON-PERSON,COUNTRY,PROPN-PROPN-PROPN,PROPN,compound-compound-nsubj,compound,NNP-NNP-NNP,NNP,3,1
4179,9186.0,20,took,5,17,4,-13,16,15,-12,-1,her,42,PERSON,NUMBER,DET,NUM,poss,appos,PRP$,CD,6,1
4180,9187.0,5,Command,3,2,5,3,1,-1,1,2,Army Medical Command,http://www.armymedicine.army.mil,ORGANIZATION-ORGANIZATION-ORGANIZATION,URL,PROPN-PROPN-PROPN,ADV,compound-compound-ROOT,punct,NNP-NNP-NNP,RB,-1,1
4181,9190.0,39,learned,2,1,14,13,0,24,1,12,Forsberg,Stockholm International Peace Research Institute,PERSON,ORGANIZATION-ORGANIZATION-ORGANIZATION-ORGANIZATION-ORGANIZATION,PROPN,PROPN-PROPN-PROPN-PROPN-PROPN,nsubj,compound-compound-compound-compound-pobj,NNP,NNP-NNP-NNP-NNP-NNP,5,1
4182,9191.0,31,drawn,3,1,30,29,0,0,2,27,Abu Zubaydah,Afghanistan,PERSON-PERSON,COUNTRY,PROPN-PROPN,PROPN,compound-nsubjpass,pobj,NNP-NNP,NNP,2,1
4183,9193.0,32,put,13,8,23,15,7,8,5,10,his,general,PERSON,TITLE,DET,ADJ,poss,amod,PRP$,JJ,5,1
4184,50801.0,33,elected,6,14,3,-11,13,29,-8,-3,his,general,PERSON,TITLE,DET,ADJ,poss,compound,PRP$,JJ,4,1
4185,67454.0,30,put,12,8,21,13,7,8,4,9,his,general,PERSON,TITLE,DET,ADJ,poss,amod,PRP$,JJ,5,1
4186,9196.0,34,TAKE,0,26,26,0,25,7,-26,26,his,his,PERSON,PERSON,DET,DET,poss,poss,PRP$,PRP$,0,1
4187,46578.0,30,survived,2,5,5,0,4,24,-3,3,his,his,PERSON,PERSON,DET,DET,poss,poss,PRP$,PRP$,0,1
4188,57124.0,47,explains,31,2,2,0,1,44,29,-29,his,his,PERSON,PERSON,DET,DET,poss,poss,PRP$,PRP$,0,1
4189,9198.0,39,said,5,3,2,-1,2,36,2,-3,G. Gary Kirchner,coroner,PERSON-PERSON-PERSON,TITLE,PROPN-PROPN-PROPN,NOUN,compound-compound-nsubj,compound,NNP-NNP-NNP,NN,2,1
4190,9206.0,36,HENEBRY,2,31,1,-30,30,34,-29,-1,Henebry,JOHN P HENEBRY,PERSON,PERSON-PERSON-PERSON,PROPN,PROPN-PROPN-PROPN,nsubj,compound-compound-ROOT,NNP,NNP-NNP-NNP,-1,1
4191,9207.0,31,touted,6,28,3,-25,27,27,-22,-3,American Bar Association,his,ORGANIZATION-ORGANIZATION-ORGANIZATION,PERSON,PROPN-PROPN-PROPN,DET,compound-compound-pobj,poss,NNP-NNP-NNP,PRP$,7,1
4192,9210.0,35,fell,8,8,1,-7,7,33,0,-7,Hindalco,India,ORGANIZATION,COUNTRY,PROPN,PROPN,appos,poss,NNP,NNP,3,1
4193,13542.0,28,gained,2,19,12,-7,18,15,-17,10,Hindalco,India,ORGANIZATION,COUNTRY,PROPN,PROPN,nsubj,poss,NNP,NNP,3,1
4194,36370.0,40,rose,7,7,1,-6,6,38,0,-6,Hindalco,India,ORGANIZATION,COUNTRY,PROPN,PROPN,nsubj,poss,NNP,NNP,3,1
4195,40905.0,17,rose,8,8,1,-7,7,15,0,-7,Hindalco,India,ORGANIZATION,COUNTRY,PROPN,PROPN,nsubj,poss,NNP,NNP,3,1
4196,54774.0,31,is,7,7,3,-4,6,27,0,-4,Hindalco,India,ORGANIZATION,COUNTRY,PROPN,PROPN,appos,npadvmod,NNP,NNP,2,1
4197,9211.0,34,face,7,22,32,10,21,1,-15,25,St. Anselm College,New Hampshire,ORGANIZATION-ORGANIZATION-ORGANIZATION,STATE_OR_PROVINCE-STATE_OR_PROVINCE,PROPN-PROPN-PROPN,PROPN-PROPN,compound-compound-pobj,compound-appos,NNP-NNP-NNP,NNP-NNP,11,1
4198,10893.0,38,told,12,3,9,6,2,28,9,-3,St. Anselm College,New Hampshire,ORGANIZATION-ORGANIZATION-ORGANIZATION,STATE_OR_PROVINCE-STATE_OR_PROVINCE,PROPN-PROPN-PROPN,PROPN-PROPN,compound-compound-pobj,compound-appos,NNP-NNP-NNP,NNP-NNP,4,1
4199,12076.0,36,said,1,29,16,-13,28,19,-28,15,St. Anselm College,New Hampshire,ORGANIZATION-ORGANIZATION-ORGANIZATION,STATE_OR_PROVINCE-STATE_OR_PROVINCE,PROPN-PROPN-PROPN,PROPN-PROPN,compound-compound-pobj,compound-compound,NNP-NNP-NNP,NNP-NNP,9,1
4200,49145.0,25,is,1,11,15,4,10,9,-10,14,St. Anselm College,New Hampshire,ORGANIZATION-ORGANIZATION-ORGANIZATION,STATE_OR_PROVINCE-STATE_OR_PROVINCE,PROPN-PROPN-PROPN,PROPN-PROPN,compound-compound-pobj,compound-pobj,NNP-NNP-NNP,NNP-NNP,3,1
4201,51579.0,45,said,16,8,14,6,7,30,8,-2,St. Anselm College,New Hampshire,ORGANIZATION-ORGANIZATION-ORGANIZATION,STATE_OR_PROVINCE-STATE_OR_PROVINCE,PROPN-PROPN-PROPN,PROPN-PROPN,compound-compound-pobj,compound-appos,NNP-NNP-NNP,NNP-NNP,4,1
4202,52204.0,28,said,12,22,26,4,21,1,-10,14,St. Anselm College,New Hampshire,ORGANIZATION-ORGANIZATION-ORGANIZATION,STATE_OR_PROVINCE-STATE_OR_PROVINCE,PROPN-PROPN-PROPN,PROPN-PROPN,compound-compound-pobj,compound-pobj,NNP-NNP-NNP,NNP-NNP,4,1
4203,9215.0,57,died,43,1,46,45,0,10,42,3,Michael K. Deaver,pancreatic cancer,PERSON-PERSON-PERSON,CAUSE_OF_DEATH-CAUSE_OF_DEATH,PROPN-PROPN-PROPN,ADJ-NOUN,compound-compound-nsubj,amod-pobj,NNP-NNP-NNP,JJ-NN,5,1
4204,9217.0,44,died,26,22,16,-6,21,27,4,-10,Gilbert Gude,her,PERSON-PERSON,PERSON,PROPN-PROPN,DET,compound-appos,poss,NNP-NNP,PRP$,1,1
4205,9219.0,12,are,7,1,9,8,0,2,6,2,Her,her,PERSON,PERSON,DET,DET,poss,poss,PRP$,PRP$,4,1
4206,9227.0,29,said,15,17,25,8,16,3,-2,10,David Gregory,St. John 's University,PERSON-PERSON,ORGANIZATION-ORGANIZATION-ORGANIZATION-ORGANIZATION,PROPN-PROPN,PROPN-PROPN-PART-PROPN,compound-nsubj,compound-poss-case-pobj,NNP-NNP,NNP-NNP-POS-NNP,6,1
4207,9230.0,40,has,18,28,24,-4,27,15,-10,6,Abu Zabaydah,al Qaeda,PERSON-PERSON,ORGANIZATION-ORGANIZATION,PROPN-PROPN,PROPN-PROPN,compound-nsubj,compound-compound,NNP-NNP,NNP-NNP,2,1
4208,9232.0,31,said,13,10,1,-9,9,29,3,-12,International Crisis Group,Nnamdi K. Obasi,ORGANIZATION-ORGANIZATION-ORGANIZATION,PERSON-PERSON-PERSON,PROPN-PROPN-PROPN,PROPN-PROPN-PROPN,compound-compound-pobj,compound-compound-nsubj,NNP-NNP-NNP,NNP-NNP-NNP,5,1
4209,9251.0,47,becoming,6,14,16,2,13,30,-8,10,NTNU,Torbjorn Digernes,ORGANIZATION,PERSON-PERSON,PROPN,PROPN-NOUN,compound,compound-pobj,NNP,NNP-NNS,1,1
4210,9269.0,68,Lunch,16,7,8,1,6,59,9,-8,National Republican Campaign Committee,Republican,ORGANIZATION-ORGANIZATION-ORGANIZATION-ORGANIZATION,IDEOLOGY,ADJ-PROPN-PROPN-PROPN,ADJ,compound-compound-compound-appos,amod,JJ-NNP-NNP-NNP,JJ,2,1
4211,56064.0,39,engendered,3,26,10,-16,25,28,-23,7,National Republican Campaign Committee,Republican,ORGANIZATION-ORGANIZATION-ORGANIZATION-ORGANIZATION,IDEOLOGY,PROPN-PROPN-PROPN-PROPN,ADJ,compound-compound-compound-pobj,amod,NNP-NNP-NNP-NNP,JJ,10,1
4212,9270.0,22,proposing,7,15,2,-13,14,19,-8,-5,ABC,Australian Communications and Media Authority,ORGANIZATION,ORGANIZATION-ORGANIZATION-ORGANIZATION-ORGANIZATION-ORGANIZATION,PROPN,PROPN-PROPN-CCONJ-PROPN-PROPN,compound,compound-nmod-cc-compound-nsubj,NNP,NNP-NNPS-CC-NNP-NNP,6,1
4213,9275.0,20,survived,2,1,19,18,0,0,1,17,Kollek,Osnat,PERSON,PERSON,PROPN,PROPN,nsubjpass,appos,NNP,NNP,2,1
4214,49797.0,14,survived,2,1,13,12,0,0,1,11,Kollek,Osnat,PERSON,PERSON,PROPN,PROPN,nsubjpass,conj,NNP,NNP,2,1
4215,9287.0,31,involved,3,1,26,25,0,4,2,23,He,Trail of Broken Treaties,PERSON,ORGANIZATION-ORGANIZATION-ORGANIZATION-ORGANIZATION,PRON,PROPN-ADP-PROPN-PROPN,nsubjpass,pobj-prep-compound-compound,PRP,NNP-IN-NNP-NNP,6,1
4216,9291.0,20,was,3,5,15,10,4,4,-2,12,Deaver,Santa Clara County Republican Party,PERSON,ORGANIZATION-ORGANIZATION-ORGANIZATION-ORGANIZATION-ORGANIZATION,PROPN,PROPN-PROPN-PROPN-PROPN-PROPN,poss,compound-compound-compound-compound-pobj,NNP,NNP-NNP-NNP-NNP-NNP,7,1
4217,9296.0,37,reiterated,20,16,1,-15,15,35,4,-19,Mainland Affairs Council,Liu Teh-hsun,ORGANIZATION-ORGANIZATION-ORGANIZATION,PERSON-PERSON,PROPN-PROPN-PROPN,PROPN-PROPN,compound-compound-appos,compound-nsubj,NNP-NNPS-NNP,NNP-NNP,3,1
4218,45130.0,36,Council,4,3,32,29,2,3,1,28,Mainland Affairs Council,Liu Teh-hsun,ORGANIZATION-ORGANIZATION-ORGANIZATION,PERSON-PERSON,PROPN-PROPN-PROPN,PROPN-PROPN,compound-compound-ROOT,compound-nsubj,NNP-NNPS-NNP,NNP-NNP,6,1
4219,60891.0,33,told,12,9,1,-8,8,31,3,-11,Mainland Affairs Council,Liu Teh-hsun,ORGANIZATION-ORGANIZATION-ORGANIZATION,PERSON-PERSON,PROPN-PROPN-PROPN,PROPN-PROPN,compound-compound-pobj,compound-nsubj,NNP-NNPS-NNP,NNP-NNP,6,1
4220,9306.0,33,honored,26,23,4,-19,22,28,3,-22,her,Gloucester County,PERSON,LOCATION-LOCATION,PRON,PROPN-PROPN,dobj,compound-nsubj,PRP,NNP-NNP,5,1
4221,38050.0,33,honored,26,23,4,-19,22,28,3,-22,her,Gloucester County,PERSON,LOCATION-LOCATION,DET,PROPN-PROPN,poss,compound-nsubj,PRP$,NNP-NNP,5,1
4222,9309.0,45,said,31,21,11,-10,20,33,10,-20,FMR Co.,Stephen P. Jonas,ORGANIZATION-ORGANIZATION,PERSON-PERSON-PERSON,PROPN-PROPN,PROPN-PROPN-PROPN,compound-nmod,compound-compound-dobj,NNP-NNP,NNP-NNP-NNP,6,1
4223,9329.0,31,said,29,12,23,11,11,7,17,-6,her,Manhattan,PERSON,CITY,DET,PROPN,poss,compound,PRP$,NNP,10,1
4224,43260.0,31,said,29,12,23,11,11,7,17,-6,her,Manhattan,PERSON,CITY,DET,PROPN,poss,compound,PRP$,NNP,10,1
4225,9334.0,32,slashed,8,8,6,-2,7,25,0,-2,MBIA,New York-based,ORGANIZATION,STATE_OR_PROVINCE-STATE_OR_PROVINCE,PROPN,PROPN-PROPN,appos,compound-compound,NNP,NNP-NNP,1,1
4226,9339.0,32,diva,1,10,9,-1,9,22,-9,8,toddler,Malawian,PERSON,NATIONALITY,NOUN,ADJ,dobj,amod,NN,JJ,2,1
4227,9348.0,6,Committee,3,1,6,5,0,-1,2,3,National Republican Campaign Committee,http://www.nrcc.org/,ORGANIZATION-ORGANIZATION-ORGANIZATION-ORGANIZATION,URL,PROPN-PROPN-PROPN-PROPN,X,compound-compound-compound-ROOT,appos,NNP-NNP-NNP-NNP,ADD,-1,1
4228,9363.0,12,dies,6,4,11,7,3,0,2,5,Jo Ann Davis,breast cancer,PERSON-PERSON-PERSON,CAUSE_OF_DEATH-CAUSE_OF_DEATH,PROPN-PROPN-PROPN,NOUN-NOUN,compound-compound-nsubj,compound-pobj,NNP-NNP-NNP,NN-NN,5,1
4229,18873.0,20,said,18,4,14,10,3,5,14,-4,Jo Ann Davis,breast cancer,PERSON-PERSON-PERSON,CAUSE_OF_DEATH-CAUSE_OF_DEATH,PROPN-PROPN-PROPN,NOUN-NOUN,compound-compound-nsubj,compound-pobj,NNP-NNP-NNP,NN-NN,5,1
4230,19063.0,34,said,32,3,28,25,2,5,29,-4,Jo Ann Davis,breast cancer,PERSON-PERSON-PERSON,CAUSE_OF_DEATH-CAUSE_OF_DEATH,PROPN-PROPN-PROPN,NOUN-NOUN,compound-compound-nsubj,compound-pobj,NNP-NNP-NNP,NN-NN,5,1
4231,24029.0,25,dies,6,4,11,7,3,13,2,5,Jo Ann Davis,breast cancer,PERSON-PERSON-PERSON,CAUSE_OF_DEATH-CAUSE_OF_DEATH,PROPN-PROPN-PROPN,NOUN-NOUN,compound-compound-nsubj,compound-compound,NNP-NNP-NNP,NN-NN,7,1
4232,51160.0,30,announced,28,4,24,20,3,5,24,-4,Jo Ann Davis,breast cancer,PERSON-PERSON-PERSON,CAUSE_OF_DEATH-CAUSE_OF_DEATH,PROPN-PROPN-PROPN,NOUN-NOUN,compound-compound-nsubj,compound-pobj,NNP-NNP-NNP,NN-NN,8,1
4233,63697.0,27,RICHMOND,0,8,21,13,7,5,-8,21,Jo Ann Davis,breast cancer,PERSON-PERSON-PERSON,CAUSE_OF_DEATH-CAUSE_OF_DEATH,PROPN-PROPN-PROPN,NOUN-NOUN,compound-compound-nsubj,compound-pobj,NNP-NNP-NNP,NN-NN,6,1
4234,9383.0,44,called,17,15,34,19,14,9,2,17,Hawkins,House,PERSON,ORGANIZATION,PROPN,PROPN,nsubj,pobj,NNP,NNP,10,1
4235,58036.0,19,assigned,9,8,6,-2,7,12,1,-3,Hawkins,House,PERSON,ORGANIZATION,PROPN,PROPN,nsubjpass,pobj,NNP,NNP,2,1
4236,9395.0,22,scored,8,21,7,-14,20,14,-13,-1,Blackburn,Jay DeMerit,ORGANIZATION,PERSON-PERSON,PROPN,PROPN-PROPN,pobj,compound-nsubj,NNP,NNP-NNP,4,1
4237,9402.0,36,include,3,22,18,-4,21,17,-19,15,SAC,Sports Affairs Council,ORGANIZATION,ORGANIZATION-ORGANIZATION-ORGANIZATION,PROPN,PROPN-PROPN-PROPN,compound,compound-compound-appos,NNP,NNPS-NNPS-NNP,7,1
4238,29256.0,47,Council,2,5,1,-4,4,45,-3,-1,SAC,Sports Affairs Council,ORGANIZATION,ORGANIZATION-ORGANIZATION-ORGANIZATION,PROPN,PROPN-PROPN-PROPN,compound,compound-compound-ROOT,NNP,NNPS-NNPS-NNP,-1,1
4239,33890.0,42,scheduled,15,37,33,-4,36,8,-22,18,SAC,Sports Affairs Council,ORGANIZATION,ORGANIZATION-ORGANIZATION-ORGANIZATION,PROPN,PROPN-PROPN-PROPN,compound,compound-compound-appos,NNP,NNPS-NNPS-NNP,2,1
4240,64846.0,32,Commenting,0,11,7,-4,10,24,-11,7,SAC,Sports Affairs Council,ORGANIZATION,ORGANIZATION-ORGANIZATION-ORGANIZATION,PROPN,PROPN-PROPN-PROPN,compound,compound-compound-appos,NNP,NNPS-NNPS-NNP,5,1
4241,9407.0,27,studied,17,17,12,-5,16,14,0,-5,Chavez,"July 28 , 1954",PERSON,DATE-DATE-DATE-DATE,PROPN,PROPN-NUM-PUNCT-NUM,nsubj,pobj-nummod-punct-nummod,NNP,"NNP-CD-,-CD",4,1
4242,9410.0,27,completed,8,1,22,21,0,4,7,14,IPSCO,NS Group Inc,ORGANIZATION,ORGANIZATION-ORGANIZATION-ORGANIZATION,PROPN,PROPN-PROPN-PROPN,nsubj,compound-compound-appos,NNP,NNP-NNP-NNP,6,1
4243,9414.0,30,said,23,1,6,5,0,23,22,-17,Forsberg,professor,PERSON,TITLE,PROPN,NOUN,nsubj,appos,NNP,NN,3,1
4244,22397.0,59,launched,16,16,8,-8,15,50,0,-8,Forsberg,professor,PERSON,TITLE,PROPN,NOUN,nsubj,conj,NNP,NN,3,1
4245,36492.0,30,said,23,1,6,5,0,23,22,-17,Forsberg,professor,PERSON,TITLE,PROPN,NOUN,nsubj,appos,NNP,NN,3,1
4246,9429.0,50,quoted,9,4,1,-3,3,48,5,-8,DCR,George Franssen,ORGANIZATION,PERSON-PERSON,PROPN,PROPN-PROPN,compound,compound-nsubjpass,NNP,NNP-NNP,1,1
4247,9432.0,32,upheld,15,25,10,-15,24,21,-10,-5,her,New York City,PERSON,CITY-CITY-CITY,PRON,PROPN-PROPN-PROPN,nsubj,compound-compound-compound,PRP,NNP-NNP-NNP,11,1
4248,9433.0,22,think,14,4,11,7,3,10,10,-3,Haifa University,Jewish,ORGANIZATION-ORGANIZATION,RELIGION,PROPN-PROPN,ADJ,compound-compound,amod,NNP-NNP,JJ,7,1
4249,9438.0,40,was,37,8,12,4,7,27,29,-25,Independent Steelworkers Union,Mark Glyptis,ORGANIZATION-ORGANIZATION-ORGANIZATION,PERSON-PERSON,PROPN-PROPN-PROPN,PROPN-PROPN,compound-compound-compound,compound-nsubj,NNP-NNPS-NNP,NNP-NNP,3,1
4250,9440.0,12,was,1,1,5,4,0,6,0,4,She,author,PERSON,TITLE,PRON,NOUN,nsubj,attr,PRP,NN,2,1
4251,58574.0,39,said,34,2,7,5,1,31,32,-27,She,author,PERSON,TITLE,PRON,NOUN,nsubj,conj,PRP,NN,3,1
4252,9443.0,32,said,22,29,24,-5,28,7,-7,2,International Crisis Group,John Prendergast,ORGANIZATION-ORGANIZATION-ORGANIZATION,PERSON-PERSON,PROPN-PROPN-PROPN,PROPN-PROPN,compound-compound-pobj,compound-nsubj,NNP-NNP-NNP,NNP-NNP,4,1
4253,9444.0,19,told,16,13,15,2,12,3,3,-1,Samsung,Hwang Chang-Gyu,ORGANIZATION,PERSON-PERSON,PROPN,PROPN-PROPN,amod,compound-nsubj,NNP,NNP-NNP,6,1
4254,9474.0,24,is,1,1,6,5,0,17,0,5,He,leader,PERSON,TITLE,PRON,NOUN,nsubj,attr,PRP,NN,2,1
4255,37686.0,33,addressing,2,1,20,19,0,12,1,18,He,leader,PERSON,TITLE,PRON,NOUN,nsubj,pobj,PRP,NN,9,1
4256,9475.0,21,elected,2,1,11,10,0,9,1,9,Mitchell,Baltimore,PERSON,CITY,PROPN,PROPN,nsubjpass,pobj,NNP,NNP,2,1
4257,9477.0,41,said,36,5,12,7,4,28,31,-24,IMF,Hossein Samiei,ORGANIZATION,PERSON-PERSON,PROPN,PROPN-PROPN,compound,compound-conj,NNP,NNP-NNP,3,1
4258,9491.0,31,inspired,5,25,29,4,24,1,-20,24,Beyoncé,Agnèz dereon,PERSON,PERSON-PERSON,PROPN,PROPN-NOUN,poss,compound-appos,NNP,NNP-NN,3,1
4259,9494.0,70,DC,0,9,9,0,8,60,-9,9,Servicemembers Legal Defense Network,Servicemembers United,ORGANIZATION-ORGANIZATION-ORGANIZATION-ORGANIZATION,ORGANIZATION-ORGANIZATION,PROPN-PROPN-PROPN-PROPN,PROPN-PROPN,compound-compound-compound-conj,compound-compound,NNP-NNP-NNP-NNP,NNP-NNP,0,1
4260,9496.0,39,said,13,7,11,4,6,27,6,-2,Mainland Affairs Council,Taipei,ORGANIZATION-ORGANIZATION-ORGANIZATION,CITY,PROPN-PROPN-PROPN,PROPN,compound-compound-pobj,pobj,NNP-NNPS-NNP,NNP,2,1
4261,9500.0,35,said,26,25,24,-1,24,10,1,-2,Julian Bond,activist,PERSON-PERSON,TITLE,PROPN-PROPN,NOUN,compound-nsubj,compound,NNP-NNP,NN,1,1
4262,47213.0,17,said,9,1,8,7,0,8,8,-1,Julian Bond,activist,PERSON-PERSON,TITLE,PROPN-PROPN,NOUN,compound-nsubj,appos,NNP-NNP,NN,2,1
4263,9501.0,63,declined,34,39,41,2,38,21,-5,7,then-MAC,Huang Kun - huei,ORGANIZATION,PERSON-PERSON-PERSON-PERSON,PUNCT,PROPN-PROPN-PUNCT-VERB,det,compound-compound-punct-pobj,.,NNP-NNP-HYPH-VBZ,2,1
4264,9516.0,58,was,4,14,25,11,13,32,-10,21,Abbas Moussawi,1992,PERSON-PERSON,DATE,PROPN-PROPN,NUM,compound-appos,pobj,NNP-NNP,CD,3,1
4265,9519.0,21,says,19,16,18,2,15,2,3,-1,the 31-year-old,commercial pilot,PERSON-PERSON,TITLE-TITLE,DET-NUM,ADJ-NOUN,det-amod,amod-nsubj,DT-CD,JJ-NN,4,1
4266,9533.0,70,seemed,6,30,60,30,29,9,-24,54,his,Christian,PERSON,RELIGION,DET,ADJ,poss,amod,PRP$,JJ,19,1
4267,45041.0,37,announced,10,12,17,5,11,19,-2,7,his,Christian,PERSON,RELIGION,DET,ADJ,poss,amod,PRP$,JJ,3,1
4268,55476.0,32,has,13,12,25,13,11,6,1,12,his,Christian,PERSON,RELIGION,DET,ADJ,poss,amod,PRP$,JJ,5,1
4269,9540.0,18,directed,4,4,7,3,3,10,0,3,he,Independent National Electoral Commission,PERSON,ORGANIZATION-ORGANIZATION-ORGANIZATION-ORGANIZATION,PRON,PROPN-PROPN-PROPN-PROPN,nsubj,compound-compound-compound-dobj,PRP,NNP-NNP-NNP-NNP,2,1
4270,56049.0,18,directed,4,4,7,3,3,10,0,3,he,Independent National Electoral Commission,PERSON,ORGANIZATION-ORGANIZATION-ORGANIZATION-ORGANIZATION,PRON,PROPN-PROPN-PROPN-PROPN,nsubj,compound-compound-compound-dobj,PRP,NNP-NNP-NNP-NNP,2,1
4271,9564.0,37,said,5,1,3,2,0,33,4,-2,Jaguars,Jack Del Rio,ORGANIZATION,PERSON-PERSON-PERSON,NOUN,PROPN-PROPN-PROPN,compound,compound-compound-nsubj,NNS,NNP-NNP-NNP,2,1
4272,17098.0,15,said,5,1,3,2,0,11,4,-2,Jaguars,Jack Del Rio,ORGANIZATION,PERSON-PERSON-PERSON,NOUN,PROPN-PROPN-PROPN,compound,compound-compound-nsubj,NNS,NNP-NNP-NNP,2,1
4273,9565.0,15,is,9,2,8,6,1,6,7,-1,International Crisis Group,Brussels,ORGANIZATION-ORGANIZATION-ORGANIZATION,CITY,PROPN-PROPN-PROPN,PROPN,compound-compound-nsubj,pobj,NNP-NNP-NNP,NNP,3,1
4274,58306.0,38,forecast,16,11,8,-3,10,29,5,-8,International Crisis Group,Brussels,ORGANIZATION-ORGANIZATION-ORGANIZATION,CITY,PROPN-PROPN-PROPN,PROPN,compound-compound-appos,npadvmod,NNP-NNP-NNP,NNP,3,1
4275,9569.0,16,said,4,1,6,5,0,9,3,2,Waratahs,his,ORGANIZATION,PERSON,PROPN,DET,compound,poss,NNP,PRP$,4,1
4276,9580.0,27,quoted,8,1,5,4,0,21,7,-3,David,Yohane Banda,PERSON,PERSON-PERSON,PROPN,PROPN-PROPN,poss,compound-appos,NNP,NNP-NNP,3,1
4277,64057.0,31,brought,2,1,22,21,0,8,1,20,David,Yohane Banda,PERSON,PERSON-PERSON,PROPN,PROPN-PROPN,nsubjpass,compound-appos,NNP,NNP-NNP,4,1
4278,66302.0,36,quoted,9,1,5,4,0,30,8,-4,David,Yohane Banda,PERSON,PERSON-PERSON,PROPN,PROPN-PROPN,poss,compound-appos,NNP,NNP-NNP,3,1
4279,9581.0,38,said,12,1,8,7,0,29,11,-4,Ali Larijani,supreme national security council,PERSON-PERSON,ORGANIZATION-ORGANIZATION-ORGANIZATION-ORGANIZATION,PROPN-PROPN,ADJ-ADJ-NOUN-NOUN,compound-nsubj,amod-amod-compound-pobj,NNP-NNP,JJ-JJ-NN-NN,5,1
4280,30930.0,40,meet,13,2,8,6,1,31,11,-5,Ali Larijani,supreme national security council,PERSON-PERSON,ORGANIZATION-ORGANIZATION-ORGANIZATION-ORGANIZATION,PROPN-PROPN,ADJ-ADJ-NOUN-NOUN,compound-nsubj,amod-amod-compound-pobj,NNP-NNP,JJ-JJ-NN-NN,5,1
4281,9582.0,25,was,9,15,7,-8,14,17,-6,-2,her,Alabama,PERSON,STATE_OR_PROVINCE,DET,PROPN,poss,appos,PRP$,NNP,3,1
4282,23832.0,38,ran,1,20,25,5,19,12,-19,24,her,Alabama,PERSON,STATE_OR_PROVINCE,DET,PROPN,poss,compound,PRP$,NNP,4,1
4283,61012.0,37,ran,1,19,24,5,18,12,-18,23,her,Alabama,PERSON,STATE_OR_PROVINCE,DET,PROPN,poss,compound,PRP$,NNP,4,1
4284,9597.0,44,rumored,12,42,40,-2,41,3,-30,28,Raul Castro,Defense Minister,PERSON-PERSON,TITLE-TITLE,PROPN-PROPN,PROPN-PROPN,compound-appos,compound-compound,NNP-NNP,NNP-NNP,1,1
4285,10231.0,33,HAVANA,0,31,29,-2,30,3,-31,29,Raul Castro,Defense Minister,PERSON-PERSON,TITLE-TITLE,PROPN-PROPN,PROPN-PROPN,compound-pobj,compound-compound,NNP-NNP,NNP-NNP,2,1
4286,47127.0,33,said,25,29,27,-2,28,5,-4,2,Raul Castro,Defense Minister,PERSON-PERSON,TITLE-TITLE,PROPN-PROPN,PROPN-PROPN,compound-nsubj,compound-compound,NNP-NNP,NNP-NNP,1,1
4287,9611.0,30,said,6,8,12,4,7,17,-2,6,George Sheldon,secretary,PERSON-PERSON,TITLE,PROPN-PROPN,NOUN,compound-nsubj,appos,NNP-NNP,NN,2,1
4288,23747.0,31,said,23,25,30,5,24,0,-2,7,George Sheldon,secretary,PERSON-PERSON,TITLE,PROPN-PROPN,NOUN,compound-nsubj,appos,NNP-NNP,NN,2,1
4289,31308.0,21,remembers,13,1,4,3,0,16,12,-9,George Sheldon,secretary,PERSON-PERSON,TITLE,PROPN-PROPN,NOUN,compound-nsubj,appos,NNP-NNP,NN,2,1
4290,43447.0,17,said,8,7,6,-1,6,10,1,-2,George Sheldon,secretary,PERSON-PERSON,TITLE,PROPN-PROPN,NOUN,compound-nsubj,compound,NNP-NNP,NN,1,1
4291,46771.0,89,made,2,32,38,6,31,50,-30,36,George Sheldon,secretary,PERSON-PERSON,TITLE,PROPN-PROPN,NOUN,compound-compound,appos,NNP-NNP,NN,-1,1
4292,9624.0,51,said,30,32,34,2,31,16,-2,4,Bond,68,PERSON,NUMBER,PROPN,NUM,nsubj,appos,NNP,CD,1,1
4293,31763.0,11,been,5,1,3,2,0,7,4,-2,Bond,68,PERSON,NUMBER,NOUN,NUM,nsubj,appos,NN,CD,2,1
4294,9630.0,8,died,4,1,4,3,0,3,3,0,Rothman,Al,PERSON,PERSON,PROPN,PROPN,poss,appos,NNP,NNP,3,1
4295,9633.0,10,became,2,1,7,6,0,2,1,5,Nolte,American Geographical Society,PERSON,ORGANIZATION-ORGANIZATION-ORGANIZATION,PROPN,PROPN-PROPN-PROPN,nsubj,compound-compound-pobj,NNP,NNP-NNP-NNP,5,1
4296,9648.0,39,awaiting,16,28,11,-17,27,27,-12,-5,SLDN,Servicemembers 's Legal Defense Network,ORGANIZATION,ORGANIZATION-ORGANIZATION-ORGANIZATION-ORGANIZATION-ORGANIZATION,PROPN,PROPN-PART-PROPN-PROPN-PROPN,nsubj,poss-case-compound-compound-pobj,NNP,NNPS-POS-NNP-NNP-NNP,9,1
4297,9651.0,34,signed,18,8,5,-3,7,28,10,-13,Philip Chen,Chief Operating Officer,PERSON-PERSON,TITLE-TITLE-TITLE,PROPN-PROPN,PROPN-PROPN-PROPN,compound-appos,compound-compound-conj,NNP-NNP,NNP-NNP-NNP,2,1
4298,56929.0,35,said,9,8,5,-3,7,29,1,-4,Philip Chen,Chief Operating Officer,PERSON-PERSON,TITLE-TITLE-TITLE,PROPN-PROPN,PROPN-PROPN-PROPN,compound-appos,compound-compound-conj,NNP-NNP,NNP-NNP-NNP,2,1
4299,9654.0,16,announced,3,3,2,-1,2,13,0,-1,Bond,68-year-old,PERSON,NUMBER,PROPN,NUM,nsubj,nummod,NNP,CD,1,1
4300,9655.0,28,said,1,3,9,6,2,18,-2,8,she,Dexter,PERSON,PERSON,PRON,PROPN,nsubj,poss,PRP,NNP,6,1
4301,9664.0,29,batted,1,26,22,-4,25,6,-25,21,Golden League,Calgary Vipers,ORGANIZATION-ORGANIZATION,ORGANIZATION-ORGANIZATION,PROPN-PROPN,PROPN-PROPN,compound-compound,compound-dobj,NNP-NNP,NNP-NNPS,4,1
4302,9668.0,25,arises,2,17,15,-2,16,9,-15,13,G. Gary Kirchner,Lancaster,PERSON-PERSON-PERSON,CITY,PROPN-PROPN-PROPN,PROPN,compound-compound-poss,compound,NNP-NNP-NNP,NNP,2,1
4303,9689.0,13,include,1,3,6,3,2,6,-2,5,her,Chuck,PERSON,PERSON,DET,PROPN,poss,appos,PRP$,NNP,2,1
4304,9704.0,22,Shah,1,1,8,7,0,13,0,7,Mahmood Shah,Pakistani government,PERSON-PERSON,ORGANIZATION-ORGANIZATION,PROPN-PROPN,ADJ-NOUN,compound-ROOT,amod-compound,NNP-NNP,JJ-NN,3,1
4305,9706.0,45,been,11,40,21,-19,39,23,-29,10,ABA,America,ORGANIZATION,COUNTRY,PROPN,PROPN,nsubj,pobj,NNP,NNP,5,1
4306,40712.0,33,said,22,32,16,-16,31,16,-10,-6,ABA,America,ORGANIZATION,COUNTRY,NOUN,PROPN,pobj,poss,NN,NNP,9,1
4307,9717.0,20,born,3,18,8,-10,17,11,-15,5,Harry Dent,Pa.,PERSON-PERSON,STATE_OR_PROVINCE,PROPN-PROPN,PROPN,compound-conj,appos,NNP-NNP,NNP,5,1
4308,9725.0,35,said,10,2,12,10,1,22,8,2,Zagat Survey,he,ORGANIZATION-ORGANIZATION,PERSON,PROPN-PROPN,PRON,compound-pobj,nsubj,NNP-NNP,PRP,4,1
4309,9729.0,32,planning,5,18,22,4,17,9,-13,17,her,SRC / Universal Motown Records,PERSON,ORGANIZATION-ORGANIZATION-ORGANIZATION-ORGANIZATION-ORGANIZATION,DET,PROPN-SYM-PROPN-PROPN-PROPN,poss,nmod-punct-compound-compound-pobj,PRP$,NNP-SYM-NNP-NNP-NNPS,2,1
4310,9733.0,39,says,4,7,26,19,6,12,-3,22,Lashkar-e-Taiba,1989,ORGANIZATION,DATE,PROPN,NUM,nsubj,pobj,NNP,CD,-1,1
4311,9742.0,35,turned,20,22,20,-2,21,14,-2,0,hers,actress,PERSON,TITLE,NOUN,NOUN,dobj,nsubj,NNS,NN,1,1
4312,9747.0,39,adopted,17,19,29,10,18,9,-2,12,David Banda,London,PERSON-PERSON,CITY,PROPN-PROPN,PROPN,compound-dobj,pobj,NNP-NNP,NNP,5,1
4313,17640.0,25,caring,14,20,24,4,19,0,-6,10,David Banda,London,PERSON-PERSON,CITY,PROPN-PROPN,PROPN,compound-appos,pobj,NNP-NNP,NNP,4,1
4314,49390.0,35,set,5,22,10,-12,21,24,-17,5,David Banda,London,PERSON-PERSON,CITY,PROPN-PROPN,PROPN,compound-nsubj,compound,NNP-NNP,NNP,7,1
4315,9749.0,26,died,17,1,25,24,0,0,16,8,Dewey,tumor,PERSON,CAUSE_OF_DEATH,PROPN,NOUN,nsubj,pobj,NNP,NN,3,1
4316,9752.0,28,said,12,14,25,11,13,2,-2,13,Sean Ross,Edison Media Research,PERSON-PERSON,ORGANIZATION-ORGANIZATION-ORGANIZATION,PROPN-PROPN,PROPN-PROPN-PROPN,compound-nsubj,compound-compound-pobj,NNP-NNP,NNP-NNP-NNP,4,1
4317,11012.0,46,says,31,33,43,10,32,2,-2,12,Sean Ross,Edison Media Research,PERSON-PERSON,ORGANIZATION-ORGANIZATION-ORGANIZATION,PROPN-PROPN,PROPN-PROPN-PROPN,compound-nsubj,compound-compound-pobj,NNP-NNP,NNP-NNP-NNP,4,1
4318,30274.0,30,says,14,16,19,3,15,10,-2,5,Sean Ross,Edison Media Research,PERSON-PERSON,ORGANIZATION-ORGANIZATION-ORGANIZATION,PROPN-PROPN,PROPN-PROPN-PROPN,compound-nsubj,compound-compound-pobj,NNP-NNP,NNP-NNP-NNP,3,1
4319,33876.0,37,said,16,18,28,10,17,8,-2,12,Sean Ross,Edison Media Research,PERSON-PERSON,ORGANIZATION-ORGANIZATION-ORGANIZATION,PROPN-PROPN,PROPN-PROPN-PROPN,compound-nsubj,compound-compound-pobj,NNP-NNP,NNP-NNP-NNP,5,1
4320,9754.0,8,name,3,5,7,2,4,0,-2,4,her,Blakesley,PERSON,PERSON,DET,PROPN,poss,appos,PRP$,NNP,2,1
4321,9755.0,26,said,17,11,5,-6,10,20,6,-12,her,68,PERSON,NUMBER,DET,NUM,poss,attr,PRP$,CD,3,1
4322,29272.0,25,said,16,10,5,-5,9,19,6,-11,her,68,PERSON,NUMBER,DET,NUM,poss,attr,PRP$,CD,3,1
4323,60871.0,26,said,17,11,5,-6,10,20,6,-12,her,68,PERSON,NUMBER,DET,NUM,poss,attr,PRP$,CD,3,1
4324,9756.0,27,said,5,4,2,-2,3,24,1,-3,George Sheldon,Assistant Secretary,PERSON-PERSON,TITLE-TITLE,PROPN-PROPN,PROPN-PROPN,compound-nsubj,compound-compound,NNP-NNP,NNP-NNP,1,1
4325,54723.0,24,said,11,15,13,-2,14,10,-4,2,George Sheldon,Assistant Secretary,PERSON-PERSON,TITLE-TITLE,PROPN-PROPN,PROPN-PROPN,compound-nsubj,compound-compound,NNP-NNP,NNP-NNP,3,1
4326,9757.0,38,formed,14,33,37,4,32,0,-19,23,Alcatel,Paris,ORGANIZATION,CITY,PROPN,PROPN,conj,pobj,NNP,NNP,6,1
4327,9760.0,34,called,28,30,15,-15,29,18,-2,-13,her,judge,PERSON,TITLE,PRON,NOUN,dobj,conj,PRP,NN,3,1
4328,56736.0,39,died,33,20,10,-10,19,28,13,-23,her,judge,PERSON,TITLE,PRON,NOUN,nsubj,attr,PRP,NN,6,1
4329,9761.0,33,said,12,14,18,4,13,14,-2,6,Morgenthau,88,PERSON,NUMBER,PROPN,NUM,nsubj,attr,NNP,CD,3,1
4330,9769.0,32,Council,2,1,8,7,0,23,1,6,National Security Council,Su Chi,ORGANIZATION-ORGANIZATION-ORGANIZATION,PERSON-PERSON,PROPN-PROPN-PROPN,PROPN-PROPN,compound-compound-ROOT,compound-nsubj,NNP-NNP-NNP,NNP-NNP,3,1
4331,9779.0,34,champions,3,17,30,13,16,3,-14,27,Jacksonville Jaguars,American Football Conference South,ORGANIZATION-ORGANIZATION,ORGANIZATION-ORGANIZATION-ORGANIZATION-ORGANIZATION,PROPN-PROPN,PROPN-PROPN-PROPN-PROPN,compound-pobj,compound-compound-compound-pobj,NNP-NNPS,NNP-NNP-NNP-NNP,10,1
4332,9789.0,52,died,37,1,51,50,0,0,36,14,Pamela Gardner Ahearn,Va,PERSON-PERSON-PERSON,STATE_OR_PROVINCE,PROPN-PROPN-PROPN,PROPN,compound-compound-nsubj,appos,NNP-NNP-NNP,NNP,2,1
4333,9793.0,42,said,35,37,39,2,36,2,-2,4,AAA,Robert L Darbelnet,ORGANIZATION,PERSON-PERSON-PERSON,PROPN,PROPN-PROPN-PROPN,compound,compound-compound-nsubj,NNP,NNP-NNP-NNP,3,1
4334,9794.0,24,retired,17,3,8,5,2,15,14,-9,he,New York State Supreme Court,PERSON,ORGANIZATION-ORGANIZATION-ORGANIZATION-ORGANIZATION-ORGANIZATION,PRON,PROPN-PROPN-PROPN-PROPN-PROPN,nsubjpass,compound-compound-compound-compound-pobj,PRP,NNP-NNP-NNP-NNP-NNP,5,1
4335,32595.0,24,retired,17,3,8,5,2,15,14,-9,he,New York State Supreme Court,PERSON,ORGANIZATION-ORGANIZATION-ORGANIZATION-ORGANIZATION-ORGANIZATION,PRON,PROPN-PROPN-PROPN-PROPN-PROPN,nsubj,compound-compound-compound-compound-pobj,PRP,NNP-NNP-NNP-NNP-NNP,5,1
4336,9796.0,45,ceasefire,4,19,14,-5,18,30,-15,10,JEM,Justice and Equality Movement,ORGANIZATION,ORGANIZATION-ORGANIZATION-ORGANIZATION-ORGANIZATION,PROPN,PROPN-CCONJ-PROPN-PROPN,compound,nmod-cc-conj-conj,NNP,NNP-CC-NNP-NNP,8,1
4337,10384.0,40,DOHA,0,20,15,-5,19,24,-20,15,JEM,Justice and Equality Movement,ORGANIZATION,ORGANIZATION-ORGANIZATION-ORGANIZATION-ORGANIZATION,PROPN,PROPN-CCONJ-PROPN-PROPN,compound,nmod-cc-conj-pobj,NNP,NNP-CC-NNP-NNP,6,1
4338,10988.0,35,said,1,17,12,-5,16,22,-16,11,JEM,Justice and Equality Movement,ORGANIZATION,ORGANIZATION-ORGANIZATION-ORGANIZATION-ORGANIZATION,PROPN,PROPN-CCONJ-PROPN-PROPN,compound,nmod-cc-conj-conj,NNP,NNP-CC-NNP-NNP,6,1
4339,27424.0,28,adopted,14,12,7,-5,11,20,2,-7,JEM,Justice and Equality Movement,ORGANIZATION,ORGANIZATION-ORGANIZATION-ORGANIZATION-ORGANIZATION,PROPN,PROPN-CCONJ-PROPN-PROPN,compound,nmod-cc-conj-pobj,NNP,NNP-CC-NNP-NNP,5,1
4340,36561.0,39,allowed,3,37,32,-5,36,6,-34,29,JEM,Justice and Equality Movement,ORGANIZATION,ORGANIZATION-ORGANIZATION-ORGANIZATION-ORGANIZATION,PROPN,PROPN-CCONJ-PROPN-PROPN,compound,nmod-cc-conj-appos,NNP,NNP-CC-NNP-NNP,9,1
4341,41583.0,33,clashed,5,16,11,-5,15,21,-11,6,JEM,Justice and Equality Movement,ORGANIZATION,ORGANIZATION-ORGANIZATION-ORGANIZATION-ORGANIZATION,PROPN,PROPN-CCONJ-PROPN-PROPN,compound,nmod-cc-conj-pobj,NNP,NNP-CC-NNP-NNP,7,1
4342,42125.0,70,sentenced,5,48,43,-5,47,26,-43,38,JEM,Justice and Equality Movement,ORGANIZATION,ORGANIZATION-ORGANIZATION-ORGANIZATION-ORGANIZATION,PROPN,PROPN-CCONJ-PROPN-PROPN,compound,nmod-cc-conj-pobj,NNP,NNP-CC-NNP-NNP,6,1
4343,48492.0,43,is,8,41,36,-5,40,6,-33,28,JEM,Justice and Equality Movement,ORGANIZATION,ORGANIZATION-ORGANIZATION-ORGANIZATION-ORGANIZATION,PROPN,PROPN-CCONJ-PROPN-PROPN,compound,nmod-cc-conj-pobj,NNP,NNP-CC-NNP-NNP,7,1
4344,50048.0,25,was,17,16,8,-8,15,16,1,-9,JEM,Justice and Equality Movement,ORGANIZATION,ORGANIZATION-ORGANIZATION-ORGANIZATION-ORGANIZATION,PROPN,PROPN-CCONJ-PROPN-PROPN,pobj,nmod-cc-conj-compound,NNP,NNP-CC-NNP-NNP,8,1
4345,55196.0,30,said,1,9,4,-5,8,25,-8,3,JEM,Justice and Equality Movement,ORGANIZATION,ORGANIZATION-ORGANIZATION-ORGANIZATION-ORGANIZATION,PROPN,PROPN-CCONJ-PROPN-PROPN,compound,nmod-cc-conj-nsubjpass,NNP,NNP-CC-NNP-NNP,3,1
4346,66212.0,45,sentences,1,40,35,-5,39,9,-39,34,JEM,Justice and Equality Movement,ORGANIZATION,ORGANIZATION-ORGANIZATION-ORGANIZATION-ORGANIZATION,PROPN,PROPN-CCONJ-PROPN-PROPN,compound,nmod-cc-conj-pobj,NNP,NNP-CC-NNP-NNP,10,1
4347,68106.0,29,added,3,27,22,-5,26,6,-24,19,JEM,Justice and Equality Movement,ORGANIZATION,ORGANIZATION-ORGANIZATION-ORGANIZATION-ORGANIZATION,PROPN,PROPN-CCONJ-PROPN-PROPN,compound,nmod-cc-conj-pobj,NNP,NNP-CC-NNP-NNP,9,1
4348,9798.0,25,was,5,1,4,3,0,20,4,-1,Burke,Melissa Bell,PERSON,PERSON-PERSON,PROPN,PROPN-PROPN,poss,compound-appos,NNP,NNP-NNP,3,1
4349,9799.0,38,said,20,37,28,-9,36,9,-17,8,Taipei,Manila Economic and Cultural Office,ORGANIZATION,CITY-CITY-CITY-CITY-CITY,PROPN,PROPN-PROPN-CCONJ-PROPN-PROPN,pobj,nmod-nmod-cc-conj-pobj,NNP,NNP-NNP-CC-NNP-NNP,-1,1
4350,9800.0,45,initiated,17,5,1,-4,4,43,12,-16,ConAgra,US,ORGANIZATION,COUNTRY,PROPN,PROPN,nsubj,nmod,NNP,NNP,3,1
4351,57202.0,13,finds,1,12,11,-1,11,1,-11,10,ConAgra,US,ORGANIZATION,COUNTRY,PROPN,PROPN,compound,compound,NNP,NNP,1,1
4352,58091.0,21,named,5,3,8,5,2,12,2,3,ConAgra,US,ORGANIZATION,COUNTRY,PROPN,PROPN,compound,compound,NNP,NNP,3,1
4353,9801.0,38,died,33,9,8,-1,8,29,24,-25,Jane Bolin,98,PERSON-PERSON,NUMBER,PROPN-PROPN,NUM,compound-pobj,nummod,NNP-NNP,CD,1,1
4354,29140.0,30,died,25,1,29,28,0,0,24,4,Jane Bolin,98,PERSON-PERSON,NUMBER,PROPN-PROPN,NUM,compound-nsubj,nummod,NNP-NNP,CD,2,1
4355,9815.0,49,said,7,21,11,-10,20,37,-14,4,he,Minister Sultan,PERSON,TITLE-TITLE,PRON,PROPN-PROPN,nsubj,compound-compound,PRP,NNP-NNP,5,1
4356,11370.0,49,said,7,21,11,-10,20,37,-14,4,he,Minister Sultan,PERSON,TITLE-TITLE,PRON,PROPN-PROPN,nsubj,compound-compound,PRP,NNP-NNP,5,1
4357,9816.0,28,made,6,1,3,2,0,24,5,-3,The,singer,PERSON,TITLE,DET,NOUN,det,nsubj,DT,NN,1,1
4358,9817.0,17,about,1,6,17,11,5,-1,-5,16,American Psychological Association,http://www.apa.org/journals/releases/amp60146.pdf,ORGANIZATION-ORGANIZATION-ORGANIZATION,URL,PROPN-PROPN-PROPN,NUM,compound-compound-nsubj,pobj,NNP-NNP-NNP,CD,-1,1
4359,9821.0,32,said,30,25,20,-5,24,11,5,-10,FAW Group Corp,China,ORGANIZATION-ORGANIZATION-ORGANIZATION,COUNTRY,PROPN-PROPN-PROPN,PROPN,compound-compound-appos,poss,NNP-NNP-NNP,NNP,4,1
4360,9828.0,23,Library,4,3,12,9,2,10,1,8,Chelsea District Library,MI,ORGANIZATION-ORGANIZATION-ORGANIZATION,STATE_OR_PROVINCE,PROPN-PROPN-PROPN,PROPN,compound-nmod-ROOT,appos,NNP-NNP-NNP,NNP,3,1
4361,9837.0,27,TV-IDOL-JOHNS,0,21,6,-15,20,20,-21,6,his,American,PERSON,NATIONALITY,DET,PROPN,poss,compound,PRP$,NNP,-1,1
4362,55401.0,18,is,2,12,5,-7,11,12,-10,3,his,American,PERSON,NATIONALITY,DET,ADJ,poss,amod,PRP$,JJ,4,1
4363,9840.0,20,said,13,18,15,-3,17,4,-5,2,Herb Gibson,OSHA,PERSON-PERSON,ORGANIZATION,PROPN-PROPN,PROPN,compound-nsubj,compound,NNP-NNP,NNP,4,1
4364,23030.0,33,said,11,9,7,-2,8,25,2,-4,Herb Gibson,OSHA,PERSON-PERSON,ORGANIZATION,PROPN-PROPN,PROPN,compound-appos,pobj,NNP-NNP,NNP,2,1
4365,64392.0,55,said,44,46,2,-44,45,52,-2,-42,Herb Gibson,OSHA,PERSON-PERSON,ORGANIZATION,PROPN-PROPN,PROPN,compound-nsubj,poss,NNP-NNP,NNP,2,1
4366,9842.0,28,died,26,1,5,4,0,22,25,-21,Bradford Washburn,Boston Museum of Science,PERSON-PERSON,ORGANIZATION-ORGANIZATION-ORGANIZATION-ORGANIZATION,PROPN-PROPN,PROPN-PROPN-ADP-PROPN,compound-nsubj,compound-appos-prep-poss,NNP-NNP,NNP-NNP-IN-NNP,1,1
4367,50386.0,35,Washburn,2,2,10,8,1,24,0,8,Bradford Washburn,Boston Museum of Science,PERSON-PERSON,ORGANIZATION-ORGANIZATION-ORGANIZATION-ORGANIZATION,PROPN-PROPN,PROPN-PROPN-ADP-PROPN,compound-ROOT,compound-dobj-prep-pobj,NNP-NNP,NNP-NNP-IN-NNP,2,1
4368,9857.0,30,sent,16,1,8,7,0,21,15,-8,Raul Castro,Central Committee,PERSON-PERSON,ORGANIZATION-ORGANIZATION,PROPN-PROPN,PROPN-PROPN,compound-nsubj,compound-pobj,NNP-NNP,NNP-NNP,3,1
4369,9875.0,27,said,5,11,1,-10,10,25,-6,-4,his,Myanmar,PERSON,NATIONALITY,DET,PROPN,poss,compound,PRP$,NNP,6,1
4370,9877.0,21,signed,7,1,4,3,0,16,6,-3,Jacksonville Jaguars,Jack Del Rio,ORGANIZATION-ORGANIZATION,PERSON-PERSON-PERSON,PROPN-PROPN,PROPN-PROPN-PROPN,compound-compound,compound-compound-nsubj,NNP-NNP,NNP-NNP-NNP,3,1
4371,35990.0,30,rejoined,3,6,15,9,5,14,-3,12,Jacksonville Jaguars,Jack Del Rio,ORGANIZATION-ORGANIZATION,PERSON-PERSON-PERSON,PROPN-PROPN,PROPN-PROPN-PROPN,compound-dobj,compound-compound-nsubj,NNP-NNPS,NNP-NNP-NNP,4,1
4372,9890.0,46,founded,3,20,29,9,19,16,-17,26,Zagat,friends,ORGANIZATION,PERSON,PROPN,NOUN,conj,dobj,NNP,NNS,5,1
4373,9892.0,44,tried,3,9,28,19,8,15,-6,25,MNLF,Muslim,ORGANIZATION,RELIGION,PROPN,ADJ,dobj,amod,NNP,JJ,7,1
4374,11529.0,23,signed,1,8,21,13,7,1,-7,20,MNLF,Muslim,ORGANIZATION,RELIGION,PROPN,ADJ,pobj,amod,NNP,JJ,7,1
4375,14010.0,31,was,2,2,6,4,1,24,0,4,MNLF,Muslim,ORGANIZATION,RELIGION,PROPN,ADJ,nsubj,amod,NNP,JJ,2,1
4376,38140.0,25,said,2,14,22,8,13,2,-12,20,MNLF,Muslim,ORGANIZATION,RELIGION,PROPN,ADJ,compound,amod,NNP,JJ,2,1
4377,39839.0,32,agreed,7,7,25,18,6,6,0,18,MNLF,Muslim,ORGANIZATION,RELIGION,PROPN,ADJ,nsubj,amod,NNP,JJ,8,1
4378,9897.0,52,wanted,11,44,46,2,43,5,-33,35,Wuorinen,70,PERSON,NUMBER,PROPN,NUM,nsubj,appos,NNP,CD,1,1
4379,9909.0,38,starlet,9,30,12,-18,29,25,-21,3,"Spencer Pratt ,",Holly Montag,PERSON-PERSON-PERSON,PERSON-PERSON,PROPN-PROPN-PUNCT,PROPN-PROPN,compound-conj-punct,compound-npadvmod,"NNP-NNP-,",NNP-NNP,5,1
4380,9912.0,26,follows,3,7,19,12,6,6,-4,16,Kate Gosselin,twins,PERSON-PERSON,ORGANIZATION,PROPN-PROPN,NOUN,compound-conj,pobj,NNP-NNP,NNS,8,1
4381,9936.0,35,moved,9,19,7,-12,18,27,-10,-2,BNC Mortgage,August,ORGANIZATION-ORGANIZATION,DATE,PROPN-PROPN,PROPN,compound-dobj,pobj,NNP-NNP,NNP,4,1
4382,9951.0,40,set,18,2,22,20,1,17,16,4,Scorpions,1999,ORGANIZATION,DATE,PROPN,NUM,nsubjpass,pobj,NNPS,CD,4,1
4383,15110.0,27,decide,11,17,21,4,16,5,-6,10,Scorpions,1999,ORGANIZATION,DATE,PROPN,NUM,dobj,pobj,NNPS,CD,3,1
4384,9960.0,41,started,16,11,15,4,10,25,5,-1,FirstGroup,Scotland,ORGANIZATION,COUNTRY,PROPN,PROPN,dobj,pobj,NNP,NNP,3,1
4385,28468.0,23,acquired,10,13,15,2,12,7,-3,5,FirstGroup,Scotland,ORGANIZATION,COUNTRY,PROPN,PROPN,pobj,pobj,NNP,NNP,2,1
4386,9962.0,31,means,9,1,30,29,0,0,8,21,Vernon Bellecourt,Minnesota,PERSON-PERSON,STATE_OR_PROVINCE,PROPN-PROPN,PROPN,compound-nsubj,pobj,NNP-NNP,NNP,4,1
4387,9979.0,49,said,47,45,15,-30,44,33,2,-32,Chunghwa Telecom Corp.,Canada,ORGANIZATION-ORGANIZATION-ORGANIZATION,COUNTRY,PROPN-PROPN-PROPN,PROPN,compound-compound-pobj,conj,NNP-NNP-NNP,NNP,6,1
4388,9983.0,19,survived,7,10,1,-9,9,17,-3,-6,her,Roraback,PERSON,PERSON,DET,PROPN,poss,nsubjpass,PRP$,NNP,4,1
4389,10014.0,29,born,4,1,13,12,0,15,3,9,Philip Mayer Kaiser,"July 12 , 1913",PERSON-PERSON-PERSON,DATE-DATE-DATE-DATE,PROPN-PROPN-PROPN,PROPN-NUM-PUNCT-NUM,compound-compound-nsubjpass,pobj-nummod-punct-nummod,NNP-NNP-NNP,"NNP-CD-,-CD",6,1
4390,27974.0,34,born,4,1,12,11,0,21,3,8,Philip Mayer Kaiser,"July 12 , 1913",PERSON-PERSON-PERSON,DATE-DATE-DATE-DATE,PROPN-PROPN-PROPN,PROPN-NUM-PUNCT-NUM,compound-compound-nsubjpass,pobj-nummod-punct-nummod,NNP-NNP-NNP,"NNP-CD-,-CD",6,1
4391,10021.0,33,provide,14,5,10,5,4,22,9,-4,Asian Development Bank,Inter-American Development Bank,ORGANIZATION-ORGANIZATION-ORGANIZATION,ORGANIZATION-ORGANIZATION-ORGANIZATION,PROPN-PROPN-PROPN,ADJ-PROPN-PROPN,compound-compound-pobj,amod-compound-appos,NNP-NNP-NNP,JJ-NNP-NNP,5,1
4392,10022.0,68,decided,7,11,59,48,10,8,-4,52,Lee,President,PERSON,TITLE,PROPN,PROPN,poss,pobj,NNP,NNP,16,1
4393,10025.0,25,elected,19,1,11,10,0,13,18,-8,Gillmor,Bowling Green,PERSON,CITY-CITY,PROPN,PROPN-PROPN,nsubjpass,compound-compound,NNP,NNP-NNP,6,1
4394,10027.0,23,worked,1,3,6,3,2,16,-2,5,his,New York University,PERSON,ORGANIZATION-ORGANIZATION-ORGANIZATION,DET,PROPN-PROPN-PROPN,poss,compound-compound-pobj,PRP$,NNP-NNP-NNP,4,1
4395,10028.0,24,returned,20,6,14,8,5,9,14,-6,MBIA,Armonk,ORGANIZATION,LOCATION,PROPN,PROPN,compound,pobj,NNP,NNP,7,1
4396,10029.0,50,acts,9,35,40,5,34,9,-26,31,Trista Rehn,Bachelorette,PERSON-PERSON,ORGANIZATION,PROPN-PROPN,PROPN,compound-conj,pobj,NNP-NNP,NNP,4,1
4397,52956.0,39,scroll,29,26,24,-2,25,14,3,-5,Trista Rehn,Bachelorette,PERSON-PERSON,TITLE,PROPN-PROPN,PROPN,compound-conj,nmod,NNP-NNP,NNP,2,1
4398,10045.0,42,are,10,39,31,-8,38,10,-29,21,International Monetary Fund,Rodrigo Rato,ORGANIZATION-ORGANIZATION-ORGANIZATION,PERSON-PERSON,PROPN-PROPN-PROPN,PROPN-PROPN,compound-compound-pobj,compound-conj,NNP-NNP-NNP,NNP-NNP,4,1
4399,47586.0,31,said,7,1,6,5,0,24,6,-1,International Monetary Fund,Rodrigo Rato,ORGANIZATION-ORGANIZATION-ORGANIZATION,PERSON-PERSON,PROPN-PROPN-PROPN,PROPN-PROPN,compound-compound-compound,compound-nsubj,NNP-NNP-NNP,NNP-NNP,3,1
4400,53346.0,26,said,6,1,5,4,0,20,5,-1,International Monetary Fund,Rodrigo Rato,ORGANIZATION-ORGANIZATION-ORGANIZATION,PERSON-PERSON,PROPN-PROPN-PROPN,PROPN-PROPN,compound-compound-compound,compound-nsubj,NNP-NNP-NNP,NNP-NNP,3,1
4401,10049.0,26,added,15,4,10,6,3,15,11,-5,Covidien,Tyco International Inc.,ORGANIZATION,ORGANIZATION-ORGANIZATION-ORGANIZATION,PROPN,PROPN-PROPN-PROPN,pobj,compound-compound-pobj,NNP,NNP-NNP-NNP,5,1
4402,10056.0,46,said,17,19,23,4,18,22,-2,6,Arsenal,Ivan Gazidis,ORGANIZATION,PERSON-PERSON,PROPN,PROPN-PROPN,poss,compound-appos,NNP,NNP-NNP,3,1
4403,18865.0,45,LONDON,0,10,15,5,9,29,-10,15,Arsenal,Ivan Gazidis,ORGANIZATION,PERSON-PERSON,PROPN,PROPN-PROPN,poss,compound-appos,NNP,NNP-NNP,3,1
4404,23748.0,29,announced,26,18,1,-17,17,27,8,-25,Arsenal,Ivan Gazidis,ORGANIZATION,PERSON-PERSON,PROPN,PROPN-PROPN,pobj,compound-nsubjpass,NNP,NNP-NNP,6,1
4405,10058.0,29,before,1,17,26,9,16,2,-16,25,his,University of Pennsylvania,PERSON,ORGANIZATION-ORGANIZATION-ORGANIZATION,DET,PROPN-ADP-PROPN,poss,pobj-prep-pobj,PRP$,NNP-IN-NNP,8,1
4406,28244.0,27,finished,5,7,12,5,6,14,-2,7,his,University of Pennsylvania,PERSON,ORGANIZATION-ORGANIZATION-ORGANIZATION,DET,PROPN-ADP-PROPN,poss,pobj-prep-pobj,PRP$,NNP-IN-NNP,4,1
4407,50234.0,27,finished,5,7,12,5,6,14,-2,7,his,University of Pennsylvania,PERSON,ORGANIZATION-ORGANIZATION-ORGANIZATION,DET,PROPN-ADP-PROPN,poss,pobj-prep-pobj,PRP$,NNP-IN-NNP,4,1
4408,10059.0,25,said,12,1,7,6,0,17,11,-5,Sean Parker,executive,PERSON-PERSON,TITLE,PROPN-PROPN,NOUN,compound-nsubj,appos,NNP-NNP,NN,3,1
4409,53040.0,32,said,14,16,26,10,15,5,-2,12,Sean Parker,executive,PERSON-PERSON,TITLE,PROPN-PROPN,NOUN,compound-nsubj,conj,NNP-NNP,NN,3,1
4410,10066.0,17,deserves,2,1,7,6,0,9,1,5,Ezra Levant,Canada,PERSON-PERSON,COUNTRY,PROPN-PROPN,PROPN,compound-nsubj,pobj,NNP-NNP,NNP,2,1
4411,10070.0,17,graduated,1,1,15,14,0,1,0,14,He,Air Force,PERSON,ORGANIZATION-ORGANIZATION,PRON,PROPN-PROPN,nsubj,compound-pobj,PRP,NNP-NNP,3,1
4412,10094.0,36,said,25,31,27,-4,30,8,-6,2,ABA,Susan Neely,ORGANIZATION,PERSON-PERSON,PROPN,PROPN-PROPN,poss,compound-nsubj,NNP,NNP-NNP,3,1
4413,44027.0,44,said,37,42,39,-3,41,4,-5,2,ABA,Susan Neely,ORGANIZATION,PERSON-PERSON,PROPN,PROPN-PROPN,compound,compound-nsubj,NNP,NNP-NNP,3,1
4414,10095.0,26,born,4,1,21,20,0,4,3,17,Joseph Simpson Farland,Richard and Grace Simpson Farland,PERSON-PERSON-PERSON,PERSON-PERSON-PERSON-PERSON-PERSON,PROPN-PROPN-PROPN,PROPN-CCONJ-PROPN-PROPN-PROPN,compound-compound-nsubjpass,pobj-cc-compound-compound-conj,NNP-NNP-NNP,NNP-CC-NNP-NNP-NNP,8,1
4415,10099.0,49,received,6,6,12,6,5,36,0,6,DeBlanc,Southwestern Louisiana Institute,PERSON,ORGANIZATION-ORGANIZATION-ORGANIZATION,PROPN,PROPN-PROPN-PROPN,nsubj,compound-compound-pobj,NNP,NNP-NNP-NNP,5,1
4416,10105.0,27,survived,2,8,5,-3,7,21,-6,3,Brenda Morgan Bacquie,her,PERSON-PERSON-PERSON,PERSON,PROPN-PROPN-PROPN,DET,compound-compound-appos,poss,NNP-NNP-NNP,PRP$,2,1
4417,10106.0,41,described,32,12,13,1,11,27,20,-19,Dan Abrams,Abrams,PERSON-PERSON,PERSON,PROPN-PROPN,PROPN,compound-pobj,poss,NNP-NNP,NNP,1,1
4418,10125.0,34,2-3,1,4,12,8,3,21,-3,11,Augustus F. Hawkins,California,PERSON-PERSON-PERSON,STATE_OR_PROVINCE,PROPN-PROPN-PROPN,PROPN,compound-compound-nsubj,pobj,NNP-NNP-NNP,NNP,4,1
4419,21502.0,30,died,28,1,10,9,0,19,27,-18,Augustus F. Hawkins,California,PERSON-PERSON-PERSON,STATE_OR_PROVINCE,PROPN-PROPN-PROPN,PROPN,compound-compound-nsubj,pobj,NNP-NNP-NNP,NNP,4,1
4420,41878.0,47,died,40,1,7,6,0,39,39,-33,Augustus F. Hawkins,California,PERSON-PERSON-PERSON,STATE_OR_PROVINCE,PROPN-PROPN-PROPN,PROPN,compound-compound-nsubj,poss,NNP-NNP-NNP,NNP,5,1
4421,10127.0,85,plan,16,28,7,-21,27,77,-12,-9,Hindalco Industries,1-India,ORGANIZATION-ORGANIZATION,COUNTRY,PROPN-PROPN,NOUN,compound-compound,compound,NNP-NNPS,NNS,6,1
4422,10144.0,27,was,2,1,5,4,0,21,1,3,Yolanda King,founder,PERSON-PERSON,TITLE,PROPN-PROPN,NOUN,compound-nsubj,attr,NNP-NNP,NN,3,1
4423,65006.0,31,ATLANTA,0,5,9,4,4,21,-5,9,Yolanda King,founder,PERSON-PERSON,TITLE,PROPN-PROPN,NOUN,compound-nsubj,attr,NNP-NNP,NN,4,1
4424,10150.0,47,returning,22,25,28,3,24,18,-3,6,her,Baltimore,PERSON,CITY,DET,PROPN,poss,pobj,PRP$,NNP,3,1
4425,50778.0,27,pronounced,3,22,10,-12,21,16,-19,7,her,Baltimore,PERSON,CITY,PRON,PROPN,poss,pobj,PRP,NNP,5,1
4426,10158.0,16,gon,2,13,12,-1,12,3,-11,10,John Wuorinen,Sgt.,PERSON-PERSON,TITLE,PROPN-PROPN,PROPN,compound-nsubj,compound,NNP-NNP,NNP,2,1
4427,10175.0,22,said,1,8,10,2,7,11,-7,9,Sox,Haywood Sullivan,ORGANIZATION,PERSON-PERSON,PROPN,PROPN-PROPN,compound,compound-nsubj,NNP,NNP-NNP,1,1
4428,10183.0,60,survived,2,1,35,34,0,24,1,33,He,Corinne Godshall,PERSON,PERSON-PERSON,PRON,PROPN-PROPN,nsubjpass,compound-conj,PRP,NNP-NNP,7,1
4429,10185.0,41,served,2,1,13,12,0,27,1,11,Hubbard,Atlantic Economic Council,PERSON,ORGANIZATION-ORGANIZATION-ORGANIZATION,PROPN,PROPN-PROPN-PROPN,nsubj,compound-compound-pobj,NNP,NNP-NNP-NNP,6,1
4430,10195.0,17,http://oxfordjournals-marketing.oup.com/c/1rNnI5119X8db2X,3,14,4,-10,13,12,-11,1,Oxford Journals,http://oxfordjournals-marketing.oup.com/c/1rNnI5119X8db2X,ORGANIZATION-ORGANIZATION,URL,PROPN-PROPN,PROPN,compound-nsubj,ROOT,NNP-NNP,NNP,-1,1
4431,10197.0,18,rest,3,15,14,-1,14,3,-12,11,Ayatollah Ali Khamenei,Leader,PERSON-PERSON-PERSON,TITLE,PROPN-PROPN-PROPN,PROPN,compound-compound-pobj,compound,NNP-NNP-NNP,NNP,2,1
4432,19358.0,38,appointed,8,5,4,-1,4,33,3,-4,Ayatollah Ali Khamenei,Leader,PERSON-PERSON-PERSON,TITLE,PROPN-PROPN-PROPN,PROPN,compound-compound-nsubj,compound,NNP-NNP-NNP,NNP,2,1
4433,30328.0,35,called,28,25,24,-1,24,10,3,-4,Ayatollah Ali Khamenei,Leader,PERSON-PERSON-PERSON,TITLE,PROPN-PROPN-PROPN,PROPN,compound-compound-pobj,compound,NNP-NNP-NNP,NNP,2,1
4434,33454.0,28,showed,1,20,19,-1,19,8,-19,18,Ayatollah Ali Khamenei,Leader,PERSON-PERSON-PERSON,TITLE,PROPN-PROPN-PROPN,PROPN,compound-compound-pobj,compound,NNP-NNP-NNP,NNP,2,1
4435,57387.0,32,was,20,29,28,-1,28,3,-9,8,Ayatollah Ali Khamenei,Leader,PERSON-PERSON-PERSON,TITLE,PROPN-PROPN-PROPN,PROPN,compound-compound-pobj,compound,NNP-NNP-NNP,NNP,1,1
4436,60796.0,32,said,17,11,10,-1,10,21,6,-7,Ayatollah Ali Khamenei,Leader,PERSON-PERSON-PERSON,TITLE,PROPN-PROPN-PROPN,PROPN,compound-compound-pobj,compound,NNP-NNP-NNP,NNP,2,1
4437,10202.0,45,said,28,41,31,-10,40,13,-13,3,National Republican Campaign Committee,New York,ORGANIZATION-ORGANIZATION-ORGANIZATION-ORGANIZATION,STATE_OR_PROVINCE-STATE_OR_PROVINCE,PROPN-PROPN-PROPN-PROPN,PROPN-PROPN,compound-compound-compound-pobj,compound-poss,NNP-NNP-NNP-NNP,NNP-NNP,3,1
4438,10211.0,26,is,1,22,12,-10,21,13,-21,11,David Banda,Lourdes,PERSON-PERSON,PERSON,PROPN-PROPN,PROPN,compound-dobj,appos,NNP-NNP,NNP,9,1
4439,10216.0,35,introduced,4,3,1,-2,2,33,1,-3,Carolyn Maloney,US Congress,PERSON-PERSON,ORGANIZATION-ORGANIZATION,PROPN-PROPN,PROPN-PROPN,compound-nsubj,compound-pobj,NNP-NNP,NNP-NNP,1,1
4440,10224.0,35,rejected,4,15,1,-14,14,33,-11,-3,CNAC,China National Aviation Corp,ORGANIZATION,ORGANIZATION-ORGANIZATION-ORGANIZATION-ORGANIZATION,PROPN,PROPN-PROPN-PROPN-PROPN,compound,compound-compound-compound-compound,NNP,NNP-NNP-NNP-NNP,3,1
4441,14002.0,24,studying,5,15,2,-13,14,21,-10,-3,CNAC,China National Aviation Corp,ORGANIZATION,ORGANIZATION-ORGANIZATION-ORGANIZATION-ORGANIZATION,PROPN,PROPN-PROPN-PROPN-PROPN,compound,compound-compound-compound-compound,NNP,NNP-NNP-NNP-NNP,3,1
4442,14561.0,39,said,2,19,14,-5,18,24,-17,12,CNAC,China National Aviation Corp,ORGANIZATION,ORGANIZATION-ORGANIZATION-ORGANIZATION-ORGANIZATION,PROPN,PROPN-PROPN-PROPN-PROPN,compound,compound-compound-compound-compound,NNP,NNP-NNP-NNP-NNP,7,1
4443,18367.0,44,said,11,21,16,-5,20,27,-10,5,CNAC,China National Aviation Corp,ORGANIZATION,ORGANIZATION-ORGANIZATION-ORGANIZATION-ORGANIZATION,PROPN,PROPN-PROPN-PROPN-PROPN,compound,compound-compound-compound-compound,NNP,NNP-NNP-NNP-NNP,3,1
4444,26959.0,40,said,4,17,12,-5,16,27,-13,8,CNAC,China National Aviation Corp,ORGANIZATION,ORGANIZATION-ORGANIZATION-ORGANIZATION-ORGANIZATION,PROPN,PROPN-PROPN-PROPN-PROPN,compound,compound-compound-compound-compound,NNP,NNP-NNP-NNP-NNP,2,1
4445,46651.0,39,fell,4,31,1,-30,30,37,-27,-3,CNAC,China National Aviation Corp,ORGANIZATION,ORGANIZATION-ORGANIZATION-ORGANIZATION-ORGANIZATION,PROPN,PROPN-PROPN-PROPN-PROPN,compound,compound-compound-compound-compound,NNP,NNP-NNP-NNP-NNP,4,1
4446,59989.0,51,thrown,4,14,9,-5,13,41,-10,5,CNAC,China National Aviation Corp,ORGANIZATION,ORGANIZATION-ORGANIZATION-ORGANIZATION-ORGANIZATION,PROPN,PROPN-PROPN-PROPN-PROPN,compound,compound-compound-compound-compound,NNP,NNP-NNP-NNP-NNP,4,1
4447,10230.0,40,said,28,6,1,-5,5,38,22,-27,Czech National Bank,Tosovsky,ORGANIZATION-ORGANIZATION-ORGANIZATION,PERSON,PROPN-PROPN-PROPN,PROPN,compound-compound-dobj,nsubj,NNP-NNP-NNP,NNP,4,1
4448,10232.0,39,via,0,8,11,3,7,27,-8,11,Trista Rehn,physical therapist,PERSON-PERSON,TITLE-TITLE,PROPN-PROPN,ADJ-NOUN,compound-nsubj,amod-appos,NNP-NNP,JJ-NN,1,1
4449,10233.0,36,created,13,12,18,6,11,17,1,5,Parker,Facebook,PERSON,ORGANIZATION,PROPN,PROPN,conj,compound,NNP,NNP,5,1
4450,10239.0,19,shot,3,17,14,-3,16,4,-14,11,Brandon McInerney,14,PERSON-PERSON,NUMBER,PROPN-PROPN,NUM,compound-appos,nummod,NNP-NNP,CD,2,1
4451,10918.0,25,2008-10-03T00,0,12,16,4,11,8,-12,16,Brandon McInerney,14,PERSON-PERSON,NUMBER,PROPN-PROPN,NUM,compound-pobj,nummod,NNP-NNP,CD,4,1
4452,24078.0,32,say,30,8,11,3,7,20,22,-19,Brandon McInerney,14,PERSON-PERSON,NUMBER,PROPN-PROPN,NUM,compound-appos,appos,NNP-NNP,CD,3,1
4453,24183.0,32,say,30,8,11,3,7,20,22,-19,Brandon McInerney,14,PERSON-PERSON,NUMBER,PROPN-PROPN,NUM,compound-appos,appos,NNP-NNP,CD,5,1
4454,40983.0,21,told,2,4,7,3,3,13,-2,5,Brandon McInerney,14,PERSON-PERSON,NUMBER,PROPN-PROPN,NUM,compound-dobj,appos,NNP-NNP,CD,1,1
4455,48211.0,34,say,32,8,11,3,7,22,24,-21,Brandon McInerney,14,PERSON-PERSON,NUMBER,PROPN-PROPN,NUM,compound-appos,appos,NNP-NNP,CD,5,1
4456,52907.0,27,declared,6,17,15,-2,16,11,-11,9,Brandon McInerney,14,PERSON-PERSON,NUMBER,PROPN-PROPN,NUM,compound-compound,nummod,NNP-NNP,CD,1,1
4457,64637.0,21,charged,2,8,11,3,7,9,-6,9,Brandon McInerney,14,PERSON-PERSON,NUMBER,PROPN-PROPN,NUM,compound-oprd,appos,NNP-NNP,CD,2,1
4458,10245.0,15,was,1,1,14,13,0,0,0,13,Al-Moussawi,1992,PERSON,DATE,PROPN,NUM,nsubj,pobj,NNP,CD,4,1
4459,10247.0,22,is,7,15,12,-3,14,9,-8,5,Donald Wildmon,Christian,PERSON-PERSON,RELIGION,PROPN-PROPN,ADJ,compound-appos,amod,NNP-NNP,JJ,2,1
4460,19168.0,36,said,15,19,31,12,18,4,-4,16,Donald Wildmon,Christian,PERSON-PERSON,RELIGION,PROPN-PROPN,ADJ,compound-nsubj,amod,NNP-NNP,JJ,3,1
4461,38587.0,60,confesses,28,12,25,13,11,34,16,-3,Donald Wildmon,Christian,PERSON-PERSON,RELIGION,PROPN-PROPN,ADJ,compound-appos,amod,NNP-NNP,JJ,2,1
4462,10270.0,23,came,12,21,2,-19,20,20,-9,-10,Abbas Musawi,"1992 attack on the Israeli Embassy , which killed 29 , came a month after Israel assassinated",PERSON-PERSON,CAUSE_OF_DEATH-CAUSE_OF_DEATH-CAUSE_OF_DEATH-CAUSE_OF_DEATH-CAUSE_OF_DEATH-CAUSE_OF_DEATH-CAUSE_OF_DEATH-CAUSE_OF_DEATH-CAUSE_OF_DEATH-CAUSE_OF_DEATH-CAUSE_OF_DEATH-CAUSE_OF_DEATH-CAUSE_OF_DEATH-CAUSE_OF_DEATH-CAUSE_OF_DEATH-CAUSE_OF_DEATH-CAUSE_OF_DEATH,PROPN-PROPN,NUM-NOUN-ADP-DET-ADJ-PROPN-PUNCT-DET-VERB-NUM-PUNCT-VERB-DET-NOUN-ADP-PROPN-VERB,compound-dobj,nummod-nsubj-prep-det-compound-pobj-punct-nsubj-relcl-dobj-punct-ROOT-det-npadvmod-mark-nsubj-advcl,NNP-NNP,"CD-NN-IN-DT-JJ-NNP-,-WDT-VBD-CD-,-VBD-DT-NN-IN-NNP-VBD",3,1
4463,10271.0,21,said,18,17,14,-3,16,6,1,-4,William Anderson,Greenville,PERSON-PERSON,CITY,PROPN-PROPN,PROPN,compound-nsubj,compound,NNP-NNP,NNP,3,1
4464,10272.0,37,said,27,35,29,-6,34,7,-8,2,Citibank,Cheng-Mount Cheng,ORGANIZATION,PERSON-PERSON,PROPN,PROPN-PROPN,compound,compound-nsubj,NNP,NNP-NNP,3,1
4465,10277.0,47,look,2,31,7,-24,30,39,-29,5,her,Congress,PERSON,ORGANIZATION,DET,PROPN,poss,pobj,PRP$,NNP,5,1
4466,10304.0,47,makes,40,6,35,29,5,11,34,-5,she,Facebook,PERSON,ORGANIZATION,PRON,PROPN,nsubj,pobj,PRP,NNP,4,1
4467,10307.0,33,aims,16,9,3,-6,8,29,7,-13,Noordhoff,1989,ORGANIZATION,DATE,PROPN,NUM,pobj,pobj,NNP,CD,4,1
4468,10317.0,43,killed,8,31,17,-14,30,25,-23,9,Badr Organization,Basra,ORGANIZATION-ORGANIZATION,LOCATION,PROPN-PROPN,PROPN,compound-pobj,pobj,NNP-NNP,NNP,6,1
4469,10326.0,25,finds,20,16,13,-3,15,11,4,-7,Federal Election Commission,Boston,ORGANIZATION-ORGANIZATION-ORGANIZATION,CITY,PROPN-PROPN-PROPN,PROPN,compound-compound-pobj,pobj,NNP-NNP-NNP,NNP,2,1
4470,10328.0,40,blasted,14,12,28,16,11,11,2,14,Ayatollah Ali Khamenei,Muslim,PERSON-PERSON-PERSON,RELIGION,PROPN-PROPN-PROPN,ADJ,compound-compound-nsubj,nmod,NNP-NNP-NNP,JJ,7,1
4471,57525.0,33,condemned,9,5,23,18,4,9,4,14,Ayatollah Ali Khamenei,Muslim,PERSON-PERSON-PERSON,RELIGION,PROPN-PROPN-PROPN,ADJ,compound-compound-appos,amod,NNP-NNP-NNP,JJ,5,1
4472,10330.0,20,considered,13,1,5,4,0,14,12,-8,Wildmon,minister,PERSON,TITLE,PROPN,NOUN,nsubj,appos,NNP,NN,3,1
4473,10332.0,48,divided,1,24,13,-11,23,34,-23,12,TACC,International Atomic Energy Agency,ORGANIZATION,ORGANIZATION-ORGANIZATION-ORGANIZATION-ORGANIZATION,PROPN,PROPN-PROPN-PROPN-PROPN,compound,compound-compound-compound-poss,NNP,NNP-NNP-NNP-NNP,-1,1
4474,26870.0,29,Committee,10,13,2,-11,12,26,-3,-8,TACC,International Atomic Energy Agency,ORGANIZATION,ORGANIZATION-ORGANIZATION-ORGANIZATION-ORGANIZATION,PROPN,PROPN-PROPN-PROPN-PROPN,compound,compound-compound-compound-poss,NNP,NNP-NNP-NNP-NNP,6,1
4475,10334.0,27,became,2,1,19,18,0,7,1,17,She,National Commission on Teaching and America 's Future,PERSON,ORGANIZATION-ORGANIZATION-ORGANIZATION-ORGANIZATION-ORGANIZATION-ORGANIZATION-ORGANIZATION-ORGANIZATION,PRON,PROPN-PROPN-ADP-PROPN-CCONJ-PROPN-PART-PROPN,nsubj,compound-pobj-prep-pobj-cc-poss-case-conj,PRP,NNP-NNP-IN-NNP-CC-NNP-POS-NNP,4,1
4476,10336.0,31,evacuated,15,7,7,0,6,23,8,-8,Haifa University,Haifa,ORGANIZATION-ORGANIZATION,CITY,PROPN-PROPN,PROPN,compound-pobj,pobj,NNP-NNP,NNP,0,1
4477,39877.0,24,evacuated,8,7,7,0,6,16,1,-1,Haifa University,Haifa,ORGANIZATION-ORGANIZATION,CITY,PROPN-PROPN,PROPN,compound-pobj,pobj,NNP-NNP,NNP,0,1
4478,10338.0,37,parties,3,15,19,4,14,17,-12,16,United National Congress,UNC,ORGANIZATION-ORGANIZATION-ORGANIZATION,ORGANIZATION,PROPN-PROPN-PROPN,PROPN,compound-compound-appos,compound,NNP-NNP-NNP,NNP,4,1
4479,23368.0,26,watching,2,14,18,4,13,7,-12,16,United National Congress,UNC,ORGANIZATION-ORGANIZATION-ORGANIZATION,ORGANIZATION,PROPN-PROPN-PROPN,PROPN,compound-compound-pobj,compound,NNP-NNP-NNP,NNP,5,1
4480,28320.0,58,said,23,41,46,5,40,11,-18,23,United National Congress,UNC,ORGANIZATION-ORGANIZATION-ORGANIZATION,ORGANIZATION,PROPN-PROPN-PROPN,PROPN,compound-compound-compound,compound,NNP-NNP-NNP,NNP,-1,1
4481,37699.0,38,has,3,26,30,4,25,7,-23,27,United National Congress,UNC,ORGANIZATION-ORGANIZATION-ORGANIZATION,ORGANIZATION,PROPN-PROPN-PROPN,PROPN,compound-compound-conj,compound,NNP-NNP-NNP,NNP,6,1
4482,10340.0,54,survived,2,29,33,4,28,20,-27,31,David Kaiser,professor,PERSON-PERSON,TITLE,PROPN-PROPN,NOUN,compound-appos,appos,NNP-NNP,NN,2,1
4483,10345.0,32,said,29,13,2,-11,12,29,16,-27,Mohamed ElBaradei,chief,PERSON-PERSON,TITLE,PROPN-PROPN,NOUN,compound-appos,nsubj,NNP-NNP,NN,3,1
4484,15453.0,37,told,34,4,3,-1,3,33,30,-31,Mohamed ElBaradei,chief,PERSON-PERSON,TITLE,PROPN-PROPN,NOUN,compound-nsubj,compound,NNP-NNP,NN,1,1
4485,21679.0,35,said,32,31,30,-1,30,4,1,-2,Mohamed ElBaradei,chief,PERSON-PERSON,TITLE,PROPN-PROPN,NOUN,compound-nsubj,compound,NNP-NNP,NN,1,1
4486,52016.0,27,said,16,15,8,-7,14,18,1,-8,Mohamed ElBaradei,chief,PERSON-PERSON,TITLE,PROPN-PROPN,NOUN,compound-nsubj,compound,NNP-NNP,NN,4,1
4487,64256.0,36,said,34,5,4,-1,4,31,29,-30,Mohamed ElBaradei,chief,PERSON-PERSON,TITLE,PROPN-PROPN,NOUN,compound-nsubj,compound,NNP-NNP,NN,1,1
4488,10346.0,22,received,1,3,7,4,2,14,-2,6,his,Institute of Hematology of Hospital Saint-Louis,PERSON,ORGANIZATION-ORGANIZATION-ORGANIZATION-ORGANIZATION-ORGANIZATION-ORGANIZATION,DET,PROPN-ADP-PROPN-ADP-PROPN-PROPN,poss,pobj-prep-pobj-prep-compound-pobj,PRP$,NNP-IN-NNP-IN-NNP-NNP,4,1
4489,10352.0,18,given,3,1,15,14,0,2,2,12,Trista Sutter,Vail,PERSON-PERSON,LOCATION,PROPN-PROPN,PROPN,compound-nsubj,pobj,NNP-NNP,NNP,4,1
4490,10354.0,27,sidelined,1,7,1,-6,6,25,-6,0,Arsenal Football Club,Fabregas,ORGANIZATION-ORGANIZATION-ORGANIZATION,PERSON,PROPN-PROPN-PROPN,PROPN,compound-compound-nsubj,nsubj,NNP-NNP-NNP,NNP,3,1
4491,10355.0,43,reported,41,8,3,-5,7,39,33,-38,Theodor ` Teddy ' Kollek,mayor,PERSON-PERSON-PERSON-PERSON-PERSON,TITLE,NOUN-PUNCT-PROPN-PART-PROPN,NOUN,nmod-punct-poss-case-nsubj,conj,NN-''-NNP-POS-NNP,NN,4,1
4492,31935.0,43,reported,41,8,3,-5,7,39,33,-38,Theodor ` Teddy ' Kollek,mayor,PERSON-PERSON-PERSON-PERSON-PERSON,TITLE,NOUN-PUNCT-PROPN-PART-PROPN,NOUN,nmod-punct-poss-case-nsubj,compound,NN-''-NNP-POS-NNP,NN,4,1
4493,10357.0,53,include,1,3,32,29,2,20,-2,31,his,Jameson Nolte,PERSON,PERSON-PERSON,DET,PROPN-PROPN,poss,compound-conj,PRP$,NNP-NNP,9,1
4494,10358.0,29,is,2,24,20,-4,23,8,-22,18,ABA,American Beverage Association,ORGANIZATION,ORGANIZATION-ORGANIZATION-ORGANIZATION,PROPN,PROPN-PROPN-PROPN,compound,compound-compound-pobj,NNP,NNP-NNP-NNP,8,1
4495,10364.0,36,felt,14,8,4,-4,7,31,6,-10,IMF,International Monetary Fund,ORGANIZATION,ORGANIZATION-ORGANIZATION-ORGANIZATION,PROPN,PROPN-PROPN-PROPN,compound,compound-compound-compound,NNP,NNP-NNP-NNP,5,1
4496,19389.0,58,spends,5,46,42,-4,45,15,-41,37,IMF,International Monetary Fund,ORGANIZATION,ORGANIZATION-ORGANIZATION-ORGANIZATION,PROPN,PROPN-PROPN-PROPN,compound,compound-compound-compound,NNP,NNP-NNP-NNP,5,1
4497,25900.0,29,pledged,9,25,17,-8,24,11,-16,8,IMF,International Monetary Fund,ORGANIZATION,ORGANIZATION-ORGANIZATION-ORGANIZATION,PROPN,PROPN-PROPN-PROPN,compound,compound-compound-pobj,NNP,NNP-NNP-NNP,7,1
4498,54505.0,29,tumbled,2,16,12,-4,15,16,-14,10,IMF,International Monetary Fund,ORGANIZATION,ORGANIZATION-ORGANIZATION-ORGANIZATION,PROPN,PROPN-PROPN-PROPN,compound,compound-compound-pobj,NNP,NNP-NNP-NNP,6,1
4499,56666.0,31,looked,13,7,3,-4,6,27,6,-10,IMF,International Monetary Fund,ORGANIZATION,ORGANIZATION-ORGANIZATION-ORGANIZATION,PROPN,PROPN-PROPN-PROPN,compound,compound-compound-compound,NNP,NNP-NNP-NNP,3,1
4500,10373.0,40,said,18,26,32,6,25,7,-8,14,National Center for Disaster Preparedness,Columbia University 's Mailman School of Public Health,ORGANIZATION-ORGANIZATION-ORGANIZATION-ORGANIZATION-ORGANIZATION,ORGANIZATION-ORGANIZATION-ORGANIZATION-ORGANIZATION-ORGANIZATION-ORGANIZATION-ORGANIZATION-ORGANIZATION,PROPN-PROPN-ADP-PROPN-PROPN,PROPN-PROPN-PART-PROPN-PROPN-ADP-PROPN-PROPN,compound-pobj-prep-compound-pobj,compound-poss-case-compound-pobj-prep-compound-pobj,NNP-NNP-IN-NNP-NNP,NNP-NNP-POS-NNP-NNP-IN-NNP-NNP,7,1
4501,10799.0,27,commissioned,3,7,13,6,6,13,-4,10,National Center for Disaster Preparedness,Columbia University 's Mailman School of Public Health,ORGANIZATION-ORGANIZATION-ORGANIZATION-ORGANIZATION-ORGANIZATION,ORGANIZATION-ORGANIZATION-ORGANIZATION-ORGANIZATION-ORGANIZATION-ORGANIZATION-ORGANIZATION-ORGANIZATION,PROPN-PROPN-ADP-PROPN-PROPN,PROPN-PROPN-PART-PROPN-PROPN-ADP-PROPN-PROPN,compound-pobj-prep-compound-pobj,compound-poss-case-compound-pobj-prep-compound-pobj,NNP-NNP-IN-NNP-NNP,NNP-NNP-POS-NNP-NNP-IN-NNP-NNP,5,1
4502,34307.0,24,praised,20,6,12,6,5,11,14,-8,National Center for Disaster Preparedness,Columbia University 's Mailman School of Public Health,ORGANIZATION-ORGANIZATION-ORGANIZATION-ORGANIZATION-ORGANIZATION,ORGANIZATION-ORGANIZATION-ORGANIZATION-ORGANIZATION-ORGANIZATION-ORGANIZATION-ORGANIZATION-ORGANIZATION,PROPN-PROPN-ADP-PROPN-PROPN,PROPN-PROPN-PART-PROPN-PROPN-ADP-PROPN-PROPN,compound-pobj-prep-compound-pobj,compound-poss-case-compound-pobj-prep-compound-pobj,NNP-NNP-IN-NNP-NNP,NNP-NNP-POS-NNP-NNP-IN-NNP-NNP,5,1
4503,61920.0,50,said,27,36,42,6,35,7,-9,15,National Center for Disaster Preparedness,Columbia University 's Mailman School of Public Health,ORGANIZATION-ORGANIZATION-ORGANIZATION-ORGANIZATION-ORGANIZATION,ORGANIZATION-ORGANIZATION-ORGANIZATION-ORGANIZATION-ORGANIZATION-ORGANIZATION-ORGANIZATION-ORGANIZATION,PROPN-PROPN-ADP-PROPN-PROPN,PROPN-PROPN-PART-PROPN-PROPN-ADP-PROPN-PROPN,compound-pobj-prep-compound-pobj,compound-poss-case-compound-pobj-prep-compound-pobj,NNP-NNP-IN-NNP-NNP,NNP-NNP-POS-NNP-NNP-IN-NNP-NNP,7,1
4504,10375.0,22,include,3,1,5,4,0,16,2,2,His,director,PERSON,TITLE,DET,NOUN,poss,dobj,PRP$,NN,4,1
4505,10376.0,32,Jordan,3,8,28,20,7,3,-5,25,Opera National de Paris,French,ORGANIZATION-ORGANIZATION-ORGANIZATION-ORGANIZATION,COUNTRY,PROPN-PROPN-PROPN-PROPN,ADJ,compound-compound-compound-pobj,amod,NNP-NNP-NNP-NNP,JJ,7,1
4506,10381.0,24,share,16,10,14,4,9,9,6,-2,Peterson,Celine Peterson,PERSON,PERSON-PERSON,PROPN,PROPN-PROPN,poss,compound-appos,NNP,NNP-NNP,4,1
4507,10389.0,18,In,0,13,9,-4,12,8,-13,9,American Bar Association,New York,ORGANIZATION-ORGANIZATION-ORGANIZATION,STATE_OR_PROVINCE-STATE_OR_PROVINCE,PROPN-PROPN-PROPN,PROPN-PROPN,compound-compound-nsubjpass,compound-conj,NNP-NNP-NNP,NNP-NNP,7,1
4508,10402.0,35,RELATED,0,30,27,-3,29,7,-30,27,Carolyn Maloney,US House,PERSON-PERSON,ORGANIZATION-ORGANIZATION,PROPN-PROPN,PROPN-PROPN,compound-pobj,compound-compound,NNP-NNP,NNP-NNP,2,1
4509,10416.0,55,question,1,45,24,-21,44,30,-44,23,John Kerry,U.S.,PERSON-PERSON,COUNTRY,PROPN-PROPN,PROPN,compound-pobj,nmod,NNP-NNP,NNP,12,1
4510,50405.0,26,said,7,6,13,7,5,12,1,6,John Kerry,U.S.,PERSON-PERSON,COUNTRY,PROPN-PROPN,PROPN,compound-nsubj,compound,NNP-NNP,NNP,3,1
4511,10419.0,32,spent,3,25,9,-16,24,22,-22,6,American Basketball Association,Cleveland Pipers,ORGANIZATION-ORGANIZATION-ORGANIZATION,ORGANIZATION-ORGANIZATION,PROPN-PROPN-PROPN,PROPN-PROPN,compound-compound-pobj,compound-npadvmod,NNP-NNP-NNP,NNP-NNPS,6,1
4512,64278.0,33,-LRB-,0,26,20,-6,25,12,-26,20,American Basketball Association,Cleveland Pipers,ORGANIZATION-ORGANIZATION-ORGANIZATION,ORGANIZATION-ORGANIZATION,PROPN-PROPN-PROPN,PROPN-PROPN,compound-compound-pobj,compound-nsubj,NNP-NNP-NNP,NNP-NNPS,5,1
4513,10421.0,30,earned,4,4,25,21,3,4,0,21,DeBlanc,McNeese State University,PERSON,ORGANIZATION-ORGANIZATION-ORGANIZATION,PROPN,PROPN-PROPN-PROPN,nsubj,compound-compound-pobj,NNP,NNP-NNP-NNP,6,1
4514,15477.0,49,received,6,6,44,38,5,4,0,38,DeBlanc,McNeese State University,PERSON,ORGANIZATION-ORGANIZATION-ORGANIZATION,PROPN,PROPN-PROPN-PROPN,nsubj,compound-compound-pobj,NNP,NNP-NNP-NNP,6,1
4515,39365.0,36,left,10,2,25,23,1,10,8,15,DeBlanc,McNeese State University,PERSON,ORGANIZATION-ORGANIZATION-ORGANIZATION,PROPN,PROPN-PROPN-PROPN,nsubj,compound-compound-pobj,NNP,NNP-NNP-NNP,8,1
4516,65654.0,49,received,6,6,44,38,5,4,0,38,DeBlanc,McNeese State University,PERSON,ORGANIZATION-ORGANIZATION-ORGANIZATION,PROPN,PROPN-PROPN-PROPN,nsubj,compound-compound-pobj,NNP,NNP-NNP-NNP,7,1
4517,10425.0,49,IN,0,36,24,-12,35,24,-36,24,him,biologist,PERSON,TITLE,PRON,NOUN,dative,compound,PRP,NN,6,1
4518,10427.0,29,release,5,3,2,-1,2,26,2,-3,Alexandra Burke,artist,PERSON-PERSON,TITLE,PROPN-PROPN,NOUN,compound-nsubj,compound,NNP-NNP,NN,1,1
4519,22919.0,35,is,2,1,21,20,0,13,1,19,Alexandra Burke,artist,PERSON-PERSON,TITLE,PROPN-PROPN,NOUN,compound-nsubj,poss,NNP-NNP,NN,5,1
4520,10429.0,59,was,18,11,3,-8,10,55,7,-15,Hindalco Industries,India,ORGANIZATION-ORGANIZATION,COUNTRY,PROPN-PROPN,PROPN,compound-compound,npadvmod,NNP-NNPS,NNP,4,1
4521,13505.0,38,fell,9,8,1,-7,7,36,1,-8,Hindalco Industries,India,ORGANIZATION-ORGANIZATION,COUNTRY,PROPN-PROPN,PROPN,compound-nsubj,poss,NNP-NNPS,NNP,3,1
4522,56294.0,40,said,9,1,4,3,0,35,8,-5,Hindalco Industries,India,ORGANIZATION-ORGANIZATION,COUNTRY,PROPN-PROPN,PROPN,compound-nsubj,pobj,NNP-NNPS,NNP,1,1
4523,59432.0,38,fell,9,8,1,-7,7,36,1,-8,Hindalco Industries,India,ORGANIZATION-ORGANIZATION,COUNTRY,PROPN-PROPN,PROPN,compound-nsubj,poss,NNP-NNPS,NNP,2,1
4524,64450.0,40,said,9,1,4,3,0,35,8,-5,Hindalco Industries,India,ORGANIZATION-ORGANIZATION,COUNTRY,PROPN-PROPN,PROPN,compound-nsubj,pobj,NNP-NNPS,NNP,1,1
4525,10434.0,39,is,6,29,14,-15,28,24,-23,8,Dee Dee Myers,U.S.,PERSON-PERSON-PERSON,COUNTRY,PROPN-PROPN-PROPN,PROPN,compound-compound-nsubj,compound,NNP-NNP-NNP,NNP,8,1
4526,11890.0,28,reiterated,2,7,16,9,6,11,-5,14,Dee Dee Myers,U.S.,PERSON-PERSON-PERSON,COUNTRY,PROPN-PROPN-PROPN,PROPN,compound-compound-nsubj,nsubj,NNP-NNP-NNP,NNP,3,1
4527,10440.0,14,was,1,1,4,3,0,9,0,3,She,nurse,PERSON,TITLE,PRON,NOUN,nsubj,attr,PRP,NN,1,1
4528,10444.0,49,Resigns,4,3,1,-2,2,47,1,-3,Donald Wildmon,AFA,PERSON-PERSON,ORGANIZATION,PROPN-PROPN,PROPN,compound-compound,compound,NNP-NNP,NNP,1,1
4529,35215.0,19,said,5,4,2,-2,3,16,1,-3,Donald Wildmon,AFA,PERSON-PERSON,ORGANIZATION,PROPN-PROPN,PROPN,compound-nsubj,compound,NNP-NNP,NNP,1,1
4530,40728.0,45,writes,15,19,17,-2,18,27,-4,2,Donald Wildmon,AFA,PERSON-PERSON,ORGANIZATION,PROPN-PROPN,PROPN,compound-nsubj,compound,NNP-NNP,NNP,3,1
4531,42409.0,14,joined,10,1,8,7,0,5,9,-2,Donald Wildmon,AFA,PERSON-PERSON,ORGANIZATION,PROPN-PROPN,PROPN,compound-poss,compound,NNP-NNP,NNP,-1,1
4532,10450.0,46,is,1,14,28,14,13,17,-13,27,Raul Castro,CTC,PERSON-PERSON,ORGANIZATION,PROPN-PROPN,PROPN,compound-conj,conj,NNP-NNP,NNP,3,1
4533,10452.0,23,approved,3,9,21,12,8,1,-6,18,Aerolineas Argentinas,Marsans Group,ORGANIZATION-ORGANIZATION,ORGANIZATION-ORGANIZATION,PROPN-PROPN,PROPN-PROPN,compound-pobj,compound-pobj,NNP-NNP,NNPS-NNP,4,1
4534,10459.0,25,said,1,1,12,11,0,12,0,11,Chen,Cathay Pacific,PERSON,ORGANIZATION-ORGANIZATION,PROPN,PROPN-PROPN,nsubj,compound-pobj,NNP,NNP-NNP,5,1
4535,23300.0,29,laid,2,16,1,-15,15,27,-14,-1,Chen,Cathay Pacific,PERSON,ORGANIZATION-ORGANIZATION,PROPN,PROPN-PROPN,nsubj,compound-nsubj,NNP,NNP-NNP,3,1
4536,61935.0,20,said,1,1,7,6,0,12,0,6,Chen,Cathay Pacific,PERSON,ORGANIZATION-ORGANIZATION,PROPN,PROPN-PROPN,nsubj,compound-nsubj,NNP,NNP-NNP,2,1
4537,64383.0,33,Philip,1,4,13,9,3,19,-3,12,Chen,Cathay Pacific,PERSON,ORGANIZATION-ORGANIZATION,PROPN,PROPN-PROPN,compound,compound-compound,NNP,NNP-NNP,7,1
4538,10462.0,36,BEIJING,0,12,22,10,11,13,-12,22,Chen Zhu,United States Institute of Medicine,PERSON-PERSON,ORGANIZATION-ORGANIZATION-ORGANIZATION-ORGANIZATION-ORGANIZATION,PROPN-PROPN,PROPN-PROPN-PROPN-ADP-PROPN,compound-nsubjpass,compound-compound-pobj-prep-pobj,NNP-NNP,NNP-NNP-NNP-IN-NNP,6,1
4539,10465.0,29,protect,3,26,1,-25,25,27,-23,-2,Child Protective Services,CPS,ORGANIZATION-ORGANIZATION-ORGANIZATION,ORGANIZATION,PROPN-PROPN-PROPN,PROPN,compound-compound-pobj,nsubj,NNP-NNP-NNPS,NNP,-1,1
4540,10466.0,45,recalled,5,1,41,40,0,3,4,36,ConAgra Foods Inc.,United States,ORGANIZATION-ORGANIZATION-ORGANIZATION,COUNTRY-COUNTRY,PROPN-PROPN-PROPN,PROPN-PROPN,compound-compound-nsubj,compound-pobj,NNP-NNP-NNP,NNP-NNP,12,1
4541,10470.0,34,became,2,29,13,-16,28,20,-27,11,George Young,personnel department,PERSON-PERSON,ORGANIZATION-ORGANIZATION,PROPN-PROPN,NOUN-NOUN,compound-appos,compound-pobj,NNP-NNP,NNS-NN,7,1
4542,10472.0,21,said,14,19,2,-17,18,18,-5,-12,Andrea Rothman,She,PERSON-PERSON,PERSON,PROPN-PROPN,PRON,compound-appos,nsubj,NNP-NNP,PRP,5,1
4543,10490.0,31,invest,9,8,19,11,7,11,1,10,Disney,US,ORGANIZATION,COUNTRY,PROPN,PROPN,nsubj,compound,NNP,NNP,2,1
4544,10513.0,46,said,18,35,14,-21,34,31,-17,-4,him,Senate Foreign Relations Committee,PERSON,ORGANIZATION-ORGANIZATION-ORGANIZATION-ORGANIZATION,PRON,PROPN-PROPN-PROPN-PROPN,dobj,compound-compound-compound-pobj,PRP,NNP-NNP-NNPS-NNP,8,1
4545,10517.0,23,played,3,7,21,14,6,1,-4,18,ABA,Kentucky Colonels,ORGANIZATION,ORGANIZATION-ORGANIZATION,NOUN,PROPN-PROPN,pobj,compound-conj,NN,NNP-NNP,7,1
4546,10519.0,44,said,25,32,27,-5,31,16,-7,2,Carnival Corp,Howard Frank,ORGANIZATION-ORGANIZATION,PERSON-PERSON,PROPN-PROPN,PROPN-PROPN,compound-subtok,compound-nsubj,NNP-NNP,NNP-NNP,2,1
4547,64104.0,29,said,26,11,25,14,10,3,15,-1,Carnival Corp,Howard Frank,ORGANIZATION-ORGANIZATION,PERSON-PERSON,PROPN-PROPN,PROPN-PROPN,compound-nsubj,compound-nsubj,NNP-NNP,NNP-NNP,7,1
4548,10524.0,10,said,5,7,4,-3,6,5,-2,-1,his,pneumonia,PERSON,CAUSE_OF_DEATH,DET,NOUN,poss,attr,PRP$,NN,2,1
4549,10525.0,26,born,14,13,17,4,12,8,1,3,Kollek,Nagyvaszony,PERSON,CITY,PROPN,PROPN,nsubjpass,pobj,NNP,NNP,2,1
4550,10537.0,18,landed,2,11,8,-3,10,9,-9,6,he,Minn,PERSON,STATE_OR_PROVINCE,PRON,PROPN,nsubj,appos,PRP,NNP,2,1
4551,10540.0,13,born,2,12,5,-7,11,7,-10,3,Ferrara,1912,PERSON,DATE,PROPN,NUM,pobj,pobj,NNP,CD,2,1
4552,10543.0,42,lost,2,14,7,-7,13,34,-12,5,Massachusetts House of Representatives,Finneran,ORGANIZATION-ORGANIZATION-ORGANIZATION-ORGANIZATION,PERSON,PROPN-PROPN-ADP-PROPN,PROPN,compound-pobj-prep-pobj,pobj,NNP-NNP-IN-NNPS,NNP,4,1
4553,52338.0,27,stem,2,12,5,-7,11,21,-10,3,Massachusetts House of Representatives,Finneran,ORGANIZATION-ORGANIZATION-ORGANIZATION-ORGANIZATION,PERSON,PROPN-PROPN-ADP-PROPN,PROPN,compound-pobj-prep-pobj,poss,NNP-NNP-IN-NNPS,NNP,6,1
4554,10546.0,39,said,34,23,9,-14,22,29,11,-25,her,producer,PERSON,TITLE,DET,NOUN,poss,conj,PRP$,NN,7,1
4555,10547.0,46,said,21,19,14,-5,18,31,2,-7,Haifa University,National Security Study Center,ORGANIZATION-ORGANIZATION,ORGANIZATION-ORGANIZATION-ORGANIZATION-ORGANIZATION,PROPN-PROPN,PROPN-PROPN-PROPN-PROPN,compound-pobj,compound-compound-compound-pobj,NNP-NNP,NNP-NNP-NNP-NNP,2,1
4556,10554.0,37,said,15,25,17,-8,24,19,-10,2,American Bankers Association,Bob Davis,ORGANIZATION-ORGANIZATION-ORGANIZATION,PERSON-PERSON,PROPN-PROPN-PROPN,PROPN-PROPN,compound-compound-pobj,compound-nsubj,NNP-NNPS-NNP,NNP-NNP,4,1
4557,13913.0,32,said,19,29,21,-8,28,10,-10,2,American Bankers Association,Bob Davis,ORGANIZATION-ORGANIZATION-ORGANIZATION,PERSON-PERSON,PROPN-PROPN-PROPN,PROPN-PROPN,compound-compound-pobj,compound-nsubj,NNP-NNPS-NNP,NNP-NNP,5,1
4558,22872.0,34,said,20,31,22,-9,30,11,-11,2,American Bankers Association,Bob Davis,ORGANIZATION-ORGANIZATION-ORGANIZATION,PERSON-PERSON,PROPN-PROPN-PROPN,PROPN-PROPN,compound-compound-pobj,compound-nsubj,NNP-NNPS-NNP,NNP-NNP,5,1
4559,10555.0,17,are,13,7,12,5,6,4,6,-1,Hamilton,Anthony,PERSON,PERSON,PROPN,PROPN,appos,pobj,NNP,NNP,6,1
4560,20760.0,29,won,23,22,4,-18,21,24,1,-19,Hamilton,Anthony,PERSON,PERSON,PROPN,PROPN,nsubj,appos,NNP,NNP,3,1
4561,26693.0,30,manager,11,5,8,3,4,21,6,-3,Hamilton,Anthony,PERSON,PERSON,PROPN,PROPN,poss,appos,NNP,NNP,2,1
4562,62050.0,37,grandson,1,7,10,3,6,26,-6,9,Hamilton,Anthony,PERSON,PERSON,PROPN,PROPN,poss,appos,NNP,NNP,3,1
4563,10556.0,56,plans,4,51,44,-7,50,11,-47,40,Alcatel,New Jersey-based,ORGANIZATION,STATE_OR_PROVINCE-STATE_OR_PROVINCE,PROPN,PROPN-PROPN,pobj,compound-compound,NNP,NNP-NNP,8,1
4564,10566.0,41,said,32,39,38,-1,38,2,-7,6,Marco Contiero,director,PERSON-PERSON,TITLE,PROPN-PROPN,NOUN,compound-nsubj,compound,NNP-NNP,NN,2,1
4565,27178.0,36,unimpressed,9,7,6,-1,6,29,2,-3,Marco Contiero,director,PERSON-PERSON,TITLE,PROPN-PROPN,NOUN,compound-nsubjpass,nsubjpass,NNP-NNP,NN,1,1
4566,10593.0,43,notes,8,7,3,-4,6,39,1,-5,APA,American Psychiatric Association,ORGANIZATION,ORGANIZATION-ORGANIZATION-ORGANIZATION,PROPN,PROPN-PROPN-PROPN,compound,compound-compound-nsubj,NNP,NNP-NNP-NNP,3,1
4567,27708.0,69,confirmed,9,17,13,-4,16,55,-8,4,APA,American Psychiatric Association,ORGANIZATION,ORGANIZATION-ORGANIZATION-ORGANIZATION,PROPN,PROPN-PROPN-PROPN,compound,compound-compound-nsubj,NNP,NNP-NNP-NNP,2,1
4568,66049.0,56,had,40,26,21,-5,25,34,14,-19,APA,American Psychiatric Association,ORGANIZATION,ORGANIZATION-ORGANIZATION-ORGANIZATION,PROPN,PROPN-PROPN-PROPN,nmod,compound-compound-poss,NNP,NNP-NNP-NNP,3,1
4569,10602.0,24,stopped,2,20,15,-5,19,8,-18,13,her,MTV,PERSON,ORGANIZATION,DET,PROPN,poss,poss,PRP$,NNP,4,1
4570,10606.0,15,dies,14,1,8,7,0,6,13,-6,Michael K. Deaver,image consultant,PERSON-PERSON-PERSON,TITLE-TITLE,PROPN-PROPN-PROPN,NOUN-NOUN,compound-compound-nsubj,compound-conj,NNP-NNP-NNP,NN-NN,3,1
4571,10609.0,48,died,37,1,45,44,0,2,36,8,Lorraine Rothman,Fullerton,PERSON-PERSON,CITY,PROPN-PROPN,PROPN,compound-nsubj,pobj,NNP-NNP,NNP,6,1
4572,10628.0,33,told,12,9,7,-2,8,25,3,-5,Mainland Affairs Council,Taiwan,ORGANIZATION-ORGANIZATION-ORGANIZATION,COUNTRY,PROPN-PROPN-PROPN,PROPN,compound-compound-pobj,poss,NNP-NNPS-NNP,NNP,3,1
4573,43481.0,38,said,13,25,23,-2,24,14,-12,10,Mainland Affairs Council,Taiwan,ORGANIZATION-ORGANIZATION-ORGANIZATION,COUNTRY,PROPN-PROPN-PROPN,PROPN,compound-compound-pobj,poss,NNP-NNPS-NNP,NNP,2,1
4574,44144.0,35,said,20,8,6,-2,7,28,12,-14,Mainland Affairs Council,Taiwan,ORGANIZATION-ORGANIZATION-ORGANIZATION,COUNTRY,PROPN-PROPN-PROPN,PROPN,compound-compound-pobj,poss,NNP-NNPS-NNP,NNP,3,1
4575,50716.0,32,told,29,26,24,-2,25,7,3,-5,Mainland Affairs Council,Taiwan,ORGANIZATION-ORGANIZATION-ORGANIZATION,COUNTRY,PROPN-PROPN-PROPN,PROPN,compound-compound-pobj,poss,NNP-NNPS-NNP,NNP,3,1
4576,10631.0,74,Via,0,23,23,0,22,50,-23,23,Trista Sutter,Trista Rehn,PERSON-PERSON,PERSON-PERSON,PROPN-PROPN,PROPN-PROPN,compound-compound,compound-compound,NNP-NNP,NNP-NNP,0,1
4577,10632.0,25,says,3,14,13,-1,13,11,-11,10,Danny Glover,actor,PERSON-PERSON,TITLE,PROPN-PROPN,NOUN,compound-pobj,compound,NNP-NNP,NN,1,1
4578,24766.0,30,Sue,0,11,10,-1,10,19,-11,10,Danny Glover,actor,PERSON-PERSON,TITLE,PROPN-PROPN,NOUN,compound-nsubjpass,compound,NNP-NNP,NN,4,1
4579,25039.0,30,Exposed,2,6,11,5,5,18,-4,9,Danny Glover,actor,PERSON-PERSON,TITLE,PROPN-PROPN,NOUN,compound-nsubj,attr,NNP-NNP,NN,3,1
4580,25894.0,33,added,5,31,27,-4,30,5,-26,22,Danny Glover,actor,PERSON-PERSON,TITLE,PROPN-PROPN,NOUN,compound-pobj,nmod,NNP-NNP,NN,2,1
4581,31330.0,47,read,45,39,38,-1,38,8,6,-7,Danny Glover,actor,PERSON-PERSON,TITLE,PROPN-PROPN,NOUN,compound-pobj,compound,NNP-NNP,NN,1,1
4582,32712.0,25,is,1,19,18,-1,18,6,-18,17,Danny Glover,actor,PERSON-PERSON,TITLE,PROPN-PROPN,NOUN,compound-pobj,compound,NNP-NNP,NN,1,1
4583,36464.0,30,plays,11,3,2,-1,2,27,8,-9,Danny Glover,actor,PERSON-PERSON,TITLE,PROPN-PROPN,NOUN,compound-nsubj,compound,NNP-NNP,NN,1,1
4584,43162.0,24,described,17,20,19,-1,19,4,-3,2,Danny Glover,actor,PERSON-PERSON,TITLE,PROPN-PROPN,NOUN,compound-poss,compound,NNP-NNP,NN,1,1
4585,65686.0,36,approved,4,34,33,-1,33,2,-30,29,Danny Glover,actor,PERSON-PERSON,TITLE,PROPN-PROPN,NOUN,compound-pobj,compound,NNP-NNP,NN,2,1
4586,10647.0,26,was,5,17,1,-16,16,24,-12,-4,UNC,Kamla Persad-Bissessar,ORGANIZATION,PERSON-PERSON,PROPN,PROPN-PROPN,compound,compound-nsubj,NNP,NNP-NNP,6,1
4587,10651.0,23,was,15,1,13,12,0,9,14,-2,Bolin,New York,PERSON,STATE_OR_PROVINCE-STATE_OR_PROVINCE,PROPN,PROPN-PROPN,nsubj,compound-appos,NNP,NNP-NNP,5,1
4588,10666.0,35,offered,4,14,17,3,13,17,-10,13,Raul Castro,Cuba,PERSON-PERSON,COUNTRY,PROPN-PROPN,PROPN,compound-pobj,pobj,NNP-NNP,NNP,6,1
4589,13020.0,34,declared,3,20,1,-19,19,32,-17,-2,Raul Castro,Cuba,PERSON-PERSON,COUNTRY,PROPN-PROPN,PROPN,compound-pobj,poss,NNP-NNP,NNP,9,1
4590,16602.0,33,Urgent,0,3,8,5,2,24,-3,8,Raul Castro,Cuba,PERSON-PERSON,COUNTRY,PROPN-PROPN,PROPN,compound-compound,compound,NNP-NNP,NNP,4,1
4591,23349.0,31,took,5,1,22,21,0,8,4,17,Raul Castro,Cuba,PERSON-PERSON,COUNTRY,PROPN-PROPN,PROPN,compound-nsubj,poss,NNP-NNP,NNP,5,1
4592,30233.0,15,convening,4,2,6,4,1,8,2,2,Raul Castro,Cuba,PERSON-PERSON,NATIONALITY,PROPN-PROPN,PROPN,compound-nsubj,poss,NNP-NNP,NNP,4,1
4593,31452.0,30,sent,16,1,14,13,0,15,15,-2,Raul Castro,Cuba,PERSON-PERSON,ORGANIZATION,PROPN-PROPN,PROPN,compound-nsubj,pobj,NNP-NNP,NNP,2,1
4594,31535.0,40,returned,3,2,9,7,1,30,1,6,Raul Castro,Cuba,PERSON-PERSON,COUNTRY,PROPN-PROPN,PROPN,compound-nsubj,pobj,NNP-NNP,NNP,2,1
4595,33366.0,40,announces,5,4,8,4,3,31,1,3,Raul Castro,Cuba,PERSON-PERSON,COUNTRY,PROPN-PROPN,PROPN,compound-nsubj,nsubj,NNP-NNP,NNP,3,1
4596,42288.0,14,leads,2,1,8,7,0,5,1,6,Raul Castro,Cuba,PERSON-PERSON,COUNTRY,PROPN-PROPN,PROPN,compound-nsubj,compound,NNP-NNP,NNP,5,1
4597,42825.0,44,told,37,3,1,-2,2,42,34,-36,Raul Castro,Cuba,PERSON-PERSON,COUNTRY,PROPN-PROPN,PROPN,compound-nsubj,poss,NNP-NNP,NNP,2,1
4598,48564.0,44,says,6,34,9,-25,33,34,-28,3,Raul Castro,Cuba,PERSON-PERSON,COUNTRY,PROPN-PROPN,PROPN,compound-nsubj,nsubj,NNP-NNP,NNP,10,1
4599,50662.0,41,stressed,32,1,31,30,0,9,31,-1,Raul Castro,Cuba,PERSON-PERSON,COUNTRY,PROPN-PROPN,PROPN,compound-nsubj,pobj,NNP-NNP,NNP,2,1
4600,51258.0,50,came,19,27,30,3,26,19,-8,11,Raul Castro,Cuba,PERSON-PERSON,COUNTRY,PROPN-PROPN,PROPN,compound-dobj,pobj,NNP-NNP,NNP,5,1
4601,67766.0,44,faces,10,20,10,-10,19,33,-10,0,Raul Castro,Cuba,PERSON-PERSON,NATIONALITY,PROPN-PROPN,PROPN,compound-pobj,nsubj,NNP-NNP,NNP,5,1
4602,10670.0,21,-RRB-,4,8,11,3,7,9,-4,7,Defensor Sporting,Uruguay,ORGANIZATION-ORGANIZATION,COUNTRY,PROPN-PROPN,PROPN,compound-compound,compound,NNP-NNP,NNP,2,1
4603,47503.0,52,came,21,44,47,3,43,4,-23,26,Defensor Sporting,Uruguay,ORGANIZATION-ORGANIZATION,COUNTRY,PROPN-PROPN,PROPN,compound-pobj,pobj,NNP-NNP,NNP,4,1
4604,10671.0,31,gave,2,24,17,-7,23,13,-22,15,First Group,Moir Lockhead,ORGANIZATION-ORGANIZATION,PERSON-PERSON,PROPN-PROPN,PROPN-PROPN,compound-pobj,compound-pobj,NNP-NNP,NNP-NNP,3,1
4605,10672.0,39,said,37,15,37,22,14,1,22,0,Ali Larijani,SANA,PERSON-PERSON,ORGANIZATION,PROPN-PROPN,PROPN,compound-appos,appos,NNP-NNP,NNP,7,1
4606,10679.0,30,persevered,20,20,25,5,19,4,0,5,Bolin,Yale Law School,PERSON,ORGANIZATION-ORGANIZATION-ORGANIZATION,PROPN,PROPN-PROPN-PROPN,nsubj,compound-compound-pobj,NNP,NNP-NNP-NNP,4,1
4607,17459.0,46,was,1,1,10,9,0,35,0,9,Bolin,Yale Law School,PERSON,ORGANIZATION-ORGANIZATION-ORGANIZATION,PROPN,PROPN-PROPN-PROPN,nsubj,compound-compound-pobj,NNP,NNP-NNP-NNP,5,1
4608,10682.0,35,pleaded,5,14,20,6,13,14,-9,15,his,Colombian,PERSON,NATIONALITY,DET,ADJ,poss,amod,PRP$,JJ,6,1
4609,19051.0,43,acted,4,30,14,-16,29,28,-26,10,his,Colombian,PERSON,NATIONALITY,DET,ADJ,poss,amod,PRP$,JJ,11,1
4610,10684.0,30,transferred,5,21,27,6,20,2,-16,22,EnergySolutions,Salt Lake City,ORGANIZATION,CITY-CITY-CITY,PROPN,PROPN-PROPN-PROPN,pobj,compound-compound-pobj,NNP,NNP-NNP-NNP,5,1
4611,12262.0,36,shipped,14,19,33,14,18,2,-5,19,EnergySolutions,Salt Lake City,ORGANIZATION,CITY-CITY-CITY,PROPN,PROPN-PROPN-PROPN,poss,compound-compound-pobj,NNP,NNP-NNP-NNP,9,1
4612,26968.0,48,said,1,5,11,6,4,36,-4,10,EnergySolutions,Salt Lake City,ORGANIZATION,CITY-CITY-CITY,PROPN,PROPN-PROPN-PROPN,nsubjpass,compound-compound-pobj,NNP,NNP-NNP-NNP,6,1
4613,27086.0,43,asked,6,1,3,2,0,39,5,-3,EnergySolutions,Salt Lake City,ORGANIZATION,CITY-CITY-CITY,PROPN,PROPN-PROPN-PROPN,nsubj,compound-compound-pobj,NNP,NNP-NNP-NNP,2,1
4614,62912.0,22,transferred,5,16,19,3,15,2,-11,14,EnergySolutions,Salt Lake City,ORGANIZATION,CITY-CITY-CITY,PROPN,PROPN-PROPN-PROPN,pobj,compound-compound-pobj,NNP,NNP-NNP-NNP,4,1
4615,10693.0,56,got,36,1,5,4,0,50,35,-31,Richard H. Nolte,86,PERSON-PERSON-PERSON,NUMBER,PROPN-PROPN-PROPN,NUM,compound-compound-nsubj,appos,NNP-NNP-NNP,CD,2,1
4616,10709.0,32,said,19,14,11,-3,13,20,5,-8,Beyonce,Matthew Knowles,PERSON,PERSON-PERSON,PROPN,PROPN-PROPN,poss,compound-appos,NNP,NNP-NNP,3,1
4617,19088.0,39,complain,26,36,33,-3,35,5,-10,7,Beyonce,Matthew Knowles,PERSON,PERSON-PERSON,PROPN,PROPN-PROPN,poss,compound-pobj,NNP,NNP-NNP,2,1
4618,10715.0,31,is,16,22,14,-8,21,16,-6,-2,Focus On The Family,Maine Marriage Initiative,ORGANIZATION-ORGANIZATION-ORGANIZATION-ORGANIZATION,ORGANIZATION-ORGANIZATION-ORGANIZATION,PROPN-ADP-DET-PROPN,PROPN-PROPN-PROPN,pobj-prep-det-pobj,compound-compound-nsubj,NNP-IN-DT-NNP,NNP-NNP-NNP,5,1
4619,10717.0,21,believed,9,2,7,5,1,13,7,-2,Red Sox,1901,ORGANIZATION-ORGANIZATION,DATE,PROPN-PROPN,NUM,compound-nsubj,pobj,NNP-NNPS,CD,2,1
4620,10718.0,69,said,46,59,65,6,58,3,-13,19,Norris Comprehensive Cancer Center,University of Southern California,ORGANIZATION-ORGANIZATION-ORGANIZATION-ORGANIZATION,ORGANIZATION-ORGANIZATION-ORGANIZATION-ORGANIZATION,PROPN-PROPN-PROPN-PROPN,PROPN-ADP-PROPN-PROPN,compound-compound-compound-pobj,pobj-prep-compound-pobj,NNP-NNP-NNP-NNP,NNP-IN-NNP-NNP,4,1
4621,41194.0,69,said,46,59,65,6,58,3,-13,19,Norris Comprehensive Cancer Center,University of Southern California,ORGANIZATION-ORGANIZATION-ORGANIZATION-ORGANIZATION,ORGANIZATION-ORGANIZATION-ORGANIZATION-ORGANIZATION,PROPN-PROPN-PROPN-PROPN,PROPN-ADP-PROPN-PROPN,compound-compound-compound-pobj,pobj-prep-compound-pobj,NNP-NNP-NNP-NNP,NNP-IN-NNP-NNP,4,1
4622,10723.0,33,is,1,16,8,-8,15,24,-15,7,Massachusetts House of Representatives,Boston,ORGANIZATION-ORGANIZATION-ORGANIZATION-ORGANIZATION,CITY,PROPN-PROPN-ADP-PROPN,PROPN,compound-pobj-prep-pobj,pobj,NNP-NNP-IN-NNPS,NNP,4,1
4623,10730.0,28,reshuffled,11,20,19,-1,19,8,-9,8,Philip Chen,executive,PERSON-PERSON,TITLE,PROPN-PROPN,NOUN,compound-dobj,compound,NNP-NNP,NN,1,1
4624,11909.0,28,reshuffled,11,20,19,-1,19,8,-9,8,Philip Chen,executive,PERSON-PERSON,TITLE,PROPN-PROPN,NOUN,compound-dobj,compound,NNP-NNP,NN,1,1
4625,17711.0,25,required,12,19,18,-1,18,6,-7,6,Philip Chen,executive,PERSON-PERSON,TITLE,PROPN-PROPN,NOUN,compound-nsubjpass,compound,NNP-NNP,NN,2,1
4626,20960.0,24,added,8,1,7,6,0,16,7,-1,Philip Chen,executive,PERSON-PERSON,TITLE,PROPN-PROPN,NOUN,compound-nsubj,appos,NNP-NNP,NN,2,1
4627,49405.0,22,called,5,4,3,-1,3,18,1,-2,Philip Chen,executive,PERSON-PERSON,TITLE,PROPN-PROPN,NOUN,compound-nsubj,compound,NNP-NNP,NN,1,1
4628,53888.0,24,said,14,16,23,7,15,0,-2,9,Philip Chen,executive,PERSON-PERSON,TITLE,PROPN-PROPN,NOUN,compound-nsubj,appos,NNP-NNP,NN,2,1
4629,60684.0,34,said,31,30,29,-1,29,4,1,-2,Philip Chen,executive,PERSON-PERSON,TITLE,PROPN-PROPN,NOUN,compound-nsubj,compound,NNP-NNP,NN,1,1
4630,10731.0,35,argues,26,20,16,-4,19,18,6,-10,International Crisis Group,Afghanistan,ORGANIZATION-ORGANIZATION-ORGANIZATION,COUNTRY,PROPN-PROPN-PROPN,PROPN,compound-compound-nmod,dobj,NNP-NNP-NNP,NNP,5,1
4631,10732.0,30,held,9,28,27,-1,27,2,-19,18,Ali Larijani,Secretary,PERSON-PERSON,TITLE,PROPN-PROPN,PROPN,compound-conj,compound,NNP-NNP,NNP,1,1
4632,50065.0,49,TEHRAN,0,18,17,-1,17,31,-18,17,Ali Larijani,Secretary,PERSON-PERSON,TITLE,PROPN-PROPN,PROPN,compound-nsubj,compound,NNP-NNP,NNP,1,1
4633,10733.0,29,spoken,19,10,6,-4,9,22,9,-13,Gholam Ali Hadad Adel,Tehran,PERSON-PERSON-PERSON-PERSON,LOCATION,PROPN-PROPN-PROPN-PROPN,PROPN,compound-compound-compound-nsubj,pobj,NNP-NNP-NNP-NNP,NNP,3,1
4634,10736.0,42,said,16,29,11,-18,28,30,-13,-5,his,executive,PERSON,TITLE,DET,NOUN,poss,conj,PRP$,NN,12,1
4635,21266.0,30,released,16,21,5,-16,20,24,-5,-11,his,executive,PERSON,TITLE,DET,NOUN,poss,appos,PRP$,NN,7,1
4636,49199.0,30,2,0,21,9,-12,20,20,-21,9,his,executive,PERSON,TITLE,DET,NOUN,poss,conj,PRP$,NN,8,1
4637,10738.0,10,reviews,2,1,10,9,0,-1,1,8,MECO,ECFA,ORGANIZATION,ORGANIZATION,ADJ,PROPN,amod,pobj,JJ,NNP,4,1
4638,10739.0,33,conned,4,4,29,25,3,3,0,25,Buchwald,New York Herald Tribune,PERSON,ORGANIZATION-ORGANIZATION-ORGANIZATION-ORGANIZATION,PROPN,PROPN-PROPN-PROPN-PROPN,nsubj,compound-compound-compound-pobj,NNP,NNP-NNP-NNP-NNP,9,1
4639,59251.0,26,built,1,1,20,19,0,5,0,19,Buchwald,New York Herald Tribune,PERSON,ORGANIZATION-ORGANIZATION-ORGANIZATION-ORGANIZATION,PROPN,PROPN-PROPN-PROPN-PROPN,nsubj,compound-compound-compound-pobj,NNP,NNP-NNP-NNP-NNP,9,1
4640,10747.0,11,Flowers,5,5,3,-2,4,7,0,-2,Richmond Flowers,Attorney General,PERSON-PERSON,TITLE-TITLE,PROPN-PROPN,PROPN-PROPN,compound-ROOT,compound-compound,NNP-NNP,NNP-NNP,1,1
4641,40929.0,19,Flowers,5,5,3,-2,4,15,0,-2,Richmond Flowers,Attorney General,PERSON-PERSON,TITLE-TITLE,PROPN-PROPN,PROPN-PROPN,compound-ROOT,compound-compound,NNP-NNP,NNP-NNP,1,1
4642,10751.0,50,earned,33,1,23,22,0,26,32,-10,Mark Buse,Freddie Mac,PERSON-PERSON,ORGANIZATION-ORGANIZATION,PROPN-PROPN,PROPN-PROPN,compound-nsubj,compound-compound,NNP-NNP,NNP-NNP,4,1
4643,10760.0,44,warned,15,28,14,-14,27,29,-13,-1,the company,Paul Tufano,ORGANIZATION-ORGANIZATION,PERSON-PERSON,DET-NOUN,PROPN-PROPN,det-nsubj,compound-nsubj,DT-NN,NNP-NNP,5,1
4644,10764.0,29,laughed,19,16,13,-3,15,15,3,-6,Golden Baseball League,Urick,ORGANIZATION-ORGANIZATION-ORGANIZATION,PERSON,PROPN-PROPN-PROPN,PROPN,compound-compound-pobj,pobj,NNP-NNP-NNP,NNP,2,1
4645,10771.0,29,says,27,2,17,15,1,11,25,-10,her,Fat Joe,PERSON,PERSON-PERSON,DET,PROPN-PROPN,poss,compound-conj,PRP$,NNP-NNP,8,1
4646,10780.0,45,include,1,3,28,25,2,16,-2,27,his,Gilbert Gude Jr,PERSON,PERSON-PERSON-PERSON,DET,PROPN-PROPN-PROPN,poss,compound-compound-conj,PRP$,NNP-NNP-NNP,3,1
4647,10781.0,25,is,2,12,7,-5,11,17,-10,5,Joseph Farland,America,PERSON-PERSON,COUNTRY,PROPN-PROPN,PROPN,compound-pobj,poss,NNP-NNP,NNP,4,1
4648,24955.0,47,-LRB-,4,38,29,-9,37,17,-34,25,Joseph Farland,America,PERSON-PERSON,COUNTRY,PROPN-PROPN,PROPN,compound-conj,poss,NNP-NNP,NNP,3,1
4649,10796.0,56,is,9,51,45,-6,50,10,-42,36,FMF,U. S. Foreign Military Financing,ORGANIZATION,ORGANIZATION-ORGANIZATION-ORGANIZATION-ORGANIZATION-ORGANIZATION,PROPN,PROPN-PROPN-PROPN-PROPN-PROPN,compound,compound-compound-compound-compound-pobj,NNP,NNP-NNP-NNP-NNP-NNP,12,1
4650,10808.0,32,said,5,3,1,-2,2,30,2,-4,Steve McPherson,ABC President,PERSON-PERSON,TITLE-TITLE,PROPN-PROPN,PROPN-PROPN,compound-nsubj,compound-compound,NNP-NNP,NNP-NNP,1,1
4651,10816.0,50,launching,11,28,1,-27,27,48,-17,-10,Residential Capital LLC,GMAC,ORGANIZATION-ORGANIZATION-ORGANIZATION,ORGANIZATION,PROPN-PROPN-PROPN,NOUN,compound-compound-conj,compound,NNP-NNP-NNP,NN,9,1
4652,16244.0,40,swapped,15,32,13,-19,31,26,-17,-2,Residential Capital LLC,GMAC,ORGANIZATION-ORGANIZATION-ORGANIZATION,ORGANIZATION,PROPN-PROPN-PROPN,PROPN,compound-compound-pobj,compound,NNP-NNP-NNP,NNP,13,1
4653,44715.0,46,said,41,20,1,-19,19,44,21,-40,Residential Capital LLC,GMAC,ORGANIZATION-ORGANIZATION-ORGANIZATION,ORGANIZATION,PROPN-PROPN-PROPN,PROPN,compound-compound-appos,poss,NNP-NNP-NNP,NNP,9,1
4654,10823.0,20,gained,6,6,19,13,5,0,0,13,Sills,Bubbles,PERSON,PERSON,PROPN,PROPN,nsubj,appos,NNP,NNP,1,1
4655,10827.0,24,said,21,18,4,-14,17,19,3,-17,Richmond Flowers,Parkinson 's disease,PERSON-PERSON,CAUSE_OF_DEATH-CAUSE_OF_DEATH-CAUSE_OF_DEATH,PROPN-PROPN,PROPN-PART-NOUN,compound-compound,poss-case-pobj,NNP-NNP,NNP-POS-NN,9,1
4656,10835.0,39,said,5,3,1,-2,2,37,2,-4,G Gary Kirchner,County coroner,PERSON-PERSON-PERSON,TITLE-TITLE,PROPN-PROPN-PROPN,NOUN-NOUN,compound-compound-nsubj,compound-compound,NNP-NNP-NNP,NN-NN,2,1
4657,10841.0,14,died,1,1,13,12,0,0,0,12,Yoadimnadji,Paris,PERSON,CITY,NOUN,PROPN,nsubj,pobj,NNS,NNP,1,1
4658,12964.0,26,died,4,1,11,10,0,14,3,7,Yoadimnadji,Paris,PERSON,CITY,NOUN,PROPN,nsubj,pobj,NNS,NNP,4,1
4659,36011.0,21,said,7,9,20,11,8,0,-2,13,Yoadimnadji,Paris,PERSON,CITY,PROPN,PROPN,nsubj,pobj,NNP,NNP,2,1
4660,43107.0,25,said,7,9,24,15,8,0,-2,17,Yoadimnadji,Paris,PERSON,CITY,PROPN,PROPN,nsubj,pobj,NNP,NNP,2,1
4661,44842.0,21,said,7,9,20,11,8,0,-2,13,Yoadimnadji,Paris,PERSON,CITY,PROPN,PROPN,nsubj,pobj,NNP,NNP,2,1
4662,62558.0,26,died,4,1,11,10,0,14,3,7,Yoadimnadji,Paris,PERSON,CITY,NOUN,PROPN,nsubj,compound,NNS,NNP,4,1
4663,10850.0,25,head,2,1,4,3,0,20,1,2,IMF,Ceyla Pazarbasioglu,ORGANIZATION,PERSON-PERSON,PROPN,PROPN-PROPN,compound,compound-nsubj,NNP,NNP-NNP,2,1
4664,10853.0,50,opened,2,25,32,7,24,17,-23,30,Illinois Tool Works,Glenview,ORGANIZATION-ORGANIZATION-ORGANIZATION,CITY,PROPN-PROPN-PROPN,PROPN,compound-compound-compound,pobj,NNP-NNP-NNP,NNP,5,1
4665,34871.0,16,shows,6,2,6,4,1,9,4,0,Illinois Tool Works,Glenview,ORGANIZATION-ORGANIZATION-ORGANIZATION,CITY,PROPN-PROPN-PROPN,PROPN,compound-compound-nsubj,pobj,NNP-NNP-NNP,NNP,2,1
4666,48354.0,40,bid,35,7,12,5,6,27,28,-23,Illinois Tool Works,Glenview,ORGANIZATION-ORGANIZATION-ORGANIZATION,CITY,PROPN-PROPN-PROPN,PROPN,compound-compound-nsubj,nmod,NNP-NNP-NNP,NNP,4,1
4667,54728.0,27,said,6,4,1,-3,3,25,2,-5,Illinois Tool Works,Glenview,ORGANIZATION-ORGANIZATION-ORGANIZATION,CITY,PROPN-PROPN-PROPN,PROPN,compound-compound-nsubj,advcl,NNP-NNP-NNP,NNP,3,1
4668,10856.0,9,was,1,1,6,5,0,2,0,5,He,St Martinville,PERSON,CITY-CITY,PRON,PROPN-PROPN,nsubj,compound-dobj,PRP,NNP-NNP,2,1
4669,10870.0,49,said,9,8,17,9,7,31,1,8,MBIA Inc,Warburg Pincus LLC,ORGANIZATION-ORGANIZATION,PERSON-PERSON-PERSON,PROPN-PROPN,PROPN-PROPN-PROPN,compound-nsubj,compound-compound-pobj,NNP-NNP,NNP-NNP-NNP,6,1
4670,10874.0,47,dropped,16,24,46,22,23,0,-8,30,Jewish National Fund,1901,ORGANIZATION-ORGANIZATION-ORGANIZATION,DATE,ADJ-PROPN-PROPN,NUM,amod-compound-pobj,pobj,JJ-NNP-NNP,CD,9,1
4671,10876.0,31,graduated,19,19,13,-6,18,17,0,-6,she,Elizabeth Patch,PERSON,PERSON-PERSON,PRON,PROPN-PROPN,nsubj,compound-pobj,PRP,NNP-NNP,9,1
4672,10892.0,56,got,36,1,13,12,0,42,35,-23,Richard H. Nolte,Institute of Current World Affairs,PERSON-PERSON-PERSON,ORGANIZATION-ORGANIZATION-ORGANIZATION-ORGANIZATION-ORGANIZATION,PROPN-PROPN-PROPN,PROPN-ADP-PROPN-PROPN-PROPN,compound-compound-nsubj,pobj-prep-compound-compound-pobj,NNP-NNP-NNP,NNP-IN-NNP-NNP-NNPS,5,1
4673,10897.0,40,held,7,20,18,-2,19,21,-13,11,Gholam - Ali Haddad-Adel,parliament,PERSON-PERSON-PERSON-PERSON,ORGANIZATION,PROPN-PUNCT-PROPN-PROPN,NOUN,compound-punct-compound-ROOT,pobj,NNP-HYPH-NNP-NNP,NN,2,1
4674,10899.0,16,has,7,2,14,12,1,1,5,7,Federal Motor Carrier Safety Administration,www.fmcsa.dot.gov,ORGANIZATION-ORGANIZATION-ORGANIZATION-ORGANIZATION-ORGANIZATION,URL,PROPN-PROPN-PROPN-PROPN-PROPN,PROPN,compound-compound-compound-compound-nsubj,compound,NNP-NNP-NNP-NNP-NNP,NNP,5,1
4675,10902.0,38,considered,24,13,10,-3,12,27,11,-14,John Dewey,philosopher,PERSON-PERSON,TITLE,PROPN-PROPN,NOUN,compound-conj,conj,NNP-NNP,NN,2,1
4676,15256.0,43,founded,17,33,29,-4,32,13,-16,12,John Dewey,philosopher,PERSON-PERSON,TITLE,PROPN-PROPN,NOUN,compound-appos,pobj,NNP-NNP,NN,3,1
4677,33910.0,25,are,2,8,7,-1,7,17,-6,5,John Dewey,philosopher,PERSON-PERSON,TITLE,PROPN-PROPN,NOUN,compound-nsubj,attr,NNP-NNP,NN,1,1
4678,56938.0,30,are,3,15,14,-1,14,15,-12,11,John Dewey,philosopher,PERSON-PERSON,TITLE,PROPN-PROPN,NOUN,compound-dobj,compound,NNP-NNP,NN,1,1
4679,10909.0,16,include,4,7,12,5,6,3,-3,8,John Kerry,Senate Foreign Relations Committee,PERSON-PERSON,ORGANIZATION-ORGANIZATION-ORGANIZATION-ORGANIZATION,PROPN-PROPN,PROPN-PROPN-PROPN-PROPN,compound-dobj,compound-compound-compound-dobj,NNP-NNP,NNP-NNP-NNPS-NNP,5,1
4680,10912.0,14,says,13,8,1,-7,7,12,5,-12,his,Ohio,PERSON,STATE_OR_PROVINCE,DET,PROPN,poss,compound,PRP$,NNP,5,1
4681,13678.0,20,Gillmor,6,15,4,-11,14,15,-9,-2,his,Ohio,PERSON,STATE_OR_PROVINCE,DET,PROPN,poss,compound,PRP$,NNP,-1,1
4682,14168.0,13,says,12,7,1,-6,6,11,5,-11,his,Ohio,PERSON,STATE_OR_PROVINCE,DET,PROPN,poss,compound,PRP$,NNP,4,1
4683,26896.0,54,said,49,32,12,-20,31,41,17,-37,his,Ohio,PERSON,STATE_OR_PROVINCE,DET,PROPN,poss,pobj,PRP$,NNP,11,1
4684,65321.0,20,said,18,11,6,-5,10,13,7,-12,his,Ohio,PERSON,STATE_OR_PROVINCE,DET,PROPN,poss,pobj,PRP$,NNP,3,1
4685,10919.0,39,remembered,3,1,29,28,0,9,2,26,Beverly Sills,fundraiser,PERSON-PERSON,TITLE,PROPN-PROPN,NOUN,compound-nsubjpass,conj,NNP-NNP,NN,6,1
4686,10920.0,37,placed,19,7,1,-6,6,35,12,-18,Babyshambles,Pete Doherty,ORGANIZATION,PERSON-PERSON,PROPN,PROPN-PROPN,pobj,compound-nsubj,NNPS,NNP-NNP,4,1
4687,54826.0,43,began,2,42,39,-3,41,3,-40,37,Babyshambles,Pete Doherty,ORGANIZATION,PERSON-PERSON,PROPN,PROPN-PROPN,pobj,compound-poss,NNPS,NNP-NNP,12,1
4688,59971.0,32,display,2,23,25,2,22,6,-21,23,Babyshambles,Pete Doherty,ORGANIZATION,PERSON-PERSON,PROPN,PROPN-PROPN,compound,compound-poss,NNP,NNP-NNP,1,1
4689,10928.0,17,obtained,1,1,11,10,0,5,0,10,Chen,Shanghai Second Medical University,PERSON,ORGANIZATION-ORGANIZATION-ORGANIZATION-ORGANIZATION,PROPN,PROPN-PROPN-PROPN-PROPN,nsubj,compound-compound-compound-pobj,NNP,NNP-NNP-NNP-NNP,3,1
4690,10935.0,16,born,4,1,7,6,0,8,3,3,Jane Matilda Bolin,"April 11 , 1908",PERSON-PERSON-PERSON,DATE-DATE-DATE-DATE,PROPN-PROPN-PROPN,PROPN-NUM-PUNCT-NUM,compound-compound-nsubjpass,pobj-nummod-punct-nummod,NNP-NNP-NNP,"NNP-CD-,-CD",5,1
4691,45050.0,16,born,4,1,7,6,0,8,3,3,Jane Matilda Bolin,"April 11 , 1908",PERSON-PERSON-PERSON,DATE-DATE-DATE-DATE,PROPN-PROPN-PROPN,PROPN-NUM-PUNCT-NUM,compound-compound-nsubjpass,pobj-nummod-punct-nummod,NNP-NNP-NNP,"NNP-CD-,-CD",5,1
4692,10946.0,22,launches,4,11,18,7,10,3,-7,14,Kennedy Space Center,Cape Canaveral,ORGANIZATION-ORGANIZATION-ORGANIZATION,CITY-CITY,PROPN-PROPN-PROPN,PROPN-PROPN,compound-compound-pobj,compound-pobj,NNP-NNP-NNP,NNP-NNP,5,1
4693,21533.0,44,swept,2,24,5,-19,23,38,-22,3,Kennedy Space Center,Cape Canaveral,ORGANIZATION-ORGANIZATION-ORGANIZATION,CITY-CITY,PROPN-PROPN-PROPN,PROPN-PROPN,compound-compound-compound,compound-dobj,NNP-NNP-NNP,NNP-NNP,7,1
4694,22127.0,41,left,1,17,21,4,16,19,-16,20,Kennedy Space Center,Cape Canaveral,ORGANIZATION-ORGANIZATION-ORGANIZATION,CITY-CITY,PROPN-PROPN-PROPN,PROPN-PROPN,compound-compound-pobj,compound-pobj,NNP-NNP-NNP,NNP-NNP,3,1
4695,45818.0,45,giving,3,37,41,4,36,3,-34,38,Kennedy Space Center,Cape Canaveral,ORGANIZATION-ORGANIZATION-ORGANIZATION,CITY-CITY,PROPN-PROPN-PROPN,PROPN-PROPN,compound-compound-pobj,compound-pobj,NNP-NNP-NNP,NNP-NNP,3,1
4696,59639.0,25,scheduled,2,17,21,4,16,3,-15,19,Kennedy Space Center,Cape Canaveral,ORGANIZATION-ORGANIZATION-ORGANIZATION,CITY-CITY,PROPN-PROPN-PROPN,PROPN-PROPN,compound-compound-pobj,compound-pobj,NNP-NNP-NNP,NNP-NNP,3,1
4697,62698.0,45,occured,23,16,20,4,15,24,7,-3,Kennedy Space Center,Cape Canaveral,ORGANIZATION-ORGANIZATION-ORGANIZATION,CITY-CITY,PROPN-PROPN-PROPN,PROPN-PROPN,compound-compound-pobj,compound-pobj,NNP-NNP-NNP,NNP-NNP,3,1
4698,10958.0,34,elected,6,4,3,-1,3,30,2,-3,Raul Castro,general,PERSON-PERSON,TITLE,PROPN-PROPN,ADJ,compound-nsubjpass,compound,NNP-NNP,JJ,1,1
4699,60314.0,38,HAVANA,0,11,10,-1,10,27,-11,10,Raul Castro,general,PERSON-PERSON,TITLE,PROPN-PROPN,ADJ,compound-nsubjpass,compound,NNP-NNP,JJ,1,1
4700,10961.0,39,attacked,1,3,6,3,2,32,-2,5,JEM,Uzban,ORGANIZATION,LOCATION,PROPN,PROPN,compound,pobj,NNP,NNP,2,1
4701,10963.0,42,Commission,3,38,2,-36,37,39,-35,-1,Hu Sheng-cheng,Financial Supervisory Commission,PERSON-PERSON,ORGANIZATION-ORGANIZATION-ORGANIZATION,PROPN-PROPN,PROPN-PROPN-PROPN,compound-nsubj,compound-compound-ROOT,NNP-NNP,NNP-NNP-NNP,6,1
4702,33367.0,32,praised,4,14,7,-7,13,24,-10,3,Hu Sheng-cheng,Financial Supervisory Commission,PERSON-PERSON,ORGANIZATION-ORGANIZATION-ORGANIZATION,PROPN-PROPN,PROPN-PROPN-PROPN,compound-poss,compound-compound-dobj,NNP-NNP,NNP-NNP-NNP,-1,1
4703,42165.0,43,noted,20,8,14,6,7,28,12,-6,Hu Sheng-cheng,Financial Supervisory Commission,PERSON-PERSON,ORGANIZATION-ORGANIZATION-ORGANIZATION,PROPN-PROPN,PROPN-PROPN-PROPN,compound-dobj,compound-compound-pobj,NNP-NNP,NNP-NNP-NNP,5,1
4704,46495.0,41,said,38,8,1,-7,7,39,30,-37,Hu Sheng-cheng,Financial Supervisory Commission,PERSON-PERSON,ORGANIZATION-ORGANIZATION-ORGANIZATION,PROPN-PROPN,PROPN-PROPN-PROPN,compound-nsubjpass,compound-compound-compound,NNP-NNP,NNP-NNP-NNP,-1,1
4705,10982.0,31,donating,7,4,1,-3,3,29,3,-6,EnergySolutions Inc.,Salt Lake City-based,ORGANIZATION-ORGANIZATION,LOCATION-LOCATION-LOCATION,PROPN-PROPN,PROPN-PROPN-PROPN,compound-nsubj,compound-compound-compound,NNP-NNP,NNP-NNP-NNP,2,1
4706,10984.0,22,are,7,5,10,5,4,11,2,3,Jackson Hewitt,Chicago,ORGANIZATION-ORGANIZATION,CITY,PROPN-PROPN,PROPN,compound-compound,pobj,NNP-NNP,NNP,5,1
4707,10989.0,42,said,34,36,40,4,35,1,-2,6,National Security Council,Gordon Johndroe,ORGANIZATION-ORGANIZATION-ORGANIZATION,PERSON-PERSON,PROPN-PROPN-PROPN,PROPN-PROPN,compound-compound-compound,compound-nsubj,NNP-NNP-NNP,NNP-NNP,4,1
4708,56355.0,25,said,6,1,5,4,0,19,5,-1,National Security Council,Gordon Johndroe,ORGANIZATION-ORGANIZATION-ORGANIZATION,PERSON-PERSON,PROPN-PROPN-PROPN,PROPN-PROPN,compound-compound-compound,compound-nsubj,NNP-NNP-NNP,NNP-NNP,3,1
4709,11011.0,40,is,1,6,23,17,5,16,-5,22,Melanie Fiona,Canadian,PERSON-PERSON,NATIONALITY,PROPN-PROPN,PROPN,compound-poss,compound,NNP-NNP,NNP,10,1
4710,25566.0,30,christened,5,3,1,-2,2,28,2,-4,Melanie Fiona,Canadian,PERSON-PERSON,NATIONALITY,PROPN-PROPN,ADJ,compound-nsubj,amod,NNP-NNP,JJ,2,1
4711,34070.0,51,Visit,1,4,8,4,3,42,-3,7,Melanie Fiona,Canadian,PERSON-PERSON,NATIONALITY,PROPN-PROPN,ADJ,compound-ROOT,amod,NNP-NNP,JJ,2,1
4712,34644.0,21,eyeing,5,3,1,-2,2,19,2,-4,Melanie Fiona,Canadian,PERSON-PERSON,NATIONALITY,PROPN-PROPN,ADJ,compound-nsubj,amod,NNP-NNP,JJ,1,1
4713,58899.0,40,mokhal,0,2,21,19,1,18,-2,21,Melanie Fiona,Canadian,PERSON-PERSON,NATIONALITY,PROPN-PROPN,ADJ,compound-nsubj,amod,NNP-NNP,JJ,6,1
4714,11029.0,33,posted,6,29,26,-3,28,6,-23,20,Alberto Gonzales,US,PERSON-PERSON,ORGANIZATION,PROPN-PROPN,PROPN,compound-conj,compound,NNP-NNP,NNP,2,1
4715,21330.0,30,came,7,16,1,-15,15,28,-9,-6,Alberto Gonzales,US,PERSON-PERSON,COUNTRY,PROPN-PROPN,PROPN,compound-pobj,compound,NNP-NNP,NNP,7,1
4716,22203.0,14,seek,3,12,9,-3,11,4,-9,6,Alberto Gonzales,US,PERSON-PERSON,ORGANIZATION,PROPN-PROPN,PROPN,compound-pobj,compound,NNP-NNP,NNP,2,1
4717,38859.0,50,Labels,0,6,30,24,5,19,-6,30,Alberto Gonzales,US,PERSON-PERSON,ORGANIZATION,PROPN-PROPN,PROPN,compound-pobj,compound,NNP-NNP,NNP,12,1
4718,42638.0,41,said,5,4,1,-3,3,39,1,-4,Alberto Gonzales,US,PERSON-PERSON,COUNTRY,PROPN-PROPN,PROPN,compound-nsubj,compound,NNP-NNP,NNP,2,1
4719,49268.0,36,wrote,33,8,5,-3,7,30,25,-28,Alberto Gonzales,US,PERSON-PERSON,COUNTRY,PROPN-PROPN,PROPN,compound-dobj,compound,NNP-NNP,NNP,2,1
4720,60206.0,24,announced,7,5,2,-3,4,21,2,-5,Alberto Gonzales,US,PERSON-PERSON,COUNTRY,PROPN-PROPN,PROPN,compound-nsubj,compound,NNP-NNP,NNP,2,1
4721,11042.0,69,include,5,23,21,-2,22,47,-18,16,Jennifer Dunn,US,PERSON-PERSON,NATIONALITY,PROPN-PROPN,PROPN,compound-conj,compound,NNP-NNP,NNP,1,1
4722,11043.0,53,held,14,1,30,29,0,22,13,16,Murat Kurnaz,U.S.,PERSON-PERSON,COUNTRY,PROPN-PROPN,PROPN,compound-compound,nmod,NNP-NNP,NNP,6,1
4723,11050.0,57,said,12,21,33,12,20,23,-9,21,American Bankers Association,Massachusetts,ORGANIZATION-ORGANIZATION-ORGANIZATION,STATE_OR_PROVINCE,PROPN-PROPN-PROPN,PROPN,compound-compound-pobj,poss,NNP-NNPS-NNP,NNP,7,1
4724,11053.0,17,said,4,1,3,2,0,13,3,-1,IPSCO,David Sutherland,ORGANIZATION,PERSON-PERSON,NOUN,PROPN-PROPN,compound,compound-nsubj,NN,NNP-NNP,1,1
4725,26332.0,15,said,4,1,3,2,0,11,3,-1,IPSCO,David Sutherland,ORGANIZATION,PERSON-PERSON,NOUN,PROPN-PROPN,compound,compound-nsubj,NN,NNP-NNP,1,1
4726,36148.0,23,said,5,1,4,3,0,18,4,-1,IPSCO,David Sutherland,ORGANIZATION,PERSON-PERSON,PROPN,PROPN-PROPN,compound,compound-nsubj,NNP,NNP-NNP,2,1
4727,11061.0,37,skinny,1,21,18,-3,20,18,-20,17,NFC South,Falcons,ORGANIZATION-ORGANIZATION,ORGANIZATION,PROPN-PROPN,PROPN,compound-pobj,dobj,NNP-NNP,NNPS,1,1
4728,16979.0,31,hold,3,13,3,-10,12,27,-10,0,NFC South,Falcons,ORGANIZATION-ORGANIZATION,ORGANIZATION,PROPN-PROPN,PROPN,compound-compound,nsubj,NNP-NNP,NNPS,4,1
4729,11065.0,22,include,3,1,13,12,0,8,2,10,His,Shanghai Institute of Haematology,PERSON,ORGANIZATION-ORGANIZATION-ORGANIZATION-ORGANIZATION,DET,PROPN-PROPN-ADP-PROPN,poss,compound-conj-prep-pobj,PRP$,NNP-NNP-IN-NNP,8,1
4730,11067.0,26,said,24,1,10,9,0,15,23,-14,Focus on the Family,1977,ORGANIZATION-ORGANIZATION-ORGANIZATION-ORGANIZATION,DATE,VERB-ADP-DET-PROPN,NUM,advcl-prep-det-pobj,pobj,VB-IN-DT-NNP,CD,3,1
4731,11077.0,37,said,26,13,28,15,12,8,13,2,the group,C Dixon Osburn,ORGANIZATION-ORGANIZATION,PERSON-PERSON-PERSON,DET-NOUN,PROPN-PROPN-PROPN,det-poss,compound-compound-nsubj,DT-NN,NNP-NNP-NNP,9,1
4732,11078.0,62,2009-05-01T11,0,10,55,45,9,6,-10,55,Ontario Human Rights Commission,Canada,ORGANIZATION-ORGANIZATION-ORGANIZATION-ORGANIZATION,COUNTRY,PROPN-PROPN-PROPN-PROPN,PROPN,compound-compound-compound-pobj,poss,NNP-NNP-NNPS-NNP,NNP,5,1
4733,11081.0,40,died,7,1,15,14,0,24,6,8,Deaver,Maryland,PERSON,STATE_OR_PROVINCE,PROPN,PROPN,nsubj,appos,NNP,NNP,3,1
4734,11086.0,17,Binoche,1,1,15,14,0,1,0,14,Juliette Binoche,director,PERSON-PERSON,TITLE,PROPN-PROPN,NOUN,compound-ROOT,compound,NNP-NNP,NN,3,1
4735,11098.0,33,took,1,1,8,7,0,24,0,7,DeBlanc,Guadalcanal,PERSON,LOCATION,PROPN,PROPN,nsubj,pobj,NNP,NNP,1,1
4736,31128.0,35,took,16,8,20,12,7,14,8,4,DeBlanc,Guadalcanal,PERSON,LOCATION,PROPN,PROPN,nsubj,pobj,NNP,NNP,3,1
4737,11114.0,36,said,20,7,6,-1,6,29,13,-14,Mitchell,Congressman,PERSON,TITLE,PROPN,PROPN,nsubj,compound,NNP,NNP,1,1
4738,11124.0,21,was,7,13,4,-9,12,16,-6,-3,Philadelphia Inquirer,Joseph I. Gradel,ORGANIZATION-ORGANIZATION,PERSON-PERSON-PERSON,PROPN-PROPN,PROPN-PROPN-PROPN,compound-pobj,compound-compound-appos,NNP-NNP,NNP-NNP-NNP,6,1
4739,11135.0,32,continue,4,24,29,5,23,2,-20,25,Moro Islamic Liberation Front,MILF,ORGANIZATION-ORGANIZATION-ORGANIZATION-ORGANIZATION,RELIGION,PROPN-PROPN-PROPN-PROPN,PROPN,compound-compound-compound-appos,compound,NNP-NNP-NNP-NNP,NNP,15,1
4740,11143.0,32,says,14,1,8,7,0,23,13,-6,ConAgra Foods,Boyardee,ORGANIZATION-ORGANIZATION,PERSON,PROPN-PROPN,PROPN,compound-nsubj,pobj,NNP-NNP,NNP,4,1
4741,11149.0,10,said,8,7,4,-3,6,5,1,-4,her,bladder cancer,PERSON,CAUSE_OF_DEATH-CAUSE_OF_DEATH,DET,NOUN-NOUN,poss,compound-attr,PRP$,NN-NN,3,1
4742,11152.0,27,seen,4,9,2,-7,8,24,-5,-2,her,23-year-old,PERSON,NUMBER,DET,NOUN,poss,nsubjpass,PRP$,NN,4,1
4743,11163.0,25,asked,23,2,15,13,1,9,21,-8,Bachelor,MA,PERSON,STATE_OR_PROVINCE,PROPN,PROPN,dep,appos,NNP,NNP,3,1
4744,11165.0,36,opened,8,30,28,-2,29,7,-22,20,Li Jie,Chinese defender,PERSON-PERSON,TITLE-TITLE,PROPN-PROPN,ADJ-NOUN,compound-pobj,amod-compound,NNP-NNP,JJ-NN,1,1
4745,11173.0,40,say,14,6,10,4,5,29,8,-4,Canadian National Railway,CN,ORGANIZATION-ORGANIZATION-ORGANIZATION,ORGANIZATION,PROPN-PROPN-PROPN,PROPN,compound-compound-compound,compound,NNP-NNP-NNP,NNP,-1,1
4746,11194.0,28,called,12,10,1,-9,9,26,2,-11,Haifa University,Oren Gazal-Ayal,ORGANIZATION-ORGANIZATION,PERSON-PERSON,PROPN-PROPN,PROPN-PROPN,compound-pobj,compound-nsubj,NNP-NNP,NNP-NNP,3,1
4747,11197.0,41,is,15,38,24,-14,37,16,-23,9,University of Haifa,Eli Avraham,ORGANIZATION-ORGANIZATION-ORGANIZATION,ORGANIZATION-ORGANIZATION,PROPN-ADP-PROPN,PROPN-PROPN,pobj-prep-pobj,compound-pobj,NNP-IN-NNP,NNP-NNP,7,1
4748,15704.0,32,taken,3,29,15,-14,28,16,-26,12,University of Haifa,Eli Avraham,ORGANIZATION-ORGANIZATION-ORGANIZATION,PERSON-PERSON,PROPN-ADP-PROPN,PROPN-PROPN,pobj-prep-pobj,compound-pobj,NNP-IN-NNP,NNP-NNP,4,1
4749,11199.0,37,was,11,25,32,7,24,4,-14,21,Professional Rodeo Cowboys Association,he,ORGANIZATION-ORGANIZATION-ORGANIZATION-ORGANIZATION,PERSON,PROPN-PROPN-PROPN-PROPN,PRON,compound-compound-compound-pobj,nsubj,NNP-NNP-NNPS-NNP,PRP,7,1
4750,11202.0,25,Ali,4,4,1,-3,3,23,0,-3,Gholam Ali Hadad-Adel,Iranian,PERSON-PERSON-PERSON,NATIONALITY,PROPN-PROPN-PROPN,ADJ,compound-ROOT-nsubj,amod,NNP-NNP-NNP,JJ,3,1
4751,11203.0,49,acquired,7,5,39,34,4,9,2,32,Jackson Hewitt,Detroit,ORGANIZATION-ORGANIZATION,CITY,PROPN-PROPN,PROPN,compound-compound,pobj,NNP-NNP,NNP,3,1
4752,11206.0,33,said,18,18,25,7,17,7,0,7,he,New York,PERSON,STATE_OR_PROVINCE-STATE_OR_PROVINCE,PRON,PROPN-PROPN,nsubj,compound-pobj,PRP,NNP-NNP,6,1
4753,37431.0,45,followed,22,22,10,-12,21,34,0,-12,he,New York,PERSON,STATE_OR_PROVINCE-STATE_OR_PROVINCE,PRON,PROPN-PROPN,nsubj,compound-compound,PRP,NNP-NNP,5,1
4754,11209.0,20,listed,9,8,5,-3,7,14,1,-4,FMR Corp,Fidelity,ORGANIZATION-ORGANIZATION,ORGANIZATION,PROPN-PROPN,PROPN,compound-pobj,compound,NNP-NNP,NNP,2,1
4755,60489.0,47,'s,1,45,26,-19,44,20,-44,25,FMR Corp,Fidelity,ORGANIZATION-ORGANIZATION,ORGANIZATION,PROPN-PROPN,PROPN,compound-pobj,poss,NNP-NNP,NNP,13,1
4756,11211.0,41,says,13,19,19,0,18,21,-6,6,New York Immigration Coalition,New York State,ORGANIZATION-ORGANIZATION-ORGANIZATION-ORGANIZATION,LOCATION-LOCATION-LOCATION,PROPN-PROPN-PROPN-PROPN,PROPN-PROPN-PROPN,compound-compound-compound-pobj,compound-compound-pobj,NNP-NNP-NNP-NNP,NNP-NNP-NNP,0,1
4757,11221.0,22,rose,2,1,18,17,0,3,1,16,IPSCO,New York Stock Exchange,ORGANIZATION,ORGANIZATION-ORGANIZATION-ORGANIZATION-ORGANIZATION,NOUN,PROPN-PROPN-PROPN-PROPN,compound,compound-compound-compound-pobj,NN,NNP-NNP-NNP-NNP,5,1
4758,28942.0,30,valued,5,4,14,10,3,15,1,9,IPSCO,New York Stock Exchange,ORGANIZATION,ORGANIZATION-ORGANIZATION-ORGANIZATION-ORGANIZATION,PROPN,PROPN-PROPN-PROPN-PROPN,nsubjpass,compound-compound-compound-pobj,NNP,NNP-NNP-NNP-NNP,4,1
4759,40492.0,35,valued,5,4,19,15,3,15,1,14,IPSCO,New York Stock Exchange,ORGANIZATION,ORGANIZATION-ORGANIZATION-ORGANIZATION-ORGANIZATION,PROPN,PROPN-PROPN-PROPN-PROPN,nsubjpass,compound-compound-compound-pobj,NNP,NNP-NNP-NNP-NNP,4,1
4760,11222.0,32,is,14,25,28,3,24,3,-11,14,Haifa University,School of Political Science,ORGANIZATION-ORGANIZATION,ORGANIZATION-ORGANIZATION-ORGANIZATION-ORGANIZATION,PROPN-PROPN,PROPN-ADP-PROPN-PROPN,compound-poss,pobj-prep-compound-pobj,NNP-NNP,NNP-IN-NNP-NNP,2,1
4761,11224.0,48,died,37,1,47,46,0,0,36,10,Lorraine Rothman,Calif,PERSON-PERSON,STATE_OR_PROVINCE,PROPN-PROPN,PROPN,compound-nsubj,appos,NNP-NNP,NNP,2,1
4762,11232.0,12,Sr.,4,2,1,-1,1,10,2,-3,Jefferson J. DeBlanc,Col.,PERSON-PERSON-PERSON,TITLE,PROPN-PROPN-PROPN,PROPN,compound-compound-compound,compound,NNP-NNP-NNP,NNP,2,1
4763,11237.0,35,rumored,14,33,29,-4,32,5,-19,15,NEC,National Economics Council,ORGANIZATION,ORGANIZATION-ORGANIZATION-ORGANIZATION,PROPN,PROPN-PROPN-PROPN,compound,compound-compound-pobj,NNP,NNP-NNP-NNP,9,1
4764,11245.0,9,Feb.,0,5,8,3,4,0,-5,8,George Kennedy,82,PERSON-PERSON,NUMBER,PROPN-PROPN,NUM,compound-nsubj,attr,NNP-NNP,CD,2,1
4765,11251.0,48,reported,46,30,25,-5,29,22,16,-21,Simon Cowell,Syco Music,PERSON-PERSON,ORGANIZATION-ORGANIZATION,PROPN-PROPN,PROPN-PROPN,compound-pobj,compound-pobj,NNP-NNP,NNP-NNP,8,1
4766,11256.0,44,reduce,37,7,5,-2,6,38,30,-32,Focus on the Family,evangelical,ORGANIZATION-ORGANIZATION-ORGANIZATION-ORGANIZATION,RELIGION,PROPN-ADP-DET-PROPN,ADJ,appos-prep-det-pobj,amod,NNP-IN-DT-NNP,JJ,2,1
4767,11606.0,46,said,15,11,7,-4,10,38,4,-8,Focus on the Family,evangelical,ORGANIZATION-ORGANIZATION-ORGANIZATION-ORGANIZATION,RELIGION,PROPN-ADP-DET-PROPN,ADJ,appos-prep-det-pobj,amod,NNP-IN-DT-NNP,JJ,4,1
4768,34981.0,43,describes,12,39,37,-2,38,5,-27,25,Focus on the Family,evangelical,ORGANIZATION-ORGANIZATION-ORGANIZATION-ORGANIZATION,RELIGION,PROPN-ADP-DET-PROPN,ADJ,appos-prep-det-pobj,amod,NNP-IN-DT-NNP,JJ,2,1
4769,45739.0,43,sent,22,18,16,-2,17,26,4,-6,Focus on the Family,evangelical,ORGANIZATION-ORGANIZATION-ORGANIZATION-ORGANIZATION,RELIGION,PROPN-ADP-DET-PROPN,ADJ,appos-prep-det-pobj,amod,NNP-IN-DT-NNP,JJ,2,1
4770,66263.0,34,says,23,20,18,-2,19,15,3,-5,Focus on the Family,evangelical,ORGANIZATION-ORGANIZATION-ORGANIZATION-ORGANIZATION,RELIGION,PROPN-ADP-DET-PROPN,ADJ,appos-prep-det-pobj,amod,NNP-IN-DT-NNP,JJ,2,1
4771,11257.0,18,forwarding,2,7,17,10,6,0,-5,15,George Kennedy,York,PERSON-PERSON,CITY,PROPN-PROPN,PROPN,compound-pobj,conj,NNP-NNP,NNP,4,1
4772,11260.0,24,scheduled,6,19,22,3,18,1,-13,16,FAW,Zhu Yanfeng,ORGANIZATION,PERSON-PERSON,PROPN,PROPN-PROPN,compound,compound-appos,NNP,NNP-NNP,1,1
4773,25015.0,26,appointed,16,12,1,-11,11,24,4,-15,FAW,Zhu Yanfeng,ORGANIZATION,PERSON-PERSON,PROPN,PROPN-PROPN,compound,compound-nsubjpass,NNP,NNP-NNP,4,1
4774,50666.0,38,said,36,1,35,34,0,2,35,-1,FAW,Zhu Yanfeng,ORGANIZATION,PERSON-PERSON,PROPN,PROPN-PROPN,nsubj,compound-appos,NNP,NNP-NNP,4,1
4775,11263.0,21,asked,2,19,10,-9,18,10,-17,8,Beverly Sills,commentator,PERSON-PERSON,TITLE,PROPN-PROPN,NOUN,compound-appos,poss,NNP-NNP,NN,6,1
4776,11269.0,25,Gude,2,22,1,-21,21,23,-20,-1,Gilbert Gude,Jane Callahan Gude,PERSON-PERSON,PERSON-PERSON-PERSON,PROPN-PROPN,PROPN-PROPN-PROPN,compound-appos,compound-compound-ROOT,NNP-NNP,NNP-NNP-NNP,6,1
4777,11272.0,62,realize,1,27,21,-6,26,40,-26,20,David Banda,her,PERSON-PERSON,PERSON,PROPN-PROPN,DET,compound-pobj,poss,NNP-NNP,PRP$,3,1
4778,11282.0,35,been,13,3,7,4,2,27,10,-6,driver,Anthony,PERSON,PERSON,NOUN,PROPN,nsubj,appos,NN,NNP,5,1
4779,11295.0,47,allow,13,8,4,-4,7,42,5,-9,Christopher Dodd,Senate Banking Committee,PERSON-PERSON,ORGANIZATION-ORGANIZATION-ORGANIZATION,PROPN-PROPN,PROPN-PROPN-PROPN,compound-pobj,compound-compound-compound,NNP-NNP,NNP-NNP-NNP,3,1
4780,11297.0,25,VERITY-OBIT-MCC,0,22,18,-4,21,6,-22,18,William Verity,Elizabeth O'Brien,PERSON-PERSON,PERSON-PERSON,PROPN-PROPN,PROPN-PROPN,compound-compound,compound-pobj,NNP-NNP,NNP-NNP,3,1
4781,11302.0,44,said,7,26,40,14,25,3,-19,33,Andre Carson,Georgia,PERSON-PERSON,STATE_OR_PROVINCE,PROPN-PROPN,PROPN,compound-ROOT,pobj,NNP-NNP,NNP,5,1
4782,11316.0,28,2010-02-14T22,0,7,10,3,6,17,-7,10,Spencer Pratt,26,PERSON-PERSON,NUMBER,PROPN-PROPN,NUM,compound-pobj,appos,NNP-NNP,CD,2,1
4783,59534.0,44,wanted,2,37,40,3,36,3,-35,38,Spencer Pratt,26,PERSON-PERSON,NUMBER,PROPN-PROPN,NUM,compound-nsubj,appos,NNP-NNP,CD,3,1
4784,60446.0,52,Pratt,1,1,37,36,0,14,0,36,Spencer Pratt,26,PERSON-PERSON,NUMBER,PROPN-PROPN,NUM,compound-ROOT,appos,NNP-NNP,CD,-1,1
4785,11382.0,15,said,2,4,14,10,3,0,-2,12,he,India,PERSON,COUNTRY,PRON,PROPN,nsubj,pobj,PRP,NNP,3,1
4786,11384.0,19,tweeted,5,3,1,-2,2,17,2,-4,Dan Abrams,Mediaite,PERSON-PERSON,ORGANIZATION,PROPN-PROPN,ADJ,compound-nsubj,amod,NNP-NNP,JJ,1,1
4787,11389.0,54,announced,10,8,20,12,7,33,2,10,Detroit Medical Center,Vanguard Health Systems,ORGANIZATION-ORGANIZATION-ORGANIZATION,ORGANIZATION-ORGANIZATION-ORGANIZATION,PROPN-PROPN-PROPN,PROPN-PROPN-PROPN,compound-compound-nsubj,compound-compound-pobj,NNP-NNP-NNP,NNP-NNP-NNPS,6,1
4788,11403.0,19,is,15,11,2,-9,10,16,4,-13,Focus on the Family,Mr Dobson,ORGANIZATION-ORGANIZATION-ORGANIZATION-ORGANIZATION,PERSON-PERSON,PROPN-ADP-DET-PROPN,PROPN-PROPN,appos-prep-det-pobj,compound-nsubj,NNP-IN-DT-NNP,NNP-NNP,5,1
4789,11407.0,22,was,9,1,11,10,0,10,8,2,Ezra Levant,publisher,PERSON-PERSON,TITLE,PROPN-PROPN,NOUN,compound-nsubj,attr,NNP-NNP,NN,3,1
4790,11422.0,37,said,13,1,8,7,0,28,12,-5,Lou Ferrara,editor,PERSON-PERSON,TITLE,PROPN-PROPN,NOUN,compound-nsubj,appos,NNP-NNP,NN,2,1
4791,66399.0,32,said,11,1,8,7,0,23,10,-3,Lou Ferrara,editor,PERSON-PERSON,TITLE,PROPN-PROPN,NOUN,compound-nsubj,appos,NNP-NNP,NN,2,1
4792,11444.0,37,made,2,11,16,5,10,20,-9,14,Moro National Liberation Front,MNLF,ORGANIZATION-ORGANIZATION-ORGANIZATION-ORGANIZATION,ORGANIZATION,PROPN-PROPN-PROPN-PROPN,PROPN,compound-compound-compound-pobj,compound,NNP-NNP-NNP-NNP,NNP,7,1
4793,15460.0,23,camp,1,8,13,5,7,9,-7,12,Moro National Liberation Front,MNLF,ORGANIZATION-ORGANIZATION-ORGANIZATION-ORGANIZATION,ORGANIZATION,PROPN-PROPN-PROPN-PROPN,PROPN,compound-compound-compound-pobj,compound,NNP-NNP-NNP-NNP,NNP,6,1
4794,15537.0,50,is,1,7,12,5,6,37,-6,11,Moro National Liberation Front,MNLF,ORGANIZATION-ORGANIZATION-ORGANIZATION-ORGANIZATION,ORGANIZATION,PROPN-PROPN-PROPN-PROPN,PROPN,compound-compound-compound-pobj,compound,NNP-NNP-NNP-NNP,NNP,5,1
4795,16904.0,41,said,37,14,19,5,13,21,23,-18,Moro National Liberation Front,MNLF,ORGANIZATION-ORGANIZATION-ORGANIZATION-ORGANIZATION,ORGANIZATION,PROPN-PROPN-PROPN-PROPN,PROPN,compound-compound-compound-pobj,compound,NNP-NNP-NNP-NNP,NNP,8,1
4796,19210.0,35,said,33,4,9,5,3,25,29,-24,Moro National Liberation Front,MNLF,ORGANIZATION-ORGANIZATION-ORGANIZATION-ORGANIZATION,ORGANIZATION,PROPN-PROPN-PROPN-PROPN,PROPN,compound-compound-compound-pobj,compound,NNP-NNP-NNP-NNP,NNP,4,1
4797,34061.0,44,said,1,9,14,5,8,29,-8,13,Moro National Liberation Front,MNLF,ORGANIZATION-ORGANIZATION-ORGANIZATION-ORGANIZATION,ORGANIZATION,PROPN-PROPN-PROPN-PROPN,PROPN,compound-compound-compound-pobj,compound,NNP-NNP-NNP-NNP,NNP,6,1
4798,40291.0,43,said,39,2,7,5,1,35,37,-32,Moro National Liberation Front,MNLF,ORGANIZATION-ORGANIZATION-ORGANIZATION-ORGANIZATION,ORGANIZATION,PROPN-PROPN-PROPN-PROPN,PROPN,compound-compound-compound-nsubj,compound,NNP-NNP-NNP-NNP,NNP,2,1
4799,43664.0,28,reached,24,6,11,5,5,16,18,-13,Moro National Liberation Front,MNLF,ORGANIZATION-ORGANIZATION-ORGANIZATION-ORGANIZATION,ORGANIZATION,PROPN-PROPN-PROPN-PROPN,PROPN,compound-compound-compound-pobj,compound,NNP-NNP-NNP-NNP,NNP,5,1
4800,54942.0,29,is,1,11,16,5,10,12,-10,15,Moro National Liberation Front,MNLF,ORGANIZATION-ORGANIZATION-ORGANIZATION-ORGANIZATION,ORGANIZATION,PROPN-PROPN-PROPN-PROPN,PROPN,compound-compound-compound-appos,compound,NNP-NNP-NNP-NNP,NNP,6,1
4801,59273.0,25,is,2,18,23,5,17,1,-16,21,Moro National Liberation Front,MNLF,ORGANIZATION-ORGANIZATION-ORGANIZATION-ORGANIZATION,ORGANIZATION,PROPN-PROPN-PROPN-PROPN,PROPN,compound-compound-compound-appos,compound,NNP-NNP-NNP-NNP,NNP,-1,1
4802,59642.0,32,took,18,4,9,5,3,22,14,-9,Moro National Liberation Front,MNLF,ORGANIZATION-ORGANIZATION-ORGANIZATION-ORGANIZATION,ORGANIZATION,PROPN-PROPN-PROPN-PROPN,PROPN,compound-compound-compound-pobj,compound,NNP-NNP-NNP-NNP,NNP,5,1
4803,67430.0,34,raging,24,9,14,5,8,19,15,-10,Moro National Liberation Front,MNLF,ORGANIZATION-ORGANIZATION-ORGANIZATION-ORGANIZATION,ORGANIZATION,PROPN-PROPN-PROPN-PROPN,PROPN,compound-compound-compound-pobj,compound,NNP-NNP-NNP-NNP,NNP,8,1
4804,11454.0,25,ATLANTA,0,19,12,-7,18,12,-19,12,his,Los Angeles,PERSON,CITY-CITY,DET,PROPN-PROPN,poss,compound-pobj,PRP$,NNP-NNP,6,1
4805,11463.0,31,graduated,19,19,5,-14,18,25,0,-14,she,Pa,PERSON,STATE_OR_PROVINCE,PRON,PROPN,nsubj,conj,PRP,NNP,5,1
4806,11467.0,28,has,2,12,7,-5,11,20,-10,5,Barbara Boxer,U.S.,PERSON-PERSON,COUNTRY,PROPN-PROPN,PROPN,compound-conj,compound,NNP-NNP,NNP,2,1
4807,39458.0,37,declared,4,3,1,-2,2,35,1,-3,Barbara Boxer,U.S.,PERSON-PERSON,COUNTRY,PROPN-PROPN,PROPN,compound-nsubj,compound,NNP-NNP,NNP,1,1
4808,43253.0,45,announced,6,19,22,3,18,22,-13,16,Barbara Boxer,U.S.,PERSON-PERSON,COUNTRY,PROPN-PROPN,PROPN,compound-poss,compound,NNP-NNP,NNP,2,1
4809,47775.0,46,used,7,6,4,-2,5,41,1,-3,Barbara Boxer,U.S.,PERSON-PERSON,COUNTRY,PROPN-PROPN,PROPN,compound-conj,compound,NNP-NNP,NNP,1,1
4810,11481.0,21,elected,2,1,6,5,0,14,1,4,Mitchell,U.S. House of Representatives,PERSON,ORGANIZATION-ORGANIZATION-ORGANIZATION-ORGANIZATION,PROPN,PROPN-PROPN-ADP-PROPN,nsubjpass,compound-pobj-prep-pobj,NNP,NNP-NNP-IN-NNPS,3,1
4811,30512.0,21,elected,2,1,6,5,0,14,1,4,Mitchell,U.S. House of Representatives,PERSON,ORGANIZATION-ORGANIZATION-ORGANIZATION-ORGANIZATION,PROPN,PROPN-PROPN-ADP-PROPN,nsubjpass,compound-pobj-prep-pobj,NNP,NNP-NNP-IN-NNPS,3,1
4812,11487.0,38,revealed,7,5,25,20,4,12,2,18,Ali Akbar Salehi,Tehran,PERSON-PERSON-PERSON,LOCATION,PROPN-PROPN-PROPN,PROPN,compound-compound-appos,poss,NNP-NNP-NNP,NNP,9,1
4813,33808.0,37,acknowledged,7,5,23,18,4,13,2,16,Ali Akbar Salehi,Tehran,PERSON-PERSON-PERSON,LOCATION,PROPN-PROPN-PROPN,PROPN,compound-compound-nsubj,poss,NNP-NNP-NNP,NNP,4,1
4814,11497.0,34,said,21,31,23,-8,30,10,-10,2,International Monetary Fund,John Lipskey,ORGANIZATION-ORGANIZATION-ORGANIZATION,PERSON-PERSON,PROPN-PROPN-PROPN,PROPN-PROPN,compound-compound-pobj,compound-nsubj,NNP-NNP-NNP,NNP-NNP,5,1
4815,11501.0,34,had,2,1,10,9,0,23,1,8,Castro,Alina Fernandez Revuelta,PERSON,PERSON-PERSON-PERSON,PROPN,PROPN-PROPN-PROPN,nsubj,compound-compound-appos,NNP,NNP-NNP-NNP,3,1
4816,11506.0,34,canceled,2,19,16,-3,18,17,-17,14,USA Network,Texas,ORGANIZATION-ORGANIZATION,STATE_OR_PROVINCE,PROPN-PROPN,PROPN,compound-nsubj,appos,NNP-NNP,NNP,7,1
4817,11509.0,26,collected,3,13,9,-4,12,16,-10,6,Old Lane Partners,his,ORGANIZATION-ORGANIZATION-ORGANIZATION,PERSON,PROPN-PROPN-PROPN,DET,compound-compound-appos,poss,NNP-NNP-NNPS,PRP$,6,1
4818,11516.0,34,born,4,1,26,25,0,7,3,22,Philip Mayer Kaiser,Tema Sloven Kaiser,PERSON-PERSON-PERSON,PERSON-PERSON-PERSON,PROPN-PROPN-PROPN,PROPN-PROPN-PROPN,compound-compound-nsubjpass,compound-compound-conj,NNP-NNP-NNP,NNP-NNP-NNP,11,1
4819,32456.0,34,born,4,1,26,25,0,7,3,22,Philip Mayer Kaiser,Tema Sloven Kaiser,PERSON-PERSON-PERSON,PERSON-PERSON-PERSON,PROPN-PROPN-PROPN,PROPN-PROPN-PROPN,compound-compound-nsubjpass,compound-compound-conj,NNP-NNP-NNP,NNP-NNP-NNP,9,1
4820,11517.0,18,fell,4,4,16,12,3,1,0,12,he,New Britain,PERSON,CITY-CITY,PRON,PROPN-PROPN,nsubj,compound-pobj,PRP,NNP-NNP,6,1
4821,38056.0,22,ran,11,11,8,-3,10,13,0,-3,he,New Britain,PERSON,CITY-CITY,PRON,PROPN-PROPN,nsubj,compound-pobj,PRP,NNP-NNP,4,1
4822,11519.0,23,calls,3,14,10,-4,13,12,-11,7,Raul,vice president,PERSON,TITLE-TITLE,PROPN,NOUN-NOUN,appos,compound-nsubj,NNP,NN-NN,3,1
4823,11532.0,28,was,6,8,22,14,7,5,-2,16,John Dewey,atheism,PERSON-PERSON,RELIGION,PROPN-PROPN,NOUN,compound-attr,pobj,NNP-NNP,NN,3,1
4824,11537.0,29,songstress,1,3,2,-1,2,26,-2,1,Alexandra Burke,songstress,PERSON-PERSON,TITLE,PROPN-PROPN,NOUN,compound-nsubj,ROOT,NNP-NNP,NN,1,1
4825,45194.0,23,scheduled,5,3,2,-1,2,20,2,-3,Alexandra Burke,songstress,PERSON-PERSON,TITLE,PROPN-PROPN,NOUN,compound-nsubjpass,compound,NNP-NNP,NN,1,1
4826,11538.0,26,accused,3,21,14,-7,20,11,-18,11,Hussein Kamel,Saddam,PERSON-PERSON,PERSON,PROPN-PROPN,PROPN,compound-ROOT,poss,NNP-NNP,NNP,12,1
4827,18031.0,46,was,12,10,4,-6,9,41,2,-8,Hussein Kamel,Saddam,PERSON-PERSON,PERSON,PROPN-PROPN,PROPN,compound-appos,poss,NNP-NNP,NNP,4,1
4828,24242.0,40,indicated,4,25,22,-3,24,17,-21,18,Hussein Kamel,Saddam,PERSON-PERSON,PERSON,PROPN-PROPN,PROPN,compound-appos,poss,NNP-NNP,NNP,3,1
4829,34619.0,46,was,12,10,4,-6,9,41,2,-8,Hussein Kamel,Saddam,PERSON-PERSON,PERSON,PROPN-PROPN,PROPN,compound-appos,poss,NNP-NNP,NNP,4,1
4830,58523.0,32,explained,13,1,4,3,0,27,12,-9,Hussein Kamel,Saddam,PERSON-PERSON,PERSON,PROPN-PROPN,PROPN,compound-nsubj,poss,NNP-NNP,NNP,3,1
4831,11539.0,8,Information,0,5,8,3,4,-1,-5,8,Philadelphia Inquirer,http://www.philly.com,ORGANIZATION-ORGANIZATION,URL,PROPN-PROPN,X,compound-pobj,appos,NNP-NNP,ADD,-1,1
4832,11547.0,40,said,32,1,7,6,0,32,31,-25,Aerolineas Argentinas,Grupo Marsans,ORGANIZATION-ORGANIZATION,ORGANIZATION-ORGANIZATION,PROPN-PROPN,PROPN-PROPN,compound-poss,compound-appos,NNP-NNP,NNP-NNP,3,1
4833,23533.0,26,AIRES,1,20,15,-5,19,10,-19,14,Aerolineas Argentinas,Grupo Marsans,ORGANIZATION-ORGANIZATION,ORGANIZATION-ORGANIZATION,PROPN-PROPN,PROPN-PROPN,compound-dobj,compound-pobj,NNP-NNP,NNP-NNP,3,1
4834,30051.0,26,operated,4,11,7,-4,10,18,-7,3,Aerolineas Argentinas,Grupo Marsans,ORGANIZATION-ORGANIZATION,ORGANIZATION-ORGANIZATION,PROPN-PROPN,PROPN-PROPN,compound-appos,compound-compound,NNP-NNP,NNP-NNPS,2,1
4835,48712.0,44,s,2,29,4,-25,28,39,-27,2,Aerolineas Argentinas,Grupo Marsans,ORGANIZATION-ORGANIZATION,ORGANIZATION-ORGANIZATION,PROPN-PROPN,PROPN-PROPN,compound-appos,compound-compound,NNP-NNP,NNP-NNPS,3,1
4836,11550.0,28,stated,2,6,9,3,5,18,-4,7,ADB,Zhao Xiaoyu,ORGANIZATION,PERSON-PERSON,PROPN,PROPN-PROPN,compound,compound-dobj,NNP,NNP-NNP,2,1
4837,11553.0,33,said,2,15,12,-3,14,20,-13,10,Federal Motor Carrier Safety Administration,Transportation Department,ORGANIZATION-ORGANIZATION-ORGANIZATION-ORGANIZATION-ORGANIZATION,ORGANIZATION-ORGANIZATION,PROPN-PROPN-PROPN-PROPN-PROPN,PROPN-PROPN,compound-compound-compound-compound-pobj,compound-poss,NNP-NNP-NNP-NNP-NNP,NNP-NNP,3,1
4838,11557.0,38,soared,10,33,1,-32,32,36,-23,-9,Kennedy Space Center,U.S.,ORGANIZATION-ORGANIZATION-ORGANIZATION,COUNTRY,PROPN-PROPN-PROPN,PROPN,compound-compound-pobj,compound,NNP-NNP-NNP,NNP,6,1
4839,62992.0,30,landed,5,9,2,-7,8,27,-4,-3,Kennedy Space Center,U.S.,ORGANIZATION-ORGANIZATION-ORGANIZATION,COUNTRY,PROPN-PROPN-PROPN,PROPN,compound-compound-pobj,compound,NNP-NNP-NNP,NNP,5,1
4840,11562.0,28,confirmed,4,21,7,-14,20,20,-17,3,Fyffes,Flavin,ORGANIZATION,PERSON,PROPN,PROPN,compound,poss,NNP,NNP,8,1
4841,17047.0,61,authorized,4,39,19,-20,38,41,-35,15,Fyffes,Flavin,ORGANIZATION,PERSON,PROPN,PROPN,pobj,pobj,NNP,NNP,4,1
4842,20230.0,58,authorized,4,36,19,-17,35,38,-32,15,Fyffes,Flavin,ORGANIZATION,PERSON,PROPN,PROPN,pobj,pobj,NNP,NNP,5,1
4843,36079.0,52,paid,8,30,26,-4,29,25,-22,18,Fyffes,Flavin,ORGANIZATION,PERSON,PROPN,PROPN,compound,poss,NNP,NNP,4,1
4844,38567.0,61,authorized,4,39,19,-20,38,41,-35,15,Fyffes,Flavin,ORGANIZATION,PERSON,PROPN,PROPN,compound,pobj,NNP,NNP,4,1
4845,47125.0,23,was,1,6,1,-5,5,21,-5,0,Fyffes,Flavin,ORGANIZATION,PERSON,PROPN,PROPN,pobj,nsubj,NNP,NNP,2,1
4846,49327.0,22,resigned,1,8,1,-7,7,20,-7,0,Fyffes,Flavin,ORGANIZATION,PERSON,PROPN,PROPN,compound,nsubj,NNP,NNP,4,1
4847,59191.0,61,authorized,4,39,19,-20,38,41,-35,15,Fyffes,Flavin,ORGANIZATION,PERSON,PROPN,PROPN,compound,pobj,NNP,NNP,4,1
4848,62089.0,58,authorized,4,36,19,-17,35,38,-32,15,Fyffes,Flavin,ORGANIZATION,PERSON,PROPN,PROPN,compound,pobj,NNP,NNP,5,1
4849,11570.0,49,said,7,21,10,-11,20,38,-14,3,he,Defense,PERSON,ORGANIZATION,PRON,PROPN,nsubj,compound,PRP,NNP,4,1
4850,11577.0,26,Season,0,4,21,17,3,4,-4,21,Trista,Ryan,PERSON,PERSON,PROPN,PROPN,dobj,appos,NNP,NNP,4,1
4851,18561.0,40,is,1,30,32,2,29,7,-29,31,Trista,Ryan,PERSON,PERSON,PROPN,PROPN,nsubjpass,conj,NNP,NNP,4,1
4852,34886.0,11,is,2,1,6,5,0,4,1,4,Trista,Ryan,PERSON,PERSON,PROPN,PROPN,npadvmod,appos,NNP,NNP,2,1
4853,11587.0,39,dogged,3,14,17,3,13,21,-11,14,Murat Kurnaz,24,PERSON-PERSON,NUMBER,PROPN-PROPN,NUM,compound-pobj,appos,NNP-NNP,CD,1,1
4854,30455.0,29,told,20,1,4,3,0,24,19,-16,Murat Kurnaz,24,PERSON-PERSON,NUMBER,PROPN-PROPN,NUM,compound-nsubj,appos,NNP-NNP,CD,2,1
4855,42317.0,40,been,9,4,7,3,3,32,5,-2,Murat Kurnaz,24,PERSON-PERSON,NUMBER,PROPN-PROPN,NUM,compound-pobj,appos,NNP-NNP,CD,4,1
4856,63811.0,32,detained,7,1,5,4,0,26,6,-2,Murat Kurnaz,24,PERSON-PERSON,NUMBER,PROPN-PROPN,NUM,compound-nsubjpass,appos,NNP-NNP,CD,2,1
4857,11594.0,34,drew,4,3,2,-1,2,31,1,-2,Carolyn Maloney,lawmaker,PERSON-PERSON,TITLE,PROPN-PROPN,NOUN,compound-nsubj,compound,NNP-NNP,NN,1,1
4858,52687.0,31,told,28,27,26,-1,26,4,1,-2,Carolyn Maloney,lawmaker,PERSON-PERSON,TITLE,PROPN-PROPN,NOUN,compound-nsubj,compound,NNP-NNP,NN,1,1
4859,55564.0,38,told,17,16,15,-1,15,22,1,-2,Carolyn Maloney,lawmaker,PERSON-PERSON,TITLE,PROPN-PROPN,NOUN,compound-nsubj,compound,NNP-NNP,NN,2,1
4860,11602.0,17,show,4,1,4,3,0,12,3,0,Cutrone,Bravo,PERSON,ORGANIZATION,PROPN,PROPN,poss,nsubj,NNP,NNP,2,1
4861,33605.0,17,2009-11-30T21,0,3,10,7,2,6,-3,10,Cutrone,Bravo,PERSON,ORGANIZATION,NOUN,PROPN,nsubj,pobj,NN,NNP,2,1
4862,11611.0,34,is,6,1,15,14,0,18,5,9,Shenyang,"16,000",ORGANIZATION,NUMBER,PROPN,NUM,nsubj,nummod,NNP,CD,6,1
4863,11612.0,13,born,2,1,7,6,0,5,1,5,She,"May 25 , 1929",PERSON,DATE-DATE-DATE-DATE,PRON,PROPN-NUM-PUNCT-NUM,nsubjpass,pobj-nummod-punct-nummod,PRP,"NNP-CD-,-CD",4,1
4864,11617.0,12,served,4,4,9,5,3,2,0,5,Davis,House of Delegates,PERSON,ORGANIZATION-ORGANIZATION-ORGANIZATION,PROPN,PROPN-ADP-PROPN,nsubj,pobj-prep-pobj,NNP,NNP-IN-NNPS,3,1
4865,19173.0,18,served,11,4,15,11,3,2,7,4,Davis,House of Delegates,PERSON,ORGANIZATION-ORGANIZATION-ORGANIZATION,PROPN,PROPN-ADP-PROPN,nsubj,pobj-prep-pobj,NNP,NNP-IN-NNPS,5,1
4866,11620.0,20,said,12,10,16,6,9,3,2,4,John F Kerry,Massachusetts,PERSON-PERSON-PERSON,STATE_OR_PROVINCE,PROPN-PROPN-PROPN,PROPN,compound-compound-nsubj,compound,NNP-NNP-NNP,NNP,6,1
4867,11633.0,37,ignored,4,4,27,23,3,9,0,23,NSC,U.S.,ORGANIZATION,COUNTRY,PROPN,PROPN,nsubj,compound,NNP,NNP,11,1
4868,11634.0,31,is,8,1,11,10,0,19,7,3,Cathie Black,author,PERSON-PERSON,TITLE,PROPN-PROPN,NOUN,compound-nsubj,attr,NNP-NNP,NN,3,1
4869,11636.0,29,said,17,6,13,7,5,15,11,-4,Professional Rodeo Cowboys Association,Colorado Springs,ORGANIZATION-ORGANIZATION-ORGANIZATION-ORGANIZATION,CITY-CITY,PROPN-PROPN-PROPN-PROPN,PROPN-PROPN,compound-compound-compound-pobj,compound-pobj,NNP-NNP-NNPS-NNP,NNP-NNP,6,1
4870,43803.0,30,said,11,21,26,5,20,3,-10,15,Professional Rodeo Cowboys Association,Colorado Springs,ORGANIZATION-ORGANIZATION-ORGANIZATION-ORGANIZATION,CITY-CITY,PROPN-PROPN-PROPN-PROPN,PROPN-PROPN,compound-compound-compound-pobj,compound-pobj,NNP-NNP-NNPS-NNP,NNP-NNP,3,1
4871,11641.0,42,appointed,7,1,33,32,0,8,6,26,Philip Chen,deputy chairman,PERSON-PERSON,TITLE-TITLE,PROPN-PROPN,NOUN-NOUN,compound-nsubjpass,compound-pobj,NNP-NNP,NN-NN,4,1
4872,24295.0,42,appointed,7,1,33,32,0,8,6,26,Philip Chen,deputy chairman,PERSON-PERSON,TITLE-TITLE,PROPN-PROPN,NOUN-NOUN,compound-nsubjpass,compound-pobj,NNP-NNP,NN-NN,4,1
4873,11656.0,22,is,1,12,11,-1,11,10,-11,10,Chad White,model,PERSON-PERSON,TITLE,PROPN-PROPN,NOUN,compound-appos,nsubj,NNP-NNP,NN,1,1
4874,20599.0,9,likes,4,3,2,-1,2,6,1,-2,Chad White,model,PERSON-PERSON,TITLE,PROPN-PROPN,NOUN,compound-nsubj,compound,NNP-NNP,NN,1,1
4875,50020.0,36,become,33,3,7,4,2,28,30,-26,Chad White,model,PERSON-PERSON,TITLE,PROPN-PROPN,NOUN,compound-dobj,appos,NNP-NNP,NN,2,1
4876,11659.0,28,accused,1,3,7,4,2,20,-2,6,him,Revolutionary Guards,PERSON,ORGANIZATION-ORGANIZATION,PRON,PROPN-PROPN,dobj,compound-dobj,PRP,NNP-NNPS,2,1
4877,11661.0,34,speculated,18,8,1,-7,7,32,10,-17,Badr Organization,Hadi al-Amari,ORGANIZATION-ORGANIZATION,PERSON-PERSON,PROPN-PROPN,PROPN-ADV,compound-pobj,compound-nsubj,NNP-NNP,NNP-RB,5,1
4878,11663.0,51,POPULATION,1,34,34,0,33,16,-33,33,New York Immigration Coalition,New York,ORGANIZATION-ORGANIZATION-ORGANIZATION-ORGANIZATION,STATE_OR_PROVINCE-STATE_OR_PROVINCE,PROPN-PROPN-PROPN-PROPN,PROPN-PROPN,compound-compound-compound-conj,compound-compound,NNP-NNP-NNP-NNP,NNP-NNP,0,1
4879,16972.0,59,planning,7,2,2,0,1,56,5,-5,New York Immigration Coalition,New York,ORGANIZATION-ORGANIZATION-ORGANIZATION-ORGANIZATION,STATE_OR_PROVINCE-STATE_OR_PROVINCE,PROPN-PROPN-PROPN-PROPN,PROPN-PROPN,compound-compound-compound-pobj,compound-pobj,NNP-NNP-NNP-NNP,NNP-NNP,0,1
4880,11670.0,39,named,16,1,6,5,0,32,15,-10,Awami League,Mujibur Rahman,ORGANIZATION-ORGANIZATION,PERSON-PERSON,PROPN-PROPN,PROPN-PROPN,compound-compound,compound-nsubjpass,NNP-NNP,NNP-NNP,2,1
4881,61975.0,16,opposed,1,7,11,4,6,4,-6,10,Awami League,Mujibur Rahman,ORGANIZATION-ORGANIZATION,PERSON-PERSON,PROPN-PROPN,PROPN-PROPN,compound-poss,compound-nsubj,NNP-NNP,NNP-NNP,5,1
4882,11672.0,47,expected,16,39,44,5,38,2,-23,28,National Christmas Tree Association,Chesterfield,ORGANIZATION-ORGANIZATION-ORGANIZATION-ORGANIZATION,CITY,PROPN-PROPN-PROPN-PROPN,PROPN,compound-compound-compound-pobj,pobj,NNP-NNP-NNP-NNP,NNP,5,1
4883,41296.0,47,expected,16,39,44,5,38,2,-23,28,National Christmas Tree Association,Chesterfield,ORGANIZATION-ORGANIZATION-ORGANIZATION-ORGANIZATION,CITY,PROPN-PROPN-PROPN-PROPN,PROPN,compound-compound-compound-pobj,pobj,NNP-NNP-NNP-NNP,NNP,5,1
4884,11678.0,11,Ugent,7,4,8,4,3,2,3,1,University of Ghent,Ugent,ORGANIZATION-ORGANIZATION-ORGANIZATION,LOCATION,PROPN-ADP-PROPN,PROPN,nmod-prep-pobj,ROOT,NNP-IN-NNP,NNP,2,1
4885,11685.0,30,died,13,21,1,-20,20,28,-8,-12,New South Wales Rugby,Roger Vanderfield,ORGANIZATION-ORGANIZATION-ORGANIZATION-ORGANIZATION,PERSON-PERSON,PROPN-PROPN-PROPN-PROPN,PROPN-PROPN,compound-compound-compound-nsubj,compound-nsubj,NNP-NNP-NNP-NNP,NNP-NNP,5,1
4886,11690.0,25,had,17,3,2,-1,2,22,14,-15,Ellen DeGeneres,judge,PERSON-PERSON,TITLE,PROPN-PROPN,NOUN,compound-nsubj,compound,NNP-NNP,NN,1,1
4887,11693.0,33,headed,4,20,16,-4,19,16,-16,12,he,Heidi,PERSON,PERSON,PRON,PROPN,nsubj,nsubj,PRP,NNP,1,1
4888,11697.0,40,------------------------------,0,8,15,7,7,24,-8,15,Ateneo Alumni Association,ateneoalumniassociation.org,ORGANIZATION-ORGANIZATION-ORGANIZATION,URL,PROPN-PROPN-PROPN,X,compound-compound-pobj,pobj,NNPS-NNPS-NNP,ADD,6,1
4889,11702.0,56,gives,20,24,31,7,23,24,-4,11,his,Alex,PERSON,PERSON,DET,PROPN,poss,compound,PRP$,NNP,7,1
4890,11717.0,29,morphed,5,2,2,0,1,26,3,-3,Badr Organization,Badr Corps,ORGANIZATION-ORGANIZATION,ORGANIZATION-ORGANIZATION,PROPN-PROPN,PROPN-PROPN,compound-appos,compound-nsubj,NNP-NNP,NNP-NNP,0,1
4891,14049.0,92,List,1,34,34,0,33,57,-33,33,Badr Organization,Badr Corps,ORGANIZATION-ORGANIZATION,ORGANIZATION-ORGANIZATION,PROPN-PROPN,PROPN-PROPN,compound-conj,compound-compound,NNP-NNP,NNP-NNP,0,1
4892,11751.0,32,said,11,19,13,-6,18,18,-8,2,Institute for Diversity and Ethics in Sport,Lapchick,ORGANIZATION-ORGANIZATION-ORGANIZATION-ORGANIZATION-ORGANIZATION-ORGANIZATION-ORGANIZATION,PERSON,PROPN-ADP-PROPN-CCONJ-PROPN-ADP-PROPN,PROPN,pobj-prep-pobj-cc-conj-prep-pobj,nsubj,NNP-IN-NNP-CC-NNP-IN-NNP,NNP,3,1
4893,11774.0,48,upheld,8,30,15,-15,29,32,-22,7,Hashim Ahmad al-Tai,saddam,PERSON-PERSON-PERSON,PERSON,PROPN-PROPN-X,NOUN,compound-subtok-punct,poss,NNP-NNP-ADD,NN,5,1
4894,11784.0,34,defends,24,23,22,-1,22,11,1,-2,Richard Perle,Secretary,PERSON-PERSON,TITLE,PROPN-PROPN,PROPN,compound-nsubj,compound,NNP-NNP,NNP,2,1
4895,11789.0,40,said,22,34,38,4,33,1,-12,16,MF Global LLC,New York,ORGANIZATION-ORGANIZATION-ORGANIZATION,STATE_OR_PROVINCE-STATE_OR_PROVINCE,PROPN-PROPN-PROPN,PROPN-PROPN,compound-compound-pobj,compound-pobj,NNP-NNP-NNP,NNP-NNP,4,1
4896,11798.0,43,reported,41,4,2,-2,3,40,37,-39,Kollek,Jerusalem,PERSON,CITY,PROPN,PROPN,nsubj,pobj,NNP,NNP,2,1
4897,11807.0,36,quoted,28,30,32,2,29,3,-2,4,CNB,Miroslav Singer,ORGANIZATION,PERSON-PERSON,PROPN,PROPN-PROPN,compound,compound-dobj,NNP,NNP-NNP,2,1
4898,61454.0,25,appointed,4,10,13,3,9,11,-6,9,CNB,Miroslav Singer,ORGANIZATION,PERSON-PERSON,PROPN,PROPN-PROPN,compound,compound-dobj,NNP,NNP-NNP,3,1
4899,11819.0,29,is,6,1,5,4,0,23,5,-1,Hindalco,Mumbai,ORGANIZATION,CITY,PROPN,PROPN,nsubj,pobj,NNP,NNP,3,1
4900,11825.0,32,marked,2,20,9,-11,19,22,-18,7,Wilkinson,Playboy,PERSON,ORGANIZATION,PROPN,PROPN,conj,pobj,NNP,NNP,5,1
4901,11830.0,35,seems,4,13,14,1,12,20,-9,10,Steve McPherson,McPherson,PERSON-PERSON,PERSON,PROPN-PROPN,PROPN,compound-nsubj,nsubj,NNP-NNP,NNP,2,1
4902,11835.0,36,said,32,35,2,-33,34,33,-3,-30,Maloney,Congress,PERSON,ORGANIZATION,PROPN,PROPN,nsubj,nsubj,NNP,NNP,3,1
4903,48322.0,22,agrees,1,4,16,12,3,5,-3,15,Maloney,Congress,PERSON,ORGANIZATION,PROPN,PROPN,pobj,pobj,NNP,NNP,3,1
4904,11839.0,37,said,20,28,24,-4,27,12,-8,4,International Crisis Group,Colin Thomas-Jensen,ORGANIZATION-ORGANIZATION-ORGANIZATION,PERSON-PERSON,PROPN-PROPN-PROPN,PROPN-PROPN,compound-compound-pobj,compound-nsubj,NNP-NNP-NNP,NNP-NNP,2,1
4905,11850.0,25,born,4,1,9,8,0,15,3,5,Richard Henry Nolte,Minn.,PERSON-PERSON-PERSON,STATE_OR_PROVINCE,PROPN-PROPN-PROPN,PROPN,compound-compound-nsubjpass,appos,NNP-NNP-NNP,NNP,3,1
4906,11855.0,43,faction,2,42,41,-1,41,1,-40,39,JEM,Islamist,ORGANIZATION,RELIGION,PROPN,ADJ,conj,amod,NNP,JJ,4,1
4907,11858.0,35,Chesley,4,1,3,2,0,31,3,-1,JNF,Stanley M. Chesley,ORGANIZATION,PERSON-PERSON-PERSON,PROPN,PROPN-PROPN-PROPN,compound,compound-compound-ROOT,NNP,NNP-NNP-NNP,2,1
4908,11863.0,18,was,1,1,5,4,0,12,0,4,He,Jew,PERSON,RELIGION,PRON,PROPN,nsubj,attr,PRP,NNP,2,1
4909,28787.0,35,was,1,1,5,4,0,29,0,4,He,Jew,PERSON,RELIGION,PRON,PROPN,nsubj,attr,PRP,NNP,2,1
4910,11864.0,45,changed,23,16,5,-11,15,39,7,-18,her,90,PERSON,NUMBER,DET,NUM,poss,appos,PRP$,CD,4,1
4911,46376.0,45,changed,23,16,5,-11,15,39,7,-18,her,90,PERSON,NUMBER,DET,NUM,poss,appos,PRP$,CD,4,1
4912,11877.0,22,MESKILL,2,1,12,11,0,9,1,10,THOMAS J MESKILL,JUDGE,PERSON-PERSON-PERSON,TITLE,PROPN-PROPN-PROPN,NOUN,compound-compound-ROOT,conj,NNP-NNP-NNP,NN,3,1
4913,11882.0,50,convicted,22,13,5,-8,12,44,9,-17,his,Maryland,PERSON,STATE_OR_PROVINCE,DET,PROPN,poss,compound,PRP$,NNP,2,1
4914,11884.0,29,criticized,2,8,25,17,7,3,-6,23,Hong Kong Disneyland,The Walt Disney Co,ORGANIZATION-ORGANIZATION-ORGANIZATION,ORGANIZATION-ORGANIZATION-ORGANIZATION-ORGANIZATION,PROPN-PROPN-PROPN,DET-PROPN-PROPN-NOUN,compound-compound-pobj,det-compound-compound-pobj,NNP-NNP-NNP,DT-NNP-NNP-NN,9,1
4915,11894.0,29,-LRB-,2,7,6,-1,6,22,-5,4,Gholam Ali Haddad Adel,Speaker,PERSON-PERSON-PERSON-PERSON,TITLE,PROPN-PROPN-PROPN-PROPN,PROPN,compound-compound-compound-nsubj,compound,NNP-NNP-NNP-NNP,NNP,2,1
4916,15026.0,43,said,7,4,3,-1,3,39,3,-4,Gholam Ali Haddad Adel,Speaker,PERSON-PERSON-PERSON-PERSON,TITLE,PROPN-PROPN-PROPN-PROPN,PROPN,compound-compound-compound-nsubj,compound,NNP-NNP-NNP-NNP,NNP,2,1
4917,34388.0,25,reported,23,14,13,-1,13,11,9,-10,Gholam Ali Haddad Adel,Speaker,PERSON-PERSON-PERSON-PERSON,TITLE,PROPN-PROPN-PROPN-PROPN,PROPN,compound-compound-compound-pobj,compound,NNP-NNP-NNP-NNP,NNP,2,1
4918,35429.0,44,thwart,5,20,2,-18,19,41,-15,-3,Gholam Ali Haddad Adel,Speaker,PERSON-PERSON-PERSON-PERSON,TITLE,PROPN-PROPN-PROPN-PROPN,PROPN,compound-compound-compound-appos,compound,NNP-NNP-NNP-NNP,NNP,4,1
4919,36190.0,28,made,1,15,14,-1,14,13,-14,13,Gholam Ali Haddad Adel,Speaker,PERSON-PERSON-PERSON-PERSON,TITLE,PROPN-PROPN-PROPN-PROPN,PROPN,compound-compound-compound-pobj,compound,NNP-NNP-NNP-NNP,NNP,2,1
4920,51592.0,23,met,8,17,16,-1,16,6,-9,8,Gholam Ali Haddad Adel,Speaker,PERSON-PERSON-PERSON-PERSON,TITLE,PROPN-PROPN-PROPN-PROPN,PROPN,compound-compound-compound-pobj,compound,NNP-NNP-NNP-NNP,NNP,2,1
4921,60517.0,43,quoted,33,30,29,-1,29,13,3,-4,Gholam Ali Haddad Adel,Speaker,PERSON-PERSON-PERSON-PERSON,TITLE,PROPN-PROPN-PROPN-PROPN,PROPN,compound-compound-compound-nsubj,compound,NNP-NNP-NNP-NNP,NNP,2,1
4922,11901.0,53,said,51,43,46,3,42,6,8,-5,KCNA,DPRK,ORGANIZATION,ORGANIZATION,PROPN,PROPN,conj,poss,NNP,NNP,4,1
4923,12001.0,28,reported,24,24,9,-15,23,18,0,-15,KCNA,DPRK,ORGANIZATION,ORGANIZATION,PROPN,PROPN,appos,compound,NNP,NNP,3,1
4924,11902.0,46,performed,11,2,9,7,1,36,9,-2,her,Atlanta,PERSON,CITY,DET,PROPN,poss,pobj,PRP$,NNP,4,1
4925,11903.0,25,Good,1,6,11,5,5,13,-5,10,Jeremy Hooper,Andrew,PERSON-PERSON,PERSON,PROPN-PROPN,PROPN,compound-nsubj,appos,NNP-NNP,NNP,2,1
4926,11904.0,11,was,1,1,6,5,0,4,0,5,He,David and Mary M Anderson,PERSON,PERSON-PERSON-PERSON-PERSON-PERSON,PRON,PROPN-CCONJ-PROPN-PROPN-PROPN,nsubj,pobj-cc-compound-compound-conj,PRP,NNP-CC-NNP-NNP-NNP,4,1
4927,11905.0,33,heard,4,1,1,0,0,31,3,-3,Hussein Kamel,Hussein,PERSON-PERSON,PERSON,PROPN-PROPN,PROPN,compound-appos,nsubjpass,NNP-NNP,NNP,0,1
4928,11912.0,36,Force,2,9,2,-7,8,33,-7,0,IRGC,Quds Force,ORGANIZATION,ORGANIZATION-ORGANIZATION,PROPN,PROPN-PROPN,pobj,compound-ROOT,NNP,NNP-NNP,5,1
4929,11913.0,19,was,2,1,5,4,0,13,1,3,Carolyn Goodman,psychologist,PERSON-PERSON,TITLE,PROPN-PROPN,NOUN,compound-nsubj,attr,NNP-NNP,NN,4,1
4930,58637.0,24,YORK,1,6,10,4,5,13,-5,9,Carolyn Goodman,psychologist,PERSON-PERSON,TITLE,PROPN-PROPN,NOUN,compound-nsubj,attr,NNP-NNP,NN,5,1
4931,11918.0,16,died,5,4,8,4,3,7,1,3,Beverly Sills,cancer,PERSON-PERSON,CAUSE_OF_DEATH,PROPN-PROPN,NOUN,compound-nsubj,pobj,NNP-NNP,NN,2,1
4932,39729.0,19,Labels,0,3,14,11,2,4,-3,14,Beverly Sills,cancer,PERSON-PERSON,CAUSE_OF_DEATH,PROPN-PROPN,NOUN,compound-nsubj,pobj,NNP-NNP,NN,3,1
4933,11919.0,44,drafted,21,33,3,-30,32,40,-12,-18,Metro Atlanta Chamber of Commerce,A.D. Correll,ORGANIZATION-ORGANIZATION-ORGANIZATION-ORGANIZATION-ORGANIZATION,PERSON-PERSON,PROPN-PROPN-PROPN-ADP-PROPN,PROPN-PROPN,compound-compound-pobj-prep-pobj,compound-conj,NNP-NNP-NNP-IN-NNP,NNP-NNP,8,1
4934,11920.0,16,worked,2,1,13,12,0,2,1,11,He,secular Jewish,PERSON,RELIGION-RELIGION,PRON,ADJ-ADJ,nsubj,conj-amod,PRP,JJ-JJ,6,1
4935,11924.0,32,announced,2,1,6,5,0,25,1,4,Samsung,Jay Y Lee,ORGANIZATION,PERSON-PERSON-PERSON,PROPN,PROPN-PROPN-PROPN,compound,compound-compound-nsubjpass,NNP,NNP-NNP-NNP,4,1
4936,11926.0,24,lives,11,1,23,22,0,0,10,12,Cutrone,Ava,PERSON,PERSON,PROPN,PROPN,nsubj,appos,NNP,NNP,5,1
4937,11929.0,19,was,2,1,11,10,0,7,1,9,Al Hubbard,assistant,PERSON-PERSON,TITLE,PROPN-PROPN,NOUN,compound-nsubj,conj,NNP-NNP,NN,4,1
4938,11930.0,74,were,10,5,9,4,4,64,5,-1,CITI,CITIBANK,ORGANIZATION,ORGANIZATION,PROPN,PROPN,compound,conj,NNP,NNP,4,1
4939,11932.0,43,said,19,9,14,5,8,28,10,-5,Carolyn Maloney,Congress 's Joint Economic committee,PERSON-PERSON,ORGANIZATION-ORGANIZATION-ORGANIZATION-ORGANIZATION-ORGANIZATION,PROPN-PROPN,PROPN-PART-PROPN-PROPN-NOUN,compound-nsubj,poss-case-compound-compound-dobj,NNP-NNP,NNP-POS-NNP-NNP-NN,4,1
4940,11933.0,29,said,23,19,19,0,18,9,4,-4,Carnival,Carnival Cruise Lines,ORGANIZATION,ORGANIZATION-ORGANIZATION-ORGANIZATION,PROPN,PROPN-PROPN-PROPN,compound,compound-compound-nsubj,NNP,NNP-NNP-NNP,0,1
4941,43639.0,27,is,1,1,1,0,0,25,0,0,Carnival,Carnival Cruise Lines,ORGANIZATION,ORGANIZATION-ORGANIZATION-ORGANIZATION,NOUN,PROPN-PROPN-PROPN,nsubj,compound-compound-pobj,NN,NNP-NNP-NNPS,0,1
4942,11944.0,35,Build,0,25,17,-8,24,17,-25,17,American Red Cross,Galveston Chapter,ORGANIZATION-ORGANIZATION-ORGANIZATION,ORGANIZATION-ORGANIZATION,PROPN-PROPN-PROPN,PROPN-PROPN,compound-compound-pobj,compound-dobj,NNP-NNP-NNP,NNP-NNP,5,1
4943,11945.0,57,HANOI,0,52,44,-8,51,12,-52,44,Asian Development Bank,Ayumi Konishi,ORGANIZATION-ORGANIZATION-ORGANIZATION,PERSON-PERSON,PROPN-PROPN-PROPN,PROPN-PROPN,compound-compound-pobj,compound-nsubj,NNP-NNP-NNP,NNP-NNP,5,1
4944,11949.0,48,JINAN,0,29,27,-2,28,20,-29,27,Li Jie,shooter,PERSON-PERSON,TITLE,PROPN-PROPN,NOUN,compound-nsubjpass,pobj,NNP-NNP,NN,2,1
4945,31532.0,34,failed,26,10,14,4,9,19,16,-12,Li Jie,shooter,PERSON-PERSON,TITLE,PROPN-PROPN,NOUN,compound-appos,appos,NNP-NNP,NN,2,1
4946,44210.0,18,set,8,14,13,-1,13,4,-6,5,Li Jie,shooter,PERSON-PERSON,TITLE,PROPN-PROPN,NOUN,compound-appos,pobj,NNP-NNP,NN,1,1
4947,46745.0,37,found,25,18,16,-2,17,20,7,-9,Li Jie,shooter,PERSON-PERSON,TITLE,PROPN-PROPN,NOUN,compound-nsubjpass,pobj,NNP-NNP,NN,2,1
4948,48909.0,39,is,1,20,24,4,19,14,-19,23,Li Jie,shooter,PERSON-PERSON,TITLE,PROPN-PROPN,NOUN,compound-conj,appos,NNP-NNP,NN,5,1
4949,49808.0,28,tested,6,5,4,-1,4,23,1,-2,Li Jie,shooter,PERSON-PERSON,TITLE,PROPN-PROPN,NOUN,compound-nsubj,compound,NNP-NNP,NN,1,1
4950,11956.0,25,Letter,0,15,11,-4,14,13,-15,11,Massachusetts House of Representatives,Paul Kujawski,ORGANIZATION-ORGANIZATION-ORGANIZATION-ORGANIZATION,PERSON-PERSON,PROPN-PROPN-ADP-PROPN,PROPN-PROPN,compound-pobj-prep-pobj,compound-dobj,NNP-NNP-IN-NNPS,NNP-NNP,2,1
4951,17171.0,40,-LRB-,0,24,32,8,23,7,-24,32,Massachusetts House of Representatives,Paul Kujawski,ORGANIZATION-ORGANIZATION-ORGANIZATION-ORGANIZATION,PERSON-PERSON,PROPN-PROPN-ADP-PROPN,PROPN-PROPN,compound-pobj-prep-pobj,compound-pobj,NNP-NNP-IN-NNPS,NNP-NNP,8,1
4952,11961.0,31,said,17,26,19,-7,25,11,-9,2,Federal Motor Carrier Safety Administration,Melissa Mazzella-Delaney,ORGANIZATION-ORGANIZATION-ORGANIZATION-ORGANIZATION-ORGANIZATION,PERSON-PERSON,PROPN-PROPN-PROPN-PROPN-PROPN,PROPN-PROPN,compound-compound-compound-compound-pobj,compound-nsubj,NNP-NNP-NNP-NNP-NNP,NNP-NNP,3,1
4953,11962.0,26,is,11,3,15,12,2,10,8,4,Awami League,All Pakistan Awami Muslim League,ORGANIZATION-ORGANIZATION,ORGANIZATION-ORGANIZATION-ORGANIZATION-ORGANIZATION-ORGANIZATION,PROPN-PROPN,DET-PROPN-PROPN-PROPN-PROPN,compound-nsubj,det-compound-compound-compound-pobj,NNP-NNP,DT-NNP-NNP-NNP-NNP,5,1
4954,11968.0,22,replaced,13,9,7,-2,8,14,4,-6,Dan Abrams,Verdict,PERSON-PERSON,ORGANIZATION,PROPN-PROPN,PROPN,compound-pobj,nsubjpass,NNP-NNP,NNP,3,1
4955,11983.0,20,born,2,1,18,17,0,1,1,16,Forsberg,New York,PERSON,STATE_OR_PROVINCE-STATE_OR_PROVINCE,PROPN,PROPN-PROPN,nsubjpass,compound-pobj,NNP,NNP-NNP,4,1
4956,27893.0,20,born,2,1,18,17,0,1,1,16,Forsberg,New York,PERSON,STATE_OR_PROVINCE-STATE_OR_PROVINCE,PROPN,PROPN-PROPN,nsubjpass,compound-pobj,NNP,NNP-NNP,4,1
4957,28882.0,59,launched,16,16,13,-3,15,45,0,-3,Forsberg,New York,PERSON,STATE_OR_PROVINCE-STATE_OR_PROVINCE,PROPN,PROPN-PROPN,nsubj,compound-pobj,NNP,NNP-NNP,6,1
4958,39938.0,30,said,23,1,11,10,0,18,22,-12,Forsberg,New York,PERSON,STATE_OR_PROVINCE-STATE_OR_PROVINCE,PROPN,PROPN-PROPN,nsubj,compound-pobj,NNP,NNP-NNP,6,1
4959,40592.0,28,appointed,6,5,26,21,4,1,1,20,Forsberg,New York,PERSON,STATE_OR_PROVINCE-STATE_OR_PROVINCE,PROPN,PROPN-PROPN,nsubjpass,compound-pobj,NNP,NNP-NNP,9,1
4960,11998.0,28,party,4,7,1,-6,6,26,-3,-3,National Union of the Total Independence of Angola,Angola,ORGANIZATION-ORGANIZATION-ORGANIZATION-ORGANIZATION-ORGANIZATION-ORGANIZATION-ORGANIZATION-ORGANIZATION,COUNTRY,PROPN-PROPN-ADP-DET-PROPN-PROPN-ADP-PROPN,PROPN,compound-appos-prep-det-compound-pobj-prep-pobj,poss,NNP-NNP-IN-DT-NNP-NNP-IN-NNP,NNP,3,1
4961,56281.0,64,LUANDA,0,50,27,-23,49,36,-50,27,National Union of the Total Independence of Angola,Angola,ORGANIZATION-ORGANIZATION-ORGANIZATION-ORGANIZATION-ORGANIZATION-ORGANIZATION-ORGANIZATION-ORGANIZATION,COUNTRY,PROPN-PROPN-ADP-DET-PROPN-PROPN-ADP-PROPN,PROPN,compound-appos-prep-det-compound-pobj-prep-pobj,pobj,NNP-NNP-IN-DT-NNP-NNP-IN-NNP,NNP,9,1
4962,12004.0,48,died,37,1,47,46,0,0,36,10,Lorraine Rothman,Calif.,PERSON-PERSON,STATE_OR_PROVINCE,PROPN-PROPN,PROPN,compound-nsubj,appos,NNP-NNP,NNP,2,1
4963,12005.0,25,survived,6,2,17,15,1,7,4,11,Raul Castro,Nilsa,PERSON-PERSON,PERSON,PROPN-PROPN,PROPN,compound-pobj,conj,NNP-NNP,NNP,8,1
4964,12012.0,40,mokhal,0,2,22,20,1,17,-2,22,Melanie Fiona,singer,PERSON-PERSON,TITLE,PROPN-PROPN,NOUN,compound-nsubj,poss,NNP-NNP,NN,5,1
4965,23791.0,43,broke,9,32,31,-1,31,11,-23,22,Melanie Fiona,singer,PERSON-PERSON,TITLE,PROPN-PROPN,NOUN,compound-pobj,compound,NNP-NNP,NN,1,1
4966,12015.0,17,arrived,2,14,5,-9,13,11,-12,3,Hawkins,Los Angeles,PERSON,CITY-CITY,PROPN,PROPN-PROPN,nsubj,compound-pobj,NNP,NNP-NNP,5,1
4967,27115.0,19,went,1,1,14,13,0,4,0,13,Hawkins,Los Angeles,PERSON,CITY-CITY,PROPN,PROPN-PROPN,nsubj,compound-appos,NNP,NNP-NNP,5,1
4968,12016.0,37,appointed,4,6,11,5,5,25,-2,7,Mainland Affairs Council,Chang Liang-jen,ORGANIZATION-ORGANIZATION-ORGANIZATION,PERSON-PERSON,PROPN-PROPN-PROPN,PROPN-PROPN,compound-compound-compound,dobj-appos,NNP-NNPS-NNP,NNP-NNP,2,1
4969,12026.0,21,says,3,14,17,3,13,3,-11,14,Royal Caribbean,Liberty of the Seas,ORGANIZATION-ORGANIZATION,ORGANIZATION-ORGANIZATION-ORGANIZATION-ORGANIZATION,PROPN-PROPN,PROPN-ADP-DET-PROPN,compound-poss,pobj-prep-det-pobj,NNP-NNP,NNP-IN-DT-NNPS,2,1
4970,51641.0,39,launched,13,20,24,4,19,14,-7,11,Royal Caribbean,Liberty of the Seas,ORGANIZATION-ORGANIZATION,ORGANIZATION-ORGANIZATION-ORGANIZATION-ORGANIZATION,ADJ-ADJ,PROPN-ADP-DET-PROPN,compound-amod,appos-prep-det-pobj,JJ-JJ,NNP-IN-DT-NNPS,3,1
4971,12044.0,35,set,5,22,15,-7,21,19,-17,10,David Banda,Madonna,PERSON-PERSON,PERSON,PROPN-PROPN,PROPN,compound-nsubj,pobj,NNP-NNP,NNP,6,1
4972,15179.0,12,-LRB-,2,1,6,5,0,5,1,4,David Banda,Madonna,PERSON-PERSON,PERSON,PROPN-PROPN,PROPN,compound-compound,pobj,NNP-NNP,NNP,4,1
4973,22063.0,31,is,22,10,1,-9,9,29,12,-21,David Banda,Madonna,PERSON-PERSON,PERSON,PROPN-PROPN,PROPN,compound-appos,nsubj,NNP-NNP,NNP,4,1
4974,42030.0,13,is,9,7,1,-6,6,11,2,-8,David Banda,Madonna,PERSON-PERSON,PERSON,PROPN-PROPN,PROPN,compound-appos,poss,NNP-NNP,NNP,3,1
4975,50013.0,42,approves,2,11,4,-7,10,37,-9,2,David Banda,Madonna,PERSON-PERSON,PERSON,PROPN-PROPN,PROPN,compound-pobj,poss,NNP-NNP,NNP,6,1
4976,52668.0,82,Woods,12,30,54,24,29,27,-18,42,David Banda,Madonna,PERSON-PERSON,PERSON,PROPN-PROPN,PROPN,compound-conj,pobj,NNP-NNP,NNP,10,1
4977,12051.0,24,claimed,1,3,17,14,2,6,-2,16,Beverly Sills,pancreatic cancer,PERSON-PERSON,CAUSE_OF_DEATH-CAUSE_OF_DEATH,PROPN-PROPN,ADJ-NOUN,compound-dobj,amod-pobj,NNP-NNP,JJ-NN,5,1
4978,12054.0,36,is,4,2,16,14,1,19,2,12,International Crisis Group,110,ORGANIZATION-ORGANIZATION-ORGANIZATION,NUMBER,PROPN-PROPN-PROPN,NUM,compound-compound-nsubj,nummod,NNP-NNP-NNP,CD,3,1
4979,12062.0,48,advancing,23,19,8,-11,18,39,4,-15,his,142nd Infantry Regiment,PERSON,ORGANIZATION-ORGANIZATION-ORGANIZATION,DET,PROPN-PROPN-PROPN,poss,compound-compound-pobj,PRP$,NNP-NNP-NNP,6,1
4980,12064.0,21,lived,9,8,15,7,7,5,1,6,she,Calif.,PERSON,STATE_OR_PROVINCE,PRON,PROPN,nsubj,appos,PRP,NNP,4,1
4981,12070.0,34,proposed,5,3,1,-2,2,32,2,-4,Marcel Ospel,Board,PERSON-PERSON,ORGANIZATION,PROPN-PROPN,NOUN,compound-nsubj,compound,NNP-NNP,NN,1,1
4982,12072.0,34,argued,7,6,1,-5,5,32,1,-6,Al Hubbard,White House,PERSON-PERSON,ORGANIZATION-ORGANIZATION,PROPN-PROPN,PROPN-PROPN,compound-nsubj,nmod-nmod,NNP-NNP,NNP-NNP,2,1
4983,37475.0,37,met,10,18,15,-3,17,21,-8,5,Al Hubbard,White House,PERSON-PERSON,ORGANIZATION-ORGANIZATION,PROPN-PROPN,PROPN-PROPN,compound-pobj,compound-compound,NNP-NNP,NNP-NNP,2,1
4984,12073.0,19,said,12,8,2,-6,7,16,4,-10,JNF,Omri Bonneh,ORGANIZATION,PERSON-PERSON,PROPN,PROPN-PROPN,poss,compound-nsubj,NNP,NNP-NNP,5,1
4985,12078.0,66,survived,12,2,4,2,1,61,10,-8,his,Charles,PERSON,PERSON,DET,PROPN,poss,appos,PRP$,NNP,1,1
4986,56023.0,14,said,8,10,13,3,9,0,-2,5,his,Charles,PERSON,PERSON,DET,PROPN,poss,appos,PRP$,NNP,2,1
4987,12088.0,20,lobbied,8,1,7,6,0,12,7,-1,Mark Buse,aide,PERSON-PERSON,TITLE,PROPN-PROPN,NOUN,compound-nsubj,appos,NNP-NNP,NN,2,1
4988,12103.0,30,is,2,1,8,7,0,21,1,6,FAW,China,ORGANIZATION,ORGANIZATION,PROPN,PROPN,compound,poss,NNP,NNP,6,1
4989,29370.0,16,announce,7,7,3,-4,6,12,0,-4,FAW,China,ORGANIZATION,COUNTRY,PROPN,PROPN,nsubj,poss,NNP,NNP,1,1
4990,38195.0,40,told,8,38,32,-6,37,7,-30,24,FAW,China,ORGANIZATION,COUNTRY,PROPN,PROPN,compound,poss,NNP,NNP,-1,1
4991,51870.0,36,has,1,16,7,-9,15,28,-15,6,FAW,China,ORGANIZATION,ORGANIZATION,PROPN,PROPN,compound,compound,NNP,NNP,4,1
4992,12109.0,35,became,7,16,14,-2,15,20,-9,7,Alberto R. Gonzales,Attorney General,PERSON-PERSON-PERSON,TITLE-TITLE,PROPN-PROPN-PROPN,PROPN-PROPN,compound-compound-dobj,compound-compound,NNP-NNP-NNP,NNP-NNP,2,1
4993,19454.0,47,announced,20,3,1,-2,2,45,17,-19,Alberto R. Gonzales,Attorney General,PERSON-PERSON-PERSON,TITLE-TITLE,PROPN-PROPN-PROPN,PROPN-PROPN,compound-compound-nsubj,compound-compound,NNP-NNP-NNP,NNP-NNP,2,1
4994,39607.0,28,captured,1,22,20,-2,21,7,-21,19,Alberto R. Gonzales,Attorney General,PERSON-PERSON-PERSON,TITLE-TITLE,PROPN-PROPN-PROPN,PROPN-PROPN,compound-compound-dobj,compound-compound,NNP-NNP-NNP,NNP-NNP,2,1
4995,12124.0,38,met,24,19,23,4,18,14,5,-1,Sports Affairs Council,Tai Hsia-ling,ORGANIZATION-ORGANIZATION-ORGANIZATION,PERSON-PERSON,PROPN-PROPN-PROPN,PROPN-NOUN,compound-compound-compound,compound-nsubj,NNPS-NNPS-NNP,NNP-NN,4,1
4996,36485.0,17,took,9,3,7,4,2,9,6,-2,Sports Affairs Council,Tai Hsia-ling,ORGANIZATION-ORGANIZATION-ORGANIZATION,PERSON-PERSON,PROPN-PROPN-PROPN,PROPN-NOUN,compound-compound-compound,compound-nsubj,NNPS-NNPS-NNP,NNP-NN,4,1
4997,60473.0,27,described,18,10,17,7,9,9,8,-1,Sports Affairs Council,Tai Hsia-ling,ORGANIZATION-ORGANIZATION-ORGANIZATION,PERSON-PERSON,PROPN-PROPN-PROPN,PROPN-NOUN,compound-compound-appos,compound-nsubj,NNPS-NNPS-NNP,NNP-NN,7,1
4998,12131.0,32,been,2,17,9,-8,16,22,-15,7,he,Egypt,PERSON,COUNTRY,PRON,PROPN,nsubj,pobj,PRP,NNP,3,1
4999,12152.0,39,had,2,11,15,4,10,23,-9,13,her,actress,PERSON,TITLE,DET,NOUN,poss,compound,PRP$,NN,5,1
5000,19523.0,17,discuss,4,6,2,-4,5,14,-2,-2,her,actress,PERSON,TITLE,DET,NOUN,poss,compound,PRP$,NN,4,1
5001,24440.0,39,said,34,23,5,-18,22,33,11,-29,her,actress,PERSON,TITLE,DET,NOUN,poss,attr,PRP$,NN,5,1
5002,27129.0,29,was,7,21,5,-16,20,23,-14,-2,her,actress,PERSON,TITLE,DET,NOUN,poss,pobj,PRP$,NN,7,1
5003,40650.0,44,said,42,32,28,-4,31,15,10,-14,her,actress,PERSON,TITLE,DET,NOUN,poss,compound,PRP$,NN,2,1
5004,58462.0,49,have,10,17,10,-7,16,38,-7,0,her,actress,PERSON,TITLE,PRON,NOUN,dobj,pobj,PRP,NN,3,1
5005,61344.0,27,said,13,16,11,-5,15,15,-3,-2,her,actress,PERSON,TITLE,DET,NOUN,poss,attr,PRP$,NN,3,1
5006,12154.0,38,began,7,7,18,11,6,19,0,11,DeGeneres,New Orleans,PERSON,CITY-CITY,PROPN,PROPN-PROPN,nsubj,compound-pobj,NNP,NNP-NNP,4,1
5007,12160.0,21,coaches,4,8,11,3,7,9,-4,7,Northwood University,South Florida,ORGANIZATION-ORGANIZATION,LOCATION-LOCATION,PROPN-PROPN,PROPN-PROPN,compound-pobj,compound-pobj,NNP-NNP,NNP-NNP,2,1
5008,12166.0,38,said,35,11,10,-1,10,27,24,-25,John Negroponte,diplomat,PERSON-PERSON,TITLE,PROPN-PROPN,NOUN,compound-nsubj,compound,NNP-NNP,NN,1,1
5009,53977.0,27,said,11,7,5,-2,6,21,4,-6,John Negroponte,diplomat,PERSON-PERSON,TITLE,PROPN-PROPN,NOUN,compound-appos,nsubj,NNP-NNP,NN,2,1
5010,12167.0,40,said,32,31,20,-11,30,19,1,-12,Jackson Hewitt,Michael Lister,ORGANIZATION-ORGANIZATION,PERSON-PERSON,PROPN-PROPN,PROPN-PROPN,compound-nsubj,compound-appos,NNP-NNP,NNP-NNP,5,1
5011,12168.0,11,Manson,1,4,11,7,3,-1,-3,10,Chad White,Hawtness,PERSON-PERSON,ORGANIZATION,PROPN-PROPN,NOUN,compound-conj,ROOT,NNP-NNP,NN,-1,1
5012,12176.0,40,sacked,23,19,16,-3,18,23,4,-7,Communist Party,Shanghai,ORGANIZATION-ORGANIZATION,CITY,PROPN-PROPN,PROPN,compound-compound,poss,NNP-NNP,NNP,3,1
5013,17575.0,38,comes,2,22,26,4,21,11,-20,24,Communist Party,Shanghai,ORGANIZATION-ORGANIZATION,CITY,PROPN-PROPN,PROPN,compound-compound,pobj,NNP-NNP,NNP,3,1
5014,12177.0,33,spoke,1,29,1,-28,28,31,-28,0,Raul Castro,Michel,PERSON-PERSON,PERSON,PROPN-PROPN,PROPN,compound-appos,nsubj,NNP-NNP,NNP,4,1
5015,12179.0,51,died,41,45,48,3,44,2,-4,7,his,Dothan,PERSON,CITY,DET,PROPN,poss,pobj,PRP$,NNP,3,1
5016,12183.0,21,said,8,14,10,-4,13,10,-6,2,ABA,Nessa Feddis,ORGANIZATION,PERSON-PERSON,PROPN,PROPN-PROPN,nmod,compound-nsubj,NNP,NNP-NNP,4,1
5017,12189.0,34,ordered,1,23,20,-3,22,13,-22,19,Philip Chen,chief operating officer,PERSON-PERSON,TITLE-TITLE-TITLE,PROPN-PROPN,ADJ-NOUN-NOUN,compound-nsubj,amod-compound-compound,NNP-NNP,JJ-NN-NN,2,1
5018,22892.0,38,ordered,1,29,20,-9,28,17,-28,19,Philip Chen,chief operating officer,PERSON-PERSON,TITLE-TITLE-TITLE,PROPN-PROPN,ADJ-NOUN-NOUN,compound-nsubj,amod-compound-compound,NNP-NNP,JJ-NN-NN,2,1
5019,32309.0,29,told,26,17,23,6,16,5,9,-3,Philip Chen,chief operating officer,PERSON-PERSON,TITLE-TITLE-TITLE,PROPN-PROPN,ADJ-NOUN-NOUN,compound-nsubj,amod-compound-appos,NNP-NNP,JJ-NN-NN,3,1
5020,44437.0,25,said,12,1,4,3,0,20,11,-8,Philip Chen,chief operating officer,PERSON-PERSON,TITLE-TITLE-TITLE,PROPN-PROPN,ADJ-VERB-NOUN,compound-nsubj,amod-compound-appos,NNP-NNP,JJ-VBG-NN,2,1
5021,60330.0,46,ordered,3,35,26,-9,34,19,-32,23,Philip Chen,chief operating officer,PERSON-PERSON,TITLE-TITLE-TITLE,PROPN-PROPN,ADJ-NOUN-NOUN,compound-appos,amod-compound-conj,NNP-NNP,JJ-NN-NN,2,1
5022,12193.0,12,includes,2,2,4,2,1,7,0,2,OIC,Iran,ORGANIZATION,COUNTRY,PROPN,PROPN,nsubj,dobj,NNP,NNP,2,1
5023,14534.0,11,include,4,3,6,3,2,4,1,2,OIC,Iran,ORGANIZATION,COUNTRY,PROPN,PROPN,compound,dobj,NNP,NNP,3,1
5024,12203.0,33,expected,9,8,6,-2,7,26,1,-3,Disneyland,Hong Kong Disneyland,ORGANIZATION,LOCATION-LOCATION-LOCATION,PROPN,PROPN-PROPN-PROPN,compound,compound-compound-nsubjpass,NNP,NNP-NNP-NNP,3,1
5025,12208.0,30,demanded,26,7,2,-5,6,27,19,-24,SLDN,Servicemembers Legal Defense Network,ORGANIZATION,ORGANIZATION-ORGANIZATION-ORGANIZATION-ORGANIZATION,PROPN,PROPN-PROPN-PROPN-PROPN,compound,compound-compound-compound-nsubj,NNP,NNPS-NNP-NNP-NNP,4,1
5026,18052.0,36,said,20,34,29,-5,33,6,-14,9,SLDN,Servicemembers Legal Defense Network,ORGANIZATION,ORGANIZATION-ORGANIZATION-ORGANIZATION-ORGANIZATION,PROPN,PROPN-PROPN-PROPN-PROPN,compound,compound-compound-compound-pobj,NNP,NNP-NNP-NNP-NNP,-1,1
5027,31838.0,15,Source,0,8,3,-5,7,11,-8,3,SLDN,Servicemembers Legal Defense Network,ORGANIZATION,ORGANIZATION-ORGANIZATION-ORGANIZATION-ORGANIZATION,PROPN,PROPN-PROPN-PROPN-PROPN,compound,compound-compound-compound-appos,NNP,NNP-NNP-NNP-NNP,4,1
5028,52699.0,29,said,8,22,17,-5,21,11,-14,9,SLDN,Servicemembers Legal Defense Network,ORGANIZATION,ORGANIZATION-ORGANIZATION-ORGANIZATION-ORGANIZATION,PROPN,PROPN-PROPN-PROPN-PROPN,compound,compound-compound-compound-pobj,NNP,NNP-NNP-NNP-NNP,7,1
5029,64598.0,41,blasted,23,7,2,-5,6,38,16,-21,SLDN,Servicemembers Legal Defense Network,ORGANIZATION,ORGANIZATION-ORGANIZATION-ORGANIZATION-ORGANIZATION,PROPN,PROPN-PROPN-PROPN-PROPN,compound,compound-compound-compound-nsubj,NNP,NNPS-NNP-NNP-NNP,3,1
5030,12210.0,49,said,24,36,26,-10,35,22,-12,2,American Automobile Association,AAA Mid-Atlantic,ORGANIZATION-ORGANIZATION-ORGANIZATION,ORGANIZATION-ORGANIZATION,PROPN-PROPN-PROPN,PROPN-PROPN,compound-compound-pobj,compound-compound,NNP-NNP-NNP,NNP-NNP,4,1
5031,12213.0,50,by,0,38,40,2,37,9,-38,40,ABA,Death Penalty Moratorium Implementation Project,ORGANIZATION,ORGANIZATION-ORGANIZATION-ORGANIZATION-ORGANIZATION-ORGANIZATION,PROPN,PROPN-PROPN-PROPN-PROPN-PROPN,poss,compound-compound-compound-compound-pobj,NNP,NNP-NNP-NNP-NNP-NNP,3,1
5032,12217.0,45,2009-03-02T09,0,39,35,-4,38,9,-39,35,commissioner of the human rights body,Barbara Hall,ORGANIZATION-ORGANIZATION-ORGANIZATION-ORGANIZATION-ORGANIZATION-ORGANIZATION,PERSON-PERSON,NOUN-ADP-DET-ADJ-NOUN-NOUN,PROPN-PROPN,appos-prep-det-amod-compound-pobj,compound-pobj,NN-IN-DT-JJ-NNS-NN,NNP-NNP,3,1
5033,12225.0,39,saw,8,1,6,5,0,32,7,-2,IPSCO,"4,400",ORGANIZATION,NUMBER,PROPN,NUM,nsubj,nummod,NNP,CD,3,1
5034,15105.0,18,has,2,2,5,3,1,12,0,3,IPSCO,"4,400",ORGANIZATION,NUMBER,PROPN,NUM,nsubj,nummod,NNP,CD,5,1
5035,23146.0,39,saw,8,1,6,5,0,32,7,-2,IPSCO,"4,400",ORGANIZATION,NUMBER,PROPN,NUM,nsubj,nummod,NNP,CD,3,1
5036,39454.0,28,------,0,2,7,5,1,20,-2,7,IPSCO,"4,400",ORGANIZATION,NUMBER,PROPN,NUM,nsubj,nummod,NNP,CD,3,1
5037,49043.0,27,completed,8,1,6,5,0,20,7,-2,IPSCO,"4,400",ORGANIZATION,NUMBER,PROPN,NUM,nsubj,nummod,NNP,CD,3,1
5038,12226.0,27,said,12,2,25,23,1,1,10,13,His,Um Mohammed,PERSON,PERSON-PERSON,DET,PROPN-PROPN,poss,compound-pobj,PRP$,NNP-NNP,7,1
5039,12229.0,30,announced,28,5,1,-4,4,28,23,-27,Ann Davis,US,PERSON-PERSON,ORGANIZATION,PROPN-PROPN,PROPN,compound-nsubj,compound,NNP-NNP,NNP,2,1
5040,12231.0,28,2008-04-30T08,0,6,8,2,5,19,-6,8,Maps,Rick Doblin,ORGANIZATION,PERSON-PERSON,PROPN,PROPN-PROPN,pobj,compound-appos,NNP,NNP-NNP,-1,1
5041,12236.0,17,was,1,1,16,15,0,0,0,15,Forsberg,typist,PERSON,TITLE,PROPN,NOUN,nsubj,pobj,NNP,NN,1,1
5042,38480.0,39,learned,2,1,11,10,0,27,1,9,Forsberg,typist,PERSON,TITLE,PROPN,NOUN,nsubj,pobj,NNP,NN,3,1
5043,64962.0,39,learned,2,1,11,10,0,27,1,9,Forsberg,typist,PERSON,TITLE,PROPN,NOUN,nsubj,pobj,NNP,NN,3,1
5044,12247.0,25,announced,5,21,20,-1,20,4,-16,15,Marcel Ospel,Chairman,PERSON-PERSON,TITLE,PROPN-PROPN,PROPN,compound-nsubj,compound,NNP-NNP,NNP,1,1
5045,12435.0,11,calling,2,6,5,-1,5,5,-4,3,Marcel Ospel,Chairman,PERSON-PERSON,TITLE,PROPN-PROPN,PROPN,compound-pobj,compound,NNP-NNP,NNP,1,1
5046,14151.0,25,told,4,3,2,-1,2,22,1,-2,Marcel Ospel,Chairman,PERSON-PERSON,TITLE,PROPN-PROPN,PROPN,compound-nsubj,compound,NNP-NNP,NNP,1,1
5047,24753.0,44,announced,17,2,1,-1,1,42,15,-16,Marcel Ospel,Chairman,PERSON-PERSON,TITLE,PROPN-PROPN,PROPN,compound-nsubj,compound,NNP-NNP,NNP,1,1
5048,31111.0,29,said,27,11,10,-1,10,18,16,-17,Marcel Ospel,Chairman,PERSON-PERSON,TITLE,PROPN-PROPN,PROPN,compound-poss,compound,NNP-NNP,NNP,1,1
5049,40699.0,18,told,1,4,3,-1,3,14,-3,2,Marcel Ospel,Chairman,PERSON-PERSON,TITLE,PROPN-PROPN,PROPN,compound-dobj,compound,NNP-NNP,NNP,1,1
5050,40940.0,23,ZURICH,0,10,9,-1,9,13,-10,9,Marcel Ospel,Chairman,PERSON-PERSON,TITLE,PROPN-PROPN,PROPN,compound-nsubj,compound,NNP-NNP,NNP,3,1
5051,41548.0,34,focused,2,30,29,-1,29,4,-28,27,Marcel Ospel,Chairman,PERSON-PERSON,TITLE,PROPN-PROPN,PROPN,compound-nsubj,compound,NNP-NNP,NNP,1,1
5052,63058.0,35,said,16,12,11,-1,11,23,4,-5,Marcel Ospel,Chairman,PERSON-PERSON,TITLE,PROPN-PROPN,PROPN,compound-pobj,compound,NNP-NNP,NNP,2,1
5053,12268.0,47,said,27,35,29,-6,34,17,-8,2,Markit,Chris Williamson,ORGANIZATION,PERSON-PERSON,PROPN,PROPN-PROPN,pobj,compound-nsubj,NNP,NNP-NNP,4,1
5054,22402.0,43,said,27,37,29,-8,36,13,-10,2,Markit,Chris Williamson,ORGANIZATION,PERSON-PERSON,PROPN,PROPN-PROPN,amod,compound-nsubj,NNP,NNP-NNP,6,1
5055,32676.0,53,said,22,31,24,-7,30,28,-9,2,Markit,Chris Williamson,ORGANIZATION,PERSON-PERSON,PROPN,PROPN-PROPN,pobj,compound-nsubj,NNP,NNP-NNP,4,1
5056,36759.0,45,said,8,7,1,-6,6,43,1,-7,Markit,Chris Williamson,ORGANIZATION,PERSON-PERSON,PROPN,PROPN-PROPN,pobj,compound-nsubj,NNP,NNP-NNP,2,1
5057,55847.0,37,said,8,7,1,-6,6,35,1,-7,Markit,Chris Williamson,ORGANIZATION,PERSON-PERSON,PROPN,PROPN-PROPN,pobj,compound-nsubj,NNP,NNP-NNP,2,1
5058,62843.0,41,said,36,35,29,-6,34,11,1,-7,Markit,Chris Williamson,ORGANIZATION,PERSON-PERSON,PROPN,PROPN-PROPN,pobj,compound-nsubj,NNP,NNP-NNP,7,1
5059,12274.0,22,dissolved,14,13,2,-11,12,19,1,-12,JNF,1953,ORGANIZATION,DATE,PROPN,NUM,nsubjpass,pobj,NNP,CD,2,1
5060,12279.0,13,became,9,1,3,2,0,9,8,-6,His,Richmond Jr,PERSON,PERSON-PERSON,DET,PROPN-PROPN,poss,compound-appos,PRP$,NNP-NNP,1,1
5061,12300.0,69,NY-SCHOOLS-CHIEF,0,7,3,-4,6,65,-7,3,Cathleen P. Black,New York,PERSON-PERSON-PERSON,STATE_OR_PROVINCE-STATE_OR_PROVINCE,PROPN-PROPN-PROPN,PROPN-PROPN,compound-compound-nsubj,compound-compound,NNP-NNP-NNP,NNP-NNP,2,1
5062,26727.0,38,misspelled,22,9,2,-7,8,35,13,-20,Cathleen P. Black,New York,PERSON-PERSON-PERSON,STATE_OR_PROVINCE-STATE_OR_PROVINCE,PROPN-PROPN-PROPN,PROPN-PROPN,compound-compound-pobj,compound-compound,NNP-NNP-NNP,NNP-NNP,6,1
5063,43868.0,66,NY-SCHOOLS-CHIEF,0,24,3,-21,23,62,-24,3,Cathleen P. Black,New York,PERSON-PERSON-PERSON,STATE_OR_PROVINCE-STATE_OR_PROVINCE,PROPN-PROPN-PROPN,PROPN-PROPN,compound-compound-pobj,compound-compound,NNP-NNP-NNP,NNP-NNP,7,1
5064,56874.0,48,NY-SCHOOLS-RESIGN,0,27,3,-24,26,44,-27,3,Cathleen P. Black,New York,PERSON-PERSON-PERSON,STATE_OR_PROVINCE-STATE_OR_PROVINCE,PROPN-PROPN-PROPN,PROPN-PROPN,compound-compound-pobj,compound-compound,NNP-NNP-NNP,NNP-NNP,-1,1
5065,12304.0,43,said,10,2,9,7,1,33,8,-1,David Gregory,M&S,PERSON-PERSON,ORGANIZATION,PROPN-PROPN,PROPN,compound-nsubj,pobj,NNP-NNP,NNP,4,1
5066,12308.0,22,founded,3,2,6,4,1,15,1,3,ADB,"Dec 19 , 1966",ORGANIZATION,DATE-DATE-DATE-DATE,PROPN,PROPN-NUM-PUNCT-NUM,nsubjpass,pobj-nummod-punct-nummod,NNP,"NNP-CD-,-CD",4,1
5067,12311.0,17,died,7,3,6,3,2,10,4,-1,her,Suzy,PERSON,PERSON,DET,PROPN,poss,appos,PRP$,NNPS,4,1
5068,19742.0,19,2008-10-26T18,0,5,8,3,4,10,-5,8,her,Suzy,PERSON,PERSON,DET,PROPN,poss,appos,PRP$,NNPS,3,1
5069,12317.0,20,confirmed,7,1,5,4,0,14,6,-2,Crisp,Richard Dent,PERSON,PERSON-PERSON,PROPN,PROPN-PROPN,poss,compound-appos,NNP,NNP-NNP,3,1
5070,12319.0,43,In,0,21,20,-1,20,22,-21,20,Paul Watson,activist,PERSON-PERSON,TITLE,PROPN-PROPN,NOUN,compound-poss,compound,NNP-NNP,NN,2,1
5071,12322.0,28,said,12,24,14,-10,23,13,-12,2,Focus on the Family,Bill Maier,ORGANIZATION-ORGANIZATION-ORGANIZATION-ORGANIZATION,PERSON-PERSON,PROPN-ADP-DET-PROPN,PROPN-PROPN,appos-prep-det-pobj,compound-nsubj,NNP-IN-DT-NNP,NNP-NNP,7,1
5072,12329.0,49,preside,9,36,20,-16,35,28,-27,11,Convocation of Anglicans in North America,Martyn Minns,ORGANIZATION-ORGANIZATION-ORGANIZATION-ORGANIZATION-ORGANIZATION-ORGANIZATION,PERSON-PERSON,PROPN-ADP-PROPN-ADP-PROPN-PROPN,PROPN-PROPN,pobj-prep-pobj-prep-compound-pobj,compound-dobj,NNP-IN-NNPS-IN-NNP-NNP,NNP-NNP,9,1
5073,64201.0,25,became,6,11,5,-6,10,19,-5,-1,Convocation of Anglicans in North America,Martyn Minns,ORGANIZATION-ORGANIZATION-ORGANIZATION-ORGANIZATION-ORGANIZATION-ORGANIZATION,PERSON-PERSON,PROPN-ADP-PROPN-ADP-PROPN-PROPN,PROPN-PROPN,pobj-prep-pobj-prep-compound-pobj,compound-nsubj,NNP-IN-NNPS-IN-NNP-NNP,NNP-NNP,5,1
5074,66030.0,38,responded,24,7,1,-6,6,36,17,-23,Convocation of Anglicans in North America,Martyn Minns,ORGANIZATION-ORGANIZATION-ORGANIZATION-ORGANIZATION-ORGANIZATION-ORGANIZATION,PERSON-PERSON,PROPN-ADP-PROPN-ADP-PROPN-PROPN,PROPN-PROPN,pobj-prep-pobj-prep-compound-pobj,compound-nsubj,NNP-IN-NNPS-IN-NNP-NNP,NNP-NNP,4,1
5075,12337.0,34,said,21,31,23,-8,30,10,-10,2,American Bankers Association,Wayne Abernathy,ORGANIZATION-ORGANIZATION-ORGANIZATION,PERSON-PERSON,PROPN-PROPN-PROPN,PROPN-PROPN,compound-compound-pobj,compound-nsubj,NNP-NNPS-NNP,NNP-NNP,5,1
5076,22658.0,49,said,32,46,34,-12,45,14,-14,2,American Bankers Association,Wayne Abernathy,ORGANIZATION-ORGANIZATION-ORGANIZATION,PERSON-PERSON,PROPN-PROPN-PROPN,PROPN-PROPN,compound-compound-pobj,compound-nsubj,NNP-NNPS-NNP,NNP-NNP,7,1
5077,23744.0,53,said,30,40,32,-8,39,20,-10,2,American Bankers Association,Wayne Abernathy,ORGANIZATION-ORGANIZATION-ORGANIZATION,PERSON-PERSON,PROPN-PROPN-PROPN,PROPN-PROPN,compound-compound-pobj,compound-nsubj,NNP-NNPS-NNP,NNP-NNP,5,1
5078,29276.0,35,said,14,32,16,-16,31,18,-18,2,American Bankers Association,Wayne Abernathy,ORGANIZATION-ORGANIZATION-ORGANIZATION,PERSON-PERSON,PROPN-PROPN-PROPN,PROPN-PROPN,compound-compound-pobj,compound-nsubj,NNP-NNPS-NNP,NNP-NNP,9,1
5079,61328.0,39,WASHINGTON,0,36,28,-8,35,10,-36,28,American Bankers Association,Wayne Abernathy,ORGANIZATION-ORGANIZATION-ORGANIZATION,PERSON-PERSON,PROPN-PROPN-PROPN,PROPN-PROPN,compound-compound-pobj,compound-nsubj,NNP-NNPS-NNP,NNP-NNP,7,1
5080,62464.0,35,said,22,32,24,-8,31,10,-10,2,American Bankers Association,Wayne Abernathy,ORGANIZATION-ORGANIZATION-ORGANIZATION,PERSON-PERSON,PROPN-PROPN-PROPN,PROPN-PROPN,compound-compound-pobj,compound-nsubj,NNP-NNPS-NNP,NNP-NNP,5,1
5081,66316.0,28,said,19,25,21,-4,24,6,-6,2,American Bankers Association,Wayne Abernathy,ORGANIZATION-ORGANIZATION-ORGANIZATION,PERSON-PERSON,PROPN-PROPN-PROPN,PROPN-PROPN,compound-compound-pobj,compound-nsubj,NNP-NNPS-NNP,NNP-NNP,3,1
5082,12341.0,62,says,31,59,34,-25,58,27,-28,3,American Psychiatric Association,Marcia Kraft Goin,ORGANIZATION-ORGANIZATION-ORGANIZATION,PERSON-PERSON-PERSON,PROPN-PROPN-PROPN,PROPN-PROPN-PROPN,compound-compound-pobj,compound-compound-nsubj,NNP-NNP-NNP,NNP-NNP-NNP,6,1
5083,12367.0,20,taken,11,8,2,-6,7,17,3,-9,Remy Smith,artist,PERSON-PERSON,TITLE,PROPN-PROPN,NOUN,compound-attr,nsubjpass,NNP-NNP,NN,3,1
5084,12368.0,41,is,15,1,21,20,0,19,14,6,DeGeneres,model,PERSON,TITLE,PROPN,NOUN,nsubj,attr,NNP,NN,4,1
5085,12372.0,44,blinked,4,3,23,20,2,20,1,19,Raul Castro,Vilma Espin Guillois,PERSON-PERSON,PERSON-PERSON-PERSON,PROPN-PROPN,PROPN-PROPN-PROPN,compound-nsubj,compound-compound-appos,NNP-NNP,NNP-NNP-NNP,8,1
5086,64311.0,25,reported,22,7,10,3,6,14,15,-12,Raul Castro,Vilma Espin Guillois,PERSON-PERSON,PERSON-PERSON-PERSON,PROPN-PROPN,PROPN-PROPN-PROPN,compound-pobj,compound-compound-appos,NNP-NNP,NNP-NNP-NNP,2,1
5087,67974.0,35,mourned,29,10,1,-9,9,33,19,-28,Raul Castro,Vilma Espin Guillois,PERSON-PERSON,PERSON-PERSON-PERSON,PROPN-PROPN,PROPN-PROPN-PROPN,compound-pobj,compound-compound-nsubjpass,NNP-NNP,NNP-NNP-NNP,4,1
5088,12376.0,29,retired,20,20,6,-14,19,22,0,-14,he,commander,PERSON,TITLE,PRON,NOUN,nsubj,pobj,PRP,NN,5,1
5089,66206.0,31,served,3,16,13,-3,15,17,-13,10,he,commander,PERSON,TITLE,PRON,NOUN,nsubj,pobj,PRP,NN,3,1
5090,12380.0,30,submitted,3,9,15,6,8,14,-6,12,Ontario Human Rights Commission,2004-5,ORGANIZATION-ORGANIZATION-ORGANIZATION-ORGANIZATION,NUMBER,PROPN-PROPN-PROPN-PROPN,NOUN,compound-compound-compound-pobj,compound,NNP-NNP-NNPS-NNP,NNS,9,1
5091,12384.0,4,NSG,0,1,3,2,0,0,-1,3,NSG,728-4126,ORGANIZATION,NUMBER,PROPN,NUM,ROOT,appos,NNP,CD,4,1
5092,12385.0,24,entered,8,1,19,18,0,4,7,11,FirstGroup,Ryder Public Transportation Services Inc,ORGANIZATION,ORGANIZATION-ORGANIZATION-ORGANIZATION-ORGANIZATION-ORGANIZATION,PROPN,PROPN-PROPN-PROPN-PROPN-PROPN,nsubj,compound-compound-compound-compound-dobj,NNP,NNP-NNP-NNP-NNPS-NNP,6,1
5093,12392.0,63,said,42,50,45,-5,49,17,-8,3,Project Islamic Hope,Ali,ORGANIZATION-ORGANIZATION-ORGANIZATION,PERSON,PROPN-PROPN-PROPN,PROPN,compound-compound-pobj,nsubj,NNP-NNP-NNP,NNP,4,1
5094,67243.0,25,said,16,22,18,-4,21,6,-6,2,Project Islamic Hope,Ali,ORGANIZATION-ORGANIZATION-ORGANIZATION,PERSON,PROPN-PROPN-PROPN,PROPN,compound-compound-pobj,nsubj,NNP-NNP-NNP,NNP,4,1
5095,12396.0,39,issued,20,17,19,2,16,19,3,-1,Fyffes,Ireland,ORGANIZATION,COUNTRY,PROPN,PROPN,conj,pobj,NNP,NNP,7,1
5096,29252.0,30,Fyffes,2,3,1,-2,2,28,-1,-1,Fyffes,Ireland,ORGANIZATION,COUNTRY,PROPN,PROPN,ROOT,poss,NNP,NNP,3,1
5097,30769.0,51,said,49,27,29,2,26,21,22,-20,Fyffes,Ireland,ORGANIZATION,COUNTRY,PROPN,PROPN,conj,pobj,NNP,NNP,6,1
5098,12404.0,43,are,1,11,30,19,10,12,-10,29,Northland Church,he,ORGANIZATION-ORGANIZATION,PERSON,PROPN-PROPN,PRON,compound-pobj,nsubj,NNP-NNP,PRP,6,1
5099,12425.0,38,hold,2,21,12,-9,20,25,-19,10,Hu Sheng,Chairman,PERSON-PERSON,TITLE,PROPN-PROPN,PROPN,compound-compound,dobj,NNP-NNP,NNP,-1,1
5100,12432.0,40,become,16,1,11,10,0,28,15,-5,Dodd,Senate Foreign Relations committee,PERSON,ORGANIZATION-ORGANIZATION-ORGANIZATION-ORGANIZATION,ADV,PROPN-PROPN-PROPN-NOUN,nsubj,compound-compound-compound-pobj,RB,NNP-NNP-NNPS-NN,7,1
5101,12445.0,24,said,21,18,11,-7,17,12,3,-10,Richmond Flowers,Dothan,PERSON-PERSON,CITY,PROPN-PROPN,PROPN,compound-compound,pobj,NNP-NNP,NNP,4,1
5102,12446.0,42,started,7,1,5,4,0,36,6,-2,Cowell,record producer,PERSON,TITLE-TITLE,PROPN,NOUN-NOUN,nsubj,compound-appos,NNP,NN-NN,2,1
5103,12448.0,13,REVIEWED,3,7,1,-6,6,11,-4,-2,AMA,BRCC,ORGANIZATION,ORGANIZATION,PROPN,PROPN,compound,compound,NNP,NNP,4,1
5104,12456.0,46,said,17,8,1,-7,7,44,9,-16,New Hampshire Institute of Politics,Jennifer Donahue,ORGANIZATION-ORGANIZATION-ORGANIZATION-ORGANIZATION-ORGANIZATION,PERSON-PERSON,PROPN-PROPN-PROPN-ADP-PROPN,PROPN-PROPN,compound-compound-pobj-prep-pobj,compound-nsubj,NNP-NNP-NNP-IN-NNP,NNP-NNP,4,1
5105,12972.0,28,thinks,13,8,1,-7,7,26,5,-12,New Hampshire Institute of Politics,Jennifer Donahue,ORGANIZATION-ORGANIZATION-ORGANIZATION-ORGANIZATION-ORGANIZATION,PERSON-PERSON,PROPN-PROPN-PROPN-ADP-PROPN,PROPN-PROPN,compound-compound-pobj-prep-pobj,compound-nsubj,NNP-NNP-NNP-IN-NNP,NNP-NNP,4,1
5106,12471.0,52,became,4,33,32,-1,32,19,-29,28,Kurt Waldheim,president,PERSON-PERSON,TITLE,PROPN-PROPN,NOUN,compound-pobj,compound,NNP-NNP,NN,2,1
5107,12487.0,47,likes,13,2,10,8,1,36,11,-3,Juanita Millender-McDonald,House Administration Committee,PERSON-PERSON,ORGANIZATION-ORGANIZATION-ORGANIZATION,PROPN-PROPN,PROPN-PROPN-PROPN,compound-nsubj,compound-compound-pobj,NNP-NNP,NNP-NNP-NNP,5,1
5108,16102.0,51,likes,17,1,14,13,0,36,16,-3,Juanita Millender-McDonald,House Administration Committee,PERSON-PERSON,ORGANIZATION-ORGANIZATION-ORGANIZATION,PROPN-PROPN,PROPN-PROPN-PROPN,compound-conj,compound-compound-pobj,NNP-NNP,NNP-NNP-NNP,6,1
5109,12490.0,30,designated,2,24,4,-20,23,25,-22,2,Al Hubbard,Health and Human Services,PERSON-PERSON,ORGANIZATION-ORGANIZATION-ORGANIZATION-ORGANIZATION,PROPN-PROPN,PROPN-CCONJ-PROPN-PROPN,compound-conj,nmod-cc-compound-conj,NNP-NNP,NNP-CC-NNP-NNPS,5,1
5110,12520.0,60,survived,9,8,40,32,7,19,1,31,Nolte,Douglas,PERSON,PERSON,PROPN,PROPN,nsubjpass,conj,NNP,NNP,10,1
5111,38592.0,73,survived,9,8,40,32,7,32,1,31,Nolte,Douglas,PERSON,PERSON,PROPN,PROPN,nsubjpass,appos,NNP,NNP,6,1
5112,12536.0,4,was,1,1,3,2,0,0,0,2,He,56,PERSON,NUMBER,PRON,NUM,nsubj,attr,PRP,CD,1,1
5113,36154.0,8,PARIS,0,5,7,2,4,0,-5,7,He,56,PERSON,NUMBER,PRON,NUM,nsubj,attr,PRP,CD,-1,1
5114,12546.0,47,survived,2,1,34,33,0,12,1,32,Henebry,Jeannine Rublee,PERSON,PERSON-PERSON,NOUN,PROPN-PROPN,nsubjpass,compound-conj,NN,NNP-NNP,5,1
5115,12565.0,22,MESKILL,2,1,8,7,0,13,1,6,THOMAS J MESKILL,CONGRESSMAN,PERSON-PERSON-PERSON,ORGANIZATION,PROPN-PROPN-PROPN,PROPN,compound-compound-ROOT,appos,NNP-NNP-NNP,NNP,3,1
5116,12568.0,22,met,8,16,13,-3,15,8,-8,5,Gholam Ali Haddad Adel,parliament,PERSON-PERSON-PERSON-PERSON,ORGANIZATION,PROPN-PROPN-PROPN-PROPN,NOUN,compound-compound-compound-dobj,compound,NNP-NNP-NNP-NNP,NN,2,1
5117,12573.0,27,expressed,19,1,14,13,0,12,18,-5,John Dewey,New York City Transit Authority,PERSON-PERSON,ORGANIZATION-ORGANIZATION-ORGANIZATION-ORGANIZATION-ORGANIZATION,PROPN-PROPN,PROPN-PROPN-PROPN-PROPN-PROPN,compound-nsubj,compound-compound-compound-compound-pobj,NNP-NNP,NNP-NNP-NNP-NNP-NNP,4,1
5118,12574.0,63,presiding,37,2,34,32,1,28,35,-3,Raul Castro,77,PERSON-PERSON,NUMBER,PROPN-PROPN,NUM,compound-nsubj,appos,NNP-NNP,CD,3,1
5119,17661.0,15,shows,6,2,5,3,1,9,4,-1,Raul Castro,77,PERSON-PERSON,NUMBER,PROPN-PROPN,NUM,compound-nsubj,appos,NNP-NNP,CD,2,1
5120,28126.0,39,named,11,4,7,3,3,31,7,-4,Raul Castro,77,PERSON-PERSON,NUMBER,PROPN-PROPN,NUM,compound-nsubjpass,appos,NNP-NNP,CD,2,1
5121,44942.0,37,appears,8,4,7,3,3,29,4,-1,Raul Castro,77,PERSON-PERSON,NUMBER,PROPN-PROPN,NUM,compound-nsubj,appos,NNP-NNP,CD,2,1
5122,57932.0,62,presiding,36,2,34,32,1,27,34,-2,Raul Castro,77,PERSON-PERSON,NUMBER,PROPN-PROPN,NUM,compound-nsubj,appos,NNP-NNP,CD,3,1
5123,12576.0,43,helped,20,1,6,5,0,36,19,-14,Crisp,"Washington , DC",PERSON,CITY-CITY-CITY,PROPN,PROPN-PUNCT-PROPN,nsubj,pobj-punct-appos,NNP,"NNP-,-NNP",5,1
5124,12586.0,51,died,40,1,50,49,0,0,39,10,Richard Nolte,NH,PERSON-PERSON,STATE_OR_PROVINCE,PROPN-PROPN,PROPN,compound-nsubj,appos,NNP-NNP,NNP,7,1
5125,12587.0,35,said,33,32,26,-6,31,8,1,-7,FAW,An Tiecheng,ORGANIZATION,PERSON-PERSON,PROPN,DET-PROPN,pobj,det-nsubj,NNP,DT-NNP,5,1
5126,12593.0,31,'s,2,23,27,4,22,3,-21,25,CMA,Tammy Genovese,ORGANIZATION,PERSON-PERSON,PROPN,PROPN-PROPN,compound,compound-nsubj,NNP,NNP-NNP,4,1
5127,31253.0,35,said,24,30,26,-4,29,8,-6,2,CMA,Tammy Genovese,ORGANIZATION,PERSON-PERSON,PROPN,PROPN-PROPN,poss,compound-nsubj,NNP,NNP-NNP,3,1
5128,12608.0,50,said,1,1,45,44,0,4,0,44,Simcox,Arizona,PERSON,STATE_OR_PROVINCE,PROPN,PROPN,nsubj,compound,NNP,NNP,6,1
5129,12617.0,49,died,39,1,48,47,0,0,38,9,Mary D Crisp,Phoenix,PERSON-PERSON-PERSON,CITY,PROPN-PROPN-PROPN,PROPN,compound-compound-nsubj,pobj,NNP-NNP-NNP,NNP,5,1
5130,12637.0,32,said,19,29,27,-2,28,4,-10,8,Crown Prosecution Service,Manchester,ORGANIZATION-ORGANIZATION-ORGANIZATION,ORGANIZATION,PROPN-PROPN-PROPN,PROPN,compound-compound-pobj,poss,NNP-NNP-NNP,NNP,2,1
5131,12646.0,43,Keli,1,7,21,14,6,21,-6,20,Taiwan Research Institute,Beijing,ORGANIZATION-ORGANIZATION-ORGANIZATION,CITY,PROPN-PROPN-PROPN,PROPN,compound-compound-pobj,pobj,NNP-NNP-NNP,NNP,6,1
5132,58254.0,76,Keli,1,7,21,14,6,54,-6,20,Taiwan Research Institute,Beijing,ORGANIZATION-ORGANIZATION-ORGANIZATION,CITY,PROPN-PROPN-PROPN,PROPN,compound-compound-pobj,pobj,NNP-NNP-NNP,NNP,6,1
5133,12650.0,26,said,11,5,1,-4,4,24,6,-10,IMF,Dan Citrin,ORGANIZATION,PERSON-PERSON,PROPN,PROPN-PROPN,poss,compound-nsubj,NNP,NNP-NNP,3,1
5134,12653.0,51,insisting,18,2,15,13,1,35,16,-3,Justice and Equality Movement,Darfur,ORGANIZATION-ORGANIZATION-ORGANIZATION-ORGANIZATION,LOCATION,PROPN-CCONJ-PROPN-PROPN,PROPN,nmod-cc-conj-nsubj,pobj,NNP-CC-NNP-NNP,NNP,4,1
5135,12654.0,31,said,19,13,9,-4,12,21,6,-10,Millonarios,Juan Carlos Lopez,ORGANIZATION,PERSON-PERSON-PERSON,PROPN,PROPN-PROPN-PROPN,pobj,compound-compound-appos,NNP,NNP-NNP-NNP,4,1
5136,12666.0,49,concerns,2,7,10,3,6,38,-5,8,Michael Sandy,29,PERSON-PERSON,NUMBER,PROPN-PROPN,NUM,compound-pobj,appos,NNP-NNP,CD,1,1
5137,50433.0,28,said,3,11,14,3,10,13,-8,11,Michael Sandy,29,PERSON-PERSON,NUMBER,PROPN-PROPN,NUM,compound-pobj,appos,NNP-NNP,CD,1,1
5138,50558.0,29,fled,5,1,4,3,0,24,4,-1,Michael Sandy,29,PERSON-PERSON,NUMBER,PROPN-PROPN,NUM,compound-nsubj,appos,NNP-NNP,CD,2,1
5139,12668.0,44,produced,7,5,3,-2,4,40,2,-4,China Faw Group,1953,ORGANIZATION-ORGANIZATION-ORGANIZATION,DATE,PROPN-PROPN-PROPN,NUM,compound-compound-nsubj,pobj,NNP-NNP-NNP,CD,3,1
5140,12675.0,51,split,3,25,10,-15,24,40,-22,7,Robert Morgenthau,Lucinda,PERSON-PERSON,PERSON,PROPN-PROPN,PROPN,compound-pobj,npadvmod,NNP-NNP,NNP,4,1
5141,12676.0,33,managed,15,9,11,2,8,21,6,-4,Alice,20,PERSON,NUMBER,PROPN,NUM,appos,appos,NNP,CD,3,1
5142,12677.0,41,represented,13,19,27,8,18,13,-6,14,Central American Parliament,Guatemala City,ORGANIZATION-ORGANIZATION-ORGANIZATION,CITY-CITY,ADJ-PROPN-PROPN,PROPN-PROPN,compound-compound-pobj,compound-pobj,JJ-NNP-NNP,NNP-NNP,4,1
5143,27770.0,25,poised,1,6,18,12,5,6,-5,17,Central American Parliament,Guatemala City,ORGANIZATION-ORGANIZATION-ORGANIZATION,CITY-CITY,ADJ-PROPN-PROPN,PROPN-PROPN,amod-compound-compound,compound-pobj,JJ-NNP-NNP,NNP-NNP,8,1
5144,48683.0,22,set,12,2,9,7,1,12,10,-3,Central American Parliament,Guatemala City,ORGANIZATION-ORGANIZATION-ORGANIZATION,CITY-CITY,ADJ-PROPN-PROPN,PROPN-PROPN,compound-compound-nsubjpass,compound-pobj,JJ-NNP-NNP,NNP-NNP,5,1
5145,12681.0,46,said,17,8,8,0,7,37,9,-9,New Hampshire Institute of Politics,New Hampshire,ORGANIZATION-ORGANIZATION-ORGANIZATION-ORGANIZATION-ORGANIZATION,STATE_OR_PROVINCE-STATE_OR_PROVINCE,PROPN-PROPN-PROPN-ADP-PROPN,PROPN-PROPN,compound-compound-pobj-prep-pobj,compound-pobj,NNP-NNP-NNP-IN-NNP,NNP-NNP,0,1
5146,46697.0,46,said,17,8,8,0,7,37,9,-9,New Hampshire Institute of Politics,New Hampshire,ORGANIZATION-ORGANIZATION-ORGANIZATION-ORGANIZATION-ORGANIZATION,STATE_OR_PROVINCE-STATE_OR_PROVINCE,PROPN-PROPN-PROPN-ADP-PROPN,PROPN-PROPN,compound-compound-pobj-prep-pobj,compound-pobj,NNP-NNP-NNP-IN-NNP,NNP-NNP,0,1
5147,50978.0,28,said,14,12,12,0,11,15,2,-2,New Hampshire Institute of Politics,New Hampshire,ORGANIZATION-ORGANIZATION-ORGANIZATION-ORGANIZATION-ORGANIZATION,STATE_OR_PROVINCE-STATE_OR_PROVINCE,PROPN-PROPN-PROPN-ADP-PROPN,PROPN-PROPN,compound-compound-pobj-prep-pobj,compound-pobj,NNP-NNP-NNP-IN-NNP,NNP-NNP,0,1
5148,64591.0,65,said,35,12,12,0,11,52,23,-23,New Hampshire Institute of Politics,New Hampshire,ORGANIZATION-ORGANIZATION-ORGANIZATION-ORGANIZATION-ORGANIZATION,STATE_OR_PROVINCE-STATE_OR_PROVINCE,PROPN-PROPN-PROPN-ADP-PROPN,PROPN-PROPN,compound-compound-pobj-prep-pobj,nmod-nmod,NNP-NNP-NNP-IN-NNP,NNP-NNP,0,1
5149,12683.0,30,died,1,10,6,-4,9,23,-9,5,her,lung cancer,PERSON,CAUSE_OF_DEATH-CAUSE_OF_DEATH,DET,NOUN-NOUN,poss,compound-pobj,PRP$,NN-NN,6,1
5150,12690.0,44,considering,8,4,2,-2,3,41,4,-6,National Red Cross,Seoul,ORGANIZATION-ORGANIZATION-ORGANIZATION,CITY,PROPN-PROPN-PROPN,PROPN,compound-compound-nsubj,poss,NNP-NNP-NNP,NNP,3,1
5151,12703.0,41,arrested,8,25,4,-21,24,36,-17,-4,Badr Corps,Shiite,ORGANIZATION-ORGANIZATION,RELIGION,PROPN-PROPN,ADJ,compound-conj,amod,NNP-NNP,JJ,3,1
5152,59026.0,27,Many,0,14,25,11,13,1,-14,25,Badr Corps,Shiite,ORGANIZATION-ORGANIZATION,RELIGION,PROPN-PROPN,ADJ,compound-conj,amod,NNP-NNP,JJ,8,1
5153,12719.0,49,Bond,0,16,30,14,15,18,-16,30,Julian Bond,chairman,PERSON-PERSON,TITLE,PROPN-PROPN,NOUN,compound-nsubj,appos,NNP-NNP,NN,-1,1
5154,19526.0,20,wrote,11,9,8,-1,8,11,2,-3,Julian Bond,chairman,PERSON-PERSON,TITLE,PROPN-PROPN,NOUN,compound-nsubj,compound,NNP-NNP,NN,1,1
5155,20585.0,28,says,2,1,27,26,0,0,1,25,Julian Bond,chairman,PERSON-PERSON,TITLE,PROPN-PROPN,NOUN,compound-nsubj,dobj,NNP-NNP,NN,2,1
5156,25797.0,35,said,24,26,30,4,25,4,-2,6,Julian Bond,chairman,PERSON-PERSON,TITLE,PROPN-PROPN,NOUN,compound-nsubj,appos,NNP-NNP,NN,2,1
5157,66907.0,25,chosen,11,17,22,5,16,2,-6,11,Julian Bond,chairman,PERSON-PERSON,TITLE,PROPN-PROPN,NOUN,compound-pobj,poss,NNP-NNP,NN,6,1
5158,12721.0,9,Submariner,0,4,3,-1,3,5,-4,3,William Anderson,Congressman,PERSON-PERSON,TITLE,PROPN-PROPN,PROPN,compound-conj,compound,NNP-NNP,NNP,1,1
5159,66466.0,27,Dies,8,4,3,-1,3,23,4,-5,William Anderson,Congressman,PERSON-PERSON,ORGANIZATION,PROPN-PROPN,PROPN,compound-conj,compound,NNP-NNP,NNP,1,1
5160,12723.0,34,said,25,28,30,2,27,3,-3,5,League,Amir Hossain Amu,ORGANIZATION,PERSON-PERSON-PERSON,PROPN,PROPN-PROPN-PROPN,compound,compound-compound-nsubj,NNP,NNP-NNP-NNP,3,1
5161,12724.0,23,joined,2,1,16,15,0,6,1,14,Ahearn,Washington,PERSON,STATE_OR_PROVINCE,VERB,PROPN,nsubj,pobj,VB,NNP,3,1
5162,12738.0,22,appointed,5,7,10,3,6,11,-2,5,her,Director 's Advisory Committee,PERSON,ORGANIZATION-ORGANIZATION-ORGANIZATION-ORGANIZATION,PRON,PROPN-PART-PROPN-PROPN,dobj,poss-case-compound-pobj,PRP,NNP-POS-NNP-NNP,3,1
5163,12741.0,36,said,20,33,22,-11,32,13,-13,2,American Bankers Association,Ken Clayton,ORGANIZATION-ORGANIZATION-ORGANIZATION,PERSON-PERSON,PROPN-PROPN-PROPN,PROPN-PROPN,compound-compound-pobj,compound-nsubj,NNP-NNPS-NNP,NNP-NNP,7,1
5164,21336.0,24,said,14,11,1,-10,10,22,3,-13,American Bankers Association,Ken Clayton,ORGANIZATION-ORGANIZATION-ORGANIZATION,PERSON-PERSON,PROPN-PROPN-PROPN,PROPN-PROPN,compound-compound-pobj,compound-nsubj,NNP-NNPS-NNP,NNP-NNP,6,1
5165,54398.0,40,said,27,37,29,-8,36,10,-10,2,American Bankers Association,Ken Clayton,ORGANIZATION-ORGANIZATION-ORGANIZATION,PERSON-PERSON,PROPN-PROPN-PROPN,PROPN-PROPN,compound-compound-pobj,compound-nsubj,NNP-NNPS-NNP,NNP-NNP,5,1
5166,12743.0,30,published,1,7,12,5,6,17,-6,11,his,National Geographic,PERSON,ORGANIZATION-ORGANIZATION,DET,PROPN-PROPN,poss,compound-compound,PRP$,NNP-NNP,3,1
5167,12746.0,34,been,10,1,7,6,0,26,9,-3,Fidelity,Boston,ORGANIZATION,CITY,PROPN,PROPN,nsubj,pobj,NNP,NNP,3,1
5168,33539.0,33,said,10,1,7,6,0,25,9,-3,Fidelity,Boston,ORGANIZATION,CITY,PROPN,PROPN,nsubj,pobj,NNP,NNP,5,1
5169,12748.0,35,is,6,26,16,-10,25,18,-20,10,Covidien PLC,Exalgo,ORGANIZATION-ORGANIZATION,ORGANIZATION,PROPN-PROPN,PROPN,compound-pobj,appos,NNP-NNP,NNP,5,1
5170,12749.0,56,NAMED,4,36,1,-35,35,54,-32,-3,Mainland Affairs Council,TAIWAN,ORGANIZATION-ORGANIZATION-ORGANIZATION,COUNTRY,PROPN-PROPN-PROPN,PROPN,compound-compound-pobj,compound,NNP-NNPS-NNP,NNP,-1,1
5171,12756.0,53,said,39,2,49,47,1,3,37,10,ADB,South Pacific Subregional Office,ORGANIZATION,ORGANIZATION-ORGANIZATION-ORGANIZATION-ORGANIZATION,PROPN,PROPN-PROPN-PROPN-PROPN,poss,compound-compound-compound-pobj,NNP,NNP-NNP-NNP-NNP,8,1
5172,12763.0,82,shot,17,58,73,15,57,8,-41,56,her,Oct,PERSON,DATE,PRON,PROPN,nsubj,compound,PRP,NNP,6,1
5173,12764.0,42,was,1,1,35,34,0,6,0,34,Verity,Ford 's Theatre,PERSON,ORGANIZATION-ORGANIZATION-ORGANIZATION,PROPN,PROPN-PART-PROPN,nsubj,poss-case-pobj,NNP,NNP-POS-NNP,16,1
5174,12772.0,42,running,17,10,23,13,9,18,7,6,Awami League,London,ORGANIZATION-ORGANIZATION,CITY,PROPN-PROPN,PROPN,compound-nmod,pobj,NNP-NNP,NNP,6,1
5175,12777.0,29,graduated,5,25,17,-8,24,11,-20,12,ANP,Afghanistan,ORGANIZATION,COUNTRY,PROPN,PROPN,compound,pobj,NNP,NNP,4,1
5176,12780.0,18,Art,0,17,9,-8,16,8,-17,9,Washington,National Museum of Women in the Arts,ORGANIZATION,STATE_OR_PROVINCE-STATE_OR_PROVINCE-STATE_OR_PROVINCE-STATE_OR_PROVINCE-STATE_OR_PROVINCE-STATE_OR_PROVINCE-STATE_OR_PROVINCE,PROPN,PROPN-PROPN-ADP-PROPN-ADP-DET-PROPN,pobj,compound-pobj-prep-pobj-prep-det-pobj,NNP,NNP-NNP-IN-NNPS-IN-DT-NNPS,3,1
5177,12784.0,44,faces,5,18,27,9,17,16,-13,22,Murat Kurnaz,Bremen,PERSON-PERSON,CITY,PROPN-PROPN,PROPN,compound-pobj,pobj,NNP-NNP,NNP,7,1
5178,59680.0,53,held,14,1,10,9,0,42,13,-4,Murat Kurnaz,Bremen,PERSON-PERSON,CITY,PROPN-PROPN,PROPN,compound-compound,pobj,NNP-NNP,NNP,1,1
5179,12788.0,25,is,8,15,24,9,14,0,-7,16,Chad White,Oregon,PERSON-PERSON,STATE_OR_PROVINCE,PROPN-PROPN,PROPN,compound-appos,appos,NNP-NNP,NNP,6,1
5180,12794.0,23,survived,7,6,4,-2,5,18,1,-3,Rothman,Andrea,PERSON,PERSON,PROPN,PROPN,nsubjpass,pobj,NNP,NNP,2,1
5181,12803.0,41,said,24,9,15,6,8,25,15,-9,Ownit Mortgage Solutions,U.S.,ORGANIZATION-ORGANIZATION-ORGANIZATION,COUNTRY,PROPN-PROPN-PROPN,PROPN,compound-compound-pobj,compound,NNP-NNP-NNPS,NNP,4,1
5182,12805.0,40,lay,21,1,32,31,0,7,20,11,Irene Morgan Kirkaldy,Friday,PERSON-PERSON-PERSON,DATE,PROPN-PROPN-PROPN,PROPN,compound-compound-nsubj,npadvmod,NNP-NNP-NNP,NNP,3,1
5183,12808.0,18,took,4,7,1,-6,6,16,-3,-3,Samsung,Lee Byung-Chull,ORGANIZATION,PERSON-PERSON,PROPN,PROPN-PROPN,dobj,appos-oprd,NNP,NNP-NNP,3,1
5184,12814.0,41,TEHRAN,0,10,9,-1,9,31,-10,9,Ali Larijani,Speaker,PERSON-PERSON,TITLE,PROPN-PROPN,PROPN,compound-nsubj,compound,NNP-NNP,NNP,1,1
5185,61363.0,52,TEHRAN,0,9,8,-1,8,43,-9,8,Ali Larijani,Speaker,PERSON-PERSON,TITLE,PROPN-PROPN,PROPN,compound-nsubj,compound,NNP-NNP,NNP,1,1
5186,12828.0,43,joined,24,35,27,-8,34,15,-11,3,Frankie Delgado,MTV,PERSON-PERSON,ORGANIZATION,PROPN-PROPN,PROPN,compound-conj,compound,NNP-NNP,NNP,4,1
5187,54890.0,43,joined,24,35,27,-8,34,15,-11,3,Frankie Delgado,MTV,PERSON-PERSON,ORGANIZATION,PROPN-PROPN,PROPN,compound-conj,compound,NNP-NNP,NNP,4,1
5188,12840.0,18,said,6,2,5,3,1,12,4,-1,Paul Gillmor,R-Ohio,PERSON-PERSON,STATE_OR_PROVINCE,PROPN-PROPN,PROPN,compound-nsubj,appos,NNP-NNP,NNP,2,1
5189,15832.0,38,said,36,2,5,3,1,32,34,-31,Paul Gillmor,R-Ohio,PERSON-PERSON,LOCATION,PROPN-PROPN,PROPN,compound-nsubjpass,appos,NNP-NNP,NNP,2,1
5190,22716.0,23,says,21,5,8,3,4,14,16,-13,Paul Gillmor,R-Ohio,PERSON-PERSON,STATE_OR_PROVINCE,PROPN-PROPN,PROPN,compound-nsubjpass,appos,NNP-NNP,NNP,2,1
5191,12858.0,28,lives,14,4,17,13,3,10,10,3,Sculfor,Los Angeles,PERSON,CITY-CITY,PROPN,PROPN-PROPN,nsubj,compound-pobj,NNP,NNP-NNP,3,1
5192,12861.0,24,told,21,7,16,9,6,7,14,-5,David,Malawian,PERSON,NATIONALITY,PROPN,ADJ,nsubj,amod,NNP,JJ,3,1
5193,12866.0,36,wore,3,30,34,4,29,1,-27,31,FA,Nottingham Forest,ORGANIZATION,ORGANIZATION-ORGANIZATION,PROPN,PROPN-PROPN,compound,compound-pobj,NNP,NNP-NNP,3,1
5194,12881.0,33,revealed,16,9,16,7,8,16,7,0,Ali Larijani,negotiator,PERSON-PERSON,TITLE,PROPN-PROPN,NOUN,compound-conj,appos,NNP-NNP,NN,3,1
5195,27285.0,36,warned,33,32,31,-1,31,4,1,-2,Ali Larijani,negotiator,PERSON-PERSON,TITLE,PROPN-PROPN,NOUN,compound-nsubj,compound,NNP-NNP,NN,1,1
5196,29186.0,49,said,32,31,30,-1,30,18,1,-2,Ali Larijani,negotiator,PERSON-PERSON,TITLE,PROPN-PROPN,NOUN,compound-nsubj,compound,NNP-NNP,NN,1,1
5197,32190.0,33,reported,30,6,5,-1,5,27,24,-25,Ali Larijani,negotiator,PERSON-PERSON,TITLE,PROPN-PROPN,NOUN,compound-appos,nsubj,NNP-NNP,NN,1,1
5198,50199.0,17,told,1,15,13,-2,14,3,-14,12,Ali Larijani,negotiator,PERSON-PERSON,TITLE,PROPN-PROPN,NOUN,compound-appos,pobj,NNP-NNP,NN,2,1
5199,53436.0,34,said,7,6,5,-1,5,28,1,-2,Ali Larijani,negotiator,PERSON-PERSON,TITLE,PROPN-PROPN,NOUN,compound-appos,nsubj,NNP-NNP,NN,1,1
5200,60611.0,22,announced,20,18,17,-1,17,4,2,-3,Ali Larijani,negotiator,PERSON-PERSON,TITLE,PROPN-PROPN,NOUN,compound-conj,compound,NNP-NNP,NN,1,1
5201,62604.0,20,holding,10,8,7,-1,7,12,2,-3,Ali Larijani,negotiator,PERSON-PERSON,TITLE,PROPN-PROPN,NOUN,compound-appos,nsubj,NNP-NNP,NN,1,1
5202,12894.0,40,sparked,15,9,12,3,8,27,6,-3,David,Malawi,PERSON,COUNTRY,PROPN,PROPN,dobj,pobj,NNP,NNP,3,1
5203,22325.0,43,granted,4,16,19,3,15,23,-12,15,David,Malawi,PERSON,NATIONALITY,PROPN,PROPN,dobj,pobj,NNP,NNP,2,1
5204,12905.0,38,were,7,6,1,-5,5,36,1,-6,Spencer Pratt,Heidi Montag,PERSON-PERSON,PERSON-PERSON,PROPN-PROPN,PROPN-PROPN,compound-conj,compound-nsubj,NNP-NNP,NNP-NNP,2,1
5205,35480.0,26,is,2,18,24,6,17,1,-16,22,Spencer Pratt,Heidi Montag,PERSON-PERSON,PERSON-PERSON,PROPN-PROPN,PROPN-PROPN,compound-pobj,compound-appos,NNP-NNP,NNP-NNP,2,1
5206,38273.0,21,are,1,13,10,-3,12,10,-12,9,Spencer Pratt,Heidi Montag,PERSON-PERSON,PERSON-PERSON,PROPN-PROPN,PROPN-PROPN,compound-conj,compound-nsubj,NNP-NNP,NNP-NNP,1,1
5207,40406.0,31,have,3,11,17,6,10,13,-8,14,Spencer Pratt,Heidi Montag,PERSON-PERSON,PERSON-PERSON,PROPN-PROPN,PROPN-PROPN,compound-nsubj,compound-pobj,NNP-NNP,NNP-NNP,3,1
5208,47015.0,7,Labels,0,6,3,-3,5,3,-6,3,Spencer Pratt,Heidi Montag,PERSON-PERSON,PERSON-PERSON,PROPN-PROPN,PROPN-PROPN,compound-appos,compound-conj,NNP-NNP,NNP-NNP,1,1
5209,55008.0,40,said,21,20,27,7,19,12,1,6,Spencer Pratt,Heidi Montag,PERSON-PERSON,PERSON-PERSON,PROPN-PROPN,PROPN-PROPN,compound-nsubj,compound-pobj,NNP-NNP,NNP-NNP,6,1
5210,12907.0,42,wasting,13,11,26,15,10,15,2,13,Kelly Cutrone,People 's Revolution,PERSON-PERSON,ORGANIZATION-ORGANIZATION-ORGANIZATION,PROPN-PROPN,PROPN-PART-PROPN,compound-npadvmod,poss-case-pobj,NNP-NNP,NNPS-POS-NNP,6,1
5211,15992.0,52,returns,3,38,41,3,37,10,-35,38,Kelly Cutrone,People 's Revolution,PERSON-PERSON,ORGANIZATION-ORGANIZATION-ORGANIZATION,PROPN-PROPN,PROPN-PART-PROPN,compound-poss,poss-case-nmod,NNP-NNP,NNPS-POS-NNP,3,1
5212,27262.0,38,Kelli,0,36,32,-4,35,5,-36,32,Kelly Cutrone,People 's Revolution,PERSON-PERSON,ORGANIZATION-ORGANIZATION-ORGANIZATION,PROPN-PROPN,PROPN-PART-PROPN,compound-conj,poss-case-compound,NNP-NNP,NNPS-POS-NNP,6,1
5213,56972.0,20,oversee,12,1,8,7,0,11,11,-4,Kelly Cutrone,People 's Revolution,PERSON-PERSON,ORGANIZATION-ORGANIZATION-ORGANIZATION,PROPN-PROPN,PROPN-PART-PROPN,compound-nsubj,poss-case-pobj,NNP-NNP,NNPS-POS-NNP,2,1
5214,12908.0,30,said,28,28,25,-3,27,4,0,-3,Dillinger,arbitrator,PERSON,TITLE,PROPN,NOUN,nsubj,attr,NNP,NN,5,1
5215,12923.0,42,said,38,30,36,6,29,5,8,-2,Robert M Morgenthau,district attorney,PERSON-PERSON-PERSON,TITLE-TITLE,PROPN-PROPN-PROPN,NOUN-NOUN,compound-compound-nsubj,compound-appos,NNP-NNP-NNP,NN-NN,2,1
5216,12926.0,35,approved,6,23,22,-1,22,12,-17,16,Danny Glover,star,PERSON-PERSON,TITLE,PROPN-PROPN,NOUN,compound-pobj,compound,NNP-NNP,NN,1,1
5217,44316.0,37,approved,6,25,24,-1,24,12,-19,18,Danny Glover,star,PERSON-PERSON,TITLE,PROPN-PROPN,NOUN,compound-pobj,compound,NNP-NNP,NN,1,1
5218,47620.0,33,added,5,31,9,-22,30,23,-26,4,Danny Glover,star,PERSON-PERSON,TITLE,PROPN-PROPN,NOUN,compound-pobj,compound,NNP-NNP,NN,7,1
5219,51256.0,29,is,2,21,4,-17,20,24,-19,2,Danny Glover,star,PERSON-PERSON,TITLE,PROPN-PROPN,NOUN,compound-conj,npadvmod,NNP-NNP,NN,4,1
5220,12933.0,19,hold,10,15,8,-7,14,10,-5,-2,159,Nina Bracewell-Smith,ORGANIZATION,PERSON-PERSON,NUM,PROPN-PROPN,nummod,conj-conj,CD,NNP-NNP,6,1
5221,12935.0,29,said,20,22,25,3,21,3,-2,5,Cathie Black,president,PERSON-PERSON,TITLE,PROPN-PROPN,NOUN,compound-nsubj,appos,NNP-NNP,NN,2,1
5222,28084.0,31,is,8,1,4,3,0,26,7,-4,Cathie Black,president,PERSON-PERSON,TITLE,PROPN-PROPN,NOUN,compound-nsubj,appos,NNP-NNP,NN,2,1
5223,12938.0,55,said,12,5,9,4,4,45,7,-3,American Bar Association,Karen J Mathis,ORGANIZATION-ORGANIZATION-ORGANIZATION,PERSON-PERSON-PERSON,PROPN-PROPN-PROPN,PROPN-PROPN-PROPN,compound-compound-pobj,compound-compound-appos,NNP-NNP-NNP,NNP-NNP-NNP,5,1
5224,35656.0,41,said,14,5,9,4,4,31,9,-5,American Bar Association,Karen J Mathis,ORGANIZATION-ORGANIZATION-ORGANIZATION,PERSON-PERSON-PERSON,PROPN-PROPN-PROPN,PROPN-PROPN-PROPN,compound-compound-pobj,compound-compound-appos,NNP-NNP-NNP,NNP-NNP-NNP,5,1
5225,43940.0,55,said,43,52,45,-7,51,9,-9,2,American Bar Association,Karen J Mathis,ORGANIZATION-ORGANIZATION-ORGANIZATION,PERSON-PERSON-PERSON,PROPN-PROPN-PROPN,PROPN-PROPN-PROPN,compound-compound-pobj,compound-compound-nsubj,NNP-NNP-NNP,NNP-NNP-NNP,5,1
5226,12947.0,17,nominates,1,6,13,7,5,3,-5,12,Hubbard,official,PERSON,TITLE,PROPN,NOUN,dobj,attr,NNP,NN,2,1
5227,12949.0,8,rapper,3,5,8,3,4,-1,-2,5,Remy Ma,assault,PERSON-PERSON,CRIMINAL_CHARGE,PROPN-PROPN,NOUN,compound-appos,pobj,NNP-NNP,NN,-1,1
5228,22893.0,37,convicted,11,9,14,5,8,22,2,3,Remy Ma,assault,PERSON-PERSON,CRIMINAL_CHARGE,PROPN-PROPN,NOUN,compound-nsubjpass,pobj,NNP-NNP,NN,3,1
5229,30885.0,12,convicted,4,8,11,3,7,0,-4,7,Remy Ma,assault,PERSON-PERSON,CRIMINAL_CHARGE,PROPN-PROPN,NOUN,compound-appos,pobj,NNP-NNP,NN,2,1
5230,36685.0,21,pleaded,3,1,12,11,0,8,2,9,Remy Ma,assault,PERSON-PERSON,CRIMINAL_CHARGE,PROPN-PROPN,NOUN,compound-nsubj,conj,NNP-NNP,NN,7,1
5231,55102.0,36,went,2,1,7,6,0,28,1,5,Remy Ma,assault,PERSON-PERSON,CRIMINAL_CHARGE,PROPN-PROPN,NOUN,compound-nsubj,pobj,NNP-NNP,NN,2,1
5232,58931.0,15,convicted,3,2,6,4,1,8,1,3,Remy Ma,assault,PERSON-PERSON,CRIMINAL_CHARGE,PROPN-PROPN,NOUN,compound-nsubj,pobj,NNP-NNP,NN,3,1
5233,12959.0,39,was,10,3,7,4,2,31,7,-3,Mia Farrow,UNICEF,PERSON-PERSON,ORGANIZATION,PROPN-PROPN,PROPN,compound-nsubj,compound,NNP-NNP,NNP,2,1
5234,38096.0,38,calling,3,25,22,-3,24,15,-22,19,Mia Farrow,UNICEF,PERSON-PERSON,ORGANIZATION,PROPN-PROPN,PROPN,compound-conj,compound,NNP-NNP,NNP,2,1
5235,55950.0,35,came,1,15,12,-3,14,22,-14,11,Mia Farrow,UNICEF,PERSON-PERSON,ORGANIZATION,PROPN-PROPN,PROPN,compound-conj,compound,NNP-NNP,NNP,2,1
5236,12960.0,16,Productions,2,5,9,4,4,6,-3,7,http://wwwyolanda-kingcom,Coretta Scott King,PERSON,PERSON-PERSON-PERSON,X,PROPN-PROPN-PROPN,ROOT,compound-compound-appos,ADD,NNP-NNP-NNP,3,1
5237,12975.0,46,look,1,12,8,-4,11,37,-11,7,John Kerry,United States,PERSON-PERSON,COUNTRY-COUNTRY,PROPN-PROPN,PROPN-PROPN,compound-pobj,compound-compound,NNP-NNP,NNP-NNP,5,1
5238,52174.0,37,compared,15,14,11,-3,13,25,1,-4,John Kerry,United States,PERSON-PERSON,COUNTRY-COUNTRY,PROPN-PROPN,PROPN-PROPN,compound-nsubj,compound-pobj,NNP-NNP,NNP-NNP,7,1
5239,12978.0,16,leaves,10,10,4,-6,9,11,0,-6,Sills,her,PERSON,PERSON,PROPN,DET,nsubj,poss,NNP,PRP$,4,1
5240,60588.0,33,confirm,4,20,10,-10,19,22,-16,6,Sills,her,PERSON,PERSON,PROPN,DET,nsubj,poss,NNP,PRP$,6,1
5241,12982.0,54,announced,10,8,31,23,7,22,2,21,Detroit Medical Center,Blackstone Group,ORGANIZATION-ORGANIZATION-ORGANIZATION,ORGANIZATION-ORGANIZATION,PROPN-PROPN-PROPN,PROPN-PROPN,compound-compound-nsubj,compound-pobj,NNP-NNP-NNP,NNP-NNP,9,1
5242,12992.0,33,said,5,1,4,3,0,28,4,-1,MNLF,Hatimil Hassan,ORGANIZATION,PERSON-PERSON,PROPN,PROPN-PROPN,compound,compound-nsubj,NNP,NNP-NNP,2,1
5243,13000.0,38,said,13,15,25,10,14,12,-2,12,Bill Deaver,Michael Deaver,PERSON-PERSON,PERSON-PERSON,PROPN-PROPN,PROPN-PROPN,compound-nsubj,compound-pobj,NNP-NNP,NNP-NNP,6,1
5244,13015.0,54,were,19,30,10,-20,29,43,-11,-9,Hawkins,California,PERSON,STATE_OR_PROVINCE,PROPN,PROPN,nsubj,compound,NNP,NNP,4,1
5245,23951.0,47,said,41,1,13,12,0,33,40,-28,Hawkins,California,PERSON,STATE_OR_PROVINCE,PROPN,PROPN,nsubj,compound,NNP,NNP,5,1
5246,62490.0,12,Hawkins,0,1,3,2,0,8,-1,3,Hawkins,California,PERSON,STATE_OR_PROVINCE,PROPN,PROPN,ROOT,poss,NNP,NNP,4,1
5247,13028.0,30,buried,19,24,5,-19,23,24,-5,-14,his,"Dec. 14 , 1923",PERSON,DATE-DATE-DATE-DATE,DET,PROPN-NUM-PUNCT-NUM,poss,pobj-nummod-punct-nummod,PRP$,"NNP-CD-,-CD",8,1
5248,13029.0,45,struggling,32,13,13,0,12,31,19,-19,Detroit Medical Center,Detroit,ORGANIZATION-ORGANIZATION-ORGANIZATION,CITY,PROPN-PROPN-PROPN,PROPN,compound-compound-pobj,pobj,NNP-NNP-NNP,NNP,0,1
5249,33228.0,38,partnered,11,9,9,0,8,28,2,-2,Detroit Medical Center,Detroit,ORGANIZATION-ORGANIZATION-ORGANIZATION,CITY,PROPN-PROPN-PROPN,PROPN,compound-compound-pobj,pobj,NNP-NNP-NNP,NNP,0,1
5250,34312.0,21,has,5,2,2,0,1,18,3,-3,Detroit Medical Center,Detroit,ORGANIZATION-ORGANIZATION-ORGANIZATION,CITY,PROPN-PROPN-PROPN,PROPN,compound-compound-nsubj,compound,NNP-NNP-NNP,NNP,0,1
5251,13047.0,29,became,1,5,22,17,4,6,-4,21,his,Paul,PERSON,PERSON,DET,PROPN,poss,appos,PRP$,NNP,5,1
5252,13048.0,33,told,17,7,15,8,6,17,10,-2,Institute for Diversity and Ethics in Sport,Central Florida,ORGANIZATION-ORGANIZATION-ORGANIZATION-ORGANIZATION-ORGANIZATION-ORGANIZATION-ORGANIZATION,LOCATION-LOCATION,PROPN-ADP-PROPN-CCONJ-PROPN-ADP-PROPN,PROPN-PROPN,pobj-prep-pobj-cc-conj-prep-pobj,compound-pobj,NNP-IN-NNP-CC-NNP-IN-NNP,NNP-NNP,5,1
5253,13053.0,35,reminded,19,18,9,-9,17,25,1,-10,NMFA,Joyce Wessel Raezer,ORGANIZATION,PERSON-PERSON-PERSON,PROPN,PROPN-PROPN-PROPN,pobj,compound-compound-nsubj,NNP,NNP-NNP-NNP,3,1
5254,61148.0,42,is,5,25,16,-9,24,25,-20,11,NMFA,Joyce Wessel Raezer,ORGANIZATION,PERSON-PERSON-PERSON,PROPN,PROPN-PROPN-PROPN,pobj,compound-compound-nsubj,NNP,NNP-NNP-NNP,6,1
5255,13057.0,34,said,32,31,27,-4,30,6,1,-5,APA,Austria Press Agency,ORGANIZATION,ORGANIZATION-ORGANIZATION-ORGANIZATION,PROPN,PROPN-PROPN-PROPN,compound,compound-compound-nsubj,NNP,NNP-NNP-NNP,4,1
5256,13061.0,41,said,19,35,28,-7,34,12,-16,9,Bond,Sacramento,PERSON,CITY,PROPN,PROPN,pobj,pobj,NNP,NNP,5,1
5257,13062.0,26,said,10,19,25,6,18,0,-9,15,AQR Capital Management,Conn.,ORGANIZATION-ORGANIZATION-ORGANIZATION,STATE_OR_PROVINCE,PROPN-PROPN-PROPN,PROPN,compound-compound-pobj,appos,NNP-NNP-NNP,NNP,4,1
5258,14226.0,50,is,1,25,36,11,24,13,-24,35,AQR Capital Management,Conn.,ORGANIZATION-ORGANIZATION-ORGANIZATION,STATE_OR_PROVINCE,PROPN-PROPN-PROPN,PROPN,compound-compound-pobj,appos,NNP-NNP-NNP,NNP,5,1
5259,47259.0,23,began,2,11,22,11,10,0,-9,20,AQR Capital Management,Conn.,ORGANIZATION-ORGANIZATION-ORGANIZATION,STATE_OR_PROVINCE,PROPN-PROPN-PROPN,PROPN,compound-compound-pobj,appos,NNP-NNP-NNP,NNP,5,1
5260,13088.0,41,said,35,33,11,-22,32,29,2,-24,MAC,Taiwan,ORGANIZATION,COUNTRY,PROPN,PROPN,compound,pobj,NNP,NNP,6,1
5261,41350.0,42,responding,2,10,33,23,9,8,-8,31,MAC,Taiwan,ORGANIZATION,COUNTRY,PROPN,PROPN,compound,dobj,NNP,NNP,9,1
5262,42704.0,59,said,1,4,27,23,3,31,-3,26,MAC,Taiwan,ORGANIZATION,COUNTRY,PROPN,PROPN,nsubj,pobj,NNP,NNP,7,1
5263,46648.0,34,proposed,4,8,25,17,7,8,-4,21,MAC,Taiwan,ORGANIZATION,COUNTRY,PROPN,PROPN,pobj,compound,NNP,NNP,4,1
5264,46719.0,34,Council,3,6,19,13,5,14,-3,16,MAC,Taiwan,ORGANIZATION,COUNTRY,PROPN,PROPN,compound,dobj,NNP,NNP,7,1
5265,13089.0,61,DirecTV,0,1,1,0,0,59,-1,1,DirecTV,DirecTV Group Inc,ORGANIZATION,ORGANIZATION-ORGANIZATION-ORGANIZATION,NOUN,PROPN-PROPN-PROPN,poss,ROOT-compound-nsubj,NN,NNP-NNP-NNP,0,1
5266,14316.0,53,said,51,1,1,0,0,51,50,-50,DirecTV,DirecTV Group Inc,ORGANIZATION,ORGANIZATION-ORGANIZATION-ORGANIZATION,PROPN,PROPN-PROPN-PROPN,poss,compound-compound-nsubj,NNP,NNP-NNP-NNP,0,1
5267,33603.0,48,blocks,1,3,3,0,2,44,-2,2,DirecTV,DirecTV Group Inc,ORGANIZATION,ORGANIZATION-ORGANIZATION-ORGANIZATION,VERB,PROPN-PROPN-PROPN,dobj,compound-compound-dobj,VBP,NNP-NNP-NNP,0,1
5268,13090.0,16,has,2,1,14,13,0,1,1,12,The company,"55,000",ORGANIZATION-ORGANIZATION,NUMBER,DET-NOUN,NUM,det-nsubj,nummod,DT-NN,CD,3,1
5269,13096.0,31,survived,3,6,10,4,5,20,-3,7,her,Rev.,PERSON,TITLE,DET,PROPN,poss,compound,PRP$,NNP,2,1
5270,13100.0,28,told,21,6,21,15,5,6,15,0,Raghad Saddam Hussein,he,PERSON-PERSON-PERSON,PERSON,PROPN-PROPN-PROPN,PRON,compound-compound-pobj,nsubj,NNP-NNP-NNP,PRP,6,1
5271,13104.0,31,take,9,5,18,13,4,12,4,9,Anglican Church,Episcopal,ORGANIZATION-ORGANIZATION,RELIGION,PROPN-PROPN,PROPN,compound-pobj,compound,NNP-NNP,NNP,8,1
5272,13109.0,30,face,5,27,18,-9,26,11,-22,13,her,Spencer Pratt,PERSON,PERSON-PERSON,PRON,PROPN-PROPN,poss,compound-conj,PRP,NNP-NNP,8,1
5273,68070.0,13,are,4,8,11,3,7,1,-4,7,her,Spencer Pratt,PERSON,PERSON-PERSON,DET,PROPN-PROPN,poss,compound-appos,PRP$,NNP-NNP,2,1
5274,13118.0,6,is,3,2,5,3,1,0,1,2,Danny Glover,61,PERSON-PERSON,NUMBER,PROPN-PROPN,NUM,compound-nsubj,attr,NNP-NNP,CD,2,1
5275,13120.0,36,sighed,9,11,16,5,10,19,-2,7,Abdul Jalil Jan,50-year-old,PERSON-PERSON-PERSON,DURATION,PROPN-PROPN-PROPN,NUM,compound-compound-nsubj,amod,NNP-NNP-NNP,CD,5,1
5276,13121.0,22,serves,2,16,6,-10,15,15,-14,4,Raul Castro,Communist Party,PERSON-PERSON,ORGANIZATION-ORGANIZATION,PROPN-PROPN,PROPN-PROPN,compound-pobj,compound-poss,NNP-NNP,NNP-NNP,6,1
5277,13123.0,39,came,4,32,15,-17,31,23,-28,11,Deaver,Sober Streets,PERSON,ORGANIZATION-ORGANIZATION,PROPN,PROPN-PROPN,nsubj,compound-conj,NNP,NNP-NNPS,4,1
5278,13125.0,24,be,19,5,11,6,4,12,14,-8,Jake Pavelka,Texas,PERSON-PERSON,STATE_OR_PROVINCE,PROPN-PROPN,PROPN,compound-dobj,pobj,NNP-NNP,NNP,3,1
5279,13127.0,79,is,50,16,8,-8,15,70,34,-42,Chinese Communist Party,Propaganda Department of the Central Committee,ORGANIZATION-ORGANIZATION-ORGANIZATION,ORGANIZATION-ORGANIZATION-ORGANIZATION-ORGANIZATION-ORGANIZATION-ORGANIZATION,PROPN-PROPN-PROPN,PROPN-PROPN-ADP-DET-PROPN-PROPN,compound-compound-pobj,compound-pobj-prep-det-compound-pobj,NNP-NNP-NNP,NNP-NNP-IN-DT-NNP-NNP,5,1
5280,13131.0,29,said,4,6,2,-4,5,26,-2,-2,he,coach,PERSON,TITLE,PRON,NOUN,nsubj,compound,PRP,NN,3,1
5281,13145.0,30,said,23,1,19,18,0,10,22,-4,Forsberg,Bronx,PERSON,LOCATION,PROPN,PROPN,nsubj,compound,NNP,NNP,4,1
5282,13156.0,25,be,2,15,5,-10,14,19,-13,3,Ownit Mortgage Solutions,William Dallas,ORGANIZATION-ORGANIZATION-ORGANIZATION,PERSON-PERSON,PROPN-PROPN-PROPN,PROPN-PROPN,compound-compound-compound,compound-nsubj,NNP-NNP-NNPS,NNP-NNP,3,1
5283,57017.0,45,said,20,28,22,-6,27,22,-8,2,Ownit Mortgage Solutions,William Dallas,ORGANIZATION-ORGANIZATION-ORGANIZATION,PERSON-PERSON,PROPN-PROPN-PROPN,PROPN-PROPN,compound-compound-pobj,compound-nsubj,NNP-NNP-NNPS,NNP-NNP,5,1
5284,13163.0,51,said,6,5,3,-2,4,47,1,-3,Philip Chen,Chief Executive,PERSON-PERSON,TITLE-TITLE,PROPN-PROPN,PROPN-PROPN,compound-nsubj,compound-compound,NNP-NNP,NNP-NNP,1,1
5285,13166.0,25,said,23,4,15,11,3,9,19,-8,Pascal Yoadimnadji,hemorrhage,PERSON-PERSON,CAUSE_OF_DEATH,PROPN-PROPN,NOUN,compound-nsubj,pobj,NNP-NNP,NN,3,1
5286,34410.0,17,died,7,5,16,11,4,0,2,9,Pascal Yoadimnadji,hemorrhage,PERSON-PERSON,CAUSE_OF_DEATH,PROPN-PROPN,NOUN,compound-appos,pobj,NNP-NNPS,NN,3,1
5287,13168.0,37,selected,5,16,20,4,15,16,-11,15,American Bar Association,ABA,ORGANIZATION-ORGANIZATION-ORGANIZATION,ORGANIZATION,PROPN-PROPN-PROPN,PROPN,compound-compound-pobj,compound,NNP-NNP-NNP,NNP,6,1
5288,22389.0,33,backs,3,1,13,12,0,19,2,10,American Bar Association,ABA,ORGANIZATION-ORGANIZATION-ORGANIZATION,ORGANIZATION,PROPN-PROPN-PROPN,PROPN,compound-compound-nsubj,poss,NNP-NNP-NNP,NNP,8,1
5289,26204.0,82,Rally,4,2,19,17,1,62,2,15,American Bar Association,ABA,ORGANIZATION-ORGANIZATION-ORGANIZATION,ORGANIZATION,PROPN-PROPN-PROPN,NOUN,compound-compound-compound,compound,NNP-NNP-NNP,NN,-1,1
5290,51829.0,26,newsletter,1,20,24,4,19,1,-19,23,American Bar Association,ABA,ORGANIZATION-ORGANIZATION-ORGANIZATION,ORGANIZATION,PROPN-PROPN-PROPN,PROPN,compound-compound-pobj,compound,NNP-NNP-NNP,NNP,8,1
5291,66704.0,14,concluded,11,1,11,10,0,2,10,0,American Bar Association,ABA,ORGANIZATION-ORGANIZATION-ORGANIZATION,ORGANIZATION,PROPN-PROPN-PROPN,NOUN,compound-compound-dep,nsubj,NNP-NNP-NNP,NN,2,1
5292,13169.0,30,said,23,1,15,14,0,14,22,-8,Forsberg,Oct 19,PERSON,DATE-DATE,PROPN,PROPN-NUM,nsubj,dobj-nummod,NNP,NNP-CD,4,1
5293,13178.0,56,got,36,1,47,46,0,8,35,11,Richard H. Nolte,Hanover,PERSON-PERSON-PERSON,CITY,PROPN-PROPN-PROPN,PROPN,compound-compound-nsubj,pobj,NNP-NNP-NNP,NNP,-1,1
5294,57455.0,56,got,36,1,47,46,0,8,35,11,Richard H. Nolte,Hanover,PERSON-PERSON-PERSON,CITY,PROPN-PROPN-PROPN,PROPN,compound-compound-nsubj,pobj,NNP-NNP-NNP,NNP,-1,1
5295,13183.0,39,weathered,17,1,3,2,0,35,16,-14,Waldheim,86,PERSON,NUMBER,PROPN,NUM,nsubj,appos,NNP,CD,2,1
5296,13192.0,36,conducted,16,7,15,8,6,20,9,-1,Focus on the Family,Colo.,ORGANIZATION-ORGANIZATION-ORGANIZATION-ORGANIZATION,STATE_OR_PROVINCE,PROPN-ADP-DET-PROPN,PROPN,appos-prep-det-pobj,appos,NNP-IN-DT-NNP,NNP,4,1
5297,44346.0,38,FOCUS-DALY-ART,0,18,6,-12,17,31,-18,6,Focus on the Family,Colo.,ORGANIZATION-ORGANIZATION-ORGANIZATION-ORGANIZATION,STATE_OR_PROVINCE,PROPN-ADP-DET-PROPN,PROPN,pobj-prep-det-pobj,compound,NNP-IN-DT-NNP,NNP,-1,1
5298,13204.0,19,led,2,4,17,13,3,1,-2,15,Fidelity Management and Research Co,Abigail Johnson,ORGANIZATION-ORGANIZATION-ORGANIZATION-ORGANIZATION-ORGANIZATION,PERSON-PERSON,PROPN-PROPN-CCONJ-PROPN-PROPN,PROPN-PROPN,compound-dobj-cc-compound-conj,compound-pobj,NNP-NNP-CC-NNP-NNP,NNP-NNP,4,1
5299,13210.0,19,exploded,3,11,18,7,10,0,-8,15,Mahdi,imam,PERSON,TITLE,PROPN,NOUN,pobj,conj,NNP,NN,6,1
5300,13217.0,76,posts,1,1,62,61,0,13,0,61,MBIA,Gary Dunton,ORGANIZATION,PERSON-PERSON,PROPN,PROPN-PROPN,nsubj,compound-nsubj,NNP,NNP-NNP,1,1
5301,13494.0,51,said,46,41,45,4,40,5,5,-1,MBIA,Gary Dunton,ORGANIZATION,PERSON-PERSON,PROPN,PROPN-PROPN,compound,compound-conj,NNP,NNP-NNP,3,1
5302,47141.0,48,said,37,42,39,-3,41,8,-5,2,MBIA,Gary Dunton,ORGANIZATION,PERSON-PERSON,PROPN,PROPN-PROPN,poss,compound-nsubj,NNP,NNP-NNP,3,1
5303,13224.0,32,2008-02-28T22,0,26,28,2,25,3,-26,28,NEC,Im Suosdey,ORGANIZATION,PERSON-PERSON,PROPN,PROPN-PROPN,compound,compound-nsubj,NNP,NNP-NNP,1,1
5304,40932.0,54,Ambassador,1,13,8,-5,12,45,-12,7,NEC,Im Suosdey,ORGANIZATION,PERSON-PERSON,PROPN,PROPN-PROPN,pobj,compound-conj,NNP,NNP-NNP,6,1
5305,13233.0,39,said,12,11,24,13,10,14,1,12,Shah Mahmood,Prince,PERSON-PERSON,TITLE,PROPN-PROPN,PROPN,compound-appos,compound,NNP-NNP,NNP,10,1
5306,13235.0,43,TEHRAN,0,20,39,19,19,3,-20,39,Seyed Ali Khamenei,IRNA,PERSON-PERSON-PERSON,ORGANIZATION,PROPN-PROPN-PROPN,PROPN,csubj-compound-dobj,compound,NNP-NNP-NNP,NNP,7,1
5307,13241.0,49,said,44,34,4,-30,33,44,10,-40,Ali-Akbar Salehi,Iran,PERSON-PERSON,COUNTRY,PROPN-PROPN,PROPN,compound-nsubj,poss,NNP-NNP,NNP,6,1
5308,13256.0,33,said,2,4,1,-3,3,31,-2,-1,his,Clyde Bellecourt,PERSON,PERSON-PERSON,DET,PROPN-PROPN,poss,compound-nsubj,PRP$,NNP-NNP,3,1
5309,13265.0,42,appointed,7,1,9,8,0,32,6,2,Philip Chen,chairman of John Swire & Sons,PERSON-PERSON,TITLE-TITLE-TITLE-TITLE-TITLE-TITLE,PROPN-PROPN,NOUN-ADP-PROPN-PROPN-CCONJ-PROPN,compound-nsubjpass,oprd-prep-compound-pobj-cc-conj,NNP-NNP,NN-IN-NNP-NNP-CC-NNPS,3,1
5310,13267.0,24,said,1,3,6,3,2,17,-2,5,al-Tai,army officer,PERSON,TITLE-TITLE,X,NOUN-NOUN,punct,compound-attr,ADD,NN-NN,4,1
5311,13273.0,34,said,14,1,11,10,0,22,13,-3,Mahmood Shah,semiautonomous tribal area,PERSON-PERSON,ORGANIZATION-ORGANIZATION-ORGANIZATION,PROPN-PROPN,ADJ-ADJ-NOUN,compound-nsubj,amod-amod-pobj,NNP-NNP,JJ-JJ-NN,4,1
5312,13278.0,49,Corporation,3,1,9,8,0,39,2,6,China National Aviation Corporation,CNAC,ORGANIZATION-ORGANIZATION-ORGANIZATION-ORGANIZATION,ORGANIZATION,PROPN-PROPN-PROPN-PROPN,PROPN,compound-compound-compound-ROOT,compound,NNP-NNP-NNP-NNP,NNP,-1,1
5313,24556.0,38,Dec,2,10,19,9,9,18,-8,17,China National Aviation Corporation,CNAC,ORGANIZATION-ORGANIZATION-ORGANIZATION-ORGANIZATION,ORGANIZATION,PROPN-PROPN-PROPN-PROPN,PROPN,compound-compound-compound-conj,compound,NNP-NNP-NNP-NNP,NNP,-1,1
5314,30537.0,17,Corporation,6,4,9,5,3,7,2,3,China National Aviation Corporation,CNAC,ORGANIZATION-ORGANIZATION-ORGANIZATION-ORGANIZATION,ORGANIZATION,PROPN-PROPN-PROPN-PROPN,PROPN,compound-compound-compound-ROOT,compound,NNP-NNP-NNP-NNP,NNP,2,1
5315,49357.0,31,Airlines,4,3,12,9,2,18,1,8,China National Aviation Corporation,CNAC,ORGANIZATION-ORGANIZATION-ORGANIZATION-ORGANIZATION,ORGANIZATION,PROPN-PROPN-PROPN-PROPN,PROPN,compound-compound-compound-conj,compound,NNP-NNP-NNP-NNP,NNP,-1,1
5316,13280.0,36,said,34,7,5,-2,6,30,27,-29,Itochu,Japan,ORGANIZATION,COUNTRY,PROPN,PROPN,nsubj,conj,NNP,NNP,3,1
5317,31207.0,63,were,5,24,18,-6,23,44,-19,13,Itochu,Japan,ORGANIZATION,COUNTRY,PROPN,PROPN,conj,poss,NNP,NNP,4,1
5318,34304.0,14,invest,4,3,1,-2,2,12,1,-3,Itochu,Japan,ORGANIZATION,COUNTRY,PROPN,PROPN,nsubj,poss,NNP,NNP,4,1
5319,52231.0,46,invest,4,3,1,-2,2,44,1,-3,Itochu,Japan,ORGANIZATION,COUNTRY,PROPN,PROPN,nsubj,poss,NNP,NNP,4,1
5320,58093.0,10,take,4,3,1,-2,2,8,1,-3,Itochu,Japan,ORGANIZATION,COUNTRY,PROPN,PROPN,nsubj,poss,NNP,NNP,4,1
5321,59076.0,32,said,1,1,22,21,0,9,0,21,Itochu,Japan,ORGANIZATION,COUNTRY,PROPN,PROPN,nsubj,pobj,NNP,NNP,8,1
5322,13288.0,30,died,1,10,5,-5,9,24,-9,4,his,88,PERSON,NUMBER,DET,NUM,poss,pobj,PRP$,CD,5,1
5323,62352.0,23,returned,5,8,4,-4,7,18,-3,-1,his,88,PERSON,NUMBER,DET,NUM,poss,appos,PRP$,CD,3,1
5324,13289.0,48,STORRS,0,28,1,-27,27,46,-28,1,Spelman College,STORRS,ORGANIZATION-ORGANIZATION,CITY,PROPN-PROPN,PROPN,compound-pobj,ROOT,NNP-NNP,NNP,-1,1
5325,13296.0,43,quit,13,20,1,-19,19,41,-7,-12,All Basotho Convention,Thabane,ORGANIZATION-ORGANIZATION-ORGANIZATION,PERSON,PROPN-PROPN-PROPN,PROPN,compound-compound-dobj,nsubj,NNP-NNP-NNP,NNP,5,1
5326,45993.0,29,won,14,11,9,-2,10,19,3,-5,All Basotho Convention,Thabane,ORGANIZATION-ORGANIZATION-ORGANIZATION,PERSON,PROPN-PROPN-PROPN,PROPN,compound-compound-nsubj,poss,NNP-NNP-NNP,NNP,4,1
5327,63690.0,45,said,13,7,1,-6,6,43,6,-12,All Basotho Convention,Thabane,ORGANIZATION-ORGANIZATION-ORGANIZATION,PERSON,PROPN-PROPN-PROPN,PROPN,compound-compound-pobj,nsubj,NNP-NNP-NNP,NNP,5,1
5328,13316.0,21,said,15,17,19,2,16,1,-2,4,Chief Executive,Peter Clarke,ORGANIZATION-ORGANIZATION,PERSON-PERSON,PROPN-PROPN,PROPN-PROPN,compound-compound,compound-nsubj,NNP-NNP,NNP-NNP,3,1
5329,13319.0,46,said,41,11,16,5,10,29,30,-25,U.S. Army Medical Command,Kiley,ORGANIZATION-ORGANIZATION-ORGANIZATION-ORGANIZATION,PERSON,PROPN-PROPN-PROPN-PROPN,PROPN,compound-compound-compound-pobj,nsubj,NNP-NNP-NNP-NNP,NNP,7,1
5330,13342.0,47,wrote,38,20,37,17,19,9,18,-1,EnergySolutions,Mark Walker,ORGANIZATION,PERSON-PERSON,PROPN,PROPN-PROPN,compound,compound-nsubj,NNP,NNP-NNP,9,1
5331,36672.0,17,said,6,4,1,-3,3,15,2,-5,EnergySolutions,Mark Walker,ORGANIZATION,PERSON-PERSON,PROPN,PROPN-PROPN,compound,compound-nsubj,NNP,NNP-NNP,1,1
5332,13345.0,38,said,34,15,14,-1,14,23,19,-20,Morgenthau,Bob Morgenthau,PERSON,PERSON-PERSON,PROPN,PROPN-PROPN,pobj,compound-nsubj,NNP,NNP-NNP,1,1
5333,13356.0,69,include,5,23,27,4,22,41,-18,22,Jennifer Dunn,Washington state,PERSON-PERSON,ORGANIZATION-ORGANIZATION,PROPN-PROPN,PROPN-NOUN,compound-conj,compound-pobj,NNP-NNP,NNP-NN,2,1
5334,13366.0,25,appeared,5,23,3,-20,22,21,-18,-2,King,actress,PERSON,TITLE,PROPN,NOUN,appos,pobj,NNP,NN,5,1
5335,13375.0,50,said,42,44,46,2,43,3,-2,4,Carnival,Jennifer de la Cruz,ORGANIZATION,PERSON-PERSON-PERSON-PERSON,PROPN,PROPN-PROPN-X-PROPN,compound,compound-compound-compound-nsubj,NNP,NNP-NNP-FW-NNP,13,1
5336,13393.0,33,said,15,12,1,-11,11,31,3,-14,Carnival Cruise Lines,Vicki Freed,ORGANIZATION-ORGANIZATION-ORGANIZATION,PERSON-PERSON,PROPN-PROPN-PROPN,PROPN-PROPN,compound-compound-pobj,compound-nsubj,NNP-NNP-NNP,NNP-NNP,6,1
5337,13394.0,47,suffered,22,1,31,30,0,15,21,9,The younger Castro,Vilma Espin,PERSON-PERSON-PERSON,PERSON-PERSON,DET-ADJ-PROPN,PROPN-PROPN,det-amod-nsubj,compound-appos,DT-JJR-NNP,NNP-NNP,5,1
5338,13399.0,31,joined,4,23,6,-17,22,24,-19,2,his,UBS,PERSON,ORGANIZATION,DET,PROPN,poss,dobj,PRP$,NNP,8,1
5339,13404.0,29,died,16,2,28,26,1,0,14,12,Juanita Millender-McDonald,Calif.,PERSON-PERSON,STATE_OR_PROVINCE,PROPN-PROPN,PROPN,compound-nsubj,appos,NNP-NNP,NNP,5,1
5340,47038.0,9,Calif.,0,4,1,-3,3,7,-4,1,Juanita Millender-McDonald,Calif.,PERSON-PERSON,STATE_OR_PROVINCE,PROPN-PROPN,PROPN,compound-ROOT,ROOT,NNP-NNP,NNP,-1,1
5341,13411.0,43,said,18,35,21,-14,34,21,-17,3,American Psychiatric Association,Gerald Kay,ORGANIZATION-ORGANIZATION-ORGANIZATION,PERSON-PERSON,PROPN-PROPN-PROPN,PROPN-PROPN,compound-compound-compound,compound-nsubj,NNP-NNP-NNP,NNP-NNP,7,1
5342,13412.0,41,said,6,5,4,-1,4,36,1,-2,Philip Chen,Executive,PERSON-PERSON,TITLE,PROPN-PROPN,PROPN,compound-nsubj,compound,NNP-NNP,NNP,1,1
5343,14638.0,34,were,11,32,31,-1,31,2,-21,20,Philip Chen,Executive,PERSON-PERSON,TITLE,PROPN-PROPN,PROPN,compound-conj,compound,NNP-NNP,NNP,1,1
5344,24687.0,31,said,6,5,4,-1,4,26,1,-2,Philip Chen,Executive,PERSON-PERSON,TITLE,PROPN-PROPN,PROPN,compound-nsubj,compound,NNP-NNP,NNP,1,1
5345,25463.0,39,made,15,14,13,-1,13,25,1,-2,Philip Chen,Executive,PERSON-PERSON,TITLE,PROPN-PROPN,PROPN,compound-nsubj,compound,NNP-NNP,NNP,1,1
5346,37650.0,21,said,13,19,18,-1,18,2,-6,5,Philip Chen,Executive,PERSON-PERSON,TITLE,PROPN-PROPN,PROPN,compound-nsubj,compound,NNP-NNP,NNP,2,1
5347,39160.0,51,said,6,5,4,-1,4,46,1,-2,Philip Chen,Executive,PERSON-PERSON,TITLE,PROPN-PROPN,PROPN,compound-nsubj,compound,NNP-NNP,NNP,1,1
5348,46611.0,46,presented,7,5,4,-1,4,41,2,-3,Philip Chen,Executive,PERSON-PERSON,TITLE,PROPN-PROPN,PROPN,compound-nsubj,compound,NNP-NNP,NNP,1,1
5349,13418.0,23,put,8,1,5,4,0,17,7,-3,New South Wales Waratahs,coach Ewen McKenzie,ORGANIZATION-ORGANIZATION-ORGANIZATION-ORGANIZATION,PERSON-PERSON-PERSON,PROPN-PROPN-PROPN-PROPN,NOUN-PROPN-PROPN,compound-compound-compound-compound,compound-compound-nsubj,NNP-NNP-NNP-NNP,NN-NNP-NNP,5,1
5350,13426.0,24,said,18,20,22,2,19,1,-2,4,ConAgra,Dave Jackson,ORGANIZATION,PERSON-PERSON,PROPN,PROPN-PROPN,compound,compound-nsubj,NNP,NNP-NNP,1,1
5351,14422.0,19,said,4,1,3,2,0,15,3,-1,ConAgra,Dave Jackson,ORGANIZATION,PERSON-PERSON,PROPN,PROPN-PROPN,compound,compound-nsubj,NNP,NNP-NNP,1,1
5352,13433.0,14,is,6,5,1,-4,4,12,1,-5,NFC South,TAMPA,ORGANIZATION-ORGANIZATION,ORGANIZATION,PROPN-PROPN,PROPN,compound-pobj,compound,NNP-NNP,NNP,2,1
5353,13434.0,18,rose,1,1,4,3,0,13,0,3,He,captain,PERSON,TITLE,PRON,NOUN,nsubj,pobj,PRP,NN,1,1
5354,45618.0,29,served,1,1,16,15,0,12,0,15,He,captain,PERSON,TITLE,PRON,NOUN,nsubj,pobj,PRP,NN,4,1
5355,13444.0,35,offers,15,23,34,11,22,0,-8,19,Justice and Equality Movement,Sudan,ORGANIZATION-ORGANIZATION-ORGANIZATION-ORGANIZATION,PERSON,PROPN-CCONJ-PROPN-PROPN,PROPN,nmod-cc-conj-appos,pobj,NNP-CC-NNP-NNP,NNP,5,1
5356,55730.0,34,said,7,4,17,13,3,16,3,10,Justice and Equality Movement,Sudan,ORGANIZATION-ORGANIZATION-ORGANIZATION-ORGANIZATION,COUNTRY,PROPN-CCONJ-PROPN-PROPN,PROPN,nmod-cc-conj-nsubj,poss,NNP-CC-NNP-NNP,NNP,10,1
5357,13451.0,40,has,19,1,17,16,0,22,18,-2,Citibank,"53,000",ORGANIZATION,NUMBER,PROPN,NUM,nsubj,nummod,NNP,CD,5,1
5358,13453.0,44,pointed,1,14,1,-13,13,42,-13,0,Gholam Ali Haddad Adel,He,PERSON-PERSON-PERSON-PERSON,PERSON,PROPN-PROPN-PROPN-PROPN,PRON,compound-compound-compound-appos,nsubj,NNP-NNP-NNP-NNP,PRP,2,1
5359,13481.0,25,headed,2,1,16,15,0,8,1,14,He,consultant,PERSON,TITLE,PRON,NOUN,nsubj,attr,PRP,NN,4,1
5360,13485.0,50,---------------------------------------------------------------------------,0,37,36,-1,36,13,-37,36,Hugo Chavez,dictator,PERSON-PERSON,TITLE,PROPN-PROPN,NOUN,compound-nsubj,compound,NNP-NNP,NN,1,1
5361,13492.0,52,died,37,1,35,34,0,16,36,-2,Pamela Gardner Ahearn,executive assistant,PERSON-PERSON-PERSON,TITLE-TITLE,PROPN-PROPN-PROPN,ADJ-NOUN,compound-compound-nsubj,amod-pobj,NNP-NNP-NNP,JJ-NN,3,1
5362,13499.0,59,turned,12,45,44,-1,44,14,-33,32,Jennifer Dunn,representative,PERSON-PERSON,TITLE,PROPN-PROPN,NOUN,compound-appos,compound,NNP-NNP,NN,2,1
5363,17342.0,30,said,28,3,2,-1,2,27,25,-26,Jennifer Dunn,representative,PERSON-PERSON,TITLE,PROPN-PROPN,NOUN,compound-nsubj,compound,NNP-NNP,NN,1,1
5364,66240.0,59,turned,12,45,44,-1,44,14,-33,32,Jennifer Dunn,representative,PERSON-PERSON,TITLE,PROPN-PROPN,NOUN,compound-conj,compound,NNP-NNP,NN,2,1
5365,13507.0,26,said,17,19,24,5,18,1,-2,7,Mamoor Khan,security official,PERSON-PERSON,TITLE-TITLE,PROPN-PROPN,NOUN-NOUN,compound-nsubj,compound-appos,NNP-NNP,NN-NN,1,1
5366,13508.0,41,died,33,1,40,39,0,0,32,7,Jefferson J. DeBlanc,La.,PERSON-PERSON-PERSON,STATE_OR_PROVINCE,PROPN-PROPN-PROPN,PROPN,compound-compound-nsubj,appos,NNP-NNP-NNP,NNP,3,1
5367,13515.0,47,died,36,1,27,26,0,19,35,-9,Vernon Bellecourt,leader,PERSON-PERSON,TITLE,PROPN-PROPN,NOUN,compound-nsubj,pobj,NNP-NNP,NN,8,1
5368,16374.0,31,said,29,1,6,5,0,24,28,-23,Vernon Bellecourt,leader,PERSON-PERSON,TITLE,PROPN-PROPN,NOUN,compound-nsubj,appos,NNP-NNP,NN,2,1
5369,13523.0,27,grew,4,1,8,7,0,18,3,4,Harry Shuler Dent,St. Matthews,PERSON-PERSON-PERSON,LOCATION-LOCATION,PROPN-PROPN-PROPN,PROPN-PROPN,compound-compound-nsubj,compound-pobj,NNP-NNP-NNP,NNP-NNP,4,1
5370,13525.0,48,organized,39,31,35,4,30,12,8,-4,Noordhoff Craniofacial Foundation,NCF,ORGANIZATION-ORGANIZATION-ORGANIZATION,ORGANIZATION,PROPN-PROPN-PROPN,PROPN,compound-compound-pobj,compound,NNP-NNP-NNP,NNP,5,1
5371,37782.0,48,explained,26,35,39,4,34,8,-9,13,Noordhoff Craniofacial Foundation,NCF,ORGANIZATION-ORGANIZATION-ORGANIZATION,ORGANIZATION,PROPN-PROPN-PROPN,PROPN,compound-compound-compound,compound,NNP-NNP-NNP,NNP,6,1
5372,13537.0,67,accord,2,60,55,-5,59,11,-58,53,International Monetary Fund,UN,ORGANIZATION-ORGANIZATION-ORGANIZATION,ORGANIZATION,PROPN-PROPN-PROPN,PROPN,compound-compound-pobj,compound,NNP-NNP-NNP,NNP,5,1
5373,13543.0,32,calls,10,7,1,-6,6,30,3,-9,American Beverage Association,Craig Stevens,ORGANIZATION-ORGANIZATION-ORGANIZATION,PERSON-PERSON,PROPN-PROPN-PROPN,PROPN-PROPN,compound-compound-pobj,compound-nsubj,NNP-NNP-NNP,NNP-NNP,4,1
5374,33203.0,53,President,3,5,1,-4,4,51,-2,-2,American Beverage Association,Craig Stevens,ORGANIZATION-ORGANIZATION-ORGANIZATION,PERSON-PERSON,PROPN-PROPN-PROPN,PROPN-PROPN,compound-compound-compound,compound-compound,NNP-NNP-NNP,NNP-NNP,3,1
5375,13551.0,34,died,28,1,33,32,0,0,27,5,Vernon Bellecourt,Minneapolis,PERSON-PERSON,CITY,PROPN-PROPN,PROPN,compound-nsubj,pobj,NNP-NNP,NNP,2,1
5376,40795.0,47,died,36,1,45,44,0,1,35,9,Vernon Bellecourt,Minneapolis,PERSON-PERSON,CITY,PROPN-PROPN,PROPN,compound-nsubj,compound,NNP-NNP,NNP,3,1
5377,47751.0,48,died,36,1,46,45,0,1,35,10,Vernon Bellecourt,Minneapolis,PERSON-PERSON,CITY,PROPN-PROPN,PROPN,compound-nsubj,compound,NNP-NNP,NNP,3,1
5378,61705.0,34,died,28,1,33,32,0,0,27,5,Vernon Bellecourt,Minneapolis,PERSON-PERSON,CITY,PROPN-PROPN,PROPN,compound-nsubj,pobj,NNP-NNP,NNP,2,1
5379,13565.0,34,include,12,10,23,13,9,10,2,11,Ahearn,Charles Eskew,PERSON,PERSON-PERSON,PROPN,PROPN-PROPN,poss,compound-appos,NNP,NNP-NNP,5,1
5380,39627.0,34,include,12,10,23,13,9,10,2,11,Ahearn,Charles Eskew,PERSON,PERSON-PERSON,PROPN,PROPN-PROPN,poss,compound-appos,NNP,NNP-NNP,5,1
5381,13575.0,31,became,15,29,1,-28,28,29,-14,-14,BNC Mortgage,Lehman Brothers Holdings Inc.,ORGANIZATION-ORGANIZATION,ORGANIZATION-ORGANIZATION-ORGANIZATION-ORGANIZATION,PROPN-PROPN,PROPN-PROPN-PROPN-PROPN,compound-appos,compound-compound-compound-nsubj,NNP-NNP,NNP-NNPS-NNPS-NNP,5,1
5382,36874.0,36,said,30,13,4,-9,12,31,17,-26,BNC Mortgage,Lehman Brothers Holdings Inc.,ORGANIZATION-ORGANIZATION,ORGANIZATION-ORGANIZATION-ORGANIZATION-ORGANIZATION,PROPN-PROPN,PROPN-PROPN-PROPN-PROPN,compound-compound,compound-compound-compound-nsubj,NNP-NNP,NNP-NNPS-NNPS-NNP,5,1
5383,13578.0,35,IAEA,10,13,11,-2,12,23,-3,1,Ali Akbar Salehi,IAEA,PERSON-PERSON-PERSON,ORGANIZATION,PROPN-PROPN-PROPN,PROPN,compound-compound-dobj,ROOT,NNP-NNP-NNP,NNP,-1,1
5384,35986.0,31,walked,15,12,10,-2,11,20,3,-5,Ali Akbar Salehi,IAEA,PERSON-PERSON-PERSON,ORGANIZATION,PROPN-PROPN-PROPN,PROPN,compound-compound-appos,pobj,NNP-NNP-NNP,NNP,3,1
5385,13582.0,22,said,2,15,20,5,14,1,-13,18,Fidelity,FMR LLC,ORGANIZATION,ORGANIZATION-ORGANIZATION,PROPN,PROPN-PROPN,poss,compound-appos,NNP,NNP-NNP,3,1
5386,13586.0,16,clinch,4,12,7,-5,11,8,-8,3,Jacksonville Jaguars,NFL,ORGANIZATION-ORGANIZATION,ORGANIZATION,PROPN-PROPN,PROPN,compound-pobj,compound,NNP-NNPS,NNP,3,1
5387,13603.0,50,said,10,47,8,-39,46,41,-37,-2,RIA-Novosti,Russia,ORGANIZATION,COUNTRY,ADJ,PROPN,compound,compound,JJ,NNP,10,1
5388,36253.0,25,cited,5,3,16,13,2,8,2,11,RIA-Novosti,Russia,ORGANIZATION,COUNTRY,X,PROPN,compound,poss,FW,NNP,6,1
5389,44321.0,27,told,20,24,22,-2,23,4,-4,2,RIA-Novosti,Russia,ORGANIZATION,COUNTRY,PROPN,PROPN,compound,poss,NNP,NNP,3,1
5390,13612.0,47,dressed,36,2,12,10,1,34,34,-24,Pamela Ahearn,Los Angeles,PERSON-PERSON,CITY-CITY,PROPN-PROPN,PROPN-PROPN,compound-nsubjpass,compound-pobj,NNP-NNP,NNP-NNP,4,1
5391,13625.0,19,deter,4,14,6,-8,13,12,-10,2,Metro Atlanta Chamber of Commerce,Sam A. Williams,ORGANIZATION-ORGANIZATION-ORGANIZATION-ORGANIZATION-ORGANIZATION,PERSON-PERSON-PERSON,PROPN-PROPN-PROPN-ADP-PROPN,PROPN-PROPN-PROPN,compound-compound-pobj-prep-pobj,compound-compound-dobj,NNP-NNP-NNP-IN-NNP,NNP-NNP-NNP,5,1
5392,13633.0,19,died,9,1,6,5,0,12,8,-3,Her,Walter Offutt Jr.,PERSON,PERSON-PERSON-PERSON,DET,PROPN-PROPN-PROPN,poss,compound-compound-nsubj,PRP$,NNP-NNP-NNP,3,1
5393,13640.0,39,died,28,1,18,17,0,20,27,-10,Bradford Washburn,Boston,PERSON-PERSON,CITY,PROPN-PROPN,PROPN,compound-nsubj,pobj,NNP-NNP,NNP,2,1
5394,13663.0,18,is,13,6,1,-5,5,16,7,-12,Residential Capital LLC,James Giertz,ORGANIZATION-ORGANIZATION-ORGANIZATION,PERSON-PERSON,PROPN-PROPN-PROPN,PROPN-PROPN,compound-compound-pobj,compound-poss,NNP-NNP-NNP,NNP-NNP,4,1
5395,13665.0,37,Title,0,13,33,20,12,3,-13,33,Universiteit Gent,Belgium,ORGANIZATION-ORGANIZATION,COUNTRY,PROPN-PROPN,PROPN,compound-ROOT,compound,NNP-NNP,NNP,2,1
5396,13683.0,18,holds,4,1,14,13,0,3,3,10,Black,Trinity University,PERSON,ORGANIZATION-ORGANIZATION,PROPN,PROPN-PROPN,nsubj,compound-pobj,NNP,NNP-NNP,6,1
5397,13688.0,16,issued,12,8,6,-2,7,9,4,-6,Mia Farrow,spokeswoman,PERSON-PERSON,TITLE,PROPN-PROPN,NOUN,compound-appos,nsubj,NNP-NNP,NN,2,1
5398,13699.0,37,alleges,8,3,1,-2,2,35,5,-7,Crown Prosecution Service,Britain,ORGANIZATION-ORGANIZATION-ORGANIZATION,COUNTRY,PROPN-PROPN-PROPN,PROPN,compound-compound-compound,poss,NNP-NNP-NNP,NNP,3,1
5399,13703.0,17,was,1,7,14,7,6,2,-6,13,his,Alabama,PERSON,STATE_OR_PROVINCE,DET,PROPN,poss,nmod,PRP$,NNP,4,1
5400,13712.0,19,Council,2,5,1,-4,4,17,-3,-1,NSC,National Security Council,ORGANIZATION,ORGANIZATION-ORGANIZATION-ORGANIZATION,PROPN,PROPN-PROPN-PROPN,compound,compound-compound-ROOT,NNP,NNP-NNP-NNP,3,1
5401,14065.0,28,threatens,6,22,11,-11,21,16,-16,5,NSC,National Security Council,ORGANIZATION,ORGANIZATION-ORGANIZATION-ORGANIZATION,PROPN,PROPN-PROPN-PROPN,nsubj,compound-compound-compound,NNP,NNP-NNP-NNP,5,1
5402,45615.0,27,worked,2,19,14,-5,18,12,-17,12,NSC,National Security Council,ORGANIZATION,ORGANIZATION-ORGANIZATION-ORGANIZATION,PROPN,PROPN-PROPN-PROPN,appos,compound-compound-pobj,NNP,NNP-NNP-NNP,6,1
5403,47377.0,29,emphasised,4,23,19,-4,22,9,-19,15,NSC,National Security Council,ORGANIZATION,ORGANIZATION-ORGANIZATION-ORGANIZATION,PROPN,PROPN-PROPN-PROPN,compound,compound-compound-dobj,NNP,NNP-NNP-NNP,3,1
5404,48052.0,18,devoted,13,7,3,-4,6,14,6,-10,NSC,National Security Council,ORGANIZATION,ORGANIZATION-ORGANIZATION-ORGANIZATION,PROPN,PROPN-PROPN-PROPN,compound,compound-compound-compound,NNP,NNP-NNP-NNP,3,1
5405,59338.0,61,General,3,11,7,-4,10,53,-8,4,NSC,National Security Council,ORGANIZATION,ORGANIZATION-ORGANIZATION-ORGANIZATION,PROPN,PROPN-PROPN-PROPN,compound,compound-compound-pobj,NNP,NNP-NNP-NNP,4,1
5406,13723.0,9,declined,5,1,4,3,0,4,4,-1,Markit,John Dooley,ORGANIZATION,PERSON-PERSON,PROPN,PROPN-PROPN,compound,compound-nsubj,NNP,NNP-NNP,2,1
5407,13731.0,31,said,22,2,16,14,1,14,20,-6,Gonzales,governor,PERSON,TITLE,PROPN,NOUN,nsubj,oprd,NNP,NN,5,1
5408,13733.0,31,arrived,15,15,18,3,14,12,0,3,McNair,chairman,PERSON,TITLE,PROPN,NOUN,nsubj,pobj,NNP,NN,3,1
5409,13734.0,52,star,1,4,12,8,3,39,-3,11,Alice,Mango,PERSON,ORGANIZATION,PROPN,PROPN,appos,compound,NNP,NNP,2,1
5410,13737.0,29,paid,4,13,25,12,12,3,-9,21,Old Lane Partners,him,ORGANIZATION-ORGANIZATION-ORGANIZATION,PERSON,PROPN-PROPN-PROPN,PRON,compound-compound-dobj,dobj,NNP-NNP-NNPS,PRP,5,1
5411,66712.0,31,bought,5,11,23,12,10,7,-6,18,Old Lane Partners,him,ORGANIZATION-ORGANIZATION-ORGANIZATION,PERSON,PROPN-PROPN-PROPN,PRON,compound-compound-appos,dobj,NNP-NNP-NNPS,PRP,5,1
5412,13746.0,7,is,1,1,6,5,0,0,0,5,Zondervan,HarperCollins,ORGANIZATION,ORGANIZATION,PROPN,PROPN,nsubj,pobj,NNP,NNP,1,1
5413,13747.0,18,married,4,6,4,-2,5,13,-2,0,Dr William Crisp,she,PERSON-PERSON-PERSON,PERSON,PROPN-PROPN-PROPN,PRON,compound-compound-dobj,nsubj,NNP-NNP-NNP,PRP,2,1
5414,13756.0,29,grew,7,7,24,17,6,4,0,17,Peterson,his,PERSON,PERSON,PROPN,DET,nsubj,poss,NNP,PRP$,4,1
5415,13774.0,54,said,19,36,41,5,35,12,-17,22,Lindsay M. Hayes,Mansfield,PERSON-PERSON-PERSON,PERSON,PROPN-PROPN-PROPN,PROPN,compound-compound-appos,pobj,NNP-NNP-NNP,NNP,2,1
5416,13777.0,60,IRAQ,0,38,42,4,37,17,-38,42,Mahdi,Shiite,PERSON,RELIGION,PROPN,ADJ,compound,amod,NNP,JJ,3,1
5417,18758.0,18,represent,6,3,15,12,2,2,3,9,Mahdi,Shiite,PERSON,RELIGION,PROPN,ADJ,conj,amod,NNP,JJ,6,1
5418,52416.0,26,credited,4,21,14,-7,20,11,-17,10,Mahdi,Shiite,PERSON,RELIGION,PROPN,ADJ,amod,amod,NNP,JJ,4,1
5419,13782.0,39,known,3,14,1,-13,13,37,-11,-2,Philadelphia Inquirer,Gene Roberts,ORGANIZATION-ORGANIZATION,PERSON-PERSON,PROPN-PROPN,PROPN-PROPN,compound-appos,compound-nsubj,NNP-NNP,NNP-NNP,7,1
5420,13784.0,33,won,9,9,6,-3,8,26,0,-3,Carson,US,PERSON,COUNTRY,PROPN,PROPN,pobj,compound,NNP,NNP,4,1
5421,13786.0,18,graduated,1,1,12,11,0,5,0,11,She,Yale School of Law,PERSON,ORGANIZATION-ORGANIZATION-ORGANIZATION-ORGANIZATION,PRON,PROPN-PROPN-ADP-PROPN,nsubj,compound-pobj-prep-pobj,PRP,NNP-NNP-IN-NNP,3,1
5422,13794.0,15,stayed,1,5,7,2,4,7,-4,6,he,5,PERSON,NUMBER,PRON,NUM,nsubj,attr,PRP,CD,2,1
5423,13809.0,33,said,6,8,1,-7,7,31,-2,-5,Disney,Hong Kong Disneyland,ORGANIZATION,LOCATION-LOCATION-LOCATION,PROPN,PROPN-PROPN-PROPN,nsubjpass,compound-compound-pobj,NNP,NNP-NNP-NNP,7,1
5424,33116.0,28,said,8,18,1,-17,17,26,-10,-7,Disney,Hong Kong Disneyland,ORGANIZATION,LOCATION-LOCATION-LOCATION,PROPN,PROPN-PROPN-PROPN,pobj,compound-compound-compound,NNP,NNP-NNP-NNP,7,1
5425,41485.0,41,criticized,16,9,1,-8,8,39,7,-15,Disney,Hong Kong Disneyland,ORGANIZATION,LOCATION-LOCATION-LOCATION,PROPN,PROPN-PROPN-PROPN,compound,compound-compound-nsubjpass,NNP,NNP-NNP-NNP,4,1
5426,42117.0,32,showed,4,1,6,5,0,25,3,2,Disney,Hong Kong Disneyland,ORGANIZATION,LOCATION-LOCATION-LOCATION,PROPN,PROPN-PROPN-PROPN,poss,compound-compound-poss,NNP,NNP-NNP-NNP,7,1
5427,53111.0,16,owns,2,12,7,-5,11,8,-10,5,Disney,Hong Kong Disneyland,ORGANIZATION,LOCATION-LOCATION-LOCATION,PROPN,PROPN-PROPN-PROPN,nsubj,compound-compound-pobj,NNP,NNP-NNP-NNP,6,1
5428,54459.0,33,said,6,8,1,-7,7,31,-2,-5,Disney,Hong Kong Disneyland,ORGANIZATION,LOCATION-LOCATION-LOCATION,PROPN,PROPN-PROPN-PROPN,nsubjpass,compound-compound-compound,NNP,NNP-NNP-NNP,7,1
5429,13810.0,28,took,7,6,3,-3,5,24,1,-4,Lewis Hamilton,McLaren Mercedes,PERSON-PERSON,ORGANIZATION-ORGANIZATION,PROPN-PROPN,PROPN-PROPN,compound-nsubj,compound-compound,NNP-NNP,NNP-NNP,2,1
5430,20905.0,25,took,5,4,1,-3,3,23,1,-4,Lewis Hamilton,McLaren Mercedes,PERSON-PERSON,ORGANIZATION-ORGANIZATION,PROPN-PROPN,PROPN-PROPN,compound-nsubj,compound-compound,NNP-NNP,NNP-NNP,2,1
5431,13815.0,22,nicknamed,2,1,5,4,0,16,1,3,Buse,The Ferret,PERSON,PERSON-PERSON,PROPN,DET-PROPN,nsubjpass,det-oprd,NNP,DT-NNP,3,1
5432,13816.0,48,recognized,11,8,1,-7,7,46,3,-10,Carnival Cruise Lines,Gerald Cahill,ORGANIZATION-ORGANIZATION-ORGANIZATION,PERSON-PERSON,PROPN-PROPN-PROPN,PROPN-PROPN,compound-compound-pobj,compound-nsubj,NNP-NNP-NNP,NNP-NNP,4,1
5433,22133.0,45,told,26,23,14,-9,22,30,3,-12,Carnival Cruise Lines,Gerald Cahill,ORGANIZATION-ORGANIZATION-ORGANIZATION,PERSON-PERSON,PROPN-PROPN-PROPN,PROPN-PROPN,compound-compound-pobj,compound-nsubj,NNP-NNP-NNP,NNP-NNP,5,1
5434,13837.0,61,BOLIN,1,1,34,33,0,26,0,33,JANE BOLIN,New York City Bar Association,PERSON-PERSON,ORGANIZATION-ORGANIZATION-ORGANIZATION-ORGANIZATION-ORGANIZATION,PROPN-PROPN,PROPN-PROPN-PROPN-PROPN-PROPN,compound-ROOT,compound-compound-compound-compound-dobj,NNP-NNP,NNP-NNP-NNP-NNP-NNP,7,1
5435,13844.0,9,ElBaradei,0,1,5,4,0,3,-1,5,ElBaradei,Egypt,PERSON,COUNTRY,NOUN,PROPN,ROOT,compound,NN,NNP,3,1
5436,13847.0,46,have,1,21,8,-13,20,37,-20,7,he,exec,PERSON,TITLE,PRON,NOUN,nsubj,compound,PRP,NN,5,1
5437,13859.0,22,Charged,0,6,8,2,5,13,-6,8,Scorpions,Slobodan Medic,ORGANIZATION,PERSON-PERSON,PROPN,PROPN-PROPN,compound,compound-nsubjpass,NNPS,NNP-NNP,1,1
5438,47682.0,33,said,12,10,2,-8,9,30,2,-10,Scorpions,Slobodan Medic,ORGANIZATION,PERSON-PERSON,PROPN,PROPN-PROPN,compound,compound-appos,NNPS,NNP-NNP,4,1
5439,13879.0,17,convicted,2,1,5,4,0,11,1,3,He,robbing a bar,PERSON,CRIMINAL_CHARGE-CRIMINAL_CHARGE-CRIMINAL_CHARGE,PRON,VERB-DET-NOUN,nsubjpass,pcomp-det-dobj,PRP,VBG-DT-NN,5,1
5440,13880.0,38,was,1,7,6,-1,6,31,-6,5,Federal Aviation Administration,US,ORGANIZATION-ORGANIZATION-ORGANIZATION,COUNTRY,PROPN-PROPN-PROPN,PROPN,compound-compound-pobj,compound,NNP-NNP-NNP,NNP,2,1
5441,64935.0,37,delayed,4,31,30,-1,30,6,-27,26,Federal Aviation Administration,US,ORGANIZATION-ORGANIZATION-ORGANIZATION,COUNTRY,PROPN-PROPN-PROPN,PROPN,compound-compound-pobj,compound,NNP-NNP-NNP,NNP,2,1
5442,13884.0,37,stays,7,10,3,-7,9,33,-3,-4,his,Israeli,PERSON,NATIONALITY,DET,ADJ,poss,amod,PRP$,JJ,5,1
5443,13886.0,21,donated,7,2,6,4,1,14,5,-1,American Red Cross,ARC,ORGANIZATION-ORGANIZATION-ORGANIZATION,ORGANIZATION,PROPN-PROPN-PROPN,PROPN,compound-compound-compound,compound,NNP-NNP-NNP,NNP,-1,1
5444,13889.0,49,scheduled,22,42,41,-1,41,7,-20,19,Nicholas Burns,State,PERSON-PERSON,ORGANIZATION,PROPN-PROPN,PROPN,compound-conj,pobj,NNP-NNP,NNP,1,1
5445,19286.0,35,said,10,9,8,-1,8,26,1,-2,Nicholas Burns,State,PERSON-PERSON,ORGANIZATION,PROPN-PROPN,PROPN,compound-nsubj,pobj,NNP-NNP,NNP,1,1
5446,37995.0,16,disagree,2,12,11,-1,11,4,-10,9,Nicholas Burns,State,PERSON-PERSON,ORGANIZATION,PROPN-PROPN,PROPN,compound-nsubj,pobj,NNP-NNP,NNP,4,1
5447,53786.0,27,warned,7,5,4,-1,4,22,2,-3,Nicholas Burns,State,PERSON-PERSON,ORGANIZATION,PROPN-PROPN,PROPN,compound-nsubj,pobj,NNP-NNP,NNP,1,1
5448,13894.0,28,check,4,11,21,10,10,6,-7,17,Spencer,Heidi,PERSON,PERSON,PROPN,PROPN,poss,poss,NNP,NNP,12,1
5449,55641.0,26,talking,3,23,16,-7,22,9,-20,13,Spencer,Heidi,PERSON,PERSON,PROPN,PROPN,nsubj,nsubj,NNP,NNP,2,1
5450,13900.0,74,start,45,7,10,3,6,63,38,-35,Bob Dillinger,secretary,PERSON-PERSON,TITLE,PROPN-PROPN,NOUN,compound-conj,appos,NNP-NNP,NN,2,1
5451,13918.0,30,said,18,27,25,-2,26,4,-9,7,Taiwan Research Institute,BUU,ORGANIZATION-ORGANIZATION-ORGANIZATION,ORGANIZATION,PROPN-PROPN-PROPN,PROPN,compound-compound-pobj,poss,NNP-NNP-NNP,NNP,3,1
5452,13919.0,58,was,4,14,34,20,13,23,-10,30,Abbas Moussawi,Hezbollah,PERSON-PERSON,ORGANIZATION,PROPN-PROPN,PROPN,compound-appos,compound,NNP-NNP,NNP,5,1
5453,13923.0,30,said,23,1,22,21,0,7,22,-1,Forsberg,cancer,PERSON,CAUSE_OF_DEATH,PROPN,NOUN,nsubj,pobj,NNP,NN,4,1
5454,13934.0,13,is,1,1,5,4,0,7,0,4,He,Rebecca,PERSON,PERSON,PRON,PROPN,nsubj,pobj,PRP,NNP,1,1
5455,13958.0,41,come,8,5,2,-3,4,38,3,-6,Marcel Ospel,UBS,PERSON-PERSON,ORGANIZATION,PROPN-PROPN,PROPN,compound-appos,compound,NNP-NNP,NNP,1,1
5456,24088.0,38,saw,5,4,2,-2,3,35,1,-3,Marcel Ospel,UBS,PERSON-PERSON,ORGANIZATION,PROPN-PROPN,PROPN,compound-nsubj,compound,NNP-NNP,NNP,1,1
5457,24417.0,18,announced,2,11,1,-10,10,16,-9,-1,Marcel Ospel,UBS,PERSON-PERSON,ORGANIZATION,PROPN-PROPN,PROPN,compound-appos,nsubj,NNP-NNP,NNP,4,1
5458,26890.0,35,told,6,1,4,3,0,30,5,-2,Marcel Ospel,UBS,PERSON-PERSON,ORGANIZATION,PROPN-PROPN,PROPN,compound-nsubj,compound,NNP-NNP,NNP,1,1
5459,32576.0,40,was,5,13,9,-4,12,30,-8,4,Marcel Ospel,UBS,PERSON-PERSON,ORGANIZATION,PROPN-PROPN,PROPN,compound-appos,poss,NNP-NNP,NNP,3,1
5460,32804.0,32,say,3,8,6,-2,7,25,-5,3,Marcel Ospel,UBS,PERSON-PERSON,ORGANIZATION,PROPN-PROPN,PROPN,compound-nsubj,pobj,NNP-NNP,NNP,1,1
5461,44094.0,43,voted,7,20,7,-13,19,35,-13,0,Marcel Ospel,UBS,PERSON-PERSON,ORGANIZATION,PROPN-PROPN,PROPN,compound-dobj,compound,NNP-NNP,NNP,3,1
5462,45231.0,36,told,31,30,28,-2,29,7,1,-3,Marcel Ospel,UBS,PERSON-PERSON,ORGANIZATION,PROPN-PROPN,PROPN,compound-nsubj,compound,NNP-NNP,NNP,1,1
5463,59795.0,34,-LRB-,1,28,7,-21,27,26,-27,6,Marcel Ospel,UBS,PERSON-PERSON,ORGANIZATION,PROPN-PROPN,PROPN,compound-appos,nsubj,NNP-NNP,NNP,7,1
5464,61135.0,66,got,4,48,4,-44,47,61,-44,0,Marcel Ospel,UBS,PERSON-PERSON,ORGANIZATION,PROPN-PROPN,PROPN,compound-dobj,nsubj,NNP-NNP,NNP,-1,1
5465,13960.0,48,Victory,0,18,12,-6,17,35,-18,12,Hugo Chavez,Latin American,PERSON-PERSON,NATIONALITY-NATIONALITY,PROPN-PROPN,ADJ-ADJ,compound-appos,amod-amod,NNP-NNP,JJ-JJ,2,1
5466,13968.0,35,said,16,25,32,7,24,2,-9,16,National Military Family Association,Alexandria,ORGANIZATION-ORGANIZATION-ORGANIZATION-ORGANIZATION,CITY,PROPN-PROPN-PROPN-PROPN,PROPN,compound-compound-compound-pobj,pobj,NNP-NNP-NNP-NNP,NNP,7,1
5467,47149.0,53,said,25,34,39,5,33,13,-9,14,National Military Family Association,Alexandria,ORGANIZATION-ORGANIZATION-ORGANIZATION-ORGANIZATION,CITY,PROPN-PROPN-PROPN-PROPN,PROPN,compound-compound-compound-pobj,pobj,NNP-NNP-NNP-NNP,NNP,3,1
5468,13975.0,26,was,4,15,9,-6,14,16,-11,5,she,Metropolitan Opera,PERSON,ORGANIZATION-ORGANIZATION,PRON,PROPN-PROPN,nsubj,compound-pobj,PRP,NNP-NNP,4,1
5469,13984.0,25,married,1,19,21,2,18,3,-18,20,David,"Sept 25 , 2005",PERSON,DATE-DATE-DATE-DATE,PROPN,PROPN-NUM-PUNCT-NUM,pobj,pobj-nummod-punct-appos,NNP,"NNP-CD-,-CD",2,1
5470,13986.0,43,said,7,4,1,-3,3,41,3,-6,Gholam Ali Haddad Adel,Iranian Parliament,PERSON-PERSON-PERSON-PERSON,ORGANIZATION-ORGANIZATION,PROPN-PROPN-PROPN-PROPN,ADJ-PROPN,compound-compound-compound-nsubj,amod-compound,NNP-NNP-NNP-NNP,JJ-NNP,3,1
5471,14006.0,36,beat,2,8,2,-6,7,33,-6,0,George Young,46-year-old,PERSON-PERSON,DURATION,PROPN-PROPN,NUM,compound-dobj,nsubj,NNP-NNP,CD,4,1
5472,14028.0,55,said,40,37,42,5,36,12,3,2,and,Shinichiro Mitsuhashi,ORGANIZATION,PERSON-PERSON,CCONJ,PROPN-PROPN,cc,compound-nsubj,CC,NNP-NNP,6,1
5473,14033.0,34,ranked,3,11,15,4,10,18,-8,12,International Skating Union,ISU,ORGANIZATION-ORGANIZATION-ORGANIZATION,ORGANIZATION,PROPN-PROPN-PROPN,PROPN,compound-compound-pobj,compound,NNP-NNP-NNP,NNP,4,1
5474,41642.0,33,opens,3,26,24,-2,25,8,-23,21,International Skating Union,ISU,ORGANIZATION-ORGANIZATION-ORGANIZATION,ORGANIZATION,PROPN-PROPN-PROPN,NOUN,compound-compound-compound,compound,NNP-NNP-NNP,NN,1,1
5475,55794.0,36,Union,3,2,6,4,1,29,1,3,International Skating Union,ISU,ORGANIZATION-ORGANIZATION-ORGANIZATION,ORGANIZATION,PROPN-PROPN-PROPN,PROPN,compound-compound-ROOT,compound,NNP-NNP-NNP,NNP,3,1
5476,14035.0,5,Inc.,2,1,5,4,0,-1,1,3,ConAgra Foods Inc.,http://www.conagrafoods.com,ORGANIZATION-ORGANIZATION-ORGANIZATION,URL,PROPN-PROPN-PROPN,X,compound-compound-ROOT,appos,NNP-NNPS-NNP,ADD,-1,1
5477,14036.0,11,agrees,2,1,6,5,0,4,1,4,First Group,Laidlaw International,ORGANIZATION-ORGANIZATION,ORGANIZATION-ORGANIZATION,PROPN-PROPN,PROPN-PROPN,compound-nsubj,compound-dobj,NNP-NNP,NNP-NNP,3,1
5478,38423.0,11,agrees,2,1,6,5,0,4,1,4,First Group,Laidlaw International,ORGANIZATION-ORGANIZATION,ORGANIZATION-ORGANIZATION,PROPN-PROPN,PROPN-PROPN,compound-nsubj,compound-dobj,NNP-NNP,NNP-NNP,3,1
5479,14046.0,20,bc-mcdonald-obit-post-correction,0,8,5,-3,7,14,-8,5,Augustus F Hawkins,American,PERSON-PERSON-PERSON,NATIONALITY,PROPN-PROPN-PROPN,PROPN,compound-compound-attr,nsubj,NNP-NNP-NNP,NNP,2,1
5480,14063.0,45,produced,34,7,3,-4,6,41,27,-31,APA,Austrian Press Agency,ORGANIZATION,ORGANIZATION-ORGANIZATION-ORGANIZATION,PROPN,PROPN-PROPN-PROPN,compound,compound-compound-compound,NNP,NNP-NNP-NNP,4,1
5481,14073.0,34,said,15,12,1,-11,11,32,3,-14,American Bankers Association,James Ballentine,ORGANIZATION-ORGANIZATION-ORGANIZATION,PERSON-PERSON,PROPN-PROPN-PROPN,PROPN-PROPN,compound-compound-pobj,compound-nsubj,NNP-NNPS-NNP,NNP-NNP,4,1
5482,14075.0,31,said,23,10,3,-7,9,27,13,-20,Bernama,Yong Soo Heong,ORGANIZATION,PERSON-PERSON-PERSON,PROPN,PROPN-PROPN-PROPN,pobj,compound-compound-nsubjpass,NNP,NNP-NNP-NNP,3,1
5483,14076.0,39,told,34,33,8,-25,32,30,1,-26,TSE,supervision post,ORGANIZATION,ORGANIZATION-ORGANIZATION,PROPN,NOUN-NOUN,compound,compound-pobj,NNP,NN-NN,4,1
5484,14081.0,31,held,8,24,19,-5,23,11,-16,11,KCNA,Korean Central News Agency,ORGANIZATION,ORGANIZATION-ORGANIZATION-ORGANIZATION-ORGANIZATION,PROPN,PROPN-PROPN-PROPN-PROPN,compound,compound-compound-compound-dep,NNP,NNP-NNP-NNP-NNP,1,1
5485,25150.0,51,lashed,12,48,38,-10,47,12,-36,26,KCNA,Korean Central News Agency,ORGANIZATION,ORGANIZATION-ORGANIZATION-ORGANIZATION-ORGANIZATION,PROPN,PROPN-PROPN-PROPN-PROPN,nsubj,compound-compound-compound-appos,NNP,NNP-NNP-NNP-NNP,6,1
5486,29153.0,28,Agency,7,10,5,-5,9,22,-3,-2,KCNA,Korean Central News Agency,ORGANIZATION,ORGANIZATION-ORGANIZATION-ORGANIZATION-ORGANIZATION,PROPN,PROPN-PROPN-PROPN-PROPN,compound,compound-compound-compound-ROOT,NNP,NNP-NNP-NNP-NNP,3,1
5487,44060.0,33,opened,15,28,23,-5,27,9,-13,8,KCNA,Korean Central News Agency,ORGANIZATION,ORGANIZATION-ORGANIZATION-ORGANIZATION-ORGANIZATION,PROPN,PROPN-PROPN-PROPN-PROPN,compound,compound-compound-compound-appos,NNP,NNP-NNP-NNP-NNP,3,1
5488,46530.0,57,quoted,43,55,50,-5,54,6,-12,7,KCNA,Korean Central News Agency,ORGANIZATION,ORGANIZATION-ORGANIZATION-ORGANIZATION-ORGANIZATION,PROPN,PROPN-PROPN-PROPN-PROPN,compound,compound-compound-compound-pobj,NNP,NNP-NNP-NNP-NNP,7,1
5489,58267.0,39,PYONGYANG,0,37,10,-27,36,28,-37,10,KCNA,Korean Central News Agency,ORGANIZATION,ORGANIZATION-ORGANIZATION-ORGANIZATION-ORGANIZATION,PROPN,PROPN-PROPN-PROPN-PROPN,compound,compound-compound-compound-pobj,NNP,NNP-NNP-NNP-NNP,12,1
5490,14094.0,33,said,24,15,26,11,14,6,9,2,IMF,Murilo Portugal,ORGANIZATION,PERSON-PERSON,PROPN,PROPN-PROPN,pobj,compound-nsubj,NNP,NNP-NNP,8,1
5491,14099.0,35,survived,2,1,12,11,0,22,1,10,Derounian,Ann Banks,PERSON,PERSON-PERSON,PROPN,PROPN-PROPN,nsubjpass,compound-conj,NNP,NNP-NNP,3,1
5492,21982.0,35,survived,2,1,12,11,0,22,1,10,Derounian,Ann Banks,PERSON,PERSON-PERSON,PROPN,PROPN-PROPN,nsubjpass,compound-conj,NNP,NNP-NNP,3,1
5493,14109.0,41,met,7,19,2,-17,18,38,-12,-5,Berthold Huber,Germany,PERSON-PERSON,COUNTRY,PROPN-PROPN,PROPN,compound-conj,pobj,NNP-NNP,NNP,5,1
5494,40079.0,33,nominated,11,13,1,-12,12,31,-2,-10,Berthold Huber,Germany,PERSON-PERSON,COUNTRY,PROPN-PROPN,PROPN,compound-dobj,poss,NNP-NNP,NNP,4,1
5495,55995.0,32,told,13,11,4,-7,10,27,2,-9,Berthold Huber,Germany,PERSON-PERSON,COUNTRY,PROPN-PROPN,PROPN,compound-appos,poss,NNP-NNP,NNP,3,1
5496,14114.0,23,established,1,4,1,-3,3,21,-3,0,Barnes Foundation,He,ORGANIZATION-ORGANIZATION,PERSON,PROPN-PROPN,PRON,compound-dobj,nsubj,NNP-NNP,PRP,1,1
5497,14116.0,45,demand,1,12,12,0,11,32,-11,11,Kate Gosselin,Kate Plus Eight,PERSON-PERSON,ORGANIZATION-ORGANIZATION-ORGANIZATION,PROPN-PROPN,PROPN-CCONJ-PROPN,conj-conj,conj-prep-pobj,NNP-NNP,NNP-CC-NNP,0,1
5498,14119.0,42,Association,2,1,4,3,0,37,1,2,American Beverage Association,http://wwwameribevorg,ORGANIZATION-ORGANIZATION-ORGANIZATION,URL,PROPN-PROPN-PROPN,PUNCT,compound-compound-ROOT,compound,NNP-NNP-NNP,.,2,1
5499,14133.0,35,seen,5,31,23,-8,30,11,-26,18,American Basketball Association,Tropics,ORGANIZATION-ORGANIZATION-ORGANIZATION,ORGANIZATION,PROPN-PROPN-PROPN,PROPN,compound-compound-compound,conj,NNP-NNP-NNP,NNPS,5,1
5500,14140.0,29,recalled,2,5,1,-4,4,27,-3,-1,his,Rev.,PERSON,TITLE,DET,PROPN,poss,compound,PRP$,NNP,3,1
5501,14148.0,20,grew,1,1,18,17,0,1,0,17,She,Remy Martin,PERSON,PERSON-PERSON,PRON,PROPN-PROPN,nsubj,compound-pobj,PRP,NNP-NNP,4,1
5502,14149.0,14,was,1,1,11,10,0,2,0,10,Kaiser,special assistant,PERSON,TITLE-TITLE,PROPN,ADJ-NOUN,nsubj,amod-conj,NNP,JJ-NN,2,1
5503,14155.0,28,founded,1,4,13,9,3,14,-3,12,Multidisciplinary Association for Psychedelic Studies,Boston,ORGANIZATION-ORGANIZATION-ORGANIZATION-ORGANIZATION-ORGANIZATION,CITY,PROPN-PROPN-ADP-PROPN-PROPN,PROPN,compound-dobj-prep-compound-pobj,pobj,NNP-NNP-IN-NNP-NNPS,NNP,2,1
5504,14157.0,24,align,2,6,22,16,5,1,-4,20,Convocation of Anglicans in North America,Peter Akinola,ORGANIZATION-ORGANIZATION-ORGANIZATION-ORGANIZATION-ORGANIZATION-ORGANIZATION,PERSON-PERSON,PROPN-ADP-PROPN-ADP-PROPN-PROPN,PROPN-PROPN,pobj-prep-pobj-prep-compound-pobj,compound-pobj,NNP-IN-NNPS-IN-NNP-NNP,NNP-NNP,4,1
5505,27919.0,46,reflects,37,24,35,11,23,10,13,-2,Convocation of Anglicans in North America,Peter Akinola,ORGANIZATION-ORGANIZATION-ORGANIZATION-ORGANIZATION-ORGANIZATION-ORGANIZATION,PERSON-PERSON,PROPN-ADP-PROPN-ADP-PROPN-PROPN,PROPN-PROPN,dobj-prep-pobj-prep-compound-pobj,compound-pobj,NNP-IN-NNPS-IN-NNP-NNP,NNP-NNP,7,1
5506,30778.0,30,formed,13,6,18,12,5,11,7,5,Convocation of Anglicans in North America,Peter Akinola,ORGANIZATION-ORGANIZATION-ORGANIZATION-ORGANIZATION-ORGANIZATION-ORGANIZATION,PERSON-PERSON,PROPN-ADP-PROPN-ADP-PROPN-PROPN,PROPN-PROPN,appos-prep-pobj-prep-compound-pobj,compound-pobj,NNP-IN-NNPS-IN-NNP-NNP,NNP-NNP,5,1
5507,46953.0,49,plans,9,43,2,-41,42,46,-34,-7,Convocation of Anglicans in North America,Peter Akinola,ORGANIZATION-ORGANIZATION-ORGANIZATION-ORGANIZATION-ORGANIZATION-ORGANIZATION,PERSON-PERSON,PROPN-ADP-PROPN-ADP-PROPN-PROPN,PROPN-PROPN,pobj-prep-pobj-prep-compound-pobj,compound-nsubj,NNP-IN-NNPS-IN-NNP-NNP,NNP-NNP,15,1
5508,14162.0,44,says,3,5,40,35,4,3,-2,37,Boyle,Scottish,PERSON,NATIONALITY,PROPN,ADJ,nsubj,amod,NNP,JJ,9,1
5509,14166.0,16,enjoy,11,7,5,-2,6,10,4,-6,Bryan Fuller,creator,PERSON-PERSON,TITLE,PROPN-PROPN,NOUN,compound-appos,nsubj,NNP-NNP,NN,1,1
5510,17245.0,24,returning,9,6,5,-1,5,18,3,-4,Bryan Fuller,creator,PERSON-PERSON,TITLE,PROPN-PROPN,NOUN,compound-nsubj,compound,NNP-NNP,NN,2,1
5511,17879.0,30,thinking,14,26,25,-1,25,4,-12,11,Bryan Fuller,creator,PERSON-PERSON,TITLE,PROPN-PROPN,NOUN,compound-nsubj,compound,NNP-NNP,NN,2,1
5512,31122.0,30,said,6,8,11,3,7,18,-2,5,Bryan Fuller,creator,PERSON-PERSON,TITLE,PROPN-PROPN,NOUN,compound-nsubj,appos,NNP-NNP,NN,2,1
5513,32496.0,18,said,10,16,15,-1,15,2,-6,5,Bryan Fuller,creator,PERSON-PERSON,TITLE,PROPN-PROPN,NOUN,compound-nsubj,compound,NNP-NNP,NN,1,1
5514,60305.0,17,said,9,15,14,-1,14,2,-6,5,Bryan Fuller,creator,PERSON-PERSON,TITLE,PROPN-PROPN,NOUN,compound-nsubj,compound,NNP-NNP,NN,1,1
5515,14175.0,38,said,14,29,16,-13,28,21,-15,2,American Bar Association,Ronald William Nelson,ORGANIZATION-ORGANIZATION-ORGANIZATION,PERSON-PERSON-PERSON,PROPN-PROPN-PROPN,PROPN-PROPN-PROPN,compound-compound-poss,compound-compound-nsubj,NNP-NNP-NNP,NNP-NNP-NNP,8,1
5516,14194.0,24,born,4,1,9,8,0,14,3,5,Catherine Gertrude Roraback,"Sept 17 , 1920",PERSON-PERSON-PERSON,DATE-DATE-DATE-DATE,PROPN-PROPN-PROPN,PROPN-NUM-PUNCT-NUM,compound-compound-nsubjpass,pobj-nummod-punct-nummod,NNP-NNP-NNP,"NNP-CD-,-CD",5,1
5517,14205.0,34,celebrated,5,14,13,-1,13,20,-9,8,Abu Zubaydah,leader,PERSON-PERSON,TITLE,PROPN-PROPN,NOUN,compound-pobj,compound,NNP-NNP,NN,1,1
5518,14212.0,40,charged,7,3,2,-1,2,37,4,-5,Brandon McInerney,defendant,PERSON-PERSON,TITLE,PROPN-PROPN,NOUN,compound-nsubjpass,nsubjpass,NNP-NNP,NN,1,1
5519,14228.0,23,run,3,6,9,3,5,13,-3,6,Lashkar-e-Taiba,Islamic,ORGANIZATION,IDEOLOGY,PROPN,ADJ,pobj,amod,NNP,JJ,2,1
5520,27731.0,34,came,15,33,30,-3,32,3,-18,15,Lashkar-e-Taiba,Islamic,ORGANIZATION,RELIGION,PROPN,ADJ,appos,amod,NNP,JJ,1,1
5521,48017.0,32,said,13,2,10,8,1,21,11,-3,Lashkar-e-Taiba,Islamic,ORGANIZATION,RELIGION,PROPN,ADJ,nsubj,amod,NNP,JJ,4,1
5522,50094.0,30,run,2,16,14,-2,15,15,-14,12,Lashkar-e-Taiba,Islamic,ORGANIZATION,RELIGION,PROPN,ADJ,dobj,amod,NNP,JJ,2,1
5523,14230.0,46,urged,29,10,3,-7,9,42,19,-26,Servicemembers Legal Defense Netowrk,Aubrey Sarvis,ORGANIZATION-ORGANIZATION-ORGANIZATION-ORGANIZATION,PERSON-PERSON,PROPN-PROPN-PROPN-PROPN,PROPN-PROPN,compound-compound-compound-pobj,compound-nsubj,NNP-NNP-NNP-NNPS,NNP-NNP,5,1
5524,14237.0,33,is,11,20,29,9,19,3,-9,18,National Museum of Women in the Arts,New York Ave. NW,ORGANIZATION-ORGANIZATION-ORGANIZATION-ORGANIZATION-ORGANIZATION-ORGANIZATION-ORGANIZATION,LOCATION-LOCATION-LOCATION-LOCATION,PROPN-PROPN-ADP-PROPN-ADP-DET-NOUN,PROPN-PROPN-PROPN-PROPN,compound-pobj-prep-pobj-prep-det-pobj,compound-compound-compound-appos,NNP-NNP-IN-NNPS-IN-DT-NNS,NNP-NNP-NNP-NNP,6,1
5525,14254.0,30,mentioned,2,16,1,-15,15,28,-14,-1,Beyonce,She,PERSON,PERSON,PROPN,PRON,appos,nsubj,NNP,PRP,6,1
5526,14256.0,37,told,27,18,23,5,17,13,9,-4,George Sheldon,assistant secretary for operations,PERSON-PERSON,TITLE-TITLE-TITLE-TITLE,PROPN-PROPN,ADJ-NOUN-ADP-NOUN,compound-nsubj,compound-appos-prep-pobj,NNP-NNP,JJ-NN-IN-NNS,3,1
5527,14261.0,54,declined,13,46,4,-42,45,49,-33,-9,Badr Organization,Supreme Council for Islamic Revolution in Iraq,ORGANIZATION-ORGANIZATION,ORGANIZATION-ORGANIZATION-ORGANIZATION-ORGANIZATION-ORGANIZATION-ORGANIZATION-ORGANIZATION,PROPN-PROPN,PROPN-PROPN-ADP-PROPN-PROPN-ADP-PROPN,compound-conj,compound-nsubj-prep-compound-pobj-prep-pobj,NNP-NNP,NNP-NNP-IN-NNP-NNP-IN-NNP,3,1
5528,14267.0,24,replaced,1,1,19,18,0,4,0,18,Alice,Dame Vivienne Westwood,PERSON,ORGANIZATION-ORGANIZATION-ORGANIZATION,PROPN,PROPN-PROPN-PROPN,nsubj,compound-compound-pobj,NNP,NNP-NNP-NNP,4,1
5529,14273.0,61,###,0,33,33,0,32,27,-33,33,Spelman College,Spelman,ORGANIZATION-ORGANIZATION,ORGANIZATION,PROPN-PROPN,PROPN,compound-pobj,pobj,NNP-NNP,NNP,0,1
5530,14277.0,23,is,3,1,10,9,0,12,2,7,Hussein Kamel,Republican Guards,PERSON-PERSON,ORGANIZATION-ORGANIZATION,PROPN-PROPN,PROPN-PROPN,compound-compound,compound-pobj,NNP-NNP,NNP-NNPS,6,1
5531,14284.0,38,said,12,1,22,21,0,15,11,10,National Beef Packing Co.,JBS SA,ORGANIZATION-ORGANIZATION-ORGANIZATION-ORGANIZATION,ORGANIZATION-ORGANIZATION,PROPN-PROPN-PROPN-PROPN,PROPN-PROPN,compound-compound-compound-nsubj,compound-pobj,NNP-NNP-NNP-NNP,NNP-NNP,6,1
5532,14288.0,52,argued,11,20,38,18,19,13,-9,27,Morgan,Congress,PERSON,ORGANIZATION,PROPN,PROPN,poss,pobj,NNP,NNP,8,1
5533,14293.0,17,contended,2,16,8,-8,15,8,-14,6,him,extortion,PERSON,CRIMINAL_CHARGE,PRON,NOUN,pobj,compound,PRP,NN,5,1
5534,14294.0,24,got,15,17,3,-14,16,20,-2,-12,his,"Aug. 15 , 1925",PERSON,DATE-DATE-DATE-DATE,DET,PROPN-NUM-PUNCT-NUM,poss,pobj-nummod-punct-nummod,PRP$,"NNP-CD-,-CD",5,1
5535,16489.0,24,got,15,17,3,-14,16,20,-2,-12,his,"Aug. 15 , 1925",PERSON,DATE-DATE-DATE-DATE,DET,PROPN-NUM-PUNCT-NUM,poss,pobj-nummod-punct-nummod,PRP$,"NNP-CD-,-CD",5,1
5536,14324.0,32,told,13,7,12,5,6,19,6,-1,Northland Church,Fla,ORGANIZATION-ORGANIZATION,STATE_OR_PROVINCE,PROPN-PROPN,PROPN,compound-pobj,appos,NNP-NNP,NNP,5,1
5537,14325.0,20,born,2,1,7,6,0,12,1,5,Forsberg,Huntsville,PERSON,CITY,PROPN,PROPN,nsubjpass,pobj,NNP,NNP,4,1
5538,46662.0,20,born,2,1,7,6,0,12,1,5,Forsberg,Huntsville,PERSON,CITY,PROPN,PROPN,nsubjpass,pobj,NNP,NNP,4,1
5539,14330.0,35,appealed,12,2,8,6,1,26,10,-4,Manila Economic and Cultural Office,MECO,ORGANIZATION-ORGANIZATION-ORGANIZATION-ORGANIZATION-ORGANIZATION,ORGANIZATION,PROPN-PROPN-CCONJ-PROPN-PROPN,PROPN,nmod-nmod-cc-conj-compound,compound,NNP-NNP-CC-NNP-NNP,NNP,3,1
5540,23326.0,26,Jr.,2,8,14,6,7,11,-6,12,Manila Economic and Cultural Office,MECO,ORGANIZATION-ORGANIZATION-ORGANIZATION-ORGANIZATION-ORGANIZATION,ORGANIZATION,PROPN-PROPN-CCONJ-PROPN-PROPN,PROPN,nmod-nmod-cc-conj-pobj,compound,NNP-NNP-CC-NNP-NNP,NNP,5,1
5541,29122.0,38,said,20,28,34,6,27,3,-8,14,Manila Economic and Cultural Office,MECO,ORGANIZATION-ORGANIZATION-ORGANIZATION-ORGANIZATION-ORGANIZATION,ORGANIZATION,PROPN-PROPN-CCONJ-PROPN-PROPN,PROPN,nmod-nmod-cc-conj-pobj,compound,NNP-NNP-CC-NNP-NNP,NNP,6,1
5542,33525.0,63,said,29,41,47,6,40,15,-12,18,Manila Economic and Cultural Office,MECO,ORGANIZATION-ORGANIZATION-ORGANIZATION-ORGANIZATION-ORGANIZATION,ORGANIZATION,PROPN-PROPN-CCONJ-PROPN-PROPN,PROPN,nmod-nmod-cc-conj-pobj,compound,NNP-NNP-CC-NNP-NNP,NNP,7,1
5543,33864.0,45,cast,7,36,42,6,35,2,-29,35,Manila Economic and Cultural Office,MECO,ORGANIZATION-ORGANIZATION-ORGANIZATION-ORGANIZATION-ORGANIZATION,ORGANIZATION,PROPN-PROPN-CCONJ-PROPN-PROPN,PROPN,nmod-amod-cc-conj-appos,compound,NNP-NNP-CC-NNP-NNP,NNP,5,1
5544,44130.0,45,celebrated,11,2,8,6,1,36,9,-3,Manila Economic and Cultural Office,MECO,ORGANIZATION-ORGANIZATION-ORGANIZATION-ORGANIZATION-ORGANIZATION,ORGANIZATION,PROPN-PROPN-CCONJ-PROPN-PROPN,PROPN,nmod-nmod-cc-conj-compound,compound,NNP-NNP-CC-NNP-NNP,NNP,-1,1
5545,46281.0,36,was,11,24,30,6,23,5,-13,19,Manila Economic and Cultural Office,MECO,ORGANIZATION-ORGANIZATION-ORGANIZATION-ORGANIZATION-ORGANIZATION,ORGANIZATION,PROPN-PROPN-CCONJ-PROPN-PROPN,PROPN,nmod-nmod-cc-conj-pobj,compound,NNP-NNP-CC-NNP-NNP,NNP,8,1
5546,47445.0,58,said,36,48,10,-38,47,47,-12,-26,Manila Economic and Cultural Office,MECO,ORGANIZATION-ORGANIZATION-ORGANIZATION-ORGANIZATION-ORGANIZATION,ORGANIZATION,PROPN-PROPN-CCONJ-PROPN-PROPN,PROPN,nmod-nmod-cc-conj-pobj,poss,NNP-NNP-CC-NNP-NNP,NNP,11,1
5547,48479.0,61,made,29,2,8,6,1,52,27,-21,Manila Economic and Cultural Office,MECO,ORGANIZATION-ORGANIZATION-ORGANIZATION-ORGANIZATION-ORGANIZATION,ORGANIZATION,PROPN-PROPN-CCONJ-PROPN-PROPN,PROPN,nmod-nmod-cc-conj-compound,compound,NNP-NNP-CC-NNP-NNP,NNP,2,1
5548,58214.0,36,Neddo,1,9,15,6,8,20,-8,14,Manila Economic and Cultural Office,MECO,ORGANIZATION-ORGANIZATION-ORGANIZATION-ORGANIZATION-ORGANIZATION,ORGANIZATION,PROPN-PROPN-CCONJ-PROPN-PROPN,PROPN,nmod-nmod-cc-conj-pobj,compound,NNP-NNP-CC-NNP-NNP,NNP,5,1
5549,58816.0,35,appealed,12,2,8,6,1,26,10,-4,Manila Economic and Cultural Office,MECO,ORGANIZATION-ORGANIZATION-ORGANIZATION-ORGANIZATION-ORGANIZATION,ORGANIZATION,PROPN-PROPN-CCONJ-PROPN-PROPN,PROPN,nmod-nmod-cc-conj-compound,compound,NNP-NNP-CC-NNP-NNP,NNP,3,1
5550,14331.0,44,implement,5,37,40,3,36,3,-32,35,ADB,Haruhiko Kuroda,ORGANIZATION,PERSON-PERSON,PROPN,PROPN-PROPN,compound,compound-nsubj,NNP,NNP-NNP,2,1
5551,14611.0,53,said,51,19,50,31,18,2,32,-1,ADB,Haruhiko Kuroda,ORGANIZATION,PERSON-PERSON,PROPN,PROPN-PROPN,pobj,compound-nsubj,NNP,NNP-NNP,10,1
5552,19491.0,63,Eds,0,43,45,2,42,17,-43,45,ADB,Haruhiko Kuroda,ORGANIZATION,PERSON-PERSON,PROPN,PROPN-PROPN,compound,compound-nsubj,NNP,NNP-NNP,3,1
5553,47165.0,30,said,4,1,3,2,0,26,3,-1,ADB,Haruhiko Kuroda,ORGANIZATION,PERSON-PERSON,PROPN,PROPN-PROPN,compound,compound-nsubj,NNP,NNP-NNP,1,1
5554,54193.0,47,Bank,2,5,35,30,4,11,-3,33,ADB,Haruhiko Kuroda,ORGANIZATION,PERSON-PERSON,PROPN,PROPN-PROPN,compound,compound-appos,NNP,NNP-NNP,4,1
5555,62177.0,42,is,2,22,24,2,21,17,-20,22,ADB,Haruhiko Kuroda,ORGANIZATION,PERSON-PERSON,PROPN,PROPN-PROPN,compound,compound-nsubj,NNP,NNP-NNP,3,1
5556,66877.0,24,said,4,1,3,2,0,20,3,-1,ADB,Haruhiko Kuroda,ORGANIZATION,PERSON-PERSON,PROPN,PROPN-PROPN,compound,compound-nsubj,NNP,NNP-NNP,1,1
5557,14333.0,72,Disclosure,1,18,14,-4,17,57,-17,13,Kennedy Space Center,Space Shuttle Fleet,ORGANIZATION-ORGANIZATION-ORGANIZATION,ORGANIZATION-ORGANIZATION-ORGANIZATION,PROPN-PROPN-PROPN,PROPN-PROPN-PROPN,compound-compound-conj,compound-compound-conj,NNP-NNP-NNP,NNP-NNP-NNP,3,1
5558,14335.0,29,delivered,7,20,19,-1,19,9,-13,12,Lewis Hamilton,driver,PERSON-PERSON,TITLE,PROPN-PROPN,NOUN,compound-nsubj,compound,NNP-NNP,NN,1,1
5559,21677.0,24,walked,7,6,5,-1,5,18,1,-2,Lewis Hamilton,driver,PERSON-PERSON,TITLE,PROPN-PROPN,NOUN,compound-appos,nsubj,NNP-NNP,NN,1,1
5560,14336.0,47,survived,11,2,17,15,1,29,9,6,his,Jane Anderson,PERSON,PERSON-PERSON,DET,PROPN-PROPN,poss,compound-appos,PRP$,NNP-NNP,5,1
5561,14339.0,42,increased,5,24,20,-4,23,21,-19,15,Option One Mortgage,H&R Block Inc,ORGANIZATION-ORGANIZATION-ORGANIZATION,ORGANIZATION-ORGANIZATION-ORGANIZATION,PROPN-PROPN-PROPN,PROPN-PROPN-PROPN,nmod-compound-compound,compound-compound-poss,NNP-NNP-NNP,NNP-NNP-NNP,4,1
5562,14342.0,52,*,0,3,10,7,2,41,-3,10,Massachusetts Department of Conservation and Recreation,DCR,ORGANIZATION-ORGANIZATION-ORGANIZATION-ORGANIZATION-ORGANIZATION-ORGANIZATION,ORGANIZATION,PROPN-PROPN-ADP-PROPN-CCONJ-PROPN,PROPN,compound-nsubj-prep-pobj-cc-conj,compound,NNP-NNP-IN-NNP-CC-NNP,NNP,1,1
5563,14344.0,28,Yang,3,1,4,3,0,23,2,1,NSC,Yang Hung-tun,ORGANIZATION,PERSON-PERSON,PROPN,PROPN-PROPN,compound,ROOT-nsubj,NNP,NNP-NNP,3,1
5564,25146.0,28,Yang,3,1,4,3,0,23,2,1,NSC,Yang Hung-tun,ORGANIZATION,PERSON-PERSON,PROPN,PROPN-PROPN,compound,ROOT-nsubj,NNP,NNP-NNP,3,1
5565,14358.0,9,2007-09-05T00,0,4,3,-1,3,5,-4,3,Paul Gillmor,Rep,PERSON-PERSON,TITLE,PROPN-PROPN,PROPN,compound-ROOT,compound,NNP-NNP,NNP,2,1
5566,34157.0,13,R,4,2,1,-1,1,11,2,-3,Paul Gillmor,Rep,PERSON-PERSON,TITLE,PROPN-PROPN,PROPN,compound-compound,compound,NNP-NNP,NNP,1,1
5567,50842.0,23,says,21,5,4,-1,4,18,16,-17,Paul Gillmor,Rep,PERSON-PERSON,TITLE,PROPN-PROPN,PROPN,compound-nsubjpass,compound,NNP-NNP,NNP,1,1
5568,14360.0,20,says,6,6,4,-2,5,15,0,-2,Ospel,chairman,PERSON,TITLE,PROPN,NOUN,nsubj,compound,NNP,NN,2,1
5569,21919.0,39,forced,12,2,23,21,1,15,10,11,Ospel,chairman,PERSON,TITLE,PROPN,NOUN,nsubjpass,pobj,NNP,NN,6,1
5570,23220.0,23,noted,9,8,22,14,7,0,1,13,Ospel,chairman,PERSON,TITLE,PROPN,NOUN,pobj,pobj,NNP,NN,2,1
5571,37856.0,24,faces,6,1,5,4,0,18,5,-1,Ospel,chairman,PERSON,TITLE,PROPN,NOUN,nsubj,appos,NNP,NN,3,1
5572,51349.0,16,screamed,0,15,13,-2,14,2,-15,13,Ospel,chairman,PERSON,TITLE,PROPN,NOUN,pobj,compound,NNP,NN,5,1
5573,60286.0,30,BANKER,2,14,20,6,13,9,-12,18,Ospel,chairman,PERSON,TITLE,PROPN,NOUN,nsubj,pobj,NNP,NN,2,1
5574,62759.0,36,said,22,18,16,-2,17,19,4,-6,Ospel,chairman,PERSON,TITLE,PROPN,NOUN,pobj,compound,NNP,NN,10,1
5575,14364.0,13,has,7,2,11,9,1,1,5,4,new Anglican Church in North America,"100,000",ORGANIZATION-ORGANIZATION-ORGANIZATION-ORGANIZATION-ORGANIZATION-ORGANIZATION,NUMBER,ADJ-PROPN-PROPN-ADP-PROPN-PROPN,NUM,amod-compound-nsubj-prep-compound-pobj,nummod,JJ-NNP-NNP-IN-NNP-NNP,CD,3,1
5576,14409.0,43,said,29,7,1,-6,6,41,22,-28,George Sheldon,Department of Children and Families,PERSON-PERSON,ORGANIZATION-ORGANIZATION-ORGANIZATION-ORGANIZATION-ORGANIZATION,PROPN-PROPN,PROPN-ADP-PROPN-CCONJ-PROPN,compound-nsubj,nmod-prep-pobj-cc-compound,NNP-NNP,NNP-IN-NNP-CC-NNPS,2,1
5577,27261.0,17,said,8,7,1,-6,6,15,1,-7,George Sheldon,Department of Children and Families,PERSON-PERSON,ORGANIZATION-ORGANIZATION-ORGANIZATION-ORGANIZATION-ORGANIZATION,PROPN-PROPN,PROPN-ADP-PROPN-CCONJ-PROPN,compound-nsubj,nmod-prep-pobj-cc-conj,NNP-NNP,NNP-IN-NNP-CC-NNPS,2,1
5578,37102.0,38,named,21,2,33,31,1,4,19,12,George Sheldon,Department of Children and Families,PERSON-PERSON,ORGANIZATION-ORGANIZATION-ORGANIZATION-ORGANIZATION-ORGANIZATION,PROPN-PROPN,PROPN-ADP-PROPN-CCONJ-PROPN,compound-nsubjpass,dobj-prep-pobj-cc-conj,NNP-NNP,NNP-IN-NNP-CC-NNPS,4,1
5579,54379.0,24,got,19,5,13,8,4,10,14,-6,George Sheldon,Department of Children and Families,PERSON-PERSON,ORGANIZATION-ORGANIZATION-ORGANIZATION-ORGANIZATION-ORGANIZATION,PROPN-PROPN,PROPN-ADP-PROPN-CCONJ-PROPN,compound-nsubj,pobj-prep-pobj-cc-conj,NNP-NNP,NNP-IN-NNP-CC-NNPS,4,1
5580,66628.0,45,asked,20,18,12,-6,17,32,2,-8,George Sheldon,Department of Children and Families,PERSON-PERSON,ORGANIZATION-ORGANIZATION-ORGANIZATION-ORGANIZATION-ORGANIZATION,PROPN-PROPN,PROPN-ADP-PROPN-CCONJ-PROPN,compound-appos,pobj-prep-pobj-cc-conj,NNP-NNP,NNP-IN-NNP-CC-NNPS,4,1
5581,14411.0,14,praised,8,1,7,6,0,6,7,-1,McAllister,secretary,PERSON,TITLE,PROPN,NOUN,nsubj,appos,NNP,NN,3,1
5582,14419.0,35,said,13,2,10,8,1,24,11,-3,Australian Broadcasting Corp.,Australia,ORGANIZATION-ORGANIZATION-ORGANIZATION,COUNTRY,PROPN-PROPN-PROPN,PROPN,compound-compound-nsubj,pobj,NNP-NNP-NNP,NNP,7,1
5583,30103.0,31,told,20,22,30,8,21,0,-2,10,Australian Broadcasting Corp.,Australia,ORGANIZATION-ORGANIZATION-ORGANIZATION,COUNTRY,PROPN-PROPN-PROPN,PROPN,compound-compound-compound,dobj,NNP-NNP-NNP,NNP,6,1
5584,58765.0,37,told,22,25,35,10,24,1,-3,13,Australian Broadcasting Corp.,Australia,ORGANIZATION-ORGANIZATION-ORGANIZATION,COUNTRY,PROPN-PROPN-PROPN,PROPN,compound-compound-subtok,pobj,NNP-NNP-NNP,NNP,-1,1
5585,14427.0,30,went,14,9,17,8,8,12,5,3,him,Jerusalem,PERSON,CITY,PRON,PROPN,dobj,poss,PRP,NNP,6,1
5586,14434.0,43,claimed,34,2,25,23,1,17,32,-9,Chavez,Hugo de los Reyes Chavez,PERSON,PERSON-PERSON-PERSON-PERSON-PERSON,PROPN,PROPN-PROPN-PROPN-PROPN-PROPN,poss,compound-compound-compound-compound-appos,NNP,NNP-NNP-NNP-NNP-NNP,6,1
5587,14457.0,34,abolished,2,11,2,-9,10,31,-9,0,MECO,Philippines,ORGANIZATION,COUNTRY,NOUN,PROPN,conj,nsubj,NNS,NNPS,2,1
5588,14469.0,34,defended,9,20,16,-4,19,17,-11,7,he,Homeownership Alliance,PERSON,ORGANIZATION-ORGANIZATION,PRON,PROPN-PROPN,nsubj,compound-pobj,PRP,NNP-NNP,5,1
5589,14475.0,52,said,17,16,28,12,15,23,1,11,Negroponte,Foreign Service,PERSON,ORGANIZATION-ORGANIZATION,PROPN,PROPN-PROPN,nsubj,compound-compound,NNP,NNP-NNP,7,1
5590,14478.0,20,bc-mcdonald-obit-post-correction,0,8,4,-4,7,15,-8,4,Augustus F Hawkins,African American,PERSON-PERSON-PERSON,NATIONALITY-NATIONALITY,PROPN-PROPN-PROPN,PROPN-PROPN,compound-compound-attr,amod-nsubj,NNP-NNP-NNP,NNP-NNP,2,1
5591,17882.0,19,was,4,7,3,-4,6,15,-3,-1,Augustus F Hawkins,African American,PERSON-PERSON-PERSON,NATIONALITY-NATIONALITY,PROPN-PROPN-PROPN,PROPN-PROPN,compound-compound-attr,amod-nsubj,NNP-NNP-NNP,NNP-NNP,3,1
5592,14482.0,35,failed,5,25,28,3,24,6,-20,23,Christopher Dodd,D-Conn.,PERSON-PERSON,LOCATION,PROPN-PROPN,ADJ,compound-conj,conj,NNP-NNP,JJ,3,1
5593,15271.0,21,suggested,12,2,5,3,1,15,10,-7,Christopher Dodd,D-Conn.,PERSON-PERSON,LOCATION,PROPN-PROPN,ADJ,compound-nsubj,appos,NNP-NNP,JJ,1,1
5594,58771.0,42,expect,32,15,18,3,14,23,17,-14,Christopher Dodd,D-Conn.,PERSON-PERSON,LOCATION,PROPN-PROPN,PROPN,compound-conj,appos,NNP-NNP,NNP,3,1
5595,14486.0,49,meets,2,22,46,24,21,2,-20,44,Korean Central News Agency,Kim Chang Gwang,ORGANIZATION-ORGANIZATION-ORGANIZATION-ORGANIZATION,PERSON-PERSON-PERSON,PROPN-PROPN-PROPN-PROPN,PROPN-PROPN-PROPN,compound-compound-compound-pobj,compound-compound-pobj,NNP-NNP-NNP-NNP,NNP-NNP-NNP,-1,1
5596,14489.0,22,provides,17,5,16,11,4,5,12,-1,Ownit Mortgage Solutions,Calif.,ORGANIZATION-ORGANIZATION-ORGANIZATION,STATE_OR_PROVINCE,PROPN-PROPN-PROPN,PROPN,compound-compound-pobj,appos,NNP-NNP-NNPS,NNP,5,1
5597,47018.0,47,was,1,12,19,7,11,27,-11,18,Ownit Mortgage Solutions,Calif.,ORGANIZATION-ORGANIZATION-ORGANIZATION,STATE_OR_PROVINCE,PROPN-PROPN-PROPN,PROPN,compound-compound-nsubj,appos,NNP-NNP-NNPS,NNP,2,1
5598,48163.0,32,halted,24,6,13,7,5,18,18,-11,Ownit Mortgage Solutions,Calif.,ORGANIZATION-ORGANIZATION-ORGANIZATION,STATE_OR_PROVINCE,PROPN-PROPN-PROPN,PROPN,compound-compound-nsubj,appos,NNP-NNP-NNPS,NNP,3,1
5599,14520.0,31,survived,3,1,23,22,0,7,2,20,Yolanda King,Dexter Scott King,PERSON-PERSON,PERSON-PERSON-PERSON,PROPN-PROPN,PROPN-PROPN-PROPN,compound-nsubjpass,compound-compound-conj,NNP-NNP,NNP-NNP-NNP,7,1
5600,14527.0,40,PARIS,0,13,13,0,12,26,-13,13,"Iranian Revolutionary Guard , Qods Force",Iranian military,ORGANIZATION-ORGANIZATION-ORGANIZATION-ORGANIZATION-ORGANIZATION-ORGANIZATION,ORGANIZATION-ORGANIZATION,PROPN-PROPN-PROPN-PUNCT-PROPN-PROPN,ADJ-NOUN,compound-compound-pobj-punct-compound-appos,amod-pobj,"NNP-NNP-NNP-,-NNP-NNP",JJ-NN,0,1
5601,14536.0,39,said,4,1,8,7,0,30,3,4,CNB,bank board,ORGANIZATION,ORGANIZATION-ORGANIZATION,PROPN,NOUN-NOUN,compound,compound-compound,NNP,NN-NN,6,1
5602,14542.0,24,born,4,1,19,18,0,4,3,15,Catherine Gertrude Roraback,Albert,PERSON-PERSON-PERSON,PERSON,PROPN-PROPN-PROPN,PROPN,compound-compound-nsubjpass,pobj,NNP-NNP-NNP,NNP,9,1
5603,14548.0,45,struggling,32,13,24,11,12,20,19,-8,Detroit Medical Center,Barbara Ann Karmanos Cancer Institute,ORGANIZATION-ORGANIZATION-ORGANIZATION,ORGANIZATION-ORGANIZATION-ORGANIZATION-ORGANIZATION-ORGANIZATION,PROPN-PROPN-PROPN,PROPN-PROPN-PROPN-PROPN-PROPN,compound-compound-pobj,compound-compound-compound-compound-nsubj,NNP-NNP-NNP,NNP-NNP-NNP-NNP-NNP,8,1
5604,14549.0,39,is,5,16,23,7,15,15,-11,18,George Sheldon,Tampa,PERSON-PERSON,CITY,PROPN-PROPN,PROPN,compound-pobj,pobj,NNP-NNP,NNP,3,1
5605,14551.0,38,finished,26,2,19,17,1,18,24,-7,22-year-old Briton,black,PERSON-PERSON,NATIONALITY,NUM-PROPN,ADJ,compound-nsubj,amod,CD-NNP,JJ,9,1
5606,14566.0,60,survived,2,21,31,10,20,28,-19,29,Robert E. Jr.,Robin Lee Howell,PERSON-PERSON-PERSON,PERSON-PERSON-PERSON,PROPN-PROPN-PROPN,PROPN-PROPN-PROPN,compound-compound-appos,compound-compound-conj,NNP-NNP-NNP,NNP-NNP-NNP,5,1
5607,14568.0,47,was,2,13,29,16,12,17,-11,27,Ellen Pompeo,Izzie,PERSON-PERSON,PERSON,PROPN-PROPN,PROPN,compound-compound,compound,NNP-NNP,NNP,6,1
5608,14572.0,29,led,23,11,16,5,10,12,12,-7,Scorpions,Gauteng,ORGANIZATION,LOCATION,PROPN,PROPN,oprd,pobj,NNPS,NNP,5,1
5609,14576.0,23,places,11,3,6,3,2,16,8,-5,Simon Cowell,Fox,PERSON-PERSON,ORGANIZATION,PROPN-PROPN,PROPN,compound-nsubj,poss,NNP-NNP,NNP,3,1
5610,14582.0,41,returned,3,9,37,28,8,3,-6,34,her,Massachusetts Institute of Technology,PERSON,ORGANIZATION-ORGANIZATION-ORGANIZATION-ORGANIZATION,DET,PROPN-PROPN-ADP-PROPN,poss,compound-pobj-prep-pobj,PRP$,NNP-NNP-IN-NNP,9,1
5611,27966.0,41,returned,3,9,37,28,8,3,-6,34,her,Massachusetts Institute of Technology,PERSON,ORGANIZATION-ORGANIZATION-ORGANIZATION-ORGANIZATION,PRON,PROPN-PROPN-ADP-PROPN,dobj,compound-pobj-prep-pobj,PRP,NNP-NNP-IN-NNP,9,1
5612,45163.0,41,returned,3,9,37,28,8,3,-6,34,her,Massachusetts Institute of Technology,PERSON,ORGANIZATION-ORGANIZATION-ORGANIZATION-ORGANIZATION,DET,PROPN-PROPN-ADP-PROPN,poss,compound-pobj-prep-pobj,PRP$,NNP-NNP-IN-NNP,9,1
5613,14585.0,8,On,0,5,4,-1,4,3,-5,4,Andre Carson,Rep,PERSON-PERSON,TITLE,PROPN-PROPN,PROPN,compound-pobj,compound,NNP-NNP,NNP,1,1
5614,14592.0,40,charged,7,3,6,3,2,33,4,-1,Brandon McInerney,Oxnard,PERSON-PERSON,CITY,PROPN-PROPN,PROPN,compound-nsubjpass,pobj,NNP-NNP,NNP,3,1
5615,17473.0,36,found,25,1,5,4,0,30,24,-20,Brandon McInerney,Oxnard,PERSON-PERSON,CITY,PROPN-PROPN,PROPN,compound-nsubjpass,compound,NNP-NNP,NNP,1,1
5616,14599.0,20,helped,13,12,4,-8,11,15,1,-9,she,assistant,PERSON,TITLE,PRON,ADJ,nsubj,amod,PRP,JJ,3,1
5617,14629.0,20,born,3,1,18,17,0,1,2,15,Mary Dent,Harry Dent,PERSON-PERSON,PERSON-PERSON,PROPN-PROPN,PROPN-PROPN,compound-nsubjpass,compound-conj,NNP-NNP,NNP-NNP,5,1
5618,14641.0,18,called,3,5,3,-2,4,14,-2,0,Citibank,she,ORGANIZATION,PERSON,PROPN,PRON,oprd,nsubj,NNP,PRP,2,1
5619,14649.0,32,play,5,20,19,-1,19,12,-15,14,Binoche,star,PERSON,TITLE,PROPN,NOUN,nsubj,compound,NNP,NN,1,1
5620,14659.0,67,contributed,9,2,34,32,1,32,7,25,the Starr Foundation,American International Group,ORGANIZATION-ORGANIZATION-ORGANIZATION,ORGANIZATION-ORGANIZATION-ORGANIZATION,DET-PROPN-PROPN,PROPN-PROPN-PROPN,det-compound-pobj,compound-compound-pobj,DT-NNP-NNP,NNP-NNP-NNP,9,1
5621,14667.0,50,Tehran,0,7,9,2,6,40,-7,9,Asian Parliament Assembly,Assembly,ORGANIZATION-ORGANIZATION-ORGANIZATION,ORGANIZATION,ADJ-PROPN-PROPN,PROPN,compound-pobj-appos,poss,JJ-NNP-NNP,NNP,2,1
5622,14668.0,50,is,1,7,24,17,6,25,-6,23,Moro National Liberation Front,Islamic separatist,ORGANIZATION-ORGANIZATION-ORGANIZATION-ORGANIZATION,IDEOLOGY-IDEOLOGY,PROPN-PROPN-PROPN-PROPN,ADJ-ADJ,compound-compound-compound-pobj,amod-amod,NNP-NNP-NNP-NNP,JJ-JJ,9,1
5623,14673.0,31,has,1,25,21,-4,24,9,-24,20,SAC,Shenyang Aircraft Corporation,ORGANIZATION,ORGANIZATION-ORGANIZATION-ORGANIZATION,PROPN,PROPN-PROPN-PROPN,compound,compound-compound-pobj,NNP,NNP-NNP-NNP,7,1
5624,14676.0,24,said,22,21,1,-20,20,22,1,-21,Bryan Baldwin,JetBlue Airways Corp.,PERSON-PERSON,ORGANIZATION-ORGANIZATION-ORGANIZATION,PROPN-PROPN,PROPN-PROPN-PROPN,compound-nsubj,compound-compound-nsubj,NNP-NNP,NNP-NNP-NNP,4,1
5625,53886.0,24,said,6,5,1,-4,4,22,1,-5,Bryan Baldwin,JetBlue Airways Corp.,PERSON-PERSON,ORGANIZATION-ORGANIZATION-ORGANIZATION,PROPN-PROPN,PROPN-PROPN-PROPN,compound-nsubj,compound-compound-compound,NNP-NNP,NNP-NNP-NNP,3,1
5626,14679.0,42,wounds,31,5,10,5,4,31,26,-21,Medina Hospital,Somalia,ORGANIZATION-ORGANIZATION,COUNTRY,PROPN-PROPN,PROPN,compound-pobj,poss,NNP-NNP,NNP,3,1
5627,14712.0,44,refused,2,42,1,-41,41,42,-40,-1,Fyffes PLC.,Flavin,ORGANIZATION-ORGANIZATION,PERSON,ADV-PROPN,PROPN,compound-pobj,nsubj,RB-NNP,NNP,8,1
5628,14714.0,20,included,3,14,3,-11,13,16,-11,0,Itochu Corp.,Tokyo,ORGANIZATION-ORGANIZATION,CITY,PROPN-PROPN,PROPN,compound-conj,pobj,NNP-NNP,NNP,3,1
5629,65711.0,28,said,15,24,27,3,23,0,-9,12,Itochu Corp.,Tokyo,ORGANIZATION-ORGANIZATION,CITY,PROPN-PROPN,PROPN,compound-pobj,pobj,NNP-NNP,NNP,5,1
5630,14718.0,24,founded,2,21,1,-20,20,22,-19,-1,Opera de Paris,He,ORGANIZATION-ORGANIZATION-ORGANIZATION,PERSON,PROPN-ADP-PROPN,PRON,compound-compound-pobj,nsubj,NNP-IN-NNP,PRP,7,1
5631,14741.0,46,slowed,3,23,17,-6,22,28,-20,14,International Monetary Fund,Brian Ames,ORGANIZATION-ORGANIZATION-ORGANIZATION,PERSON-PERSON,PROPN-PROPN-PROPN,PROPN-PROPN,compound-compound-poss,compound-nsubj,NNP-NNP-NNP,NNP-NNP,6,1
5632,14787.0,41,detained,16,1,9,8,0,31,15,-7,Kurnaz,Germany,PERSON,COUNTRY,PROPN,PROPN,nsubjpass,appos,NNP,NNP,3,1
5633,37233.0,35,said,4,26,29,3,25,5,-22,25,Kurnaz,Germany,PERSON,COUNTRY,PROPN,PROPN,compound,pobj,NNP,NNP,3,1
5634,41995.0,30,released,6,1,13,12,0,16,5,7,Kurnaz,Germany,PERSON,COUNTRY,PROPN,PROPN,nsubjpass,pobj,NNP,NNP,4,1
5635,45184.0,21,living,10,17,13,-4,16,7,-7,3,Kurnaz,Germany,PERSON,NATIONALITY,PROPN,PROPN,pobj,pobj,NNP,NNP,5,1
5636,53747.0,30,blamed,5,10,23,13,9,6,-5,18,Kurnaz,Germany,PERSON,COUNTRY,PROPN,PROPN,poss,pobj,NNP,NNP,7,1
5637,14793.0,27,known,14,1,23,22,0,3,13,9,Fidelity Investments,his,ORGANIZATION-ORGANIZATION,PERSON,PROPN-PROPN,DET,compound-compound,poss,NNP-NNPS,PRP$,5,1
5638,14794.0,13,Morgenthau,0,1,12,11,0,0,-1,12,Morgenthau,90,PERSON,NUMBER,NOUN,NUM,ROOT,nummod,NNS,CD,2,1
5639,14797.0,7,joined,1,1,4,3,0,2,0,3,Farland,FBI,PERSON,ORGANIZATION,PROPN,PROPN,nsubj,dobj,NNP,NNP,1,1
5640,14807.0,44,said,17,16,9,-7,15,34,1,-8,CPS,Department of Economic Security,ORGANIZATION,ORGANIZATION-ORGANIZATION-ORGANIZATION-ORGANIZATION,PROPN,PROPN-ADP-PROPN-PROPN,dobj,pobj-prep-compound-pobj,NNP,NNP-IN-NNP-NNP,6,1
5641,14813.0,28,CMA,0,1,3,2,0,24,-1,3,CMA,http://wwwcmaworldcom,ORGANIZATION,URL,PROPN,X,ROOT,ROOT,NNP,ADD,3,1
5642,44826.0,16,CMA,0,1,3,2,0,12,-1,3,CMA,http://wwwcmaworldcom,ORGANIZATION,URL,PROPN,X,ROOT,compound,NNP,ADD,2,1
5643,14820.0,34,said,32,3,10,7,2,23,29,-22,Jo Ann Davis,Virginia in the House of Representatives,PERSON-PERSON-PERSON,ORGANIZATION-ORGANIZATION-ORGANIZATION-ORGANIZATION-ORGANIZATION-ORGANIZATION,PROPN-PROPN-PROPN,PROPN-ADP-DET-PROPN-ADP-PROPN,compound-compound-nsubj,dobj-prep-det-pobj-prep-pobj,NNP-NNP-NNP,NNP-IN-DT-NNP-IN-NNPS,3,1
5644,14821.0,33,was,7,5,19,14,4,13,2,12,she,City,PERSON,ORGANIZATION,PRON,PROPN,nsubj,compound,PRP,NNP,8,1
5645,14823.0,52,made,19,7,10,3,6,41,12,-9,NSC,Lee Lou - chuang,ORGANIZATION,PERSON-PERSON-PERSON-PERSON,PROPN,PROPN-PROPN-PUNCT-PROPN,compound,compound-compound-punct-pobj,NNP,NNP-NNP-HYPH-NNP,3,1
5646,14824.0,35,said,6,8,8,0,7,26,-2,2,Remy Smith,Remy Ma,PERSON-PERSON,PERSON-PERSON,PROPN-PROPN,PROPN-PROPN,compound-attr,compound-nsubj,NNP-NNP,NNP-NNP,0,1
5647,48585.0,30,nominated,11,1,1,0,0,28,10,-10,Remy Smith,Remy Ma,PERSON-PERSON,PERSON-PERSON,PROPN-PROPN,PROPN-PROPN,compound-attr,compound-nsubjpass,NNP-NNP,NNP-NNP,0,1
5648,51609.0,30,said,6,8,8,0,7,21,-2,2,Remy Smith,Remy Ma,PERSON-PERSON,PERSON-PERSON,PROPN-PROPN,PROPN-PROPN,compound-attr,compound-nsubj,NNP-NNP,NNP-NNP,0,1
5649,60890.0,33,said,1,7,7,0,6,25,-6,6,Remy Smith,Remy Ma,PERSON-PERSON,PERSON-PERSON,PROPN-PROPN,PROPN-PROPN,compound-attr,compound-nsubj,NNP-NNP,NNP-NNP,0,1
5650,63835.0,35,conceded,3,6,6,0,5,28,-3,3,Remy Smith,Remy Ma,PERSON-PERSON,PERSON-PERSON,PROPN-PROPN,PROPN-PROPN,compound-attr,compound-nsubj,NNP-NNP,NNP-NNP,0,1
5651,14835.0,30,published,1,1,22,21,0,7,0,21,Washburn,New England Museum of Natural History,PERSON,ORGANIZATION-ORGANIZATION-ORGANIZATION-ORGANIZATION-ORGANIZATION-ORGANIZATION,NOUN,PROPN-PROPN-PROPN-ADP-PROPN-PROPN,nsubj,compound-compound-pobj-prep-compound-pobj,NN,NNP-NNP-NNP-IN-NNP-NNP,5,1
5652,14837.0,45,said,8,1,6,5,0,38,7,-2,National Red Cross,Carlos Ivan Marquez,ORGANIZATION-ORGANIZATION-ORGANIZATION,PERSON-PERSON-PERSON,PROPN-PROPN-PROPN,PROPN-PROPN-PROPN,amod-compound-compound,compound-compound-nsubj,NNP-NNP-NNP,NNP-NNP-NNP,4,1
5653,14844.0,53,announced,9,6,11,5,5,41,3,2,Robert M. Morgenthau,manslaughter,PERSON-PERSON-PERSON,CRIMINAL_CHARGE,PROPN-PROPN-PROPN,NOUN,compound-compound-appos,compound,NNP-NNP-NNP,NN,4,1
5654,14873.0,36,said,13,8,1,-7,7,34,5,-12,International Crisis Group,Samina Ahmed,ORGANIZATION-ORGANIZATION-ORGANIZATION,PERSON-PERSON,PROPN-PROPN-PROPN,PROPN-PROPN,compound-compound-pobj,compound-nsubj,NNP-NNP-NNP,NNP-NNP,4,1
5655,14882.0,30,said,11,21,16,-5,20,13,-10,5,Professional Rodeo Cowboys Association,animal welfare,ORGANIZATION-ORGANIZATION-ORGANIZATION-ORGANIZATION,IDEOLOGY-IDEOLOGY,PROPN-PROPN-PROPN-PROPN,NOUN-NOUN,compound-compound-compound-pobj,compound-compound,NNP-NNP-NNPS-NNP,NN-NN,4,1
5656,14884.0,48,said,18,2,30,28,1,17,16,12,He,New York University Law School,PERSON,ORGANIZATION-ORGANIZATION-ORGANIZATION-ORGANIZATION-ORGANIZATION,PRON,PROPN-PROPN-PROPN-PROPN-PROPN,nsubj,compound-compound-compound-compound-pobj,PRP,NNP-NNP-NNP-NNP-NNP,9,1
5657,14888.0,48,asked,17,32,22,-10,31,25,-15,5,Buchwald,editor,PERSON,TITLE,PROPN,NOUN,poss,compound,NNP,NN,7,1
5658,14893.0,34,said,1,3,10,7,2,23,-2,9,Negroponte,U.S.,PERSON,COUNTRY,PROPN,PROPN,poss,compound,NNP,NNP,6,1
5659,14897.0,34,was,10,4,29,25,3,4,6,19,he,mechanic,PERSON,TITLE,PRON,NOUN,nsubj,pobj,PRP,NN,3,1
5660,16104.0,34,was,10,4,29,25,3,4,6,19,he,mechanic,PERSON,TITLE,PRON,NOUN,nsubj,pobj,PRP,NN,3,1
5661,14907.0,45,said,25,10,2,-8,9,42,15,-23,House,Frank Smizik,ORGANIZATION,PERSON-PERSON,PROPN,PROPN-PROPN,compound,compound-nsubj,NNP,NNP-NNP,3,1
5662,14918.0,48,explained,26,35,28,-7,34,19,-9,2,Noordhoff Craniofacial Foundation,Jessica Chen,ORGANIZATION-ORGANIZATION-ORGANIZATION,PERSON-PERSON,PROPN-PROPN-PROPN,PROPN-PROPN,compound-compound-compound,compound-nsubj,NNP-NNP-NNP,NNP-NNP,5,1
5663,14929.0,21,was,4,4,18,14,3,2,0,14,Ahearn,Williamsburg,PERSON,CITY,PROPN,PROPN,nsubj,pobj,NNP,NNP,8,1
5664,14935.0,31,became,22,2,5,3,1,25,20,-17,her,Robert W. Goodman,PERSON,PERSON-PERSON-PERSON,DET,PROPN-PROPN-PROPN,poss,compound-compound-pobj,PRP$,NNP-NNP-NNP,3,1
5665,14945.0,9,Mitchell,4,3,7,4,2,1,1,3,Parren J. Mitchell,85,PERSON-PERSON-PERSON,NUMBER,PROPN-PROPN-PROPN,NUM,compound-compound-ROOT,appos,NNP-NNP-NNP,CD,3,1
5666,14946.0,43,is,20,8,12,4,7,30,12,-8,Barbara Boxer,Congress,PERSON-PERSON,ORGANIZATION,PROPN-PROPN,PROPN,compound-pobj,dobj,NNP-NNP,NNP,5,1
5667,23450.0,38,flying,11,21,26,5,20,11,-10,15,Barbara Boxer,Congress,PERSON-PERSON,ORGANIZATION,PROPN-PROPN,PROPN,compound-pobj,poss,NNP-NNP,NNP,5,1
5668,14953.0,25,said,18,23,22,-1,22,2,-5,4,Berthold Huber,Chairman,PERSON-PERSON,TITLE,PROPN-PROPN,PROPN,compound-nsubj,compound,NNP-NNP,NNP,2,1
5669,14963.0,67,RESTRICTIONS,0,10,13,3,9,53,-10,13,MAC,Liu Te-hsun,ORGANIZATION,PERSON-PERSON,PROPN,PROPN-PROPN,compound,compound-nsubj,NNP,NNP-NNP,3,1
5670,53779.0,58,survey,8,26,29,3,25,28,-18,21,MAC,Liu Te-hsun,ORGANIZATION,PERSON-PERSON,PROPN,PROPN-PROPN,compound,compound-nsubj,NNP,NNP-NNP,3,1
5671,14966.0,28,said,18,9,27,18,8,0,9,9,JEM,Khartoum,ORGANIZATION,CITY,PROPN,PROPN,poss,pobj,NNP,NNP,7,1
5672,62373.0,35,been,3,1,32,31,0,2,2,29,JEM,Khartoum,ORGANIZATION,CITY,PROPN,PROPN,compound,appos,NNP,NNP,7,1
5673,14970.0,19,said,7,9,17,8,8,1,-2,10,his,Mary Grady,PERSON,PERSON-PERSON,DET,PROPN-PROPN,poss,compound-appos,PRP$,NNP-NNP,1,1
5674,14975.0,25,is,2,23,18,-5,22,6,-21,16,MNLF,Moro National Liberation Front,ORGANIZATION,ORGANIZATION-ORGANIZATION-ORGANIZATION-ORGANIZATION,PROPN,PROPN-PROPN-PROPN-PROPN,compound,compound-compound-compound-appos,NNP,NNP-NNP-NNP-NNP,-1,1
5675,16327.0,34,engaged,4,30,25,-5,29,8,-26,21,MNLF,Moro National Liberation Front,ORGANIZATION,ORGANIZATION-ORGANIZATION-ORGANIZATION-ORGANIZATION,PROPN,PROPN-PROPN-PROPN-PROPN,compound,compound-compound-compound-conj,NNP,NNP-NNP-NNP-NNP,3,1
5676,32983.0,35,Al-Qaeda-linked,0,25,20,-5,24,14,-25,20,MNLF,Moro National Liberation Front,ORGANIZATION,ORGANIZATION-ORGANIZATION-ORGANIZATION-ORGANIZATION,PROPN,PROPN-PROPN-PROPN-PROPN,compound,compound-compound-compound-pobj,NNP,NNP-NNP-NNP-NNP,3,1
5677,49188.0,24,said,1,13,8,-5,12,15,-12,7,MNLF,Moro National Liberation Front,ORGANIZATION,ORGANIZATION-ORGANIZATION-ORGANIZATION-ORGANIZATION,PROPN,PROPN-PROPN-PROPN-PROPN,compound,compound-compound-compound-pobj,NNP,NNP-NNP-NNP-NNP,6,1
5678,50972.0,45,created,19,30,25,-5,29,19,-11,6,MNLF,Moro National Liberation Front,ORGANIZATION,ORGANIZATION-ORGANIZATION-ORGANIZATION-ORGANIZATION,PROPN,PROPN-PROPN-PROPN-PROPN,compound,compound-compound-compound-dobj,NNP,NNP-NNP-NNP-NNP,4,1
5679,52473.0,26,established,3,22,17,-5,21,8,-19,14,MNLF,Moro National Liberation Front,ORGANIZATION,ORGANIZATION-ORGANIZATION-ORGANIZATION-ORGANIZATION,PROPN,PROPN-PROPN-PROPN-PROPN,compound,compound-compound-compound-conj,NNP,NNP-NNP-NNP-NNP,9,1
5680,53102.0,29,broke,2,16,11,-5,15,17,-14,9,MNLF,Moro National Liberation Front,ORGANIZATION,ORGANIZATION-ORGANIZATION-ORGANIZATION-ORGANIZATION,PROPN,PROPN-PROPN-PROPN-PROPN,compound,compound-compound-compound-appos,NNP,NNP-NNP-NNP-NNP,6,1
5681,63587.0,42,lamented,2,9,4,-5,8,37,-7,2,MNLF,Moro National Liberation Front,ORGANIZATION,ORGANIZATION-ORGANIZATION-ORGANIZATION-ORGANIZATION,PROPN,PROPN-PROPN-PROPN-PROPN,compound,compound-compound-compound-dobj,NNP,NNP-NNP-NNP-NNP,2,1
5682,65329.0,29,is,10,9,4,-5,8,24,1,-6,MNLF,Moro National Liberation Front,ORGANIZATION,ORGANIZATION-ORGANIZATION-ORGANIZATION-ORGANIZATION,PROPN,PROPN-PROPN-PROPN-PROPN,compound,compound-compound-compound-appos,NNP,NNP-NNP-NNP-NNP,-1,1
5683,66337.0,48,told,1,36,30,-6,35,17,-35,29,MNLF,Moro National Liberation Front,ORGANIZATION,ORGANIZATION-ORGANIZATION-ORGANIZATION-ORGANIZATION,PROPN,PROPN-PROPN-PROPN-PROPN,conj,compound-compound-compound-pobj,NNP,NNP-NNP-NNP-NNP,4,1
5684,67328.0,43,reported,37,30,25,-5,29,17,7,-12,MNLF,Moro National Liberation Front,ORGANIZATION,ORGANIZATION-ORGANIZATION-ORGANIZATION-ORGANIZATION,PROPN,PROPN-PROPN-PROPN-PROPN,compound,compound-compound-compound-pobj,NNP,NNP-NNP-NNP-NNP,9,1
5685,14978.0,51,found,37,27,25,-2,26,25,10,-12,Jake Pavelka,Dallas,PERSON-PERSON,CITY,PROPN-PROPN,PROPN,compound-pobj,compound,NNP-NNP,NNP,1,1
5686,14980.0,50,made,18,11,8,-3,10,41,7,-10,Justin Theroux,DC,PERSON-PERSON,STATE_OR_PROVINCE,PROPN-PROPN,PROPN,compound-conj,nmod,NNP-NNP,NNP,4,1
5687,14986.0,67,were,3,2,54,52,1,12,1,51,corporations,Ask Tax,ORGANIZATION,ORGANIZATION-ORGANIZATION,NOUN,PROPN-PROPN,nsubj,compound-conj,NNS,NNP-NNP,6,1
5688,14994.0,10,Wildmon,2,1,5,4,0,4,1,3,Donald E. Wildmon,Founder and Chairman American Family Association,PERSON-PERSON-PERSON,ORGANIZATION-ORGANIZATION-ORGANIZATION-ORGANIZATION-ORGANIZATION-ORGANIZATION,PROPN-PROPN-PROPN,PROPN-CCONJ-PROPN-PROPN-PROPN-PROPN,compound-compound-ROOT,conj-cc-compound-compound-compound-conj,NNP-NNP-NNP,NNP-CC-NNP-NNP-NNP-NNP,3,1
5689,14998.0,40,said,33,35,38,3,34,1,-2,5,ABA,Edward Yingling,ORGANIZATION,PERSON-PERSON,PROPN,PROPN-PROPN,compound,compound-nsubj,NNP,NNP-NNP,3,1
5690,33995.0,29,said,23,25,27,2,24,1,-2,4,ABA,Edward Yingling,ORGANIZATION,PERSON-PERSON,PROPN,PROPN-PROPN,compound,compound-nsubj,NNP,NNP-NNP,3,1
5691,48116.0,36,said,31,26,30,4,25,5,5,-1,ABA,Edward Yingling,ORGANIZATION,PERSON-PERSON,PROPN,PROPN-PROPN,compound,compound-nsubj,NNP,NNP-NNP,3,1
5692,15001.0,17,agreed,2,1,15,14,0,1,1,13,Sandy,Sheepshead Bay,PERSON,LOCATION-LOCATION,PROPN,PROPN-PROPN,nsubj,compound-pobj,NNP,NNP-NNP,6,1
5693,15008.0,46,said,33,44,38,-6,43,7,-11,5,Jackson Hewitt,vice president,PERSON-PERSON,TITLE-TITLE,PROPN-PROPN,NOUN-NOUN,compound-pobj,compound-appos,NNP-NNP,NN-NN,3,1
5694,15036.0,85,Sutter,1,1,29,28,0,55,0,28,Trista Sutter,Blakesley Grace,PERSON-PERSON,PERSON-PERSON,PROPN-PROPN,PROPN-PROPN,compound-ROOT,compound-oprd,NNP-NNP,NNP-NNP,-1,1
5695,15042.0,30,manager,2,15,18,3,14,11,-13,16,RIA-Novosti,Zhidakov,ORGANIZATION,PERSON,NOUN,PROPN,compound,nsubj,NN,NNP,7,1
5696,15046.0,53,said,40,42,47,5,41,5,-2,7,Boxer,Senate Environment and Public Work Committee,PERSON,ORGANIZATION-ORGANIZATION-ORGANIZATION-ORGANIZATION-ORGANIZATION-ORGANIZATION,PROPN,PROPN-PROPN-CCONJ-PROPN-PROPN-PROPN,nsubj,compound-dobj-cc-compound-compound-conj,NNP,NNP-NNP-CC-NNP-NNP-NNP,3,1
5697,15048.0,43,trapped,15,18,17,-1,17,25,-3,2,Dewey,Professor,PERSON,TITLE,PROPN,PROPN,dobj,compound,NNP,NNP,2,1
5698,15056.0,33,sentenced,4,3,20,17,2,12,1,16,al-Khawinay,defaming the president,PERSON,CRIMINAL_CHARGE-CRIMINAL_CHARGE-CRIMINAL_CHARGE,PRON,VERB-DET-NOUN,nsubjpass,conj-det-dobj,PRP,VBG-DT-NN,5,1
5699,15063.0,26,called,10,7,1,-6,6,24,3,-9,Red Cross board,Bonnie McElveen-Hunter,ORGANIZATION-ORGANIZATION-ORGANIZATION,PERSON-PERSON,PROPN-PROPN-NOUN,PROPN-NOUN,compound-compound-pobj,compound-nsubj,NNP-NNP-NN,NNP-NN,5,1
5700,15072.0,23,used,11,1,6,5,0,16,10,-5,George Young,New York Giants,PERSON-PERSON,ORGANIZATION-ORGANIZATION-ORGANIZATION,PROPN-PROPN,PROPN-PROPN-PROPN,compound-nsubj,compound-nmod-nmod,NNP-NNP,NNP-NNP-NNP,3,1
5701,15078.0,45,said,17,13,8,-5,12,36,4,-9,Ghent University,department of paediatric dentistry,ORGANIZATION-ORGANIZATION,ORGANIZATION-ORGANIZATION-ORGANIZATION-ORGANIZATION,PROPN-PROPN,NOUN-ADP-ADJ-NOUN,compound-appos,pobj-prep-amod-pobj,NNP-NNP,NN-IN-JJ-NN,4,1
5702,15087.0,40,accompanied,2,9,8,-1,8,31,-7,6,Ali Akbar Salehi,minister,PERSON-PERSON-PERSON,TITLE,PROPN-PROPN-PROPN,NOUN,compound-compound-appos,pobj,NNP-NNP-NNP,NN,2,1
5703,32999.0,40,be,2,14,13,-1,13,26,-12,11,Ali Akbar Salehi,minister,PERSON-PERSON-PERSON,TITLE,PROPN-PROPN-PROPN,NOUN,compound-compound-appos,pobj,NNP-NNP-NNP,NN,2,1
5704,57475.0,39,is,12,9,7,-2,8,31,3,-5,Ali Akbar Salehi,minister,PERSON-PERSON-PERSON,TITLE,PROPN-PROPN-PROPN,NOUN,compound-compound-appos,pobj,NNP-NNP-NNP,NN,3,1
5705,15092.0,20,was,1,12,17,5,11,2,-11,16,Focus On The Family,Values Voters Summit,ORGANIZATION-ORGANIZATION-ORGANIZATION-ORGANIZATION,ORGANIZATION-ORGANIZATION-ORGANIZATION,PROPN-ADP-DET-PROPN,PROPN-PROPN-PROPN,pobj-ROOT-det-poss,compound-compound-pobj,NNP-IN-DT-NNP,NNP-NNP-NNP,2,1
5706,15097.0,33,visited,12,10,1,-9,9,31,2,-11,Raul Castro,Lina Ruz,PERSON-PERSON,PERSON-PERSON,PROPN-PROPN,PROPN-PROPN,compound-conj,compound-nsubj,NNP-NNP,NNP-NNP,4,1
5707,30929.0,32,visited,12,10,1,-9,9,30,2,-11,Raul Castro,Lina Ruz,PERSON-PERSON,PERSON-PERSON,PROPN-PROPN,PROPN-PROPN,compound-conj,compound-nsubj,NNP-NNP,NNP-NNP,4,1
5708,15114.0,32,composed,4,13,17,4,12,14,-9,13,Sports Affairs Council,SAC,ORGANIZATION-ORGANIZATION-ORGANIZATION,ORGANIZATION,PROPN-PROPN-PROPN,PROPN,compound-compound-appos,compound,NNPS-NNPS-NNP,NNP,6,1
5709,21152.0,43,launched,4,11,15,4,10,27,-7,11,Sports Affairs Council,SAC,ORGANIZATION-ORGANIZATION-ORGANIZATION,ORGANIZATION,PROPN-PROPN-PROPN,PROPN,compound-compound-dobj,compound,NNPS-NNPS-NNP,NNP,5,1
5710,51535.0,33,announced,3,8,12,4,7,20,-5,9,Sports Affairs Council,SAC,ORGANIZATION-ORGANIZATION-ORGANIZATION,ORGANIZATION,PROPN-PROPN-PROPN,PROPN,compound-compound-nsubjpass,compound,NNPS-NNPS-NNP,NNP,2,1
5711,15115.0,54,says,34,10,16,6,9,37,24,-18,Zagat,Nina,ORGANIZATION,PERSON,PROPN,PROPN,nsubj,appos,NNP,NNP,3,1
5712,15120.0,36,gave,6,6,23,17,5,12,0,17,Hussein Kamel,his,PERSON-PERSON,PERSON,PROPN-PROPN,DET,compound-conj,poss,NNP-NNP,PRP$,3,1
5713,15123.0,41,declined,9,31,33,2,30,7,-22,24,Alcatel,Mike Quigley,ORGANIZATION,PERSON-PERSON,PROPN,PROPN-PROPN,compound,compound-nsubjpass,NNP,NNP-NNP,1,1
5714,61771.0,45,PARIS,0,35,37,2,34,7,-35,37,Alcatel,Mike Quigley,ORGANIZATION,PERSON-PERSON,PROPN,PROPN-PROPN,compound,compound-nsubjpass,NNP,NNP-NNP,2,1
5715,15128.0,21,died,1,1,4,3,0,16,0,3,Peterson,kidney failure,PERSON,CAUSE_OF_DEATH-CAUSE_OF_DEATH,PROPN,NOUN-NOUN,nsubj,compound-pobj,NNP,NN-NN,2,1
5716,55787.0,8,died,1,1,4,3,0,3,0,3,Peterson,kidney failure,PERSON,CAUSE_OF_DEATH-CAUSE_OF_DEATH,PROPN,NOUN-NOUN,nsubj,compound-pobj,NNP,NN-NN,2,1
5717,66729.0,21,died,1,1,4,3,0,16,0,3,Peterson,kidney failure,PERSON,CAUSE_OF_DEATH-CAUSE_OF_DEATH,PROPN,NOUN-NOUN,nsubj,compound-pobj,NNP,NN-NN,2,1
5718,15129.0,33,is,3,2,8,6,1,24,1,5,Barnes Foundation,more than 80 years ago,ORGANIZATION-ORGANIZATION,DATE-DATE-DATE-DATE-DATE,PROPN-PROPN,ADJ-ADP-NUM-NOUN-ADV,compound-nsubj,amod-quantmod-nummod-npadvmod-advmod,NNP-NNP,JJR-IN-CD-NNS-RB,7,1
5719,15145.0,35,said,1,12,15,3,11,19,-11,14,Lashkar-e-Taiba,Pakistan-based,ORGANIZATION,MISC,PROPN,ADJ,pobj,amod,NNP,JJ,2,1
5720,36324.0,34,blamed,1,8,7,-1,7,26,-7,6,Lashkar-e-Taiba,Pakistan-based,ORGANIZATION,MISC,PROPN,ADJ,nmod,amod,NNP,JJ,1,1
5721,64910.0,46,said,12,28,27,-1,27,18,-16,15,Lashkar-e-Taiba,Pakistan-based,ORGANIZATION,MISC,PROPN,ADJ,compound,amod,NNP,JJ,3,1
5722,15147.0,50,reported,47,8,35,27,7,14,39,-12,Oscar Peterson,Canada,PERSON-PERSON,NATIONALITY,PROPN-PROPN,PROPN,compound-nsubj,poss,NNP-NNP,NNP,9,1
5723,15151.0,17,considered,9,2,5,3,1,11,7,-4,he,Mexican,PERSON,NATIONALITY,PRON,ADJ,nsubj,amod,PRP,JJ,1,1
5724,27189.0,34,received,7,22,26,4,21,7,-15,19,he,Mexican,PERSON,NATIONALITY,PRON,ADJ,nsubj,amod,PRP,JJ,1,1
5725,28935.0,34,received,7,22,26,4,21,7,-15,19,he,Mexican,PERSON,NATIONALITY,PRON,ADJ,nsubj,amod,PRP,JJ,1,1
5726,44778.0,17,considered,9,2,5,3,1,11,7,-4,he,Mexican,PERSON,NATIONALITY,PRON,ADJ,nsubj,amod,PRP,JJ,1,1
5727,56949.0,17,considered,9,2,5,3,1,11,7,-4,he,Mexican,PERSON,NATIONALITY,PRON,ADJ,nsubj,amod,PRP,JJ,1,1
5728,15155.0,40,died,37,1,12,11,0,27,36,-25,Philip M Kaiser,Hungary,PERSON-PERSON-PERSON,COUNTRY,PROPN-PROPN-PROPN,PROPN,compound-compound-nsubj,conj,NNP-NNP-NNP,NNP,6,1
5729,15158.0,19,discovered,2,15,17,2,14,1,-13,15,KGB,Yury Andropov,ORGANIZATION,PERSON-PERSON,PROPN,PROPN-PROPN,compound,compound-pobj,NNP,NNP-NNP,1,1
5730,26187.0,37,In,0,30,25,-5,29,11,-30,25,KGB,Yury Andropov,ORGANIZATION,PERSON-PERSON,PROPN,PROPN-PROPN,compound,compound-conj,NNP,NNP-NNP,2,1
5731,15160.0,41,said,4,17,13,-4,16,27,-13,9,Golden Baseball League,Chico,ORGANIZATION-ORGANIZATION-ORGANIZATION,ORGANIZATION,PROPN-PROPN-PROPN,PROPN,compound-compound-pobj,compound,NNP-NNP-NNP,NNP,2,1
5732,15167.0,35,survived,2,1,27,26,0,7,1,25,Derounian,Eleanor Derounian,PERSON,PERSON-PERSON,PROPN,PROPN-PROPN,nsubjpass,compound-conj,NNP,NNP-NNP,5,1
5733,64314.0,35,survived,2,1,27,26,0,7,1,25,Derounian,Eleanor Derounian,PERSON,PERSON-PERSON,PROPN,PROPN-PROPN,nsubjpass,compound-conj,NNP,NNP-NNP,8,1
5734,15169.0,36,sighed,9,11,23,12,10,12,-2,14,Abdul Jalil Jan,Peshawar,PERSON-PERSON-PERSON,CITY,PROPN-PROPN-PROPN,PROPN,compound-compound-nsubj,dobj,NNP-NNP-NNP,NNP,4,1
5735,15170.0,10,Beef,1,8,1,-7,7,8,-7,0,National Beef,Premium Beef,ORGANIZATION-ORGANIZATION,PERSON-PERSON,PROPN-PROPN,PROPN-PROPN,compound-pobj,compound-ROOT,NNP-NNP,NNP-NNP,3,1
5736,15177.0,19,declined,10,1,6,5,0,12,9,-4,Highland Capital,Lexington,ORGANIZATION-ORGANIZATION,CITY,PROPN-PROPN,PROPN,compound-nsubj,pobj,NNP-NNP,NNP,1,1
5737,15180.0,28,said,12,14,18,4,13,9,-2,6,Sean Ross,vice president,PERSON-PERSON,TITLE-TITLE,PROPN-PROPN,NOUN-NOUN,compound-nsubj,compound-appos,NNP-NNP,NN-NN,1,1
5738,23425.0,31,said,16,18,21,3,17,9,-2,5,Sean Ross,vice president,PERSON-PERSON,TITLE-TITLE,PROPN-PROPN,NOUN-NOUN,compound-nsubj,compound-appos,NNP-NNP,NN-NN,3,1
5739,39773.0,37,said,16,18,21,3,17,15,-2,5,Sean Ross,vice president,PERSON-PERSON,TITLE-TITLE,PROPN-PROPN,NOUN-NOUN,compound-nsubj,compound-appos,NNP-NNP,NN-NN,3,1
5740,45629.0,27,said,15,2,5,3,1,21,13,-10,Sean Ross,vice president,PERSON-PERSON,TITLE-TITLE,PROPN-PROPN,NOUN-NOUN,compound-nsubj,compound-appos,NNP-NNP,NN-NN,1,1
5741,60201.0,46,says,31,33,36,3,32,9,-2,5,Sean Ross,vice president,PERSON-PERSON,TITLE-TITLE,PROPN-PROPN,NOUN-NOUN,compound-nsubj,compound-appos,NNP-NNP,NN-NN,1,1
5742,15197.0,65,thrown,10,17,62,45,16,2,-7,52,she,New York,PERSON,STATE_OR_PROVINCE-STATE_OR_PROVINCE,PRON,PROPN-PROPN,nsubj,compound-pobj,PRP,NNP-NNP,9,1
5743,34415.0,59,launched,16,23,13,-10,22,45,-7,-3,she,New York,PERSON,STATE_OR_PROVINCE-STATE_OR_PROVINCE,PRON,PROPN-PROPN,nsubj,compound-pobj,PRP,NNP-NNP,7,1
5744,15211.0,41,said,6,8,5,-3,7,35,-2,-1,he,spokesman,PERSON,TITLE,PRON,NOUN,nsubj,appos,PRP,NN,2,1
5745,22346.0,41,said,6,8,5,-3,7,35,-2,-1,he,spokesman,PERSON,TITLE,PRON,NOUN,nsubj,appos,PRP,NN,2,1
5746,15224.0,55,summary,3,16,24,8,15,30,-13,21,Gholam Ali Haddad Adel,Iran,PERSON-PERSON-PERSON-PERSON,ORGANIZATION,PROPN-PROPN-PROPN-PROPN,PROPN,compound-compound-compound-nsubj,nsubj,NNP-NNP-NNP-NNP,NNP,4,1
5747,15226.0,34,include,12,10,17,7,9,16,2,5,Ahearn,Jewell Eskew,PERSON,PERSON-PERSON,PROPN,PROPN-PROPN,poss,compound-appos,NNP,NNP-NNP,5,1
5748,64604.0,34,include,12,10,17,7,9,16,2,5,Ahearn,Jewell Eskew,PERSON,PERSON-PERSON,PROPN,PROPN-PROPN,poss,compound-appos,NNP,NNP-NNP,5,1
5749,15227.0,50,love,25,12,12,0,11,37,13,-13,Alice Dellal,Alice,PERSON-PERSON,PERSON,PROPN-PROPN,PROPN,compound-pobj,pobj,NNP-NNP,NNP,0,1
5750,15236.0,24,scheduled,6,19,22,3,18,1,-13,16,FAW Group,Zhu Yanfeng,ORGANIZATION-ORGANIZATION,PERSON-PERSON,PROPN-PROPN,PROPN-PROPN,compound-pobj,compound-appos,NNP-NNP,NNP-NNP,1,1
5751,15240.0,23,said,18,1,10,9,0,12,17,-8,Haifa University,Carmel,ORGANIZATION-ORGANIZATION,CITY,PROPN-PROPN,PROPN,compound-nsubjpass,compound,NNP-NNP,NNP,6,1
5752,44872.0,31,evacuated,15,7,28,21,6,2,8,13,Haifa University,Carmel,ORGANIZATION-ORGANIZATION,CITY,PROPN-PROPN,PROPN,compound-pobj,compound,NNP-NNP,NNP,11,1
5753,15244.0,30,promoted,10,7,20,13,6,9,3,10,Chen Zhu,Ministry of Health,PERSON-PERSON,ORGANIZATION-ORGANIZATION-ORGANIZATION,PROPN-PROPN,PROPN-ADP-PROPN,compound-conj,conj-prep-pobj,NNP-NNP,NNP-IN-NNP,7,1
5754,15261.0,36,plays,1,21,17,-4,20,18,-20,16,American Basketball Association,Maryland Nighthawks,ORGANIZATION-ORGANIZATION-ORGANIZATION,ORGANIZATION-ORGANIZATION,PROPN-PROPN-PROPN,PROPN-PROPN,compound-compound-pobj,compound-pobj,NNP-NNP-NNP,NNP-NNP,3,1
5755,61537.0,18,completed,4,15,11,-4,14,6,-11,7,American Basketball Association,Maryland Nighthawks,ORGANIZATION-ORGANIZATION-ORGANIZATION,ORGANIZATION-ORGANIZATION,PROPN-PROPN-PROPN,PROPN-PROPN,compound-compound-pobj,compound-pobj,NNP-NNP-NNP,NNP-NNP,3,1
5756,15282.0,21,*,0,6,11,5,5,9,-6,11,Ateneo Alumni Association,AAA,ORGANIZATION-ORGANIZATION-ORGANIZATION,ORGANIZATION,PROPN-PROPN-PROPN,PROPN,compound-compound-pobj,nsubj,NNPS-NNPS-NNP,NNP,-1,1
5757,15284.0,7,urges,1,1,3,2,0,3,0,2,OIC,Switzerland,ORGANIZATION,COUNTRY,PROPN,PROPN,nsubj,dobj,NNP,NNP,2,1
5758,15290.0,62,Dies,9,1,23,22,0,38,8,14,Roy Scheider,Christian Verrier Scheider,PERSON-PERSON,PERSON-PERSON-PERSON,PROPN-PROPN,PROPN-PROPN-PROPN,compound-nsubj,compound-compound-conj,NNP-NNP,NNP-NNP-NNP,5,1
5759,15293.0,23,say,3,1,14,13,0,8,2,11,He,Juanita Jackson Mitchell,PERSON,PERSON-PERSON-PERSON,PRON,PROPN-PROPN-PROPN,nsubj,compound-compound-appos,PRP,NNP-NNP-NNP,5,1
5760,15310.0,19,said,17,14,16,2,13,2,3,-1,his,Bradley Mascho,PERSON,PERSON-PERSON,DET,PROPN-PROPN,poss,compound-appos,PRP$,NNP-NNP,1,1
5761,15313.0,18,is,2,1,5,4,0,12,1,3,Frankie Delgado,American,PERSON-PERSON,NATIONALITY,PROPN-PROPN,ADJ,compound-nsubj,amod,NNP-NNP,JJ,3,1
5762,55852.0,21,2009-10-07T09,0,4,8,4,3,12,-4,8,Frankie Delgado,American,PERSON-PERSON,NATIONALITY,PROPN-PROPN,ADJ,compound-nsubj,amod,NNP-NNP,JJ,4,1
5763,15321.0,23,said,9,1,5,4,0,17,8,-4,Chris Bentley,U.S. Citizenship and Immigration Services,PERSON-PERSON,ORGANIZATION-ORGANIZATION-ORGANIZATION-ORGANIZATION-ORGANIZATION,PROPN-PROPN,PROPN-PROPN-CCONJ-PROPN-PROPN,compound-nsubj,nmod-nmod-cc-conj-pobj,NNP-NNP,NNP-NNP-CC-NNP-NNPS,3,1
5764,37035.0,29,said,16,18,24,6,17,4,-2,8,Chris Bentley,U.S. Citizenship and Immigration Services,PERSON-PERSON,ORGANIZATION-ORGANIZATION-ORGANIZATION-ORGANIZATION-ORGANIZATION,PROPN-PROPN,PROPN-PROPN-CCONJ-PROPN-PROPN,compound-nsubj,nmod-nmod-cc-conj-pobj,NNP-NNP,NNP-NNP-CC-NNP-NNPS,3,1
5765,48366.0,22,declined,12,11,5,-6,10,16,1,-7,Chris Bentley,U.S. Citizenship and Immigration Services,PERSON-PERSON,ORGANIZATION-ORGANIZATION-ORGANIZATION-ORGANIZATION-ORGANIZATION,PROPN-PROPN,PROPN-PROPN-CCONJ-PROPN-PROPN,compound-nsubj,nmod-nmod-cc-compound-conj,NNP-NNP,NNP-NNP-CC-NNP-NNPS,3,1
5766,50959.0,27,said,9,11,17,6,10,9,-2,8,Chris Bentley,U.S. Citizenship and Immigration Services,PERSON-PERSON,ORGANIZATION-ORGANIZATION-ORGANIZATION-ORGANIZATION-ORGANIZATION,PROPN-PROPN,PROPN-PROPN-CCONJ-PROPN-PROPN,compound-nsubj,nmod-nmod-cc-conj-pobj,NNP-NNP,NNP-NNP-CC-NNP-NNPS,5,1
5767,15324.0,57,said,52,46,43,-3,45,13,6,-9,MBIA,Jay Brown,ORGANIZATION,PERSON-PERSON,PROPN,PROPN-PROPN,poss,compound-nsubj,NNP,NNP-NNP,3,1
5768,59630.0,34,said,12,4,1,-3,3,32,8,-11,MBIA,Jay Brown,ORGANIZATION,PERSON-PERSON,PROPN,PROPN-PROPN,poss,compound-nsubj,NNP,NNP-NNP,3,1
5769,15332.0,32,set,13,7,24,17,6,7,6,11,Kerry,he,PERSON,PERSON,PROPN,PRON,poss,nsubj,NNP,PRP,5,1
5770,15334.0,8,said,0,3,7,4,2,0,-3,7,Christopher J. Dodd,D-Conn,PERSON-PERSON-PERSON,LOCATION,PROPN-PROPN-PROPN,INTJ,compound-compound-nsubj,punct,NNP-NNP-NNP,UH,2,1
5771,15336.0,30,sought,12,1,9,8,0,20,11,-3,Chavez,Adan Chavez,PERSON,PERSON-PERSON,PROPN,PROPN-PROPN,nsubj,compound-appos,NNP,NNP-NNP,4,1
5772,15347.0,27,served,7,7,13,6,6,13,0,6,Verity,US Chamber of Commerce,PERSON,ORGANIZATION-ORGANIZATION-ORGANIZATION-ORGANIZATION,PROPN,PROPN-PROPN-ADP-PROPN,nsubj,compound-pobj-prep-pobj,NNP,NNP-NNP-IN-NNP,4,1
5773,15355.0,42,promoting,7,34,5,-29,33,36,-27,-2,USA Networks,NBC Universal,ORGANIZATION-ORGANIZATION,ORGANIZATION-ORGANIZATION,PROPN-PROPN,PROPN-PROPN,compound-conj,compound-nsubj,NNP-NNP,NNP-NNP,9,1
5774,15356.0,40,pay,16,7,36,29,6,3,9,20,Johnny Knoxville,negligence,PERSON-PERSON,CRIMINAL_CHARGE,PROPN-PROPN,NOUN,compound-nsubj,conj,NNP-NNP,NN,6,1
5775,15359.0,40,SHENG-CHENG,1,8,14,6,7,25,-7,13,Hu Sheng-cheng,Council for Economic Planning and Development,PERSON-PERSON,ORGANIZATION-ORGANIZATION-ORGANIZATION-ORGANIZATION-ORGANIZATION-ORGANIZATION,PROPN-PROPN,PROPN-ADP-PROPN-PROPN-CCONJ-PROPN,compound-nsubj,pobj-prep-compound-pobj-cc-conj,NNP-NNP,NNP-IN-NNP-NNP-CC-NNP,2,1
5776,51474.0,68,said,24,9,15,6,8,52,15,-9,Hu Sheng-cheng,Council for Economic Planning and Development,PERSON-PERSON,ORGANIZATION-ORGANIZATION-ORGANIZATION-ORGANIZATION-ORGANIZATION-ORGANIZATION,PROPN-PROPN,PROPN-ADP-PROPN-PROPN-CCONJ-PROPN,compound-nsubj,pobj-prep-compound-pobj-cc-conj,NNP-NNP,NNP-IN-NNP-NNP-CC-NNP,5,1
5777,15367.0,65,Ranke,2,42,14,-28,41,50,-40,12,George Roy Hill,U.S.,PERSON-PERSON-PERSON,COUNTRY,PROPN-PROPN-PROPN,PROPN,compound-compound-conj,compound,NNP-NNP-NNP,NNP,4,1
5778,15368.0,19,working,7,4,16,12,3,2,3,9,Palermo,Elle,PERSON,ORGANIZATION,PROPN,PROPN,nsubj,poss,NNP,NNP,7,1
5779,38471.0,35,filmed,15,1,33,32,0,1,14,18,Palermo,Elle,PERSON,ORGANIZATION,PROPN,PROPN,nsubjpass,compound,NNP,NNP,8,1
5780,15372.0,15,ran,8,2,4,2,1,10,6,-4,he,17,PERSON,NUMBER,PRON,NUM,nsubj,npadvmod,PRP,CD,1,1
5781,15386.0,25,set,10,5,21,16,4,3,5,11,Northampton / Amherst / Greenfield area,Rep Ellen Story,ORGANIZATION-ORGANIZATION-ORGANIZATION-ORGANIZATION-ORGANIZATION-ORGANIZATION,PERSON-PERSON-PERSON,PROPN-SYM-PROPN-SYM-PROPN-NOUN,PROPN-PROPN-PROPN,nmod-punct-nmod-punct-compound-pobj,compound-compound-compound,NNP-SYM-NNP-SYM-NNP-NN,NNP-NNP-NNP,8,1
5782,15391.0,18,google_ad_section_start,0,13,10,-3,12,7,-13,10,Molly Malaney,Jason Mesnick,PERSON-PERSON,PERSON-PERSON,PROPN-PROPN,PROPN-PROPN,compound-conj,compound-nsubjpass,NNP-NNP,NNP-NNP,1,1
5783,26889.0,24,said,14,12,9,-3,11,14,2,-5,Molly Malaney,Jason Mesnick,PERSON-PERSON,PERSON-PERSON,PROPN-PROPN,PROPN-PROPN,compound-conj,compound-nsubj,NNP-NNP,NNP-NNP,1,1
5784,15400.0,23,said,11,20,13,-7,19,9,-9,2,American Bankers Association,Edward L Yingling,ORGANIZATION-ORGANIZATION-ORGANIZATION,PERSON-PERSON-PERSON,PROPN-PROPN-PROPN,PROPN-PROPN-PROPN,compound-compound-pobj,compound-compound-nsubj,NNP-NNPS-NNP,NNP-NNP-NNP,5,1
5785,17046.0,34,said,18,8,1,-7,7,32,10,-17,American Bankers Association,Edward L Yingling,ORGANIZATION-ORGANIZATION-ORGANIZATION,PERSON-PERSON-PERSON,PROPN-PROPN-PROPN,PROPN-PROPN-PROPN,compound-compound-pobj,compound-compound-nsubj,NNP-NNPS-NNP,NNP-NNP-NNP,5,1
5786,21143.0,58,said,48,45,37,-8,44,20,3,-11,American Bankers Association,Edward L Yingling,ORGANIZATION-ORGANIZATION-ORGANIZATION,PERSON-PERSON-PERSON,PROPN-PROPN-PROPN,PROPN-PROPN-PROPN,compound-compound-pobj,compound-compound-nsubj,NNP-NNPS-NNP,NNP-NNP-NNP,4,1
5787,38120.0,34,said,19,31,21,-10,30,12,-12,2,American Bankers Association,Edward L Yingling,ORGANIZATION-ORGANIZATION-ORGANIZATION,PERSON-PERSON-PERSON,PROPN-PROPN-PROPN,PROPN-PROPN-PROPN,compound-compound-pobj,compound-compound-nsubj,NNP-NNPS-NNP,NNP-NNP-NNP,5,1
5788,15407.0,73,survived,9,2,6,4,1,66,7,-3,his,Minneapolis,PERSON,CITY,DET,PROPN,poss,pobj,PRP$,NNP,3,1
5789,15411.0,37,stormed,1,24,22,-2,23,14,-23,21,Dee Dee Myers,Clinton aide,PERSON-PERSON-PERSON,TITLE-TITLE,PROPN-PROPN-PROPN,PROPN-NOUN,compound-compound-compound,compound-conj,NNP-NNP-NNP,NNP-NN,1,1
5790,15413.0,35,moved,24,5,28,23,4,6,19,4,Herrera,Glendale,PERSON,CITY,PROPN,PROPN,nsubj,pobj,NNP,NNP,2,1
5791,20085.0,22,said,14,1,11,10,0,10,13,-3,Herrera,Glendale,PERSON,CITY,NOUN,PROPN,nsubj,pobj,NN,NNP,3,1
5792,40732.0,22,said,14,1,11,10,0,10,13,-3,Herrera,Glendale,PERSON,CITY,NOUN,PROPN,nsubj,pobj,NN,NNP,3,1
5793,15416.0,59,said,22,28,24,-4,27,34,-6,2,Jamaat al Muslimeen,Yasin Abu Bakr,ORGANIZATION-ORGANIZATION-ORGANIZATION,PERSON-PERSON-PERSON,PROPN-PROPN-PROPN,PROPN-PROPN-PROPN,compound-compound-poss,compound-compound-nsubj,NNP-NNP-NNP,NNP-NNP-NNP,-1,1
5794,25529.0,49,told,11,8,1,-7,7,47,3,-10,Jamaat al Muslimeen,Yasin Abu Bakr,ORGANIZATION-ORGANIZATION-ORGANIZATION,PERSON-PERSON-PERSON,PROPN-PROPN-PROPN,PROPN-PROPN-PROPN,compound-compound-pobj,compound-compound-nsubj,NNP-NNP-NNP,NNP-NNP-NNP,5,1
5795,15419.0,29,has,11,8,10,2,7,18,3,-1,Black,66,PERSON,NUMBER,PROPN,NUM,nsubj,appos,NNP,CD,3,1
5796,27645.0,18,holds,4,1,3,2,0,14,3,-1,Black,66,PERSON,NUMBER,PROPN,NUM,nsubj,appos,NNP,CD,4,1
5797,53796.0,40,KLEIN,0,19,21,2,18,18,-19,21,Black,66,PERSON,NUMBER,PROPN,NUM,nsubj,appos,NNP,CD,3,1
5798,15425.0,45,doing,41,14,18,4,13,26,27,-23,Photographic Resource Center,Boston University,ORGANIZATION-ORGANIZATION-ORGANIZATION,ORGANIZATION-ORGANIZATION,PROPN-PROPN-PROPN,PROPN-PROPN,compound-compound-pobj,compound-pobj,NNP-NNP-NNP,NNP-NNP,1,1
5799,18700.0,40,is,1,17,21,4,16,18,-16,20,Photographic Resource Center,Boston University,ORGANIZATION-ORGANIZATION-ORGANIZATION,ORGANIZATION-ORGANIZATION,PROPN-PROPN-PROPN,PROPN-PROPN,compound-compound-pobj,compound-pobj,NNP-NNP-NNP,NNP-NNP,5,1
5800,45434.0,31,reminds,18,9,13,4,8,17,9,-5,Photographic Resource Center,Boston University,ORGANIZATION-ORGANIZATION-ORGANIZATION,ORGANIZATION-ORGANIZATION,PROPN-PROPN-PROPN,PROPN-PROPN,compound-compound-pobj,compound-pobj,NNP-NNP-NNP,NNP-NNP,3,1
5801,15432.0,44,told,20,17,19,2,16,24,3,-1,UNITA,Isaias Samakuva,ORGANIZATION,PERSON-PERSON,ADJ,PROPN-PROPN,compound,compound-appos,JJ,NNP-NNP,3,1
5802,28564.0,29,retained,6,5,8,3,4,20,1,2,UNITA,Isaias Samakuva,ORGANIZATION,PERSON-PERSON,PROPN,PROPN-PROPN,nsubj,compound-dobj,NNP,NNP-NNP,2,1
5803,41904.0,35,pledged,14,11,13,2,10,21,3,-1,UNITA,Isaias Samakuva,ORGANIZATION,PERSON-PERSON,PROPN,PROPN-PROPN,compound,compound-nsubj,NNP,NNP-NNP,1,1
5804,47951.0,65,LUANDA,0,14,8,-6,13,56,-14,8,UNITA,Isaias Samakuva,ORGANIZATION,PERSON-PERSON,PROPN,PROPN-PROPN,pobj,compound-nsubj,NNP,NNP-NNP,2,1
5805,55782.0,78,told,31,29,23,-6,28,54,2,-8,UNITA,Isaias Samakuva,ORGANIZATION,PERSON-PERSON,PROPN,PROPN-PROPN,pobj,compound-pobj,NNP,NNP-NNP,5,1
5806,60382.0,20,announced,4,1,3,2,0,16,3,-1,UNITA,Isaias Samakuva,ORGANIZATION,PERSON-PERSON,ADJ,PROPN-PROPN,compound,compound-nsubj,JJ,NNP-NNP,1,1
5807,15437.0,14,survived,2,1,7,6,0,6,1,5,Kollek,Tamar,PERSON,PERSON,PROPN,PROPN,nsubjpass,appos,NNP,NNP,5,1
5808,51475.0,23,survived,2,1,8,7,0,14,1,6,Kollek,Tamar,PERSON,PERSON,PROPN,PROPN,nsubjpass,appos,NNP,NNP,5,1
5809,55821.0,20,survived,2,1,8,7,0,11,1,6,Kollek,Tamar,PERSON,PERSON,PROPN,PROPN,nsubjpass,appos,NNP,NNP,5,1
5810,15449.0,33,said,31,30,27,-3,29,5,1,-4,Chris Bentley,Homeland Security,PERSON-PERSON,ORGANIZATION-ORGANIZATION,PROPN-PROPN,PROPN-PROPN,compound-nsubj,compound-compound,NNP-NNP,NNP-NNP,4,1
5811,23213.0,23,said,16,21,18,-3,20,4,-5,2,Chris Bentley,Homeland Security,PERSON-PERSON,ORGANIZATION-ORGANIZATION,PROPN-PROPN,PROPN-PROPN,compound-nsubj,compound-compound,NNP-NNP,NNP-NNP,2,1
5812,15451.0,26,said,16,15,18,3,14,7,1,2,convocation,Kelly Oliver,ORGANIZATION,PERSON-PERSON,NOUN,PROPN-PROPN,pobj,compound-nsubj,NN,NNP-NNP,2,1
5813,15459.0,34,2009-10-02T11,0,11,21,10,10,12,-11,21,her,Hills,PERSON,ORGANIZATION,DET,PROPN,poss,compound,PRP$,NNP,2,1
5814,15462.0,48,PissingOffTheL@yahoocom,4,11,15,4,10,32,-7,11,John Kerry,Democratic Party,PERSON-PERSON,ORGANIZATION-ORGANIZATION,PROPN-PROPN,PROPN-PROPN,compound-nsubj,compound-poss,NNP-NNP,NNP-NNP,4,1
5815,15472.0,19,disputed,2,17,1,-16,16,17,-15,-1,his,DNI,PERSON,ORGANIZATION,DET,PROPN,poss,compound,PRP$,NNP,6,1
5816,15482.0,76,add,17,61,69,8,60,6,-44,52,Badr Organisation,Supreme Islamic Iraqi Council,ORGANIZATION-ORGANIZATION,ORGANIZATION-ORGANIZATION-ORGANIZATION-ORGANIZATION,PROPN-PROPN,PROPN-PROPN-PROPN-PROPN,compound-pobj,compound-compound-compound-pobj,NNP-NNP,NNP-NNP-NNP-NNP,3,1
5817,15483.0,25,chosen,11,17,14,-3,16,10,-6,3,Julian Bond,NAACP Board,PERSON-PERSON,ORGANIZATION-ORGANIZATION,PROPN-PROPN,PROPN-PROPN,compound-pobj,compound-compound,NNP-NNP,NNP-NNP,2,1
5818,15487.0,17,relates,3,2,1,-1,1,15,1,-2,James Stewart,Author/journalist,PERSON-PERSON,TITLE,PROPN-PROPN,DET,compound-nsubj,compound,NNP-NNP,DT,1,1
5819,15488.0,63,said,25,19,1,-18,18,61,6,-24,Crown Prosecution Service,Ken Macdonald,ORGANIZATION-ORGANIZATION-ORGANIZATION,PERSON-PERSON,PROPN-PROPN-PROPN,PROPN-PROPN,compound-compound-compound,compound-nsubj,NNP-NNP-NNP,NNP-NNP,5,1
5820,24210.0,43,said,38,33,37,4,32,5,5,-1,Crown Prosecution Service,Ken Macdonald,ORGANIZATION-ORGANIZATION-ORGANIZATION,PERSON-PERSON,PROPN-PROPN-PROPN,PROPN-PROPN,compound-compound-compound,compound-nsubj,NNP-NNP-NNP,NNP-NNP,4,1
5821,15499.0,10,was,1,1,3,2,0,6,0,2,He,deputy prime minister,PERSON,TITLE-TITLE-TITLE,PRON,ADJ-ADJ-NOUN,nsubj,amod-amod-attr,PRP,JJ-JJ-NN,2,1
5822,15500.0,52,said,32,41,34,-7,40,17,-9,2,Servicemembers Legal Defense Network,Steve Ralls,ORGANIZATION-ORGANIZATION-ORGANIZATION-ORGANIZATION,PERSON-PERSON,PROPN-PROPN-PROPN-PROPN,PROPN-PROPN,compound-compound-compound-pobj,compound-nsubj,NNP-NNP-NNP-NNP,NNP-NNP,5,1
5823,52628.0,67,said,45,53,47,-6,52,19,-8,2,Servicemembers Legal Defense Network,Steve Ralls,ORGANIZATION-ORGANIZATION-ORGANIZATION-ORGANIZATION,PERSON-PERSON,PROPN-PROPN-PROPN-PROPN,PROPN-PROPN,compound-compound-compound-pobj,compound-nsubj,NNP-NNP-NNP-NNP,NNP-NNP,5,1
5824,66222.0,59,said,37,8,1,-7,7,57,29,-36,Servicemembers Legal Defense Network,Steve Ralls,ORGANIZATION-ORGANIZATION-ORGANIZATION-ORGANIZATION,PERSON-PERSON,PROPN-PROPN-PROPN-PROPN,PROPN-PROPN,compound-compound-compound-pobj,compound-nsubj,NNP-NNP-NNP-NNP,NNP-NNP,5,1
5825,15520.0,25,was,5,5,10,5,4,14,0,5,Nolte,Institute of Current World Affairs,PERSON,ORGANIZATION-ORGANIZATION-ORGANIZATION-ORGANIZATION-ORGANIZATION,PROPN,PROPN-ADP-PROPN-PROPN-PROPN,nsubj,pobj-prep-compound-compound-pobj,NNP,NNP-IN-NNP-NNP-NNPS,4,1
5826,15530.0,39,paired,10,8,7,-1,7,31,2,-3,Brad Washburn,founder,PERSON-PERSON,TITLE,PROPN-PROPN,NOUN,compound-pobj,compound,NNP-NNP,NN,1,1
5827,15535.0,60,said,14,8,31,23,7,28,6,17,Northland Church,Christian,ORGANIZATION-ORGANIZATION,RELIGION,PROPN-PROPN,PROPN,compound-pobj,compound,NNP-NNP,NNP,10,1
5828,15540.0,34,born,4,1,23,22,0,10,3,19,Philip Mayer Kaiser,Moishe Bear,PERSON-PERSON-PERSON,PERSON-PERSON,PROPN-PROPN-PROPN,PROPN-PROPN,compound-compound-nsubjpass,compound-pobj,NNP-NNP-NNP,NNP-NNP,9,1
5829,38679.0,29,born,4,1,24,23,0,4,3,20,Philip Mayer Kaiser,Moishe Bear,PERSON-PERSON-PERSON,PERSON-PERSON,PROPN-PROPN-PROPN,PROPN-PROPN,compound-compound-nsubjpass,compound-pobj,NNP-NNP-NNP,NNP-NNP,7,1
5830,41849.0,34,born,4,1,23,22,0,10,3,19,Philip Mayer Kaiser,Moishe Bear,PERSON-PERSON-PERSON,PERSON-PERSON,PROPN-PROPN-PROPN,PROPN-PROPN,compound-compound-nsubjpass,compound-pobj,NNP-NNP-NNP,NNP-NNP,7,1
5831,15543.0,21,was,1,1,5,4,0,15,0,4,He,representative,PERSON,TITLE,PRON,NOUN,nsubj,attr,PRP,NN,2,1
5832,15550.0,24,said,15,2,17,15,1,6,13,2,Federal Election Commission,Scott Thomas,ORGANIZATION-ORGANIZATION-ORGANIZATION,PERSON-PERSON,PROPN-PROPN-PROPN,PROPN-PROPN,compound-compound-nsubj,compound-nsubj,NNP-NNP-NNP,NNP-NNP,4,1
5833,15552.0,34,is,2,8,1,-7,7,32,-6,-1,China FAW Group,FAW,ORGANIZATION-ORGANIZATION-ORGANIZATION,ORGANIZATION,PROPN-PROPN-PROPN,PROPN,compound-compound-pobj,compound,NNP-NNP-NNP,NNP,5,1
5834,15553.0,23,said,9,11,13,2,10,9,-2,4,Larijani,secretary general,PERSON,TITLE-TITLE,PROPN,NOUN-NOUN,nsubj,compound-appos,NNP,NN-NN,2,1
5835,15563.0,25,said,23,1,18,17,0,6,22,-5,Goodman,natural causes,PERSON,CAUSE_OF_DEATH-CAUSE_OF_DEATH,PROPN,ADJ-NOUN,nsubj,amod-pobj,NNP,JJ-NNS,4,1
5836,50632.0,26,said,24,2,19,17,1,6,22,-5,Goodman,natural causes,PERSON,CAUSE_OF_DEATH-CAUSE_OF_DEATH,PROPN,ADJ-NOUN,nsubj,amod-pobj,NNP,JJ-NNS,4,1
5837,15578.0,37,JAKARTA,0,28,1,-27,27,35,-28,1,Jakarta Globe,JAKARTA,ORGANIZATION-ORGANIZATION,CITY,PROPN-PROPN,PROPN,compound-nsubj,ROOT,NNP-NNP,NNP,-1,1
5838,29987.0,40,JAKARTA,0,31,1,-30,30,38,-31,1,Jakarta Globe,JAKARTA,ORGANIZATION-ORGANIZATION,CITY,PROPN-PROPN,PROPN,compound-nsubj,ROOT,NNP-NNP,NNP,-1,1
5839,46352.0,45,JAKARTA,0,39,1,-38,38,43,-39,1,Jakarta Globe,JAKARTA,ORGANIZATION-ORGANIZATION,CITY,PROPN-PROPN,NOUN,compound-nsubj,ROOT,NNP-NNP,NN,9,1
5840,15586.0,28,said,26,3,6,3,2,21,23,-20,Pascal Yoadimnadji,Chad,PERSON-PERSON,COUNTRY,PROPN-PROPN,PROPN,compound-nsubj,pobj,NNP-NNPS,NNP,1,1
5841,16954.0,91,Mourned,0,14,17,3,13,73,-14,17,Pascal Yoadimnadji,Chad,PERSON-PERSON,COUNTRY,PROPN-PROPN,PROPN,compound-compound,compound,NNP-NNPS,NNP,3,1
5842,46944.0,30,said,27,12,8,-4,11,21,15,-19,Pascal Yoadimnadji,Chad,PERSON-PERSON,COUNTRY,PROPN-PROPN,PROPN,compound-pobj,poss,NNP-NNPS,NNP,3,1
5843,65214.0,23,said,20,5,1,-4,4,21,15,-19,Pascal Yoadimnadji,Chad,PERSON-PERSON,PERSON,PROPN-PROPN,PROPN,compound-nsubj,poss,NNP-NNPS,NNP,3,1
5844,15590.0,44,said,39,1,37,36,0,6,38,-2,Abdul Karim al-Khawinay,Yemeni,PERSON-PERSON-PERSON,NATIONALITY,PROPN-PROPN-PROPN,PROPN,compound-compound-nsubjpass,compound,NNP-NNP-NNP,NNP,7,1
5845,49956.0,44,gathered,3,31,14,-17,30,29,-28,11,Abdul Karim al-Khawinay,Yemeni,PERSON-PERSON-PERSON,NATIONALITY,PROPN-PROPN-PROPN,ADJ,compound-compound-pobj,amod,NNP-NNP-NNP,JJ,12,1
5846,15592.0,51,said,38,49,40,-9,48,10,-11,2,Crisis Group,Gareth Evans,ORGANIZATION-ORGANIZATION,PERSON-PERSON,PROPN-PROPN,PROPN-PROPN,compound-pobj,compound-nsubj,NNP-NNP,NNP-NNP,5,1
5847,23784.0,42,said,9,7,1,-6,6,40,2,-8,Crisis Group,Gareth Evans,ORGANIZATION-ORGANIZATION,PERSON-PERSON,PROPN-PROPN,PROPN-PROPN,compound-dobj,compound-nsubj,NNP-NNP,NNP-NNP,2,1
5848,15593.0,24,were,7,2,22,20,1,1,5,15,Inquirer,McClatchy Co,ORGANIZATION,ORGANIZATION-ORGANIZATION,PROPN,PROPN-PROPN,nsubj,compound-pobj,NNP,NNP-NNP,8,1
5849,15595.0,29,is,4,21,3,-18,20,25,-17,-1,Julia Carson,Andre Carson,PERSON-PERSON,PERSON-PERSON,PROPN-PROPN,PROPN-PROPN,compound-appos,compound-nsubj,NNP-NNP,NNP-NNP,2,1
5850,15598.0,89,have,30,1,86,85,0,2,29,56,Cathleen P. Black,Coca-Cola,PERSON-PERSON-PERSON,ORGANIZATION,PROPN-PROPN-PROPN,PROPN,compound-compound-nsubj,pobj,NNP-NNP-NNP,NNP,-1,1
5851,59982.0,36,step,19,1,33,32,0,2,18,14,Cathleen P. Black,Coca-Cola,PERSON-PERSON-PERSON,ORGANIZATION,PROPN-PROPN-PROPN,PROPN,compound-compound-nsubj,pobj,NNP-NNP-NNP,NNP,8,1
5852,15635.0,68,-LSB-,2,37,36,-1,36,31,-35,34,Richard Lindzen,Dr,PERSON-PERSON,TITLE,PROPN-PROPN,PROPN,compound-ROOT,compound,NNP-NNP,NNP,2,1
5853,26676.0,57,-LSB-,2,37,36,-1,36,20,-35,34,Richard Lindzen,Dr,PERSON-PERSON,TITLE,PROPN-PROPN,PROPN,compound-ROOT,compound,NNP-NNP,NNP,2,1
5854,42688.0,56,-LSB-,0,35,34,-1,34,21,-35,34,Richard Lindzen,Dr,PERSON-PERSON,TITLE,PROPN-PROPN,PROPN,compound-ROOT,compound,NNP-NNP,NNP,2,1
5855,52228.0,44,makes,0,42,41,-1,41,2,-42,41,Richard Lindzen,Dr,PERSON-PERSON,TITLE,PROPN-PROPN,PROPN,compound-ROOT,compound,NNP-NNP,NNP,2,1
5856,15646.0,35,said,33,9,7,-2,8,27,24,-26,group,Florida-based,ORGANIZATION,STATE_OR_PROVINCE,NOUN,ADJ,pobj,amod,NN,JJ,3,1
5857,15654.0,49,said,1,46,45,-1,45,3,-45,44,Mohamed ElBaradei,Dr,PERSON-PERSON,TITLE,PROPN-PROPN,PROPN,compound-appos,compound,NNP-NNP,NNP,3,1
5858,15655.0,23,are,16,1,4,3,0,18,15,-12,Trista Rehn,Ryan Sutter,PERSON-PERSON,PERSON-PERSON,PROPN-PROPN,PROPN-PROPN,compound-nsubj,compound-conj,NNP-NNP,NNP-NNP,1,1
5859,15668.0,31,believes,1,6,8,2,5,22,-5,7,Lashkar-e-Taiba,LeT,ORGANIZATION,ORGANIZATION,PROPN,PROPN,compound,ROOT,NNP,NNP,2,1
5860,35652.0,33,said,11,20,25,5,19,7,-9,14,Lashkar-e-Taiba,LeT,ORGANIZATION,ORGANIZATION,PROPN,NOUN,conj,pobj,NNP,NN,4,1
5861,57300.0,37,carried,4,28,26,-2,27,10,-24,22,Lashkar-e-Taiba,LeT,ORGANIZATION,ORGANIZATION,PROPN,VERB,compound,relcl,NNP,VB,-1,1
5862,66470.0,34,told,4,8,14,6,7,19,-4,10,Lashkar-e-Taiba,LeT,ORGANIZATION,ORGANIZATION,PROPN,PROPN,nsubj,pobj,NNP,NNP,2,1
5863,15669.0,27,represented,4,17,9,-8,16,17,-13,5,his,18,PERSON,NUMBER,DET,NUM,poss,appos,PRP$,CD,5,1
5864,16959.0,27,represented,4,17,9,-8,16,17,-13,5,his,18,PERSON,NUMBER,DET,NUM,poss,appos,PRP$,CD,5,1
5865,15676.0,14,Sr.,4,2,14,12,1,-1,2,10,Jefferson J. DeBlanc,86,PERSON-PERSON-PERSON,NUMBER,PROPN-PROPN-PROPN,NUM,compound-compound-compound,appos,NNP-NNP-NNP,CD,-1,1
5866,15695.0,44,said,18,35,28,-7,34,15,-17,10,his,Alamagordo,PERSON,LOCATION,DET,PROPN,poss,pobj,PRP$,NNP,6,1
5867,15696.0,35,said,12,7,1,-6,6,33,5,-11,IAPA,Gonzalo Marroquin,ORGANIZATION,PERSON-PERSON,PROPN,PROPN-PROPN,poss,compound-nsubj,NNP,NNP-NNP,5,1
5868,45522.0,42,said,18,26,20,-6,25,21,-8,2,IAPA,Gonzalo Marroquin,ORGANIZATION,PERSON-PERSON,PROPN,PROPN-PROPN,poss,compound-nsubj,NNP,NNP-NNP,5,1
5869,15701.0,38,said,30,32,36,4,31,1,-2,6,CMA chief,Tammy Genovese,ORGANIZATION-ORGANIZATION,PERSON-PERSON,PROPN-ADJ,PROPN-PROPN,compound-compound,compound-nsubj,NNP-JJ,NNP-NNP,1,1
5870,15702.0,38,indicated,5,28,36,8,27,1,-23,31,Organization of Islamic Conference,Muslim,ORGANIZATION-ORGANIZATION-ORGANIZATION-ORGANIZATION,RELIGION,PROPN-ADP-PROPN-PROPN,ADJ,pobj-prep-compound-pobj,amod,NNP-IN-NNP-NNP,JJ,5,1
5871,15714.0,28,began,2,7,11,4,6,16,-5,9,AA,Spain,ORGANIZATION,COUNTRY,PROPN,PROPN,nsubj,poss,NNP,NNP,6,1
5872,15715.0,50,predicted,3,1,20,19,0,29,2,17,Royal Caribbean,Pullmantur,ORGANIZATION-ORGANIZATION,ORGANIZATION,PROPN-PROPN,PROPN,compound-nsubj,pobj,NNP-NNP,NNP,7,1
5873,15726.0,56,said,28,40,30,-10,39,25,-12,2,CMA,Mike Dungan,ORGANIZATION,PERSON-PERSON,PROPN,PROPN-PROPN,poss,compound-nsubj,NNP,NNP-NNP,5,1
5874,15730.0,49,died,39,1,46,45,0,2,38,7,Harry Shuler Dent,"Columbia , SC",PERSON-PERSON-PERSON,STATE_OR_PROVINCE-STATE_OR_PROVINCE-STATE_OR_PROVINCE,PROPN-PROPN-PROPN,PROPN-PUNCT-PROPN,compound-compound-nsubj,pobj-punct-appos,NNP-NNP-NNP,"NNP-,-NNP",3,1
5875,15731.0,38,said,28,31,30,-1,30,7,-3,2,John Dewey,spokesman,PERSON-PERSON,TITLE,PROPN-PROPN,NOUN,compound-nsubj,compound,NNP-NNP,NN,1,1
5876,15745.0,32,gratifying,4,27,25,-2,26,6,-23,21,she,congresswoman,PERSON,TITLE,PRON,NOUN,nsubj,pobj,PRP,NN,2,1
5877,15755.0,54,adopted,18,38,25,-13,37,28,-20,7,Richard Perle,Israeli,PERSON-PERSON,NATIONALITY,PROPN-PROPN,ADJ,compound-pobj,amod,NNP-NNP,JJ,9,1
5878,41025.0,41,was,1,15,20,5,14,20,-14,19,Richard Perle,Israeli,PERSON-PERSON,NATIONALITY,PROPN-PROPN,ADJ,compound-pobj,amod,NNP-NNP,JJ,5,1
5879,15789.0,10,grew,1,1,5,4,0,4,0,4,Black,Chicago,PERSON,CITY,PROPN,PROPN,nsubj,pobj,NNP,NNP,1,1
5880,15801.0,54,President,1,5,11,6,4,42,-4,10,Asian Development Bank,Jin Liqun,ORGANIZATION-ORGANIZATION-ORGANIZATION,PERSON-PERSON,PROPN-PROPN-PROPN,PROPN-PROPN,compound-compound-pobj,compound-nsubj,NNP-NNP-NNP,NNP-NNP,-1,1
5881,15806.0,37,said,19,34,27,-7,33,9,-15,8,Central American Parliament,Jacinto Suarez Espinoza,ORGANIZATION-ORGANIZATION-ORGANIZATION,PERSON-PERSON-PERSON,ADJ-PROPN-PROPN,PROPN-PROPN-PROPN,compound-compound-pobj,compound-compound-pobj,JJ-NNP-NNP,NNP-NNP-NNP,5,1
5882,15811.0,37,was,11,25,9,-16,24,27,-14,-2,Professional Rodeo Cowboys Association,him,ORGANIZATION-ORGANIZATION-ORGANIZATION-ORGANIZATION,PERSON,PROPN-PROPN-PROPN-PROPN,PRON,compound-compound-compound-pobj,dobj,NNP-NNP-NNPS-NNP,PRP,7,1
5883,15816.0,37,bet,14,18,4,-14,17,32,-4,-10,her,"Kabbalah Center , Inc.",PERSON,ORGANIZATION-ORGANIZATION-ORGANIZATION-ORGANIZATION,DET,PROPN-PROPN-PUNCT-PROPN,poss,compound-pobj-punct-nsubj,PRP$,"NNP-NNP-,-NNP",6,1
5884,15820.0,23,born,2,1,20,19,0,2,1,18,Ahearn,University of Alabama,PERSON,ORGANIZATION-ORGANIZATION-ORGANIZATION,PROPN,PROPN-ADP-PROPN,nsubjpass,pobj-prep-pobj,NNP,NNP-IN-NNP,5,1
5885,51022.0,23,born,2,1,20,19,0,2,1,18,Ahearn,University of Alabama,PERSON,ORGANIZATION-ORGANIZATION-ORGANIZATION,PROPN,PROPN-ADP-PROPN,nsubjpass,pobj-prep-pobj,NNP,NNP-IN-NNP,5,1
5886,15835.0,21,rekindled,11,19,17,-2,18,3,-8,6,Binoche,Marie,PERSON,PERSON,PROPN,PROPN,compound,compound,NNP,NNP,1,1
5887,15850.0,46,said,44,5,21,16,4,24,39,-23,OIC,Egypt,ORGANIZATION,COUNTRY,PROPN,PROPN,compound,conj,NNP,NNP,9,1
5888,15862.0,26,watching,2,18,13,-5,17,12,-16,11,UNC,Indian-dominated,ORGANIZATION,MISC,PROPN,ADJ,compound,amod,NNP,JJ,6,1
5889,15868.0,28,commissioned,8,20,12,-8,19,15,-12,4,Charles Wuorinen,America,PERSON-PERSON,COUNTRY,PROPN-PROPN,PROPN,compound-conj,poss,NNP-NNP,NNP,7,1
5890,15869.0,67,was,41,23,26,3,22,40,18,-15,Richard Lindzen,MIT,PERSON-PERSON,ORGANIZATION,PROPN-PROPN,PROPN,compound-conj,pobj,NNP-NNP,NNP,7,1
5891,26811.0,8,piece,2,5,8,3,4,-1,-3,6,Richard Lindzen,MIT,PERSON-PERSON,ORGANIZATION,PROPN-PROPN,PROPN,compound-pobj,pobj,NNP-NNP,NNP,-1,1
5892,28651.0,34,point,7,32,30,-2,31,3,-25,23,Richard Lindzen,MIT,PERSON-PERSON,ORGANIZATION,PROPN-PROPN,PROPN,compound-pobj,compound,NNP-NNP,NNP,3,1
5893,37023.0,46,defeated,33,15,13,-2,14,32,18,-20,Richard Lindzen,MIT,PERSON-PERSON,ORGANIZATION,PROPN-PROPN,PROPN,compound-pobj,compound,NNP-NNP,NNP,1,1
5894,15873.0,24,is,11,17,19,2,16,4,-6,8,ADB,Office of Regional Economic Integration,ORGANIZATION,ORGANIZATION-ORGANIZATION-ORGANIZATION-ORGANIZATION-ORGANIZATION,PROPN,PROPN-ADP-PROPN-PROPN-PROPN,poss,pobj-prep-compound-compound-pobj,NNP,NNP-IN-NNP-NNP-NNP,3,1
5895,15876.0,38,saw,15,2,20,18,1,17,13,5,Chunghwa Telecom,his,ORGANIZATION-ORGANIZATION,PERSON,PROPN-PROPN,DET,compound-poss,poss,NNP-NNP,PRP$,5,1
5896,15882.0,39,said,37,18,34,16,17,4,19,-3,her,cancer,PERSON,CAUSE_OF_DEATH,DET,NOUN,poss,pobj,PRP$,NN,8,1
5897,17552.0,40,said,38,18,35,17,17,4,20,-3,her,cancer,PERSON,CAUSE_OF_DEATH,DET,NOUN,poss,pobj,PRP$,NN,8,1
5898,15883.0,26,said,23,2,11,9,1,14,21,-12,Art Buchwald,humorist,PERSON-PERSON,TITLE,NOUN-PROPN,NOUN,compound-nsubj,compound,NN-NNP,NN,5,1
5899,29581.0,41,writes,22,27,26,-1,26,14,-5,4,Art Buchwald,humorist,PERSON-PERSON,TITLE,PROPN-PROPN,NOUN,compound-appos,pobj,NNP-NNP,NN,2,1
5900,31662.0,27,said,24,2,12,10,1,14,22,-12,Art Buchwald,humorist,PERSON-PERSON,TITLE,NOUN-PROPN,NOUN,compound-nsubj,compound,NN-NNP,NN,5,1
5901,61678.0,19,have,3,16,15,-1,15,3,-13,12,Art Buchwald,humorist,PERSON-PERSON,TITLE,PROPN-PROPN,NOUN,compound-appos,nsubj,NNP-NNP,NN,1,1
5902,15887.0,30,advised,16,11,2,-9,10,27,5,-14,National Republican Campaign Committee,Tom Cole,ORGANIZATION-ORGANIZATION-ORGANIZATION-ORGANIZATION,PERSON-PERSON,PROPN-PROPN-PROPN-PROPN,PROPN-PROPN,compound-compound-compound-pobj,compound-nsubj,NNP-NNP-NNP-NNP,NNP-NNP,4,1
5903,15891.0,47,Sponsors,1,45,47,2,44,-1,-44,46,Pentax,http://www.pentaximaging.com/,ORGANIZATION,URL,PROPN,X,ROOT,punct,NNP,ADD,-1,1
5904,15936.0,19,delayed,3,1,13,12,0,5,2,10,His,police investigation,PERSON,CRIMINAL_CHARGE-CRIMINAL_CHARGE,DET,NOUN-NOUN,poss,compound-dobj,PRP$,NN-NN,4,1
5905,15937.0,29,served,1,1,8,7,0,20,0,7,He,Europe,PERSON,LOCATION,PRON,PROPN,nsubj,pobj,PRP,NNP,1,1
5906,15949.0,25,is,8,15,22,7,14,2,-7,14,Chad White,Portland,PERSON-PERSON,CITY,PROPN-PROPN,PROPN,compound-appos,pobj,NNP-NNP,NNP,4,1
5907,15952.0,23,made,10,1,6,5,0,16,9,-4,Philip Chen,Far Eastern Air Transport,PERSON-PERSON,ORGANIZATION-ORGANIZATION-ORGANIZATION-ORGANIZATION,PROPN-PROPN,PROPN-PROPN-PROPN-PROPN,compound-nsubj,compound-compound-compound-pobj,NNP-NNP,NNP-NNP-NNP-NNP,4,1
5908,15960.0,36,google_ad_section_start,0,5,14,9,4,21,-5,14,Jake Pavelka,Bachelor star,PERSON-PERSON,TITLE-TITLE,PROPN-PROPN,PROPN-NOUN,compound-appos,compound-compound,NNP-NNP,NNP-NN,5,1
5909,15990.0,23,said,14,20,16,-4,19,6,-6,2,American Bar Association,Greg Jenner,ORGANIZATION-ORGANIZATION-ORGANIZATION,PERSON-PERSON,PROPN-PROPN-PROPN,PROPN-PROPN,compound-compound-pobj,compound-nsubj,NNP-NNP-NNP,NNP-NNP,3,1
5910,15995.0,36,is,18,21,34,13,20,1,-3,16,DeGeneres,host,PERSON,TITLE,PROPN,NOUN,nsubj,pobj,NNP,NN,3,1
5911,47082.0,25,has,1,1,19,18,0,5,0,18,DeGeneres,host,PERSON,TITLE,PROPN,NOUN,nsubj,attr,NNP,NN,2,1
5912,15998.0,32,winger,1,14,25,11,13,6,-13,24,New South Wales,he,ORGANIZATION-ORGANIZATION-ORGANIZATION,PERSON,PROPN-PROPN-PROPN,PRON,compound-compound-compound,nsubj,NNP-NNP-NNP,PRP,6,1
5913,16013.0,28,released,11,2,7,5,1,20,9,-4,Barbara Boxer,chair,PERSON-PERSON,TITLE,PROPN-PROPN,NOUN,compound-nsubj,appos,NNP-NNP,NN,2,1
5914,16018.0,20,played,8,1,6,5,0,13,7,-2,The 22-year old,Portland,PERSON-PERSON-PERSON,CITY,DET-ADJ-ADJ,PROPN,det-nummod-amod,pobj,DT-JJ-JJ,NNP,4,1
5915,16019.0,24,was,4,4,7,3,3,16,0,3,Roraback,lawyer,PERSON,TITLE,PROPN,NOUN,nsubj,attr,NNP,NN,2,1
5916,46429.0,34,was,1,1,5,4,0,28,0,4,Roraback,lawyer,PERSON,TITLE,PROPN,NOUN,nsubj,attr,NNP,NN,2,1
5917,16021.0,34,ingrained,2,18,30,12,17,3,-16,28,Spelman College,his,ORGANIZATION-ORGANIZATION,PERSON,PROPN-PROPN,DET,compound-pobj,poss,NNP-NNP,PRP$,7,1
5918,16027.0,66,survived,12,2,47,45,1,18,10,35,his,David,PERSON,PERSON,DET,PROPN,poss,conj,PRP$,NNP,7,1
5919,37476.0,66,survived,12,2,47,45,1,18,10,35,his,David,PERSON,PERSON,DET,PROPN,poss,conj,PRP$,NNP,7,1
5920,16029.0,31,arrived,15,15,5,-10,14,25,0,-10,McNair,National Democratic Governors Conference,PERSON,ORGANIZATION-ORGANIZATION-ORGANIZATION-ORGANIZATION,PROPN,PROPN-PROPN-PROPN-PROPN,nsubj,compound-compound-compound-conj,NNP,NNP-NNP-NNPS-NNP,2,1
5921,16030.0,46,said,15,2,17,15,1,28,13,2,Asian Development Bank,Zhao Xiaoyu,ORGANIZATION-ORGANIZATION-ORGANIZATION,PERSON-PERSON,PROPN-PROPN-PROPN,PROPN-PROPN,compound-compound-pobj,compound-nsubj,NNP-NNP-NNP,NNP-NNP,3,1
5922,16033.0,41,detained,16,1,7,6,0,33,15,-9,Kurnaz,Bremen,PERSON,CITY,PROPN,PROPN,nsubjpass,pobj,NNP,NNP,5,1
5923,18365.0,41,detained,16,1,7,6,0,33,15,-9,Kurnaz,Bremen,PERSON,CITY,PROPN,PROPN,nsubjpass,pobj,NNP,NNP,5,1
5924,32304.0,47,detained,16,1,7,6,0,39,15,-9,Kurnaz,Bremen,PERSON,CITY,PROPN,PROPN,nsubjpass,pobj,NNP,NNP,5,1
5925,16034.0,16,Debacle,3,8,16,8,7,-1,-5,13,Philadelphia Inquirer,http://www.moveon.org/r?r=3583&id;=12458-1898879-ruzLlE&t;=19,ORGANIZATION-ORGANIZATION,URL,PROPN-PROPN,NOUN,compound-compound,ROOT,NNP-NNP,NN,4,1
5926,16038.0,34,died,21,1,6,5,0,27,20,-15,Parren J. Mitchell,Baltimore,PERSON-PERSON-PERSON,CITY,PROPN-PROPN-PROPN,PROPN,compound-compound-nsubj,nmod,NNP-NNP-NNP,NNP,4,1
5927,46402.0,36,died,25,1,34,33,0,1,24,9,Parren J. Mitchell,Baltimore,PERSON-PERSON-PERSON,CITY,PROPN-PROPN-PROPN,PROPN,compound-compound-nsubj,compound,NNP-NNP-NNP,NNP,4,1
5928,16046.0,54,said,52,38,36,-2,37,17,14,-16,she,Blackburn,PERSON,CITY,PRON,PROPN,nsubj,pobj,PRP,NNP,1,1
5929,31434.0,46,has,35,15,32,17,14,13,20,-3,she,Blackburn,PERSON,CITY,PRON,PROPN,nsubj,pobj,PRP,NNP,5,1
5930,16050.0,25,falls,1,6,8,2,5,16,-5,7,DCR,Richard Sullivan,ORGANIZATION,PERSON-PERSON,PROPN,PROPN-PROPN,compound,compound-pobj,NNP,NNP-NNP,1,1
5931,52118.0,20,been,5,1,3,2,0,16,4,-2,DCR,Richard Sullivan,ORGANIZATION,PERSON-PERSON,PROPN,PROPN-PROPN,compound,compound-nsubj,NNP,NNP-NNP,1,1
5932,16051.0,45,said,18,28,37,9,27,7,-10,19,American Beverage Association,PepsiCo Inc.,ORGANIZATION-ORGANIZATION-ORGANIZATION,ORGANIZATION-ORGANIZATION,PROPN-PROPN-PROPN,PROPN-PROPN,compound-compound-pobj,compound-conj,NNP-NNP-NNP,NNP-NNP,6,1
5933,16059.0,34,said,17,1,14,13,0,19,16,-3,Li Jie,Military Academy,PERSON-PERSON,ORGANIZATION-ORGANIZATION,PROPN-PROPN,PROPN-PROPN,compound-nsubj,compound-pobj,NNP-NNP,NNP-NNP,3,1
5934,16072.0,34,has,20,14,30,16,13,3,6,10,Denso Corp,Guangzhou,ORGANIZATION-ORGANIZATION,CITY,PROPN-PROPN,PROPN,compound-nsubj,poss,NNP-NNP,NNP,8,1
5935,16074.0,41,-RRB-,1,11,3,-8,10,37,-10,2,Mainland Affairs Council,You Ying-long,ORGANIZATION-ORGANIZATION-ORGANIZATION,PERSON-PERSON,PROPN-PROPN-PROPN,PRON-VERB,compound-compound-pobj,compound-ROOT,NNP-NNPS-NNP,PRP-VBP,6,1
5936,16081.0,37,is,8,7,3,-4,6,33,1,-5,Jackson Hewitt,Parsippany,ORGANIZATION-ORGANIZATION,CITY,PROPN-PROPN,PROPN,compound-nsubj,pobj,NNP-NNP,NNP,5,1
5937,64368.0,25,is,9,1,6,5,0,18,8,-3,Jackson Hewitt,Parsippany,ORGANIZATION-ORGANIZATION,CITY,PROPN-PROPN,PROPN,compound-nsubj,pobj,NNP-NNP,NNP,4,1
5938,16093.0,45,2007-09-27T09,0,5,4,-1,4,40,-5,4,Richard Lindzen,Professor,PERSON-PERSON,TITLE,PROPN-PROPN,PROPN,compound-nsubj,compound,NNP-NNP,NNP,3,1
5939,32716.0,31,is,4,24,23,-1,23,7,-20,19,Richard Lindzen,Professor,PERSON-PERSON,TITLE,PROPN-PROPN,PROPN,compound-pobj,compound,NNP-NNP,NNP,1,1
5940,38279.0,18,published,6,5,4,-1,4,13,1,-2,Richard Lindzen,Professor,PERSON-PERSON,TITLE,PROPN-PROPN,PROPN,compound-nsubj,compound,NNP-NNP,NNP,1,1
5941,40026.0,31,said,23,10,16,6,9,14,13,-7,Richard Lindzen,Professor,PERSON-PERSON,TITLE,PROPN-PROPN,PROPN,compound-nsubj,appos,NNP-NNP,NNP,2,1
5942,44957.0,42,argued,14,2,1,-1,1,40,12,-13,Richard Lindzen,Professor,PERSON-PERSON,TITLE,PROPN-PROPN,PROPN,compound-nsubj,compound,NNP-NNP,NNP,1,1
5943,16101.0,32,said,9,11,22,11,10,9,-2,13,Dee Dee Myers,author,PERSON-PERSON-PERSON,TITLE,PROPN-PROPN-PROPN,NOUN,compound-compound-nsubj,conj,NNP-NNP-NNP,NN,3,1
5944,16103.0,66,comes,2,47,65,18,46,0,-45,63,Donald Wildmon,Mississippi,PERSON-PERSON,STATE_OR_PROVINCE,PROPN-PROPN,PROPN,compound-pobj,appos,NNP-NNP,NNP,14,1
5945,57267.0,66,comes,2,47,65,18,46,0,-45,63,Donald Wildmon,Mississippi,PERSON-PERSON,STATE_OR_PROVINCE,PROPN-PROPN,PROPN,compound-pobj,appos,NNP-NNP,NNP,14,1
5946,16119.0,28,said,25,5,1,-4,4,26,20,-24,Mohamed ElBaradei,UN,PERSON-PERSON,ORGANIZATION,PROPN-PROPN,PROPN,compound-nsubj,amod,NNP-NNP,NNP,3,1
5947,37533.0,37,told,34,4,1,-3,3,35,30,-33,Mohamed ElBaradei,UN,PERSON-PERSON,ORGANIZATION,PROPN-PROPN,PROPN,compound-nsubj,nmod,NNP-NNP,NNP,2,1
5948,41600.0,31,walked,8,5,1,-4,4,29,3,-7,Mohamed ElBaradei,UN,PERSON-PERSON,ORGANIZATION,PROPN-PROPN,PROPN,compound-nsubj,nmod,NNP-NNP,NNP,3,1
5949,59011.0,54,Urgent,1,44,37,-7,43,16,-43,36,Mohamed ElBaradei,UN,PERSON-PERSON,ORGANIZATION,PROPN-PROPN,PROPN,compound-nsubj,nmod,NNP-NNP,NNP,7,1
5950,16121.0,20,convicted,5,2,1,-1,1,18,3,-4,Danny Glover,Actor,PERSON-PERSON,TITLE,PROPN-PROPN,PROPN,compound-nsubjpass,compound,NNP-NNP,NNP,1,1
5951,22186.0,33,urges,3,2,1,-1,1,31,1,-2,Danny Glover,Actor,PERSON-PERSON,TITLE,PROPN-PROPN,PROPN,compound-nsubj,compound,NNP-NNP,NNP,1,1
5952,16128.0,33,urging,5,20,12,-8,19,20,-15,7,Sadiq el-Mahdi,Sudan,PERSON-PERSON,COUNTRY,PROPN-PROPN,PROPN,compound-appos,poss,NNP-NNP,NNP,4,1
5953,16131.0,37,told,12,1,10,9,0,26,11,-2,Al-Khawinay,Um Mohammed,PERSON,PERSON-PERSON,PROPN,PROPN-PROPN,poss,compound-pobj,NNP,NNP-NNP,4,1
5954,16133.0,36,told,17,34,31,-3,33,4,-17,14,Awami League,left,ORGANIZATION-ORGANIZATION,RELIGION,PROPN-PROPN,ADV,compound-pobj,advmod,NNP-NNP,RB,2,1
5955,16137.0,38,confirmed,6,5,1,-4,4,36,1,-5,Robert Morgenthau,New York District Attorney,PERSON-PERSON,TITLE-TITLE-TITLE-TITLE,PROPN-PROPN,PROPN-PROPN-PROPN-PROPN,compound-nsubj,compound-compound-compound-compound,NNP-NNP,NNP-NNP-NNP-NNP,2,1
5956,16144.0,11,added,5,4,8,4,3,2,1,3,Spelman,department of chemistry,ORGANIZATION,ORGANIZATION-ORGANIZATION-ORGANIZATION,PROPN,NOUN-ADP-NOUN,nsubj,dobj-prep-pobj,NNP,NN-IN-NN,3,1
5957,16155.0,31,said,16,28,22,-6,27,8,-12,6,University of Haifa,Department of Computer Science,ORGANIZATION-ORGANIZATION-ORGANIZATION,ORGANIZATION-ORGANIZATION-ORGANIZATION-ORGANIZATION,PROPN-ADP-PROPN,PROPN-ADP-PROPN-PROPN,pobj-prep-pobj,pobj-prep-compound-pobj,NNP-IN-NNP,NNP-IN-NNP-NNP,6,1
5958,16157.0,37,was,8,7,3,-4,6,33,1,-5,Parren Mitchell,Baltimore,PERSON-PERSON,CITY,PROPN-PROPN,PROPN,compound-nsubj,pobj,NNP-NNP,NNP,3,1
5959,16176.0,47,Football,4,10,7,-3,9,39,-6,3,Blackburn Rovers,Allardyce,ORGANIZATION-ORGANIZATION,PERSON,PROPN-PROPN,PROPN,compound-pobj,nsubj,NNP-NNPS,NNP,3,1
5960,16179.0,26,seen,2,10,1,-9,9,24,-8,-1,Paul Sculfor,Cameron,PERSON-PERSON,PERSON,PROPN-PROPN,PROPN,compound-appos,nsubjpass,NNP-NNP,NNP,4,1
5961,16182.0,35,turned,20,22,19,-3,21,15,-2,-1,hers,French,PERSON,NATIONALITY,NOUN,ADJ,dobj,amod,NNS,JJ,2,1
5962,16185.0,37,said,23,1,4,3,0,32,22,-19,Shah Mahmood,33,PERSON-PERSON,NUMBER,PROPN-PROPN,NUM,compound-nsubj,appos,NNP-NNP,CD,1,1
5963,16186.0,46,said,5,1,4,3,0,41,4,-1,Chunghwa Telecom,Lu Shyue-ching,ORGANIZATION-ORGANIZATION,PERSON-PERSON,PROPN-PROPN,PROPN-PROPN,compound-compound,compound-nsubj,NNP-NNP,NNP-NNP,3,1
5964,29054.0,27,justified,8,1,4,3,0,22,7,-4,Chunghwa Telecom,Lu Shyue-ching,ORGANIZATION-ORGANIZATION,PERSON-PERSON,PROPN-PROPN,PROPN-PROPN,compound-compound,compound-nsubj,NNP-NNP,NNP-NNP,3,1
5965,31418.0,22,said,5,1,4,3,0,17,4,-1,Chunghwa Telecom,Lu Shyue-ching,ORGANIZATION-ORGANIZATION,PERSON-PERSON,PROPN-PROPN,PROPN-PROPN,compound-compound,compound-nsubj,NNP-NNP,NNP-NNP,3,1
5966,16198.0,19,is,5,7,7,0,6,11,-2,2,Hugo,Hugo de los Reyes Chavez,PERSON,PERSON-PERSON-PERSON-PERSON-PERSON,PROPN,PROPN-PROPN-PROPN-PROPN-PROPN,pobj,compound-compound-compound-compound-attr,NNP,NNP-NNP-NNP-NNP-NNP,0,1
5967,16210.0,38,said,21,20,20,0,19,17,1,-1,Atlanta Chamber of Commerce,Atlanta,ORGANIZATION-ORGANIZATION-ORGANIZATION-ORGANIZATION,CITY,PROPN-PROPN-ADP-PROPN,PROPN,compound-pobj-prep-pobj,dobj,NNP-NNP-IN-NNP,NNP,0,1
5968,16212.0,26,went,12,3,2,-1,2,23,9,-10,Watson,Captain,PERSON,TITLE,PROPN,PROPN,nsubj,compound,NNP,NNP,2,1
5969,16825.0,26,accused,1,4,3,-1,3,22,-3,2,Watson,Captain,PERSON,TITLE,PROPN,PROPN,dobj,compound,NNP,NNP,2,1
5970,59859.0,13,fighting,4,2,1,-1,1,11,2,-3,Watson,Captain,PERSON,TITLE,PROPN,PROPN,nsubj,compound,NNP,NNP,2,1
5971,63711.0,33,said,29,32,31,-1,31,1,-3,2,Watson,Captain,PERSON,TITLE,PROPN,PROPN,nsubj,compound,NNP,NNP,1,1
5972,16221.0,20,left,1,3,1,-2,2,18,-2,0,Millonarios,Osorio,ORGANIZATION,PERSON,PROPN,PROPN,dobj,nsubj,NNP,NNP,2,1
5973,16223.0,27,consider,1,10,14,4,9,12,-9,13,Representatives,Steve Walsh,ORGANIZATION,PERSON-PERSON,PROPN,PROPN-PROPN,compound,compound-conj,NNPS,NNP-NNP,2,1
5974,16231.0,19,said,9,1,4,3,0,14,8,-5,Hussein Kamel,21,PERSON-PERSON,NUMBER,PROPN-PROPN,NUM,compound-nsubj,appos,NNP-NNP,CD,1,1
5975,37316.0,19,said,5,1,4,3,0,14,4,-1,Hussein Kamel,21,PERSON-PERSON,NUMBER,PROPN-PROPN,NUM,compound-nsubj,appos,NNP-NNP,CD,2,1
5976,16232.0,24,won,17,1,4,3,0,19,16,-13,His,Thomas J Dodd,PERSON,PERSON-PERSON-PERSON,DET,PROPN-PROPN-PROPN,poss,compound-compound-appos,PRP$,NNP-NNP-NNP,2,1
5977,16248.0,31,KONG,1,22,12,-10,21,18,-21,11,Hong Kong Disneyland,China,ORGANIZATION-ORGANIZATION-ORGANIZATION,COUNTRY,PROPN-PROPN-PROPN,PROPN,compound-compound-pobj,poss,NNP-NNP-NNP,NNP,10,1
5978,16722.0,33,agreed,14,11,16,5,10,16,3,2,Hong Kong Disneyland,China,ORGANIZATION-ORGANIZATION-ORGANIZATION,COUNTRY,PROPN-PROPN-PROPN,PROPN,compound-compound-pobj,compound,NNP-NNP-NNP,NNP,7,1
5979,42816.0,37,----------------------------------------------,0,17,6,-11,16,30,-17,6,Hong Kong Disneyland,China,ORGANIZATION-ORGANIZATION-ORGANIZATION,COUNTRY,PROPN-PROPN-PROPN,PROPN,compound-compound-compound,compound,NNP-NNP-NNP,NNP,8,1
5980,58724.0,41,criticized,16,1,13,12,0,27,15,-3,Hong Kong Disneyland,China,ORGANIZATION-ORGANIZATION-ORGANIZATION,COUNTRY,PROPN-PROPN-PROPN,PROPN,compound-compound-nsubjpass,pobj,NNP-NNP-NNP,NNP,3,1
5981,16251.0,34,2-3,1,4,17,13,3,16,-3,16,Augustus F. Hawkins,Congress,PERSON-PERSON-PERSON,ORGANIZATION,PROPN-PROPN-PROPN,PROPN,compound-compound-nsubj,pobj,NNP-NNP-NNP,NNP,5,1
5982,25837.0,30,died,28,1,15,14,0,14,27,-13,Augustus F. Hawkins,Congress,PERSON-PERSON-PERSON,ORGANIZATION,PROPN-PROPN-PROPN,PROPN,compound-compound-nsubj,pobj,NNP-NNP-NNP,NNP,3,1
5983,16260.0,62,be,4,53,59,6,52,2,-49,55,Covidien,Mansfield,ORGANIZATION,CITY,PROPN,PROPN,oprd,pobj,NNP,NNP,7,1
5984,44276.0,15,plans,3,3,7,4,2,7,0,4,Covidien,Mansfield,ORGANIZATION,CITY,PROPN,PROPN,nsubj,dobj,NNP,NNP,3,1
5985,16269.0,65,Representative,0,16,3,-13,15,61,-16,3,Ali Larijani,Iran,PERSON-PERSON,COUNTRY,PROPN-PROPN,PROPN,compound-nsubj,poss,NNP-NNP,NNP,-1,1
5986,18621.0,37,reported,33,5,1,-4,4,35,28,-32,Ali Larijani,Iran,PERSON-PERSON,ORGANIZATION,PROPN-PROPN,PROPN,compound-appos,poss,NNP-NNP,NNP,3,1
5987,19227.0,25,reported,5,15,9,-6,14,15,-10,4,Ali Larijani,Iran,PERSON-PERSON,COUNTRY,PROPN-PROPN,PROPN,compound-appos,poss,NNP-NNP,NNP,3,1
5988,20159.0,27,announced,3,6,11,5,5,15,-3,8,Ali Larijani,Iran,PERSON-PERSON,ORGANIZATION,PROPN-PROPN,PROPN,compound-nsubj,poss,NNP-NNP,NNP,5,1
5989,25006.0,40,reported,37,13,2,-11,12,37,24,-35,Ali Larijani,Iran,PERSON-PERSON,ORGANIZATION,PROPN-PROPN,PROPN,compound-appos,poss,NNP-NNP,NNP,6,1
5990,25450.0,20,expected,8,6,1,-5,5,18,2,-7,Ali Larijani,Iran,PERSON-PERSON,COUNTRY,PROPN-PROPN,PROPN,compound-appos,poss,NNP-NNP,NNP,3,1
5991,27451.0,35,appealed,13,11,4,-7,10,30,2,-9,Ali Larijani,Iran,PERSON-PERSON,COUNTRY,PROPN-PROPN,PROPN,compound-appos,poss,NNP-NNP,NNP,3,1
5992,33312.0,30,said,7,6,1,-5,5,28,1,-6,Ali Larijani,Iran,PERSON-PERSON,COUNTRY,PROPN-PROPN,PROPN,compound-appos,poss,NNP-NNP,NNP,3,1
5993,39438.0,41,TEHRAN,0,13,9,-4,12,31,-13,9,Ali Larijani,Iran,PERSON-PERSON,COUNTRY,PROPN-PROPN,PROPN,compound-nsubj,poss,NNP-NNP,NNP,3,1
5994,40459.0,35,box,1,4,13,9,3,21,-3,12,Ali Larijani,Iran,PERSON-PERSON,COUNTRY,PROPN-PROPN,PROPN,compound-pobj,poss,NNP-NNP,NNP,-1,1
5995,41223.0,40,asked,10,7,1,-6,6,38,3,-9,Ali Larijani,Iran,PERSON-PERSON,COUNTRY,PROPN-PROPN,PROPN,compound-appos,poss,NNP-NNP,NNP,3,1
5996,47676.0,42,said,2,6,11,5,5,30,-4,9,Ali Larijani,Iran,PERSON-PERSON,COUNTRY,PROPN-PROPN,PROPN,compound-nsubj,nsubj,NNP-NNP,NNP,5,1
5997,54643.0,26,says,12,21,3,-18,20,22,-9,-9,Ali Larijani,Iran,PERSON-PERSON,ORGANIZATION,PROPN-PROPN,PROPN,compound-appos,nmod,NNP-NNP,NNP,6,1
5998,16270.0,26,said,17,1,8,7,0,17,16,-9,Millender-McDonald,late Saturday,PERSON,DATE-DATE,PROPN,ADJ-PROPN,nsubj,amod-npadvmod,NNP,JJ-NNP,2,1
5999,16278.0,45,questioned,16,1,7,6,0,37,15,-9,Chris Simcox,Minuteman Civil Defense Corps,PERSON-PERSON,ORGANIZATION-ORGANIZATION-ORGANIZATION-ORGANIZATION,PROPN-PROPN,PROPN-PROPN-PROPN-PROPN,compound-nsubj,compound-compound-compound-pobj,NNP-NNP,NNP-NNP-NNP-NNP,5,1
6000,17685.0,7,Corps,6,1,4,3,0,2,5,-2,Chris Simcox,Minuteman Civil Defense Corps,PERSON-PERSON,ORGANIZATION-ORGANIZATION-ORGANIZATION-ORGANIZATION,PROPN-PROPN,PROPN-PROPN-NOUN-PROPN,compound-compound,compound-compound-compound-ROOT,NNP-NNP,NNP-NNP-NN-NNP,4,1
6001,18628.0,23,said,8,10,19,9,9,3,-2,11,Chris Simcox,Minuteman Civil Defense Corps,PERSON-PERSON,ORGANIZATION-ORGANIZATION-ORGANIZATION-ORGANIZATION,PROPN-PROPN,PROPN-PROPN-PROPN-PROPN,compound-nsubj,compound-compound-compound-pobj,NNP-NNP,NNP-NNP-NNP-NNP,3,1
6002,27160.0,51,built,2,7,13,6,6,37,-5,11,Chris Simcox,Minuteman Civil Defense Corps,PERSON-PERSON,ORGANIZATION-ORGANIZATION-ORGANIZATION-ORGANIZATION,PROPN-PROPN,PROPN-PROPN-PROPN-PROPN,compound-dobj,compound-compound-compound-pobj,NNP-NNP,NNP-NNP-NNP-NNP,5,1
6003,29567.0,36,requesting,3,7,10,3,6,25,-4,7,Chris Simcox,Minuteman Civil Defense Corps,PERSON-PERSON,ORGANIZATION-ORGANIZATION-ORGANIZATION-ORGANIZATION,PROPN-PROPN,PROPN-PROPN-PROPN-PROPN,compound-poss,compound-compound-compound-pobj,NNP-NNP,NNP-NNP-NNP-NNP,3,1
6004,51576.0,40,are,1,16,23,7,15,16,-15,22,Chris Simcox,Minuteman Civil Defense Corps,PERSON-PERSON,ORGANIZATION-ORGANIZATION-ORGANIZATION-ORGANIZATION,PROPN-PROPN,PROPN-PROPN-PROPN-PROPN,compound-conj,compound-compound-compound-pobj,NNP-NNP,NNP-NNP-NNP-NNP,4,1
6005,66187.0,22,set,10,9,4,-5,8,17,1,-6,Chris Simcox,Minuteman Civil Defense Corps,PERSON-PERSON,ORGANIZATION-ORGANIZATION-ORGANIZATION-ORGANIZATION,PROPN-PROPN,PROPN-PROPN-PROPN-PROPN,compound-nsubj,compound-compound-compound-compound,NNP-NNP,NNP-NNP-NNP-NNP,3,1
6006,16279.0,32,confirmed,29,4,31,27,3,0,25,2,Parren J. Mitchell,Tuesday,PERSON-PERSON-PERSON,DATE,PROPN-PROPN-PROPN,PROPN,compound-compound-nsubj,npadvmod,NNP-NNP-NNP,NNP,4,1
6007,16280.0,13,became,9,1,3,2,0,9,8,-6,His,Richmond Jr.,PERSON,PERSON-PERSON,DET,PROPN-PROPN,poss,compound-appos,PRP$,NNP-NNP,1,1
6008,16282.0,22,received,3,15,20,5,14,1,-12,17,Justice and Equality Movement,North Darfur,ORGANIZATION-ORGANIZATION-ORGANIZATION-ORGANIZATION,STATE_OR_PROVINCE-STATE_OR_PROVINCE,PROPN-CCONJ-PROPN-PROPN,PROPN-PROPN,nmod-cc-conj-conj,compound-pobj,NNP-CC-NNP-NNP,NNP-NNP,2,1
6009,16290.0,43,Party,2,11,7,-4,10,35,-9,5,national congress,CPC,ORGANIZATION-ORGANIZATION,ORGANIZATION,ADJ-NOUN,PROPN,amod-dobj,compound,JJ-NN,NNP,3,1
6010,16299.0,52,live,5,24,16,-8,23,35,-19,11,her,Blakesley Grace,PERSON,PERSON-PERSON,DET,PROPN-PROPN,poss,compound-conj,PRP$,NNP-NNP,6,1
6011,16303.0,27,say,11,1,4,3,0,22,10,-7,Bentley,Citizenship and Immigration Services,PERSON,ORGANIZATION-ORGANIZATION-ORGANIZATION-ORGANIZATION,PROPN,PROPN-CCONJ-PROPN-PROPN,nsubj,nmod-cc-compound-conj,NNP,NNP-CC-NNP-NNPS,5,1
6012,16305.0,32,said,5,5,1,-4,4,30,0,-4,Markit,Financial information services,ORGANIZATION,ORGANIZATION-ORGANIZATION-ORGANIZATION,PROPN,ADJ-NOUN-NOUN,appos,amod-compound-compound,NNP,JJ-NN-NNS,4,1
6013,16307.0,66,say,37,14,35,21,13,30,23,-2,Sean Parker,Founders Fund,PERSON-PERSON,ORGANIZATION-ORGANIZATION,PROPN-PROPN,PROPN-PROPN,compound-conj,compound-dobj,NNP-NNP,NNP-NNP,11,1
6014,16322.0,12,welcomed,7,1,6,5,0,5,6,-1,Chris Simcox,organizer,PERSON-PERSON,TITLE,PROPN-PROPN,NOUN,compound-nsubj,appos,NNP-NNP,NN,2,1
6015,16325.0,20,slated,4,8,19,11,7,0,-4,15,Sean Parker,president,PERSON-PERSON,TITLE,PROPN-PROPN,NOUN,compound-dobj,conj,NNP-NNP,NN,5,1
6016,16721.0,37,play,5,11,10,-1,10,26,-6,5,Sean Parker,president,PERSON-PERSON,TITLE,PROPN-PROPN,NOUN,compound-appos,dobj,NNP-NNP,NN,1,1
6017,37484.0,22,play,3,15,21,6,14,0,-12,18,Sean Parker,president,PERSON-PERSON,TITLE,PROPN-PROPN,NOUN,compound-pobj,appos,NNP-NNP,NN,3,1
6018,16329.0,35,accused,1,1,18,17,0,16,0,17,Chavez,Venezuelan,PERSON,NATIONALITY,PROPN,ADJ,nsubjpass,amod,NNP,JJ,5,1
6019,16336.0,41,returned,3,9,9,0,8,31,-6,6,her,her,PERSON,PERSON,PRON,DET,dobj,poss,PRP,PRP$,0,1
6020,24483.0,33,confirm,4,10,10,0,9,22,-6,6,her,her,PERSON,PERSON,DET,DET,poss,poss,PRP$,PRP$,0,1
6021,40889.0,62,think,1,31,31,0,30,30,-30,30,her,her,PERSON,PERSON,DET,DET,poss,poss,PRP$,PRP$,0,1
6022,49446.0,23,says,2,9,9,0,8,13,-7,7,her,her,PERSON,PERSON,DET,DET,poss,poss,PRP$,PRP$,0,1
6023,16340.0,31,said,21,26,23,-3,25,7,-5,2,ICG,Robert Templer,ORGANIZATION,PERSON-PERSON,PROPN,PROPN-PROPN,poss,compound-nsubj,NNP,NNP-NNP,3,1
6024,16342.0,28,testified,1,16,1,-15,15,26,-15,0,Pamela Martin & amp ; Associates,She,ORGANIZATION-ORGANIZATION-ORGANIZATION-ORGANIZATION-ORGANIZATION-ORGANIZATION,PERSON,PROPN-PROPN-CCONJ-NOUN-PUNCT-NOUN,PRON,compound-dobj-cc-conj-punct-ROOT,nsubj,NNP-NNP-CC-NN-:-NNS,PRP,3,1
6025,16345.0,30,died,22,3,2,-1,2,27,19,-20,Steven B. Derounian,Rep.,PERSON-PERSON-PERSON,TITLE,PROPN-PROPN-PROPN,PROPN,compound-compound-nsubj,compound,NNP-NNP-NNP,NNP,2,1
6026,16349.0,20,said,18,12,15,3,11,4,6,-3,his,Chad,PERSON,COUNTRY,DET,PROPN,poss,pobj,PRP$,NNP,3,1
6027,16356.0,25,merged,6,4,2,-2,3,22,2,-4,Konica Minolta,2003,ORGANIZATION-ORGANIZATION,DATE,PROPN-PROPN,NUM,compound-compound,pobj,NNP-NNP,CD,3,1
6028,16362.0,19,born,2,1,13,12,0,5,1,11,He,Presbyterian College,PERSON,ORGANIZATION-ORGANIZATION,PRON,PROPN-PROPN,nsubjpass,compound-pobj,PRP,NNP-NNP,4,1
6029,16364.0,33,WASHBURN,1,1,15,14,0,17,0,14,BRADFORD WASHBURN,Harvard,PERSON-PERSON,ORGANIZATION,PROPN-PROPN,PROPN,compound-ROOT,pobj,NNP-NNP,NNP,3,1
6030,16372.0,19,Ltd.,0,3,1,-2,2,17,-3,1,CNR,Ltd.,ORGANIZATION,ORGANIZATION,PROPN,PROPN,poss,ROOT,NNP,NNP,4,1
6031,16376.0,22,appointed,13,12,15,3,11,6,1,2,Samsung,Lee Yoon-Woo,ORGANIZATION,PERSON-PERSON,PROPN,PROPN-PROPN,appos,compound-dobj,NNP,NNP-NNP,3,1
6032,16379.0,24,stopped,2,1,15,14,0,8,1,13,Holly Montag,MTV,PERSON-PERSON,ORGANIZATION,PROPN-PROPN,PROPN,compound-nsubj,poss,NNP-NNP,NNP,8,1
6033,25721.0,34,Stephanie,0,3,16,13,2,17,-3,16,Holly Montag,MTV,PERSON-PERSON,ORGANIZATION,PROPN-PROPN,PROPN,compound-conj,compound,NNP-NNP,NNP,3,1
6034,16385.0,25,-RRB-,0,2,8,6,1,16,-2,8,Johns,Maverick Records,PERSON,ORGANIZATION-ORGANIZATION,PROPN,PROPN-PROPN,nsubj,compound-pobj,NNP,NNP-NNPS,2,1
6035,16388.0,16,December,0,5,13,8,4,2,-5,13,Jefferson DeBlanc,86,PERSON-PERSON,NUMBER,PROPN-PROPN,NUM,compound-conj,pobj,NNP-NNP,CD,3,1
6036,33614.0,17,DeBlanc,1,1,9,8,0,7,0,8,Jefferson DeBlanc,86,PERSON-PERSON,NUMBER,PROPN-PROPN,NUM,compound-ROOT,nummod,NNP-NNP,CD,2,1
6037,16400.0,38,said,5,3,21,18,2,16,2,16,Crown Prosecution Service,London,ORGANIZATION-ORGANIZATION-ORGANIZATION,CITY,PROPN-PROPN-PROPN,PROPN,compound-compound-nsubj,compound,NNP-NNP-NNP,NNP,5,1
6038,50696.0,39,said,37,2,16,14,1,22,35,-21,Crown Prosecution Service,London,ORGANIZATION-ORGANIZATION-ORGANIZATION,CITY,PROPN-PROPN-PROPN,PROPN,compound-compound-nsubj,compound,NNP-NNP-NNP,NNP,9,1
6039,65146.0,20,said,12,5,2,-3,4,17,7,-10,Crown Prosecution Service,London,ORGANIZATION-ORGANIZATION-ORGANIZATION,CITY,PROPN-PROPN-PROPN,PROPN,compound-compound-nsubj,pobj,NNP-NNP-NNP,NNP,3,1
6040,16402.0,43,LUMPUR,1,9,23,14,8,19,-8,22,Bernama,1968,ORGANIZATION,DATE,PROPN,NUM,compound,pobj,NNP,CD,6,1
6041,46210.0,19,began,1,1,9,8,0,9,0,8,Bernama,1968,ORGANIZATION,DATE,PROPN,NUM,nsubj,pobj,NNP,CD,1,1
6042,16417.0,39,drama,3,12,9,-3,11,29,-9,6,Bryan Fuller,executive,PERSON-PERSON,TITLE,PROPN-PROPN,NOUN,compound-pobj,pobj,NNP-NNP,NN,2,1
6043,16418.0,36,left,10,2,34,32,1,1,8,24,DeBlanc,St. Martinville,PERSON,LOCATION-LOCATION,PROPN,PROPN-PROPN,nsubj,compound-pobj,NNP,NNP-NNP,6,1
6044,16419.0,26,is,15,17,2,-15,16,23,-2,-13,CC,one,ORGANIZATION,NUMBER,PROPN,NUM,attr,nsubj,NNP,CD,4,1
6045,16433.0,88,are,1,39,45,6,38,42,-38,44,Jennifer Dunn,congresswoman,PERSON-PERSON,TITLE,PROPN-PROPN,NOUN,compound-conj,appos,NNP-NNP,NN,2,1
6046,16436.0,39,was,13,13,16,3,12,22,0,3,Dent,architect,PERSON,TITLE,PROPN,NOUN,nsubj,attr,NNP,NN,2,1
6047,16442.0,20,Buchwald,0,1,14,13,0,5,-1,14,Buchwald,Pacific,PERSON,LOCATION,PROPN,PROPN,ROOT,compound,NNP,NNP,4,1
6048,16445.0,21,'s,1,3,6,3,2,14,-2,5,Waldheim,intelligence officer,PERSON,TITLE-TITLE,PROPN,NOUN-NOUN,attr,compound-appos,NNP,NN-NN,2,1
6049,16451.0,32,saw,12,8,6,-2,7,25,4,-6,Gholam Ali Haddad Adel,Tehran,PERSON-PERSON-PERSON-PERSON,LOCATION,PROPN-PROPN-PROPN-PROPN,PROPN,compound-compound-compound-appos,pobj,NNP-NNP-NNP-NNP,NNP,5,1
6050,16467.0,24,said,22,2,21,19,1,2,20,-1,Czech National Bank,Pavlina Bolfova,ORGANIZATION-ORGANIZATION-ORGANIZATION,PERSON-PERSON,PROPN-PROPN-PROPN,PROPN-PROPN,compound-compound-nsubj,compound-nsubj,NNP-NNP-NNP,NNP-NNP,4,1
6051,16479.0,47,describe,5,7,30,23,6,16,-2,25,him,Peshawar,PERSON,CITY,PRON,PROPN,dobj,pobj,PRP,NNP,7,1
6052,16481.0,41,noted,1,34,24,-10,33,16,-33,23,Mainland Affairs Council,her,ORGANIZATION-ORGANIZATION-ORGANIZATION,PERSON,PROPN-PROPN-PROPN,DET,compound-compound-pobj,poss,NNP-NNPS-NNP,PRP$,7,1
6053,16492.0,48,explained,26,39,28,-11,38,19,-13,2,NCF,Jessica Chen,ORGANIZATION,PERSON-PERSON,PROPN,PROPN-PROPN,compound,compound-nsubj,NNP,NNP-NNP,3,1
6054,21207.0,39,stressed,14,20,16,-4,19,22,-6,2,NCF,Jessica Chen,ORGANIZATION,PERSON-PERSON,PROPN,PROPN-PROPN,compound,compound-nsubj,NNP,NNP-NNP,2,1
6055,16493.0,28,died,21,1,16,15,0,11,20,-5,Sills,Lincoln Center,PERSON,ORGANIZATION-ORGANIZATION,NOUN,PROPN-PROPN,nsubj,compound-pobj,NNS,NNP-NNP,5,1
6056,32567.0,31,died,24,1,19,18,0,11,23,-5,Sills,Lincoln Center,PERSON,ORGANIZATION-ORGANIZATION,NOUN,PROPN-PROPN,nsubj,compound-pobj,NNS,NNP-NNP,7,1
6057,16503.0,22,said,13,9,15,6,8,6,4,2,Servicemembers Legal Defense Network,he,ORGANIZATION-ORGANIZATION-ORGANIZATION-ORGANIZATION,PERSON,PROPN-PROPN-PROPN-PROPN,PRON,compound-compound-compound-pobj,nsubj,NNP-NNP-NNP-NNP,PRP,7,1
6058,34027.0,32,said,13,9,15,6,8,16,4,2,Servicemembers Legal Defense Network,he,ORGANIZATION-ORGANIZATION-ORGANIZATION-ORGANIZATION,PERSON,PROPN-PROPN-PROPN-PROPN,PRON,compound-compound-compound-pobj,nsubj,NNP-NNP-NNP-NNP,PRP,7,1
6059,37206.0,48,ask,31,8,36,28,7,11,23,5,Servicemembers Legal Defense Network,he,ORGANIZATION-ORGANIZATION-ORGANIZATION-ORGANIZATION,PERSON,PROPN-PROPN-PROPN-PROPN,PRON,compound-compound-compound-pobj,nsubj,NNP-NNP-NNP-NNP,PRP,9,1
6060,16508.0,33,says,18,31,20,-11,30,12,-13,2,Haifa University,Shlomo Getz,ORGANIZATION-ORGANIZATION,PERSON-PERSON,PROPN-PROPN,PROPN-PROPN,compound-pobj,compound-nsubj,NNP-NNP,NNP-NNP,7,1
6061,16509.0,43,said,41,3,2,-1,2,40,38,-39,Crown Prosecution Service,Norfolk,ORGANIZATION-ORGANIZATION-ORGANIZATION,COUNTRY,PROPN-PROPN-PROPN,PROPN,compound-compound-nsubj,compound,NNP-NNP-NNP,NNP,2,1
6062,16516.0,34,mocked,1,1,17,16,0,16,0,16,Khamenei,Iraq,PERSON,COUNTRY,PROPN,PROPN,nsubj,pobj,NNP,NNP,2,1
6063,16518.0,38,said,26,31,28,-3,30,9,-5,2,Royal Caribbean,Rich Pruitt,ORGANIZATION-ORGANIZATION,PERSON-PERSON,PROPN-PROPN,PROPN-PROPN,compound-poss,compound-nsubj,NNP-NNP,NNP-NNP,2,1
6064,16523.0,41,include,16,38,35,-3,37,5,-22,19,AQR Capital Management,Clifford Asness,ORGANIZATION-ORGANIZATION-ORGANIZATION,PERSON-PERSON,PROPN-PROPN-PROPN,PROPN-PROPN,compound-compound-pobj,compound-conj,NNP-NNP-NNP,NNP-NNP,4,1
6065,42365.0,44,said,20,28,22,-6,27,21,-8,2,AQR Capital Management,Clifford Asness,ORGANIZATION-ORGANIZATION-ORGANIZATION,PERSON-PERSON,PROPN-PROPN-PROPN,PROPN-PROPN,compound-compound-pobj,compound-nsubj,NNP-NNP-NNP,NNP-NNP,2,1
6066,16524.0,25,was,5,2,14,12,1,10,3,9,her,Albert Einstein College of Medicine of Yeshiva University,PERSON,ORGANIZATION-ORGANIZATION-ORGANIZATION-ORGANIZATION-ORGANIZATION-ORGANIZATION-ORGANIZATION-ORGANIZATION,DET,PROPN-PROPN-PROPN-ADP-PROPN-ADP-PROPN-PROPN,poss,compound-compound-pobj-prep-pobj-prep-compound-pobj,PRP$,NNP-NNP-NNP-IN-NNP-IN-NNP-NNP,6,1
6067,16529.0,11,Shah,1,1,5,4,0,5,0,4,Mahmood Shah,chief of security,PERSON-PERSON,TITLE-TITLE-TITLE,PROPN-PROPN,NOUN-ADP-NOUN,compound-ROOT,appos-prep-pobj,NNP-NNP,NN-IN-NN,2,1
6068,16535.0,75,Television,2,1,1,0,0,73,1,-1,Samsung LTM,Samsung,ORGANIZATION-ORGANIZATION,ORGANIZATION,PROPN-PROPN,PROPN,compound-ROOT,amod,NNP-NNP,NNP,0,1
6069,16543.0,28,told,8,12,1,-11,11,26,-4,-7,he,University of South Florida,PERSON,ORGANIZATION-ORGANIZATION-ORGANIZATION-ORGANIZATION,PRON,PROPN-ADP-PROPN-PROPN,nsubj,nmod-prep-compound-pobj,PRP,NNP-IN-NNP-NNP,6,1
6070,16549.0,9,dons,3,2,1,-1,1,7,1,-2,Chad White,Model,PERSON-PERSON,TITLE,PROPN-PROPN,PROPN,compound-nsubj,compound,NNP-NNP,NNP,1,1
6071,16551.0,29,said,16,28,25,-3,27,3,-12,9,APA,Arlington,ORGANIZATION,CITY,PROPN,PROPN,pobj,nmod,NNP,NNP,5,1
6072,16556.0,34,seen,7,3,5,2,2,28,4,-2,her,Guy Ritchie,PERSON,PERSON-PERSON,DET,PROPN-PROPN,poss,compound-conj,PRP$,NNP-NNP,1,1
6073,39436.0,45,recommended,27,17,20,3,16,24,10,-7,her,Guy Ritchie,PERSON,PERSON-PERSON,DET,PROPN-PROPN,poss,compound-conj,PRP$,NNP-NNP,2,1
6074,16557.0,19,said,7,9,5,-4,8,13,-2,-2,his,blood disorder,PERSON,CAUSE_OF_DEATH-CAUSE_OF_DEATH,DET,NOUN-NOUN,poss,compound-attr,PRP$,NN-NN,3,1
6075,16568.0,22,earned,7,7,19,12,6,2,0,12,ElBaradei,University of Cairo,PERSON,ORGANIZATION-ORGANIZATION-ORGANIZATION,PROPN,PROPN-ADP-PROPN,nsubj,pobj-prep-pobj,NNP,NNP-IN-NNP,3,1
6076,16573.0,16,born,4,1,13,12,0,2,3,9,Jane Matilda Bolin,Poughkeepsie,PERSON-PERSON-PERSON,CITY,PROPN-PROPN-PROPN,PROPN,compound-compound-nsubjpass,pobj,NNP-NNP-NNP,NNP,5,1
6077,37861.0,16,born,4,1,13,12,0,2,3,9,Jane Matilda Bolin,Poughkeepsie,PERSON-PERSON-PERSON,CITY,PROPN-PROPN-PROPN,PROPN,compound-compound-nsubjpass,pobj,NNP-NNP-NNP,NNP,5,1
6078,16578.0,48,said,5,10,14,4,9,33,-5,9,Independent Steelworkers Union,Weirton,ORGANIZATION-ORGANIZATION-ORGANIZATION,CITY,PROPN-PROPN-PROPN,PROPN,compound-compound-nsubj,pobj,NNP-NNPS-NNP,NNP,2,1
6079,19107.0,48,said,20,29,45,16,28,2,-9,25,Independent Steelworkers Union,Weirton,ORGANIZATION-ORGANIZATION-ORGANIZATION,CITY,PROPN-PROPN-PROPN,PROPN,compound-compound-pobj,pobj,NNP-NNPS-NNP,NNP,8,1
6080,28898.0,36,voted,24,4,20,16,3,15,20,-4,Independent Steelworkers Union,Weirton,ORGANIZATION-ORGANIZATION-ORGANIZATION,CITY,PROPN-PROPN-PROPN,PROPN,compound-compound-pobj,pobj,NNP-NNPS-NNP,NNP,10,1
6081,62575.0,38,seized,1,34,23,-11,33,14,-33,22,Independent Steelworkers Union,Weirton,ORGANIZATION-ORGANIZATION-ORGANIZATION,ORGANIZATION,PROPN-PROPN-PROPN,PROPN,compound-compound-conj,compound,NNP-NNPS-NNP,NNP,7,1
6082,16583.0,30,survived,9,8,6,-2,7,23,1,-3,DeBlanc,Frank,PERSON,PERSON,PROPN,PROPN,nsubjpass,appos,NNP,NNP,2,1
6083,16601.0,15,said,13,1,4,3,0,10,12,-9,Kaiser,aspiration pneumonia,PERSON,CAUSE_OF_DEATH-CAUSE_OF_DEATH,PROPN,NOUN-NOUN,nsubj,compound-pobj,NNP,NN-NN,2,1
6084,16611.0,37,reported,35,1,7,6,0,29,34,-28,Millender-McDonald,September 1938,PERSON,DATE-DATE,PROPN,PROPN-NUM,nsubj,pobj-nummod,NNP,NNP-CD,3,1
6085,16624.0,13,dies,11,7,6,-1,6,6,4,-5,Oscar Peterson,virtuoso,PERSON-PERSON,TITLE,PROPN-PROPN,NOUN,compound-appos,compound,NNP-NNP,NN,1,1
6086,16627.0,8,bought,3,5,3,-2,4,4,-2,0,Lucent,Alcatel,ORGANIZATION,ORGANIZATION,PROPN,PROPN,dobj,nsubj,NNP,NNP,2,1
6087,60960.0,22,formed,2,13,11,-2,12,10,-11,9,Lucent,Alcatel,ORGANIZATION,ORGANIZATION,PROPN,PROPN,pobj,pobj,NNP,NNP,2,1
6088,16629.0,53,said,34,36,4,-32,35,48,-2,-30,David Gregory,president,PERSON-PERSON,TITLE,PROPN-PROPN,NOUN,compound-nsubj,attr,NNP-NNP,NN,3,1
6089,16630.0,19,said,6,8,14,6,7,4,-2,8,Christopher Bentley,U.S. Citizenship and Immigration Services,PERSON-PERSON,ORGANIZATION-ORGANIZATION-ORGANIZATION-ORGANIZATION-ORGANIZATION,PROPN-PROPN,PROPN-PROPN-CCONJ-PROPN-PROPN,compound-nsubj,nmod-nmod-cc-conj-pobj,NNP-NNP,NNP-NNP-CC-NNP-NNPS,4,1
6090,16639.0,30,says,15,8,12,4,7,17,7,-3,AQR Capital Management,Greenwich,ORGANIZATION-ORGANIZATION-ORGANIZATION,CITY,PROPN-PROPN-PROPN,PROPN,compound-compound-pobj,pobj,NNP-NNP-NNP,NNP,4,1
6091,23273.0,50,is,1,25,34,9,24,15,-24,33,AQR Capital Management,Greenwich,ORGANIZATION-ORGANIZATION-ORGANIZATION,CITY,PROPN-PROPN-PROPN,PROPN,compound-compound-pobj,pobj,NNP-NNP-NNP,NNP,3,1
6092,32285.0,30,says,15,8,12,4,7,17,7,-3,AQR Capital Management,Greenwich,ORGANIZATION-ORGANIZATION-ORGANIZATION,CITY,PROPN-PROPN-PROPN,PROPN,compound-compound-pobj,pobj,NNP-NNP-NNP,NNP,4,1
6093,45538.0,23,began,2,11,20,9,10,2,-9,18,AQR Capital Management,Greenwich,ORGANIZATION-ORGANIZATION-ORGANIZATION,CITY,PROPN-PROPN-PROPN,PROPN,compound-compound-pobj,pobj,NNP-NNP-NNP,NNP,5,1
6094,64898.0,26,said,10,19,23,4,18,2,-9,13,AQR Capital Management,Greenwich,ORGANIZATION-ORGANIZATION-ORGANIZATION,CITY,PROPN-PROPN-PROPN,PROPN,compound-compound-pobj,pobj,NNP-NNP-NNP,NNP,3,1
6095,67995.0,42,said,40,10,18,8,9,23,30,-22,AQR Capital Management,Greenwich,ORGANIZATION-ORGANIZATION-ORGANIZATION,CITY,PROPN-PROPN-PROPN,PROPN,compound-compound-appos,pobj,NNP-NNP-NNP,NNP,6,1
6096,16646.0,37,dissect,23,7,26,19,6,10,16,3,Chavez,president,PERSON,TITLE,PROPN,NOUN,pobj,poss,NNP,NN,10,1
6097,16649.0,7,was,3,1,3,2,0,3,2,0,Her,Fidel,PERSON,PERSON,DET,PROPN,poss,appos,PRP$,NNP,1,1
6098,16659.0,43,found,41,39,31,-8,38,11,2,-10,University of Haifa,Center for Brain and Behavior Research,ORGANIZATION-ORGANIZATION-ORGANIZATION,ORGANIZATION-ORGANIZATION-ORGANIZATION-ORGANIZATION-ORGANIZATION-ORGANIZATION,PROPN-ADP-PROPN,PROPN-ADP-PROPN-CCONJ-PROPN-PROPN,pobj-prep-pobj,pobj-prep-pobj-cc-conj-dobj,NNP-IN-NNP,NNP-IN-NNP-CC-NNP-NNP,4,1
6099,16668.0,37,led,26,28,16,-12,27,20,-2,-10,Bellecourt,Clyde,PERSON,PERSON,PROPN,PROPN,dobj,appos,NNP,NNP,10,1
6100,16675.0,26,started,12,5,15,10,4,10,7,3,Goodman,Andrew Goodman Foundation,PERSON,ORGANIZATION-ORGANIZATION-ORGANIZATION,PROPN,PROPN-PROPN-PROPN,nsubj,compound-compound-dobj,NNP,NNP-NNP-NNP,4,1
6101,16676.0,12,dies,6,4,3,-1,3,8,2,-3,Jo Ann Davis,congresswoman,PERSON-PERSON-PERSON,TITLE,PROPN-PROPN-PROPN,NOUN,compound-compound-nsubj,compound,NNP-NNP-NNP,NN,2,1
6102,20633.0,25,dies,6,4,3,-1,3,21,2,-3,Jo Ann Davis,congresswoman,PERSON-PERSON-PERSON,TITLE,PROPN-PROPN-PROPN,NOUN,compound-compound-nsubj,compound,NNP-NNP-NNP,NN,2,1
6103,16686.0,29,said,7,6,12,6,5,16,1,5,National Beef/JBS-Swift,Tim Klein,ORGANIZATION-ORGANIZATION,PERSON-PERSON,PROPN-PROPN,PROPN-PROPN,nmod-compound,compound-appos,NNP-NNP,NNP-NNP,4,1
6104,16692.0,24,entered,8,1,3,2,0,20,7,-5,FirstGroup,Britain,ORGANIZATION,COUNTRY,PROPN,PROPN,nsubj,poss,NNP,NNP,4,1
6105,19412.0,31,has,21,1,5,4,0,25,20,-16,FirstGroup,Britain,ORGANIZATION,COUNTRY,PROPN,PROPN,nsubj,poss,NNP,NNP,6,1
6106,25867.0,32,pay,9,1,3,2,0,28,8,-6,FirstGroup,Britain,ORGANIZATION,COUNTRY,PROPN,PROPN,nsubj,poss,NNP,NNP,4,1
6107,30059.0,20,is,1,1,8,7,0,11,0,7,FirstGroup,Britain,ORGANIZATION,COUNTRY,PROPN,PROPN,nsubj,pobj,NNP,NNP,1,1
6108,40238.0,34,announced,11,11,6,-5,10,27,0,-5,FirstGroup,Britain,ORGANIZATION,COUNTRY,PROPN,PROPN,appos,poss,NNP,NNP,3,1
6109,50336.0,31,has,21,1,5,4,0,25,20,-16,FirstGroup,Britain,ORGANIZATION,COUNTRY,PROPN,PROPN,nsubj,pobj,NNP,NNP,6,1
6110,16699.0,20,is,8,12,11,-1,11,8,-4,3,Chad White,Rev.,PERSON-PERSON,TITLE,PROPN-PROPN,PROPN,compound-attr,compound,NNP-NNP,NNP,1,1
6111,16706.0,29,contrasted,17,13,15,2,12,13,4,-2,Larijani,49,PERSON,NUMBER,PROPN,NUM,pobj,appos,NNP,CD,3,1
6112,16712.0,12,Schatzberg,3,9,2,-7,8,9,-6,-1,American Psychiatric Association,Alan F. Schatzberg,ORGANIZATION-ORGANIZATION-ORGANIZATION,PERSON-PERSON-PERSON,PROPN-PROPN-PROPN,PROPN-PROPN-PROPN,compound-compound-pobj,compound-compound-ROOT,NNP-NNP-NNP,NNP-NNP-NNP,5,1
6113,16717.0,35,found,14,9,13,4,8,21,5,-1,University of Haifa,Jewish-Arab Center,ORGANIZATION-ORGANIZATION-ORGANIZATION,ORGANIZATION-ORGANIZATION,PROPN-ADP-PROPN,PROPN-PROPN,poss-prep-pobj,compound-pobj,NNP-IN-NNP,NNP-NNP,3,1
6114,16723.0,41,said,5,4,1,-3,3,39,1,-4,Alberto Gonzales,U.S.,PERSON-PERSON,COUNTRY,PROPN-PROPN,PROPN,compound-nsubj,nsubj,NNP-NNP,NNP,2,1
6115,22254.0,37,expressed,5,25,1,-24,24,35,-20,-4,Alberto Gonzales,U.S.,PERSON-PERSON,COUNTRY,PROPN-PROPN,PROPN,compound-pobj,compound,NNP-NNP,NNP,9,1
6116,24433.0,24,said,8,7,4,-3,6,19,1,-4,Alberto Gonzales,U.S.,PERSON-PERSON,COUNTRY,PROPN-PROPN,PROPN,compound-nsubj,compound,NNP-NNP,NNP,2,1
6117,16726.0,20,told,17,1,7,6,0,12,16,-10,Jamie Lynn Spears,Nickelodeon,PERSON-PERSON-PERSON,ORGANIZATION,PROPN-PROPN-PROPN,PROPN,compound-compound-nsubj,poss,NNP-NNP-NNP,NNP,6,1
6118,16730.0,23,said,5,1,4,3,0,18,4,-1,Haifa University,Aharon Ben-Zeev,ORGANIZATION-ORGANIZATION,PERSON-PERSON,PROPN-PROPN,PROPN-PROPN,compound-compound,nsubj-punct,NNP-NNP,NNP-NNP,3,1
6119,16737.0,25,Watson,2,2,5,3,1,19,0,3,Paul Watson,Sea Shepard/ex-Greenpeace,PERSON-PERSON,ORGANIZATION-ORGANIZATION,PROPN-PROPN,PROPN-PROPN,compound-ROOT,compound-appos,NNP-NNP,NNP-NNP,2,1
6120,16743.0,14,said,5,3,8,5,2,5,2,3,Kerry,VA,PERSON,ORGANIZATION,PROPN,PROPN,nsubj,nsubj,NNP,NNP,4,1
6121,16752.0,16,is,9,1,12,11,0,3,8,3,His,Sharif University,PERSON,ORGANIZATION-ORGANIZATION,DET,PROPN-PROPN,poss,compound-pobj,PRP$,NNP-NNP,4,1
6122,16758.0,37,said,24,24,35,11,23,1,0,11,Watson,New Brunswick,PERSON,STATE_OR_PROVINCE-STATE_OR_PROVINCE,PROPN,PROPN-PROPN,nsubj,compound-appos,NNP,NNP-NNP,7,1
6123,16783.0,56,reshaped,7,7,46,39,6,9,0,39,Washburn,Mass.,PERSON,STATE_OR_PROVINCE,PROPN,PROPN,nsubj,appos,NNP,NNP,4,1
6124,16820.0,10,dresses,4,3,2,-1,2,7,1,-2,Chad White,Supermodel,PERSON-PERSON,TITLE,PROPN-PROPN,PROPN,compound-nsubj,compound,NNP-NNP,NNP,1,1
6125,16831.0,42,said,21,10,19,9,9,22,11,-2,Badr Organization,Supreme Council,ORGANIZATION-ORGANIZATION,ORGANIZATION-ORGANIZATION,PROPN-PROPN,PROPN-PROPN,compound-dobj,compound-pobj,NNP-NNP,NNP-NNP,8,1
6126,16834.0,22,told,1,1,14,13,0,7,0,13,Wildmon,Tim,PERSON,PERSON,PROPN,PROPN,nsubj,appos,NNP,NNP,2,1
6127,16842.0,16,replaced,3,13,6,-7,12,9,-10,3,Alcatel,Hubert De Pesquidoux,ORGANIZATION,PERSON-PERSON-PERSON,PROPN,PROPN-PROPN-PROPN,compound,compound-compound-pobj,NNP,NNP-NNP-NNP,7,1
6128,16847.0,27,is,1,1,17,16,0,9,0,16,Carnival,Holland America Line,ORGANIZATION,ORGANIZATION-ORGANIZATION-ORGANIZATION,PROPN,PROPN-PROPN-PROPN,compound,compound-compound-conj,NNP,NNP-NNP-NNP,7,1
6129,46512.0,30,predicts,15,1,8,7,0,21,14,-7,Carnival,Holland America Line,ORGANIZATION,ORGANIZATION-ORGANIZATION-ORGANIZATION,PROPN,PROPN-PROPN-PROPN,nsubj,compound-compound-conj,NNP,NNP-NNP-NNP,5,1
6130,16848.0,25,House,8,7,7,0,6,17,1,-1,Kentucky State House of Representatives,Kentucky,ORGANIZATION-ORGANIZATION-ORGANIZATION-ORGANIZATION-ORGANIZATION,STATE_OR_PROVINCE,PROPN-PROPN-PROPN-ADP-PROPN,PROPN,appos-compound-ROOT-prep-pobj,pobj,NNP-NNP-NNP-IN-NNPS,NNP,0,1
6131,16885.0,34,is,4,4,2,-2,3,31,0,-2,native,57-year-old,PERSON,NUMBER,NOUN,NUM,nsubj,nummod,NN,CD,3,1
6132,16887.0,25,include,5,10,9,-1,9,15,-5,4,Simon Cowell,judge,PERSON-PERSON,TITLE,PROPN-PROPN,NOUN,compound-dobj,appos,NNP-NNP,NN,1,1
6133,18298.0,37,reports,1,21,26,5,20,10,-20,25,Simon Cowell,judge,PERSON-PERSON,TITLE,PROPN-PROPN,NOUN,compound-dobj,appos,NNP-NNP,NN,3,1
6134,21897.0,31,said,29,10,9,-1,9,21,19,-20,Simon Cowell,judge,PERSON-PERSON,TITLE,PROPN-PROPN,NOUN,compound-dobj,ccomp,NNP-NNP,NN,2,1
6135,30554.0,38,ANGELES,1,16,15,-1,15,22,-15,14,Simon Cowell,judge,PERSON-PERSON,TITLE,PROPN-PROPN,NOUN,compound-dobj,ccomp,NNP-NNP,NN,2,1
6136,33082.0,23,preview,1,10,9,-1,9,13,-9,8,Simon Cowell,judge,PERSON-PERSON,TITLE,PROPN-PROPN,NOUN,compound-poss,compound,NNP-NNP,NN,1,1
6137,34058.0,22,responded,6,5,3,-2,4,18,1,-3,Simon Cowell,judge,PERSON-PERSON,TITLE,PROPN-PROPN,NOUN,compound-nsubj,npadvmod,NNP-NNP,NN,2,1
6138,34812.0,37,was,1,26,25,-1,25,11,-25,24,Simon Cowell,judge,PERSON-PERSON,TITLE,PROPN-PROPN,NOUN,compound-dobj,compound,NNP-NNP,NN,1,1
6139,35188.0,59,Labels,0,32,31,-1,31,27,-32,31,Simon Cowell,judge,PERSON-PERSON,TITLE,PROPN-PROPN,NOUN,compound-pobj,compound,NNP-NNP,NN,2,1
6140,61774.0,63,Picks,2,1,20,19,0,42,1,18,Simon Cowell,judge,PERSON-PERSON,TITLE,PROPN-PROPN,NOUN,compound-nsubj,compound,NNP-NNP,NN,-1,1
6141,62289.0,24,Number,2,10,9,-1,9,14,-8,7,Simon Cowell,judge,PERSON-PERSON,TITLE,PROPN-PROPN,NOUN,compound-appos,compound,NNP-NNP,NN,1,1
6142,64806.0,32,raised,2,21,20,-1,20,11,-19,18,Simon Cowell,judge,PERSON-PERSON,TITLE,PROPN-PROPN,NOUN,compound-pobj,compound,NNP-NNP,NN,2,1
6143,67643.0,28,judge,6,8,7,-1,7,20,-2,1,Simon Cowell,judge,PERSON-PERSON,TITLE,PROPN-PROPN,NOUN,compound-poss,ROOT,NNP-NNP,NN,3,1
6144,16897.0,13,was,1,1,4,3,0,8,0,3,Verity,lieutenant,PERSON,TITLE,PROPN,NOUN,nsubj,attr,NNP,NN,2,1
6145,16898.0,34,acquired,6,13,5,-8,12,28,-7,-1,DirecTV,Liberty Media,ORGANIZATION,PERSON-PERSON,NOUN,PROPN-PROPN,pobj,compound-nsubj,NN,NNP-NNP,2,1
6146,44248.0,36,------,0,10,2,-8,9,33,-10,2,DirecTV,Liberty Media,ORGANIZATION,PERSON-PERSON,NOUN,PROPN-PROPN,pobj,compound-nsubj,NN,NNP-NNP,2,1
6147,16906.0,32,Federation,3,6,2,-4,5,29,-3,-1,FMF,Mexican Football Federation,ORGANIZATION,ORGANIZATION-ORGANIZATION-ORGANIZATION,PROPN,PROPN-PROPN-PROPN,compound,compound-compound-ROOT,NNP,NNP-NNP-NNP,4,1
6148,20023.0,29,fined,4,12,8,-4,11,20,-8,4,FMF,Mexican Football Federation,ORGANIZATION,ORGANIZATION-ORGANIZATION-ORGANIZATION,PROPN,PROPN-PROPN-PROPN,compound,compound-compound-pobj,NNP,NNP-NNP-NNP,4,1
6149,23902.0,33,Federation,3,6,2,-4,5,30,-3,-1,FMF,Mexican Football Federation,ORGANIZATION,ORGANIZATION-ORGANIZATION-ORGANIZATION,PROPN,PROPN-PROPN-PROPN,compound,compound-compound-ROOT,NNP,NNP-NNP-NNP,3,1
6150,16918.0,52,Mahandra,0,15,34,19,14,17,-15,34,Bryan Fuller,ABC,PERSON-PERSON,ORGANIZATION,PROPN-PROPN,PROPN,compound-nsubj,poss,NNP-NNP,NNP,4,1
6151,17036.0,37,get,17,29,12,-17,28,24,-12,-5,Bryan Fuller,ABC,PERSON-PERSON,ORGANIZATION,PROPN-PROPN,PROPN,compound-poss,nsubj,NNP-NNP,NNP,9,1
6152,21715.0,42,had,5,12,27,15,11,14,-7,22,Bryan Fuller,ABC,PERSON-PERSON,ORGANIZATION,PROPN-PROPN,PROPN,compound-pobj,appos,NNP-NNP,NNP,6,1
6153,16929.0,49,referring,2,11,16,5,10,32,-9,14,Taiwan Research Institute,Chinese Academy of Social Science,ORGANIZATION-ORGANIZATION-ORGANIZATION,ORGANIZATION-ORGANIZATION-ORGANIZATION-ORGANIZATION-ORGANIZATION,PROPN-PROPN-PROPN,PROPN-PROPN-ADP-PROPN-PROPN,compound-compound-pobj,compound-pobj-prep-compound-pobj,NNP-NNP-NNP,NNP-NNP-IN-NNP-NNP,5,1
6154,16952.0,30,are,5,24,20,-4,23,9,-19,15,Red Sox,Boston,ORGANIZATION-ORGANIZATION,CITY,PROPN-PROPN,PROPN,compound-compound,pobj,NNP-NNPS,NNP,4,1
6155,28549.0,41,adds,33,30,29,-1,29,11,3,-4,Red Sox,Boston,ORGANIZATION-ORGANIZATION,CITY,PROPN-PROPN,PROPN,compound-appos,compound,NNP-NNPS,NNP,1,1
6156,29052.0,36,considered,31,4,3,-1,3,32,27,-28,Red Sox,Boston,ORGANIZATION-ORGANIZATION,CITY,PROPN-PROPN,PROPN,compound-nsubj,compound,NNP-NNP,NNP,1,1
6157,45426.0,40,said,2,11,20,9,10,19,-9,18,Red Sox,Boston,ORGANIZATION-ORGANIZATION,CITY,PROPN-PROPN,PROPN,compound-nsubj,pobj,NNP-NNPS,NNP,6,1
6158,53466.0,36,sparked,5,28,14,-14,27,21,-23,9,Red Sox,Boston,ORGANIZATION-ORGANIZATION,CITY,PROPN-PROPN,PROPN,compound-appos,pobj,NNP-NNPS,NNP,10,1
6159,57613.0,29,Result,0,17,16,-1,16,12,-17,16,Red Sox,Boston,ORGANIZATION-ORGANIZATION,CITY,PROPN-PROPN,PROPN,compound-ROOT,compound,NNP-NNP,NNP,1,1
6160,60934.0,13,play,3,7,6,-1,6,6,-4,3,Red Sox,Boston,ORGANIZATION-ORGANIZATION,CITY,PROPN-PROPN,PROPN,compound-dobj,compound,NNP-NNPS,NNP,1,1
6161,63133.0,28,Baseball,0,7,6,-1,6,21,-7,6,Red Sox,Boston,ORGANIZATION-ORGANIZATION,CITY,PROPN-PROPN,PROPN,compound-nmod,compound,NNP-NNPS,NNP,1,1
6162,16961.0,24,said,11,19,22,3,18,1,-8,11,MF Global,New York,ORGANIZATION-ORGANIZATION,STATE_OR_PROVINCE-STATE_OR_PROVINCE,PROPN-PROPN,PROPN-PROPN,compound-pobj,compound-pobj,NNP-NNP,NNP-NNP,4,1
6163,18990.0,48,said,13,24,27,3,23,20,-11,14,MF Global,New York,ORGANIZATION-ORGANIZATION,STATE_OR_PROVINCE-STATE_OR_PROVINCE,PROPN-PROPN,PROPN-PROPN,compound-pobj,compound-pobj,NNP-NNP,NNP-NNP,4,1
6164,20171.0,39,said,25,34,37,3,33,1,-9,12,MF Global,New York,ORGANIZATION-ORGANIZATION,STATE_OR_PROVINCE-STATE_OR_PROVINCE,PROPN-PROPN,PROPN-PROPN,compound-pobj,compound-pobj,NNP-NNP,NNP-NNP,4,1
6165,23708.0,33,said,13,8,11,3,7,21,5,-2,MF Global,New York,ORGANIZATION-ORGANIZATION,STATE_OR_PROVINCE-STATE_OR_PROVINCE,PROPN-PROPN,PROPN-PROPN,compound-pobj,compound-pobj,NNP-NNP,NNP-NNP,2,1
6166,48461.0,46,said,30,41,44,3,40,1,-11,14,MF Global,New York,ORGANIZATION-ORGANIZATION,STATE_OR_PROVINCE-STATE_OR_PROVINCE,PROPN-PROPN,PROPN-PROPN,compound-pobj,compound-pobj,NNP-NNP,NNP-NNP,4,1
6167,61299.0,48,said,13,8,11,3,7,36,5,-2,MF Global,New York,ORGANIZATION-ORGANIZATION,STATE_OR_PROVINCE-STATE_OR_PROVINCE,PROPN-PROPN,PROPN-PROPN,compound-pobj,compound-pobj,NNP-NNP,NNP-NNP,2,1
6168,66050.0,44,said,34,39,42,3,38,1,-5,8,MF Global,New York,ORGANIZATION-ORGANIZATION,STATE_OR_PROVINCE-STATE_OR_PROVINCE,PROPN-PROPN,PROPN-PROPN,compound-pobj,compound-pobj,NNP-NNP,NNP-NNP,4,1
6169,16962.0,34,told,1,12,8,-4,11,25,-11,7,NSC,National Sports Commission,ORGANIZATION,ORGANIZATION-ORGANIZATION-ORGANIZATION,PROPN,PROPN-PROPN-PROPN,compound,compound-compound-pobj,NNP,NNP-NNPS-NNP,2,1
6170,53809.0,29,Commission,4,7,3,-4,6,25,-3,-1,NSC,National Sports Commission,ORGANIZATION,ORGANIZATION-ORGANIZATION-ORGANIZATION,PROPN,PROPN-PROPN-PROPN,compound,compound-compound-ROOT,NNP,NNP-NNPS-NNP,3,1
6171,64734.0,37,told,26,21,17,-4,20,19,5,-9,NSC,National Sports Commission,ORGANIZATION,ORGANIZATION-ORGANIZATION-ORGANIZATION,PROPN,PROPN-PROPN-PROPN,compound,compound-compound-pobj,NNP,NNP-NNPS-NNP,3,1
6172,16968.0,37,support,5,7,10,3,6,26,-2,5,House,Bradley H Jones Jr,ORGANIZATION,PERSON-PERSON-PERSON-PERSON,PROPN,PROPN-PROPN-PROPN-PROPN,compound,compound-compound-compound-dobj,NNP,NNP-NNP-NNP-NNP,2,1
6173,16977.0,15,passed,5,3,9,6,2,5,2,4,Jo Ann Davis,Saturday,PERSON-PERSON-PERSON,DATE,PROPN-PROPN-PROPN,PROPN,compound-compound-nsubj,pobj,NNP-NNP-NNP,NNP,3,1
6174,40218.0,30,announced,28,4,18,14,3,11,24,-10,Jo Ann Davis,Saturday,PERSON-PERSON-PERSON,DATE,PROPN-PROPN-PROPN,PROPN,compound-compound-nsubj,npadvmod,NNP-NNP-NNP,NNP,4,1
6175,55558.0,34,said,32,3,21,18,2,12,29,-11,Jo Ann Davis,Saturday,PERSON-PERSON-PERSON,DATE,PROPN-PROPN-PROPN,PROPN,compound-compound-nsubj,compound,NNP-NNP-NNP,NNP,3,1
6176,16991.0,39,appointed,14,11,1,-10,10,37,3,-13,Itochu Corp,Niwa,ORGANIZATION-ORGANIZATION,PERSON,PROPN-PROPN,NOUN,compound-pobj,nsubjpass,NNP-NNP,NNS,4,1
6177,16994.0,6,ANNOUNCES,3,1,3,2,0,2,2,0,NSC,MIZRAHI,ORGANIZATION,PERSON,PROPN,PROPN,compound,nsubj,NNP,NNP,2,1
6178,16996.0,47,died,40,1,46,45,0,0,39,6,Augustus F. Hawkins,Md.,PERSON-PERSON-PERSON,STATE_OR_PROVINCE,PROPN-PROPN-PROPN,PROPN,compound-compound-nsubj,appos,NNP-NNP-NNP,NNP,3,1
6179,17006.0,39,said,25,27,34,7,26,4,-2,9,Chris Bentley,U.S. Customs,PERSON-PERSON,ORGANIZATION-ORGANIZATION,PROPN-PROPN,PROPN-PROPN,compound-nsubj,nmod-nmod,NNP-NNP,NNP-NNP,5,1
6180,17007.0,19,led,7,9,7,-2,8,11,-2,0,Sadia,Furlan,ORGANIZATION,PERSON,PROPN,PROPN,dobj,nsubj,NNP,NNP,7,1
6181,17010.0,45,said,32,43,34,-9,42,10,-11,2,Haifa University,Yitzhak Shichor,ORGANIZATION-ORGANIZATION,PERSON-PERSON,PROPN-PROPN,PROPN-PROPN,compound-pobj,compound-nsubj,NNP-NNP,NNP-NNP,5,1
6182,17019.0,30,gained,1,19,24,5,18,5,-18,23,his,Clarence Mitchell III,PERSON,PERSON-PERSON-PERSON,DET,PROPN-PROPN-PROPN,poss,compound-compound-dobj,PRP$,NNP-NNP-NNP,5,1
6183,17024.0,22,included,1,3,7,4,2,14,-2,6,James B Stewart,SmartMoney,PERSON-PERSON-PERSON,ORGANIZATION,PROPN-PROPN-PROPN,PROPN,compound-compound-dobj,compound,NNP-NNP-NNP,NNP,3,1
6184,17030.0,37,said,35,29,34,5,28,2,6,-1,U.S. National Security Council,Gordon Johndroe,ORGANIZATION-ORGANIZATION-ORGANIZATION-ORGANIZATION,PERSON-PERSON,PROPN-PROPN-PROPN-PROPN,PROPN-PROPN,compound-compound-compound-compound,compound-nsubj,NNP-NNP-NNP-NNP,NNP-NNP,4,1
6185,38407.0,27,said,25,1,24,23,0,2,24,-1,U.S. National Security Council,Gordon Johndroe,ORGANIZATION-ORGANIZATION-ORGANIZATION-ORGANIZATION,PERSON-PERSON,PROPN-PROPN-PROPN-PROPN,PROPN-PROPN,compound-compound-compound-compound,compound-nsubj,NNP-NNP-NNP-NNP,NNP-NNP,4,1
6186,56809.0,21,described,10,4,9,5,3,11,6,-1,U.S. National Security Council,Gordon Johndroe,ORGANIZATION-ORGANIZATION-ORGANIZATION-ORGANIZATION,PERSON-PERSON,PROPN-PROPN-PROPN-PROPN,PROPN-PROPN,compound-compound-compound-compound,compound-nsubj,NNP-NNP-NNP-NNP,NNP-NNP,3,1
6187,58380.0,19,said,17,11,16,5,10,2,6,-1,U.S. National Security Council,Gordon Johndroe,ORGANIZATION-ORGANIZATION-ORGANIZATION-ORGANIZATION,PERSON-PERSON,PROPN-PROPN-PROPN-PROPN,PROPN-PROPN,compound-compound-compound-compound,compound-nsubj,NNP-NNP-NNP-NNP,NNP-NNP,3,1
6188,17041.0,39,said,18,36,20,-16,35,18,-18,2,Highland Capital Partners,Thomas Stemberg,ORGANIZATION-ORGANIZATION-ORGANIZATION,PERSON-PERSON,PROPN-PROPN-PROPN,PROPN-PROPN,compound-compound-pobj,compound-nsubj,NNP-NNP-NNPS,NNP-NNP,7,1
6189,17043.0,27,said,24,23,2,-21,22,24,1,-22,Nicholas Burns,United States,PERSON-PERSON,COUNTRY-COUNTRY,PROPN-PROPN,PROPN-PROPN,compound-nsubj,compound-nsubj,NNP-NNP,NNP-NNP,3,1
6190,17054.0,52,announce,5,25,36,11,24,15,-20,31,Al Hubbard,U.s.,PERSON-PERSON,COUNTRY,PROPN-PROPN,ADJ,compound-dobj,nmod,NNP-NNP,JJ,4,1
6191,17056.0,4,was,1,1,3,2,0,0,0,2,She,91,PERSON,NUMBER,PRON,NUM,nsubj,attr,PRP,CD,1,1
6192,17063.0,29,said,12,6,11,5,5,17,6,-1,BNC Mortgage LLC,Lehman Brothers,ORGANIZATION-ORGANIZATION-ORGANIZATION,ORGANIZATION-ORGANIZATION,PROPN-PROPN-PROPN,PROPN-PROPN,compound-compound-compound,compound-nsubj,NNP-NNP-NNP,NNP-NNPS,6,1
6193,17071.0,31,said,14,23,16,-7,22,14,-9,2,Chunghwa Telecom,Wu Chih-ming,ORGANIZATION-ORGANIZATION,PERSON-PERSON,PROPN-PROPN,PROPN-PROPN,compound-pobj,compound-nsubj,NNP-NNP,NNP-NNP,3,1
6194,17072.0,24,said,8,6,3,-3,5,20,2,-5,Ali Akbar Salehi,Iranian,PERSON-PERSON-PERSON,NATIONALITY,PROPN-PROPN-PROPN,ADJ,compound-compound-nsubj,amod,NNP-NNP-NNP,JJ,3,1
6195,17858.0,34,said,6,4,1,-3,3,32,2,-5,Ali Akbar Salehi,Iranian,PERSON-PERSON-PERSON,NATIONALITY,PROPN-PROPN-PROPN,ADJ,compound-compound-nsubj,amod,NNP-NNP-NNP,JJ,3,1
6196,24476.0,36,told,12,10,8,-2,9,27,2,-4,Ali Akbar Salehi,Iranian,PERSON-PERSON-PERSON,NATIONALITY,PROPN-PROPN-PROPN,ADJ,compound-compound-nsubj,amod,NNP-NNP-NNP,JJ,3,1
6197,37659.0,31,walked,15,12,6,-6,11,24,3,-9,Ali Akbar Salehi,Iranian,PERSON-PERSON-PERSON,NATIONALITY,PROPN-PROPN-PROPN,ADJ,compound-compound-appos,amod,NNP-NNP-NNP,JJ,4,1
6198,51862.0,32,hoped,15,10,7,-3,9,24,5,-8,Ali Akbar Salehi,Iranian,PERSON-PERSON-PERSON,NATIONALITY,PROPN-PROPN-PROPN,ADJ,compound-compound-pobj,amod,NNP-NNP-NNP,JJ,3,1
6199,17075.0,57,said,32,54,40,-14,53,16,-22,8,University of Haifa,Sagy Center for Internet Research,ORGANIZATION-ORGANIZATION-ORGANIZATION,ORGANIZATION-ORGANIZATION-ORGANIZATION-ORGANIZATION-ORGANIZATION,PROPN-ADP-PROPN,PROPN-PROPN-ADP-PROPN-PROPN,pobj-prep-pobj,compound-pobj-prep-compound-pobj,NNP-IN-NNP,NNP-NNP-IN-NNP-NNP,6,1
6200,17092.0,41,replace,13,6,31,25,5,9,7,18,CNB,his,ORGANIZATION,PERSON,PROPN,DET,compound,poss,NNP,PRP$,7,1
6201,17094.0,45,changed,23,29,10,-19,28,34,-6,-13,she,Alzheimer 's disease,PERSON,CAUSE_OF_DEATH-CAUSE_OF_DEATH-CAUSE_OF_DEATH,PRON,PROPN-PART-NOUN,nsubj,poss-case-pobj,PRP,NNP-POS-NN,7,1
6202,17095.0,10,Gillmor,1,1,7,6,0,2,0,6,Paul Gillmor,U.S. Air Force,PERSON-PERSON,ORGANIZATION-ORGANIZATION-ORGANIZATION,PROPN-PROPN,PROPN-PROPN-PROPN,compound-ROOT,compound-compound-ROOT,NNP-NNP,NNP-NNP-NNP,3,1
6203,17100.0,51,separated,27,18,10,-8,17,40,9,-17,Hamilton,Hertfordshire,PERSON,STATE_OR_PROVINCE,PROPN,PROPN,nsubj,pobj,NNP,NNP,4,1
6204,27603.0,30,claims,13,1,7,6,0,22,12,-6,Hamilton,Hertfordshire,PERSON,STATE_OR_PROVINCE,PROPN,PROPN,nsubj,pobj,NNP,NNP,2,1
6205,17105.0,29,2009-10-24T05,0,10,8,-2,9,20,-10,8,Paul Sculfor,british,PERSON-PERSON,NATIONALITY,PROPN-PROPN,ADJ,compound-nsubj,amod,NNP-NNP,JJ,3,1
6206,17106.0,35,said,19,8,1,-7,7,33,11,-18,New Hampshire Institute of Politics,"Paul Manuel ,",ORGANIZATION-ORGANIZATION-ORGANIZATION-ORGANIZATION-ORGANIZATION,PERSON-PERSON-PERSON,PROPN-PROPN-PROPN-ADP-PROPN,PROPN-PROPN-PUNCT,compound-compound-pobj-prep-pobj,compound-nsubj-punct,NNP-NNP-NNP-IN-NNP,"NNP-NNP-,",4,1
6207,17114.0,49,said,13,2,6,4,1,42,11,-7,American Bankers Association,ABA,ORGANIZATION-ORGANIZATION-ORGANIZATION,ORGANIZATION,PROPN-PROPN-PROPN,PROPN,compound-compound-nsubj,compound,NNP-NNPS-NNP,NNP,3,1
6208,19632.0,34,agreed,8,30,8,-22,29,25,-22,0,American Bankers Association,ABA,ORGANIZATION-ORGANIZATION-ORGANIZATION,ORGANIZATION,PROPN-PROPN-PROPN,NOUN,compound-compound-compound,nsubj,NNP-NNPS-NNP,NN,7,1
6209,32874.0,33,issued,10,7,17,10,6,15,3,7,American Bankers Association,ABA,ORGANIZATION-ORGANIZATION-ORGANIZATION,ORGANIZATION,PROPN-PROPN-PROPN,PROPN,compound-compound-pobj,nsubj,NNP-NNPS-NNP,NNP,8,1
6210,64212.0,36,warned,8,2,6,4,1,29,6,-2,American Bankers Association,ABA,ORGANIZATION-ORGANIZATION-ORGANIZATION,ORGANIZATION,PROPN-PROPN-PROPN,PROPN,compound-compound-nsubj,compound,NNP-NNPS-NNP,NNP,2,1
6211,67655.0,25,been,7,11,15,4,10,9,-4,8,American Bankers Association,ABA,ORGANIZATION-ORGANIZATION-ORGANIZATION,ORGANIZATION,PROPN-PROPN-PROPN,PROPN,compound-compound-attr,compound,NNP-NNPS-NNP,NNP,3,1
6212,17131.0,7,congresswoman,2,4,2,-2,3,4,-2,0,Millender-McDonald,US,PERSON,COUNTRY,PROPN,PROPN,nsubj,compound,NNP,NNP,2,1
6213,17142.0,47,said,33,42,35,-7,41,11,-9,2,Federal Motor Carrier Safety Administration,Duane DeBruyne,ORGANIZATION-ORGANIZATION-ORGANIZATION-ORGANIZATION-ORGANIZATION,PERSON-PERSON,PROPN-PROPN-PROPN-PROPN-PROPN,PROPN-PROPN,compound-compound-compound-compound-pobj,compound-nsubj,NNP-NNP-NNP-NNP-NNP,NNP-NNP,5,1
6214,17143.0,33,agrees,16,8,15,7,7,17,8,-1,Norwegian University of Science and Technology,Trondheim,ORGANIZATION-ORGANIZATION-ORGANIZATION-ORGANIZATION-ORGANIZATION-ORGANIZATION,CITY,PROPN-PROPN-ADP-PROPN-CCONJ-PROPN,PROPN,compound-pobj-prep-pobj-cc-conj,pobj,NNP-NNP-IN-NNP-CC-NNP,NNP,5,1
6215,17150.0,37,was,4,3,3,0,2,33,1,-1,Ezra Levant,Ezra,PERSON-PERSON,PERSON,PROPN-PROPN,ADV,compound-nsubj,nsubj,NNP-NNP,RB,0,1
6216,17158.0,21,benefit,2,12,15,3,11,5,-10,13,Alcatel-Lucent,"22,000",ORGANIZATION,NUMBER,NOUN,NUM,pobj,nummod,NN,CD,6,1
6217,17164.0,26,December,0,5,9,4,4,16,-5,9,Jefferson DeBlanc,Pilot,PERSON-PERSON,TITLE,PROPN-PROPN,PROPN,compound-conj,conj,NNP-NNP,NNP,3,1
6218,17168.0,24,sold,7,7,2,-5,6,21,0,-5,PRCA,Ellerman,ORGANIZATION,PERSON,PROPN,PROPN,nsubj,poss,NNP,NNP,4,1
6219,55531.0,24,sold,7,7,2,-5,6,21,0,-5,PRCA,Ellerman,ORGANIZATION,PERSON,ADJ,PROPN,amod,poss,JJ,NNP,4,1
6220,17173.0,14,explains,6,5,3,-2,4,10,1,-3,Ali Fedotowsky,14,PERSON-PERSON,NUMBER,PROPN-PROPN,NUM,compound-nsubj,nummod,NNP-NNP,CD,2,1
6221,17174.0,24,Buccaneers,3,20,23,3,19,0,-17,20,NFC South,Atlanta,ORGANIZATION-ORGANIZATION,CITY,PROPN-PROPN,PROPN,compound-nsubj,dobj,NNP-NNP,NNP,10,1
6222,17176.0,40,died,18,3,2,-1,2,37,15,-16,Paul Gillmor,Representative,PERSON-PERSON,TITLE,PROPN-PROPN,PROPN,compound-nsubj,compound,NNP-NNP,NNP,1,1
6223,27256.0,40,died,18,3,2,-1,2,37,15,-16,Paul Gillmor,Representative,PERSON-PERSON,TITLE,PROPN-PROPN,PROPN,compound-nsubj,compound,NNP-NNP,NNP,1,1
6224,64587.0,28,said,4,3,2,-1,2,25,1,-2,Paul Gillmor,Representative,PERSON-PERSON,TITLE,PROPN-PROPN,NOUN,compound-nsubj,compound,NNP-NNP,NN,1,1
6225,17190.0,31,means,9,1,8,7,0,22,8,-1,Vernon Bellecourt,WaBun-Inini,PERSON-PERSON,PERSON,PROPN-PROPN,PROPN,compound-nsubj,appos,NNP-NNP,NNP,4,1
6226,46842.0,36,means,7,1,7,6,0,28,6,0,Vernon Bellecourt,WaBun-Inini,PERSON-PERSON,PERSON,PROPN-PROPN,PROPN,compound-nsubj,nsubj,NNP-NNP,NNP,4,1
6227,17207.0,28,headed,2,11,7,-4,10,20,-9,5,the United Iraqi Alliance,Abdul Aziz al-Hakim,ORGANIZATION-ORGANIZATION-ORGANIZATION-ORGANIZATION,PERSON-PERSON-PERSON,DET-PROPN-PROPN-PROPN,PROPN-PROPN-PROPN,det-compound-compound-appos,compound-compound-pobj,DT-NNP-NNP-NNP,NNP-NNP-NNP,2,1
6228,17218.0,52,died,37,1,39,38,0,12,36,2,Pamela Gardner Ahearn,March 26,PERSON-PERSON-PERSON,DATE-DATE,PROPN-PROPN-PROPN,PROPN-NUM,compound-compound-nsubj,npadvmod-nummod,NNP-NNP-NNP,NNP-CD,4,1
6229,37327.0,52,died,37,1,39,38,0,12,36,2,Pamela Gardner Ahearn,March 26,PERSON-PERSON-PERSON,DATE-DATE,PROPN-PROPN-PROPN,PROPN-NUM,compound-compound-nsubj,npadvmod-nummod,NNP-NNP-NNP,NNP-CD,4,1
6230,17222.0,42,expressed,21,8,1,-7,7,40,13,-20,MECO,Antonio Basilio,ORGANIZATION,PERSON-PERSON,NOUN,PROPN-PROPN,pobj,compound-nsubj,NNS,NNP-NNP,2,1
6231,21151.0,63,said,29,47,31,-16,46,31,-18,2,MECO,Antonio Basilio,ORGANIZATION,PERSON-PERSON,PROPN,PROPN-PROPN,compound,compound-nsubj,NNP,NNP-NNP,1,1
6232,52432.0,59,said,39,57,41,-16,56,17,-18,2,MECO,Antonio Basilio,ORGANIZATION,PERSON-PERSON,PROPN,PROPN-PROPN,compound,compound-nsubj,NNP,NNP-NNP,-1,1
6233,17237.0,44,ruled,3,22,18,-4,21,25,-19,15,Fyffes,his,ORGANIZATION,PERSON,PROPN,DET,compound,poss,NNP,PRP$,4,1
6234,39982.0,22,resigned,1,8,4,-4,7,17,-7,3,Fyffes,his,ORGANIZATION,PERSON,PROPN,DET,compound,poss,NNP,PRP$,2,1
6235,17249.0,34,did,7,31,5,-26,30,28,-24,-2,SAC,Securities Association of China,ORGANIZATION,ORGANIZATION-ORGANIZATION-ORGANIZATION-ORGANIZATION,PROPN,PROPN-PROPN-ADP-PROPN,compound,compound-pobj-prep-pobj,NNP,NNPS-NNP-IN-NNP,4,1
6236,17257.0,44,provide,11,7,29,22,6,14,4,18,Hu Sheng,Wangye,PERSON-PERSON,PERSON,PROPN-PROPN,PROPN,compound-oprd,appos,NNP-NNP,NNP,9,1
6237,17274.0,16,DATE,1,14,11,-3,13,4,-13,10,Iranian citizen,Najaf,PERSON-PERSON,CITY,ADJ-NOUN,PROPN,amod-appos,pobj,JJ-NN,NNP,4,1
6238,17300.0,21,Clinton,5,17,13,-4,16,7,-12,8,John Kerry,Secretary of Defense,PERSON-PERSON,TITLE-TITLE-TITLE,PROPN-PROPN,PROPN-ADP-PROPN,compound-conj,appos-prep-pobj,NNP-NNP,NNP-IN-NNP,3,1
6239,17308.0,35,turned,17,1,13,12,0,21,16,-4,Millender-McDonald,House Administration Committee,PERSON,ORGANIZATION-ORGANIZATION-ORGANIZATION,PROPN,PROPN-PROPN-PROPN,nsubj,compound-compound-pobj,NNP,NNP-NNP-NNP,8,1
6240,17312.0,4,was,1,1,3,2,0,0,0,2,He,75,PERSON,NUMBER,PRON,NUM,nsubj,attr,PRP,CD,1,1
6241,17322.0,32,confirmed,29,4,3,-1,3,28,25,-26,Parren J Mitchell,Rep,PERSON-PERSON-PERSON,TITLE,PROPN-PROPN-PROPN,PROPN,compound-compound-nsubj,compound,NNP-NNP-NNP,NNP,2,1
6242,17325.0,18,died,1,4,9,5,3,8,-3,8,her,Va.,PERSON,STATE_OR_PROVINCE,DET,PROPN,poss,appos,PRP$,NNP,3,1
6243,17328.0,43,tries,19,17,3,-14,16,39,2,-16,Spelman College,William Jelani Cobb,ORGANIZATION-ORGANIZATION,PERSON-PERSON-PERSON,PROPN-PROPN,PROPN-PROPN-PROPN,compound-pobj,compound-compound-appos,NNP-NNP,NNP-NNP-NNP,6,1
6244,36109.0,36,Adds,0,12,2,-10,11,33,-12,2,Spelman College,William Jelani Cobb,ORGANIZATION-ORGANIZATION,PERSON-PERSON-PERSON,PROPN-PROPN,PROPN-PROPN-PROPN,compound-pobj,compound-compound-nsubj,NNP-NNP,NNP-NNP-NNP,4,1
6245,17333.0,39,said,16,2,18,16,1,20,14,2,Spelman,Lily McNair,ORGANIZATION,PERSON-PERSON,PROPN,PROPN-PROPN,nsubj,compound-nsubj,NNP,NNP-NNP,4,1
6246,17338.0,16,2009-04-13T00,0,5,4,-1,4,11,-5,4,Susan Boyle,48-year-old,PERSON-PERSON,NUMBER,PROPN-PROPN,NUM,compound-nsubj,dep,NNP-NNP,CD,2,1
6247,21350.0,14,be,6,3,2,-1,2,11,3,-4,Susan Boyle,48-year-old,PERSON-PERSON,DURATION,PROPN-PROPN,NUM,compound-nsubj,amod,NNP-NNP,CD,1,1
6248,63900.0,63,catapulted,2,32,36,4,31,26,-30,34,Susan Boyle,48-year-old,PERSON-PERSON,DURATION,PROPN-PROPN,NUM,compound-pobj,amod,NNP-NNP,CD,5,1
6249,17340.0,46,is,7,10,37,27,9,8,-3,30,he,Transportation Committee,PERSON,ORGANIZATION-ORGANIZATION,PRON,PROPN-PROPN,nsubj,conj-conj,PRP,NNP-NNP,7,1
6250,21766.0,46,is,7,10,37,27,9,8,-3,30,he,Transportation Committee,PERSON,ORGANIZATION-ORGANIZATION,PRON,PROPN-PROPN,nsubj,conj-conj,PRP,NNP-NNP,7,1
6251,17358.0,14,Source,0,12,3,-9,11,10,-12,3,Detroit Medical Center,Steven J. Karageanes,ORGANIZATION-ORGANIZATION-ORGANIZATION,PERSON-PERSON-PERSON,PROPN-PROPN-PROPN,PROPN-PROPN-PROPN,compound-compound-pobj,compound-compound-ROOT,NNP-NNP-NNP,NNP-NNP-NNP,5,1
6252,17369.0,10,making,2,4,1,-3,3,8,-2,-1,his,He,PERSON,PERSON,DET,PRON,poss,nsubj,PRP$,PRP,3,1
6253,17374.0,92,List,1,34,1,-33,33,90,-33,0,Badr Organization,Shiite,ORGANIZATION-ORGANIZATION,ORGANIZATION,PROPN-PROPN,ADJ,compound-conj,amod,NNP-NNP,JJ,-1,1
6254,20247.0,28,blame,8,26,4,-22,25,23,-18,-4,Badr Organization,Shiite,ORGANIZATION-ORGANIZATION,RELIGION,PROPN-PROPN,ADJ,compound-conj,conj,NNP-NNP,JJ,5,1
6255,40006.0,26,was,11,2,14,12,1,11,9,3,Badr Organization,Shiite,ORGANIZATION-ORGANIZATION,RELIGION,PROPN-PROPN,ADJ,compound-nsubj,amod,NNP-NNP,JJ,2,1
6256,47408.0,54,declined,13,46,22,-24,45,31,-33,9,Badr Organization,Shiite,ORGANIZATION-ORGANIZATION,RELIGION,PROPN-PROPN,ADJ,compound-conj,amod,NNP-NNP,JJ,7,1
6257,61978.0,27,left,20,18,14,-4,17,12,2,-6,Badr Organization,Shiite,ORGANIZATION-ORGANIZATION,RELIGION,PROPN-PROPN,ADJ,compound-appos,amod,NNP-NNP,JJ,2,1
6258,17387.0,22,noted,2,5,19,14,4,2,-3,17,Irene Morgan Kirkaldy,America,PERSON-PERSON-PERSON,COUNTRY,PROPN-PROPN-PROPN,PROPN,compound-compound-nsubj,dobj,NNP-NNP-NNP,NNP,6,1
6259,17390.0,44,said,42,21,11,-10,20,32,21,-31,Nuclear Suppliers Group,Bulgaria,ORGANIZATION-ORGANIZATION-ORGANIZATION,ORGANIZATION,PROPN-PROPN-PROPN,PROPN,compound-compound-pobj,poss,NNP-NNPS-NNP,NNP,7,1
6260,17391.0,23,TOUR,2,7,1,-6,6,21,-5,-1,Konica Minolta,JAPAN,ORGANIZATION-ORGANIZATION,COUNTRY,PROPN-PROPN,PROPN,compound-compound,compound,NNP-NNP,NNP,3,1
6261,17400.0,47,FLOWERS,1,1,4,3,0,42,0,3,RICHMOND FLOWERS,88,PERSON-PERSON,NUMBER,PROPN-PROPN,NUM,compound-ROOT,appos,NNP-NNP,CD,1,1
6262,17402.0,35,licensed,14,18,34,16,17,0,-4,20,Federal Motor Carrier Safety Administration,protectyourmove.gov,ORGANIZATION-ORGANIZATION-ORGANIZATION-ORGANIZATION-ORGANIZATION,URL,PROPN-PROPN-PROPN-PROPN-PROPN,X,compound-compound-compound-compound-pobj,pobj,NNP-NNP-NNP-NNP-NNP,ADD,6,1
6263,17407.0,25,planned,14,4,1,-3,3,23,10,-13,Robert Morgenthau,Manhattan District Attorney,PERSON-PERSON,TITLE-TITLE-TITLE,PROPN-PROPN,PROPN-PROPN-PROPN,compound-nsubj,compound-compound-compound,NNP-NNP,NNP-NNP-NNP,2,1
6264,54315.0,18,said,5,4,1,-3,3,16,1,-4,Robert Morgenthau,Manhattan District Attorney,PERSON-PERSON,TITLE-TITLE-TITLE,PROPN-PROPN,PROPN-PROPN-PROPN,compound-nsubj,compound-compound-compound,NNP-NNP,NNP-NNP-NNP,2,1
6265,17410.0,56,include,1,24,28,4,23,27,-23,27,William Wymond Verity,Beaufort,PERSON-PERSON-PERSON,CITY,PROPN-PROPN-PROPN,PROPN,compound-compound-conj,pobj,NNP-NNP-NNP,NNP,4,1
6266,17414.0,19,said,4,1,3,2,0,15,3,-1,UNC,Basdeo Panday,ORGANIZATION,PERSON-PERSON,PROPN,PROPN-PROPN,compound,compound-nsubj,NNP,NNP-NNP,1,1
6267,17938.0,35,blamed,22,1,3,2,0,31,21,-19,UNC,Basdeo Panday,ORGANIZATION,PERSON-PERSON,PROPN,PROPN-PROPN,compound,compound-nsubj,NNP,NNP-NNP,1,1
6268,22464.0,21,PORT-OF-SPAIN,0,7,9,2,6,11,-7,9,UNC,Basdeo Panday,ORGANIZATION,PERSON-PERSON,PROPN,PROPN-PROPN,compound,compound-appos,NNP,NNP-NNP,3,1
6269,46948.0,38,blamed,26,1,3,2,0,34,25,-23,UNC,Basdeo Panday,ORGANIZATION,PERSON-PERSON,PROPN,PROPN-PROPN,compound,compound-nsubj,NNP,NNP-NNP,1,1
6270,17417.0,12,-LRB-,2,1,8,7,0,3,1,6,David Banda,Guy Ritchie,PERSON-PERSON,PERSON-PERSON,PROPN-PROPN,PROPN-PROPN,compound-compound,compound-conj,NNP-NNP,NNP-NNP,4,1
6271,22363.0,82,Woods,12,30,56,26,29,25,-18,44,David Banda,Guy Ritchie,PERSON-PERSON,PERSON-PERSON,PROPN-PROPN,PROPN-PROPN,compound-conj,compound-conj,NNP-NNP,NNP-NNP,10,1
6272,31472.0,26,allowed,14,19,8,-11,18,17,-5,-6,David Banda,Guy Ritchie,PERSON-PERSON,PERSON-PERSON,PROPN-PROPN,PROPN-PROPN,compound-dobj,compound-appos,NNP-NNP,NNP-NNP,7,1
6273,33056.0,47,seen,2,17,36,19,16,10,-15,34,David Banda,Guy Ritchie,PERSON-PERSON,PERSON-PERSON,PROPN-PROPN,PROPN-PROPN,compound-appos,compound-pobj,NNP-NNP,NNP-NNP,12,1
6274,35067.0,42,approves,2,11,25,14,10,16,-9,23,David Banda,Guy Ritchie,PERSON-PERSON,PERSON-PERSON,PROPN-PROPN,PROPN-PROPN,compound-compound,compound-appos,NNP-NNP,NNP-NNP,10,1
6275,17418.0,17,had,1,15,1,-14,14,15,-14,0,Jacksonville Jaguars,He,ORGANIZATION-ORGANIZATION,PERSON,PROPN-PROPN,PRON,compound-pobj,nsubj,NNP-NNPS,PRP,4,1
6276,17435.0,52,intends,2,2,15,13,1,36,0,13,Kerry,64,PERSON,NUMBER,PROPN,NUM,pobj,appos,NNP,CD,4,1
6277,17438.0,19,worked,10,10,5,-5,9,13,0,-5,Ahearn,House,PERSON,ORGANIZATION,PROPN,PROPN,nsubj,compound,NNP,NNP,4,1
6278,36482.0,24,was,8,8,6,-2,7,17,0,-2,Ahearn,House,PERSON,ORGANIZATION,PROPN,PROPN,nsubj,pobj,NNP,NNP,1,1
6279,17480.0,43,resigned,16,21,29,8,20,13,-5,13,Focus On The Family,thirty years ago,ORGANIZATION-ORGANIZATION-ORGANIZATION-ORGANIZATION,DATE-DATE-DATE,PROPN-ADP-DET-PROPN,NUM-NOUN-ADV,pobj-prep-det-pobj,nummod-npadvmod-advmod,NNP-IN-DT-NNP,CD-NNS-RB,4,1
6280,17494.0,28,turn,4,15,27,12,14,0,-11,23,Donald E. Wildmon,Miss.,PERSON-PERSON-PERSON,STATE_OR_PROVINCE,PROPN-PROPN-PROPN,PROPN,compound-compound-appos,appos,NNP-NNP-NNP,NNP,6,1
6281,17495.0,29,said,26,21,25,4,20,3,5,-1,Central American Parliament,PARLACEN,ORGANIZATION-ORGANIZATION-ORGANIZATION,ORGANIZATION,ADJ-ADJ-PROPN,PROPN,compound-compound-pobj,compound,JJ-JJ-NNP,NNP,9,1
6282,17512.0,18,married,2,1,16,15,0,1,1,14,She,New York,PERSON,STATE_OR_PROVINCE-STATE_OR_PROVINCE,PRON,PROPN-PROPN,nsubj,compound-pobj,PRP,NNP-NNP,4,1
6283,34462.0,33,lived,1,1,30,29,0,2,0,29,She,New York,PERSON,STATE_OR_PROVINCE-STATE_OR_PROVINCE,PRON,PROPN-PROPN,nsubj,compound-compound,PRP,NNP-NNP,7,1
6284,43028.0,27,born,2,1,22,21,0,4,1,20,She,New York,PERSON,STATE_OR_PROVINCE-STATE_OR_PROVINCE,PRON,PROPN-PROPN,nsubjpass,compound-compound,PRP,NNP-NNP,-1,1
6285,17513.0,10,BORN,0,1,3,2,0,6,-1,3,BORN,"June 3 , 1931",PERSON,DATE-DATE-DATE-DATE,PROPN,PROPN-NUM-PUNCT-NUM,ROOT,ROOT-nummod-punct-nummod,NNP,"NNP-CD-,-CD",3,1
6286,17515.0,72,Territory,1,36,46,10,35,25,-35,45,Simcox,Civil Homeland Defense,PERSON,ORGANIZATION-ORGANIZATION-ORGANIZATION,PROPN,PROPN-PROPN-PROPN,nsubj,compound-compound-dobj,NNP,NNP-NNP-NNP,9,1
6287,17525.0,45,phwoarrrrr,0,8,6,-2,7,38,-8,6,Adam Senn,23-year old,PERSON-PERSON,NUMBER-NUMBER,PROPN-PROPN,ADJ-ADJ,compound-nsubj,punct-amod,NNP-NNP,JJ-JJ,1,1
6288,24261.0,40,is,4,3,1,-2,2,38,1,-3,Adam Senn,23-year old,PERSON-PERSON,DURATION-DURATION,PROPN-PROPN,ADJ-ADJ,compound-nsubj,nummod-amod,NNP-NNP,JJ-JJ,2,1
6289,17532.0,48,reported,44,6,3,-3,5,44,38,-41,Ali Larijani,Iranian Parliament,PERSON-PERSON,ORGANIZATION-ORGANIZATION,PROPN-PROPN,ADJ-PROPN,compound-nsubj,compound-compound,NNP-NNP,JJ-NNP,2,1
6290,17533.0,35,emerged,16,29,32,3,28,2,-13,16,her,Lourdes,PERSON,PERSON,DET,PROPN,poss,appos,PRP$,NNP,2,1
6291,17534.0,21,was,4,4,20,16,3,0,0,16,Ahearn,Va.,PERSON,STATE_OR_PROVINCE,PROPN,PROPN,nsubj,appos,NNP,NNP,1,1
6292,17548.0,42,Chao-ying,6,13,10,-3,12,31,-7,4,Formosan Association for Public Affairs,Washington,ORGANIZATION-ORGANIZATION-ORGANIZATION-ORGANIZATION-ORGANIZATION,STATE_OR_PROVINCE,PROPN-PROPN-ADP-PROPN-PROPN,PROPN,compound-conj-prep-compound-pobj,npadvmod,NNP-NNP-IN-NNP-NNPS,NNP,3,1
6293,17555.0,40,died,37,1,7,6,0,32,36,-30,Philip M. Kaiser,U.S.,PERSON-PERSON-PERSON,COUNTRY,PROPN-PROPN-PROPN,PROPN,compound-compound-nsubj,compound,NNP-NNP-NNP,NNP,2,1
6294,17563.0,62,Dies,9,1,27,26,0,34,8,18,Roy Scheider,Molly Mae Scheider,PERSON-PERSON,PERSON-PERSON-PERSON,PROPN-PROPN,PROPN-PROPN-PROPN,compound-nsubj,compound-compound-conj,NNP-NNP,NNP-NNP-NNP,5,1
6295,17566.0,22,said,14,1,13,12,0,8,13,-1,Herrera,Ariz.,PERSON,STATE_OR_PROVINCE,NOUN,PROPN,nsubj,appos,NN,NNP,5,1
6296,17569.0,35,survived,2,5,22,17,4,12,-3,20,his,Lexington,PERSON,CITY,DET,PROPN,poss,pobj,PRP$,NNP,8,1
6297,17570.0,66,Times,1,16,14,-2,15,51,-15,13,Ali Akbar Salehi,AEOI,PERSON-PERSON-PERSON,ORGANIZATION,PROPN-PROPN-PROPN,PROPN,compound-compound-appos,nsubj,NNP-NNP-NNP,NNP,-1,1
6298,58764.0,40,TEHRAN,0,13,11,-2,12,28,-13,11,Ali Akbar Salehi,AEOI,PERSON-PERSON-PERSON,ORGANIZATION,PROPN-PROPN-PROPN,PROPN,compound-compound-nsubj,compound,NNP-NNP-NNP,NNP,-1,1
6299,17576.0,42,wrote,28,36,30,-6,35,11,-8,2,ABA,William Neukom,ORGANIZATION,PERSON-PERSON,NOUN,PROPN-PROPN,pobj,compound-nsubj,NN,NNP-NNP,4,1
6300,26100.0,22,said,17,14,16,2,13,5,3,-1,ABA,William Neukom,ORGANIZATION,PERSON-PERSON,PROPN,PROPN-PROPN,compound,compound-nsubj,NNP,NNP-NNP,3,1
6301,17591.0,41,dedicated,11,10,18,8,9,22,1,7,he,Atlanta,PERSON,CITY,PRON,PROPN,nsubjpass,compound,PRP,NNP,4,1
6302,30121.0,22,left,3,2,10,8,1,11,1,7,he,Atlanta,PERSON,CITY,PRON,PROPN,nsubj,pobj,PRP,NNP,2,1
6303,17592.0,41,died,34,1,40,39,0,0,33,6,Irene Morgan Kirkaldy,Va,PERSON-PERSON-PERSON,STATE_OR_PROVINCE,PROPN-PROPN-PROPN,PROPN,compound-compound-nsubj,appos,NNP-NNP-NNP,NNP,3,1
6304,17602.0,40,said,20,35,22,-13,34,17,-15,2,St. Anselm College,Paul Manuel,ORGANIZATION-ORGANIZATION-ORGANIZATION,PERSON-PERSON,PROPN-PROPN-PROPN,PROPN-PROPN,compound-compound-pobj,compound-nsubj,NNP-NNP-NNP,NNP-NNP,7,1
6305,61848.0,32,credits,17,14,2,-12,13,29,3,-15,St. Anselm College,Paul Manuel,ORGANIZATION-ORGANIZATION-ORGANIZATION,PERSON-PERSON,PROPN-PROPN-PROPN,PROPN-PROPN,compound-compound-pobj,compound-nsubj,NNP-NNP-NNP,NNP-NNP,6,1
6306,17609.0,4,http://www.northwood.edu/,3,1,4,3,0,-1,2,1,Northwood University,http://www.northwood.edu/,ORGANIZATION-ORGANIZATION,URL,PROPN-PROPN,PROPN,compound-dep,ROOT,NNP-NNP,NNP,-1,1
6307,17620.0,25,said,23,4,18,14,3,6,19,-5,Pascal Yoadimnadji,African,PERSON-PERSON,NATIONALITY,PROPN-PROPN,ADJ,compound-nsubj,amod,NNP-NNP,JJ,4,1
6308,34769.0,27,said,25,4,22,18,3,4,21,-3,Pascal Yoadimnadji,African,PERSON-PERSON,NATIONALITY,PROPN-PROPN,ADJ,compound-nsubj,amod,NNP-NNP,JJ,4,1
6309,17630.0,42,died,34,1,41,40,0,0,33,7,Teddy Kollek,95,PERSON-PERSON,NUMBER,PROPN-PROPN,NUM,compound-nsubj,pobj,NNP-NNP,CD,2,1
6310,46417.0,11,dies,8,1,11,10,0,-1,7,3,Teddy Kollek,95,PERSON-PERSON,NUMBER,PROPN-PROPN,NUM,compound-nsubj,pobj,NNP-NNP,CD,-1,1
6311,17638.0,49,IN,0,25,24,-1,24,24,-25,24,Lindsey Hord,biologist,PERSON-PERSON,TITLE,PROPN-PROPN,NOUN,compound-nsubj,compound,NNP-NNP,NN,3,1
6312,27958.0,43,'s,1,19,18,-1,18,24,-18,17,Lindsey Hord,biologist,PERSON-PERSON,TITLE,PROPN-PROPN,NOUN,compound-nsubj,compound,NNP-NNP,NN,3,1
6313,58530.0,43,'s,1,19,18,-1,18,24,-18,17,Lindsey Hord,biologist,PERSON-PERSON,TITLE,PROPN-PROPN,NOUN,compound-nsubj,compound,NNP-NNP,NN,3,1
6314,17639.0,7,Lohan,1,5,1,-4,4,5,-4,0,Adam Senn,Lindsay Lohan,PERSON-PERSON,PERSON-PERSON,PROPN-PROPN,PROPN-PROPN,compound-pobj,compound-ROOT,NNP-NNP,NNP-NNP,3,1
6315,17641.0,60,survived,9,8,26,18,7,33,1,17,Nolte,Charles,PERSON,PERSON,PROPN,PROPN,nsubjpass,appos,NNP,NNP,5,1
6316,17670.0,29,said,17,19,23,4,18,5,-2,6,Nicholas Burns,State Department,PERSON-PERSON,ORGANIZATION-ORGANIZATION,PROPN-PROPN,PROPN-PROPN,compound-nsubj,compound-poss,NNP-NNP,NNP-NNP,4,1
6317,50144.0,32,said,28,10,9,-1,9,22,18,-19,Nicholas Burns,State Department,PERSON-PERSON,ORGANIZATION-ORGANIZATION,PROPN-PROPN,PROPN-PROPN,compound-nsubj,compound-compound,NNP-NNP,NNP-NNP,1,1
6318,17680.0,24,is,5,2,4,2,1,19,3,-1,younger brother,Sadegh Larijani,PERSON-PERSON,PERSON-PERSON,ADJ-NOUN,PROPN-PROPN,amod-nsubj,compound-nsubj,JJR-NN,NNP-NNP,1,1
6319,17682.0,44,told,41,38,28,-10,37,15,3,-13,ABC,Tom Thabane,ORGANIZATION,PERSON-PERSON,PROPN,PROPN-PROPN,compound,compound-nsubj,NNP,NNP-NNP,7,1
6320,22153.0,44,formed,3,2,12,10,1,31,1,9,ABC,Tom Thabane,ORGANIZATION,PERSON-PERSON,PROPN,PROPN-PROPN,nsubj,compound-pobj,NNP,NNP-NNP,3,1
6321,33401.0,45,won,18,35,27,-8,34,17,-17,9,ABC,Tom Thabane,ORGANIZATION,PERSON-PERSON,PROPN,PROPN-PROPN,compound,compound-poss,NNP,NNP-NNP,3,1
6322,35702.0,40,comes,12,20,31,11,19,8,-8,19,ABC,Tom Thabane,ORGANIZATION,PERSON-PERSON,PROPN,PROPN-PROPN,compound,compound-pobj,NNP,NNP-NNP,3,1
6323,17683.0,33,said,25,30,27,-3,29,5,-5,2,ABA,James Chessen,ORGANIZATION,PERSON-PERSON,PROPN,PROPN-PROPN,compound,compound-nsubj,NNP,NNP-NNP,3,1
6324,58658.0,26,said,21,17,13,-4,16,12,4,-8,ABA,James Chessen,ORGANIZATION,PERSON-PERSON,PROPN,PROPN-PROPN,poss,compound-nsubj,NNP,NNP-NNP,3,1
6325,17691.0,42,shares,15,5,23,18,4,18,10,8,her,Heidi Montag,PERSON,PERSON-PERSON,DET,PROPN-PROPN,poss,compound-conj,PRP$,NNP-NNP,8,1
6326,17703.0,33,said,6,1,5,4,0,27,5,-1,NEC,Konosuke Kashima,ORGANIZATION,PERSON-PERSON,PROPN,PROPN-PROPN,nmod,compound-nsubj,NNP,NNP-NNP,2,1
6327,66122.0,31,said,29,24,28,4,23,2,5,-1,NEC,Konosuke Kashima,ORGANIZATION,PERSON-PERSON,PROPN,PROPN-PROPN,compound,compound-nsubj,NNP,NNP-NNP,11,1
6328,17704.0,38,Goodman,2,2,4,2,1,33,0,2,Carolyn Goodman,NEW YORK,PERSON-PERSON,STATE_OR_PROVINCE-STATE_OR_PROVINCE,PROPN-PROPN,PROPN-PROPN,compound-ROOT,compound-ROOT,NNP-NNP,NNP-NNP,-1,1
6329,17706.0,40,loved,5,5,2,-3,4,37,0,-3,Johns,CJ,PERSON,ORGANIZATION,PROPN,PROPN,nsubj,pobj,NNP,NNP,3,1
6330,17707.0,19,continued,1,1,11,10,0,7,0,10,He,Denver,PERSON,CITY,PRON,PROPN,nsubj,pobj,PRP,NNP,1,1
6331,36009.0,9,moved,1,1,4,3,0,4,0,3,He,Denver,PERSON,CITY,PRON,PROPN,nsubj,pobj,PRP,NNP,1,1
6332,17708.0,28,revealed,4,14,4,-10,13,23,-10,0,she,worker,PERSON,TITLE,PRON,NOUN,nsubj,nsubj,PRP,NN,1,1
6333,17715.0,15,said,9,11,6,-5,10,8,-2,-3,her,Alzheimer 's disease,PERSON,CAUSE_OF_DEATH-CAUSE_OF_DEATH-CAUSE_OF_DEATH,DET,PROPN-PART-NOUN,nsubj,poss-case-pobj,PRP$,NNP-POS-NN,7,1
6334,57662.0,45,changed,23,16,10,-6,15,34,7,-13,her,Alzheimer 's disease,PERSON,CAUSE_OF_DEATH-CAUSE_OF_DEATH-CAUSE_OF_DEATH,DET,PROPN-PART-NOUN,poss,poss-case-pobj,PRP$,NNP-POS-NN,6,1
6335,17719.0,15,is,1,13,9,-4,12,5,-12,8,Paul Sculfor,boxer,PERSON-PERSON,TITLE,PROPN-PROPN,NOUN,compound-conj,pobj,NNP-NNP,NN,1,1
6336,17720.0,39,cease,2,25,10,-15,24,28,-23,8,Justice and Equality Movement,rebels,ORGANIZATION-ORGANIZATION-ORGANIZATION-ORGANIZATION,PERSON,PROPN-CCONJ-PROPN-PROPN,VERB,nmod-cc-conj-conj,ROOT,NNP-CC-NNP-NNP,VBZ,12,1
6337,17728.0,53,started,18,10,15,5,9,37,8,-3,Federal Election Commission,Hans Von Spakovsky,ORGANIZATION-ORGANIZATION-ORGANIZATION,PERSON-PERSON-PERSON,PROPN-PROPN-PROPN,PROPN-PROPN-PROPN,compound-compound-compound,compound-compound-appos,NNP-NNP-NNP,NNP-NNP-NNP,4,1
6338,17732.0,30,WASHINGTON,0,6,20,14,5,9,-6,20,congresswoman,House of Representatives,PERSON,ORGANIZATION-ORGANIZATION-ORGANIZATION,NOUN,PROPN-ADP-PROPN,nsubj,pobj-prep-pobj,NN,NNP-IN-NNPS,-1,1
6339,17733.0,21,said,14,19,8,-11,18,12,-5,-6,Andrea Rothman,she,PERSON-PERSON,PERSON,PROPN-PROPN,PRON,compound-appos,nsubj,NNP-NNP,PRP,8,1
6340,17738.0,40,was,1,1,5,4,0,34,0,4,King,author,PERSON,TITLE,PROPN,NOUN,nsubj,attr,NNP,NN,2,1
6341,17740.0,23,heads,7,1,6,5,0,16,6,-1,Raul Castro,Mariela,PERSON-PERSON,PERSON,PROPN-PROPN,PROPN,compound-poss,appos,NNP-NNP,NNP,3,1
6342,20404.0,25,survived,6,2,13,11,1,11,4,7,Raul Castro,Mariela,PERSON-PERSON,PERSON,PROPN-PROPN,PROPN,compound-pobj,appos,NNP-NNP,NNP,6,1
6343,30081.0,32,2007-07-11T00,0,14,10,-4,13,21,-14,10,Raul Castro,Mariela,PERSON-PERSON,PERSON,PROPN-PROPN,PROPN,compound-appos,poss,NNP-NNP,NNP,4,1
6344,38584.0,49,think,2,38,34,-4,37,14,-36,32,Raul Castro,Mariela,PERSON-PERSON,PERSON,PROPN-PROPN,PROPN,compound-appos,npadvmod,NNP-NNP,NNP,4,1
6345,55940.0,20,said,17,13,17,4,12,2,4,0,Raul Castro,Mariela,PERSON-PERSON,PERSON,PROPN-PROPN,PROPN,compound-poss,appos,NNP-NNP,NNP,2,1
6346,17744.0,7,Information,0,4,7,3,3,-1,-4,7,Daily News,http://www.nydailynews.com,ORGANIZATION-ORGANIZATION,URL,PROPN-PROPN,X,compound-pobj,npadvmod,NNP-NNP,ADD,-1,1
6347,17745.0,46,said,21,8,1,-7,7,44,13,-20,Institute for Diversity and Ethics in Sport,Richard Lapchick,ORGANIZATION-ORGANIZATION-ORGANIZATION-ORGANIZATION-ORGANIZATION-ORGANIZATION-ORGANIZATION,PERSON-PERSON,PROPN-ADP-PROPN-CCONJ-PROPN-ADP-PROPN,PROPN-PROPN,pobj-prep-pobj-cc-conj-prep-pobj,compound-nsubj,NNP-IN-NNP-CC-NNP-IN-NNP,NNP-NNP,4,1
6348,49804.0,43,said,22,30,24,-6,29,18,-8,2,Institute for Diversity and Ethics in Sport,Richard Lapchick,ORGANIZATION-ORGANIZATION-ORGANIZATION-ORGANIZATION-ORGANIZATION-ORGANIZATION-ORGANIZATION,PERSON-PERSON,PROPN-ADP-PROPN-CCONJ-PROPN-ADP-PROPN,PROPN-PROPN,pobj-prep-pobj-cc-conj-prep-pobj,compound-nsubj,NNP-IN-NNP-CC-NNP-IN-NNP,NNP-NNP,4,1
6349,17753.0,40,jumped,3,9,8,-1,8,31,-6,5,Boxer,Barbara Boxer,PERSON,PERSON-PERSON,PROPN,PROPN-PROPN,nsubj,compound-pobj,NNP,NNP-NNP,4,1
6350,17759.0,47,said,7,4,1,-3,3,45,3,-6,Ali Akbar Salehi,Atomic energy,PERSON-PERSON-PERSON,ORGANIZATION-ORGANIZATION,PROPN-PROPN-PROPN,ADJ-NOUN,compound-compound-nsubj,amod-compound,NNP-NNP-NNP,JJ-NN,3,1
6351,17769.0,73,survived,9,2,40,38,1,32,7,31,his,Douglas,PERSON,PERSON,DET,PROPN,poss,appos,PRP$,NNP,7,1
6352,17772.0,30,included,1,4,10,6,3,19,-3,9,George Young,Standards and Privileges Committee,PERSON-PERSON,ORGANIZATION-ORGANIZATION-ORGANIZATION-ORGANIZATION,PROPN-PROPN,PROPN-CCONJ-PROPN-PROPN,compound-dobj,nmod-cc-conj-pobj,NNP-NNP,NNPS-CC-NNPS-NNP,5,1
6353,17774.0,39,seized,2,1,30,29,0,8,1,28,Kurnaz,Afghanistan,PERSON,COUNTRY,PROPN,PROPN,nsubjpass,pobj,NNP,NNP,3,1
6354,56436.0,38,said,3,13,30,17,12,7,-10,27,Kurnaz,Afghanistan,PERSON,COUNTRY,PROPN,PROPN,poss,pobj,NNP,NNP,9,1
6355,63046.0,41,seized,2,1,30,29,0,10,1,28,Kurnaz,Afghanistan,PERSON,COUNTRY,PROPN,PROPN,nsubjpass,pobj,NNP,NNP,3,1
6356,17781.0,20,born,3,18,1,-17,17,18,-15,-2,Harry Dent,Mary Dent,PERSON-PERSON,PERSON-PERSON,PROPN-PROPN,PROPN-PROPN,compound-conj,compound-nsubjpass,NNP-NNP,NNP-NNP,5,1
6357,17782.0,49,received,6,8,12,4,7,36,-2,6,his,Southwestern Louisiana Institute,PERSON,ORGANIZATION-ORGANIZATION-ORGANIZATION,DET,PROPN-PROPN-PROPN,poss,compound-compound-pobj,PRP$,NNP-NNP-NNP,4,1
6358,17802.0,29,Of,0,4,12,8,3,16,-4,12,ABA,Indiana,ORGANIZATION,ORGANIZATION,PROPN,PROPN,compound,conj,NNP,NNP,7,1
6359,17803.0,42,said,40,16,13,-3,15,28,24,-27,Ali Larijani,lead nuclear negotiator,PERSON-PERSON,TITLE-TITLE-TITLE,PROPN-PROPN,ADJ-ADJ-NOUN,compound-nsubj,amod-amod-compound,NNP-NNP,JJ-JJ-NN,2,1
6360,17811.0,37,9,0,11,3,-8,10,33,-11,3,MTC Technologies,BAE,ORGANIZATION-ORGANIZATION,ORGANIZATION,PROPN-PROPN,PROPN,compound-dobj,compound,NNP-NNPS,NNP,2,1
6361,17812.0,36,means,7,1,9,8,0,26,6,2,Vernon Bellecourt,Man of Dawn,PERSON-PERSON,PERSON-PERSON-PERSON,PROPN-PROPN,PROPN-ADP-PROPN,compound-nsubj,dobj-prep-pobj,NNP-NNP,NNP-IN-NNP,1,1
6362,17821.0,32,worked,1,29,13,-16,28,18,-28,12,Old Lane Partners,2005,ORGANIZATION-ORGANIZATION-ORGANIZATION,DATE,PROPN-PROPN-PROPN,NUM,compound-compound-dobj,pobj,NNP-NNP-NNPS,CD,6,1
6363,17884.0,31,worked,1,28,10,-18,27,20,-27,9,Old Lane Partners,2005,ORGANIZATION-ORGANIZATION-ORGANIZATION,DATE,PROPN-PROPN-PROPN,NUM,compound-compound-dobj,pobj,NNP-NNP-NNPS,CD,8,1
6364,17830.0,35,provided,4,23,9,-14,22,25,-19,5,she,dancer,PERSON,TITLE,PRON,NOUN,nsubjpass,pobj,PRP,NN,6,1
6365,17833.0,38,set,13,2,18,16,1,19,11,5,Scorpions,Thabo Mbeki,ORGANIZATION,PERSON-PERSON,PROPN,PROPN-PROPN,nsubjpass,compound-pobj,NNPS,NNP-NNP,4,1
6366,17841.0,20,fund,9,1,7,6,0,12,8,-2,Covidien,Ireland,ORGANIZATION,COUNTRY,PROPN,PROPN,nsubj,appos,NNP,NNP,3,1
6367,17863.0,5,CENTER,2,1,5,4,0,-1,1,3,KENNEDY SPACE CENTER,Florida,ORGANIZATION-ORGANIZATION-ORGANIZATION,STATE_OR_PROVINCE,PROPN-PROPN-PROPN,PROPN,compound-compound-ROOT,npadvmod,NNP-NNP-NNP,NNP,-1,1
6368,17873.0,28,was,3,18,11,-7,17,16,-15,8,Sean Preston,Spears,PERSON-PERSON,PERSON,PROPN-PROPN,PROPN,compound-npadvmod,pobj,NNP-NNP,NNPS,6,1
6369,24473.0,45,wheeled,5,29,4,-25,28,40,-24,-1,Sean Preston,Spears,PERSON-PERSON,PERSON,PROPN-PROPN,PROPN,compound-appos,nsubjpass,NNP-NNP,NNPS,10,1
6370,17890.0,34,said,32,3,10,7,2,23,29,-22,Jo Ann Davis,Virginia,PERSON-PERSON-PERSON,STATE_OR_PROVINCE,PROPN-PROPN-PROPN,PROPN,compound-compound-nsubj,dobj,NNP-NNP-NNP,NNP,3,1
6371,18172.0,23,is,1,9,15,6,8,7,-8,14,Jo Ann Davis,Virginia,PERSON-PERSON-PERSON,STATE_OR_PROVINCE,PROPN-PROPN-PROPN,PROPN,compound-compound-pobj,poss,NNP-NNP-NNP,NNP,5,1
6372,24379.0,15,passed,5,3,1,-2,2,13,2,-4,Jo Ann Davis,Virginia,PERSON-PERSON-PERSON,STATE_OR_PROVINCE,PROPN-PROPN-PROPN,PROPN,compound-compound-nsubj,compound,NNP-NNP-NNP,NNP,2,1
6373,24825.0,30,announced,28,4,10,6,3,19,24,-18,Jo Ann Davis,Virginia,PERSON-PERSON-PERSON,STATE_OR_PROVINCE,PROPN-PROPN-PROPN,PROPN,compound-compound-nsubj,dobj,NNP-NNP-NNP,NNP,3,1
6374,17891.0,36,2009-12-11T12,0,22,28,6,21,7,-22,28,Kendra Wilkinson,Hank Baskett,PERSON-PERSON,PERSON-PERSON,PROPN-PROPN,PROPN-PROPN,compound-nsubj,compound-compound,NNP-NNP,NNP-NNP,3,1
6375,55322.0,34,is,14,20,26,6,19,7,-6,12,Kendra Wilkinson,Hank Baskett,PERSON-PERSON,PERSON-PERSON,PROPN-PROPN,PROPN-PROPN,compound-nsubj,compound-compound,NNP-NNP,NNP-NNP,3,1
6376,17893.0,31,was,1,17,6,-11,16,24,-16,5,he,Hawkins Family Memorial Foundation of Educational Research and Development,PERSON,ORGANIZATION-ORGANIZATION-ORGANIZATION-ORGANIZATION-ORGANIZATION-ORGANIZATION-ORGANIZATION-ORGANIZATION-ORGANIZATION,PRON,PROPN-PROPN-PROPN-PROPN-ADP-PROPN-PROPN-CCONJ-PROPN,nsubj,compound-compound-compound-pobj-prep-compound-pobj-cc-conj,PRP,NNP-NNP-NNP-NNP-IN-NNP-NNP-CC-NNP,2,1
6377,17906.0,43,was,9,17,9,-8,16,33,-8,0,Fidelity Investments-Retail,Lawson,ORGANIZATION-ORGANIZATION,PERSON,PROPN-PROPN,PROPN,compound-pobj,nsubj,NNP-NNP,NNP,5,1
6378,17928.0,24,worked,1,1,6,5,0,17,0,5,He,columnist,PERSON,TITLE,PRON,NOUN,nsubj,pobj,PRP,NN,3,1
6379,17930.0,35,told,6,1,4,3,0,30,5,-2,Marcel Ospel,UBS president,PERSON-PERSON,TITLE-TITLE,PROPN-PROPN,PROPN-NOUN,compound-nsubj,compound-appos,NNP-NNP,NNP-NN,1,1
6380,17947.0,53,involves,8,14,16,2,13,36,-6,8,CNAC,China Eastern Airlines Group,ORGANIZATION,ORGANIZATION-ORGANIZATION-ORGANIZATION-ORGANIZATION,PROPN,PROPN-PROPN-PROPN-PROPN,pobj,compound-compound-compound-conj,NNP,NNP-NNP-NNPS-NNP,3,1
6381,17948.0,39,put,8,12,19,7,11,19,-4,11,Larijani,Spain,PERSON,COUNTRY,PROPN,PROPN,pobj,appos,NNP,NNP,3,1
6382,17949.0,45,invited,18,26,44,18,25,0,-8,26,BarbaraBoxercom,Senate,PERSON,ORGANIZATION,PROPN,PROPN,compound,pobj,NNP,NNP,14,1
6383,17956.0,11,dies,8,1,11,10,0,-1,7,3,Joseph Farland,92,PERSON-PERSON,NUMBER,PROPN-PROPN,NUM,compound-nsubj,pobj,NNP-NNP,CD,-1,1
6384,67665.0,15,dies,8,1,11,10,0,3,7,3,Joseph Farland,92,PERSON-PERSON,NUMBER,PROPN-PROPN,NUM,compound-nsubj,attr,NNP-NNP,CD,3,1
6385,17957.0,59,gain,5,12,25,13,11,33,-7,20,Robbins,Leonard Bernstein,PERSON,PERSON-PERSON,PROPN,PROPN-PROPN,pobj,compound-appos,NNP,NNP-NNP,6,1
6386,17958.0,16,are,4,3,13,10,2,2,1,9,Raul Castro,Cuban Communist Party,PERSON-PERSON,ORGANIZATION-ORGANIZATION-ORGANIZATION,PROPN-PROPN,PROPN-PROPN-PROPN,compound-conj,compound-compound-pobj,NNP-NNP,NNP-NNP-NNP,6,1
6387,17967.0,57,told,5,4,2,-2,3,54,1,-3,Michael Ferrara,U.S.,PERSON-PERSON,COUNTRY,PROPN-PROPN,PROPN,compound-nsubj,compound,NNP-NNP,NNP,1,1
6388,17969.0,43,said,34,36,38,2,35,4,-2,4,Markit,RBS,PERSON,ORGANIZATION,PROPN,PROPN,nsubj,conj,NNP,NNP,2,1
6389,17971.0,27,was,16,26,10,-16,25,16,-10,-6,Inquirer,Brian P Tierney,ORGANIZATION,PERSON-PERSON-PERSON,PROPN,PROPN-PROPN-PROPN,pobj,compound-compound-pobj,NNP,NNP-NNP-NNP,8,1
6390,17996.0,17,Congratulations,0,11,3,-8,10,13,-11,3,Chelsea District Library,Bill Harmer,ORGANIZATION-ORGANIZATION-ORGANIZATION,PERSON-PERSON,PROPN-PROPN-PROPN,PROPN-PROPN,compound-compound-poss,compound-pobj,NNP-NNP-NNP,NNP-NNP,5,1
6391,18009.0,47,measures,33,10,13,3,9,33,23,-20,Royal Caribbean,Oasis of the Seas,ORGANIZATION-ORGANIZATION,ORGANIZATION-ORGANIZATION-ORGANIZATION-ORGANIZATION,PROPN-PROPN,PROPN-ADP-DET-PROPN,compound-poss,pobj-prep-det-pobj,NNP-NNP,NNP-IN-DT-NNPS,2,1
6392,18013.0,25,threw,6,2,23,21,1,1,4,17,Pennsylvania Supreme Court,Mark Ciavarella,ORGANIZATION-ORGANIZATION-ORGANIZATION,PERSON-PERSON,PROPN-PROPN-PROPN,PROPN-PROPN,compound-compound-nsubj,compound-pobj,NNP-NNP-NNP,NNP-NNP,8,1
6393,18014.0,20,was,5,5,12,7,4,7,0,7,he,House Ways and Means Committee,PERSON,ORGANIZATION-ORGANIZATION-ORGANIZATION-ORGANIZATION-ORGANIZATION,PRON,PROPN-PROPN-CCONJ-PROPN-PROPN,nsubj,nmod-nmod-cc-conj-pobj,PRP,NNP-NNPS-CC-NNPS-NNP,4,1
6394,18017.0,20,living,6,1,3,2,0,16,5,-3,Mitchell,85,PERSON,NUMBER,PROPN,NUM,nsubj,appos,NNP,CD,3,1
6395,40407.0,20,said,18,1,3,2,0,16,17,-15,Mitchell,85,PERSON,NUMBER,PROPN,NUM,nsubj,appos,NNP,CD,3,1
6396,18018.0,57,Buse,1,1,30,29,0,26,0,29,Mark Buse,AT&T,PERSON-PERSON,ORGANIZATION,PROPN-PROPN,PROPN,compound-ROOT,conj,NNP-NNP,NNP,5,1
6397,29249.0,30,registered,22,7,25,18,6,4,15,3,Mark Buse,AT&T,PERSON-PERSON,ORGANIZATION,PROPN-PROPN,PROPN,compound-nsubj,compound,NNP-NNP,NNP,4,1
6398,18026.0,14,Guide,0,3,13,10,2,0,-3,13,ABC Radio Australia,http://www.abc.net.au/ra/guide/,ORGANIZATION-ORGANIZATION-ORGANIZATION,URL,PROPN-PROPN-PROPN,X,compound-compound-pobj,advmod,NNP-NNP-NNP,XX,-1,1
6399,18027.0,39,CALIF-SEN-RACE,0,14,20,6,13,18,-14,20,Barbara Boxer,U.S. Senate,PERSON-PERSON,ORGANIZATION-ORGANIZATION,PROPN-PROPN,PROPN-PROPN,compound-pobj,compound-pobj,NNP-NNP,NNP-NNP,5,1
6400,18036.0,46,HONOR,5,30,24,-6,29,21,-25,19,American Bar Association,Michael Greco,ORGANIZATION-ORGANIZATION-ORGANIZATION,PERSON-PERSON,PROPN-PROPN-PROPN,PROPN-PROPN,compound-compound-pobj,compound-nsubj,NNP-NNP-NNP,NNP-NNP,4,1
6401,59342.0,13,asked,6,1,5,4,0,7,5,-1,American Bar Association,Michael Greco,ORGANIZATION-ORGANIZATION-ORGANIZATION,PERSON-PERSON,PROPN-PROPN-PROPN,PROPN-PROPN,compound-compound-compound,compound-nsubj,NNP-NNP-NNP,NNP-NNP,3,1
6402,18039.0,32,said,9,4,7,3,3,24,5,-2,Canadian National,Mark Hallman,ORGANIZATION-ORGANIZATION,PERSON-PERSON,PROPN-PROPN,PROPN-PROPN,compound-pobj,compound-appos,NNP-NNP,NNP-NNP,3,1
6403,18041.0,20,-LRB-,3,1,5,4,0,14,2,2,Royal Caribbean International,RCL,ORGANIZATION-ORGANIZATION-ORGANIZATION,ORGANIZATION,ADJ-ADJ-PROPN,PROPN,compound-compound-compound,compound,JJ-JJ-NNP,NNP,2,1
6404,47105.0,18,Reason,1,10,14,4,9,3,-9,13,Royal Caribbean International,RCL,ORGANIZATION-ORGANIZATION-ORGANIZATION,ORGANIZATION,ADJ-PROPN-PROPN,PROPN,compound-compound-compound,compound,JJ-NNP-NNP,NNP,2,1
6405,18046.0,45,said,1,26,19,-7,25,25,-25,18,MECO,South Korea,ORGANIZATION,COUNTRY-COUNTRY,NOUN,PROPN-PROPN,nsubj,compound-pobj,NNS,NNP-NNP,4,1
6406,18050.0,26,advanced,1,10,18,8,9,7,-9,17,his,Jackson Hewitt Tax Services Inc.,PERSON,ORGANIZATION-ORGANIZATION-ORGANIZATION-ORGANIZATION-ORGANIZATION,DET,PROPN-PROPN-PROPN-PROPN-PROPN,poss,compound-compound-compound-compound-appos,PRP$,NNP-NNP-NNP-NNPS-NNP,7,1
6407,18064.0,26,is,1,14,22,8,13,3,-13,21,his,Indiana,PERSON,STATE_OR_PROVINCE,DET,PROPN,poss,poss,PRP$,NNP,9,1
6408,18065.0,56,Ma,2,9,5,-4,8,50,-7,3,Paul Kim,CEO,PERSON-PERSON,TITLE,PROPN-PROPN,PROPN,compound-appos,appos,NNP-NNP,NNP,2,1
6409,18066.0,20,spearheaded,1,11,10,-1,10,9,-10,9,NSG,Vienna-based,ORGANIZATION,CITY,PROPN,VERB,pobj,amod,NNP,VBN,1,1
6410,18069.0,54,is,8,1,14,13,0,39,7,6,CNR,Canada,ORGANIZATION,COUNTRY,PROPN,PROPN,nsubj,poss,NNP,NNP,4,1
6411,45871.0,54,is,8,1,14,13,0,39,7,6,CNR,Canada,ORGANIZATION,COUNTRY,PROPN,PROPN,nsubj,pobj,NNP,NNP,4,1
6412,18073.0,20,fund,9,1,5,4,0,14,8,-4,Covidien,Dublin,ORGANIZATION,CITY,PROPN,PROPN,nsubj,pobj,NNP,NNP,6,1
6413,18076.0,59,launched,16,16,50,34,15,8,0,34,Forsberg,United States,PERSON,COUNTRY-COUNTRY,PROPN,PROPN-PROPN,nsubj,compound-pobj,NNP,NNP-NNP,11,1
6414,18083.0,21,stricken,14,13,10,-3,12,10,1,-4,he,New Jersey,PERSON,STATE_OR_PROVINCE-STATE_OR_PROVINCE,PRON,PROPN-PROPN,nsubjpass,compound-appos,PRP,NNP-NNP,7,1
6415,18088.0,49,said,35,26,32,6,25,16,9,-3,Organization of the Islamic Conference,Parliamentary Union,ORGANIZATION-ORGANIZATION-ORGANIZATION-ORGANIZATION-ORGANIZATION,ORGANIZATION-ORGANIZATION,PROPN-ADP-DET-PROPN-PROPN,PROPN-PROPN,pobj-prep-det-compound-poss,compound-pobj,NNP-IN-DT-NNP-NNP,NNP-NNP,1,1
6416,18093.0,36,served,10,32,2,-30,31,33,-22,-8,Professional Rodeo Cowboys Association,his,ORGANIZATION-ORGANIZATION-ORGANIZATION-ORGANIZATION,PERSON,PROPN-PROPN-PROPN-PROPN,DET,compound-compound-compound-pobj,poss,NNP-NNP-NNPS-NNP,PRP$,9,1
6417,18098.0,43,MANILA,0,9,1,-8,8,41,-9,1,Asian Development Bank,MANILA,ORGANIZATION-ORGANIZATION-ORGANIZATION,ORGANIZATION,PROPN-PROPN-PROPN,PROPN,compound-compound-ROOT,ROOT,NNP-NNP-NNP,NNP,-1,1
6418,33996.0,40,------,0,7,12,5,6,27,-7,12,Asian Development Bank,MANILA,ORGANIZATION-ORGANIZATION-ORGANIZATION,CITY,PROPN-PROPN-PROPN,PROPN,compound-compound-pobj,dobj,NNP-NNP-NNP,NNP,7,1
6419,18113.0,21,decided,13,3,10,7,2,10,10,-3,Al Hubbard,specialist,PERSON-PERSON,TITLE,PROPN-PROPN,NOUN,compound-nsubj,appos,NNP-NNP,NN,2,1
6420,18114.0,49,DAMASCUS,0,30,3,-27,29,45,-30,3,his,Saudi,PERSON,NATIONALITY,DET,ADJ,poss,amod,PRP$,JJ,8,1
6421,18121.0,42,sworn,9,1,5,4,0,36,8,-4,Bolin,Monday,PERSON,DATE,PROPN,PROPN,nsubjpass,npadvmod,NNP,NNP,3,1
6422,61624.0,42,sworn,9,1,5,4,0,36,8,-4,Bolin,Monday,PERSON,DATE,PROPN,PROPN,nsubjpass,npadvmod,NNP,NNP,3,1
6423,18128.0,38,entered,10,1,1,0,0,36,9,-9,Samsung Group,Samsung Motors,ORGANIZATION-ORGANIZATION,ORGANIZATION-ORGANIZATION,PROPN-PROPN,PROPN-PROPN,compound-pobj,compound-nsubj,NNP-NNP,NNP-NNPS,0,1
6424,18130.0,46,said,15,9,1,-8,8,44,6,-14,International Monetary Fund,Renu Kohli,ORGANIZATION-ORGANIZATION-ORGANIZATION,PERSON-PERSON,PROPN-PROPN-PROPN,PROPN-PROPN,compound-compound-pobj,compound-nsubj,NNP-NNP-NNP,NNP-NNP,4,1
6425,18150.0,23,announced,6,10,6,-4,9,16,-4,0,Hector Elizondo,ABC,PERSON-PERSON,ORGANIZATION,PROPN-PROPN,PROPN,compound-pobj,nsubj,NNP-NNP,NNP,3,1
6426,59313.0,41,has,23,34,22,-12,33,18,-11,-1,Hector Elizondo,ABC,PERSON-PERSON,ORGANIZATION,PROPN-PROPN,PROPN,compound-conj,pobj,NNP-NNP,NNP,8,1
6427,18151.0,15,passed,5,3,14,11,2,0,2,9,Jo Ann Davis,57,PERSON-PERSON-PERSON,NUMBER,PROPN-PROPN-PROPN,NUM,compound-compound-nsubj,pobj,NNP-NNP-NNP,CD,3,1
6428,36294.0,41,said,39,6,17,11,5,23,33,-22,Jo Ann Davis,57,PERSON-PERSON-PERSON,NUMBER,PROPN-PROPN-PROPN,NUM,compound-compound-pobj,nummod,NNP-NNP-NNP,CD,4,1
6429,18164.0,24,cancelled,14,11,1,-10,10,22,3,-13,Bryan McFadden,Kerry Katona,PERSON-PERSON,PERSON-PERSON,PROPN-PROPN,PROPN-PROPN,compound-dobj,compound-nsubj,NNP-NNP,NNP-NNP,3,1
6430,18176.0,16,replaced,8,11,1,-10,10,14,-3,-7,his,National Economic Council,PERSON,ORGANIZATION-ORGANIZATION-ORGANIZATION,DET,PROPN-PROPN-PROPN,poss,compound-compound-compound,PRP$,NNP-NNP-NNP,6,1
6431,18177.0,40,People,3,5,15,10,4,24,-2,12,Olivia Palermo,The City,PERSON-PERSON,ORGANIZATION-ORGANIZATION,PROPN-PROPN,DET-PROPN,compound-nsubj,det-poss,NNP-NNP,DT-NNP,5,1
6432,47865.0,39,host,25,1,6,5,0,32,24,-19,Olivia Palermo,The City,PERSON-PERSON,ORGANIZATION-ORGANIZATION,PROPN-PROPN,DET-PROPN,compound-nsubj,compound-pobj,NNP-NNP,DT-NNP,2,1
6433,18186.0,18,voiced,4,1,3,2,0,14,3,-1,Gunners,Peter Hill-Wood,ORGANIZATION,PERSON-PERSON,NOUN,PROPN-PROPN,compound,compound-nsubj,NNS,NNP-NNP,2,1
6434,18188.0,25,Flowers,2,1,9,8,0,15,1,7,Richmond M Flowers,attorney general,PERSON-PERSON-PERSON,TITLE-TITLE,PROPN-PROPN-PROPN,NOUN-NOUN,compound-compound-ROOT,compound-pobj,NNP-NNP-NNPS,NN-NN,4,1
6435,18194.0,26,insist,4,20,3,-17,19,22,-16,-1,NSC,he,ORGANIZATION,PERSON,PROPN,PRON,nsubj,nsubj,NNP,PRP,4,1
6436,18196.0,27,said,17,19,22,3,18,4,-2,5,her,Frederick `` Rick '' Ahearn,PERSON,PERSON-PERSON-PERSON-PERSON-PERSON,DET,PROPN-PUNCT-PROPN-PUNCT-PROPN,poss,nmod-punct-nmod-punct-appos,PRP$,NNP-``-NNP-''-NNP,3,1
6437,18200.0,49,DHAKA,0,14,18,4,13,30,-14,18,IMF,Thomas R Rumbaugh,ORGANIZATION,PERSON-PERSON-PERSON,PROPN,PROPN-PROPN-PROPN,compound,compound-compound-nsubj,NNP,NNP-NNP-NNP,3,1
6438,18215.0,27,include,1,15,6,-9,14,20,-14,5,Reagan Dunn,Keith Thomson,PERSON-PERSON,PERSON-PERSON,PROPN-PROPN,PROPN-PROPN,compound-conj,compound-appos,NNP-NNP,NNP-NNP,4,1
6439,18219.0,27,grew,4,1,21,20,0,5,3,17,Harry Shuler Dent,Clinton,PERSON-PERSON-PERSON,CITY,PROPN-PROPN-PROPN,PROPN,compound-compound-nsubj,pobj,NNP-NNP-NNP,NNP,7,1
6440,18224.0,34,achieved,4,3,1,-2,2,32,1,-3,Paavo Nurmi,Finland,PERSON-PERSON,COUNTRY,PROPN-PROPN,PROPN,compound-nsubj,poss,NNP-NNP,NNP,2,1
6441,37270.0,23,won,20,19,17,-2,18,5,1,-3,Paavo Nurmi,Finland,PERSON-PERSON,NATIONALITY,PROPN-PROPN,PROPN,compound-nsubj,poss,NNP-NNP,NNP,2,1
6442,65886.0,30,taken,9,16,14,-2,15,15,-7,5,Paavo Nurmi,Finland,PERSON-PERSON,COUNTRY,PROPN-PROPN,PROPN,compound-pobj,poss,NNP-NNP,NNP,2,1
6443,18240.0,44,recorded,24,17,21,4,16,22,7,-3,Jewish National Fund,Eastern Galilee,ORGANIZATION-ORGANIZATION-ORGANIZATION,LOCATION-LOCATION,ADJ-PROPN-PROPN,PROPN-PROPN,amod-compound-pobj,compound-compound,JJ-NNP-NNP,NNP-NNP,4,1
6444,18245.0,16,congresswoman,2,4,7,3,3,8,-2,5,Millender-McDonald,cancer,PERSON,CAUSE_OF_DEATH,PROPN,NOUN,nsubj,pobj,NNP,NN,3,1
6445,25784.0,7,congresswoman,2,4,7,3,3,-1,-2,5,Millender-McDonald,cancer,PERSON,CAUSE_OF_DEATH,PROPN,NOUN,nsubj,pobj,NNP,NN,3,1
6446,31103.0,13,congresswoman,2,4,7,3,3,5,-2,5,Millender-McDonald,cancer,PERSON,CAUSE_OF_DEATH,PROPN,NOUN,nsubj,pobj,NNP,NN,3,1
6447,37221.0,14,is,1,1,13,12,0,0,0,12,Millender-McDonald,cancer,PERSON,CAUSE_OF_DEATH,PROPN,NOUN,nsubj,pobj,NNP,NN,6,1
6448,18250.0,22,transferred,5,16,12,-4,15,9,-11,7,EnergySolutions,Ill.,ORGANIZATION,STATE_OR_PROVINCE,PROPN,PROPN,pobj,nmod,NNP,NNP,5,1
6449,18251.0,34,want,13,32,26,-6,31,7,-19,13,CNR,Congolese National Commission of Refugees,ORGANIZATION,ORGANIZATION-ORGANIZATION-ORGANIZATION-ORGANIZATION-ORGANIZATION,PROPN,PROPN-PROPN-PROPN-ADP-PROPN,compound,compound-compound-pobj-prep-pobj,NNP,NNP-NNP-NNP-IN-NNPS,4,1
6450,18260.0,32,urged,5,1,4,3,0,27,4,-1,OIC,Ekmeleddin Ihsanoglu,ORGANIZATION,PERSON-PERSON,PROPN,PROPN-PROPN,compound,compound-nsubj,NNP,NNP-NNP,2,1
6451,36835.0,32,condoled,12,8,11,3,7,20,4,-1,OIC,Ekmeleddin Ihsanoglu,ORGANIZATION,PERSON-PERSON,PROPN,PROPN-PROPN,compound,compound-nsubj,NNP,NNP-NNP,-1,1
6452,51850.0,38,said,36,1,3,2,0,34,35,-33,OIC,Ekmeleddin Ihsanoglu,ORGANIZATION,PERSON-PERSON,PROPN,PROPN-PROPN,compound,compound-nsubj,NNP,NNP-NNP,1,1
6453,18267.0,39,arrested,14,4,7,3,3,31,10,-7,Irene Morgan,Baltimore,PERSON-PERSON,CITY,PROPN-PROPN,PROPN,compound-appos,pobj,NNP-NNP,NNP,3,1
6454,18273.0,29,said,16,1,12,11,0,16,15,-4,FirstGroup PLC,Dallas-based Greyhound Lines Inc.,ORGANIZATION-ORGANIZATION,ORGANIZATION-ORGANIZATION-ORGANIZATION-ORGANIZATION,PROPN-PROPN,VERB-PROPN-PROPN-PROPN,compound-nsubj,compound-compound-compound-dobj,NNP-NNP,VBD-NNP-NNP-NNP,5,1
6455,18281.0,54,was,1,1,19,18,0,34,0,18,Nolte,World Academy of Art and Science,PERSON,ORGANIZATION-ORGANIZATION-ORGANIZATION-ORGANIZATION-ORGANIZATION-ORGANIZATION,PROPN,PROPN-PROPN-ADP-PROPN-CCONJ-PROPN,nsubj,compound-pobj-prep-pobj-cc-conj,NNP,NNP-NNP-IN-NNP-CC-NNP,4,1
6456,18283.0,24,was,8,2,18,16,1,5,6,10,her,State Department 's Office of Protocol,PERSON,ORGANIZATION-ORGANIZATION-ORGANIZATION-ORGANIZATION-ORGANIZATION-ORGANIZATION,DET,PROPN-PROPN-PART-PROPN-ADP-PROPN,poss,compound-poss-case-pobj-prep-pobj,PRP$,NNP-NNP-POS-NNP-IN-NNP,10,1
6457,18303.0,29,been,16,1,6,5,0,22,15,-10,Atlanta Chamber of Commerce,Sam Williams,ORGANIZATION-ORGANIZATION-ORGANIZATION-ORGANIZATION,PERSON-PERSON,PROPN-PROPN-ADP-PROPN,PROPN-PROPN,compound-nmod-prep-pobj,compound-nsubj,NNP-NNP-IN-NNP,NNP-NNP,1,1
6458,18307.0,59,promoted,29,8,7,-1,7,51,21,-22,George Roy Hill,director,PERSON-PERSON-PERSON,TITLE,PROPN-PROPN-PROPN,NOUN,compound-compound-pobj,compound,NNP-NNP-NNP,NN,2,1
6459,33354.0,27,died,25,21,20,-1,20,6,4,-5,George Roy Hill,director,PERSON-PERSON-PERSON,TITLE,PROPN-PROPN-PROPN,NOUN,compound-compound-pobj,compound,NNP-NNP-NNP,NN,2,1
6460,45452.0,39,applied,6,25,24,-1,24,14,-19,18,George Roy Hill,director,PERSON-PERSON-PERSON,TITLE,PROPN-PROPN-PROPN,NOUN,compound-compound-appos,conj,NNP-NNP-NNP,NN,3,1
6461,55631.0,32,died,30,26,25,-1,25,6,4,-5,George Roy Hill,director,PERSON-PERSON-PERSON,TITLE,PROPN-PROPN-PROPN,NOUN,compound-compound-pobj,compound,NNP-NNP-NNP,NN,4,1
6462,18312.0,17,set,1,1,5,4,0,11,0,4,She,Andrew Goodman Foundation,PERSON,ORGANIZATION-ORGANIZATION-ORGANIZATION,PRON,PROPN-PROPN-PROPN,nsubj,compound-compound-dobj,PRP,NNP-NNP-NNP,2,1
6463,18318.0,27,represented,4,17,14,-3,16,12,-13,10,his,Conn.,PERSON,STATE_OR_PROVINCE,DET,PROPN,poss,appos,PRP$,NNP,4,1
6464,64144.0,27,represented,4,17,14,-3,16,12,-13,10,his,Conn.,PERSON,STATE_OR_PROVINCE,DET,PROPN,poss,appos,PRP$,NNP,4,1
6465,18322.0,20,be,7,2,13,11,1,6,5,6,his,Swire,PERSON,ORGANIZATION,DET,PROPN,poss,poss,PRP$,NNP,10,1
6466,18323.0,43,told,6,12,15,3,11,27,-6,9,Gonzales,White House,PERSON,ORGANIZATION-ORGANIZATION,PROPN,PROPN-PROPN,nsubj,compound-compound,NNP,NNP-NNP,4,1
6467,59071.0,35,said,4,34,16,-18,33,18,-30,12,Gonzales,White House,PERSON,ORGANIZATION-ORGANIZATION,PROPN,PROPN-PROPN,pobj,compound-pobj,NNP,NNP-NNP,4,1
6468,18324.0,41,returning,4,34,15,-19,33,25,-30,11,Johns,Tin Roof Cantina,PERSON,ORGANIZATION-ORGANIZATION-ORGANIZATION,PROPN,PROPN-PROPN-PROPN,nsubj,compound-compound-pobj,NNP,NNP-NNP-NNP,9,1
6469,18328.0,30,found,22,14,15,1,13,14,8,-7,Guatemala-based,Central American Parliament,ORGANIZATION,COUNTRY-COUNTRY-COUNTRY,ADJ,PROPN-PROPN-PROPN,amod,compound-compound-pobj,JJ,NNP-NNP-NNP,1,1
6470,18344.0,26,confirmed,6,20,17,-3,19,8,-14,11,Ali Larijani,top nuclear negotiator,PERSON-PERSON,TITLE-TITLE-TITLE,PROPN-PROPN,ADJ-ADJ-NOUN,compound-appos,amod-amod-pobj,NNP-NNP,JJ-JJ-NN,2,1
6471,18354.0,43,Hooper,3,3,1,-2,2,41,0,-2,Jeremy Hooper,New Yorker,PERSON-PERSON,STATE_OR_PROVINCE-STATE_OR_PROVINCE,PROPN-PROPN,PROPN-PROPN,compound-ROOT,compound-compound,NNP-NNP,NNP-NNP,1,1
6472,18356.0,37,Based,0,16,22,6,15,14,-16,22,SAC,nine,ORGANIZATION,NUMBER,PROPN,NUM,compound,nummod,NNP,CD,8,1
6473,18376.0,31,teamed,1,4,11,7,3,19,-3,10,Chris Simcox,Tucson,PERSON-PERSON,CITY,PROPN-PROPN,PROPN,compound-pobj,pobj,NNP-NNP,NNP,4,1
6474,18381.0,19,Labels,0,3,13,10,2,5,-3,13,Beverly Sills,lung cancer,PERSON-PERSON,CAUSE_OF_DEATH-CAUSE_OF_DEATH,PROPN-PROPN,NOUN-NOUN,compound-nsubj,compound-pobj,NNP-NNP,NN-NN,4,1
6475,33213.0,39,was,15,1,7,6,0,31,14,-8,Beverly Sills,lung cancer,PERSON-PERSON,CAUSE_OF_DEATH-CAUSE_OF_DEATH,PROPN-PROPN,NOUN-NOUN,compound-nsubj,compound-pobj,NNP-NNP,NN-NN,3,1
6476,18384.0,57,said,12,21,29,8,20,27,-9,17,American Bankers Association,"Washington , DC",ORGANIZATION-ORGANIZATION-ORGANIZATION,STATE_OR_PROVINCE-STATE_OR_PROVINCE-STATE_OR_PROVINCE,PROPN-PROPN-PROPN,PROPN-PUNCT-PROPN,compound-compound-pobj,nmod-punct-nmod,NNP-NNPS-NNP,"NNP-,-NNP",4,1
6477,18390.0,29,is,2,1,13,12,0,15,1,11,Mark Buse,United States,PERSON-PERSON,COUNTRY-COUNTRY,PROPN-PROPN,PROPN-PROPN,compound-nsubj,compound-compound,NNP-NNP,NNP-NNP,5,1
6478,18408.0,26,born,4,1,13,12,0,12,3,9,Joseph Simpson Farland,Clarksburg,PERSON-PERSON-PERSON,CITY,PROPN-PROPN-PROPN,PROPN,compound-compound-nsubjpass,pobj,NNP-NNP-NNP,NNP,4,1
6479,18410.0,43,started,13,9,35,26,8,7,4,22,Christopher Dodd,Martin Luther King Jr.,PERSON-PERSON,ORGANIZATION-ORGANIZATION-ORGANIZATION-ORGANIZATION,PROPN-PROPN,PROPN-PROPN-PROPN-PROPN,compound-nsubj,compound-compound-compound-nmod,NNP-NNP,NNP-NNP-NNP-NNP,10,1
6480,18420.0,28,told,10,7,1,-6,6,26,3,-9,Oxford University Press,Nigel Portwood,ORGANIZATION-ORGANIZATION-ORGANIZATION,PERSON-PERSON,PROPN-PROPN-PROPN,PROPN-PROPN,compound-compound-pobj,compound-nsubj,NNP-NNP-NNP,NNP-NNP,4,1
6481,31174.0,54,FRANKFURT,0,16,10,-6,15,43,-16,10,Oxford University Press,Nigel Portwood,ORGANIZATION-ORGANIZATION-ORGANIZATION,PERSON-PERSON,PROPN-PROPN-PROPN,PROPN-PROPN,compound-compound-pobj,compound-nsubj,NNP-NNP-NNP,NNP-NNP,4,1
6482,52100.0,45,said,10,7,1,-6,6,43,3,-9,Oxford University Press,Nigel Portwood,ORGANIZATION-ORGANIZATION-ORGANIZATION,PERSON-PERSON,PROPN-PROPN-PROPN,PROPN-PROPN,compound-compound-pobj,compound-nsubj,NNP-NNP-NNP,NNP-NNP,4,1
6483,18436.0,43,HILLS,1,17,21,4,16,21,-16,20,DeGeneres,Betty,PERSON,PERSON,PROPN,PROPN,poss,conj,NNP,NNP,4,1
6484,53552.0,16,given,7,1,5,4,0,10,6,-2,DeGeneres,Betty,PERSON,PERSON,PROPN,PROPN,poss,appos,NNP,NNP,4,1
6485,60197.0,36,attended,3,10,14,4,9,21,-7,11,DeGeneres,Betty,PERSON,PERSON,PROPN,PROPN,poss,conj,NNP,NNP,4,1
6486,18440.0,53,PART,1,19,19,0,18,33,-18,18,Jackson Hewitt,Jackson Hewitt Tax Services,ORGANIZATION-ORGANIZATION,ORGANIZATION-ORGANIZATION-ORGANIZATION-ORGANIZATION,PROPN-PROPN,PROPN-PROPN-PROPN-PROPN,nmod-nmod,compound-compound-compound-compound,NNP-NNP,NNP-NNP-NNP-NNPS,0,1
6487,25101.0,46,says,1,12,12,0,11,33,-11,11,Jackson Hewitt,Jackson Hewitt Tax Services,ORGANIZATION-ORGANIZATION,ORGANIZATION-ORGANIZATION-ORGANIZATION-ORGANIZATION,PROPN-PROPN,PROPN-PROPN-PROPN-PROPN,nmod-nmod,compound-compound-compound-compound,NNP-NNP,NNP-NNP-NNP-NNPS,0,1
6488,18451.0,21,lost,2,7,1,-6,6,19,-5,-1,UNC,Panday,ORGANIZATION,PERSON,PROPN,NOUN,pobj,nsubj,NNP,NN,2,1
6489,18457.0,28,revealed,4,10,4,-6,9,23,-6,0,her,worker,PERSON,TITLE,DET,NOUN,poss,nsubj,PRP$,NN,4,1
6490,18459.0,35,said,32,1,1,0,0,33,31,-31,Fidelity,Fidelity Investments,ORGANIZATION,ORGANIZATION-ORGANIZATION,PROPN,PROPN-PROPN,compound,compound-nsubj,NNP,NNP-NNP,0,1
6491,18486.0,39,said,17,33,29,-4,32,9,-16,12,Marywood University,human physiology laboratory,ORGANIZATION-ORGANIZATION,ORGANIZATION-ORGANIZATION-ORGANIZATION,PROPN-PROPN,ADJ-NOUN-NOUN,compound-pobj,amod-compound-conj,NNP-NNP,JJ-NN-NN,2,1
6492,28749.0,31,said,8,25,21,-4,24,9,-17,13,Marywood University,human physiology laboratory,ORGANIZATION-ORGANIZATION,ORGANIZATION-ORGANIZATION-ORGANIZATION,PROPN-PROPN,ADJ-NOUN-NOUN,compound-pobj,amod-compound-conj,NNP-NNP,JJ-NN-NN,3,1
6493,46645.0,36,manage,22,15,11,-4,14,24,7,-11,Marywood University,human physiology laboratory,ORGANIZATION-ORGANIZATION,ORGANIZATION-ORGANIZATION-ORGANIZATION,PROPN-PROPN,ADJ-NOUN-NOUN,compound-pobj,amod-compound-conj,NNP-NNP,JJ-NN-NN,3,1
6494,18507.0,38,offered,2,24,17,-7,23,20,-22,15,Justice and Equality Movement,Khalil Ibrahim,ORGANIZATION-ORGANIZATION-ORGANIZATION-ORGANIZATION,PERSON-PERSON,PROPN-CCONJ-PROPN-PROPN,PROPN-PROPN,nmod-cc-conj-pobj,compound-pobj,NNP-CC-NNP-NNP,NNP-NNP,5,1
6495,31416.0,38,shown,13,18,23,5,17,14,-5,10,Justice and Equality Movement,Khalil Ibrahim,ORGANIZATION-ORGANIZATION-ORGANIZATION-ORGANIZATION,PERSON-PERSON,PROPN-CCONJ-PROPN-PROPN,PROPN-PROPN,nmod-cc-compound-compound,compound-pobj,NNP-CC-NNP-NNP,NNP-NNP,7,1
6496,35629.0,33,told,28,21,26,5,20,6,7,-2,Justice and Equality Movement,Khalil Ibrahim,ORGANIZATION-ORGANIZATION-ORGANIZATION-ORGANIZATION,PERSON-PERSON,PROPN-CCONJ-PROPN-PROPN,PROPN-PROPN,nmod-cc-conj-pobj,compound-appos,NNP-CC-NNP-NNP,NNP-NNP,5,1
6497,42767.0,26,was,18,9,1,-8,8,24,9,-17,Justice and Equality Movement,Khalil Ibrahim,ORGANIZATION-ORGANIZATION-ORGANIZATION-ORGANIZATION,PERSON-PERSON,PROPN-CCONJ-PROPN-PROPN,PROPN-PROPN,nmod-cc-conj-compound,compound-nsubj,NNP-CC-NNP-NNP,NNP-NNP,6,1
6498,18512.0,37,celebrates,22,33,36,3,32,0,-11,14,Daily News,EL UNIVERSAL,ORGANIZATION-ORGANIZATION,ORGANIZATION-ORGANIZATION,PROPN-PROPN,PROPN-PROPN,compound-compound,compound-pobj,NNP-NNP,NNP-NNP,2,1
6499,18514.0,27,identified,1,16,7,-9,15,19,-15,6,Awami League,Mohammad Yousuf,ORGANIZATION-ORGANIZATION,PERSON-PERSON,PROPN-PROPN,PROPN-PROPN,compound-pobj,compound-compound,NNP-NNP,NNP-NNP,4,1
6500,18529.0,58,wrote,50,47,38,-9,46,19,3,-12,Royal Caribbean Cruises,Bradley Stein,ORGANIZATION-ORGANIZATION-ORGANIZATION,PERSON-PERSON,ADJ-PROPN-PROPN,PROPN-PROPN,compound-compound-pobj,compound-nsubj,JJ-NNP-NNPS,NNP-NNP,4,1
6501,18543.0,21,VIENNA,0,7,9,2,6,11,-7,9,He,ambassador,PERSON,TITLE,PRON,NOUN,nsubj,attr,PRP,NN,4,1
6502,29554.0,16,appointed,2,1,4,3,0,11,1,2,He,ambassador,PERSON,TITLE,PRON,NOUN,nsubjpass,oprd,PRP,NN,3,1
6503,36481.0,25,left,1,1,14,13,0,10,0,13,He,ambassador,PERSON,TITLE,PRON,NOUN,nsubj,pobj,PRP,NN,5,1
6504,54912.0,34,was,1,1,17,16,0,16,0,16,He,ambassador,PERSON,TITLE,PRON,NOUN,nsubj,oprd,PRP,NN,5,1
6505,18555.0,39,defended,2,10,27,17,9,11,-8,25,he,Catholic,PERSON,RELIGION,PRON,ADJ,nsubj,amod,PRP,JJ,5,1
6506,18564.0,22,said,7,1,5,4,0,16,6,-2,National Beef,John R Miller,ORGANIZATION-ORGANIZATION,PERSON-PERSON-PERSON,PROPN-PROPN,PROPN-PROPN-PROPN,compound-compound,compound-compound-nsubj,NNP-NNP,NNP-NNP-NNP,3,1
6507,18576.0,86,Bryanston,2,2,2,0,1,83,0,0,CNR Bryanston,CNR Main,ORGANIZATION-ORGANIZATION,ORGANIZATION-ORGANIZATION,PROPN-PROPN,PROPN-PROPN,compound-ROOT,compound-pobj,NNP-NNP,NNP-NNP,0,1
6508,18577.0,30,remembered,18,6,3,-3,5,26,12,-15,Verity,Beaufort,PERSON,COUNTRY,PROPN,PROPN,nsubj,pobj,NNP,NNP,2,1
6509,26040.0,14,died,1,1,11,10,0,2,0,10,Verity,Beaufort,PERSON,CITY,NOUN,PROPN,nsubj,compound,NN,NNP,3,1
6510,18578.0,48,wrote,5,14,9,-5,13,38,-9,4,Michael Sandy,murder,PERSON-PERSON,CAUSE_OF_DEATH,PROPN-PROPN,NOUN,compound-pobj,pobj,NNP-NNP,NN,1,1
6511,18591.0,51,Directed,0,39,46,7,38,4,-39,46,Johnny Knoxville,Paramount Pictures,PERSON-PERSON,ORGANIZATION-ORGANIZATION,PROPN-PROPN,PROPN-PROPN,compound-conj,compound-pobj,NNP-NNP,NNP-NNP,7,1
6512,18598.0,31,came,4,1,30,29,0,0,3,26,Yolanda King,stroke,PERSON-PERSON,CAUSE_OF_DEATH,PROPN-PROPN,NOUN,compound-poss,pobj,NNP-NNP,NN,3,1
6513,18614.0,20,worked,6,1,10,9,0,9,5,4,Lindsey Hord,Florida Fish and Wildlife Conservation Commission,PERSON-PERSON,ORGANIZATION-ORGANIZATION-ORGANIZATION-ORGANIZATION-ORGANIZATION-ORGANIZATION,PROPN-PROPN,PROPN-PROPN-CCONJ-PROPN-PROPN-PROPN,compound-nsubj,nmod-nmod-cc-compound-compound-pobj,NNP-NNP,NNP-NNP-CC-NNP-NNP-NNP,4,1
6514,18642.0,49,said,12,10,1,-9,9,47,2,-11,ITOCHU Corporation,Eizo Kobayshi,ORGANIZATION-ORGANIZATION,PERSON-PERSON,PROPN-PROPN,PROPN-PROPN,compound-pobj,compound-nsubj,NNP-NNP,NNP-NNP,3,1
6515,18647.0,25,witnessed,14,12,7,-5,11,17,2,-7,he,Baltimore,PERSON,CITY,PRON,PROPN,nsubj,compound,PRP,NNP,7,1
6516,48457.0,36,taught,11,11,21,10,10,14,0,10,he,Baltimore,PERSON,CITY,PRON,PROPN,nsubj,compound,PRP,NNP,4,1
6517,18665.0,20,said,12,3,11,8,2,8,9,-1,Carolyn Maloney,chairwoman,PERSON-PERSON,TITLE,PROPN-PROPN,NOUN,compound-nsubj,appos,NNP-NNP,NN,3,1
6518,34727.0,30,echoed,3,7,13,6,6,16,-4,10,Carolyn Maloney,chairwoman,PERSON-PERSON,TITLE,PROPN-PROPN,NOUN,compound-pobj,appos,NNP-NNP,NN,3,1
6519,18667.0,60,said,51,13,47,34,12,12,38,-4,ADB,Central West Asia Department,ORGANIZATION,ORGANIZATION-ORGANIZATION-ORGANIZATION-ORGANIZATION,PROPN,PROPN-PROPN-PROPN-PROPN,poss,compound-compound-compound-pobj,NNP,NNP-NNP-NNP-NNP,12,1
6520,39987.0,62,said,53,15,49,34,14,12,38,-4,ADB,Central West Asia Department,ORGANIZATION,ORGANIZATION-ORGANIZATION-ORGANIZATION-ORGANIZATION,PROPN,PROPN-PROPN-PROPN-PROPN,poss,compound-compound-compound-pobj,NNP,NNP-NNP-NNP-NNP,12,1
6521,18669.0,33,came,2,12,7,-5,11,25,-10,5,John D. Negroponte,U.S.,PERSON-PERSON-PERSON,COUNTRY,PROPN-PROPN-PROPN,PROPN,compound-compound-nsubj,nmod,NNP-NNP-NNP,NNP,3,1
6522,64126.0,33,was,1,22,17,-5,21,15,-21,16,John D. Negroponte,U.S.,PERSON-PERSON-PERSON,COUNTRY,PROPN-PROPN-PROPN,PROPN,compound-compound-nsubj,nmod,NNP-NNP-NNP,NNP,3,1
6523,18675.0,16,are,4,3,10,7,2,5,1,6,Mia Farrow,John Farrow,PERSON-PERSON,PERSON-PERSON,PROPN-PROPN,PROPN-PROPN,compound-conj,compound-pobj,NNP-NNP,NNP-NNP,5,1
6524,18676.0,56,reshaped,7,7,30,23,6,25,0,23,Washburn,Museum of Science,PERSON,ORGANIZATION-ORGANIZATION-ORGANIZATION,PROPN,PROPN-ADP-PROPN,nsubj,pobj-prep-pobj,NNP,NNP-IN-NNP,4,1
6525,18681.0,27,``,0,25,23,-2,24,3,-25,23,Bryan Fuller,series creator,PERSON-PERSON,TITLE-TITLE,PROPN-PROPN,NOUN-NOUN,compound-pobj,compound-compound,NNP-NNP,NN-NN,2,1
6526,18683.0,32,graduated,1,1,6,5,0,25,0,5,He,Frederick Douglass High School,PERSON,ORGANIZATION-ORGANIZATION-ORGANIZATION-ORGANIZATION,PRON,PROPN-PROPN-PROPN-PROPN,nsubj,compound-compound-compound-pobj,PRP,NNP-NNP-NNP-NNP,3,1
6527,18686.0,28,lead,10,9,1,-8,8,26,1,-9,Lewis Hamilton,Great Britain,PERSON-PERSON,COUNTRY-COUNTRY,PROPN-PROPN,PROPN-PROPN,compound-appos,compound-poss,NNP-NNP,NNP-NNP,4,1
6528,45812.0,22,Formula,1,12,15,3,11,6,-11,14,Lewis Hamilton,Great Britain,PERSON-PERSON,COUNTRY-COUNTRY,PROPN-PROPN,PROPN-PROPN,compound-dobj,compound-pobj,NNP-NNP,NNP-NNP,2,1
6529,18697.0,44,Committee,4,17,21,4,16,22,-13,17,Al Hubbard,director of the National Economic Council,PERSON-PERSON,TITLE-TITLE-TITLE-TITLE-TITLE-TITLE,PROPN-PROPN,NOUN-ADP-DET-PROPN-PROPN-PROPN,compound-dobj,appos-prep-det-compound-compound-pobj,NNP-NNP,NN-IN-DT-NNP-NNP-NNP,2,1
6530,18698.0,44,is,14,6,13,7,5,30,8,-1,Berthold Huber,57,PERSON-PERSON,NUMBER,PROPN-PROPN,NUM,compound-dobj,appos,NNP-NNP,CD,2,1
6531,18706.0,26,said,10,8,1,-7,7,24,2,-9,Gibson Guitar,Henry Juszkiewicz,ORGANIZATION-ORGANIZATION,PERSON-PERSON,PROPN-PROPN,PROPN-PROPN,compound-pobj,compound-nsubj,NNP-NNP,NNP-NNP,3,1
6532,18738.0,25,said,4,11,24,13,10,0,-7,20,JEM,North Darfur,ORGANIZATION,LOCATION-LOCATION,PROPN,PROPN-PROPN,compound,compound-pobj,NNP,NNP-NNP,7,1
6533,18742.0,15,dies,12,3,9,6,2,5,9,-3,Parren Mitchell,Congressional Black Caucus,PERSON-PERSON,ORGANIZATION-ORGANIZATION-ORGANIZATION,PROPN-PROPN,PROPN-PROPN-PROPN,compound-nsubj,compound-compound-pobj,NNP-NNP,NNP-NNP-NNP,4,1
6534,41696.0,26,dies,12,3,9,6,2,16,9,-3,Parren Mitchell,Congressional Black Caucus,PERSON-PERSON,ORGANIZATION-ORGANIZATION-ORGANIZATION,PROPN-PROPN,PROPN-PROPN-PROPN,compound-nsubj,compound-compound-pobj,NNP-NNP,NNP-NNP-NNP,4,1
6535,18744.0,52,is,26,9,2,-7,8,49,17,-24,AQR Capital Management,Clifford S Asness,ORGANIZATION-ORGANIZATION-ORGANIZATION,PERSON-PERSON-PERSON,PROPN-PROPN-PROPN,PROPN-PROPN-PROPN,compound-compound-pobj,compound-compound-nsubj,NNP-NNP-NNP,NNP-NNP-NNP,6,1
6536,28380.0,45,is,16,21,1,-20,20,43,-5,-15,AQR Capital Management,Clifford S Asness,ORGANIZATION-ORGANIZATION-ORGANIZATION,PERSON-PERSON-PERSON,PROPN-PROPN-PROPN,PROPN-PROPN-PROPN,compound-compound-pobj,compound-compound-nsubj,NNP-NNP-NNP,NNP-NNP-NNP,6,1
6537,67220.0,50,is,1,25,18,-7,24,31,-24,17,AQR Capital Management,Clifford S Asness,ORGANIZATION-ORGANIZATION-ORGANIZATION,PERSON-PERSON-PERSON,PROPN-PROPN-PROPN,PROPN-PROPN-PROPN,compound-compound-pobj,compound-compound-pobj,NNP-NNP-NNP,NNP-NNP-NNP,6,1
6538,18748.0,28,received,6,6,13,7,5,14,0,7,she,Ways and Means Committee,PERSON,ORGANIZATION-ORGANIZATION-ORGANIZATION-ORGANIZATION,PRON,PROPN-CCONJ-PROPN-PROPN,nsubj,nmod-cc-conj-pobj,PRP,NNPS-CC-NNPS-NNP,4,1
6539,18761.0,30,demanded,26,2,7,5,1,22,24,-19,Servicemembers Legal Defense Network,SLDN,ORGANIZATION-ORGANIZATION-ORGANIZATION-ORGANIZATION,ORGANIZATION,PROPN-PROPN-PROPN-PROPN,PROPN,compound-compound-compound-nsubj,compound,NNPS-NNP-NNP-NNP,NNP,4,1
6540,18768.0,29,worked,7,7,5,-2,6,23,0,-2,Mitchell,Congress,PERSON,ORGANIZATION,PROPN,PROPN,nsubj,pobj,NNP,NNP,1,1
6541,37309.0,28,reported,26,5,3,-2,4,24,21,-23,Mitchell,Congress,PERSON,ORGANIZATION,PROPN,PROPN,nsubj,pobj,NNP,NNP,1,1
6542,47860.0,55,called,26,21,25,4,20,29,5,-1,Mitchell,Congress,PERSON,ORGANIZATION,PROPN,PROPN,nsubj,pobj,NNP,NNP,7,1
6543,18780.0,91,reports,8,17,10,-7,16,80,-9,2,Mainland Affairs Council,Liu Teh-shun,ORGANIZATION-ORGANIZATION-ORGANIZATION,PERSON-PERSON,PROPN-PROPN-PROPN,PROPN-PROPN,compound-compound-pobj,compound-nsubj,NNP-NNPS-NNP,NNP-NNP,5,1
6544,18783.0,13,thinks,1,1,5,4,0,7,0,4,Pratt,Heidi Montag,PERSON,PERSON-PERSON,PROPN,PROPN-PROPN,nsubj,compound-appos,NNP,NNP-NNP,3,1
6545,18803.0,29,said,4,1,3,2,0,25,3,-1,Carnival Chairman,Micky Arison,ORGANIZATION-ORGANIZATION,PERSON-PERSON,PROPN-PROPN,PROPN-PROPN,compound-compound,compound-nsubj,NNP-NNP,NNP-NNP,1,1
6546,18814.0,24,headed,5,18,4,-14,17,19,-13,-1,she,Sanjaya,PERSON,PERSON,PRON,PROPN,nsubj,conj,PRP,NNP,4,1
6547,18816.0,33,said,13,1,7,6,0,25,12,-6,M. Enkhbold,MPRP,PERSON-PERSON,ORGANIZATION,PROPN-PROPN,PROPN,compound-nsubj,pobj,NNP-NNP,NNP,4,1
6548,18817.0,12,agreed,10,9,4,-5,8,7,1,-6,George Kennedy,Santa Clara County,PERSON-PERSON,LOCATION-LOCATION-LOCATION,PROPN-PROPN,PROPN-PROPN-PROPN,compound-conj,compound-compound-compound,NNP-NNP,NNP-NNP-NNP,3,1
6549,30045.0,26,took,8,7,20,13,6,5,1,12,George Kennedy,Santa Clara County,PERSON-PERSON,LOCATION-LOCATION-LOCATION,PROPN-PROPN,PROPN-PROPN-PROPN,compound-nsubj,compound-compound-pobj,NNP-NNP,NNP-NNP-NNP,9,1
6550,18820.0,30,survived,2,8,21,13,7,8,-6,19,Carol Ann Bellecourt,Janice Denny,PERSON-PERSON-PERSON,PERSON-PERSON,PROPN-PROPN-PROPN,PROPN-PROPN,compound-compound-appos,compound-appos,NNP-NNP-NNP,NNP-NNP,4,1
6551,18840.0,25,sought,4,7,23,16,6,1,-3,19,Mark Buse,senator,PERSON-PERSON,TITLE,PROPN-PROPN,NOUN,compound-dobj,nsubj,NNP-NNP,NN,1,1
6552,18842.0,38,hosting,2,27,33,6,26,4,-25,31,Organization of the Islamic Conference,OIC,ORGANIZATION-ORGANIZATION-ORGANIZATION-ORGANIZATION-ORGANIZATION,ORGANIZATION,PROPN-ADP-DET-PROPN-PROPN,PROPN,pobj-prep-det-compound-pobj,compound,NNP-IN-DT-NNP-NNP,NNP,13,1
6553,21664.0,37,closed,8,29,35,6,28,1,-21,27,Organization of the Islamic Conference,OIC,ORGANIZATION-ORGANIZATION-ORGANIZATION-ORGANIZATION-ORGANIZATION,ORGANIZATION,PROPN-ADP-DET-PROPN-PROPN,PROPN,pobj-prep-det-compound-pobj,compound,NNP-IN-DT-NNP-NNP,NNP,7,1
6554,25734.0,36,General,1,5,11,6,4,24,-4,10,Organization of the Islamic Conference,OIC,ORGANIZATION-ORGANIZATION-ORGANIZATION-ORGANIZATION-ORGANIZATION,ORGANIZATION,PROPN-ADP-DET-PROPN-PROPN,PROPN,pobj-prep-det-compound-pobj,compound,NNP-IN-DT-NNP-NNP,NNP,5,1
6555,34937.0,49,TEHRAN,0,26,32,6,25,16,-26,32,Organization of the Islamic Conference,OIC,ORGANIZATION-ORGANIZATION-ORGANIZATION-ORGANIZATION-ORGANIZATION,ORGANIZATION,PROPN-ADP-DET-PROPN-PROPN,PROPN,pobj-prep-det-compound-pobj,compound,NNP-IN-DT-NNP-NNP,NNP,6,1
6556,46582.0,36,told,1,17,23,6,16,12,-16,22,Organization of the Islamic Conference,OIC,ORGANIZATION-ORGANIZATION-ORGANIZATION-ORGANIZATION-ORGANIZATION,ORGANIZATION,PROPN-ADP-DET-PROPN-PROPN,PROPN,pobj-prep-det-compound-pobj,compound,NNP-IN-DT-NNP-NNP,NNP,9,1
6557,46905.0,65,Participants,0,13,19,6,12,45,-13,19,Organization of the Islamic Conference,OIC,ORGANIZATION-ORGANIZATION-ORGANIZATION-ORGANIZATION-ORGANIZATION,ORGANIZATION,PROPN-ADP-DET-PROPN-PROPN,PROPN,pobj-prep-det-compound-pobj,compound,NNP-IN-DT-NNP-NNP,NNP,7,1
6558,51622.0,38,opens,5,27,33,6,26,4,-22,28,Organization of the Islamic Conference,OIC,ORGANIZATION-ORGANIZATION-ORGANIZATION-ORGANIZATION-ORGANIZATION,ORGANIZATION,PROPN-ADP-DET-PROPN-PROPN,PROPN,pobj-prep-det-compound-pobj,compound,NNP-IN-DT-NNP-NNP,NNP,8,1
6559,62282.0,35,axe,1,13,19,6,12,15,-12,18,Organization of the Islamic Conference,OIC,ORGANIZATION-ORGANIZATION-ORGANIZATION-ORGANIZATION-ORGANIZATION,ORGANIZATION,PROPN-ADP-DET-PROPN-PROPN,PROPN,conj-prep-det-compound-pobj,compound,NNP-IN-DT-NNP-NNP,NNP,6,1
6560,18843.0,37,'s,7,18,20,2,17,16,-11,13,Beyonce,Jay Z,PERSON,PERSON-PERSON,PROPN,PROPN-PROPN,appos,compound-conj,NNP,NNP-NNP,2,1
6561,18844.0,38,cover,9,7,35,28,6,2,2,26,Shanghai Disneyland,Disney,ORGANIZATION-ORGANIZATION,ORGANIZATION,PROPN-PROPN,PROPN,compound-pobj,poss,NNP-NNP,NNP,8,1
6562,18861.0,50,said,12,8,2,-6,7,47,4,-10,National Republican Campaign Committee,Lindsay,ORGANIZATION-ORGANIZATION-ORGANIZATION-ORGANIZATION,PERSON,PROPN-PROPN-PROPN-PROPN,PROPN,compound-compound-compound-pobj,nsubj,NNP-NNP-NNP-NNP,NNP,5,1
6563,18870.0,27,survived,2,14,8,-6,13,18,-12,6,Sherwood Morgan Jr.,Brenda Morgan Bacquie,PERSON-PERSON-PERSON,PERSON-PERSON-PERSON,PROPN-PROPN-PROPN,PROPN-PROPN-PROPN,compound-compound-appos,compound-compound-appos,NNP-NNP-NNP,NNP-NNP-NNP,4,1
6564,18887.0,30,REMY,2,3,23,20,2,6,-1,21,REMY MA,Remy Smith,PERSON-PERSON,PERSON-PERSON,PROPN-PROPN,PROPN-PROPN,ROOT-compound,compound-poss,NNP-NNP,NNP-NNP,4,1
6565,18890.0,49,said,17,11,1,-10,10,47,6,-16,ADB,PowerGrid Corp,ORGANIZATION,ORGANIZATION-ORGANIZATION,PROPN,PROPN-PROPN,compound,compound-nsubj,NNP,NNP-NNP,-1,1
6566,18891.0,28,suggested,2,6,4,-2,5,23,-4,2,Barry Goldwater,US,PERSON-PERSON,COUNTRY,PROPN-PROPN,PROPN,compound-dobj,compound,NNP-NNP,NNP,1,1
6567,18898.0,29,went,6,28,6,-22,27,22,-22,0,EnergySolutions,Reid,ORGANIZATION,PERSON,PROPN,PROPN,pobj,nsubj,NNP,NNP,1,1
6568,18903.0,37,taped,10,9,6,-3,8,30,1,-4,Ellen Degeneres,New Orleans,PERSON-PERSON,CITY-CITY,PROPN-PROPN,PROPN-PROPN,compound-nsubj,compound-nmod,NNP-NNP,NNP-NNP,2,1
6569,18915.0,37,comprises,3,1,1,0,0,35,2,-2,China National Aviation Corporation,China Aviation Group,ORGANIZATION-ORGANIZATION-ORGANIZATION-ORGANIZATION,ORGANIZATION-ORGANIZATION-ORGANIZATION,PROPN-PROPN-PROPN-PROPN,PROPN-PROPN-PROPN,compound-compound-compound-conj,compound-compound-nsubj,NNP-NNP-NNP-NNP,NNP-NNP-NNP,0,1
6570,18918.0,33,co-founded,4,7,2,-5,6,30,-3,-2,International Crisis Group,1995,ORGANIZATION-ORGANIZATION-ORGANIZATION,DATE,PROPN-PROPN-PROPN,NUM,compound-compound-dobj,pobj,NNP-NNP-NNP,CD,4,1
6571,18928.0,18,landed,2,1,16,15,0,1,1,14,He,hair stylist,PERSON,TITLE-TITLE,PRON,NOUN-NOUN,nsubj,conj-attr,PRP,NN-NN,6,1
6572,18931.0,49,spent,18,6,17,11,5,31,12,-1,American Beverage Association,Pepsi,ORGANIZATION-ORGANIZATION-ORGANIZATION,ORGANIZATION,PROPN-PROPN-PROPN,PROPN,compound-compound-nsubj,conj,NNP-NNP-NNP,NNP,3,1
6573,18943.0,44,Smits,0,29,26,-3,28,17,-29,26,Hector Elizondo,Rita Moreno,PERSON-PERSON,PERSON-PERSON,PROPN-PROPN,PROPN-PROPN,compound-appos,compound-pobj,NNP-NNP,NNP-NNP,3,1
6574,18949.0,37,claims,10,7,2,-5,6,34,3,-8,Dee Dee Myers,president,PERSON-PERSON-PERSON,TITLE,PROPN-PROPN-PROPN,NOUN,compound-compound-appos,poss,NNP-NNP-NNP,NN,4,1
6575,18951.0,15,returned,2,5,8,3,4,6,-3,6,his,Bremen,PERSON,CITY,DET,PROPN,poss,pobj,PRP$,NNP,1,1
6576,18960.0,45,said,40,39,16,-23,38,28,1,-24,FMF,Mexican Federation,ORGANIZATION,ORGANIZATION-ORGANIZATION,PROPN,PROPN-PROPN,compound,compound-nsubj,NNP,NNP-NNP,6,1
6577,39105.0,50,striker,10,44,21,-23,43,28,-34,11,FMF,Mexican Federation,ORGANIZATION,ORGANIZATION-ORGANIZATION,PROPN,PROPN-PROPN,compound,compound-nsubj,NNP,NNP-NNP,3,1
6578,18966.0,45,said,24,14,41,27,13,3,10,17,MDC,Movement for Democratic Change,ORGANIZATION,ORGANIZATION-ORGANIZATION-ORGANIZATION-ORGANIZATION,PROPN,PROPN-ADP-PROPN-PROPN,pobj,pobj-prep-compound-pobj,NNP,NNP-IN-NNP-NNP,7,1
6579,18973.0,32,said,4,1,3,2,0,28,3,-1,SLDN,Steve Ralls,ORGANIZATION,PERSON-PERSON,PROPN,PROPN-PROPN,compound,compound-nsubj,NNP,NNP-NNP,1,1
6580,18994.0,35,disappeared,27,24,17,-7,23,17,3,-10,Le Point,Salongo,ORGANIZATION-ORGANIZATION,PERSON,PROPN-PROPN,PROPN,nmod-nmod,pobj,NNP-NNP,NNP,6,1
6581,18999.0,17,promised,8,10,6,-4,9,10,-2,-2,she,star,PERSON,TITLE,PRON,NOUN,nsubj,compound,PRP,NN,4,1
6582,19001.0,36,released,25,35,1,-34,34,34,-10,-24,Babyshambles,Doherty,ORGANIZATION,PERSON,PROPN,NOUN,appos,nsubj,NNP,NN,3,1
6583,61623.0,29,said,7,14,9,-5,13,19,-7,2,Babyshambles,Doherty,ORGANIZATION,PERSON,PROPN,PROPN,dobj,nsubj,NNPS,NNP,4,1
6584,19003.0,39,2009-08-08T15,0,33,10,-23,32,28,-33,10,Trista Sutter,star,PERSON-PERSON,TITLE,PROPN-PROPN,NOUN,compound-nsubjpass,compound,NNP-NNP,NN,5,1
6585,29178.0,85,Sutter,1,1,44,43,0,40,0,43,Trista Sutter,star,PERSON-PERSON,TITLE,PROPN-PROPN,NOUN,compound-ROOT,appos,NNP-NNP,NN,-1,1
6586,19006.0,30,repeated,3,1,20,19,0,9,2,17,Hadad Adel,Iranian,PERSON-PERSON,NATIONALITY,PROPN-PROPN,ADJ,compound-nsubj,amod,NNP-NNP,JJ,7,1
6587,19008.0,19,arrested,2,1,11,10,0,7,1,9,Morgan,resisting arrest,PERSON,CRIMINAL_CHARGE-CRIMINAL_CHARGE,PROPN,VERB-NOUN,nsubjpass,advcl-dobj,NNP,VBG-NN,5,1
6588,19015.0,55,IS,2,53,38,-15,52,16,-51,36,Badr Organization,Hadi al-Ameri,ORGANIZATION-ORGANIZATION,PERSON-PERSON,PROPN-PROPN,PROPN-ADV,compound-pobj,compound-conj,NNP-NNP,NNP-RB,8,1
6589,44012.0,52,said,22,37,30,-7,36,21,-15,8,Badr Organization,Hadi al-Ameri,ORGANIZATION-ORGANIZATION,PERSON-PERSON,PROPN-PROPN,PROPN-ADV,compound-dobj,compound-appos,NNP-NNP,NNP-RB,3,1
6590,61307.0,46,were,8,44,29,-15,43,16,-36,21,Badr Organization,Hadi al-Ameri,ORGANIZATION-ORGANIZATION,PERSON-PERSON,PROPN-PROPN,PROPN-ADV,compound-pobj,compound-conj,NNP-NNP,NNP-RB,8,1
6591,19021.0,37,TEHRAN,0,7,11,4,6,25,-7,11,Ayatollah Ali Khamenei,Iranians,PERSON-PERSON-PERSON,MISC,PROPN-PROPN-PROPN,PROPN,compound-compound-appos,dobj,NNP-NNP-NNP,NNPS,5,1
6592,19030.0,25,born,4,1,7,6,0,17,3,3,Steven Boghos Derounian,Sofia,PERSON-PERSON-PERSON,CITY,PROPN-PROPN-PROPN,PROPN,compound-compound-nsubjpass,pobj,NNP-NNP-NNP,NNP,5,1
6593,19039.0,27,born,2,1,9,8,0,17,1,7,She,1932,PERSON,DATE,PRON,NUM,nsubjpass,nummod,PRP,CD,-1,1
6594,19042.0,17,chair,13,11,2,-9,10,14,2,-11,Citibank,Alok Prasad,ORGANIZATION,PERSON-PERSON,PROPN,PROPN-PROPN,npadvmod,compound-nsubj,NNP,NNP-NNP,2,1
6595,19043.0,24,say,3,19,23,4,18,0,-16,20,CCP,Beijing,ORGANIZATION,CITY,PROPN,PROPN,compound,pobj,NNP,NNP,5,1
6596,19055.0,27,seems,23,12,8,-4,11,18,11,-15,Raul,Cuba,PERSON,COUNTRY,PROPN,PROPN,appos,poss,NNP,NNP,4,1
6597,19069.0,49,is,3,40,45,5,39,3,-37,42,NSW Rugby Union,Fraser Neill,ORGANIZATION-ORGANIZATION-ORGANIZATION,PERSON-PERSON,PROPN-PROPN-PROPN,PROPN-PROPN,nmod-nmod-nmod,compound-nsubj,NNP-NNP-NNP,NNP-NNP,4,1
6598,19073.0,26,saw,1,3,1,-2,2,24,-2,0,his,Dodd,PERSON,PERSON,DET,PROPN,poss,nsubj,PRP$,NNP,1,1
6599,19079.0,50,said,16,42,44,2,41,5,-26,28,APA,Council of Representatives,ORGANIZATION,ORGANIZATION-ORGANIZATION-ORGANIZATION,PROPN,PROPN-ADP-PROPN,poss,nsubj-prep-pobj,NNP,NNP-IN-NNPS,1,1
6600,19080.0,34,chief,2,17,21,4,16,12,-15,19,Negroponte,diplomat,PERSON,TITLE,PROPN,NOUN,nsubj,appos,NNP,NN,1,1
6601,19137.0,30,pushing,2,6,20,14,5,9,-4,18,Negroponte,diplomat,PERSON,TITLE,PROPN,NOUN,dobj,nsubj,NNP,NN,5,1
6602,54851.0,33,described,6,8,12,4,7,20,-2,6,Negroponte,diplomat,PERSON,TITLE,PROPN,NOUN,dobj,pobj,NNP,NN,2,1
6603,19083.0,24,attended,17,13,23,10,12,0,4,6,he,UCLA,PERSON,ORGANIZATION,PRON,PROPN,nsubj,conj,PRP,NNP,3,1
6604,19092.0,25,survived,2,1,8,7,0,16,1,6,She,Brenda Morgan Bacquie,PERSON,PERSON-PERSON-PERSON,PRON,PROPN-PROPN-PROPN,nsubjpass,compound-compound-appos,PRP,NNP-NNP-NNP,5,1
6605,19104.0,38,involved,9,5,7,2,4,30,4,-2,JNF,Himnuta,ORGANIZATION,LOCATION,PROPN,PROPN,pobj,appos,NNP,NNP,2,1
6606,19108.0,17,warned,3,1,3,2,0,13,2,0,Samsung,Yi,ORGANIZATION,PERSON,PROPN,PROPN,poss,nsubj,NNP,NNP,3,1
6607,19135.0,14,concluded,11,1,5,4,0,8,10,-6,American Bar Association,http://wwwabanetorg,ORGANIZATION-ORGANIZATION-ORGANIZATION,URL,PROPN-PROPN-PROPN,PUNCT,compound-compound-dep,appos,NNP-NNP-NNP,.,3,1
6608,19148.0,40,said,11,17,13,-4,16,26,-6,2,IMF,Meral Karasulu,ORGANIZATION,PERSON-PERSON,PROPN,PROPN-PROPN,poss,compound-nsubj,NNP,NNP-NNP,3,1
6609,19150.0,29,continued,7,7,3,-4,6,25,0,-4,Scheider,Sag Harbor,PERSON,LOCATION-LOCATION,PROPN,PROPN-PROPN,nsubj,compound-pobj,NNP,NNP-NNP,3,1
6610,19153.0,47,took,8,8,12,4,7,34,0,4,Ferrara,Juve,PERSON,ORGANIZATION,PROPN,PROPN,nsubj,dobj,NNP,NNP,1,1
6611,19155.0,35,said,7,6,2,-4,5,32,1,-5,AAA,American Automobile Association,ORGANIZATION,ORGANIZATION-ORGANIZATION-ORGANIZATION,PROPN,PROPN-PROPN-PROPN,compound,compound-compound-nsubj,NNP,NNP-NNP-NNP,3,1
6612,32216.0,42,projected,10,6,2,-4,5,39,4,-8,AAA,American Automobile Association,ORGANIZATION,ORGANIZATION-ORGANIZATION-ORGANIZATION,PROPN,PROPN-PROPN-PROPN,compound,compound-compound-nsubj,NNP,NNP-NNP-NNP,3,1
6613,54655.0,24,sells,7,6,2,-4,5,21,1,-5,AAA,American Automobile Association,ORGANIZATION,ORGANIZATION-ORGANIZATION-ORGANIZATION,PROPN,PROPN-PROPN-PROPN,compound,compound-compound-nsubj,NNP,NNP-NNP-NNP,3,1
6614,59004.0,43,released,9,2,6,4,1,36,7,-3,AAA,American Automobile Association,ORGANIZATION,ORGANIZATION-ORGANIZATION-ORGANIZATION,PROPN,PROPN-PROPN-PROPN,nsubj,compound-compound-appos,NNP,NNP-NNP-NNP,3,1
6615,62046.0,23,expects,9,8,4,-4,7,18,1,-5,AAA,American Automobile Association,ORGANIZATION,ORGANIZATION-ORGANIZATION-ORGANIZATION,PROPN,PROPN-PROPN-PROPN,compound,compound-compound-nsubj,NNP,NNP-NNP-NNP,3,1
6616,19158.0,23,said,17,14,17,3,13,5,3,0,IMF,Sarkozy,ORGANIZATION,PERSON,PROPN,PROPN,pobj,nsubj,NNP,NNP,7,1
6617,19166.0,10,was,6,1,4,3,0,5,5,-2,His,Nyanza Hawkins,PERSON,PERSON-PERSON,DET,PROPN-PROPN,poss,compound-appos,PRP$,NNP-NNP,1,1
6618,19169.0,22,say,5,4,14,10,3,7,1,9,Red Sox,Major League Baseball,ORGANIZATION-ORGANIZATION,ORGANIZATION-ORGANIZATION-ORGANIZATION,PROPN-PROPN,PROPN-PROPN-PROPN,compound-conj,compound-compound-compound,NNP-NNPS,NNP-NNP-NNP,8,1
6619,64735.0,31,turn,5,3,21,18,2,9,2,16,Red Sox,Major League Baseball,ORGANIZATION-ORGANIZATION,ORGANIZATION-ORGANIZATION-ORGANIZATION,PROPN-PROPN,PROPN-PROPN-PROPN,compound-nsubj,compound-compound-poss,NNP-NNPS,NNP-NNP-NNP,7,1
6620,19177.0,20,reported,17,6,13,7,5,6,11,-4,Oscar Peterson,Toronto,PERSON-PERSON,CITY,PROPN-PROPN,PROPN,compound-conj,compound,NNP-NNP,NNP,4,1
6621,35491.0,40,said,37,5,28,23,4,11,32,-9,Oscar Peterson,Toronto,PERSON-PERSON,CITY,PROPN-PROPN,PROPN,compound-nsubj,compound,NNP-NNP,NNP,4,1
6622,19178.0,36,studied,18,18,16,-2,17,19,0,-2,Waldheim,Vienna University,PERSON,ORGANIZATION-ORGANIZATION,PROPN,PROPN-PROPN,nsubj,compound-pobj,NNP,NNP-NNP,1,1
6623,19189.0,26,said,17,11,8,-3,10,17,6,-9,her,late Saturday,PERSON,DATE-DATE,DET,ADJ-PROPN,poss,amod-npadvmod,PRP$,JJ-NNP,1,1
6624,19195.0,36,said,21,24,34,10,23,1,-3,13,Christopher J. Dodd,banking committee,PERSON-PERSON-PERSON,ORGANIZATION-ORGANIZATION,PROPN-PROPN-PROPN,NOUN-NOUN,compound-compound-nsubj,compound-pobj,NNP-NNP-NNP,NN-NN,3,1
6625,19201.0,10,do,1,9,3,-6,8,6,-8,2,Carnival,Cunard,ORGANIZATION,ORGANIZATION,PROPN,PROPN,pobj,compound,NNP,NNP,2,1
6626,19203.0,13,received,1,1,8,7,0,4,0,7,He,University of Connecticut,PERSON,ORGANIZATION-ORGANIZATION-ORGANIZATION,PRON,PROPN-ADP-PROPN,nsubj,pobj-prep-pobj,PRP,NNP-IN-NNP,3,1
6627,19205.0,42,said,18,26,28,2,25,13,-8,10,IAPA,committee on press freedom,ORGANIZATION,ORGANIZATION-ORGANIZATION-ORGANIZATION-ORGANIZATION,PROPN,NOUN-ADP-NOUN-NOUN,poss,pobj-prep-compound-pobj,NNP,NN-IN-NN-NN,3,1
6628,19206.0,35,said,8,26,4,-22,25,30,-18,-4,he,president,PERSON,TITLE,PRON,NOUN,nsubj,nsubj,PRP,NN,4,1
6629,20805.0,24,shunned,7,14,23,9,13,0,-7,16,he,president,PERSON,TITLE,PRON,NOUN,nsubj,attr,PRP,NN,2,1
6630,30002.0,25,inaugurated,5,13,10,-3,12,14,-8,5,he,president,PERSON,TITLE,PRON,NOUN,nsubj,pobj,PRP,NN,2,1
6631,52161.0,46,Party,3,32,9,-23,31,36,-29,6,he,president,PERSON,TITLE,PRON,NOUN,nsubj,nsubjpass,PRP,NN,4,1
6632,54150.0,47,Copulos,2,37,7,-30,36,39,-35,5,he,president,PERSON,TITLE,PRON,NOUN,nsubj,attr,PRP,NN,5,1
6633,19212.0,38,began,19,2,6,4,1,31,17,-13,Christopher J. Dodd,D-Conn.,PERSON-PERSON-PERSON,LOCATION,PROPN-PROPN-PROPN,PROPN,compound-compound-nsubj,appos,NNP-NNP-NNP,NNP,2,1
6634,19232.0,40,reports,38,10,8,-2,9,31,28,-30,Sculfor,British,PERSON,NATIONALITY,PROPN,ADJ,compound,amod,NNP,JJ,1,1
6635,19237.0,38,died,33,1,18,17,0,19,32,-15,Philip M. Kaiser,diplomat,PERSON-PERSON-PERSON,TITLE,PROPN-PROPN-PROPN,NOUN,compound-compound-nsubj,pobj,NNP-NNP-NNP,NN,6,1
6636,19241.0,20,be,7,6,19,13,5,0,1,12,Chen,China,PERSON,COUNTRY,PROPN,PROPN,nsubj,pobj,NNP,NNP,2,1
6637,34356.0,18,said,1,7,11,4,6,6,-6,10,Chen,China,PERSON,COUNTRY,PROPN,PROPN,pobj,poss,NNP,NNP,7,1
6638,19243.0,31,lived,12,1,11,10,0,19,11,-1,Irene Morgan Kirkaldy,Baltimore,PERSON-PERSON-PERSON,CITY,PROPN-PROPN-PROPN,PROPN,compound-compound-nsubj,pobj,NNP-NNP-NNP,NNP,3,1
6639,19259.0,46,was,12,10,8,-2,9,37,2,-4,Hussein Kamel,Lt. Gen.,PERSON-PERSON,TITLE-TITLE,PROPN-PROPN,PROPN-PROPN,compound-appos,compound-compound,NNP-NNP,NNP-NNP,4,1
6640,27571.0,26,accused,3,21,19,-2,20,6,-18,16,Hussein Kamel,Lt. Gen.,PERSON-PERSON,TITLE-TITLE,PROPN-PROPN,PROPN-PROPN,compound-ROOT,compound-compound,NNP-NNP,NNP-NNP,1,1
6641,52374.0,33,heard,4,1,27,26,0,5,3,23,Hussein Kamel,Lt. Gen.,PERSON-PERSON,TITLE-TITLE,PROPN-PROPN,PROPN-PROPN,compound-appos,compound-compound,NNP-NNP,NNP-NNP,11,1
6642,19274.0,41,was,7,1,4,3,0,36,6,-3,Her,Larkin Douglass Watson,PERSON,PERSON-PERSON-PERSON,DET,PROPN-PROPN-PROPN,poss,compound-compound-appos,PRP$,NNP-NNP-NNP,2,1
6643,19275.0,32,said,18,28,20,-8,27,11,-10,2,National Military Family Association,Joyce Raezer,ORGANIZATION-ORGANIZATION-ORGANIZATION-ORGANIZATION,PERSON-PERSON,PROPN-PROPN-PROPN-PROPN,PROPN-PROPN,compound-compound-compound-pobj,compound-nsubj,NNP-NNP-NNP-NNP,NNP-NNP,5,1
6644,36274.0,26,surprised,18,8,1,-7,7,24,10,-17,National Military Family Association,Joyce Raezer,ORGANIZATION-ORGANIZATION-ORGANIZATION-ORGANIZATION,PERSON-PERSON,PROPN-PROPN-PROPN-PROPN,PROPN-PROPN,compound-compound-compound-pobj,compound-nsubjpass,NNP-NNP-NNP-NNP,NNP-NNP,5,1
6645,67289.0,35,said,16,25,18,-7,24,16,-9,2,National Military Family Association,Joyce Raezer,ORGANIZATION-ORGANIZATION-ORGANIZATION-ORGANIZATION,PERSON-PERSON,PROPN-PROPN-PROPN-PROPN,PROPN-PROPN,compound-compound-compound-pobj,compound-nsubj,NNP-NNP-NNP-NNP,NNP-NNP,5,1
6646,19279.0,37,acknowledged,17,5,11,6,4,25,12,-6,R Nicholas Burns,US negotiator,PERSON-PERSON-PERSON,TITLE-TITLE,PROPN-PROPN-PROPN,PROPN-NOUN,compound-compound-appos,compound-appos,NNP-NNP-NNP,NNP-NN,2,1
6647,19281.0,21,was,1,1,4,3,0,16,0,3,He,special representative,PERSON,TITLE-TITLE,PRON,ADJ-NOUN,nsubj,amod-attr,PRP,JJ-NN,1,1
6648,19296.0,19,born,2,1,5,4,0,13,1,3,He,St Matthews,PERSON,CITY-CITY,PRON,PROPN-PROPN,nsubjpass,compound-pobj,PRP,NNP-NNP,3,1
6649,19300.0,32,said,30,4,3,-1,3,28,26,-27,Gholam-Ali Haddad-Adel,speaker,PERSON-PERSON,TITLE,PROPN-PROPN,NOUN,compound-nsubj,compound,NNP-NNP,NN,2,1
6650,19304.0,59,is,12,25,6,-19,24,52,-13,-6,Goldwater,Arizona,PERSON,STATE_OR_PROVINCE,PROPN,PROPN,pobj,poss,NNP,NNP,11,1
6651,34793.0,45,dat,2,40,38,-2,39,6,-38,36,Goldwater,Arizona,PERSON,STATE_OR_PROVINCE,PROPN,PROPN,nsubj,pobj,NNP,NNP,1,1
6652,19307.0,26,was,23,14,20,6,13,5,9,-3,Cathleen Black,Hearst Magazines,PERSON-PERSON,ORGANIZATION-ORGANIZATION,PROPN-PROPN,PROPN-PROPN,compound-attr,compound-pobj,NNP-NNP,NNP-NNPS,3,1
6653,56916.0,33,booked,12,24,29,5,23,3,-12,17,Cathleen Black,Hearst Magazines,PERSON-PERSON,ORGANIZATION-ORGANIZATION,PROPN-PROPN,PROPN-PROPN,compound-dobj,compound-pobj,NNP-NNP,NNP-NNPS,3,1
6654,19308.0,20,denied,4,3,1,-2,2,18,1,-3,Lee Jye,Defence,PERSON-PERSON,ORGANIZATION,PROPN-PROPN,NOUN,compound-nsubj,compound,NNP-NNP,NN,1,1
6655,19320.0,35,survived,2,1,22,21,0,12,1,20,Derounian,Lexington,PERSON,CITY,PROPN,PROPN,nsubjpass,pobj,NNP,NNP,7,1
6656,19321.0,29,added,27,13,5,-8,12,23,14,-22,PRC,Kamal al-Nirab,ORGANIZATION,PERSON-PERSON,PROPN,PROPN-PROPN,poss,compound-appos,NNP,NNP-NNP,3,1
6657,19331.0,42,pays,2,6,22,16,5,19,-4,20,Waldheim,diplomat,PERSON,TITLE,PROPN,NOUN,pobj,oprd,NNP,NN,7,1
6658,41067.0,47,noted,14,16,24,8,15,22,-2,10,Waldheim,diplomat,PERSON,TITLE,PROPN,NOUN,poss,pobj,NNP,NN,4,1
6659,43025.0,49,praised,14,16,34,18,15,14,-2,20,Waldheim,diplomat,PERSON,TITLE,PROPN,NOUN,poss,pobj,NNP,NN,6,1
6660,19332.0,40,said,14,2,33,31,1,6,12,19,He,CIA,PERSON,ORGANIZATION,PRON,PROPN,nsubj,compound,PRP,NNP,7,1
6661,19342.0,39,host,25,1,12,11,0,26,24,-13,Olivia Palermo,Creative Director,PERSON-PERSON,TITLE-TITLE,PROPN-PROPN,PROPN-PROPN,compound-nsubj,compound-appos,NNP-NNP,NNP-NNP,2,1
6662,19343.0,47,selected,3,1,10,9,0,36,2,7,He,Society of Islamic Coalition,PERSON,ORGANIZATION-ORGANIZATION-ORGANIZATION-ORGANIZATION,PRON,PROPN-ADP-PROPN-PROPN,nsubjpass,pobj-prep-compound-pobj,PRP,NNP-IN-NNP-NNP,6,1
6663,19346.0,28,scored,4,18,14,-4,17,13,-14,10,Donald E. Wildmon,leader,PERSON-PERSON-PERSON,TITLE,PROPN-PROPN-PROPN,NOUN,compound-compound-appos,pobj,NNP-NNP-NNP,NN,3,1
6664,19353.0,46,left,11,11,3,-8,10,42,0,-8,Ospel,1950,PERSON,DATE,PROPN,NUM,nsubj,pobj,NNP,CD,2,1
6665,19374.0,23,said,4,20,3,-17,19,19,-16,-1,him,66,PERSON,NUMBER,PRON,NUM,dobj,appos,PRP,CD,4,1
6666,19375.0,37,said,35,3,2,-1,2,34,32,-33,ElBaradei,Doctor,PERSON,TITLE,PROPN,PROPN,nsubj,compound,NNP,NNP,1,1
6667,19398.0,22,said,20,1,3,2,0,18,19,-17,Scheider,Sunday,PERSON,DATE,PROPN,PROPN,nsubj,npadvmod,NNP,NNP,1,1
6668,19408.0,39,died,30,1,13,12,0,25,29,-17,Mary Dent Crisp,Republican Party,PERSON-PERSON-PERSON,ORGANIZATION-ORGANIZATION,PROPN-PROPN-PROPN,PROPN-PROPN,compound-compound-nsubj,compound-pobj,NNP-NNP-NNP,NNP-NNP,6,1
6669,19416.0,48,said,36,45,38,-7,44,9,-9,2,American Bar Association,Karen J. Mathis,ORGANIZATION-ORGANIZATION-ORGANIZATION,PERSON-PERSON-PERSON,PROPN-PROPN-PROPN,PROPN-PROPN-PROPN,compound-compound-pobj,compound-compound-nsubj,NNP-NNP-NNP,NNP-NNP-NNP,5,1
6670,45758.0,33,criticized,10,4,8,4,3,24,6,-2,American Bar Association,Karen J. Mathis,ORGANIZATION-ORGANIZATION-ORGANIZATION,PERSON-PERSON-PERSON,PROPN-PROPN-PROPN,PROPN-PROPN-PROPN,compound-compound-compound,compound-compound-nsubj,NNP-NNP-NNP,NNP-NNP-NNP,4,1
6671,19418.0,52,BBA-REDSOX-TIGERS,0,33,23,-10,32,28,-33,23,Red Sox,Detroit,ORGANIZATION-ORGANIZATION,CITY,PROPN-PROPN,PROPN,compound-dobj,poss,NNP-NNPS,NNP,7,1
6672,19423.0,20,set,7,4,10,6,3,9,3,3,All Basotho Convention,four months ago,ORGANIZATION-ORGANIZATION-ORGANIZATION,DATE-DATE-DATE,PROPN-PROPN-PROPN,NUM-NOUN-ADV,det-compound-nsubj,nummod-npadvmod-advmod,NNP-NNP-NNP,CD-NNS-RB,5,1
6673,56642.0,45,complained,14,8,11,3,7,33,6,-3,All Basotho Convention,four months ago,ORGANIZATION-ORGANIZATION-ORGANIZATION,DATE-DATE-DATE,PROPN-PROPN-PROPN,NUM-NOUN-ADV,compound-compound-dobj,nummod-npadvmod-advmod,NNP-NNP-NNP,CD-NNS-RB,4,1
6674,19424.0,34,Lines,2,1,15,14,0,18,1,13,Carnival Cruise Lines,CCL,ORGANIZATION-ORGANIZATION-ORGANIZATION,ORGANIZATION,PROPN-PROPN-PROPN,PROPN,compound-compound-ROOT,appos,NNP-NNP-NNPS,NNP,4,1
6675,19430.0,14,was,11,1,10,9,0,3,10,-1,Flowers,bribery,PERSON,CRIMINAL_CHARGE,NOUN,NOUN,nsubj,pobj,NNS,NN,3,1
6676,19451.0,49,said,47,13,10,-3,12,38,34,-37,Nicholas Burns,Secretary of State,PERSON-PERSON,TITLE-TITLE-TITLE,PROPN-PROPN,PROPN-ADP-PROPN,compound-pobj,nmod-prep-pobj,NNP-NNP,NNP-IN-NNP,2,1
6677,22779.0,25,told,22,21,18,-3,20,6,1,-4,Nicholas Burns,Secretary of State,PERSON-PERSON,TITLE-TITLE-TITLE,PROPN-PROPN,PROPN-ADP-PROPN,compound-nsubj,nmod-prep-pobj,NNP-NNP,NNP-IN-NNP,4,1
6678,26104.0,32,comes,3,13,10,-3,12,21,-10,7,Nicholas Burns,Secretary of State,PERSON-PERSON,TITLE-TITLE-TITLE,PROPN-PROPN,PROPN-ADP-PROPN,compound-nsubj,nmod-prep-pobj,NNP-NNP,NNP-IN-NNP,2,1
6679,28039.0,56,said,51,5,2,-3,4,53,46,-49,Nicholas Burns,Secretary of State,PERSON-PERSON,TITLE-TITLE-TITLE,PROPN-PROPN,PROPN-ADP-PROPN,compound-pobj,nmod-prep-pobj,NNP-NNP,NNP-IN-NNP,2,1
6680,29659.0,65,said,35,46,43,-3,45,21,-11,8,Nicholas Burns,Secretary of State,PERSON-PERSON,TITLE-TITLE-TITLE,PROPN-PROPN,PROPN-ADP-PROPN,compound-nsubj,nmod-prep-pobj,NNP-NNP,NNP-IN-NNP,2,1
6681,31326.0,40,had,28,8,2,-6,7,37,20,-26,Nicholas Burns,Secretary of State,PERSON-PERSON,TITLE-TITLE-TITLE,PROPN-PROPN,PROPN-ADP-PROPN,compound-pobj,nmod-prep-pobj,NNP-NNP,NNP-IN-NNP,3,1
6682,52540.0,44,am,2,25,19,-6,24,24,-23,17,Nicholas Burns,Secretary of State,PERSON-PERSON,TITLE-TITLE-TITLE,PROPN-PROPN,PROPN-ADP-PROPN,compound-nsubj,pobj-prep-pobj,NNP-NNP,NNP-IN-NNP,4,1
6683,56525.0,42,told,7,5,2,-3,4,39,2,-5,Nicholas Burns,Secretary of State,PERSON-PERSON,TITLE-TITLE-TITLE,PROPN-PROPN,PROPN-ADP-PROPN,compound-nsubj,nmod-prep-pobj,NNP-NNP,NNP-IN-NNP,2,1
6684,19452.0,50,survived,9,13,8,-5,12,41,-4,-1,Jennifer Buchwald,Buchwald,PERSON-PERSON,PERSON,PROPN-PROPN,PROPN,compound-appos,nsubjpass,NNP-NNP,NNP,3,1
6685,19455.0,36,overlooks,5,15,34,19,14,1,-10,29,Massachusetts House of Representatives,Tom Finneran,ORGANIZATION-ORGANIZATION-ORGANIZATION-ORGANIZATION,PERSON-PERSON,PROPN-PROPN-ADP-PROPN,PROPN-PROPN,compound-pobj-prep-pobj,compound-conj,NNP-NNP-IN-NNPS,NNP-NNP,7,1
6686,19460.0,33,invited,22,22,20,-2,21,12,0,-2,Haddad-Adel,Tehran,PERSON,LOCATION,PROPN,PROPN,nsubj,pobj,NNP,NNP,9,1
6687,19467.0,73,survived,9,2,33,31,1,39,7,24,his,Roger,PERSON,PERSON,DET,PROPN,poss,conj,PRP$,NNP,7,1
6688,19475.0,53,saying,4,2,15,13,1,37,2,11,Dan Abrams Live,MSNBC,PERSON-PERSON-PERSON,ORGANIZATION,PROPN-PROPN-PROPN,PROPN,compound-compound-pobj,compound,NNP-NNP-NNP,NNP,3,1
6689,19490.0,13,D,4,2,7,5,1,5,2,3,Carolyn Maloney,NY,PERSON-PERSON,STATE_OR_PROVINCE,PROPN-PROPN,PROPN,compound-compound,compound,NNP-NNP,NNP,2,1
6690,19496.0,33,been,20,7,19,12,6,13,13,-1,his,William,PERSON,PERSON,DET,PROPN,poss,nsubj,PRP$,NNP,4,1
6691,19505.0,21,converted,1,1,17,16,0,3,0,16,He,Sunni,PERSON,RELIGION,PRON,ADJ,nsubj,amod,PRP,JJ,4,1
6692,19512.0,23,wasted,5,3,21,18,2,1,2,16,Olivia Palermo,ELLE Magazine,PERSON-PERSON,ORGANIZATION-ORGANIZATION,PROPN-PROPN,PROPN-PROPN,compound-nsubj,compound-pobj,NNP-NNP,NNP-NNP,7,1
6693,19515.0,17,was,2,2,13,11,1,3,0,11,she,National Organization for Women,PERSON,ORGANIZATION-ORGANIZATION-ORGANIZATION-ORGANIZATION,PRON,PROPN-PROPN-ADP-PROPN,nsubj,compound-pobj-prep-pobj,PRP,NNP-NNP-IN-NNPS,5,1
6694,19540.0,53,went,23,5,44,39,4,8,18,21,Waldheim,assistant adjutant,PERSON,TITLE-TITLE,PROPN,NOUN-NOUN,nsubj,amod-attr,NNP,NN-NN,5,1
6695,19542.0,49,helped,27,1,13,12,0,35,26,-14,Randall Forsberg,Sweden,PERSON-PERSON,COUNTRY,PROPN-PROPN,PROPN,compound-nsubj,pobj,NNP-NNP,NNP,4,1
6696,19544.0,24,told,8,22,19,-3,21,4,-14,11,OIC,Islamic Conference,ORGANIZATION,ORGANIZATION-ORGANIZATION,PROPN,PROPN-PROPN,compound,compound-pobj,NNP,NNP-NNP,8,1
6697,48959.0,35,banking,3,33,30,-3,32,4,-30,27,OIC,Islamic Conference,ORGANIZATION,ORGANIZATION-ORGANIZATION,PROPN,PROPN-PROPN,compound,compound-pobj,NNP,NNP-NNP,3,1
6698,50553.0,31,recognises,15,14,11,-3,13,19,1,-4,OIC,Islamic Conference,ORGANIZATION,ORGANIZATION-ORGANIZATION,PROPN,PROPN-PROPN,compound,compound-pobj,NNP,NNP-NNP,6,1
6699,19545.0,38,enraged,6,11,12,1,10,25,-5,6,Barry Goldwater,Goldwater,PERSON-PERSON,PERSON,PROPN-PROPN,PROPN,compound-dobj,nsubj,NNP-NNP,NNP,3,1
6700,35294.0,31,took,4,6,7,1,5,23,-2,3,Barry Goldwater,Goldwater,PERSON-PERSON,PERSON,PROPN-PROPN,PROPN,compound-poss,nsubj,NNP-NNP,NNP,1,1
6701,62952.0,50,took,2,13,14,1,12,35,-11,12,Barry Goldwater,Goldwater,PERSON-PERSON,PERSON,PROPN-PROPN,PROPN,compound-nsubj,poss,NNP-NNP,NNP,2,1
6702,19549.0,46,called,13,15,9,-6,14,36,-2,-4,Cathleen P. Black,Mayor,PERSON-PERSON-PERSON,TITLE,PROPN-PROPN-PROPN,PROPN,compound-compound-dobj,compound,NNP-NNP-NNP,NNP,4,1
6703,26248.0,69,NY-SCHOOLS-CHIEF,0,7,11,4,6,57,-7,11,Cathleen P. Black,Mayor,PERSON-PERSON-PERSON,TITLE,PROPN-PROPN-PROPN,PROPN,compound-compound-nsubj,compound,NNP-NNP-NNP,NNP,3,1
6704,38933.0,36,had,26,6,10,4,5,25,20,-16,Cathleen P. Black,Mayor,PERSON-PERSON-PERSON,TITLE,PROPN-PROPN-PROPN,PROPN,compound-compound-nsubj,compound,NNP-NNP-NNP,NNP,4,1
6705,19550.0,22,operates,6,11,14,3,10,7,-5,8,USA Network,Bravo,ORGANIZATION-ORGANIZATION,LOCATION,PROPN-PROPN,PROPN,compound-pobj,conj,NNP-NNP,NNP,2,1
6706,46933.0,31,air,20,8,24,16,7,6,12,4,USA Network,Bravo,ORGANIZATION-ORGANIZATION,LOCATION,PROPN-PROPN,PROPN,compound-pobj,pobj,NNP-NNP,NNP,6,1
6707,19562.0,12,came,5,10,8,-2,9,3,-5,3,George Young,Giants GM,PERSON-PERSON,ORGANIZATION-ORGANIZATION,PROPN-PROPN,PROPN-PROPN,compound-pobj,compound-compound,NNP-NNP,NNP-NNP,1,1
6708,19569.0,38,said,1,11,19,8,10,18,-10,18,her,adultery,PERSON,CRIMINAL_CHARGE,DET,NOUN,poss,pobj,PRP$,NN,6,1
6709,19570.0,37,was,4,3,3,0,2,33,1,-1,Ezra,Ezra Levant,PERSON,PERSON-PERSON,ADV,PROPN-PROPN,nsubj,compound-nsubj,RB,NNP-NNP,0,1
6710,19571.0,54,said,8,3,2,-1,2,51,5,-6,Paul E. Gillmor,Rep.,PERSON-PERSON-PERSON,TITLE,PROPN-PROPN-PROPN,PROPN,compound-compound-nsubj,compound,NNP-NNP-NNP,NNP,2,1
6711,34342.0,30,holding,10,19,18,-1,18,11,-9,8,Paul E. Gillmor,Rep.,PERSON-PERSON-PERSON,TITLE,PROPN-PROPN-PROPN,PROPN,compound-compound-pobj,compound,NNP-NNP-NNP,NNP,2,1
6712,35815.0,73,said,24,27,26,-1,26,46,-3,2,Paul E. Gillmor,Rep.,PERSON-PERSON-PERSON,TITLE,PROPN-PROPN-PROPN,PROPN,compound-compound-nsubj,compound,NNP-NNP-NNP,NNP,2,1
6713,19590.0,43,said,38,35,27,-8,34,15,3,-11,International Monetary Fund,John Lipsky,ORGANIZATION-ORGANIZATION-ORGANIZATION,PERSON-PERSON,PROPN-PROPN-PROPN,PROPN-PROPN,compound-compound-pobj,compound-nsubj,NNP-NNP-NNP,NNP-NNP,5,1
6714,19592.0,10,was,2,1,4,3,0,5,1,2,Robert McNair,Governor,PERSON-PERSON,TITLE,PROPN-PROPN,PROPN,compound-nsubj,attr,NNP-NNP,NNP,3,1
6715,45081.0,14,Dies,11,1,4,3,0,9,10,-7,Robert McNair,Governor,PERSON-PERSON,TITLE,PROPN-PROPN,PROPN,compound-nsubj,appos,NNP-NNP,NNP,2,1
6716,50083.0,12,McNair,1,1,4,3,0,7,0,3,Robert McNair,Governor,PERSON-PERSON,TITLE,PROPN-PROPN,PROPN,compound-ROOT,npadvmod,NNP-NNP,NNP,2,1
6717,19610.0,37,told,27,18,23,5,17,13,9,-4,George Sheldon,assistant secretary,PERSON-PERSON,TITLE-TITLE,PROPN-PROPN,ADJ-NOUN,compound-nsubj,compound-appos,NNP-NNP,JJ-NN,3,1
6718,19612.0,26,contained,12,8,12,4,7,13,4,0,JNF,Israel,ORGANIZATION,COUNTRY,PROPN,PROPN,nsubjpass,nsubj,NNP,NNP,3,1
6719,19623.0,29,confirmed,19,11,27,16,10,1,8,8,Le Point,foreign ministry,ORGANIZATION-ORGANIZATION,ORGANIZATION-ORGANIZATION,PROPN-PROPN,ADJ-NOUN,compound-appos,amod-conj,NNP-NNP,JJ-NN,8,1
6720,19625.0,45,won,21,31,37,6,30,7,-10,16,Paul Gillmor,September,PERSON-PERSON,DATE,PROPN-PROPN,PROPN,compound-dobj,pobj,NNP-NNP,NNP,2,1
6721,52786.0,42,choosing,11,28,34,6,27,7,-17,23,Paul Gillmor,September,PERSON-PERSON,DATE,PROPN-PROPN,PROPN,compound-dobj,pobj,NNP-NNP,NNP,2,1
6722,19649.0,36,assisted,10,10,4,-6,9,31,0,-6,Kaiser,Senegal,PERSON,COUNTRY,PROPN,PROPN,nsubj,pobj,NNP,NNP,3,1
6723,19658.0,32,said,14,16,21,5,15,10,-2,7,Sean Parker,chairman,PERSON-PERSON,TITLE,PROPN-PROPN,NOUN,compound-nsubj,appos,NNP-NNP,NN,2,1
6724,19664.0,14,is,1,1,10,9,0,3,0,9,Millender-McDonald,this year,PERSON,DATE-DATE,PROPN,DET-NOUN,nsubj,det-npadvmod,NNP,DT-NN,4,1
6725,48540.0,14,is,1,1,12,11,0,1,0,11,Millender-McDonald,this year,PERSON,DATE-DATE,PROPN,DET-NOUN,nsubj,det-npadvmod,NNP,DT-NN,5,1
6726,19691.0,41,lobbying,9,39,24,-15,38,16,-30,15,American Psychiatric Association,DSM,ORGANIZATION-ORGANIZATION-ORGANIZATION,ORGANIZATION,PROPN-PROPN-PROPN,PROPN,compound-compound-pobj,conj,NNP-NNP-NNP,NNP,8,1
6727,19693.0,41,quoted,37,26,35,9,25,5,11,-2,Haddad Adel,Speaker,PERSON-PERSON,TITLE,PROPN-PROPN,PROPN,compound-nsubjpass,appos,NNP-NNP,NNP,2,1
6728,19697.0,27,be,2,13,21,8,12,5,-11,19,David Gregory,French,PERSON-PERSON,NATIONALITY,PROPN-PROPN,PROPN,compound-dobj,pobj,NNP-NNP,NNP,5,1
6729,19709.0,30,echoed,3,7,20,13,6,9,-4,17,Carolyn Maloney,Congress,PERSON-PERSON,ORGANIZATION,PROPN-PROPN,PROPN,compound-pobj,nsubj,NNP-NNP,NNP,5,1
6730,28037.0,30,echoed,3,7,20,13,6,9,-4,17,Carolyn Maloney,Congress,PERSON-PERSON,ORGANIZATION,PROPN-PROPN,PROPN,compound-pobj,nsubj,NNP-NNP,NNP,5,1
6731,38201.0,27,says,5,8,20,12,7,6,-3,15,Carolyn Maloney,Congress,PERSON-PERSON,ORGANIZATION,PROPN-PROPN,PROPN,compound-compound,pobj,NNP-NNP,NNP,5,1
6732,39866.0,33,faces,8,17,32,15,16,0,-9,24,Carolyn Maloney,Congress,PERSON-PERSON,ORGANIZATION,PROPN-PROPN,PROPN,compound-nsubj,pobj,NNP-NNP,NNP,2,1
6733,42008.0,42,reps,17,19,2,-17,18,39,-2,-15,Carolyn Maloney,Congress,PERSON-PERSON,ORGANIZATION,PROPN-PROPN,PROPN,compound-dobj,compound,NNP-NNP,NNP,2,1
6734,48578.0,20,said,12,3,14,11,2,5,9,2,Carolyn Maloney,Congress,PERSON-PERSON,ORGANIZATION,PROPN-PROPN,PROPN,compound-nsubj,nsubj,NNP-NNP,NNP,1,1
6735,48891.0,15,Labels,0,7,10,3,6,4,-7,10,Carolyn Maloney,Congress,PERSON-PERSON,ORGANIZATION,PROPN-PROPN,PROPN,compound-conj,conj,NNP-NNP,NNP,2,1
6736,19714.0,56,died,36,2,11,9,1,44,34,-25,Jefferson J. DeBlanc Sr.,Marine Corps,PERSON-PERSON-PERSON-PERSON,ORGANIZATION-ORGANIZATION,PROPN-PROPN-PROPN-PROPN,PROPN-PROPN,compound-compound-compound-nsubj,compound-compound,NNP-NNP-NNP-NNP,NNP-NNP,5,1
6737,19715.0,41,overshadowed,3,29,28,-1,28,12,-26,25,Lewis Hamilton,Briton,PERSON-PERSON,NATIONALITY,PROPN-PROPN,PROPN,compound-conj,compound,NNP-NNP,NNP,1,1
6738,36028.0,30,won,8,2,1,-1,1,28,6,-7,Lewis Hamilton,Briton,PERSON-PERSON,NATIONALITY,PROPN-PROPN,PROPN,compound-nsubj,compound,NNP-NNP,NNP,1,1
6739,45507.0,33,won,3,2,1,-1,1,31,1,-2,Lewis Hamilton,Briton,PERSON-PERSON,NATIONALITY,PROPN-PROPN,PROPN,compound-nsubj,compound,NNP-NNP,NNP,1,1
6740,19721.0,33,said,17,15,12,-3,14,20,2,-5,Awami League,left-of - centre,ORGANIZATION-ORGANIZATION,RELIGION-RELIGION-RELIGION,PROPN-PROPN,NOUN-PUNCT-NOUN,compound-appos,compound-punct-compound,NNP-NNP,NN-HYPH-NN,3,1
6741,19728.0,29,had,3,1,14,13,0,14,2,11,Hamilton,Stevenage,PERSON,CITY,PROPN,PROPN,nsubj,pobj,NNP,NNP,2,1
6742,19731.0,46,was,12,10,4,-6,9,41,2,-8,Hussein Kamel,Saddam Kamel,PERSON-PERSON,PERSON-PERSON,PROPN-PROPN,PROPN-PROPN,compound-appos,compound-appos,NNP-NNP,NNP-NNP,4,1
6743,19733.0,56,Justin,7,6,4,-2,5,51,1,-3,Paul Sculfor,Male Model,PERSON-PERSON,TITLE-TITLE,PROPN-PROPN,PROPN-PROPN,compound-compound,compound-compound,NNP-NNP,NNP-NNP,2,1
6744,19738.0,34,1988,0,30,24,-6,29,9,-30,24,National Military Family Association,Operation Purple,ORGANIZATION-ORGANIZATION-ORGANIZATION-ORGANIZATION,ORGANIZATION-ORGANIZATION,PROPN-PROPN-PROPN-PROPN,PROPN-PROPN,compound-compound-compound-pobj,compound-oprd,NNP-NNP-NNP-NNP,NNP-NNP,3,1
6745,19751.0,46,DAMASCUS,0,29,8,-21,28,37,-29,8,his,Arab League,PERSON,ORGANIZATION-ORGANIZATION,DET,PROPN-PROPN,poss,compound-compound,PRP$,NNP-NNP,9,1
6746,19755.0,35,resign,22,26,31,5,25,3,-4,9,Unita,Daniel Domingos,ORGANIZATION,PERSON-PERSON,PROPN,PROPN-PROPN,poss,compound-appos,NNP,NNP-NNP,4,1
6747,19757.0,62,saddened,11,14,20,6,13,41,-3,9,Hamilton,Switzerland,PERSON,COUNTRY,PROPN,PROPN,nsubj,pobj,NNP,NNP,3,1
6748,44163.0,47,come,19,8,46,38,7,0,11,27,Hamilton,Switzerland,PERSON,COUNTRY,PROPN,PROPN,poss,pobj,NNP,NNP,7,1
6749,19759.0,32,be,6,4,3,-1,3,28,2,-3,Ezra Levant,commentator,PERSON-PERSON,TITLE,PROPN-PROPN,NOUN,compound-nsubj,compound,NNP-NNP,NN,1,1
6750,19764.0,36,was,1,1,10,9,0,25,0,9,DeGeneres,judge,PERSON,TITLE,PROPN,NOUN,nsubj,pobj,NNP,NN,4,1
6751,19789.0,42,found,7,15,6,-9,14,35,-8,-1,his,congressman,PERSON,TITLE,DET,NOUN,poss,pobj,PRP$,NN,9,1
6752,19803.0,14,-RRB-,1,3,7,4,2,6,-2,6,Michael Sandy,Bellport,PERSON-PERSON,LOCATION,PROPN-PROPN,PROPN,compound-appos,pobj,NNP-NNP,NNP,2,1
6753,19809.0,85,said,77,41,36,-5,40,48,36,-41,American Bar Association,Silver Gavel,ORGANIZATION-ORGANIZATION-ORGANIZATION,ORGANIZATION-ORGANIZATION,PROPN-PROPN-PROPN,PROPN-PROPN,compound-compound-pobj,compound-compound,NNP-NNP-NNP,NNP-NNP,4,1
6754,19812.0,53,be,21,15,14,-1,14,38,6,-7,Dee Dee Myers,Secretary,PERSON-PERSON-PERSON,TITLE,PROPN-PROPN-PROPN,PROPN,compound-compound-nsubj,compound,NNP-NNP-NNP,NNP,2,1
6755,23054.0,39,came,2,11,10,-1,10,28,-9,8,Dee Dee Myers,Secretary,PERSON-PERSON-PERSON,TITLE,PROPN-PROPN-PROPN,PROPN,compound-compound-pobj,compound,NNP-NNP-NNP,NNP,2,1
6756,23373.0,27,says,5,3,2,-1,2,24,2,-3,Dee Dee Myers,Secretary,PERSON-PERSON-PERSON,TITLE,PROPN-PROPN-PROPN,PROPN,compound-compound-nsubj,compound,NNP-NNP-NNP,NNP,2,1
6757,25655.0,31,reacted,7,5,4,-1,4,26,2,-3,Dee Dee Myers,Secretary,PERSON-PERSON-PERSON,TITLE,PROPN-PROPN-PROPN,PROPN,compound-compound-nsubj,compound,NNP-NNP-NNP,NNP,2,1
6758,30546.0,14,said,5,3,2,-1,2,11,2,-3,Dee Dee Myers,Secretary,PERSON-PERSON-PERSON,TITLE,PROPN-PROPN-PROPN,PROPN,compound-compound-nsubj,compound,NNP-NNP-NNP,NNP,2,1
6759,43822.0,28,reiterated,2,7,6,-1,6,21,-5,4,Dee Dee Myers,Secretary,PERSON-PERSON-PERSON,TITLE,PROPN-PROPN-PROPN,PROPN,compound-compound-nsubj,compound,NNP-NNP-NNP,NNP,2,1
6760,47464.0,50,'s,10,26,25,-1,25,24,-16,15,Dee Dee Myers,Secretary,PERSON-PERSON-PERSON,TITLE,PROPN-PROPN-PROPN,PROPN,compound-compound-nsubj,compound,NNP-NNP-NNP,NNP,2,1
6761,52642.0,36,denies,5,3,2,-1,2,33,2,-3,Dee Dee Myers,Secretary,PERSON-PERSON-PERSON,TITLE,PROPN-PROPN-PROPN,PROPN,compound-compound-nsubj,compound,NNP-NNP-NNP,NNP,2,1
6762,54176.0,23,says,15,13,12,-1,12,10,2,-3,Dee Dee Myers,Secretary,PERSON-PERSON-PERSON,TITLE,PROPN-PROPN-PROPN,PROPN,compound-compound-nsubj,compound,NNP-NNP-NNP,NNP,2,1
6763,19813.0,13,Crisp,1,1,4,3,0,8,0,3,Mary Crisp,83,PERSON-PERSON,NUMBER,PROPN-PROPN,NUM,compound-ROOT,appos,NNP-NNP,CD,1,1
6764,63497.0,49,Crisp,1,1,4,3,0,44,0,3,Mary Crisp,83,PERSON-PERSON,NUMBER,PROPN-PROPN,NUM,compound-ROOT,appos,NNP-NNP,CD,1,1
6765,19815.0,40,is,15,19,24,5,18,15,-4,9,Adam Senn,owner,PERSON-PERSON,TITLE,PROPN-PROPN,NOUN,compound-attr,appos,NNP-NNP,NN,2,1
6766,19816.0,43,like,6,22,27,5,21,15,-16,21,Danny Glover,activist,PERSON-PERSON,TITLE,PROPN-PROPN,ADJ,compound-conj,amod,NNP-NNP,JJ,1,1
6767,33615.0,20,urging,6,4,3,-1,3,16,2,-3,Danny Glover,activist,PERSON-PERSON,TITLE,PROPN-PROPN,NOUN,compound-conj,compound,NNP-NNP,NN,1,1
6768,42928.0,33,added,5,31,30,-1,30,2,-26,25,Danny Glover,activist,PERSON-PERSON,TITLE,PROPN-PROPN,NOUN,compound-pobj,conj,NNP-NNP,NN,1,1
6769,47595.0,51,include,10,40,39,-1,39,11,-30,29,Danny Glover,activist,PERSON-PERSON,TITLE,PROPN-PROPN,NOUN,compound-conj,conj,NNP-NNP,NN,1,1
6770,60664.0,28,says,5,4,3,-1,3,24,1,-2,Danny Glover,activist,PERSON-PERSON,TITLE,PROPN-PROPN,NOUN,compound-nsubj,conj,NNP-NNP,NN,1,1
6771,19825.0,35,stands,1,25,33,8,24,1,-24,32,Elizondo,Moreno,PERSON,PERSON,PROPN,PROPN,compound,compound,NNP,NNP,-1,1
6772,19841.0,43,BEIJING,0,11,10,-1,10,32,-11,10,Mohamed ElBaradei,Chief,PERSON-PERSON,TITLE,PROPN-PROPN,PROPN,compound-nsubj,compound,NNP-NNP,NNP,1,1
6773,19843.0,47,survived,11,10,40,30,9,6,1,29,Anderson,William,PERSON,PERSON,PROPN,PROPN,nsubjpass,conj,NNP,NNP,8,1
6774,19846.0,48,Administration,5,8,2,-6,7,45,-3,-3,FMCSA,Federal Motor Carrier Safety Administration,ORGANIZATION,ORGANIZATION-ORGANIZATION-ORGANIZATION-ORGANIZATION-ORGANIZATION,PROPN,PROPN-PROPN-PROPN-PROPN-PROPN,compound,compound-compound-compound-compound-ROOT,NNP,NNP-NNP-NNP-NNP-NNP,5,1
6775,61770.0,73,represented,16,32,26,-6,31,46,-16,10,FMCSA,Federal Motor Carrier Safety Administration,ORGANIZATION,ORGANIZATION-ORGANIZATION-ORGANIZATION-ORGANIZATION-ORGANIZATION,PROPN,PROPN-PROPN-PROPN-PROPN-PROPN,ROOT,compound-compound-compound-compound-pobj,NNP,NNP-NNP-NNP-NNP-NNP,5,1
6776,67060.0,52,WASHINGTON,0,49,43,-6,48,8,-49,43,FMCSA,Federal Motor Carrier Safety Administration,ORGANIZATION,ORGANIZATION-ORGANIZATION-ORGANIZATION-ORGANIZATION-ORGANIZATION,PROPN,PROPN-PROPN-PROPN-PROPN-PROPN,ROOT,compound-compound-compound-compound-dobj,NNP,NNP-NNP-NNP-NNP-NNP,6,1
6777,67333.0,57,said,4,20,14,-6,19,42,-16,10,FMCSA,Federal Motor Carrier Safety Administration,ORGANIZATION,ORGANIZATION-ORGANIZATION-ORGANIZATION-ORGANIZATION-ORGANIZATION,PROPN,PROPN-PROPN-PROPN-PROPN-PROPN,ROOT,compound-compound-compound-compound-dobj,NNP,NNP-NNP-NNP-NNP-NNP,7,1
6778,19849.0,19,came,9,9,6,-3,8,12,0,-3,Goodman,90,PERSON,NUMBER,PROPN,NUM,nsubj,attr,NNP,CD,1,1
6779,19863.0,24,graduated,1,1,4,3,0,19,0,3,He,George Washington University Law School,PERSON,ORGANIZATION-ORGANIZATION-ORGANIZATION-ORGANIZATION-ORGANIZATION,PRON,PROPN-PROPN-PROPN-PROPN-PROPN,nsubj,compound-compound-compound-compound-pobj,PRP,NNP-NNP-NNP-NNP-NNP,4,1
6780,19873.0,13,died,4,1,12,11,0,0,3,8,Davis,Virginia,PERSON,STATE_OR_PROVINCE,PROPN,PROPN,nsubj,appos,NNP,NNP,3,1
6781,19879.0,37,fight,18,35,27,-8,34,9,-17,9,Bob Dillinger,Secretary,PERSON-PERSON,TITLE,PROPN-PROPN,PROPN,compound-conj,compound,NNP-NNP,NNP,5,1
6782,19882.0,21,remember,4,7,13,6,6,7,-3,9,Beverly Sills,performer,PERSON-PERSON,TITLE,PROPN-PROPN,NOUN,compound-nsubj,appos,NNP-NNP,NN,2,1
6783,19889.0,34,removed,9,5,14,9,4,19,4,5,Jerome Wilson Rabinowitz,Russian-Jewish,PERSON-PERSON-PERSON,NATIONALITY,PROPN-PROPN-PROPN,ADJ,compound-compound-pobj,amod,NNP-NNP-NNP,JJ,8,1
6784,19895.0,48,reintroduced,10,23,31,8,22,16,-13,21,Highland Capital Partners,Boston,ORGANIZATION-ORGANIZATION-ORGANIZATION,CITY,PROPN-PROPN-PROPN,PROPN,compound-compound-pobj,compound,NNP-NNP-NNPS,NNP,9,1
6785,19906.0,72,65k,2,29,21,-8,28,50,-27,19,Nicholas Burns,Under Secretary of State of Political Affairs,PERSON-PERSON,ORGANIZATION-ORGANIZATION-ORGANIZATION-ORGANIZATION-ORGANIZATION-ORGANIZATION-ORGANIZATION,PROPN-PROPN,PROPN-PROPN-ADP-PROPN-ADP-PROPN-PROPN,compound-appos,nmod-appos-prep-pobj-prep-compound-pobj,NNP-NNP,NNP-NNP-IN-NNP-IN-NNP-NNPS,2,1
6786,19907.0,15,'s,1,6,10,4,5,4,-5,9,Spencer,Pratt,PERSON,PERSON,PROPN,PROPN,npadvmod,ROOT,NNP,NNP,-1,1
6787,19917.0,40,quits,4,16,19,3,15,20,-12,15,his,Malaysia,ORGANIZATION,COUNTRY,DET,PROPN,poss,poss,PRP$,NNP,4,1
6788,19922.0,35,turned,2,26,1,-25,25,33,-24,-1,Professional Rodeo Cowboys Association,Ellerman,ORGANIZATION-ORGANIZATION-ORGANIZATION-ORGANIZATION,PERSON,PROPN-PROPN-PROPN-PROPN,PROPN,compound-compound-compound-pobj,nsubj,NNP-NNP-NNPS-NNP,NNP,9,1
6789,50042.0,35,turned,2,26,1,-25,25,33,-24,-1,Professional Rodeo Cowboys Association,Ellerman,ORGANIZATION-ORGANIZATION-ORGANIZATION-ORGANIZATION,PERSON,PROPN-PROPN-PROPN-PROPN,PROPN,compound-compound-compound-pobj,pobj,NNP-NNP-NNPS-NNP,NNP,9,1
6790,56854.0,10,is,1,6,1,-5,5,8,-5,0,Professional Rodeo Cowboys Association,Ellerman,ORGANIZATION-ORGANIZATION-ORGANIZATION-ORGANIZATION,PERSON,PROPN-PROPN-PROPN-PROPN,PROPN,compound-compound-compound-pobj,nsubj,NNP-NNP-NNPS-NNP,NNP,4,1
6791,63753.0,13,fired,3,9,1,-8,8,11,-6,-2,Professional Rodeo Cowboys Association,Ellerman,ORGANIZATION-ORGANIZATION-ORGANIZATION-ORGANIZATION,PERSON,PROPN-PROPN-PROPN-PROPN,PROPN,compound-compound-compound-pobj,nsubjpass,NNP-NNP-NNPS-NNP,NNP,6,1
6792,19925.0,39,bid,2,9,12,3,8,26,-7,10,Remy Ma,26,PERSON-PERSON,NUMBER,PROPN-PROPN,NUM,compound-pobj,nummod,NNP-NNP,CD,-1,1
6793,30246.0,31,discovered,5,14,17,3,13,13,-9,12,Remy Ma,26,PERSON-PERSON,NUMBER,PROPN-PROPN,NUM,compound-pobj,appos,NNP-NNP,CD,1,1
6794,58296.0,30,accused,6,1,4,3,0,25,5,-2,Remy Ma,26,PERSON-PERSON,NUMBER,PROPN-PROPN,NUM,compound-nsubjpass,appos,NNP-NNP,CD,2,1
6795,19930.0,13,leaves,1,1,7,6,0,5,0,6,Peterson,Kelly,PERSON,PERSON,PROPN,PROPN,nsubj,appos,NNP,NNP,1,1
6796,65630.0,24,include,3,1,9,8,0,14,2,6,Peterson,Kelly,PERSON,PERSON,PROPN,PROPN,poss,appos,NNP,NNP,6,1
6797,19933.0,9,stunned,2,1,4,3,0,4,1,2,Her,Washington,PERSON,STATE_OR_PROVINCE,DET,PROPN,poss,compound,PRP$,NNP,3,1
6798,19936.0,53,said,35,49,52,3,48,0,-14,17,MF Global,Chicago,ORGANIZATION-ORGANIZATION,CITY,PROPN-PROPN,PROPN,compound-pobj,pobj,NNP-NNP,NNP,3,1
6799,35267.0,29,said,14,25,28,3,24,0,-11,14,MF Global,Chicago,ORGANIZATION-ORGANIZATION,CITY,PROPN-PROPN,PROPN,compound-pobj,pobj,NNP-NNP,NNP,3,1
6800,42089.0,30,said,12,26,29,3,25,0,-14,17,MF Global,Chicago,ORGANIZATION-ORGANIZATION,CITY,PROPN-PROPN,PROPN,compound-pobj,pobj,NNP-NNP,NNP,7,1
6801,52116.0,42,said,24,38,41,3,37,0,-14,17,MF Global,Chicago,ORGANIZATION-ORGANIZATION,CITY,PROPN-PROPN,PROPN,compound-pobj,pobj,NNP-NNP,NNP,7,1
6802,19949.0,27,finished,5,5,12,7,4,14,0,7,he,University of Pennsylvania,PERSON,ORGANIZATION-ORGANIZATION-ORGANIZATION,PRON,PROPN-ADP-PROPN,nsubj,pobj-prep-pobj,PRP,NNP-IN-NNP,4,1
6803,19950.0,28,acquires,1,1,3,2,0,24,0,2,ITW,Hwa Meir Packing Illinois Tool Works Inc,ORGANIZATION,ORGANIZATION-ORGANIZATION-ORGANIZATION-ORGANIZATION-ORGANIZATION-ORGANIZATION-ORGANIZATION,PROPN,PROPN-PROPN-PROPN-PROPN-PROPN-PROPN-PROPN,compound,ROOT-compound-compound-compound-compound-compound-compound,NNP,NNP-NNP-NNP-NNP-NNP-NNP-NNP,2,1
6804,19955.0,26,RELEASE,1,5,21,16,4,4,-4,20,Chelsea District Library,Friends of the Library,ORGANIZATION-ORGANIZATION-ORGANIZATION,ORGANIZATION-ORGANIZATION-ORGANIZATION-ORGANIZATION,PROPN-PROPN-PROPN,PROPN-ADP-DET-PROPN,compound-compound-nsubj,dobj-prep-det-compound,NNP-NNP-NNP,NNPS-IN-DT-NNP,5,1
6805,19970.0,61,followed,27,33,11,-22,32,49,-6,-16,Organization of the Islamic Conference,Islam,ORGANIZATION-ORGANIZATION-ORGANIZATION-ORGANIZATION-ORGANIZATION,RELIGION,PROPN-ADP-DET-PROPN-PROPN,PROPN,pobj-prep-det-compound-pobj,pobj,NNP-IN-DT-NNP-NNP,NNP,11,1
6806,19987.0,58,recall,3,1,12,11,0,45,2,9,She,he,PERSON,PERSON,PRON,PRON,nsubj,nsubj,PRP,PRP,5,1
6807,44178.0,19,went,1,1,7,6,0,11,0,6,She,he,PERSON,PERSON,PRON,PRON,nsubj,nsubj,PRP,PRP,4,1
6808,19994.0,50,said,12,8,1,-7,7,48,4,-11,National Republican Campaign Committee,Paul Lindsay,ORGANIZATION-ORGANIZATION-ORGANIZATION-ORGANIZATION,PERSON-PERSON,PROPN-PROPN-PROPN-PROPN,PROPN-PROPN,compound-compound-compound-pobj,compound-nsubj,NNP-NNP-NNP-NNP,NNP-NNP,4,1
6809,20003.0,62,provided,2,13,6,-7,12,55,-11,4,he,Peterborough,PERSON,CITY,PRON,PROPN,nsubj,compound,PRP,NNP,4,1
6810,20012.0,37,thinks,1,19,22,3,18,14,-18,21,Sean Preston,three,PERSON-PERSON,NUMBER,PROPN-PROPN,NUM,compound-conj,conj,NNP-NNP,CD,3,1
6811,37559.0,43,is,2,17,20,3,16,22,-15,18,Sean Preston,three,PERSON-PERSON,NUMBER,PROPN-PROPN,NUM,compound-appos,conj,NNP-NNP,CD,3,1
6812,20014.0,15,says,1,1,4,3,0,10,0,3,Chavez,Marisabel Rodriguez,PERSON,PERSON-PERSON,PROPN,PROPN-PROPN,nsubj,compound-nsubj,NNP,NNP-NNP,3,1
6813,33536.0,18,come,12,1,5,4,0,12,11,-7,Chavez,Marisabel Rodriguez,PERSON,PERSON-PERSON,PROPN,PROPN-PROPN,poss,compound-appos,NNP,NNP-NNP,6,1
6814,60836.0,22,running,15,7,11,4,6,10,8,-4,Chavez,Marisabel Rodriguez,PERSON,PERSON-PERSON,PROPN,PROPN-PROPN,poss,compound-appos,NNP,NNP-NNP,6,1
6815,20022.0,39,working,21,13,8,-5,12,30,8,-13,Bryan Fuller,Warner Brothers,PERSON-PERSON,ORGANIZATION-ORGANIZATION,PROPN-PROPN,PROPN-PROPN,compound-nsubj,compound-compound,NNP-NNP,NNP-NNPS,7,1
6816,61972.0,15,picketing,3,1,5,4,0,9,2,2,Bryan Fuller,Warner Brothers,PERSON-PERSON,ORGANIZATION-ORGANIZATION,PROPN-PROPN,PROPN-PROPN,compound-nsubj,compound-dobj,NNP-NNP,NNP-NNPS,2,1
6817,20026.0,34,denies,13,17,3,-14,16,30,-4,-10,his,cleric,PERSON,TITLE,DET,NOUN,poss,compound,PRP$,NN,2,1
6818,20028.0,25,said,13,18,13,-5,17,11,-5,0,her,Kate,PERSON,PERSON,DET,PROPN,poss,nsubj,PRP$,NNP,3,1
6819,20034.0,42,moved,16,3,6,3,2,35,13,-10,his,Ann McGarry Buchwald,PERSON,PERSON-PERSON-PERSON,DET,PROPN-PROPN-PROPN,poss,compound-compound-appos,PRP$,NNP-NNP-NNP,2,1
6820,20039.0,20,learned,4,18,10,-8,17,9,-14,6,his,barber,PERSON,TITLE,DET,NOUN,poss,attr,PRP$,NN,3,1
6821,20040.0,43,reported,41,8,2,-6,7,40,33,-39,Theodor ` Teddy ' Kollek,Jerusalem,PERSON-PERSON-PERSON-PERSON-PERSON,CITY,NOUN-PUNCT-PROPN-PART-PROPN,PROPN,nmod-punct-poss-case-nsubj,compound,NN-''-NNP-POS-NNP,NNP,5,1
6822,51731.0,43,reported,41,8,2,-6,7,40,33,-39,Theodor ` Teddy ' Kollek,Jerusalem,PERSON-PERSON-PERSON-PERSON-PERSON,ORGANIZATION,NOUN-PUNCT-PROPN-PART-PROPN,PROPN,nmod-punct-poss-case-nsubj,pobj,NN-''-NNP-POS-NNP,NNP,5,1
6823,20044.0,30,buried,19,1,28,27,0,1,18,9,McNair,Berkeley County,PERSON,LOCATION-LOCATION,PROPN,PROPN-PROPN,nsubjpass,compound-pobj,NNP,NNP-NNP,6,1
6824,20058.0,33,said,22,24,26,2,23,6,-2,4,AAA,Robert Darbelnet,ORGANIZATION,PERSON-PERSON,PROPN,PROPN-PROPN,compound,compound-nsubj,NNP,NNP-NNP,3,1
6825,57681.0,42,is,2,41,33,-8,40,8,-39,31,AAA,Robert Darbelnet,ORGANIZATION,PERSON-PERSON,PROPN,PROPN-PROPN,pobj,compound-nsubj,NNP,NNP-NNP,4,1
6826,20061.0,20,born,2,1,5,4,0,14,1,3,Forsberg,1943,PERSON,DATE,PROPN,NUM,nsubjpass,pobj,NNP,CD,2,1
6827,41439.0,20,born,2,1,5,4,0,14,1,3,Forsberg,1943,PERSON,DATE,PROPN,NUM,nsubjpass,pobj,NNP,CD,2,1
6828,20069.0,47,said,2,15,32,17,14,14,-13,30,Chavez,Adan,PERSON,PERSON,PROPN,PROPN,poss,pobj,NNP,NNP,7,1
6829,50375.0,20,won,6,1,5,4,0,14,5,-1,Chavez,Adan,PERSON,PERSON,PROPN,PROPN,poss,appos,NNP,NNP,4,1
6830,20086.0,23,told,19,18,17,-1,17,5,1,-2,Berthold Huber,boss,PERSON-PERSON,TITLE,PROPN-PROPN,NOUN,compound-nsubj,compound,NNP-NNP,NN,1,1
6831,20102.0,19,chose,7,9,16,7,8,2,-2,9,Michael J. Sandy,designer,PERSON-PERSON-PERSON,TITLE,PROPN-PROPN-PROPN,NOUN,compound-compound-dobj,appos,NNP-NNP-NNP,NN,3,1
6832,20107.0,29,spending,19,6,14,8,5,14,13,-5,his,NBC,PERSON,ORGANIZATION,DET,PROPN,poss,pobj,PRP$,NNP,3,1
6833,56858.0,37,acknowledged,2,14,30,16,13,6,-12,28,his,NBC,PERSON,ORGANIZATION,DET,PROPN,poss,compound,PRP$,NNP,6,1
6834,58350.0,29,spending,19,6,14,8,5,14,13,-5,his,NBC,PERSON,ORGANIZATION,DET,PROPN,poss,pobj,PRP$,NNP,3,1
6835,20125.0,18,served,11,4,8,4,3,9,7,-3,Davis,real estate broker,PERSON,TITLE-TITLE-TITLE,PROPN,ADJ-NOUN-NOUN,nsubj,amod-compound-appos,NNP,JJ-NN-NN,3,1
6836,20126.0,18,based,3,2,7,5,1,10,1,4,party,North West Frontier,ORGANIZATION,STATE_OR_PROVINCE-STATE_OR_PROVINCE-STATE_OR_PROVINCE,NOUN,PROPN-PROPN-PROPN,nsubjpass,compound-compound-compound,NN,NNP-NNP-NNP,5,1
6837,20136.0,25,was,1,1,4,3,0,20,0,3,He,Navy,PERSON,ORGANIZATION,PRON,PROPN,nsubj,compound,PRP,NNP,1,1
6838,20141.0,44,Alcatel-Lucent,0,1,12,11,0,31,-1,12,Alcatel-Lucent,New Jersey-based,ORGANIZATION,STATE_OR_PROVINCE-STATE_OR_PROVINCE,ADJ,PROPN-PROPN,ROOT,compound-compound,JJ,NNP-NNP,7,1
6839,20143.0,13,earned,1,1,7,6,0,5,0,6,She,"California State University , Los Angeles",PERSON,ORGANIZATION-ORGANIZATION-ORGANIZATION-ORGANIZATION-ORGANIZATION-ORGANIZATION,PRON,PROPN-PROPN-PROPN-PUNCT-PROPN-PROPN,nsubj,compound-compound-pobj-punct-compound-appos,PRP,"NNP-NNP-NNP-,-NNP-NNP",4,1
6840,20146.0,28,snatched,15,19,2,-17,18,25,-4,-13,Yolanda,Coretta King,PERSON,PERSON-PERSON,PROPN,PROPN-PROPN,dobj,compound-nsubj,NNP,NNP-NNP,3,1
6841,20160.0,16,Name,5,11,1,-10,10,14,-6,-4,Shah Murtada,MOHAMMED MOHSIN FAIZ KASHANI,PERSON-PERSON,PERSON-PERSON-PERSON-PERSON,PROPN-PROPN,PROPN-PROPN-PROPN-PROPN,compound-pobj,compound-compound-compound-compound,NNP-NNP,NNP-NNP-NNP-NNP,7,1
6842,20161.0,30,survived,2,14,8,-6,13,21,-12,6,he,Carol Ann Bellecourt,PERSON,PERSON-PERSON-PERSON,PRON,PROPN-PROPN-PROPN,nsubjpass,compound-compound-appos,PRP,NNP-NNP-NNP,4,1
6843,55855.0,26,include,2,13,7,-6,12,18,-11,5,he,Carol Ann Bellecourt,PERSON,PERSON-PERSON-PERSON,PRON,PROPN-PROPN-PROPN,nsubjpass,compound-compound-appos,PRP,NNP-NNP-NNP,4,1
6844,20181.0,55,said,21,15,42,27,14,12,6,21,her,politician,PERSON,TITLE,DET,NOUN,poss,pobj,PRP$,NN,15,1
6845,42572.0,42,starred,4,9,27,18,8,14,-5,23,her,politician,PERSON,TITLE,DET,NOUN,poss,pobj,PRP$,NN,8,1
6846,20191.0,35,stands,1,28,31,3,27,3,-27,30,his,Amalia,PERSON,PERSON,DET,PROPN,poss,compound,PRP$,NNP,3,1
6847,20199.0,32,Labels,0,19,15,-4,18,16,-19,15,SLDN,military,ORGANIZATION,ORGANIZATION,PROPN,NOUN,ROOT,conj,NNP,NN,6,1
6848,20206.0,32,confirmed,29,4,13,9,3,18,25,-16,Parren J Mitchell,Congressional Black Caucus,PERSON-PERSON-PERSON,ORGANIZATION-ORGANIZATION-ORGANIZATION,PROPN-PROPN-PROPN,PROPN-PROPN-PROPN,compound-compound-nsubj,compound-compound-pobj,NNP-NNP-NNP,NNP-NNP-NNP,5,1
6849,20209.0,47,was,1,36,21,-15,35,25,-35,20,Paavo Nurmi,athlete,PERSON-PERSON,TITLE,PROPN-PROPN,NOUN,compound-conj,attr,NNP-NNP,NN,9,1
6850,20212.0,30,said,4,1,3,2,0,26,3,-1,EnergySolutions,Val Christensen,ORGANIZATION,PERSON-PERSON,PROPN,PROPN-PROPN,compound,compound-nsubj,NNP,NNP-NNP,1,1
6851,35335.0,31,said,4,1,3,2,0,27,3,-1,EnergySolutions,Val Christensen,ORGANIZATION,PERSON-PERSON,PROPN,PROPN-PROPN,compound,compound-nsubj,NNP,NNP-NNP,1,1
6852,20214.0,51,said,18,41,20,-21,40,30,-23,2,Philadelphia Inquirer,Rosenthal,ORGANIZATION-ORGANIZATION,PERSON,PROPN-PROPN,PROPN,compound-pobj,nsubj,NNP-NNP,NNP,13,1
6853,60994.0,41,Rosenthal,0,18,1,-17,17,39,-18,1,Philadelphia Inquirer,Rosenthal,ORGANIZATION-ORGANIZATION,PERSON,PROPN-PROPN,NOUN,compound-pobj,ROOT,NNP-NNP,NN,5,1
6854,20221.0,54,said,45,42,47,5,41,6,3,2,federal elections,Robert Lenhard,ORGANIZATION-ORGANIZATION,PERSON-PERSON,ADJ-NOUN,PROPN-PROPN,amod-dobj,compound-nsubj,JJ-NNS,NNP-NNP,10,1
6855,20222.0,29,came,2,10,13,3,9,15,-8,11,Li Jie,Argentina,PERSON-PERSON,COUNTRY,PROPN-PROPN,PROPN,compound-nsubj,compound,NNP-NNP,NNP,3,1
6856,20231.0,24,said,15,17,22,5,16,1,-2,7,Canadian National Railway Company,Patrick Waldron,ORGANIZATION-ORGANIZATION-ORGANIZATION-ORGANIZATION,PERSON-PERSON,PROPN-PROPN-PROPN-PROPN,PROPN-PROPN,compound-compound-compound-compound,compound-nsubj,NNP-NNP-NNP-NNP,NNP-NNP,3,1
6857,20238.0,45,had,5,33,23,-10,32,21,-28,18,Nuclear Suppliers Group,IAEA,ORGANIZATION-ORGANIZATION-ORGANIZATION,ORGANIZATION,PROPN-PROPN-PROPN,PROPN,compound-compound-compound,ROOT,NNP-NNPS-NNP,NNP,3,1
6858,20240.0,49,said,30,19,24,5,18,24,11,-6,Carolyn Maloney,vice chairman,PERSON-PERSON,TITLE-TITLE,PROPN-PROPN,NOUN-NOUN,compound-appos,compound-appos,NNP-NNP,NN-NN,1,1
6859,20242.0,29,was,26,13,10,-3,12,18,13,-16,him,attack,PERSON,CAUSE_OF_DEATH,PRON,NOUN,dobj,dobj,PRP,NN,5,1
6860,20246.0,30,said,11,21,29,8,20,0,-10,18,Professional Rodeo Cowboys Association,Colo.,ORGANIZATION-ORGANIZATION-ORGANIZATION-ORGANIZATION,STATE_OR_PROVINCE,PROPN-PROPN-PROPN-PROPN,PROPN,compound-compound-compound-pobj,appos,NNP-NNP-NNPS-NNP,NNP,6,1
6861,20256.0,44,survived,12,11,9,-2,10,34,1,-3,Farland,Va,PERSON,STATE_OR_PROVINCE,PROPN,PROPN,nsubjpass,appos,NNP,NNP,7,1
6862,20267.0,47,URGENT,0,18,22,4,17,24,-18,22,Chen,scientist,PERSON,TITLE,PROPN,NOUN,nsubj,appos,NNP,NN,4,1
6863,39600.0,29,replacing,6,5,3,-2,4,25,1,-3,Chen,scientist,PERSON,TITLE,PROPN,NOUN,nsubj,dep,NNP,NN,3,1
6864,20270.0,31,held,2,1,16,15,0,14,1,14,Negroponte,ambassador,PERSON,TITLE,PROPN,NOUN,nsubj,pobj,NNP,NN,7,1
6865,21134.0,59,be,54,2,45,43,1,13,52,-9,Negroponte,ambassador,PERSON,TITLE,PROPN,NOUN,nsubjpass,pobj,NNP,NN,12,1
6866,65572.0,34,arrived,8,1,5,4,0,28,7,-3,Negroponte,ambassador,PERSON,TITLE,PROPN,NOUN,nsubj,appos,NNP,NN,3,1
6867,20271.0,12,Found,2,2,1,-1,1,10,0,-1,Gillmor,Rep.,PERSON,TITLE,PROPN,PROPN,nsubj,compound,NNP,NNP,1,1
6868,27525.0,14,says,13,4,3,-1,3,10,9,-10,Gillmor,Rep.,PERSON,TITLE,PROPN,PROPN,nsubj,compound,NNP,NNP,1,1
6869,20283.0,45,need,39,27,35,8,26,9,12,-4,House,160,ORGANIZATION,NUMBER,PROPN,NUM,compound,nummod,NNP,CD,9,1
6870,20291.0,50,earned,33,1,11,10,0,38,32,-22,Mark Buse,staff director,PERSON-PERSON,TITLE-TITLE,PROPN-PROPN,NOUN-NOUN,compound-nsubj,compound-attr,NNP-NNP,NN-NN,3,1
6871,20298.0,17,represent,2,1,10,9,0,6,1,8,Carson,Indianapolis,PERSON,ORGANIZATION,PROPN,PROPN,nsubj,pobj,NNP,NNP,4,1
6872,20301.0,49,died,42,1,5,4,0,43,41,-37,Robert E McNair,South Carolina,PERSON-PERSON-PERSON,STATE_OR_PROVINCE-STATE_OR_PROVINCE,PROPN-PROPN-PROPN,PROPN-PROPN,compound-compound-nsubj,compound-pobj,NNP-NNP-NNP,NNP-NNP,3,1
6873,20307.0,61,said,19,2,11,9,1,49,17,-8,Christopher J. Dodd,"Senate Banking , Housing and Urban Affairs Committee",PERSON-PERSON-PERSON,ORGANIZATION-ORGANIZATION-ORGANIZATION-ORGANIZATION-ORGANIZATION-ORGANIZATION-ORGANIZATION-ORGANIZATION,PROPN-PROPN-PROPN,PROPN-PROPN-PUNCT-PROPN-CCONJ-PROPN-PROPN-PROPN,compound-compound-nsubj,compound-nmod-punct-nmod-cc-compound-conj-pobj,NNP-NNP-NNP,"NNP-NNP-,-NNP-CC-NNP-NNPS-NNP",5,1
6874,20313.0,18,born,5,1,11,10,0,6,4,6,Thomas Joseph Meskill,Conn,PERSON-PERSON-PERSON,STATE_OR_PROVINCE,PROPN-PROPN-PROPN,PROPN,compound-compound-compound,appos,NNP-NNP-NNP,NNP,3,1
6875,20318.0,33,joined,13,15,8,-7,14,24,-2,-5,Washburn,Harvard,PERSON,ORGANIZATION,PROPN,PROPN,dobj,pobj,NNP,NNP,4,1
6876,20340.0,61,BOLIN,1,1,15,14,0,45,0,14,JANE BOLIN,JUDGE,PERSON-PERSON,TITLE,PROPN-PROPN,PROPN,compound-ROOT,attr,NNP-NNP,NNP,1,1
6877,20342.0,32,A,0,3,25,22,2,6,-3,25,Yolanda King,Calif.,PERSON-PERSON,STATE_OR_PROVINCE,PROPN-PROPN,PROPN,compound-nsubj,appos,NNP-NNP,NNP,2,1
6878,20346.0,24,attended,17,13,19,6,12,4,4,2,he,Jefferson High School,PERSON,ORGANIZATION-ORGANIZATION-ORGANIZATION,PRON,PROPN-PROPN-PROPN,nsubj,compound-compound-dobj,PRP,NNP-NNP-NNP,3,1
6879,65882.0,24,attended,17,13,19,6,12,4,4,2,he,Jefferson High School,PERSON,ORGANIZATION-ORGANIZATION-ORGANIZATION,PRON,PROPN-PROPN-PROPN,nsubj,compound-compound-dobj,PRP,NNP-NNP-NNP,3,1
6880,20359.0,32,redcrossorg,17,4,4,0,3,27,13,-13,American Red Cross,American,ORGANIZATION-ORGANIZATION-ORGANIZATION,COUNTRY,PROPN-PROPN-PROPN,PROPN,compound-compound-appos,compound,NNP-NNP-NNP,NNP,0,1
6881,20360.0,42,was,11,7,1,-6,6,40,4,-10,Opera National de Paris,Mortier,ORGANIZATION-ORGANIZATION-ORGANIZATION-ORGANIZATION,PERSON,PROPN-PROPN-PROPN-PROPN,ADJ,compound-compound-compound-pobj,nsubj,NNP-NNP-NNP-NNP,JJR,5,1
6882,37286.0,41,said,13,9,1,-8,8,39,4,-12,Opera National de Paris,Mortier,ORGANIZATION-ORGANIZATION-ORGANIZATION-ORGANIZATION,PERSON,PROPN-PROPN-PROPN-PROPN,ADJ,compound-compound-compound-pobj,nsubj,NNP-NNP-NNP-NNP,JJR,5,1
6883,48609.0,34,announced,3,18,10,-8,17,23,-15,7,Opera National de Paris,Mortier,ORGANIZATION-ORGANIZATION-ORGANIZATION-ORGANIZATION,PERSON,PROPN-PROPN-PROPN-PROPN,PROPN,compound-compound-compound-pobj,dobj,NNP-NNP-NNP-NNP,NNP,5,1
6884,61005.0,33,quit,13,9,1,-8,8,31,4,-12,Opera National de Paris,Mortier,ORGANIZATION-ORGANIZATION-ORGANIZATION-ORGANIZATION,PERSON,PROPN-PROPN-PROPN-PROPN,ADJ,compound-compound-compound-pobj,nsubj,NNP-NNP-NNP-NNP,JJR,5,1
6885,20364.0,64,told,43,41,35,-6,40,28,2,-8,University of Haifa,National Security Studies Center,ORGANIZATION-ORGANIZATION-ORGANIZATION,ORGANIZATION-ORGANIZATION-ORGANIZATION-ORGANIZATION,PROPN-ADP-PROPN,PROPN-PROPN-PROPN-PROPN,pobj-prep-pobj,compound-compound-compound-pobj,NNP-IN-NNP,NNP-NNP-NNPS-NNP,7,1
6886,20384.0,45,came,27,14,14,0,13,30,13,-13,Samsung,Samsung Electronics,ORGANIZATION,ORGANIZATION-ORGANIZATION,PROPN,PROPN-PROPN,compound,compound-nsubj,NNP,NNP-NNPS,0,1
6887,56403.0,51,said,46,8,8,0,7,42,38,-38,Samsung,Samsung Electronics,ORGANIZATION,ORGANIZATION-ORGANIZATION,PROPN,PROPN-PROPN,nsubj,compound-poss,NNP,NNP-NNPS,0,1
6888,20392.0,39,died,28,1,7,6,0,31,27,-21,Bradford Washburn,cartographer,PERSON-PERSON,TITLE,PROPN-PROPN,NOUN,compound-nsubj,conj,NNP-NNP,NN,2,1
6889,26218.0,38,died,28,1,7,6,0,30,27,-21,Bradford Washburn,cartographer,PERSON-PERSON,TITLE,PROPN-PROPN,NOUN,compound-nsubj,conj,NNP-NNP,NN,2,1
6890,42700.0,29,include,5,11,17,6,10,11,-6,12,Bradford Washburn,cartographer,PERSON-PERSON,TITLE,PROPN-PROPN,NOUN,compound-pobj,conj,NNP-NNP,NN,5,1
6891,20394.0,23,chatted,5,17,21,4,16,1,-12,16,Spencer Pratt,Speidi,PERSON-PERSON,PERSON,PROPN-PROPN,PROPN,compound-conj,compound,NNP-NNP,NNP,7,1
6892,20403.0,35,said,20,2,9,7,1,25,18,-11,International Monetary Fund,Albert Jaeger,ORGANIZATION-ORGANIZATION-ORGANIZATION,PERSON-PERSON,PROPN-PROPN-PROPN,PROPN-PROPN,compound-compound-poss,compound-appos,NNP-NNP-NNP,NNP-NNP,3,1
6893,20405.0,5,Association,2,1,5,4,0,-1,1,3,American Bankers Association,http://www.aba.com/default.htm,ORGANIZATION-ORGANIZATION-ORGANIZATION,URL,PROPN-PROPN-PROPN,NOUN,compound-compound-ROOT,appos,NNP-NNPS-NNP,NN,-1,1
6894,20436.0,44,Lan,1,7,31,24,6,12,-6,30,Tianjin Lions,CBL,ORGANIZATION-ORGANIZATION,ORGANIZATION,PROPN-PROPN,PROPN,compound-pobj,poss,NNP-NNP,NNP,10,1
6895,20439.0,36,reported,7,16,16,0,15,19,-9,9,Hong Kong Disneyland,Hong Kong Disneyland Cast Members ' Union,ORGANIZATION-ORGANIZATION-ORGANIZATION,ORGANIZATION-ORGANIZATION-ORGANIZATION-ORGANIZATION-ORGANIZATION-ORGANIZATION-ORGANIZATION,PROPN-PROPN-PROPN,PROPN-PROPN-PROPN-PROPN-PROPN-PART-PROPN,compound-compound-compound,compound-compound-compound-compound-poss-case-pobj,NNP-NNP-NNP,NNP-NNP-NNP-NNP-NNP-POS-NNP,0,1
6896,20443.0,25,TITLES,0,3,7,4,2,17,-3,7,First vice president of Council of State,Council of Ministers,PERSON-PERSON-PERSON-PERSON-PERSON-PERSON-PERSON,ORGANIZATION-ORGANIZATION-ORGANIZATION,ADJ-NOUN-NOUN-ADP-PROPN-ADP-PROPN,PROPN-ADP-PROPN,amod-compound-ROOT-prep-pobj-prep-pobj,conj-prep-pobj,JJ-NN-NN-IN-NNP-IN-NNP,NNP-IN-NNP,4,1
6897,20447.0,37,-LRB-,3,1,5,4,0,31,2,2,Chunghwa Telecom,CTC,ORGANIZATION-ORGANIZATION,ORGANIZATION,PROPN-PROPN,PROPN,compound-compound,compound,NNP-NNP,NNP,3,1
6898,20453.0,32,say,30,8,6,-2,7,25,22,-24,Brandon McInerney,student,PERSON-PERSON,TITLE,PROPN-PROPN,NOUN,compound-appos,nsubj,NNP-NNP,NN,2,1
6899,38221.0,31,contend,26,13,12,-1,12,18,13,-14,Brandon McInerney,student,PERSON-PERSON,TITLE,PROPN-PROPN,NOUN,compound-dobj,compound,NNP-NNP,NN,1,1
6900,39247.0,32,say,30,8,6,-2,7,25,22,-24,Brandon McInerney,student,PERSON-PERSON,TITLE,PROPN-PROPN,NOUN,compound-appos,nsubj,NNP-NNP,NN,2,1
6901,49078.0,36,arrested,18,4,9,5,3,26,14,-9,Brandon McInerney,student,PERSON-PERSON,TITLE,PROPN-PROPN,NOUN,compound-pobj,appos,NNP-NNP,NN,3,1
6902,20457.0,30,announced,28,4,3,-1,3,26,24,-25,Jo Ann Davis,lawmaker,PERSON-PERSON-PERSON,TITLE,PROPN-PROPN-PROPN,NOUN,compound-compound-nsubj,compound,NNP-NNP-NNP,NN,2,1
6903,20458.0,25,said,22,5,17,12,4,7,17,-5,Pascal Yoadimnadji,cerebral haemorrhage,PERSON-PERSON,CAUSE_OF_DEATH-CAUSE_OF_DEATH,PROPN-PROPN,ADJ-NOUN,compound-nsubj,amod-pobj,NNP-NNPS,JJ-NN,4,1
6904,20459.0,41,said,14,16,11,-5,15,29,-2,-3,her,TLC,PERSON,ORGANIZATION,DET,PROPN,poss,compound,PRP$,NNP,3,1
6905,20466.0,29,welcomes,1,1,7,6,0,21,0,6,AAA,Patrick Raymond,ORGANIZATION,PERSON-PERSON,PROPN,PROPN-PROPN,nsubj,nmod-nmod,NNP,NNP-NNP,2,1
6906,20470.0,38,ran,1,20,23,3,19,14,-19,22,her,stand-in,PERSON,TITLE,DET,NOUN,poss,attr,PRP$,NN,2,1
6907,20477.0,40,are,4,3,39,36,2,0,1,35,OIC,Maldives,ORGANIZATION,COUNTRY,PROPN,PROPN,compound,conj,NNP,NNP,3,1
6908,20482.0,54,said,52,50,49,-1,49,4,2,-3,Dee Dee Myers,spokeswoman,PERSON-PERSON-PERSON,TITLE,PROPN-PROPN-PROPN,NOUN,compound-compound-appos,nsubj,NNP-NNP-NNP,NN,2,1
6909,20484.0,40,said,22,34,24,-10,33,15,-12,2,MF Global LLC,John Kilduff,ORGANIZATION-ORGANIZATION-ORGANIZATION,PERSON-PERSON,PROPN-PROPN-PROPN,PROPN-PROPN,compound-compound-pobj,compound-nsubj,NNP-NNP-NNP,NNP-NNP,5,1
6910,20486.0,36,had,18,15,8,-7,14,27,3,-10,American Beverage Association,Alliance,ORGANIZATION-ORGANIZATION-ORGANIZATION,ORGANIZATION,PROPN-PROPN-PROPN,PROPN,compound-compound-nsubj,pobj,NNP-NNP-NNP,NNP,6,1
6911,20489.0,24,appointed,7,4,3,-1,3,20,3,-4,Cathleen P. Black,President,PERSON-PERSON-PERSON,TITLE,PROPN-PROPN-PROPN,PROPN,compound-compound-nsubj,compound,NNP-NNP-NNP,NNP,2,1
6912,20511.0,14,Visit,0,9,2,-7,8,11,-9,2,RCI,www.RoyalCaribbeanFan.com,ORGANIZATION,URL,PROPN,X,compound,dobj,NNP,ADD,5,1
6913,20512.0,60,survived,2,1,31,30,0,28,1,29,He,Robin Lee Howell,PERSON,PERSON-PERSON-PERSON,PRON,PROPN-PROPN-PROPN,nsubjpass,compound-compound-conj,PRP,NNP-NNP-NNP,7,1
6914,20518.0,12,wrestling,7,3,1,-2,2,10,4,-6,Communist Party,China,ORGANIZATION-ORGANIZATION,COUNTRY,PROPN-PROPN,PROPN,compound-compound,poss,NNP-NNP,NNP,3,1
6915,62311.0,38,reported,35,20,5,-15,19,32,15,-30,Communist Party,China,ORGANIZATION-ORGANIZATION,COUNTRY,PROPN-PROPN,PROPN,compound-pobj,poss,NNP-NNP,NNP,8,1
6916,20536.0,40,died,7,1,13,12,0,26,6,6,Deaver,Bethesda,PERSON,CITY,PROPN,PROPN,compound,pobj,NNP,NNP,7,1
6917,56266.0,16,died,8,2,14,12,1,1,6,6,Deaver,Bethesda,PERSON,CITY,PROPN,PROPN,nsubj,pobj,NNP,NNP,5,1
6918,20539.0,53,said,16,29,19,-10,28,33,-13,3,DMC,Mike Duggan,ORGANIZATION,PERSON-PERSON,PROPN,PROPN-PROPN,poss,compound-nsubj,NNP,NNP-NNP,8,1
6919,20558.0,45,said,21,31,23,-8,30,21,-10,2,Focus on the Family,Peter Brandt,ORGANIZATION-ORGANIZATION-ORGANIZATION-ORGANIZATION,PERSON-PERSON,PROPN-ADP-DET-PROPN,PROPN-PROPN,pobj-prep-det-pobj,compound-nsubj,NNP-IN-DT-NNP,NNP-NNP,4,1
6920,20563.0,43,discovered,5,10,13,3,9,29,-5,8,Haifa University,Institute for Maritime Studies,ORGANIZATION-ORGANIZATION,ORGANIZATION-ORGANIZATION-ORGANIZATION-ORGANIZATION,PROPN-PROPN,PROPN-ADP-PROPN-PROPN,compound-poss,pobj-prep-compound-pobj,NNP-NNP,NNP-IN-NNP-NNPS,5,1
6921,20567.0,58,announced,26,18,37,19,17,20,8,11,his,Kate,PERSON,PERSON,DET,PROPN,poss,appos,PRP$,NNP,8,1
6922,20571.0,60,survived,9,8,55,47,7,4,1,46,Nolte,Mimi Krebs,PERSON,PERSON-PERSON,PROPN,PROPN-PROPN,nsubjpass,compound-conj,NNP,NNP-NNP,12,1
6923,51180.0,73,survived,9,8,55,47,7,17,1,46,Nolte,Mimi Krebs,PERSON,PERSON-PERSON,PROPN,PROPN-PROPN,nsubjpass,compound-conj,NNP,NNP-NNP,6,1
6924,20576.0,46,stems,2,32,13,-19,31,32,-30,11,Alcatel-Lucent,"Thomson , Royal Philips Electronics and AT & amp",ORGANIZATION,ORGANIZATION-ORGANIZATION-ORGANIZATION-ORGANIZATION-ORGANIZATION-ORGANIZATION-ORGANIZATION-ORGANIZATION-ORGANIZATION,PROPN,PROPN-PUNCT-PROPN-PROPN-PROPN-CCONJ-PROPN-CCONJ-NOUN,amod,pobj-punct-compound-compound-conj-cc-conj-cc-conj,NNP,"NNP-,-NNP-NNP-NNPS-CC-NNP-CC-NN",13,1
6925,20592.0,46,is,7,2,25,23,1,20,5,18,Buse,Staff Director,PERSON,TITLE-TITLE,PROPN,PROPN-PROPN,nsubj,compound-pobj,NNP,NNP-NNP,5,1
6926,20600.0,17,asked,0,3,11,8,2,5,-3,11,Carolyn Maloney,House committee,PERSON-PERSON,ORGANIZATION-ORGANIZATION,PROPN-PROPN,PROPN-NOUN,compound-dobj,compound-pobj,NNP-NNP,NNP-NN,3,1
6927,20606.0,27,Association,3,1,6,5,0,20,2,3,National Christmas Tree Association,http://wwwchristmastreeorg,ORGANIZATION-ORGANIZATION-ORGANIZATION-ORGANIZATION,URL,PROPN-PROPN-PROPN-PROPN,PROPN,compound-compound-compound-ROOT,appos,NNP-NNP-NNP-NNP,NNP,8,1
6928,20612.0,49,received,6,5,12,7,4,36,1,6,Col DeBlanc,Southwestern Louisiana Institute,PERSON-PERSON,ORGANIZATION-ORGANIZATION-ORGANIZATION,PROPN-PROPN,PROPN-PROPN-PROPN,compound-nsubj,compound-compound-pobj,NNP-NNP,NNP-NNP-NNP,5,1
6929,20613.0,32,told,29,26,20,-6,25,11,3,-9,Mainland Affairs Council,Lai,ORGANIZATION-ORGANIZATION-ORGANIZATION,PERSON,PROPN-PROPN-PROPN,PROPN,compound-compound-pobj,npadvmod,NNP-NNPS-NNP,NNP,5,1
6930,20615.0,17,Labels,0,3,11,8,2,5,-3,11,Brandon McInerney,hate crimes,PERSON-PERSON,CRIMINAL_CHARGE-CRIMINAL_CHARGE,PROPN-PROPN,NOUN-NOUN,compound-ROOT,compound-conj,NNP-NNP,NN-NNS,2,1
6931,20620.0,28,said,11,1,4,3,0,23,10,-7,Bryan Fuller,creator/executive,PERSON-PERSON,TITLE,PROPN-PROPN,ADJ,compound-nsubj,det,NNP-NNP,JJ,3,1
6932,20623.0,60,include,1,3,6,3,2,53,-2,5,her,Keith Thomson,PERSON,PERSON-PERSON,DET,PROPN-PROPN,poss,compound-appos,PRP$,NNP-NNP,1,1
6933,22776.0,27,include,1,3,6,3,2,20,-2,5,her,Keith Thomson,PERSON,PERSON-PERSON,DET,PROPN-PROPN,poss,compound-appos,PRP$,NNP-NNP,1,1
6934,20628.0,66,said,30,13,25,12,12,40,17,-5,R Nicholas Burns,chief negotiator,PERSON-PERSON-PERSON,TITLE-TITLE,PROPN-PROPN-PROPN,ADJ-NOUN,compound-compound-nsubj,amod-conj,NNP-NNP-NNP,JJ-NN,4,1
6935,20640.0,91,contacted,3,21,14,-7,20,76,-18,11,his,Arizona,PERSON,STATE_OR_PROVINCE,DET,PROPN,poss,compound,PRP$,NNP,1,1
6936,62102.0,91,contacted,3,21,14,-7,20,76,-18,11,his,Arizona,PERSON,STATE_OR_PROVINCE,DET,PROPN,poss,compound,PRP$,NNP,1,1
6937,20669.0,42,said,40,9,25,16,8,16,31,-15,David Gregory,correspondent,PERSON-PERSON,TITLE,PROPN-PROPN,NOUN,compound-compound,nsubj,NNP-NNP,NN,3,1
6938,53278.0,37,getting,7,5,4,-1,4,32,2,-3,David Gregory,correspondent,PERSON-PERSON,TITLE,PROPN-PROPN,NOUN,compound-nsubj,compound,NNP-NNP,NN,1,1
6939,64592.0,27,one,1,9,23,14,8,3,-8,22,David Gregory,correspondent,PERSON-PERSON,TITLE,PROPN-PROPN,NOUN,compound-pobj,dobj,NNP-NNP,NN,7,1
6940,20671.0,36,told,16,1,6,5,0,29,15,-10,Mohamed ElBaradei,lawyer,PERSON-PERSON,TITLE,PROPN-PROPN,NOUN,compound-nsubj,appos,NNP-NNP,NN,3,1
6941,20674.0,60,survived,2,11,1,-10,10,58,-9,-1,Josephine Robinson McNair,He,PERSON-PERSON-PERSON,PERSON,PROPN-PROPN-PROPN,PRON,compound-compound-appos,nsubjpass,NNP-NNP-NNP,PRP,4,1
6942,20678.0,69,said,46,49,59,10,48,9,-3,13,David Peng,Norris Comprehensive Cancer Center,ORGANIZATION-ORGANIZATION,PERSON-PERSON-PERSON-PERSON,PROPN-PROPN,PROPN-PROPN-PROPN-PROPN,compound-nsubj,compound-compound-compound-pobj,NNP-NNP,NNP-NNP-NNP-NNP,6,1
6943,20691.0,51,died,44,3,50,47,2,0,41,6,Robert E. McNair,Charleston,PERSON-PERSON-PERSON,CITY,PROPN-PROPN-PROPN,PROPN,compound-compound-nsubj,pobj,NNP-NNP-NNP,NNP,3,1
6944,20705.0,26,said,7,5,1,-4,4,24,2,-6,John D. Negroponte,Deputy Secretary of State,PERSON-PERSON-PERSON,TITLE-TITLE-TITLE-TITLE,PROPN-PROPN-PROPN,PROPN-PROPN-ADP-PROPN,compound-compound-nsubj,nmod-nmod-prep-pobj,NNP-NNP-NNP,NNP-NNP-IN-NNP,2,1
6945,20709.0,36,Tehran,0,10,6,-4,9,29,-10,6,Gholam Ali Haddad Adel,IRNA,PERSON-PERSON-PERSON-PERSON,ORGANIZATION,PROPN-PROPN-PROPN-PROPN,PROPN,compound-compound-compound-nsubj,compound,NNP-NNP-NNP-NNP,NNP,3,1
6946,20727.0,44,said,18,35,30,-5,34,13,-17,12,his,New Mexico,PERSON,STATE_OR_PROVINCE-STATE_OR_PROVINCE,DET,PROPN-PROPN,poss,compound-appos,PRP$,NNP-NNP,6,1
6947,20728.0,36,said,24,26,33,7,25,2,-2,9,Li,Beijing Normal University,PERSON,ORGANIZATION-ORGANIZATION-ORGANIZATION,PROPN,PROPN-PROPN-PROPN,nsubj,compound-compound-pobj,NNP,NNP-NNP-NNP,4,1
6948,20746.0,48,said,38,23,27,4,22,20,15,-11,Farrow,ambassador,PERSON,TITLE,NOUN,NOUN,nsubj,appos,NN,NN,1,1
6949,60287.0,65,said,38,40,44,4,39,20,-2,6,Farrow,ambassador,PERSON,TITLE,PROPN,NOUN,nsubj,appos,NNP,NN,3,1
6950,20748.0,46,asked,17,5,24,19,4,21,12,7,Farland,deputy director,PERSON,TITLE-TITLE,PROPN,NOUN-NOUN,nsubjpass,compound-attr,NNP,NN-NN,4,1
6951,20752.0,29,Urgent,0,17,8,-9,16,20,-17,8,Lashkar-e-Toiba,LeT,ORGANIZATION,ORGANIZATION,PROPN,PROPN,compound,ROOT,NNP,NNP,6,1
6952,20753.0,29,said,23,1,22,21,0,6,22,-1,IMF,Caroline Atkinson,ORGANIZATION,PERSON-PERSON,PROPN,PROPN-PROPN,compound,compound-nsubj,NNP,NNP-NNP,7,1
6953,20765.0,18,had,2,8,17,9,7,0,-6,15,Ownit Mortgage Solutions,December,ORGANIZATION-ORGANIZATION-ORGANIZATION,DATE,PROPN-PROPN-PROPN,PROPN,compound-compound-pobj,pobj,NNP-NNP-NNPS,NNP,5,1
6954,20791.0,35,comes,26,9,24,15,8,10,17,-2,Palermo,MTV,PERSON,ORGANIZATION,PROPN,PROPN,nsubj,compound,NNP,NNP,6,1
6955,20795.0,35,said,26,33,21,-12,32,13,-7,-5,FMCSA,U.S.,ORGANIZATION,COUNTRY,PROPN,PROPN,compound,nmod,NNP,NNP,7,1
6956,20799.0,51,make,13,41,50,9,40,0,-28,37,Fidelity Investments,Boston,ORGANIZATION-ORGANIZATION,CITY,PROPN-PROPN,PROPN,compound-pobj,pobj,NNP-NNPS,NNP,9,1
6957,57682.0,36,is,6,12,8,-4,11,27,-6,2,Fidelity Investments,Boston,ORGANIZATION-ORGANIZATION,CITY,PROPN-PROPN,PROPN,compound-attr,nmod,NNP-NNPS,NNP,3,1
6958,20804.0,18,elected,7,6,4,-2,5,13,1,-3,he,lawyer,PERSON,TITLE,PRON,NOUN,nsubjpass,pobj,PRP,NN,2,1
6959,51182.0,19,let,1,14,4,-10,13,14,-13,3,he,lawyer,PERSON,TITLE,PRON,NOUN,nsubj,nsubj,PRP,NN,5,1
6960,20814.0,13,run,2,10,12,2,9,0,-8,10,Lashkar-e-Taiba,1989 .,ORGANIZATION,DATE-DATE,PROPN,NUM-PUNCT,dobj,pobj-punct,NNP,CD-.,2,1
6961,20816.0,42,told,18,8,10,2,7,31,10,-8,al-Khawinay,38,PERSON,NUMBER,NOUN,NUM,appos,appos,NN,CD,2,1
6962,20817.0,36,faced,13,1,12,11,0,23,12,-1,Meskill,judge,PERSON,TITLE,PROPN,NOUN,nsubj,conj,NNP,NN,3,1
6963,20828.0,30,filed,10,21,26,5,20,3,-11,16,National Beef Packing Co,Kansas City,ORGANIZATION-ORGANIZATION-ORGANIZATION-ORGANIZATION,CITY-CITY,PROPN-PROPN-PROPN-PROPN,PROPN-PROPN,compound-compound-compound-conj,compound-pobj,NNP-NNP-NNP-NNP,NNP-NNP,3,1
6964,49067.0,41,said,4,32,37,5,31,3,-28,33,National Beef Packing Co,Kansas City,ORGANIZATION-ORGANIZATION-ORGANIZATION-ORGANIZATION,CITY-CITY,PROPN-PROPN-PROPN-PROPN,PROPN-PROPN,compound-compound-compound-appos,compound-pobj,NNP-NNP-NNP-NNP,NNP-NNP,3,1
6965,20844.0,19,Cutrone,0,1,5,4,0,13,-1,5,Cutrone,New York City,PERSON,CITY-CITY-CITY,NOUN,PROPN-PROPN-PROPN,ROOT,compound-compound-pobj,NN,NNP-NNP-NNP,2,1
6966,20851.0,44,notes,28,41,39,-2,40,4,-13,11,University of Haifa,Israel,ORGANIZATION-ORGANIZATION-ORGANIZATION,COUNTRY,PROPN-ADP-PROPN,PROPN,pobj-prep-pobj,poss,NNP-IN-NNP,NNP,3,1
6967,44977.0,44,involved,25,18,23,5,17,20,7,-2,University of Haifa,Israel,ORGANIZATION-ORGANIZATION-ORGANIZATION,COUNTRY,PROPN-ADP-PROPN,PROPN,pobj-prep-pobj,pobj,NNP-IN-NNP,NNP,5,1
6968,20853.0,24,become,12,4,1,-3,3,22,8,-11,Carnival Corp.,David Bernstein,ORGANIZATION-ORGANIZATION,PERSON-PERSON,PROPN-PROPN,PROPN-PROPN,compound-poss,compound-nsubj,NNP-NNP,NNP-NNP,2,1
6969,20872.0,42,survived,2,1,16,15,0,25,1,14,Kaiser,Robert G Kaiser,PERSON,PERSON-PERSON-PERSON,PROPN,PROPN-PROPN-PROPN,nsubjpass,compound-compound-appos,NNP,NNP-NNP-NNP,7,1
6970,20875.0,32,said,10,7,9,2,6,22,3,-1,NSC,Lee Lou-chuang,ORGANIZATION,PERSON-PERSON,PROPN,PROPN-PROPN,compound,compound-nsubj,NNP,NNP-NNP,2,1
6971,42950.0,41,excels,1,15,18,3,14,22,-14,17,NSC,Lee Lou-chuang,ORGANIZATION,PERSON-PERSON,PROPN,PROPN-PROPN,compound,compound-nsubj,NNP,NNP-NNP,3,1
6972,20883.0,27,said,15,17,25,8,16,1,-2,10,Robert McNair,Houston Texans,PERSON-PERSON,ORGANIZATION-ORGANIZATION,PROPN-PROPN,PROPN-PROPN,compound-nsubj,compound-pobj,NNP-NNP,NNP-NNPS,5,1
6973,20895.0,23,was,6,3,6,3,2,16,3,0,Old Lane,Pandit,ORGANIZATION-ORGANIZATION,PERSON,PROPN-PROPN,PROPN,compound-dobj,nsubj,NNP-NNP,NNP,3,1
6974,20903.0,37,Box,3,29,9,-20,28,27,-26,6,CC,San Jose,ORGANIZATION,CITY-CITY,PROPN,PROPN-PROPN,compound,compound-ROOT,NNP,NNP-NNP,3,1
6975,20908.0,45,accepted,19,29,10,-19,28,34,-10,-9,MF Global Holdings Ltd.,Goldman Sachs Group Inc.,ORGANIZATION-ORGANIZATION-ORGANIZATION-ORGANIZATION,ORGANIZATION-ORGANIZATION-ORGANIZATION-ORGANIZATION,PROPN-PROPN-PROPN-PROPN,PROPN-PROPN-PROPN-PROPN,compound-compound-compound-appos,compound-compound-compound-dobj,NNP-NNP-NNPS-NNP,NNP-NNP-NNP-NNP,7,1
6976,20909.0,34,investigated,4,32,15,-17,31,18,-28,11,Samsung,Lee Jae-Yong,ORGANIZATION,PERSON-PERSON,PROPN,PROPN-PROPN,compound,subtok-npadvmod,NNP,NNP-NNP,6,1
6977,20930.0,36,survived,12,11,18,7,10,17,1,6,Forsberg,Genie Loaring-Clark Watson,PERSON,PERSON-PERSON-PERSON,PROPN,PROPN-PROPN-PROPN,nsubjpass,compound-compound-appos,NNP,NNP-NNP-NNP,6,1
6978,23132.0,35,survived,12,11,18,7,10,16,1,6,Forsberg,Genie Loaring-Clark Watson,PERSON,PERSON-PERSON-PERSON,PROPN,PROPN-PROPN-PROPN,nsubjpass,compound-compound-appos,NNP,NNP-NNP-NNP,6,1
6979,20937.0,29,Stars,0,18,6,-12,17,22,-18,6,Hector Elizondo,Lindsay Lohan,PERSON-PERSON,PERSON-PERSON,PROPN-PROPN,PROPN-PROPN,compound-conj,compound-conj,NNP-NNP,NNP-NNP,4,1
6980,20956.0,30,get,12,28,20,-8,27,9,-16,8,John Hewitt,Liberty Tax Service,PERSON-PERSON,ORGANIZATION-ORGANIZATION-ORGANIZATION,PROPN-PROPN,PROPN-PROPN-PROPN,compound-pobj,compound-compound-pobj,NNP-NNP,NNP-NNP-NNP,7,1
6981,20966.0,20,told,17,1,5,4,0,14,16,-12,Jamie Lynn Spears,star,PERSON-PERSON-PERSON,TITLE,PROPN-PROPN-PROPN,NOUN,compound-compound-nsubj,appos,NNP-NNP-NNP,NN,3,1
6982,27326.0,29,considering,2,24,23,-1,23,5,-22,21,Jamie Lynn Spears,star,PERSON-PERSON-PERSON,TITLE,PROPN-PROPN-PROPN,NOUN,compound-compound-nsubj,compound,NNP-NNP-NNPS,NN,1,1
6983,20975.0,39,said,8,1,11,10,0,27,7,3,JEM,his,ORGANIZATION,PERSON,PROPN,DET,poss,poss,NNP,PRP$,6,1
6984,20980.0,36,passed,5,2,26,24,1,9,3,21,Massachusetts House of Representatives,Legislature,ORGANIZATION-ORGANIZATION-ORGANIZATION-ORGANIZATION,ORGANIZATION,PROPN-PROPN-ADP-PROPN,PROPN,compound-nsubj-prep-pobj,nsubj,NNP-NNP-IN-NNPS,NNP,3,1
6985,23730.0,42,lost,2,14,41,27,13,0,-12,39,Massachusetts House of Representatives,Legislature,ORGANIZATION-ORGANIZATION-ORGANIZATION-ORGANIZATION,ORGANIZATION,PROPN-PROPN-ADP-PROPN,PROPN,compound-pobj-prep-pobj,pobj,NNP-NNP-IN-NNPS,NNP,11,1
6986,20994.0,44,said,31,41,33,-8,40,10,-10,2,Crown Prosecution Service,Sir Ken Macdonald,ORGANIZATION-ORGANIZATION-ORGANIZATION,PERSON-PERSON-PERSON,PROPN-PROPN-PROPN,PROPN-PROPN-PROPN,compound-compound-pobj,compound-compound-nsubj,NNP-NNP-NNP,NNP-NNP-NNP,5,1
6987,20999.0,75,survived,26,2,10,8,1,64,24,-16,Deaver,Calif.,PERSON,STATE_OR_PROVINCE,PROPN,PROPN,nsubjpass,appos,NNP,NNP,2,1
6988,21005.0,40,were,1,7,22,15,6,17,-6,21,she,Scottish,PERSON,NATIONALITY,PRON,ADJ,nsubj,amod,PRP,JJ,9,1
6989,21032.0,26,are,4,12,19,7,11,6,-8,15,Abdul Rahim Noor,Anwar 's staff,PERSON-PERSON-PERSON,ORGANIZATION-ORGANIZATION-ORGANIZATION,PROPN-PROPN-PROPN,PROPN-PART-NOUN,compound-compound-conj,poss-case-pobj,NNP-NNP-NNP,NNP-POS-NN,6,1
6990,21057.0,43,said,19,16,18,2,15,24,3,-1,Arsenal,Danny Fiszman,ORGANIZATION,PERSON-PERSON,ADJ,PROPN-PROPN,conj,compound-nsubj,JJ,NNP-NNP,1,1
6991,21061.0,8,tells,4,1,3,2,0,4,3,-1,Pratt,26,PERSON,NUMBER,PROPN,NUM,nsubj,appos,NNP,CD,3,1
6992,32828.0,16,Spencer,0,6,8,2,5,7,-6,8,Pratt,26,PERSON,NUMBER,PROPN,NUM,nsubj,appos,NNP,CD,2,1
6993,47054.0,40,came,2,23,25,2,22,14,-21,23,Pratt,26,PERSON,NUMBER,PROPN,NUM,nsubj,appos,NNP,CD,1,1
6994,64384.0,30,Credit,0,12,14,2,11,15,-12,14,Pratt,26,PERSON,NUMBER,PROPN,NUM,appos,appos,NNP,CD,5,1
6995,21065.0,29,protect,3,1,26,25,0,2,2,23,CPS,Child Protective Services,ORGANIZATION,ORGANIZATION-ORGANIZATION-ORGANIZATION,PROPN,PROPN-PROPN-PROPN,nsubj,compound-compound-pobj,NNP,NNP-NNP-NNPS,-1,1
6996,21066.0,45,Minister,0,26,31,5,25,13,-26,31,Mainland Affairs Council,Joseph Wu,ORGANIZATION-ORGANIZATION-ORGANIZATION,PERSON-PERSON,PROPN-PROPN-PROPN,PROPN-PROPN,compound-compound-compound,compound-compound,NNP-NNPS-NNP,NNP-NNP,3,1
6997,27133.0,31,Council,2,1,8,7,0,22,1,6,Mainland Affairs Council,Joseph Wu,ORGANIZATION-ORGANIZATION-ORGANIZATION,PERSON-PERSON,PROPN-PROPN-PROPN,PROPN-PROPN,compound-compound-ROOT,compound-nsubj,NNP-NNPS-NNP,NNP-NNP,-1,1
6998,30471.0,25,said,22,17,21,4,16,3,5,-1,Mainland Affairs Council,Joseph Wu,ORGANIZATION-ORGANIZATION-ORGANIZATION,PERSON-PERSON,PROPN-PROPN-PROPN,PROPN-PROPN,compound-compound-compound,compound-nsubj,NNP-NNPS-NNP,NNP-NNP,3,1
6999,67370.0,32,confirmed,3,7,11,4,6,20,-4,8,Mainland Affairs Council,Joseph Wu,ORGANIZATION-ORGANIZATION-ORGANIZATION,PERSON-PERSON,PROPN-PROPN-PROPN,PROPN-PROPN,compound-compound-compound,compound-nsubjpass,NNP-NNPS-NNP,NNP-NNP,3,1
7000,21070.0,49,DAMASCUS,0,20,3,-17,19,45,-20,3,he,Saudi,PERSON,NATIONALITY,PRON,ADJ,nsubj,amod,PRP,JJ,4,1
7001,21073.0,46,dead,3,2,1,-1,1,44,1,-2,Art Buchwald,Columnist,PERSON-PERSON,TITLE,NOUN-PROPN,PROPN,compound-nsubj,compound,NN-NNP,NNP,1,1
7002,21081.0,40,were,9,5,8,3,4,31,4,-1,his,John,PERSON,PERSON,DET,PROPN,poss,appos,PRP$,NNP,3,1
7003,21084.0,13,say,2,4,6,2,3,6,-2,4,he,murder,PERSON,CRIMINAL_CHARGE,PRON,NOUN,nsubj,dobj,PRP,NN,2,1
7004,62981.0,53,said,1,3,18,15,2,34,-2,17,he,murder,PERSON,CRIMINAL_CHARGE,PRON,NOUN,nsubj,xcomp,PRP,NN,3,1
7005,21107.0,33,managed,15,19,11,-8,18,21,-4,-4,her,20,PERSON,NUMBER,DET,NUM,poss,appos,PRP$,CD,3,1
7006,21110.0,47,is,8,16,21,5,15,25,-8,13,he,Christian,PERSON,RELIGION,PRON,PROPN,nsubj,attr,PRP,NNP,2,1
7007,21115.0,19,was,8,8,4,-4,7,14,0,-4,Maloney,N.C.,PERSON,STATE_OR_PROVINCE,PROPN,PROPN,nsubj,nmod,NNP,NNP,2,1
7008,21149.0,23,immigrated,12,12,10,-2,11,12,0,-2,Nurmi,Finland,PERSON,NATIONALITY,PROPN,PROPN,nsubj,pobj,NNP,NNP,1,1
7009,54207.0,19,won,3,3,1,-2,2,17,0,-2,Nurmi,Finland,PERSON,NATIONALITY,PROPN,PROPN,nsubj,poss,NNP,NNP,3,1
7010,21157.0,38,said,36,22,2,-20,21,35,14,-34,his,senator,PERSON,TITLE,DET,NOUN,poss,nsubj,PRP$,NN,2,1
7011,21159.0,33,were,9,7,2,-5,6,30,2,-7,American Basketball Association,New Orleans Buccaneers,ORGANIZATION-ORGANIZATION-ORGANIZATION,ORGANIZATION-ORGANIZATION-ORGANIZATION,PROPN-PROPN-PROPN,PROPN-PROPN-PROPN,compound-compound-pobj,compound-compound-nsubj,NNP-NNP-NNP,NNP-NNP-NNPS,4,1
7012,21167.0,4,was,1,1,3,2,0,0,0,2,He,89,PERSON,NUMBER,PRON,NUM,nsubj,attr,PRP,CD,1,1
7013,21171.0,11,dies,5,4,11,7,3,-1,1,6,Pascal Yoadimnadji,56,PERSON-PERSON,NUMBER,PROPN-PROPN,NUM,compound-nsubj,nummod,NNP-NNP,CD,-1,1
7014,56528.0,18,Yoadimnadji,2,2,5,3,1,12,0,3,Pascal Yoadimnadji,56,PERSON-PERSON,NUMBER,PROPN-PROPN,NUM,compound-ROOT,appos,NNP-NNPS,CD,1,1
7015,57088.0,36,dies,5,4,11,7,3,24,1,6,Pascal Yoadimnadji,56,PERSON-PERSON,NUMBER,PROPN-PROPN,NUM,compound-nsubj,nummod,NNP-NNP,CD,3,1
7016,21187.0,31,looked,5,29,2,-27,28,28,-24,-3,her,reality TV show star,PERSON,TITLE-TITLE-TITLE-TITLE,DET,NOUN-NOUN-NOUN-NOUN,poss,compound-compound-compound-nsubj,PRP$,NN-NN-NN-NN,7,1
7017,21190.0,62,existed,5,38,40,2,37,21,-33,35,ABA,Denver Rockets,ORGANIZATION,ORGANIZATION-ORGANIZATION,PROPN,PROPN-PROPN,poss,compound-pobj,NNP,NNP-NNPS,2,1
7018,21191.0,22,accessed,13,6,21,15,5,0,7,8,Ontario Human Rights Commission,http://wwwohrconca/en/resources/news/en/resources/news/statement,ORGANIZATION-ORGANIZATION-ORGANIZATION-ORGANIZATION,URL,PROPN-PROPN-PROPN-PROPN,X,compound-compound-compound-poss,intj,NNP-NNP-NNPS-NNP,ADD,10,1
7019,21195.0,30,'s,2,17,5,-12,16,24,-15,3,Red Sox,Joe McCarthy,ORGANIZATION-ORGANIZATION,PERSON-PERSON,PROPN-PROPN,PROPN-PROPN,compound-compound,compound-poss,NNP-NNP,NNP-NNP,9,1
7020,21196.0,21,said,19,17,1,-16,16,19,2,-18,NSG,New Delhi,ORGANIZATION,CITY-CITY,PROPN,PROPN-PROPN,pobj,compound-nsubj,NNP,NNP-NNP,3,1
7021,21216.0,56,died,40,1,5,4,0,50,39,-35,Richard H Nolte,86,PERSON-PERSON-PERSON,NUMBER,PROPN-PROPN-PROPN,NUM,compound-compound-nsubj,appos,NNP-NNP-NNP,CD,2,1
7022,21226.0,40,said,20,35,29,-6,34,10,-15,9,St. Anselm College,New Hampshire Institute of Politics,ORGANIZATION-ORGANIZATION-ORGANIZATION,ORGANIZATION-ORGANIZATION-ORGANIZATION-ORGANIZATION-ORGANIZATION,PROPN-PROPN-PROPN,PROPN-PROPN-PROPN-ADP-PROPN,compound-compound-pobj,compound-compound-pobj-prep-pobj,NNP-NNP-NNP,NNP-NNP-NNP-IN-NNP,5,1
7023,29890.0,33,said,15,30,24,-6,29,8,-15,9,St. Anselm College,New Hampshire Institute of Politics,ORGANIZATION-ORGANIZATION-ORGANIZATION,ORGANIZATION-ORGANIZATION-ORGANIZATION-ORGANIZATION-ORGANIZATION,PROPN-PROPN-PROPN,PROPN-PROPN-PROPN-ADP-PROPN,compound-compound-pobj,compound-compound-pobj-prep-pobj,NNP-NNP-NNP,NNP-NNP-NNP-IN-NNP,5,1
7024,30307.0,39,said,20,36,30,-6,35,8,-16,10,St. Anselm College,New Hampshire Institute of Politics,ORGANIZATION-ORGANIZATION-ORGANIZATION,ORGANIZATION-ORGANIZATION-ORGANIZATION-ORGANIZATION-ORGANIZATION,PROPN-PROPN-PROPN,PROPN-PROPN-PROPN-ADP-PROPN,compound-compound-pobj,compound-compound-pobj-prep-pobj,NNP-NNP-NNP,NNP-NNP-NNP-IN-NNP,5,1
7025,21238.0,45,ANCHOR,2,5,11,6,4,33,-3,9,DAN ABRAMS,CONSULTING,PERSON-PERSON,TITLE,PROPN-NOUN,NOUN,compound-appos,compound,NNP-NNS,NN,3,1
7026,21244.0,47,died,32,1,34,33,0,12,31,2,Jennifer Dunn,Wednesday,PERSON-PERSON,DATE,PROPN-PROPN,PROPN,compound-nsubj,npadvmod,NNP-NNP,NNP,2,1
7027,54394.0,30,said,28,3,25,22,2,4,25,-3,Jennifer Dunn,Wednesday,PERSON-PERSON,DATE,PROPN-PROPN,PROPN,compound-nsubj,npadvmod,NNP-NNP,NNP,3,1
7028,21245.0,23,Jr,2,1,3,2,0,19,1,1,Jefferson DeBlanc,Jr,PERSON-PERSON,PERSON,PROPN-PROPN,PROPN,compound-compound,ROOT,NNP-NNP,NNP,2,1
7029,21248.0,37,said,24,33,29,-4,32,7,-9,5,Myers,President,PERSON,TITLE,PROPN,PROPN,dobj,compound,NNP,NNP,3,1
7030,21250.0,25,linked,5,9,2,-7,8,22,-4,-3,Paul Sculfor,Jennifer Aniston,PERSON-PERSON,PERSON-PERSON,PROPN-PROPN,PROPN-PROPN,compound-dobj,compound-nsubjpass,NNP-NNP,NNP-NNP,3,1
7031,32945.0,39,dating,3,13,9,-4,12,29,-10,6,Paul Sculfor,Jennifer Aniston,PERSON-PERSON,PERSON-PERSON,PROPN-PROPN,PROPN-PROPN,compound-dobj,compound-nsubj,NNP-NNP,NNP-NNP,2,1
7032,56870.0,61,saw,2,11,6,-5,10,54,-9,4,Paul Sculfor,Jennifer Aniston,PERSON-PERSON,PERSON-PERSON,PROPN-PROPN,PROPN-PROPN,compound-appos,compound-poss,NNP-NNP,NNP-NNP,2,1
7033,21258.0,23,spent,2,1,17,16,0,5,1,15,She,Rosamond,PERSON,PERSON,PRON,PROPN,nsubj,pobj,PRP,NNP,6,1
7034,21279.0,21,took,1,1,16,15,0,4,0,15,Castro,he,PERSON,PERSON,PROPN,PRON,nsubj,nsubj,NNP,PRP,2,1
7035,21292.0,18,wants,1,6,10,4,5,7,-5,9,Red Cross,"30,000",ORGANIZATION-ORGANIZATION,NUMBER,PROPN-PROPN,NUM,compound-dobj,nummod,NNP-NNP,CD,3,1
7036,21299.0,36,requesting,3,7,17,10,6,18,-4,14,Chris Simcox,Az.,PERSON-PERSON,LOCATION,PROPN-PROPN,PROPN,compound-poss,appos,NNP-NNP,NNP,5,1
7037,21302.0,25,said,12,21,14,-7,20,10,-9,2,Medina hospital,Dahir Mohamed Mohamoud,ORGANIZATION-ORGANIZATION,PERSON-PERSON-PERSON,PROPN-NOUN,PROPN-PROPN-PROPN,compound-pobj,compound-compound-nsubj,NNP-NN,NNP-NNP-NNP,5,1
7038,63708.0,28,said,14,24,17,-7,23,10,-10,3,Medina hospital,Dahir Mohamed Mohamoud,ORGANIZATION-ORGANIZATION,PERSON-PERSON-PERSON,PROPN-NOUN,PROPN-PROPN-PROPN,compound-pobj,compound-compound-nsubj,NNP-NN,NNP-NNP-NNP,4,1
7039,21316.0,51,quoted,43,39,35,-4,38,15,4,-8,Ali Akbar Salehi,atomic energy agency,PERSON-PERSON-PERSON,ORGANIZATION-ORGANIZATION-ORGANIZATION,PROPN-PROPN-PROPN,ADJ-NOUN-NOUN,compound-compound-appos,amod-compound-pobj,NNP-NNP-NNP,JJ-NN-NN,6,1
7040,27715.0,21,speaking,2,18,14,-4,17,6,-16,12,Ali Akbar Salehi,atomic energy agency,PERSON-PERSON-PERSON,ORGANIZATION-ORGANIZATION-ORGANIZATION,PROPN-PROPN-PROPN,ADJ-NOUN-NOUN,compound-compound-appos,amod-compound-pobj,NNP-NNP-NNP,JJ-NN-NN,3,1
7041,21321.0,34,died,1,29,11,-18,28,22,-28,10,Multidisciplinary Association for Psychedelic Studies,Switzerland,ORGANIZATION-ORGANIZATION-ORGANIZATION-ORGANIZATION-ORGANIZATION,COUNTRY,PROPN-PROPN-ADP-PROPN-PROPN,PROPN,compound-appos-prep-compound-pobj,appos,NNP-NNP-IN-NNP-NNPS,NNP,5,1
7042,21323.0,21,said,7,3,6,3,2,14,4,-1,Samsung,Yun Jong-yong,ORGANIZATION,PERSON-PERSON,PROPN,PROPN-PROPN,compound,compound-appos,NNP,NNP-NNP,3,1
7043,21326.0,14,has,4,1,2,1,0,11,3,-2,Her,White House,PERSON,ORGANIZATION-ORGANIZATION,DET,PROPN-PROPN,poss,compound-compound,PRP$,NNP-NNP,1,1
7044,21335.0,29,made,12,4,18,14,3,10,8,6,her,Sydney,PERSON,CITY,DET,PROPN,poss,pobj,PRP$,NNP,9,1
7045,21337.0,49,said,18,32,14,-18,31,34,-14,-4,Justice and Equality Movement,Islamist,ORGANIZATION-ORGANIZATION-ORGANIZATION-ORGANIZATION,RELIGION,PROPN-CCONJ-PROPN-PROPN,ADJ,nmod-cc-conj-pobj,amod,NNP-CC-NNP-NNP,JJ,15,1
7046,43286.0,37,rebels,2,6,2,-4,5,34,-4,0,Justice and Equality Movement,Islamist,ORGANIZATION-ORGANIZATION-ORGANIZATION-ORGANIZATION,RELIGION,PROPN-CCONJ-PROPN-PROPN,ADJ,nmod-cc-conj-pobj,amod,NNP-CC-NNP-NNP,JJ,4,1
7047,62432.0,61,MEANT,0,44,26,-18,43,34,-44,26,Justice and Equality Movement,Islamist,ORGANIZATION-ORGANIZATION-ORGANIZATION-ORGANIZATION,RELIGION,PROPN-CCONJ-PROPN-PROPN,ADJ,nmod-cc-conj-pobj,amod,NNP-CC-NNP-NNP,JJ,17,1
7048,21355.0,27,told,10,4,7,3,3,19,6,-3,Olivia,MTV,PERSON,ORGANIZATION,PROPN,PROPN,pobj,compound,NNP,NNP,3,1
7049,21357.0,32,brings,4,19,21,2,18,10,-15,17,ISU,International Skating Union,ORGANIZATION,ORGANIZATION-ORGANIZATION-ORGANIZATION,NOUN,PROPN-PROPN-PROPN,compound,compound-compound-compound,NN,NNP-NNP-NNP,4,1
7050,29169.0,31,disputed,21,28,24,-4,27,6,-7,3,ISU,International Skating Union,ORGANIZATION,ORGANIZATION-ORGANIZATION-ORGANIZATION,PROPN,PROPN-PROPN-PROPN,compound,compound-compound-dobj,NNP,NNP-NNP-NNP,3,1
7051,49768.0,32,brought,4,19,21,2,18,10,-15,17,ISU,International Skating Union,ORGANIZATION,ORGANIZATION-ORGANIZATION-ORGANIZATION,NOUN,PROPN-PROPN-PROPN,compound,compound-compound-compound,NN,NNP-NNP-NNP,4,1
7052,61503.0,41,banned,8,21,17,-4,20,23,-13,9,ISU,International Skating Union,ORGANIZATION,ORGANIZATION-ORGANIZATION-ORGANIZATION,PROPN,PROPN-PROPN-PROPN,compound,compound-compound-pobj,NNP,NNP-NNP-NNP,5,1
7053,21362.0,41,say,1,16,21,5,15,19,-15,20,Samsung Electronics Co.,Jae-yong,ORGANIZATION-ORGANIZATION-ORGANIZATION,PERSON,PROPN-PROPN-PROPN,PROPN,compound-compound-pobj,appos,NNP-NNPS-NNP,NNP,7,1
7054,21363.0,21,warned,7,1,6,5,0,14,6,-1,Citibank,Robert Bruckland,ORGANIZATION,PERSON-PERSON,PROPN,PROPN-PROPN,amod,compound-nsubj,NNP,NNP-NNP,2,1
7055,21366.0,53,went,23,14,51,37,13,1,9,28,he,Department I-C,PERSON,ORGANIZATION-ORGANIZATION,PRON,PROPN-PROPN,nsubjpass,compound-appos,PRP,NNP-NNP,11,1
7056,21370.0,23,said,21,1,20,19,0,2,20,-1,Medina hospital,Dahir Dhere,ORGANIZATION-ORGANIZATION,PERSON-PERSON,ADJ-NOUN,PROPN-PROPN,compound-nsubj,compound-nsubj,JJ-NN,NNP-NNP,3,1
7057,38300.0,30,said,18,28,20,-8,27,9,-10,2,Medina hospital,Dahir Dhere,ORGANIZATION-ORGANIZATION,PERSON-PERSON,PROPN-NOUN,PROPN-PROPN,compound-pobj,compound-nsubj,NNP-NN,NNP-NNP,5,1
7058,49831.0,18,says,11,7,10,3,6,7,4,-1,Medina hospital,Dahir Dhere,ORGANIZATION-ORGANIZATION,PERSON-PERSON,PROPN-NOUN,PROPN-PROPN,compound-compound,compound-appos,NNP-NN,NNP-NNP,8,1
7059,21376.0,24,was,9,2,6,4,1,17,7,-3,Defensor,Montevideo,PERSON,CITY,PROPN,PROPN,pobj,compound,NNP,NNP,1,1
7060,61568.0,34,won,1,1,19,18,0,14,0,18,Defensor,Montevideo,ORGANIZATION,CITY,PROPN,PROPN,nsubj,pobj,NNP,NNP,6,1
7061,21404.0,48,said,35,37,45,8,36,2,-2,10,Marco Contiero,Greenpeace European Unit,PERSON-PERSON,ORGANIZATION-ORGANIZATION-ORGANIZATION,PROPN-PROPN,PROPN-ADJ-PROPN,compound-nsubj,compound-compound-pobj,NNP-NNP,NNP-JJ-NNP,5,1
7062,21418.0,33,said,20,5,28,23,4,4,15,8,Philadelphia Inquirer,Newspaper Guild,ORGANIZATION-ORGANIZATION,ORGANIZATION-ORGANIZATION,PROPN-PROPN,PROPN-PROPN,compound-pobj,compound-pobj,NNP-NNP,NNP-NNP,8,1
7063,21430.0,14,born,2,1,12,11,0,1,1,10,Rothman,Jewish,PERSON,RELIGION,PROPN,ADJ,nsubjpass,amod,NNP,JJ,3,1
7064,21450.0,25,started,11,6,14,8,5,10,5,3,her,Andrew Goodman Foundation,PERSON,ORGANIZATION-ORGANIZATION-ORGANIZATION,DET,PROPN-PROPN-PROPN,poss,compound-compound-dobj,PRP$,NNP-NNP-NNP,4,1
7065,24563.0,26,started,12,7,15,8,6,10,5,3,her,Andrew Goodman Foundation,PERSON,ORGANIZATION-ORGANIZATION-ORGANIZATION,DET,PROPN-PROPN-PROPN,poss,compound-compound-dobj,PRP$,NNP-NNP-NNP,4,1
7066,21461.0,42,told,10,1,40,39,0,1,9,30,Li Jie,Chinese Navy,PERSON-PERSON,ORGANIZATION-ORGANIZATION,PROPN-PROPN,PROPN-PROPN,compound-nsubj,compound-pobj,NNP-NNP,NNP-NNP,6,1
7067,21468.0,33,signed,18,18,5,-13,17,27,0,-13,he,Southwestern Louisiana Institute,PERSON,ORGANIZATION-ORGANIZATION-ORGANIZATION,PRON,PROPN-PROPN-PROPN,nsubj,compound-compound-pobj,PRP,NNP-NNP-NNP,4,1
7068,35323.0,25,signed,4,4,14,10,3,10,0,10,he,Southwestern Louisiana Institute,PERSON,ORGANIZATION-ORGANIZATION-ORGANIZATION,PRON,PROPN-PROPN-PROPN,nsubj,compound-compound-pobj,PRP,NNP-NNP-NNP,5,1
7069,21478.0,33,building,11,8,1,-7,7,31,3,-10,Carnival Corp,Cunard,ORGANIZATION-ORGANIZATION,ORGANIZATION,PROPN-PROPN,PROPN,compound-pobj,compound,NNP-NNP,NNP,4,1
7070,21483.0,48,crushed,1,3,7,4,2,40,-2,6,Li Jie,Netherlands,PERSON-PERSON,COUNTRY,PROPN-PROPN,PROPN,compound-dobj,compound,NNP-NNP,NNP,2,1
7071,47611.0,30,had,3,9,13,4,8,16,-6,10,Li Jie,Netherlands,PERSON-PERSON,COUNTRY,PROPN-PROPN,PROPN,compound-pobj,pobj,NNP-NNP,NNP,4,1
7072,21489.0,26,born,4,1,23,22,0,2,3,19,Joseph Simpson Farland,Grace Simpson Farland,PERSON-PERSON-PERSON,PERSON-PERSON-PERSON,PROPN-PROPN-PROPN,PROPN-PROPN-PROPN,compound-compound-nsubjpass,compound-compound-conj,NNP-NNP-NNP,NNP-NNP-NNP,7,1
7073,21493.0,37,International,4,27,33,6,26,3,-23,29,APA,David Pruden,ORGANIZATION,PERSON-PERSON,PROPN,PROPN-PROPN,poss,compound-nsubj,NNP,NNP-NNP,3,1
7074,21495.0,22,commissioned,6,5,10,5,4,11,1,4,he,Navy,PERSON,ORGANIZATION,PRON,PROPN,nsubjpass,compound,PRP,NNP,3,1
7075,32880.0,25,returned,10,10,7,-3,9,17,0,-3,he,Navy,PERSON,ORGANIZATION,PRON,PROPN,nsubj,compound,PRP,NNP,4,1
7076,21505.0,35,guided,19,12,16,4,11,18,7,-3,American Basketball Association,Carolina Cougars,ORGANIZATION-ORGANIZATION-ORGANIZATION,ORGANIZATION-ORGANIZATION,PROPN-PROPN-PROPN,PROPN-PROPN,compound-compound-poss,compound-pobj,NNP-NNP-NNP,NNP-NNP,2,1
7077,21514.0,45,Hamilton,2,3,5,2,2,39,-1,3,Hamilton,23,PERSON,NUMBER,PROPN,NUM,ROOT,appos,NNP,CD,2,1
7078,22671.0,31,needed,1,1,14,13,0,16,0,13,Hamilton,23,PERSON,NUMBER,PROPN,NUM,nsubj,nummod,NNP,CD,1,1
7079,21530.0,47,died,40,1,9,8,0,37,39,-31,Catherine Roraback,Connecticut,PERSON-PERSON,STATE_OR_PROVINCE,PROPN-PROPN,PROPN,compound-nsubj,compound,NNP-NNP,NNP,3,1
7080,21545.0,41,needs,2,36,32,-4,35,8,-34,30,UNC,United National Congress,ORGANIZATION,ORGANIZATION-ORGANIZATION-ORGANIZATION,PROPN,PROPN-PROPN-PROPN,compound,compound-compound-appos,NNP,NNP-NNP-NNP,4,1
7081,23316.0,26,watching,2,18,14,-4,17,11,-16,12,UNC,United National Congress,ORGANIZATION,ORGANIZATION-ORGANIZATION-ORGANIZATION,PROPN,PROPN-PROPN-PROPN,compound,compound-compound-pobj,NNP,NNP-NNP-NNP,5,1
7082,62865.0,38,has,3,30,26,-4,29,11,-27,23,UNC,United National Congress,ORGANIZATION,ORGANIZATION-ORGANIZATION-ORGANIZATION,PROPN,PROPN-PROPN-PROPN,compound,compound-compound-conj,NNP,NNP-NNP-NNP,6,1
7083,21546.0,52,says,29,42,31,-11,41,20,-13,2,American Beverage Association,Maureen Storey,ORGANIZATION-ORGANIZATION-ORGANIZATION,PERSON-PERSON,PROPN-PROPN-PROPN,PROPN-PROPN,compound-compound-pobj,compound-nsubj,NNP-NNP-NNP,NNP-NNP,7,1
7084,21552.0,36,WASHINGTON,0,6,23,17,5,12,-6,23,Michael K. Deaver,director,PERSON-PERSON-PERSON,TITLE,PROPN-PROPN-PROPN,NOUN,compound-compound-nsubj,conj,NNP-NNP-NNP,NN,7,1
7085,21562.0,39,born,2,4,9,5,3,29,-2,7,Madonna Louise Veronica Ciccone,"August 16 , 1958",PERSON-PERSON-PERSON-PERSON,DATE-DATE-DATE-DATE,PROPN-PROPN-PROPN-PROPN,PROPN-NUM-PUNCT-NUM,compound-compound-compound-dobj,pobj-nummod-punct-appos,NNP-NNP-NNP-NNP,"NNP-CD-,-CD",5,1
7086,21571.0,35,survived,2,5,11,6,4,23,-3,9,his,Emily Ann Kennard Derounian,PERSON,PERSON-PERSON-PERSON-PERSON,DET,PROPN-PROPN-PROPN-PROPN,poss,compound-compound-compound-appos,PRP$,NNP-NNP-NNP-NNP,5,1
7087,21574.0,61,said,26,1,58,57,0,2,25,32,Phil Chen,Asian,PERSON-PERSON,NATIONALITY,PROPN-PROPN,ADJ,compound-nsubj,amod,NNP-NNP,JJ,5,1
7088,21576.0,28,said,23,25,19,-6,24,8,-2,-4,FirstGroup,USA,ORGANIZATION,COUNTRY,PROPN,PROPN,compound,pobj,NNP,NNP,9,1
7089,21577.0,86,Event,0,6,47,41,5,38,-6,47,Mainland Affairs Council,Chen Ming - tong,ORGANIZATION-ORGANIZATION-ORGANIZATION,PERSON-PERSON-PERSON-PERSON,PROPN-PROPN-PROPN,PROPN-PROPN-PUNCT-PROPN,compound-compound-compound,compound-compound-punct-compound,NNP-NNPS-NNP,NNP-NNP-HYPH-NNP,8,1
7090,21579.0,46,On,0,5,9,4,4,36,-5,9,National Action Network,http://wwwnationalactionnetworknet,ORGANIZATION-ORGANIZATION-ORGANIZATION,URL,PROPN-PROPN-PROPN,X,compound-compound-pobj,compound,NNP-NNP-NNP,ADD,5,1
7091,21582.0,73,McNair,1,1,43,42,0,29,0,42,Robert McNair,Robin Lee Howell,PERSON-PERSON,PERSON-PERSON-PERSON,PROPN-PROPN,PROPN-PROPN-PROPN,compound-ROOT,compound-compound-conj,NNP-NNP,NNP-NNP-NNP,-1,1
7092,21592.0,19,is,5,5,3,-2,4,15,0,-2,SAC,1951,ORGANIZATION,DATE,PROPN,NUM,nsubj,pobj,NNP,CD,1,1
7093,21595.0,43,said,12,18,21,3,17,21,-6,9,Black,publishing executive,PERSON,TITLE-TITLE,PROPN,NOUN-NOUN,dobj,compound-appos,NNP,NN-NN,2,1
7094,21597.0,37,said,11,1,7,6,0,29,10,-4,Leslie Walker,Massachusetts Correctional Legal Services,PERSON-PERSON,ORGANIZATION-ORGANIZATION-ORGANIZATION-ORGANIZATION,PROPN-PROPN,PROPN-PROPN-PROPN-PROPN,compound-nsubj,compound-compound-compound-pobj,NNP-NNP,NNP-NNP-NNP-NNPS,4,1
7095,21602.0,13,died,9,2,1,-1,1,11,7,-8,DeBlanc,Col.,PERSON,TITLE,PROPN,PROPN,poss,compound,NNP,NNP,1,1
7096,37998.0,49,received,6,6,5,-1,5,43,0,-1,DeBlanc,Col.,PERSON,TITLE,PROPN,PROPN,nsubj,compound,NNP,NNP,1,1
7097,21607.0,24,attended,17,13,15,2,12,8,4,-2,he,11,PERSON,NUMBER,PRON,NUM,nsubj,attr,PRP,CD,2,1
7098,24096.0,24,attended,17,13,15,2,12,8,4,-2,he,11,PERSON,NUMBER,PRON,NUM,nsubj,attr,PRP,CD,2,1
7099,21614.0,44,explained,13,8,11,3,7,32,5,-2,NSC,Lih J Chen,ORGANIZATION,PERSON-PERSON-PERSON,PROPN,PROPN-PROPN-PROPN,compound,compound-compound-nsubj,NNP,NNP-NNP-NNP,5,1
7100,21617.0,21,said,8,20,16,-4,19,4,-12,8,FAW,Hongqi,ORGANIZATION,PERSON,PROPN,PROPN,pobj,compound,NNP,NNP,6,1
7101,21618.0,22,chief,1,1,20,19,0,1,0,19,Samsung,Kim In-Joo,ORGANIZATION,PERSON-PERSON,ADJ,PROPN-PROPN,amod,compound-appos,JJ,NNP-NNP,4,1
7102,21622.0,30,sending,4,28,15,-13,27,14,-24,11,Juanita Millender-McDonald,Congress,PERSON-PERSON,ORGANIZATION,PROPN-PROPN,PROPN,compound-pobj,pobj,NNP-NNP,NNP,8,1
7103,22757.0,39,replied,13,12,29,17,11,9,1,16,Juanita Millender-McDonald,Congress,PERSON-PERSON,ORGANIZATION,PROPN-PROPN,PROPN,compound-nsubj,pobj,NNP-NNP,NNP,6,1
7104,21625.0,30,pushing,22,15,18,3,14,11,7,-4,her,Lynne Spears,PERSON,PERSON-PERSON,DET,PROPN-PROPN,poss,compound-appos,PRP$,NNP-NNP,1,1
7105,42256.0,27,told,2,10,1,-9,9,25,-8,-1,her,Lynne Spears,PERSON,PERSON-PERSON,DET,PROPN-PROPN,poss,compound-nsubj,PRP$,NNP-NNP,3,1
7106,21636.0,47,put,7,30,7,-23,29,39,-23,0,her,she,PERSON,PERSON,DET,PRON,poss,nsubj,PRP$,PRP,3,1
7107,54211.0,29,said,1,20,8,-12,19,20,-19,7,her,she,PERSON,PERSON,PRON,PRON,dobj,nsubj,PRP,PRP,9,1
7108,66236.0,18,says,1,7,3,-4,6,14,-6,2,her,she,PERSON,PERSON,DET,PRON,poss,nsubj,PRP$,PRP,6,1
7109,21638.0,34,said,10,4,1,-3,3,32,6,-9,Citibank,Cheng Cheng-mount,ORGANIZATION,PERSON-PERSON,PROPN,PROPN-PROPN,poss,compound-nsubj,NNP,NNP-NNP,2,1
7110,61618.0,69,Taipei,0,26,28,2,25,40,-26,28,Citibank,Cheng Cheng-mount,ORGANIZATION,PERSON-PERSON,PROPN,PROPN-NOUN,compound,compound-nsubj,NNP,NNP-NN,-1,1
7111,21644.0,31,was,15,18,25,7,17,5,-3,10,Carolyn Maloney,Queens,PERSON-PERSON,LOCATION,PROPN-PROPN,PROPN,compound-nsubj,dobj,NNP-NNP,NNP,1,1
7112,21647.0,17,announces,2,15,2,-13,14,14,-13,0,Jake Pavelka,ABC,PERSON-PERSON,ORGANIZATION,PROPN-PROPN,PROPN,compound-pobj,nsubj,NNP-NNP,NNP,7,1
7113,21653.0,31,JANEIRO,2,11,13,2,10,17,-9,11,Citibank,Gustavo Gomes Matarazzo,ORGANIZATION,PERSON-PERSON-PERSON,PROPN,PROPN-PROPN-PROPN,compound,compound-compound-nsubjpass,NNP,NNP-NNP-NNP,2,1
7114,21668.0,22,said,1,11,16,5,10,5,-10,15,her,activist,PERSON,TITLE,DET,NOUN,poss,conj,PRP$,NN,2,1
7115,21671.0,49,died,39,1,8,7,0,40,38,-31,Joseph S Farland,US,PERSON-PERSON-PERSON,COUNTRY,PROPN-PROPN-PROPN,PROPN,compound-compound-nsubj,compound,NNP-NNP-NNP,NNP,4,1
7116,21680.0,40,refused,23,34,12,-22,33,27,-11,-11,Daily News,Los Angeles,ORGANIZATION-ORGANIZATION,CITY-CITY,PROPN-PROPN,PROPN-PROPN,compound-compound,compound-npadvmod,NNP-NNP,NNP-NNP,7,1
7117,21681.0,28,numbered,2,22,27,5,21,0,-20,25,Northland Church,Florida,ORGANIZATION-ORGANIZATION,STATE_OR_PROVINCE,PROPN-PROPN,PROPN,compound-pobj,appos,NNP-NNP,NNP,6,1
7118,21688.0,54,was,1,1,51,50,0,2,0,50,Nolte,Alicia Patterson Foundation,PERSON,ORGANIZATION-ORGANIZATION-ORGANIZATION,PROPN,PROPN-PROPN-PROPN,nsubj,compound-compound-pobj,NNP,NNP-NNP-NNP,6,1
7119,21699.0,25,said,16,1,8,7,0,16,15,-8,Millender-McDonald,Sunday,PERSON,DATE,PROPN,PROPN,nsubj,npadvmod,NNP,NNP,2,1
7120,21707.0,26,SUSPENDS,4,12,25,13,11,0,-8,21,Jackson Hewitt,wwwjacksonhewittcom,ORGANIZATION-ORGANIZATION,URL,PROPN-PROPN,NOUN,compound-compound,dobj,NNP-NNP,NN,5,1
7121,21713.0,34,acting,3,19,30,11,18,3,-16,27,Ayatollah Ali Khamenei,chairman,PERSON-PERSON-PERSON,TITLE,PROPN-PROPN-PROPN,NOUN,compound-compound-pobj,pobj,NNP-NNP-NNP,NN,14,1
7122,21731.0,23,showed,6,9,2,-7,8,20,-3,-4,Boxer,California,PERSON,STATE_OR_PROVINCE,PROPN,PROPN,poss,pobj,NNP,NNP,5,1
7123,21733.0,20,graduated,1,1,4,3,0,15,0,3,He,Venezuela 's military academy,PERSON,ORGANIZATION-ORGANIZATION-ORGANIZATION-ORGANIZATION,PRON,PROPN-PART-ADJ-NOUN,nsubj,poss-case-amod-pobj,PRP,NNP-POS-JJ-NN,4,1
7124,21734.0,49,said,43,3,42,39,2,6,40,-1,Ellen DeGeneres,49,PERSON-PERSON,NUMBER,PROPN-PROPN,NUM,compound-compound,appos,NNP-NNP,CD,4,1
7125,21741.0,91,Veterans,6,49,1,-48,48,89,-43,-5,Paralyzed Veterans of America,American,ORGANIZATION-ORGANIZATION-ORGANIZATION-ORGANIZATION,COUNTRY,PROPN-PROPN-ADP-PROPN,PROPN,compound-oprd-prep-pobj,compound,NNP-NNPS-IN-NNP,NNP,4,1
7126,56137.0,54,adds,16,4,15,11,3,38,12,-1,Paralyzed Veterans of America,American,ORGANIZATION-ORGANIZATION-ORGANIZATION-ORGANIZATION,COUNTRY,PROPN-PROPN-ADP-PROPN,ADJ,compound-pobj-prep-pobj,compound,NNP-NNPS-IN-NNP,JJ,2,1
7127,21745.0,32,said,15,19,18,-1,18,13,-4,3,Robert Morgenthau,Attorney,PERSON-PERSON,TITLE,PROPN-PROPN,PROPN,compound-nsubj,compound,NNP-NNP,NNP,1,1
7128,21752.0,50,said,18,29,1,-28,28,48,-11,-17,al - Khawinay,Yemeni,PERSON-PERSON-PERSON,COUNTRY,PROPN-PUNCT-PROPN,ADJ,compound-punct-dobj,amod,NNP-HYPH-NNP,JJ,6,1
7129,21754.0,50,opened,2,25,25,0,24,24,-23,23,Illinois Tool Works Inc.,Illinois,ORGANIZATION-ORGANIZATION-ORGANIZATION-ORGANIZATION,STATE_OR_PROVINCE,PROPN-PROPN-PROPN-PROPN,PROPN,compound-compound-compound-nsubj,appos,NNP-NNP-NNP-NNP,NNP,0,1
7130,21757.0,44,has,2,17,21,4,16,22,-15,19,Christopher Bentley,USCIS,PERSON-PERSON,ORGANIZATION,PROPN-PROPN,PROPN,compound-pobj,nsubj,NNP-NNP,NNP,8,1
7131,21759.0,56,died,40,1,13,12,0,42,39,-27,Richard H Nolte,Institute of Current World Affairs,PERSON-PERSON-PERSON,ORGANIZATION-ORGANIZATION-ORGANIZATION-ORGANIZATION-ORGANIZATION,PROPN-PROPN-PROPN,PROPN-ADP-PROPN-PROPN-PROPN,compound-compound-nsubj,pobj-prep-compound-compound-pobj,NNP-NNP-NNP,NNP-IN-NNP-NNP-NNPS,5,1
7132,21793.0,47,-LRB-,4,26,29,3,25,17,-22,25,Jane Bolin,America,PERSON-PERSON,COUNTRY,PROPN-PROPN,PROPN,compound-nsubj,poss,NNP-NNP,NNP,3,1
7133,40894.0,38,died,33,9,26,17,8,11,24,-7,Jane Bolin,America,PERSON-PERSON,NATIONALITY,PROPN-PROPN,PROPN,compound-pobj,poss,NNP-NNP,NNP,5,1
7134,42022.0,30,died,25,1,18,17,0,11,24,-7,Jane Bolin,America,PERSON-PERSON,COUNTRY,PROPN-PROPN,PROPN,compound-nsubj,poss,NNP-NNP,NNP,5,1
7135,21806.0,35,reported,10,7,10,3,6,24,3,0,Jakarta Globe,Indonesia,ORGANIZATION-ORGANIZATION,COUNTRY,PROPN-PROPN,PROPN,compound-pobj,pobj,NNP-NNP,NNP,3,1
7136,27102.0,35,reported,31,30,4,-26,29,30,1,-27,Jakarta Globe,Indonesia,ORGANIZATION-ORGANIZATION,COUNTRY,PROPN-PROPN,PROPN,compound-nsubj,poss,NNP-NNP,NNP,7,1
7137,21810.0,16,was,1,1,14,13,0,1,0,13,She,California,PERSON,STATE_OR_PROVINCE,PRON,PROPN,nsubj,compound,PRP,NNP,6,1
7138,21811.0,69,said,46,59,48,-11,58,20,-13,2,Norris Comprehensive Cancer Center,Dr David Peng,ORGANIZATION-ORGANIZATION-ORGANIZATION-ORGANIZATION,PERSON-PERSON-PERSON,PROPN-PROPN-PROPN-PROPN,PROPN-PROPN-PROPN,compound-compound-compound-pobj,compound-compound-nsubj,NNP-NNP-NNP-NNP,NNP-NNP-NNP,7,1
7139,21813.0,14,has,5,5,7,2,4,6,0,2,ADB,67,ORGANIZATION,NUMBER,PROPN,NUM,nsubj,nummod,NNP,CD,1,1
7140,21817.0,27,said,11,14,24,10,13,2,-3,13,Carolyn Maloney,Joint Economic Committee,PERSON-PERSON,ORGANIZATION-ORGANIZATION-ORGANIZATION,PROPN-PROPN,PROPN-PROPN-PROPN,compound-nsubj,compound-compound-pobj,NNP-NNP,NNP-NNP-NNP,3,1
7141,44271.0,27,said,11,14,24,10,13,2,-3,13,Carolyn Maloney,Joint Economic Committee,PERSON-PERSON,ORGANIZATION-ORGANIZATION-ORGANIZATION,PROPN-PROPN,PROPN-PROPN-PROPN,compound-nsubj,compound-compound-pobj,NNP-NNP,NNP-NNP-NNP,3,1
7142,21818.0,31,However,0,10,30,20,9,0,-10,30,APA,Austria,ORGANIZATION,COUNTRY,PROPN,PROPN,compound,pobj,NNP,NNP,2,1
7143,30273.0,42,reported,40,39,8,-31,38,33,1,-32,APA,Austria,ORGANIZATION,COUNTRY,PROPN,PROPN,compound,pobj,NNP,NNP,4,1
7144,21829.0,35,said,15,1,17,16,0,17,14,2,M. Enkhbold,Mongolia,PERSON-PERSON,COUNTRY,PROPN-PROPN,PROPN,compound-nsubj,nsubj,NNP-NNP,NNP,4,1
7145,22310.0,20,accepted,9,16,1,-15,15,18,-7,-8,M. Enkhbold,Mongolia,PERSON-PERSON,COUNTRY,PROPN-PROPN,PROPN,compound-pobj,poss,NNP-NNP,NNP,6,1
7146,27947.0,34,won,10,20,30,10,19,3,-10,20,M. Enkhbold,Mongolia,PERSON-PERSON,COUNTRY,PROPN-PROPN,PROPN,compound-dobj,poss,NNP-NNP,NNP,4,1
7147,32221.0,20,met,2,9,5,-4,8,14,-7,3,M. Enkhbold,Mongolia,PERSON-PERSON,COUNTRY,PROPN-PROPN,PROPN,compound-pobj,poss,NNP-NNP,NNP,3,1
7148,48088.0,33,said,13,1,12,11,0,20,12,-1,M. Enkhbold,Mongolia,PERSON-PERSON,COUNTRY,PROPN-PROPN,PROPN,compound-nsubj,pobj,NNP-NNP,NNP,2,1
7149,59094.0,21,offered,17,4,12,8,3,8,13,-5,M. Enkhbold,Mongolia,PERSON-PERSON,COUNTRY,PROPN-PROPN,PROPN,compound-nsubj,conj,NNP-NNP,NNP,4,1
7150,21834.0,13,obtained,2,1,12,11,0,0,1,10,Nottingham-Spirk,1972,ORGANIZATION,DATE,PROPN,NUM,nsubj,pobj,NNP,CD,5,1
7151,21842.0,45,include,1,28,32,4,27,12,-27,31,Gilbert Gude,Bethesda,PERSON-PERSON,CITY,PROPN-PROPN,PROPN,compound-compound,pobj,NNP-NNP,NNP,4,1
7152,21846.0,66,made,7,46,21,-25,45,44,-39,14,NSC,US,ORGANIZATION,COUNTRY,PROPN,PROPN,conj,compound,NNP,NNP,13,1
7153,21874.0,30,established,6,4,16,12,3,13,2,10,Rothman,Los Angeles,PERSON,CITY-CITY,PROPN,PROPN-PROPN,nsubj,compound-pobj,NNP,NNP-NNP,5,1
7154,38304.0,41,Rothman,3,4,18,14,3,22,-1,15,Rothman,Los Angeles,PERSON,CITY-CITY,PROPN,PROPN-PROPN,ROOT,compound-compound,NNP,NNP-NNP,6,1
7155,43866.0,23,moved,6,2,12,10,1,10,4,6,Rothman,Los Angeles,PERSON,CITY-CITY,PROPN,PROPN-PROPN,nsubj,compound-pobj,NNP,NNP-NNP,3,1
7156,21877.0,35,said,9,8,3,-5,7,31,1,-6,Philip Chen,Director,PERSON-PERSON,TITLE,PROPN-PROPN,PROPN,compound-appos,nsubj,NNP-NNP,NNP,2,1
7157,43588.0,34,signed,18,8,3,-5,7,30,10,-15,Philip Chen,Director,PERSON-PERSON,TITLE,PROPN-PROPN,PROPN,compound-appos,nsubj,NNP-NNP,NNP,2,1
7158,46173.0,33,said,5,4,3,-1,3,29,1,-2,Philip Chen,Director,PERSON-PERSON,TITLE,PROPN-PROPN,PROPN,compound-nsubj,compound,NNP-NNP,NNP,1,1
7159,21891.0,30,evolved,5,4,12,8,3,17,1,7,Deaver,stage manager,PERSON,TITLE-TITLE,PROPN,NOUN-NOUN,nsubj,compound-pobj,NNP,NN-NN,3,1
7160,21894.0,30,announced,28,4,13,9,3,16,24,-15,Jo Ann Davis,House of Representatives,PERSON-PERSON-PERSON,ORGANIZATION-ORGANIZATION-ORGANIZATION,PROPN-PROPN-PROPN,PROPN-ADP-PROPN,compound-compound-nsubj,pobj-prep-pobj,NNP-NNP-NNP,NNP-IN-NNPS,5,1
7161,35719.0,34,said,32,3,13,10,2,20,29,-19,Jo Ann Davis,House of Representatives,PERSON-PERSON-PERSON,ORGANIZATION-ORGANIZATION-ORGANIZATION,PROPN-PROPN-PROPN,PROPN-ADP-PROPN,compound-compound-nsubj,pobj-prep-pobj,NNP-NNP-NNP,NNP-IN-NNPS,5,1
7162,21901.0,24,gave,8,6,1,-5,5,22,2,-7,KGB,Lugovoi,ORGANIZATION,PERSON,PROPN,PROPN,compound,nsubj,NNP,NNP,1,1
7163,21902.0,40,said,38,37,35,-2,36,4,1,-3,her,Friday,PERSON,DATE,DET,PROPN,poss,npadvmod,PRP$,NNP,2,1
7164,21912.0,14,pleaded,1,1,5,4,0,8,0,4,Rahim,assault,PERSON,CRIMINAL_CHARGE,NOUN,NOUN,nsubj,pobj,NNS,NN,2,1
7165,21913.0,34,died,21,1,23,22,0,10,20,2,Parren J. Mitchell,May 28,PERSON-PERSON-PERSON,DATE-DATE,PROPN-PROPN-PROPN,PROPN-NUM,compound-compound-nsubj,npadvmod-nummod,NNP-NNP-NNP,NNP-CD,4,1
7166,21926.0,42,Council,3,2,6,4,1,35,1,3,National Security Council,NSC,ORGANIZATION-ORGANIZATION-ORGANIZATION,ORGANIZATION,PROPN-PROPN-PROPN,PROPN,compound-compound-ROOT,compound,NNP-NNP-NNP,NNP,3,1
7167,48456.0,36,said,30,5,9,4,4,26,25,-21,National Security Council,NSC,ORGANIZATION-ORGANIZATION-ORGANIZATION,ORGANIZATION,PROPN-PROPN-PROPN,PROPN,compound-compound-dobj,compound,NNP-NNP-NNP,NNP,3,1
7168,21936.0,25,risen,2,22,20,-2,21,4,-20,18,Arsenal football club,Britain,ORGANIZATION-ORGANIZATION-ORGANIZATION,COUNTRY,PROPN-NOUN-NOUN,PROPN,compound-compound-pobj,poss,NNP-NN-NN,NNP,3,1
7169,21947.0,14,were,9,1,4,3,0,9,8,-5,Sutter,Darryl,PERSON,PERSON,PROPN,PROPN,poss,nsubj,NNP,NNP,4,1
7170,21950.0,39,eased,4,22,4,-18,21,34,-18,0,Paavo Nurmi,swimmer,PERSON-PERSON,TITLE,PROPN-PROPN,NOUN,compound-dobj,nsubj,NNP-NNP,NN,4,1
7171,21953.0,63,said,25,19,23,4,18,39,6,-2,Crown Prosecution Service,CPS,ORGANIZATION-ORGANIZATION-ORGANIZATION,ORGANIZATION,PROPN-PROPN-PROPN,PROPN,compound-compound-compound,compound,NNP-NNP-NNP,NNP,6,1
7172,24347.0,42,said,30,36,40,4,35,1,-6,10,Crown Prosecution Service,CPS,ORGANIZATION-ORGANIZATION-ORGANIZATION,ORGANIZATION,PROPN-PROPN-PROPN,PROPN,compound-compound-compound,compound,NNP-NNP-NNP,NNP,4,1
7173,26978.0,42,said,21,11,9,-2,10,32,10,-12,Crown Prosecution Service,CPS,ORGANIZATION-ORGANIZATION-ORGANIZATION,ORGANIZATION,PROPN-PROPN-PROPN,PROPN,compound-compound-compound,compound,NNP-NNP-NNP,NNP,2,1
7174,27339.0,42,'s,2,14,12,-2,13,29,-12,10,Crown Prosecution Service,CPS,ORGANIZATION-ORGANIZATION-ORGANIZATION,ORGANIZATION,PROPN-PROPN-PROPN,PROPN,compound-compound-compound,compound,NNP-NNP-NNP,NNP,2,1
7175,41619.0,47,said,31,41,45,4,40,1,-10,14,Crown Prosecution Service,CPS,ORGANIZATION-ORGANIZATION-ORGANIZATION,ORGANIZATION,PROPN-PROPN-PROPN,PROPN,compound-compound-compound,compound,NNP-NNP-NNP,NNP,-1,1
7176,49743.0,37,alleges,8,3,7,4,2,29,5,-1,Crown Prosecution Service,CPS,ORGANIZATION-ORGANIZATION-ORGANIZATION,ORGANIZATION,PROPN-PROPN-PROPN,PROPN,compound-compound-compound,compound,NNP-NNP-NNP,NNP,-1,1
7177,21961.0,30,published,1,7,19,12,6,10,-6,18,his,director,PERSON,TITLE,DET,NOUN,poss,oprd,PRP$,NN,6,1
7178,54028.0,16,replaced,8,11,4,-7,10,11,-3,-4,his,director,PERSON,TITLE,DET,NOUN,poss,compound,PRP$,NN,4,1
7179,21976.0,30,served,1,1,10,9,0,19,0,9,She,Los Angeles Unified School District,PERSON,ORGANIZATION-ORGANIZATION-ORGANIZATION-ORGANIZATION-ORGANIZATION,PRON,PROPN-PROPN-VERB-PROPN-PROPN,nsubj,compound-compound-compound-compound-pobj,PRP,NNP-NNP-VBD-NNP-NNP,5,1
7180,21981.0,15,started,6,12,6,-6,11,8,-6,0,George Boyd,Foxes,PERSON-PERSON,ORGANIZATION,PROPN-PROPN,PROPN,compound-compound,nsubj,NNP-NNP,NNPS,4,1
7181,21985.0,45,sparked,23,16,20,4,15,24,7,-3,David Banda,Malawi,PERSON-PERSON,COUNTRY,PROPN-PROPN,PROPN,compound-dobj,pobj,NNP-NNP,NNP,4,1
7182,50323.0,20,visited,1,12,3,-9,11,16,-11,2,David Banda,Malawi,PERSON-PERSON,COUNTRY,PROPN-PROPN,PROPN,compound-pobj,dobj,NNP-NNP,NNP,7,1
7183,60643.0,26,begins,1,24,6,-18,23,19,-23,5,David Banda,Malawi,PERSON-PERSON,COUNTRY,PROPN-PROPN,PROPN,compound-pobj,pobj,NNP-NNP,NNP,8,1
7184,21988.0,45,crippled,8,39,43,4,38,1,-31,35,Awami League,Hasina Wajed,ORGANIZATION-ORGANIZATION,PERSON-PERSON,PROPN-PROPN,PROPN-PROPN,compound-conj,compound-pobj,NNP-NNP,NNP-NNP,2,1
7185,24108.0,38,are,11,6,10,4,5,27,5,-1,Awami League,Hasina Wajed,ORGANIZATION-ORGANIZATION,PERSON-PERSON,PROPN-PROPN,PROPN-PROPN,compound-compound,compound-conj,NNP-NNP,NNP-NNP,2,1
7186,40462.0,26,denied,2,24,10,-14,23,15,-22,8,Awami League,Hasina Wajed,ORGANIZATION-ORGANIZATION,PERSON-PERSON,PROPN-PROPN,PROPN-PROPN,compound-appos,compound-appos,NNP-NNP,NNP-NNP,2,1
7187,47108.0,30,include,1,15,11,-4,14,18,-14,10,Awami League,Hasina Wajed,ORGANIZATION-ORGANIZATION,PERSON-PERSON,PROPN-PROPN,PROPN-PROPN,compound-pobj,compound-appos,NNP-NNP,NNP-NNP,2,1
7188,50743.0,38,been,2,30,27,-3,29,10,-28,25,Awami League,Hasina Wajed,ORGANIZATION-ORGANIZATION,PERSON-PERSON,PROPN-PROPN,PROPN-PROPN,compound-compound,compound-poss,NNP-NNP,NNP-NNP,2,1
7189,62563.0,38,reported,7,32,36,4,31,1,-25,29,Awami League,Hasina Wajed,ORGANIZATION-ORGANIZATION,PERSON-PERSON,PROPN-PROPN,PROPN-PROPN,compound-compound,compound-pobj,NNP-NNP,NNP-NNP,6,1
7190,67708.0,44,agreed,39,25,36,11,24,7,14,-3,Awami League,Hasina Wajed,ORGANIZATION-ORGANIZATION,PERSON-PERSON,PROPN-PROPN,PROPN-PROPN,compound-conj,compound-appos,NNP-NNP,NNP-NNP,6,1
7191,21991.0,34,told,11,8,3,-5,7,30,3,-8,Ali Akbar Salehi,representative,PERSON-PERSON-PERSON,TITLE,PROPN-PROPN-PROPN,NOUN,compound-compound-appos,nsubj,NNP-NNP-NNP,NN,3,1
7192,22008.0,20,has,14,1,17,16,0,2,13,3,Covidien,"42,000",ORGANIZATION,NUMBER,PROPN,NUM,nsubj,nummod,NNP,CD,3,1
7193,22017.0,36,accused,5,4,14,10,3,21,1,9,Flowers,extorting payments,PERSON,CRIMINAL_CHARGE-CRIMINAL_CHARGE,PROPN,VERB-NOUN,nsubjpass,pcomp-dobj,NNP,VBG-NNS,8,1
7194,22027.0,32,writing,2,25,30,5,24,1,-23,28,American Psychological Association,Gerald Koocher,ORGANIZATION-ORGANIZATION-ORGANIZATION,PERSON-PERSON,PROPN-PROPN-PROPN,PROPN-PROPN,compound-compound-pobj,compound-appos,NNP-NNP-NNP,NNP-NNP,4,1
7195,27116.0,29,said,12,9,1,-8,8,27,3,-11,American Psychological Association,Gerald Koocher,ORGANIZATION-ORGANIZATION-ORGANIZATION,PERSON-PERSON,PROPN-PROPN-PROPN,PROPN-PROPN,compound-compound-pobj,compound-nsubj,NNP-NNP-NNP,NNP-NNP,4,1
7196,59981.0,73,said,49,70,51,-19,69,21,-21,2,American Psychological Association,Gerald Koocher,ORGANIZATION-ORGANIZATION-ORGANIZATION,PERSON-PERSON,PROPN-PROPN-PROPN,PROPN-PROPN,compound-compound-pobj,compound-nsubj,NNP-NNP-NNP,NNP-NNP,6,1
7197,22041.0,12,considered,2,1,10,9,0,1,1,8,Dunn,Republican caucus,PERSON,ORGANIZATION-ORGANIZATION,PROPN,ADJ-NOUN,nsubjpass,amod-pobj,NNP,JJ-NN,4,1
7198,22057.0,47,died,32,1,12,11,0,34,31,-20,Jennifer Dunn,U.S.,PERSON-PERSON,COUNTRY,PROPN-PROPN,PROPN,compound-nsubj,compound,NNP-NNP,NNP,4,1
7199,22062.0,34,faces,11,9,2,-7,8,31,2,-9,Remy Smith,26-year-old,PERSON-PERSON,DURATION,PROPN-PROPN,NUM,compound-attr,nummod,NNP-NNP,CD,6,1
7200,22065.0,55,were,34,52,41,-11,51,13,-18,7,Golden Baseball League,Long Beach Armada,ORGANIZATION-ORGANIZATION-ORGANIZATION,ORGANIZATION-ORGANIZATION-ORGANIZATION,PROPN-PROPN-PROPN,PROPN-PROPN-PROPN,compound-compound-pobj,compound-compound-pobj,NNP-NNP-NNP,NNP-NNP-NNP,5,1
7201,22068.0,24,is,2,12,1,-11,11,22,-10,-1,Carnival Corporation,Costa Crociere,ORGANIZATION-ORGANIZATION,LOCATION-LOCATION,PROPN-PROPN,PROPN-PROPN,compound-pobj,compound-nsubj,NNP-NNP,NNP-NNP,7,1
7202,22088.0,33,is,6,2,12,10,1,20,4,6,Lewis Hamilton,UK,PERSON-PERSON,COUNTRY,PROPN-PROPN,PROPN,compound-poss,pobj,NNP-NNP,NNP,8,1
7203,22092.0,35,took,16,7,12,5,6,22,9,-4,Mr DeBlanc,lieutenant,PERSON-PERSON,TITLE,PROPN-PROPN,NOUN,compound-nsubj,appos,NNP-NNP,NN,2,1
7204,22096.0,26,said,17,19,23,4,18,2,-2,6,Mamoor Khan,area,PERSON-PERSON,COUNTRY,PROPN-PROPN,NOUN,compound-nsubj,compound,NNP-NNP,NN,2,1
7205,22101.0,67,taken,16,1,57,56,0,9,15,41,Retired Supreme Court,Stephen Breyer,ORGANIZATION-ORGANIZATION-ORGANIZATION,PERSON-PERSON,PROPN-PROPN-PROPN,PROPN-PROPN,compound-compound-compound,compound-appos,NNP-NNP-NNP,NNP-NNP,9,1
7206,22110.0,36,declined,10,3,1,-2,2,34,7,-9,Manuel Barcena,Senior Superintendent,PERSON-PERSON,TITLE-TITLE,PROPN-PROPN,ADJ-PROPN,compound-nsubj,compound-compound,NNP-NNP,JJ-NNP,1,1
7207,22132.0,45,reported,39,1,3,2,0,41,38,-36,Pentax,Fumio Urano,ORGANIZATION,PERSON-PERSON,ADJ,PROPN-PROPN,amod,compound-nsubj,JJ,NNP-NNP,1,1
7208,32106.0,25,announced,2,1,6,5,0,18,1,4,Pentax,Fumio Urano,ORGANIZATION,PERSON-PERSON,PROPN,PROPN-PROPN,nsubj,compound-appos,NNP,NNP-NNP,4,1
7209,22150.0,35,appealed,12,2,15,13,1,19,10,3,Manila Economic and Cultural Office,Taiwan,ORGANIZATION-ORGANIZATION-ORGANIZATION-ORGANIZATION-ORGANIZATION,COUNTRY,PROPN-PROPN-CCONJ-PROPN-PROPN,PROPN,nmod-nmod-cc-conj-compound,nmod,NNP-NNP-CC-NNP-NNP,NNP,-1,1
7210,38826.0,32,referred,22,2,14,12,1,17,20,-8,Manila Economic and Cultural Office,Taiwan,ORGANIZATION-ORGANIZATION-ORGANIZATION-ORGANIZATION-ORGANIZATION,STATE_OR_PROVINCE,PROPN-PROPN-CCONJ-PROPN-PROPN,PROPN,nmod-nmod-cc-conj-nsubj,pobj,NNP-NNP-CC-NNP-NNP,NNP,3,1
7211,22165.0,29,Ahearn,1,1,7,6,0,21,0,6,Pamela Ahearn,Protocol Chief,PERSON-PERSON,TITLE-TITLE,PROPN-PROPN,PROPN-PROPN,compound-ROOT,compound-appos,NNP-NNP,NNP-NNP,1,1
7212,22170.0,32,granted,12,2,1,-1,1,30,10,-11,Hussein Kamel Hassan,General,PERSON-PERSON-PERSON,TITLE,PROPN-PROPN-PROPN,PROPN,compound-compound-nsubjpass,compound,NNP-NNP-NNP,NNP,2,1
7213,22174.0,38,------,0,12,10,-2,11,27,-12,10,Carolyn Maloney,Vice Chair,PERSON-PERSON,TITLE-TITLE,PROPN-PROPN,PROPN-PROPN,compound-pobj,compound-compound,NNP-NNP,NNP-NNP,1,1
7214,22176.0,48,said,35,2,2,0,1,45,33,-33,USA Network,USA,ORGANIZATION-ORGANIZATION,COUNTRY,PROPN-PROPN,PROPN,compound-nsubj,poss,NNP-NNP,NNP,0,1
7215,22184.0,41,sparked,23,18,15,-3,17,25,5,-8,Focus on the Family,Colorado-based,ORGANIZATION-ORGANIZATION-ORGANIZATION-ORGANIZATION,STATE_OR_PROVINCE,PROPN-ADP-DET-PROPN,ADJ,appos-prep-det-pobj,amod,NNP-IN-DT-NNP,JJ,3,1
7216,22197.0,39,stands,11,22,36,14,21,2,-11,25,Covidien,"43,000",ORGANIZATION,NUMBER,PROPN,NUM,ROOT,nummod,NNP,CD,-1,1
7217,22212.0,29,said,19,12,21,9,11,7,7,2,Carnival,Howard Frank,ORGANIZATION,PERSON-PERSON,PROPN,PROPN-PROPN,nsubj,compound-nsubj,NNP,NNP-NNP,3,1
7218,28454.0,30,said,17,22,19,-3,21,10,-5,2,Carnival,Howard Frank,ORGANIZATION,PERSON-PERSON,PROPN,PROPN-PROPN,poss,compound-nsubj,NNP,NNP-NNP,3,1
7219,49938.0,42,said,32,1,34,33,0,7,31,2,Carnival,Howard Frank,ORGANIZATION,PERSON-PERSON,ADJ,PROPN-PROPN,compound,compound-nsubj,JJ,NNP-NNP,4,1
7220,22215.0,42,dished,1,28,26,-2,27,15,-27,25,Kelly Cutrone,PR queen,PERSON-PERSON,TITLE-TITLE,PROPN-PROPN,PROPN-NOUN,compound-conj,compound-compound,NNP-NNP,NNP-NN,1,1
7221,22241.0,23,was,9,1,6,5,0,16,8,-3,Parren Mitchell,Juanita Jackson Mitchell,PERSON-PERSON,PERSON-PERSON-PERSON,PROPN-PROPN,PROPN-PROPN-PROPN,compound-poss,compound-compound-appos,NNP-NNP,NNP-NNP-NNP,3,1
7222,22246.0,36,said,34,33,30,-3,32,5,1,-4,Robert Morgenthau,Manhattan district attorney,PERSON-PERSON,TITLE-TITLE-TITLE,PROPN-PROPN,PROPN-NOUN-NOUN,compound-nsubj,compound-compound-compound,NNP-NNP,NNP-NN-NN,2,1
7223,22255.0,33,splitting,3,2,2,0,1,30,1,-1,Tyco Healthcare,Tyco,ORGANIZATION-ORGANIZATION,ORGANIZATION,PROPN-PROPN,PROPN,compound-pobj,nsubj,NNP-NNP,NNP,0,1
7224,47290.0,58,splitting,15,2,2,0,1,55,13,-13,Tyco Healthcare,Tyco,ORGANIZATION-ORGANIZATION,ORGANIZATION,PROPN-PROPN,PROPN,compound-appos,nsubj,NNP-NNP,NNP,0,1
7225,22291.0,22,served,2,1,5,4,0,16,1,3,Huber,deputy leader,PERSON,TITLE-TITLE,PROPN,NOUN-NOUN,nsubj,compound-pobj,NNP,NN-NN,3,1
7226,23190.0,22,served,2,1,5,4,0,16,1,3,Huber,deputy leader,PERSON,TITLE-TITLE,PROPN,NOUN-NOUN,nsubj,compound-pobj,NNP,NN-NN,3,1
7227,54930.0,35,served,2,1,5,4,0,29,1,3,Huber,deputy leader,PERSON,TITLE-TITLE,PROPN,NOUN-NOUN,nsubj,compound-pobj,NNP,NN-NN,3,1
7228,22296.0,51,held,10,2,7,5,1,43,8,-3,International Crisis Group,Washington-based,ORGANIZATION-ORGANIZATION-ORGANIZATION,STATE_OR_PROVINCE,PROPN-PROPN-PROPN,ADJ,compound-compound-nsubj,amod,NNP-NNP-NNP,JJ,4,1
7229,22303.0,20,named,8,4,3,-1,3,16,4,-5,Ciro Ferrara,coach,PERSON-PERSON,TITLE,PROPN-PROPN,NOUN,compound-nsubj,compound,NNP-NNP,NN,1,1
7230,23961.0,38,retained,5,3,2,-1,2,35,2,-3,Ciro Ferrara,coach,PERSON-PERSON,TITLE,PROPN-PROPN,NOUN,compound-nsubj,compound,NNP-NNP,NN,1,1
7231,33382.0,15,hired,3,7,10,3,6,4,-4,7,Ciro Ferrara,coach,PERSON-PERSON,TITLE,PROPN-PROPN,NOUN,compound-dobj,pobj,NNP-NNP,NN,4,1
7232,33999.0,26,Juventus,0,14,10,-4,13,15,-14,10,Ciro Ferrara,coach,PERSON-PERSON,TITLE,PROPN-PROPN,NOUN,compound-pobj,pobj,NNP-NNP,NN,3,1
7233,67192.0,22,insisted,4,3,2,-1,2,19,1,-2,Ciro Ferrara,coach,PERSON-PERSON,TITLE,PROPN-PROPN,NOUN,compound-nsubj,compound,NNP-NNP,NN,1,1
7234,22307.0,43,was,5,4,2,-2,3,40,1,-3,JEM,Muslim fundamentalist,ORGANIZATION,RELIGION-RELIGION,PROPN,PROPN-ADJ,compound,amod-amod,NNP,NNP-JJ,1,1
7235,22311.0,45,struggling,32,13,41,28,12,3,19,9,Detroit Medical Center,DMC,ORGANIZATION-ORGANIZATION-ORGANIZATION,ORGANIZATION,PROPN-PROPN-PROPN,PROPN,compound-compound-pobj,poss,NNP-NNP-NNP,NNP,13,1
7236,22343.0,19,Irvine,0,4,3,-1,3,15,-4,3,Option One Mortgage,Calif-based,ORGANIZATION-ORGANIZATION-ORGANIZATION,STATE_OR_PROVINCE,PROPN-PROPN-PROPN,PROPN,conj-nummod-nsubj,amod,NNP-NNP-NNP,NNP,1,1
7237,22348.0,33,offered,3,24,9,-15,23,23,-21,6,APA,Raymond Fowler,ORGANIZATION,PERSON-PERSON,PROPN,PROPN-PROPN,compound,compound-pobj,NNP,NNP-NNP,-1,1
7238,22357.0,32,said,15,13,9,-4,12,22,2,-6,R Nicholas Burns,Assistant Secretary of State,PERSON-PERSON-PERSON,TITLE-TITLE-TITLE-TITLE,PROPN-PROPN-PROPN,PROPN-PROPN-ADP-PROPN,compound-compound-nsubj,nmod-nmod-prep-pobj,NNP-NNP-NNP,NNP-NNP-IN-NNP,3,1
7239,22365.0,38,created,8,16,21,5,15,16,-8,13,Barry Goldwater,senator,PERSON-PERSON,TITLE,PROPN-PROPN,NOUN,compound-pobj,poss,NNP-NNP,NN,3,1
7240,47856.0,46,said,27,12,11,-1,11,34,15,-16,Barry Goldwater,senator,PERSON-PERSON,TITLE,PROPN-PROPN,NOUN,compound-appos,pobj,NNP-NNP,NN,1,1
7241,22384.0,15,is,11,9,6,-3,8,8,2,-5,Bill McAllister,communications director,PERSON-PERSON,TITLE-TITLE,PROPN-PROPN,NOUN-NOUN,compound-appos,compound-nsubj,NNP-NNP,NNS-NN,1,1
7242,46681.0,14,is,10,8,5,-3,7,8,2,-5,Bill McAllister,communications director,PERSON-PERSON,TITLE-TITLE,PROPN-PROPN,NOUN-NOUN,compound-appos,compound-nsubj,NNP-NNP,NNS-NN,1,1
7243,22390.0,29,agreed,3,1,1,0,0,27,2,-2,Pentax Corp.,Pentax,ORGANIZATION-ORGANIZATION,ORGANIZATION,PROPN-PROPN,PROPN,compound-nsubj,compound,NNP-NNP,NNP,0,1
7244,33770.0,38,said,1,9,9,0,8,28,-8,8,Pentax Corp.,Pentax,ORGANIZATION-ORGANIZATION,ORGANIZATION,PROPN-PROPN,PROPN,compound-pobj,nsubj,NNP-NNP,NNP,0,1
7245,22392.0,41,died,33,1,10,9,0,30,32,-23,Jefferson J. DeBlanc,pilot,PERSON-PERSON-PERSON,TITLE,PROPN-PROPN-PROPN,NOUN,compound-compound-nsubj,appos,NNP-NNP-NNP,NN,4,1
7246,22393.0,37,groups,4,24,27,3,23,9,-20,23,MNLF,Salamat Hashim,ORGANIZATION,PERSON-PERSON,PROPN,PROPN-PROPN,compound,compound-pobj,NNP,NNP-NNP,2,1
7247,22401.0,28,said,22,2,21,19,1,6,20,-1,We,Massood Ahmed,ORGANIZATION,PERSON-PERSON,PRON,PROPN-PROPN,nsubj,compound-nsubj,PRP,NNP-NNP,3,1
7248,22403.0,36,invited,10,22,19,-3,21,16,-12,9,Northland Church,Joel Hunter,ORGANIZATION-ORGANIZATION,PERSON-PERSON,PROPN-PROPN,PROPN-PROPN,compound-pobj,compound-appos,NNP-NNP,NNP-NNP,2,1
7249,37941.0,28,said,10,18,14,-4,17,13,-8,4,Northland Church,Joel Hunter,ORGANIZATION-ORGANIZATION,PERSON-PERSON,PROPN-PROPN,PROPN-PROPN,compound-pobj,compound-nsubj,NNP-NNP,NNP-NNP,2,1
7250,51327.0,61,said,52,46,39,-7,45,21,6,-13,Northland Church,Joel Hunter,ORGANIZATION-ORGANIZATION,PERSON-PERSON,PROPN-PROPN,PROPN-PROPN,compound-pobj,compound-nsubj,NNP-NNP,NNP-NNP,6,1
7251,59634.0,52,said,22,16,11,-5,15,40,6,-11,Northland Church,Joel Hunter,ORGANIZATION-ORGANIZATION,PERSON-PERSON,PROPN-PROPN,PROPN-PROPN,compound-pobj,compound-appos,NNP-NNP,NNP-NNP,3,1
7252,64226.0,32,told,13,7,1,-6,6,30,6,-12,Northland Church,Joel Hunter,ORGANIZATION-ORGANIZATION,PERSON-PERSON,PROPN-PROPN,PROPN-PROPN,compound-pobj,compound-nsubj,NNP-NNP,NNP-NNP,3,1
7253,22408.0,14,was,1,1,3,2,0,10,0,2,He,79,PERSON,NUMBER,PRON,NUM,nsubj,attr,PRP,CD,1,1
7254,28799.0,14,was,1,1,3,2,0,10,0,2,He,79,PERSON,NUMBER,PRON,NUM,nsubj,attr,PRP,CD,1,1
7255,22415.0,27,sees,3,2,14,12,1,12,1,11,Sox,Beckett,ORGANIZATION,PERSON,PROPN,PROPN,compound,nsubj,NNPS,NNP,6,1
7256,22416.0,80,recognizes,3,18,50,32,17,29,-15,47,Chelsea Library,Michigan,ORGANIZATION-ORGANIZATION,STATE_OR_PROVINCE,PROPN-PROPN,PROPN,compound-pobj,compound,NNP-NNP,NNP,-1,1
7257,22422.0,35,use,18,17,9,-8,16,25,1,-9,Covidien,Bristol-Myers Squibb,ORGANIZATION,ORGANIZATION-ORGANIZATION,PROPN,PROPN-PROPN,pobj,compound-pobj,NNP,NNPS-NNP,3,1
7258,22424.0,25,won,2,1,12,11,0,12,1,10,He,Washington,PERSON,STATE_OR_PROVINCE,PRON,PROPN,nsubj,pobj,PRP,NNP,5,1
7259,22435.0,22,jumped,3,1,19,18,0,2,2,16,FirstGroup,London Stock Exchange,ORGANIZATION,ORGANIZATION-ORGANIZATION-ORGANIZATION,PROPN,PROPN-PROPN-PROPN,poss,compound-compound-pobj,NNP,NNP-NNP-NNP,7,1
7260,22438.0,38,allowed,28,17,24,7,16,13,11,-4,Federal Motor Carrier Safety Administration,Department of Transportation,ORGANIZATION-ORGANIZATION-ORGANIZATION-ORGANIZATION-ORGANIZATION,ORGANIZATION-ORGANIZATION-ORGANIZATION,PROPN-PROPN-PROPN-PROPN-PROPN,PROPN-ADP-PROPN,compound-compound-compound-compound-pobj,pobj-prep-pobj,NNP-NNP-NNP-NNP-NNP,NNP-IN-NNP,6,1
7261,22441.0,31,benefit,6,14,11,-3,13,19,-8,5,Safe Passage,Guatemala City,ORGANIZATION-ORGANIZATION,CITY-CITY,PROPN-PROPN,PROPN-PROPN,compound-compound,compound-poss,NNP-NNP,NNP-NNP,2,1
7262,22447.0,40,wrote,5,12,3,-9,11,36,-7,-2,Abu Zubaida,director,PERSON-PERSON,TITLE,PROPN-PROPN,NOUN,compound-nsubjpass,compound,NNP-NNP,NN,5,1
7263,22465.0,17,is,5,1,8,7,0,8,4,3,Trista Sutter,designer,PERSON-PERSON,TITLE,PROPN-PROPN,NOUN,compound-nsubj,attr,NNP-NNP,NN,3,1
7264,22478.0,18,said,12,14,16,2,13,1,-2,4,committee,Ma Zongjin,ORGANIZATION,PERSON-PERSON,NOUN,PROPN-PROPN,compound,compound-nsubj,NN,NNP-NNP,1,1
7265,22482.0,27,said,21,11,26,15,10,0,10,5,our,Brian J,ORGANIZATION,PERSON-PERSON,DET,PROPN-PROPN,poss,compound-nsubj,PRP$,NNP-NNP,5,1
7266,22488.0,21,held,5,13,19,6,12,1,-8,14,Saint Anselm College,New Hampshire,ORGANIZATION-ORGANIZATION-ORGANIZATION,STATE_OR_PROVINCE-STATE_OR_PROVINCE,PROPN-PROPN-PROPN,PROPN-PROPN,compound-compound-pobj,compound-appos,NNP-NNP-NNP,NNP-NNP,2,1
7267,61311.0,37,found,15,13,9,-4,12,27,2,-6,Saint Anselm College,New Hampshire,ORGANIZATION-ORGANIZATION-ORGANIZATION,STATE_OR_PROVINCE-STATE_OR_PROVINCE,PROPN-PROPN-PROPN,PROPN-PROPN,compound-compound-pobj,compound-compound,NNP-NNP-NNP,NNP-NNP,6,1
7268,61943.0,26,graduated,1,12,16,4,11,9,-11,15,Saint Anselm College,New Hampshire,ORGANIZATION-ORGANIZATION-ORGANIZATION,STATE_OR_PROVINCE-STATE_OR_PROVINCE,PROPN-PROPN-PROPN,PROPN-PROPN,compound-compound-pobj,compound-pobj,NNP-NNP-NNP,NNP-NNP,3,1
7269,22509.0,31,involved,14,13,3,-10,12,27,1,-11,Itochu,1858,ORGANIZATION,DATE,PROPN,NUM,nsubjpass,pobj,NNP,CD,3,1
7270,22510.0,17,said,6,10,12,2,9,4,-4,6,KGB,Yuri Zhadobin,ORGANIZATION,PERSON-PERSON,PROPN,PROPN-PROPN,compound,compound-nsubjpass,NNP,NNP-NNP,1,1
7271,22511.0,8,bought,3,3,1,-2,2,6,0,-2,Alcatel,France,ORGANIZATION,COUNTRY,PROPN,PROPN,nsubj,poss,NNP,NNP,3,1
7272,60839.0,27,presented,4,9,7,-2,8,19,-5,3,Alcatel,France,ORGANIZATION,COUNTRY,PROPN,PROPN,nmod,poss,NNP,NNP,4,1
7273,22520.0,53,said,28,28,25,-3,27,27,0,-3,Maloney,president,PERSON,TITLE,PROPN,NOUN,nsubj,pobj,NNP,NN,8,1
7274,22523.0,48,died,36,1,38,37,0,9,35,2,Vernon Bellecourt,Oct 13,PERSON-PERSON,DATE-DATE,PROPN-PROPN,PROPN-NUM,compound-nsubj,dobj-nummod,NNP-NNP,NNP-CD,3,1
7275,32682.0,34,died,28,1,30,29,0,3,27,2,Vernon Bellecourt,Oct 13,PERSON-PERSON,DATE-DATE,PROPN-PROPN,PROPN-NUM,compound-nsubj,dobj-nummod,NNP-NNP,NNP-CD,3,1
7276,22530.0,44,HAVANA,0,14,7,-7,13,36,-14,7,Raul Castro,Vilma Espin,PERSON-PERSON,PERSON-PERSON,PROPN-PROPN,PROPN-PROPN,compound-poss,compound-ROOT,NNP-NNP,NNP-NNP,4,1
7277,48335.0,23,HAVANA,0,16,9,-7,15,13,-16,9,Raul Castro,Vilma Espin,PERSON-PERSON,PERSON-PERSON,PROPN-PROPN,PROPN-PROPN,compound-pobj,compound-dobj,NNP-NNP,NNP-NNP,4,1
7278,22531.0,54,According,0,42,27,-15,41,26,-42,27,Lashkar-e-Taiba,Osama bin Laden,ORGANIZATION,PERSON-PERSON-PERSON,PROPN,PROPN-PROPN-PROPN,dobj,compound-compound-conj,NNP,NNP-NNP-NNP,11,1
7279,22539.0,44,said,26,36,28,-8,35,15,-10,2,International Crisis Group,Mark Schneider,ORGANIZATION-ORGANIZATION-ORGANIZATION,PERSON-PERSON,PROPN-PROPN-PROPN,PROPN-PROPN,compound-compound-pobj,compound-nsubj,NNP-NNP-NNP,NNP-NNP,5,1
7280,56893.0,37,said,14,16,21,5,15,15,-2,7,International Crisis Group,Mark Schneider,ORGANIZATION-ORGANIZATION-ORGANIZATION,PERSON-PERSON,PROPN-PROPN-PROPN,PROPN-PROPN,compound-compound-compound,compound-nsubj,NNP-NNP-NNP,NNP-NNP,4,1
7281,22541.0,18,died,1,4,11,7,3,6,-3,10,her,Wednesday,PERSON,DATE,DET,PROPN,poss,npadvmod,PRP$,NNP,3,1
7282,22543.0,36,YORK,1,9,7,-2,8,28,-8,6,company,New York-based,ORGANIZATION,STATE_OR_PROVINCE-STATE_OR_PROVINCE,NOUN,PROPN-ADJ,nsubj,compound-compound,NN,NNP-JJ,4,1
7283,62108.0,33,said,4,4,2,-2,3,30,0,-2,company,New York-based,ORGANIZATION,STATE_OR_PROVINCE-STATE_OR_PROVINCE,NOUN,PROPN-ADJ,nsubj,compound-compound,NN,NNP-JJ,1,1
7284,22550.0,36,said,14,10,1,-9,9,34,4,-13,International Monetary Fund,Fischer,ORGANIZATION-ORGANIZATION-ORGANIZATION,PERSON,PROPN-PROPN-PROPN,PROPN,compound-compound-compound,nsubj,NNP-NNP-NNP,NNP,4,1
7285,22551.0,45,2007-10-15T18,0,9,9,0,8,35,-9,9,Focus on the Family,Focus on the Family,ORGANIZATION-ORGANIZATION-ORGANIZATION-ORGANIZATION,ORGANIZATION-ORGANIZATION-ORGANIZATION-ORGANIZATION,PROPN-ADP-DET-PROPN,PROPN-ADP-DET-PROPN,pobj-prep-det-pobj,pobj-prep-det-pobj,NNP-IN-DT-NNP,NNP-IN-DT-NNP,0,1
7286,22552.0,23,mentioned,13,10,16,6,9,6,3,3,ABA,Skinner,ORGANIZATION,PERSON,NOUN,PROPN,compound,nsubj,NN,NNP,6,1
7287,22560.0,9,died,5,1,4,3,0,4,4,-1,His,Louise,PERSON,PERSON,DET,PROPN,poss,appos,PRP$,NNP,2,1
7288,22563.0,37,obtained,1,1,11,10,0,25,0,10,He,Shanghai Second Medical University,PERSON,ORGANIZATION-ORGANIZATION-ORGANIZATION-ORGANIZATION,PRON,PROPN-PROPN-PROPN-PROPN,nsubj,compound-compound-compound-pobj,PRP,NNP-NNP-NNP-NNP,3,1
7289,22571.0,60,survived,2,1,11,10,0,48,1,9,He,Josephine Robinson McNair,PERSON,PERSON-PERSON-PERSON,PRON,PROPN-PROPN-PROPN,nsubjpass,compound-compound-appos,PRP,NNP-NNP-NNP,4,1
7290,22575.0,37,was,12,12,14,2,11,22,0,2,Gregory,MSNBC,PERSON,ORGANIZATION,PROPN,PROPN,nsubj,poss,NNP,NNP,3,1
7291,22584.0,21,-LRB-,2,1,4,3,0,16,1,2,Paul Kim,25,PERSON-PERSON,NUMBER,PROPN-PROPN,NUM,compound-compound,nummod,NNP-NNP,CD,1,1
7292,22598.0,22,said,9,11,20,9,10,1,-2,11,Bob Dillinger,Pasco,PERSON-PERSON,CITY,PROPN-PROPN,PROPN,compound-nsubj,conj,NNP-NNP,NNP,5,1
7293,22601.0,23,born,2,1,4,3,0,18,1,2,Ahearn,"Oct. 7 , 1954",PERSON,DATE-DATE-DATE-DATE,PROPN,PROPN-NUM-PUNCT-NUM,nsubjpass,npadvmod-nummod-punct-nummod,NNP,"NNP-CD-,-CD",3,1
7294,22606.0,28,said,12,8,1,-7,7,26,4,-11,Inter American Press Association,Rafael Molina,ORGANIZATION-ORGANIZATION-ORGANIZATION-ORGANIZATION,PERSON-PERSON,PROPN-PROPN-PROPN-PROPN,PROPN-PROPN,compound-compound-compound-pobj,compound-nsubj,NNP-NNP-NNP-NNP,NNP-NNP,4,1
7295,26102.0,28,said,12,8,1,-7,7,26,4,-11,Inter American Press Association,Rafael Molina,ORGANIZATION-ORGANIZATION-ORGANIZATION-ORGANIZATION,PERSON-PERSON,PROPN-PROPN-PROPN-PROPN,PROPN-PROPN,compound-compound-compound-pobj,compound-nsubj,NNP-NNP-NNP-NNP,NNP-NNP,4,1
7296,63494.0,34,said,12,8,1,-7,7,32,4,-11,Inter American Press Association,Rafael Molina,ORGANIZATION-ORGANIZATION-ORGANIZATION-ORGANIZATION,PERSON-PERSON,PROPN-PROPN-PROPN-PROPN,PROPN-PROPN,compound-compound-compound-pobj,compound-nsubj,NNP-NNP-NNP-NNP,NNP-NNP,4,1
7297,22609.0,66,comes,2,47,51,4,46,14,-45,49,Donald Wildmon,Methodist,PERSON-PERSON,RELIGION,PROPN-PROPN,ADJ,compound-pobj,compound,NNP-NNP,JJ,1,1
7298,22616.0,15,has,3,1,6,5,0,8,2,3,The Red Cross,"33,000",ORGANIZATION-ORGANIZATION-ORGANIZATION,NUMBER,DET-PROPN-PROPN,NUM,det-compound-nsubj,nummod,DT-NNP-NNP,CD,4,1
7299,22620.0,35,said,21,32,23,-9,31,11,-11,2,International Crisis Group,Rinaldo Depagne,ORGANIZATION-ORGANIZATION-ORGANIZATION,PERSON-PERSON,PROPN-PROPN-PROPN,PROPN-PROPN,compound-compound-pobj,compound-nsubj,NNP-NNP-NNP,NNP-NNP,4,1
7300,22623.0,35,said,31,1,6,5,0,28,30,-25,Alcatel-Lucent,Verwaayen,ORGANIZATION,PERSON,ADJ,PROPN,amod,compound,JJ,NNP,4,1
7301,22631.0,54,said,34,43,47,4,42,6,-9,13,Crown Prosecution Service,West and North Yorkshire Complex Case unit,ORGANIZATION-ORGANIZATION-ORGANIZATION,ORGANIZATION-ORGANIZATION-ORGANIZATION-ORGANIZATION-ORGANIZATION-ORGANIZATION-ORGANIZATION,PROPN-PROPN-PROPN,PROPN-CCONJ-PROPN-PROPN-PROPN-PROPN-NOUN,compound-compound-poss,nmod-cc-compound-compound-compound-compound-pobj,NNP-NNP-NNP,NNP-CC-NNP-NNP-NNP-NNP-NN,2,1
7302,22645.0,46,Council,2,5,8,3,4,37,-3,6,MAC,Lai Shin-yuan,ORGANIZATION,PERSON-PERSON,PROPN,PROPN-NOUN,compound,compound-nsubj,NNP,NNP-NN,-1,1
7303,22656.0,20,*,0,18,16,-2,17,3,-18,16,Barry Goldwater,Arizona,PERSON-PERSON,STATE_OR_PROVINCE,PROPN-PROPN,PROPN,compound-pobj,compound,NNP-NNP,NNP,1,1
7304,25844.0,39,was,14,2,7,5,1,31,12,-7,Barry Goldwater,Arizona,PERSON-PERSON,STATE_OR_PROVINCE,PROPN-PROPN,PROPN,compound-nsubjpass,pobj,NNP-NNP,NNP,4,1
7305,27179.0,33,quoted,10,16,19,3,15,13,-6,9,Barry Goldwater,Arizona,PERSON-PERSON,STATE_OR_PROVINCE,PROPN-PROPN,PROPN,compound-dobj,pobj,NNP-NNP,NNP,2,1
7306,30489.0,34,wrapped,2,30,28,-2,29,5,-28,26,Barry Goldwater,Arizona,PERSON-PERSON,STATE_OR_PROVINCE,PROPN-PROPN,PROPN,compound-pobj,compound,NNP-NNP,NNP,1,1
7307,60666.0,28,insists,2,20,18,-2,19,9,-18,16,Barry Goldwater,Arizona,PERSON-PERSON,STATE_OR_PROVINCE,PROPN-PROPN,PROPN,compound-appos,pobj,NNP-NNP,NNP,2,1
7308,22675.0,73,survived,9,2,55,53,1,17,7,46,his,Mimi Krebs,PERSON,PERSON-PERSON,DET,PROPN-PROPN,poss,compound-conj,PRP$,NNP-NNP,7,1
7309,57884.0,73,survived,9,2,55,53,1,17,7,46,his,Mimi Krebs,PERSON,PERSON-PERSON,DET,PROPN-PROPN,poss,compound-conj,PRP$,NNP-NNP,7,1
7310,22682.0,25,formed,1,7,10,3,6,14,-6,9,Babyshambles,2005,PERSON,DATE,PROPN,NUM,appos,pobj,NNP,CD,2,1
7311,22695.0,29,was,1,26,1,-25,25,27,-25,0,American Bar Association,He,ORGANIZATION-ORGANIZATION-ORGANIZATION,PERSON,PROPN-PROPN-PROPN,PRON,compound-compound-pobj,nsubj,NNP-NNP-NNP,PRP,9,1
7312,33884.0,31,was,1,12,1,-11,11,29,-11,0,American Bar Association,He,ORGANIZATION-ORGANIZATION-ORGANIZATION,PERSON,PROPN-PROPN-PROPN,PRON,compound-compound-pobj,nsubj,NNP-NNP-NNP,PRP,4,1
7313,22705.0,16,said,14,1,10,9,0,5,13,-4,Anderson,brief illness,PERSON,CAUSE_OF_DEATH-CAUSE_OF_DEATH,PROPN,ADJ-NOUN,nsubj,amod-pobj,NNP,JJ-NN,2,1
7314,22707.0,17,died,13,1,6,5,0,10,12,-7,Hawkins,Pegga Adeline Smith,PERSON,PERSON-PERSON-PERSON,PROPN,PROPN-PROPN-PROPN,poss,compound-compound-appos,NNP,NNP-NNP-NNP,4,1
7315,22723.0,31,called,10,7,1,-6,6,29,3,-9,Mohamed ElBaradei,Egypt,PERSON-PERSON,COUNTRY,PROPN-PROPN,PROPN,compound-appos,poss,NNP-NNP,NNP,3,1
7316,22732.0,28,acquires,1,6,1,-5,5,26,-5,0,Illinois Tool Works,ITW,ORGANIZATION-ORGANIZATION-ORGANIZATION,ORGANIZATION,PROPN-PROPN-PROPN,PROPN,compound-compound-compound,compound,NNP-NNP-NNP,NNP,2,1
7317,22736.0,33,YORK,1,6,8,2,5,24,-5,7,CANA,http://wwwcanaconvocationorg/,ORGANIZATION,URL,NOUN,VERB,ROOT,ROOT,NNS,VB,3,1
7318,22738.0,18,said,11,13,17,4,12,0,-2,6,Bentley,spokesman,PERSON,TITLE,PROPN,NOUN,nsubj,appos,NNP,NN,1,1
7319,22744.0,41,died,34,1,38,37,0,2,33,4,Irene Morgan Kirkaldy,Hayes,PERSON-PERSON-PERSON,LOCATION,PROPN-PROPN-PROPN,PROPN,compound-compound-nsubj,pobj,NNP-NNP-NNP,NNP,5,1
7320,63824.0,41,died,34,1,38,37,0,2,33,4,Irene Morgan Kirkaldy,Hayes,PERSON-PERSON-PERSON,CITY,PROPN-PROPN-PROPN,PROPN,compound-compound-nsubj,pobj,NNP-NNP-NNP,NNP,5,1
7321,22747.0,22,began,8,8,2,-6,7,19,0,-6,Sheldon,Wildwood,PERSON,CITY,PROPN,PROPN,nsubj,nmod,NNP,NNP,3,1
7322,22756.0,48,is,1,6,14,8,5,33,-5,13,Huber,tool-maker,PERSON,TITLE,PROPN,NOUN,pobj,pobj,NNP,NN,5,1
7323,39125.0,48,is,1,6,14,8,5,33,-5,13,Huber,tool-maker,PERSON,TITLE,PROPN,NOUN,pobj,pobj,NNP,NN,5,1
7324,22763.0,20,said,9,1,5,4,0,14,8,-4,Cathleen P Black,president,PERSON-PERSON-PERSON,TITLE,PROPN-PROPN-PROPN,NOUN,compound-compound-nsubj,appos,NNP-NNP-NNP,NN,3,1
7325,28304.0,46,said,22,4,8,4,3,37,18,-14,Cathleen P Black,president,PERSON-PERSON-PERSON,TITLE,PROPN-PROPN-PROPN,NOUN,compound-compound-pobj,appos,NNP-NNP-NNP,NN,3,1
7326,39198.0,20,report,4,7,11,4,6,8,-3,7,Cathleen P Black,president,PERSON-PERSON-PERSON,TITLE,PROPN-PROPN-PROPN,NOUN,compound-compound-pobj,appos,NNP-NNP-NNP,NN,3,1
7327,41045.0,66,purchased,9,55,59,4,54,6,-46,50,Cathleen P Black,president,PERSON-PERSON-PERSON,TITLE,PROPN-PROPN-PROPN,NOUN,compound-compound-appos,appos,NNP-NNP-NNP,NN,7,1
7328,46143.0,22,made,3,6,10,4,5,11,-3,7,Cathleen P Black,president,PERSON-PERSON-PERSON,TITLE,PROPN-PROPN-PROPN,NOUN,compound-compound-pobj,appos,NNP-NNP-NNP,NN,3,1
7329,57433.0,22,said,11,13,18,5,12,3,-2,7,Cathleen P Black,president,PERSON-PERSON-PERSON,TITLE,PROPN-PROPN-PROPN,NOUN,compound-compound-nsubj,appos,NNP-NNP-NNP,NN,3,1
7330,22772.0,21,include,1,3,6,3,2,14,-2,5,his,Mary Russell Flowers,PERSON,PERSON-PERSON-PERSON,DET,PROPN-PROPN-PROPN,poss,compound-compound-appos,PRP$,NNP-NNP-NNP,2,1
7331,22797.0,48,makes,7,5,7,2,4,40,2,0,Arsenal,Hill-Wood,ORGANIZATION,PERSON,PROPN,NOUN,compound,nsubj,NNP,NN,6,1
7332,22817.0,31,shows,6,2,11,9,1,19,4,5,Islamic Hope,California,ORGANIZATION-ORGANIZATION,STATE_OR_PROVINCE,PROPN-PROPN,PROPN,compound-poss,compound,NNP-NNP,NNP,6,1
7333,22821.0,28,serving,6,1,25,24,0,2,5,19,Raul Castro,Council of State,PERSON-PERSON,ORGANIZATION-ORGANIZATION-ORGANIZATION,PROPN-PROPN,PROPN-ADP-PROPN,compound-nsubj,dobj-prep-pobj,NNP-NNP,NNP-IN-NNP,5,1
7334,29772.0,34,HAVANA,0,8,16,8,7,17,-8,16,Raul Castro,Council of State,PERSON-PERSON,ORGANIZATION-ORGANIZATION-ORGANIZATION,PROPN-PROPN,PROPN-ADP-PROPN,compound-nsubj,pobj-prep-pobj,NNP-NNP,NNP-IN-NNP,4,1
7335,22826.0,34,based,15,1,10,9,0,23,14,-5,Zagat Survey LLC,28 years ago,ORGANIZATION-ORGANIZATION-ORGANIZATION,DATE-DATE-DATE,PROPN-PROPN-PROPN,NUM-NOUN-ADV,compound-compound-nsubj,nummod-npadvmod-advmod,NNP-NNP-NNP,CD-NNS-RB,4,1
7336,22830.0,30,commented,12,15,23,8,14,6,-3,11,Mahmood Shah,Federally Administered Tribal Areas,PERSON-PERSON,ORGANIZATION-ORGANIZATION-ORGANIZATION-ORGANIZATION,PROPN-PROPN,PROPN-PROPN-PROPN-PROPN,compound-nsubj,compound-compound-compound-pobj,NNP-NNP,NNP-NNP-NNP-NNPS,6,1
7337,22832.0,27,approved,8,25,22,-3,24,4,-17,14,Richard Perle,Hollinger,PERSON-PERSON,ORGANIZATION,PROPN-PROPN,PROPN,compound-appos,compound,NNP-NNP,NNP,1,1
7338,22833.0,38,are,9,4,23,19,3,14,5,14,the club,David Dein,ORGANIZATION-ORGANIZATION,PERSON-PERSON,DET-NOUN,PROPN-PROPN,det-poss,compound-conj,DT-NN,NNP-NNP,4,1
7339,22836.0,45,include,1,28,23,-5,27,21,-27,22,Gilbert Gude,Adrienne Lewis,PERSON-PERSON,PERSON-PERSON,PROPN-PROPN,PROPN-PROPN,compound-compound,compound-conj,NNP-NNP,NNP-NNP,4,1
7340,22837.0,65,survived,2,18,12,-6,17,52,-16,10,Sherwood Morgan Jr.,Hayes,PERSON-PERSON-PERSON,PERSON,PROPN-PROPN-PROPN,PROPN,compound-compound-appos,pobj,NNP-NNP-NNP,NNP,4,1
7341,22855.0,45,said,13,16,11,-5,15,33,-3,-2,Chunghwa Telecom,China,ORGANIZATION-ORGANIZATION,COUNTRY,PROPN-PROPN,PROPN,compound-nsubj,pobj,NNP-NNP,NNP,3,1
7342,22859.0,49,Gibson,1,41,6,-35,40,42,-40,5,his,UK,PERSON,COUNTRY,DET,PROPN,poss,appos,PRP$,NNP,-1,1
7343,22861.0,24,said,14,12,23,11,11,0,2,9,Molly Malaney,California,PERSON-PERSON,STATE_OR_PROVINCE,PROPN-PROPN,PROPN,compound-conj,pobj,NNP-NNP,NNP,6,1
7344,22865.0,37,Museum,1,1,32,31,0,4,0,31,National Museum of Women in the Arts,museum,ORGANIZATION-ORGANIZATION-ORGANIZATION-ORGANIZATION-ORGANIZATION-ORGANIZATION-ORGANIZATION,ORGANIZATION,PROPN-PROPN-ADP-PROPN-ADP-DET-NOUN,NOUN,compound-ROOT-prep-pobj-prep-det-pobj,nsubj,NNP-NNP-IN-NNPS-IN-DT-NNS,NN,3,1
7345,22869.0,26,filed,3,13,13,0,12,12,-10,10,FOF,FOF,ORGANIZATION,ORGANIZATION,PROPN,PROPN,pobj,nsubj,NNP,NNP,0,1
7346,22871.0,51,was,28,30,6,-24,29,44,-2,-22,Paul Sculfor,Victoria,PERSON-PERSON,PERSON,PROPN-PROPN,PROPN,compound-attr,nsubj,NNP-NNP,NNP,1,1
7347,22880.0,21,married,11,1,3,2,0,17,10,-8,DeGeneres,50,PERSON,NUMBER,PROPN,NUM,nsubjpass,appos,NNP,CD,2,1
7348,61128.0,26,seem,15,11,13,2,10,12,4,-2,DeGeneres,50,PERSON,NUMBER,PROPN,NUM,appos,appos,NNP,CD,5,1
7349,66660.0,30,said,28,13,15,2,12,14,15,-13,DeGeneres,50,PERSON,NUMBER,PROPN,NUM,conj,appos,NNP,CD,5,1
7350,22887.0,40,said,4,1,3,2,0,36,3,-1,Blackburn,John Williams,ORGANIZATION,PERSON-PERSON,NOUN,PROPN-PROPN,compound,compound-nsubj,NN,NNP-NNP,1,1
7351,42829.0,33,won,4,1,17,16,0,15,3,13,Blackburn,John Williams,ORGANIZATION,PERSON-PERSON,NOUN,PROPN-PROPN,compound,compound-nsubj,NN,NNP-NNP,4,1
7352,53013.0,33,made,15,4,6,2,3,26,11,-9,Blackburn,John Williams,ORGANIZATION,PERSON-PERSON,PROPN,PROPN-PROPN,compound,compound-nsubj,NNP,NNP-NNP,1,1
7353,63680.0,29,confirmed,5,1,3,2,0,25,4,-2,Blackburn,John Williams,ORGANIZATION,PERSON-PERSON,NOUN,PROPN-PROPN,compound,compound-nsubj,NN,NNP-NNP,1,1
7354,22890.0,21,was,1,15,9,-6,14,11,-14,8,he,U.S. House Budget Committee,PERSON,ORGANIZATION-ORGANIZATION-ORGANIZATION-ORGANIZATION,PRON,PROPN-PROPN-PROPN-PROPN,nsubj,compound-compound-compound-pobj,PRP,NNP-NNP-NNP-NNP,4,1
7355,22916.0,29,said,23,9,16,7,8,12,14,-7,ADB,ERD,ORGANIZATION,ORGANIZATION,PROPN,PROPN,nsubj,compound,NNP,NNP,7,1
7356,22921.0,59,says,15,1,21,20,0,37,14,6,Asian Development Bank,http://wwwadborg,ORGANIZATION-ORGANIZATION-ORGANIZATION,URL,PROPN-PROPN-PROPN,PROPN,compound-compound-nsubj,dep,NNP-NNP-NNP,NNP,5,1
7357,56080.0,25,emerged,12,1,5,4,0,19,11,-7,Asian Development Bank,http://wwwadborg,ORGANIZATION-ORGANIZATION-ORGANIZATION,URL,PROPN-PROPN-PROPN,PROPN,compound-compound-dep,appos,NNP-NNP-NNP,NNP,3,1
7358,61638.0,41,Bank,2,1,5,4,0,35,1,3,Asian Development Bank,http://wwwadborg,ORGANIZATION-ORGANIZATION-ORGANIZATION,URL,PROPN-PROPN-PROPN,PROPN,compound-compound-ROOT,compound,NNP-NNP-NNP,NNP,2,1
7359,22922.0,29,told,8,5,7,2,4,21,3,-1,FMF,Feizal Sidat,ORGANIZATION,PERSON-PERSON,PROPN,PROPN-PROPN,compound,compound-nsubj,NNP,NNP-NNP,1,1
7360,22936.0,29,stated,27,2,11,9,1,17,25,-16,She,Capitol Security Committee,PERSON,ORGANIZATION-ORGANIZATION-ORGANIZATION,PRON,PROPN-PROPN-PROPN,nsubj,compound-compound-pobj,PRP,NNP-NNP-NNP,7,1
7361,22947.0,31,creates,3,1,12,11,0,18,2,9,Negroponte,director,PERSON,TITLE,PROPN,NOUN,poss,pobj,NNP,NN,9,1
7362,22948.0,37,be,10,22,36,14,21,0,-12,26,Golden Baseball League,Canada,ORGANIZATION-ORGANIZATION-ORGANIZATION,COUNTRY,PROPN-PROPN-PROPN,PROPN,compound-compound-conj,pobj,NNP-NNP-NNP,NNP,7,1
7363,22949.0,20,know,2,4,7,3,3,12,-2,5,Adam Senn,Allie Crandell,PERSON-PERSON,PERSON-PERSON,PROPN-PROPN,PROPN-PROPN,compound-dobj,compound-poss,NNP-NNP,NNP-NNP,3,1
7364,22961.0,8,Forsberg,3,3,2,-1,2,5,0,-1,Randall Forsberg,Activist,PERSON-PERSON,TITLE,PROPN-PROPN,PROPN,compound-ROOT,compound,NNP-NNP,NNP,1,1
7365,22962.0,31,said,21,2,23,21,1,7,19,2,Carnival,Gerald Cahill,ORGANIZATION,PERSON-PERSON,PROPN,PROPN-PROPN,poss,compound-nsubj,NNP,NNP-NNP,3,1
7366,22964.0,6,-RRB-,4,4,1,-3,3,4,0,-3,Arsenal,Marouane Chamakh,ORGANIZATION,PERSON-PERSON,PROPN,PROPN-PROPN,compound,compound-compound,NNP,NNP-NNP,1,1
7367,22975.0,45,writes,15,19,18,-1,18,26,-4,3,Donald Wildmon,Chairman,PERSON-PERSON,TITLE,PROPN-PROPN,PROPN,compound-nsubj,compound,NNP-NNP,NNP,2,1
7368,26054.0,39,said,19,3,2,-1,2,36,16,-17,Donald Wildmon,Chairman,PERSON-PERSON,TITLE,PROPN-PROPN,PROPN,compound-nsubj,compound,NNP-NNP,NNP,1,1
7369,43711.0,19,said,5,4,3,-1,3,15,1,-2,Donald Wildmon,Chairman,PERSON-PERSON,TITLE,PROPN-PROPN,PROPN,compound-nsubj,compound,NNP-NNP,NNP,1,1
7370,22976.0,65,arranged,58,2,2,0,1,62,56,-56,Barnes Foundation,Barnes,ORGANIZATION-ORGANIZATION,PERSON,PROPN-PROPN,PROPN,compound-nsubj,nsubj,NNP-NNP,NNP,0,1
7371,27518.0,65,arranged,58,2,2,0,1,62,56,-56,Barnes Foundation,Barnes,ORGANIZATION-ORGANIZATION,PERSON,PROPN-PROPN,PROPN,compound-nsubj,poss,NNP-NNP,NNP,0,1
7372,23012.0,11,died,9,7,1,-6,6,9,2,-8,Michael Deaver,Last week,PERSON-PERSON,DATE-DATE,PROPN-PROPN,ADJ-NOUN,compound-conj,amod-npadvmod,NNP-NNP,JJ-NN,3,1
7373,23031.0,33,died,30,1,8,7,0,24,29,-22,Art Buchwald,satirist,PERSON-PERSON,TITLE,PROPN-PROPN,NOUN,compound-nsubj,appos,NNP-NNP,NN,2,1
7374,47787.0,37,managed,10,9,8,-1,8,28,1,-2,Art Buchwald,satirist,PERSON-PERSON,TITLE,PROPN-PROPN,VERB,compound-conj,compound,NNP-NNP,VB,1,1
7375,23035.0,46,have,11,32,24,-8,31,21,-21,13,Ali Akbar Salehi,International Atomic Energy Agency,PERSON-PERSON-PERSON,ORGANIZATION-ORGANIZATION-ORGANIZATION-ORGANIZATION,PROPN-PROPN-PROPN,PROPN-PROPN-PROPN-PROPN,compound-compound-nsubj,compound-compound-compound-compound,NNP-NNP-NNP,NNP-NNP-NNP-NNP,5,1
7376,23068.0,37,said,30,14,19,5,13,17,16,-11,Justice and Equality Movement,National Democratic Alliance,ORGANIZATION-ORGANIZATION-ORGANIZATION-ORGANIZATION,RELIGION-RELIGION-RELIGION,PROPN-CCONJ-PROPN-PROPN,PROPN-PROPN-PROPN,nmod-cc-conj-pobj,compound-compound-conj,NNP-CC-NNP-NNP,NNP-NNP-NNP,4,1
7377,23070.0,49,names,2,4,12,8,3,36,-2,10,Chelsea District Library,America,ORGANIZATION-ORGANIZATION-ORGANIZATION,COUNTRY,PROPN-PROPN-PROPN,PROPN,compound-compound-appos,pobj,NNP-NNP-NNP,NNP,3,1
7378,23075.0,14,remains,2,9,12,3,8,1,-7,10,IAPA,Americas,ORGANIZATION,LOCATION,PROPN,PROPN,pobj,pobj,NNP,NNPS,2,1
7379,23084.0,41,emphasized,14,11,7,-4,10,33,3,-7,University of Haifa,Michael Lazar,ORGANIZATION-ORGANIZATION-ORGANIZATION,PERSON-PERSON,PROPN-ADP-PROPN,PROPN-PROPN,pobj-prep-pobj,compound-appos,NNP-IN-NNP,NNP-NNP,5,1
7380,23090.0,22,insisted,4,18,2,-16,17,19,-14,-2,him,coach,PERSON,TITLE,PRON,NOUN,pobj,compound,PRP,NN,4,1
7381,23094.0,29,Times,1,11,10,-1,10,18,-10,9,Ali Akbar Salehi,Director,PERSON-PERSON-PERSON,TITLE,PROPN-PROPN-PROPN,PROPN,compound-compound-nsubj,compound,NNP-NNP-NNP,NNP,2,1
7382,23109.0,20,convicted,5,2,10,8,1,9,3,5,Danny Glover,trespassing,PERSON-PERSON,CRIMINAL_CHARGE,PROPN-PROPN,NOUN,compound-nsubjpass,pobj,NNP-NNP,NN,4,1
7383,23110.0,56,got,36,1,9,8,0,46,35,-27,Richard H. Nolte,executive director,PERSON-PERSON-PERSON,TITLE-TITLE,PROPN-PROPN-PROPN,ADJ-NOUN,compound-compound-nsubj,amod-appos,NNP-NNP-NNP,JJ-NN,2,1
7384,23113.0,46,said,22,42,35,-7,41,10,-20,13,Juanita Millender-McDonald,House,PERSON-PERSON,ORGANIZATION,PROPN-PROPN,PROPN,compound-nmod,compound,NNP-NNP,NNP,5,1
7385,60746.0,25,Democrat,4,2,19,17,1,5,2,15,Juanita Millender-McDonald,House,PERSON-PERSON,ORGANIZATION,PROPN-PROPN,PROPN,compound-compound,compound,NNP-NNP,NNP,-1,1
7386,23116.0,47,said,45,1,26,25,0,20,44,-19,Mia Farrow,United States,PERSON-PERSON,COUNTRY-COUNTRY,PROPN-PROPN,PROPN-PROPN,compound-nsubj,compound-pobj,NNP-NNP,NNP-NNP,6,1
7387,23120.0,18,leaves,2,4,17,13,3,0,-2,15,her,Bernice,PERSON,PERSON,DET,PROPN,poss,appos,PRP$,NNP,3,1
7388,23121.0,15,is,2,1,13,12,0,1,1,11,Stephanie Pratt,Spencer Pratt,PERSON-PERSON,PERSON-PERSON,PROPN-PROPN,PROPN-PROPN,compound-nsubj,compound-pobj,NNP-NNP,NNP-NNP,5,1
7389,23124.0,45,dies,12,3,15,12,2,29,9,3,Parren Mitchell,85,PERSON-PERSON,NUMBER,PROPN-PROPN,NUM,compound-nsubj,pobj,NNP-NNP,CD,2,1
7390,38909.0,38,dies,12,3,15,12,2,22,9,3,Parren Mitchell,85,PERSON-PERSON,NUMBER,PROPN-PROPN,NUM,compound-nsubj,pobj,NNP-NNP,CD,4,1
7391,58611.0,26,dies,12,3,15,12,2,10,9,3,Parren Mitchell,85,PERSON-PERSON,NUMBER,PROPN-PROPN,NUM,compound-nsubj,pobj,NNP-NNP,CD,3,1
7392,23129.0,80,divas,4,55,1,-54,54,78,-51,-3,she,AFAIC,PERSON,ORGANIZATION,PRON,PROPN,nsubj,compound,PRP,NNP,7,1
7393,23134.0,30,rejoined,3,6,26,20,5,3,-3,23,Jacksonville Jaguars,National Football League,ORGANIZATION-ORGANIZATION,ORGANIZATION-ORGANIZATION-ORGANIZATION,PROPN-PROPN,PROPN-PROPN-PROPN,compound-dobj,compound-compound-compound,NNP-NNPS,NNP-NNP-NNP,8,1
7394,26844.0,27,rushed,3,18,23,5,17,3,-15,20,Jacksonville Jaguars,National Football League,ORGANIZATION-ORGANIZATION,ORGANIZATION-ORGANIZATION-ORGANIZATION,PROPN-PROPN,PROPN-PROPN-PROPN,compound-compound,compound-compound-compound,NNP-NNP,NNP-NNP-NNP,4,1
7395,23145.0,32,is,24,29,26,-3,28,5,-5,2,Morgenthau,Paul Grand,PERSON,PERSON-PERSON,PROPN,PROPN-PROPN,poss,compound-attr,NNP,NNP-NNP,3,1
7396,23147.0,45,noted,17,13,10,-3,12,34,4,-7,MF Global,commodity research,ORGANIZATION-ORGANIZATION,ORGANIZATION-ORGANIZATION,PROPN-PROPN,NOUN-NOUN,compound-pobj,compound-pobj,NNP-NNP,NN-NN,2,1
7397,23148.0,8,11.30.08,0,3,8,5,2,-1,-3,8,CMA,http://www.cmt.com/shows/dyn/2008-cma-awards-red-carpet/1/episode.jhtml,ORGANIZATION,URL,PROPN,PROPN,compound,ROOT,NNP,NNP,-1,1
7398,23149.0,32,blasted,8,7,1,-6,6,30,1,-7,Mia Farrow,US,PERSON-PERSON,NATIONALITY,PROPN-PROPN,PROPN,compound-conj,compound,NNP-NNP,NNP,1,1
7399,53365.0,36,protesters,2,9,7,-2,8,28,-7,5,Mia Farrow,US,PERSON-PERSON,COUNTRY,PROPN-PROPN,PROPN,compound-pobj,compound,NNP-NNP,NNP,1,1
7400,23150.0,33,said,18,1,14,13,0,18,17,-4,Paul Watson,spokesman,PERSON-PERSON,TITLE,PROPN-PROPN,NOUN,compound-nsubj,conj,NNP-NNP,NN,3,1
7401,23155.0,24,said,21,18,1,-17,17,22,3,-20,Richmond Flowers Jr.,Flowers,PERSON-PERSON-PERSON,PERSON,PROPN-PROPN-PROPN,NOUN,compound-compound-appos,nsubj,NNP-NNP-NNP,NNS,5,1
7402,23169.0,20,elected,6,11,4,-7,10,15,-5,-2,Awami League,Sheikh Hasina,ORGANIZATION-ORGANIZATION,PERSON-PERSON,PROPN-PROPN,PROPN-PROPN,compound-pobj,compound-nsubjpass,NNP-NNP,NNP-NNP,5,1
7403,25869.0,40,met,16,14,4,-10,13,35,2,-12,Awami League,Sheikh Hasina,ORGANIZATION-ORGANIZATION,PERSON-PERSON,PROPN-PROPN,PROPN-PROPN,compound-pobj,compound-nsubj,NNP-NNP,NNP-NNP,5,1
7404,39563.0,55,Urgent,0,8,5,-3,7,49,-8,5,Awami League,Sheikh Hasina,ORGANIZATION-ORGANIZATION,PERSON-PERSON,PROPN-PROPN,PROPN-PROPN,compound-nsubj,compound-poss,NNP-NNP,NNP-NNP,1,1
7405,40860.0,39,quoted,19,14,6,-8,13,32,5,-13,Awami League,Sheikh Hasina,ORGANIZATION-ORGANIZATION,PERSON-PERSON,PROPN-PROPN,PROPN-PROPN,compound-compound,compound-appos,NNP-NNP,NNP-NNP,3,1
7406,23172.0,26,born,2,1,5,4,0,20,1,3,King,1955,PERSON,DATE,PROPN,NUM,nsubjpass,pobj,NNP,CD,2,1
7407,23198.0,18,respond,10,2,7,5,1,10,8,-3,National Republican Campaign Committee,Washington,ORGANIZATION-ORGANIZATION-ORGANIZATION-ORGANIZATION,STATE_OR_PROVINCE,PROPN-PROPN-PROPN-PROPN,PROPN,compound-compound-compound-nsubj,pobj,NNP-NNP-NNP-NNP,NNP,3,1
7408,23212.0,31,said,5,4,3,-1,3,27,1,-2,Christopher Dodd,Senator,PERSON-PERSON,ORGANIZATION,PROPN-PROPN,PROPN,compound-nsubj,compound,NNP-NNP,NNP,1,1
7409,35454.0,20,expressed,16,3,2,-1,2,17,13,-14,Christopher Dodd,Senator,PERSON-PERSON,TITLE,PROPN-PROPN,PROPN,compound-nsubj,compound,NNP-NNP,NNP,1,1
7410,23218.0,24,said,7,5,3,-2,4,20,2,-4,G. Gary Kirchner,Coroner,PERSON-PERSON-PERSON,TITLE,PROPN-PROPN-PROPN,PROPN,compound-compound-nsubj,nsubj,NNP-NNP-NNP,NNP,2,1
7411,29790.0,33,said,5,3,2,-1,2,30,2,-3,G. Gary Kirchner,Coroner,PERSON-PERSON-PERSON,TITLE,PROPN-PROPN-PROPN,PROPN,compound-compound-nsubj,compound,NNP-NNP-NNP,NNP,2,1
7412,54158.0,19,told,6,4,3,-1,3,15,2,-3,G. Gary Kirchner,Coroner,PERSON-PERSON-PERSON,TITLE,PROPN-PROPN-PROPN,PROPN,compound-compound-nsubj,compound,NNP-NNP-NNP,NNP,2,1
7413,54468.0,29,said,27,25,24,-1,24,4,2,-3,G. Gary Kirchner,Coroner,PERSON-PERSON-PERSON,TITLE,PROPN-PROPN-PROPN,PROPN,compound-compound-nsubj,compound,NNP-NNP-NNP,NNP,2,1
7414,23228.0,20,said,5,3,1,-2,2,18,2,-4,Abdul Jalil Jan,MMA,PERSON-PERSON-PERSON,ORGANIZATION,PROPN-PROPN-PROPN,PROPN,compound-compound-nsubj,compound,NNP-NNP-NNP,NNP,2,1
7415,34007.0,19,said,5,3,1,-2,2,17,2,-4,Abdul Jalil Jan,MMA,PERSON-PERSON-PERSON,ORGANIZATION,PROPN-PROPN-PROPN,PROPN,compound-compound-nsubj,compound,NNP-NNP-NNP,NNP,2,1
7416,23230.0,23,retired,7,19,1,-18,18,21,-12,-6,FAW,Fulham,ORGANIZATION,ORGANIZATION,PROPN,PROPN,compound,poss,NNP,NNP,-1,1
7417,23232.0,32,Federation,3,6,24,18,5,7,-3,21,FMF,Mexico,ORGANIZATION,COUNTRY,PROPN,PROPN,compound,poss,NNP,NNP,8,1
7418,23242.0,76,Keli,1,7,18,11,6,57,-6,17,Taiwan Research Institute,CASS,ORGANIZATION-ORGANIZATION-ORGANIZATION,ORGANIZATION,PROPN-PROPN-PROPN,PROPN,compound-compound-pobj,compound,NNP-NNP-NNP,NNP,5,1
7419,23244.0,30,called,17,3,11,8,2,18,14,-6,American Beverage Association,PepsiCo,ORGANIZATION-ORGANIZATION-ORGANIZATION,ORGANIZATION,PROPN-PROPN-PROPN,PROPN,compound-compound-nsubj,conj,NNP-NNP-NNP,NNP,4,1
7420,23246.0,35,Bles8ings,1,5,17,12,4,17,-4,16,Kate Gosselin,Grand Rapids,PERSON-PERSON,CITY-CITY,PROPN-PROPN,PROPN-PROPN,conj-conj,compound-npadvmod,NNP-NNP,NNP-NNPS,6,1
7421,23253.0,29,protect,3,1,26,25,0,2,2,23,CPS Does,Child Protective Services,ORGANIZATION-ORGANIZATION,ORGANIZATION-ORGANIZATION-ORGANIZATION,PROPN-VERB,PROPN-PROPN-PROPN,nsubj-aux,compound-compound-pobj,NNP-VBZ,NNP-NNP-NNPS,-1,1
7422,23268.0,27,is,6,2,1,-1,1,25,4,-5,Juanita Millender-McDonald,Rep.,PERSON-PERSON,TITLE,PROPN-PROPN,PROPN,compound-nsubj,compound,NNP-NNP,NNP,2,1
7423,28061.0,26,said,23,2,1,-1,1,24,21,-22,Juanita Millender-McDonald,Rep.,PERSON-PERSON,TITLE,PROPN-PROPN,PROPN,compound-nsubj,compound,NNP-NNP,NNP,2,1
7424,28266.0,38,said,15,34,33,-1,33,4,-19,18,Juanita Millender-McDonald,Rep.,PERSON-PERSON,TITLE,PROPN-PROPN,PROPN,compound-nmod,pobj,NNP-NNP,NNP,2,1
7425,36915.0,25,credited,9,7,6,-1,6,18,2,-3,Juanita Millender-McDonald,Rep.,PERSON-PERSON,TITLE,PROPN-PROPN,PROPN,compound-pobj,compound,NNP-NNP,NNP,2,1
7426,59157.0,17,fills,1,13,12,-1,12,4,-12,11,Juanita Millender-McDonald,Rep.,PERSON-PERSON,TITLE,PROPN-PROPN,PROPN,compound-pobj,compound,NNP-NNP,NNP,2,1
7427,59457.0,46,said,22,42,41,-1,41,4,-20,19,Juanita Millender-McDonald,Rep.,PERSON-PERSON,TITLE,PROPN-PROPN,PROPN,compound-nmod,compound,NNP-NNP,NNP,2,1
7428,65292.0,31,died,26,2,1,-1,1,29,24,-25,Juanita Millender-McDonald,Rep.,PERSON-PERSON,TITLE,PROPN-PROPN,PROPN,compound-nsubj,compound,NNP-NNP,NNP,2,1
7429,23272.0,40,said,10,4,1,-3,3,38,6,-9,Fidelity,Kathleen Murphy,ORGANIZATION,PERSON-PERSON,PROPN,PROPN-PROPN,poss,compound-nsubj,NNP,NNP-NNP,3,1
7430,23292.0,49,died,39,1,37,36,0,11,38,-2,Harry Shuler Dent,lay minister,PERSON-PERSON-PERSON,TITLE-TITLE,PROPN-PROPN-PROPN,NOUN-NOUN,compound-compound-nsubj,compound-attr,NNP-NNP-NNP,NN-NN,9,1
7431,23294.0,47,made,3,31,37,6,30,9,-28,34,Korean Central News Agency,Pyongyang,ORGANIZATION-ORGANIZATION-ORGANIZATION-ORGANIZATION,LOCATION,PROPN-PROPN-PROPN-PROPN,PROPN,compound-compound-compound-appos,poss,NNP-NNP-NNP-NNP,NNP,13,1
7432,40117.0,35,said,7,4,1,-3,3,33,3,-6,Korean Central News Agency,Pyongyang,ORGANIZATION-ORGANIZATION-ORGANIZATION-ORGANIZATION,LOCATION,PROPN-PROPN-PROPN-PROPN,PROPN,compound-compound-compound-nsubj,poss,NNP-NNP-NNP-NNP,NNP,3,1
7433,62096.0,51,said,37,47,44,-3,46,6,-10,7,Korean Central News Agency,Pyongyang,ORGANIZATION-ORGANIZATION-ORGANIZATION-ORGANIZATION,LOCATION,PROPN-PROPN-PROPN-PROPN,PROPN,compound-compound-compound-pobj,poss,NNP-NNP-NNP-NNP,NNP,2,1
7434,23297.0,39,plans,10,7,16,9,6,22,3,6,Awami League,Dhaka,ORGANIZATION-ORGANIZATION,CITY,PROPN-PROPN,PROPN,compound-dobj,pobj,NNP-NNP,NNP,6,1
7435,45153.0,50,DHAKA,0,11,49,38,10,0,-11,49,Awami League,Dhaka,ORGANIZATION-ORGANIZATION,CITY,PROPN-PROPN,PROPN,compound-nsubj,pobj,NNP-NNP,NNP,2,1
7436,23324.0,27,included,1,9,13,4,8,13,-8,12,Christopher Dodd,author,PERSON-PERSON,TITLE,PROPN-PROPN,NOUN,compound-conj,appos,NNP-NNP,NN,6,1
7437,23336.0,25,confirmed,6,16,11,-5,15,13,-10,5,Lashkar-e-Taiba,Zaki-ur-Rehman Lakhvi,ORGANIZATION,PERSON-PERSON,PROPN,PROPN-PROPN,compound,compound-pobj,NNP,NNP-NNP,4,1
7438,23340.0,19,said,17,16,15,-1,15,3,1,-2,Jennifer Dunn,meteorologist,PERSON-PERSON,TITLE,PROPN-PROPN,NOUN,compound-nsubj,compound,NNP-NNP,NN,1,1
7439,23354.0,37,said,1,11,1,-10,10,35,-10,0,EAB,Citibank,ORGANIZATION,ORGANIZATION,PROPN,PROPN,dobj,nsubj,NNP,NNP,3,1
7440,53879.0,37,said,1,11,1,-10,10,35,-10,0,EAB,Citibank,ORGANIZATION,ORGANIZATION,PROPN,PROPN,nmod,nsubj,NNP,NNP,3,1
7441,23386.0,34,played,9,7,6,-1,6,27,2,-3,Sean Parker,creator,PERSON-PERSON,TITLE,PROPN-PROPN,NOUN,compound-pobj,compound,NNP-NNP,NN,1,1
7442,23393.0,19,chose,7,9,18,9,8,0,-2,11,Michael J. Sandy,Williamsburg,PERSON-PERSON-PERSON,CITY,PROPN-PROPN-PROPN,PROPN,compound-compound-dobj,pobj,NNP-NNP-NNP,NNP,3,1
7443,23397.0,13,became,9,1,3,2,0,9,8,-6,His,Richmond III,PERSON,PERSON-PERSON,DET,PROPN-PROPN,poss,compound-conj,PRP$,NNP-NNP,1,1
7444,23404.0,43,LG,27,6,10,4,5,32,21,-17,Red Sox,Lou Gorman,ORGANIZATION-ORGANIZATION,PERSON-PERSON,PROPN-PROPN,PROPN-PROPN,nmod-nmod,compound-pobj,NNP-NNP,NNP-NNP,1,1
7445,23420.0,24,was,8,2,6,4,1,17,6,-2,her,House,PERSON,ORGANIZATION,DET,PROPN,poss,pobj,PRP$,NNP,3,1
7446,26308.0,63,know,22,16,52,36,15,10,6,30,her,House,PERSON,ORGANIZATION,DET,PROPN,poss,pobj,PRP$,NNP,11,1
7447,23423.0,19,King,0,1,11,10,0,7,-1,11,King,Dexter Scott King,PERSON,PERSON-PERSON-PERSON,PROPN,PROPN-PROPN-PROPN,ROOT,compound-compound-conj,NNP,NNP-NNP-NNP,5,1
7448,60648.0,19,King,0,1,11,10,0,7,-1,11,King,Dexter Scott King,PERSON,PERSON-PERSON-PERSON,PROPN,PROPN-PROPN-PROPN,compound,compound-compound-conj,NNP,NNP-NNP-NNP,5,1
7449,23426.0,47,point,1,24,43,19,23,3,-23,42,Covidien,Abbott Laboratories,ORGANIZATION,ORGANIZATION-ORGANIZATION,PROPN,PROPN-PROPN,pobj,compound-pobj,NNP,NNP-NNP,4,1
7450,23438.0,40,called,6,26,10,-16,25,29,-20,4,Supreme Court,Debra Todd,ORGANIZATION-ORGANIZATION,PERSON-PERSON,PROPN-PROPN,PROPN-PROPN,compound-pobj,compound-oprd,NNP-NNP,NNP-NNP,6,1
7451,23441.0,22,called,5,4,1,-3,3,20,1,-4,Philip Chen,Cathay,PERSON-PERSON,ORGANIZATION,PROPN-PROPN,PROPN,compound-nsubj,compound,NNP-NNP,NNP,2,1
7452,30774.0,24,added,8,1,4,3,0,19,7,-4,Philip Chen,Cathay,PERSON-PERSON,ORGANIZATION,PROPN-PROPN,PROPN,compound-nsubj,poss,NNP-NNP,NNP,3,1
7453,23449.0,39,converted,19,16,16,0,15,22,3,-3,FMR Corp,FMR LLC,ORGANIZATION-ORGANIZATION,ORGANIZATION-ORGANIZATION,PROPN-PROPN,PROPN-PROPN,compound-pobj,compound-oprd,NNP-NNP,NNP-NNP,0,1
7454,23459.0,20,was,5,5,3,-2,4,16,0,-2,he,Congress,PERSON,ORGANIZATION,PRON,PROPN,nsubj,pobj,PRP,NNP,1,1
7455,61948.0,14,elected,7,6,10,4,5,3,1,3,he,Congress,PERSON,ORGANIZATION,PRON,PROPN,nsubjpass,pobj,PRP,NNP,2,1
7456,23469.0,26,Jr.,2,14,1,-13,13,24,-12,-1,MECO,Amadeo Perez Jr.,ORGANIZATION,PERSON-PERSON-PERSON,PROPN,PROPN-PROPN-PROPN,compound,compound-compound-ROOT,NNP,NNP-NNP-NNP,2,1
7457,23471.0,25,Birthday,1,13,17,4,12,7,-12,16,Johnny Knoxville,34,PERSON-PERSON,NUMBER,PROPN-PROPN,NUM,compound-appos,dobj,NNP-NNP,CD,1,1
7458,23488.0,36,dressed,13,12,33,21,11,2,1,20,Frankie Delgado,LA,PERSON-PERSON,CITY,PROPN-PROPN,PROPN,compound-conj,pobj,NNP-NNP,NNP,7,1
7459,23504.0,42,took,4,1,3,2,0,38,3,-1,Hubbard,60,PERSON,NUMBER,PROPN,NUM,nsubj,appos,NNP,CD,3,1
7460,36088.0,31,report,8,10,12,2,9,18,-2,4,Hubbard,60,PERSON,NUMBER,PROPN,NUM,dobj,appos,NNP,CD,3,1
7461,39055.0,22,joined,4,1,3,2,0,18,3,-1,Hubbard,60,PERSON,NUMBER,PROPN,NUM,nsubj,appos,NNP,CD,3,1
7462,23505.0,25,was,16,13,23,10,12,1,3,7,Chris Dodd,Susan Dodd,PERSON-PERSON,PERSON-PERSON,PROPN-PROPN,PROPN-PROPN,compound-nsubj,compound-pobj,NNP-NNP,NNP-NNP,11,1
7463,23509.0,30,raised,4,2,13,11,1,16,2,9,Asian Development Bank,Philippines,ORGANIZATION-ORGANIZATION-ORGANIZATION,ORGANIZATION,PROPN-PROPN-PROPN,PROPN,compound-compound-nsubj,pobj,NNP-NNP-NNP,NNPS,3,1
7464,23518.0,61,Taipei,0,15,18,3,14,42,-15,18,MAC,Fu Tung-cheng,ORGANIZATION,PERSON-PERSON,PROPN,PROPN-PROPN,compound,compound-nsubj,NNP,NNP-NNP,4,1
7465,23525.0,32,is,17,12,8,-4,11,23,5,-9,Sean Parker,entrepreneurs,PERSON-PERSON,TITLE,PROPN-PROPN,VERB,compound-conj,dobj,NNP-NNP,VBZ,2,1
7466,23555.0,43,are,7,14,4,-10,13,38,-7,-3,his,New York,PERSON,STATE_OR_PROVINCE-STATE_OR_PROVINCE,DET,PROPN-PROPN,poss,compound-compound,PRP$,NNP-NNP,6,1
7467,38410.0,43,are,7,14,4,-10,13,38,-7,-3,his,New York,PERSON,STATE_OR_PROVINCE-STATE_OR_PROVINCE,DET,PROPN-PROPN,poss,compound-compound,PRP$,NNP-NNP,6,1
7468,23557.0,41,died,33,1,38,37,0,2,32,5,Jefferson J. DeBlanc,Lafayette,PERSON-PERSON-PERSON,CITY,PROPN-PROPN-PROPN,PROPN,compound-compound-nsubj,pobj,NNP-NNP-NNP,NNP,5,1
7469,23561.0,43,said,24,27,33,6,26,9,-3,9,Mamoor Khan,Levies,PERSON-PERSON,ORGANIZATION,PROPN-PROPN,PROPN,compound-nsubj,pobj,NNP-NNP,NNP,4,1
7470,23565.0,24,graduated,1,1,20,19,0,3,0,19,He,Georgetown University,PERSON,ORGANIZATION-ORGANIZATION,PRON,PROPN-PROPN,nsubj,compound-pobj,PRP,NNP-NNP,3,1
7471,23572.0,71,called,6,5,4,-1,4,66,1,-2,Mia Farrow,activist,PERSON-PERSON,TITLE,PROPN-PROPN,NOUN,compound-appos,conj,NNP-NNP,NN,1,1
7472,43181.0,44,appeased,2,33,32,-1,32,11,-31,30,Mia Farrow,activist,PERSON-PERSON,TITLE,PROPN-PROPN,NOUN,compound-conj,conj,NNP-NNP,NN,2,1
7473,51383.0,35,said,33,7,6,-1,6,28,26,-27,Mia Farrow,activist,PERSON-PERSON,TITLE,PROPN-PROPN,NOUN,compound-appos,conj,NNP-NNP,NN,2,1
7474,23575.0,36,reported,32,10,22,12,9,13,22,-10,DeGeneres,Margaret Rogers,PERSON,PERSON-PERSON,PROPN,PROPN-PROPN,poss,compound-conj,NNP,NNP-NNP,5,1
7475,23578.0,50,include,1,3,23,20,2,26,-2,22,his,Adrienne Lewis,PERSON,PERSON-PERSON,DET,PROPN-PROPN,poss,compound-conj,PRP$,NNP-NNP,3,1
7476,23584.0,34,think,2,32,26,-6,31,7,-30,24,MF Global,Pioneer Futures,ORGANIZATION-ORGANIZATION,ORGANIZATION-ORGANIZATION,PROPN-PROPN,PROPN-PROPN,compound-pobj,compound-pobj,NNP-NNP,NNP-NNPS,5,1
7477,32765.0,58,'s,16,56,50,-6,55,7,-40,34,MF Global,Pioneer Futures,ORGANIZATION-ORGANIZATION,ORGANIZATION-ORGANIZATION,PROPN-PROPN,PROPN-PROPN,compound-pobj,compound-pobj,NNP-NNP,NNP-NNPS,3,1
7478,23589.0,27,said,25,7,23,16,6,3,18,-2,her,Jay-Z,PERSON,PERSON,PRON,NOUN,dobj,pobj,PRP,NNS,5,1
7479,23592.0,26,spent,1,1,12,11,0,13,0,11,Pratt,Las Vegas,PERSON,CITY-CITY,PROPN,PROPN-PROPN,nsubj,compound-pobj,NNP,NNP-NNP,5,1
7480,23601.0,50,bought,3,44,5,-39,43,44,-41,2,USA Network,Universal,ORGANIZATION-ORGANIZATION,ORGANIZATION,PROPN-PROPN,PROPN,compound-pobj,poss,NNP-NNP,NNP,11,1
7481,23619.0,38,led,25,15,33,18,14,4,10,8,Army Medical Command,U.S.,ORGANIZATION-ORGANIZATION-ORGANIZATION,COUNTRY,PROPN-PROPN-PROPN,PROPN,compound-compound-pobj,compound,NNP-NNP-NNP,NNP,9,1
7482,23628.0,51,directed,14,37,26,-11,36,24,-23,12,his,sergeant,PERSON,TITLE,DET,NOUN,poss,pobj,PRP$,NN,-1,1
7483,23632.0,10,Medal,0,5,8,3,4,1,-5,8,Silvestre Herrera,90,PERSON-PERSON,NUMBER,PROPN-PROPN,NUM,compound-pobj,conj,NNP-NNP,CD,2,1
7484,23634.0,25,admitted,5,5,1,-4,4,23,0,-4,Babyshambles,The 28-year-old leader,ORGANIZATION,PERSON-PERSON-PERSON,PROPN,DET-NUM-NOUN,pobj,det-amod-nsubj,NNPS,DT-CD-NN,2,1
7485,23647.0,31,vowed,25,8,1,-7,7,29,17,-24,Jewish National Fund,Russell Robinson,ORGANIZATION-ORGANIZATION-ORGANIZATION,PERSON-PERSON,ADJ-PROPN-PROPN,PROPN-PROPN,compound-compound-pobj,compound-nsubj,JJ-NNP-NNP,NNP-NNP,4,1
7486,23649.0,63,said,57,6,31,25,5,31,51,-26,institutions,Afghanistan,ORGANIZATION,ORGANIZATION,NOUN,PROPN,pobj,pobj,NNS,NNP,9,1
7487,23650.0,20,Founded,0,11,3,-8,10,16,-11,3,FAW,1953,ORGANIZATION,DATE,PROPN,NUM,nsubj,pobj,NNP,CD,4,1
7488,50886.0,52,is,5,5,3,-2,4,48,0,-2,FAW,1953,ORGANIZATION,DATE,PROPN,NUM,nsubj,pobj,NNP,CD,1,1
7489,23652.0,8,said,1,1,3,2,0,4,0,2,Chen,94,PERSON,NUMBER,PROPN,NUM,nsubj,nsubj,NNP,CD,1,1
7490,23670.0,48,advancing,23,19,2,-17,18,45,4,-21,his,Army,PERSON,ORGANIZATION,DET,PROPN,poss,nmod,PRP$,NNP,8,1
7491,23671.0,12,Wilkinson,1,1,12,11,0,-1,0,11,Kendra Wilkinson,E!,PERSON-PERSON,ORGANIZATION,PROPN-PROPN,NOUN,compound-ROOT,pobj,NNP-NNP,NNS,1,1
7492,43927.0,43,appear,32,7,21,14,6,21,25,-11,Kendra Wilkinson,E!,PERSON-PERSON,ORGANIZATION,PROPN-PROPN,PROPN,compound-conj,poss,NNP-NNP,NNP,8,1
7493,23679.0,25,asked,23,2,9,7,1,15,21,-14,Bachelor,advertising account manager,PERSON,TITLE-TITLE-TITLE,PROPN,NOUN-NOUN-NOUN,dep,compound-compound-pobj,NNP,NN-NN-NN,4,1
7494,23684.0,42,said,5,1,4,3,0,37,4,-1,MAC,Chao Chien-min,ORGANIZATION,PERSON-PERSON,PROPN,PROPN-PROPN,compound,nsubj-nummod,NNP,NNP-NNP,3,1
7495,24513.0,23,said,5,1,4,3,0,18,4,-1,MAC,Chao Chien-min,ORGANIZATION,PERSON-PERSON,PROPN,PROPN-PROPN,compound,nsubj-punct,NNP,NNP-NNP,3,1
7496,32086.0,47,head,10,10,21,11,9,25,0,11,MAC,Chao Chien-min,ORGANIZATION,PERSON-PERSON,PROPN,PROPN-PROPN,compound,nsubj-nummod,NNP,NNP-NNP,3,1
7497,23685.0,24,denied,11,1,7,6,0,16,10,-4,Paul Watson,Sea Shepherd Society,PERSON-PERSON,ORGANIZATION-ORGANIZATION-ORGANIZATION,PROPN-PROPN,PROPN-PROPN-PROPN,compound-nsubj,compound-compound-pobj,NNP-NNP,NNP-NNP-NNP,4,1
7498,23696.0,25,In,0,6,11,5,5,13,-6,11,International Monetary Fund,Horst Kohler,ORGANIZATION-ORGANIZATION-ORGANIZATION,PERSON-PERSON,PROPN-PROPN-PROPN,PROPN-PROPN,compound-compound-compound,compound-pobj,NNP-NNP-NNP,NNP-NNP,3,1
7499,23709.0,23,said,15,21,17,-4,20,5,-6,2,ANP,Haji Adeel,ORGANIZATION,PERSON-PERSON,PROPN,PROPN-PROPN,compound,compound-nsubj,NNP,NNP-NNP,3,1
7500,23712.0,54,continued,4,17,35,18,16,18,-13,31,John Kerry,Boston,PERSON-PERSON,CITY,PROPN-PROPN,PROPN,compound-nsubj,compound,NNP-NNP,NNP,4,1
7501,23725.0,40,said,13,22,34,12,21,5,-9,21,Focus On the Family,Christian,ORGANIZATION-ORGANIZATION-ORGANIZATION-ORGANIZATION,RELIGION,PROPN-ADP-DET-PROPN,ADJ,pobj-prep-det-nmod,amod,NNP-IN-DT-NNP,JJ,4,1
7502,23733.0,9,Dead,6,5,4,-1,4,4,1,-2,Vernon Bellecourt Dead,Activist,PERSON-PERSON-PERSON,TITLE,PROPN-PROPN-PROPN,PROPN,compound-compound-ROOT,compound,NNP-NNP-NNP,NNP,1,1
7503,27151.0,9,Dead,6,5,4,-1,4,4,1,-2,Vernon Bellecourt Dead,Activist,PERSON-PERSON-PERSON,TITLE,PROPN-PROPN-PROPN,PROPN,compound-compound-ROOT,compound,NNP-NNP-NNP,NNP,1,1
7504,23746.0,12,announced,3,1,9,8,0,2,2,6,Her,Yorke B. Mizelle,PERSON,PERSON-PERSON-PERSON,DET,PROPN-PROPN-PROPN,poss,compound-compound-appos,PRP$,NNP-NNP-NNP,5,1
7505,23749.0,19,allowed,5,2,17,15,1,1,3,12,Red Sox,United States,ORGANIZATION-ORGANIZATION,COUNTRY-COUNTRY,PROPN-PROPN,PROPN-PROPN,compound-nsubjpass,compound-pobj,NNP-NNPS,NNP-NNP,4,1
7506,23755.0,13,By,0,2,5,3,1,7,-2,5,Paul Watson,Los Angeles Times,PERSON-PERSON,ORGANIZATION-ORGANIZATION-ORGANIZATION,PROPN-PROPN,PROPN-PROPN-PROPN,compound-pobj,compound-npadvmod-compound,NNP-NNP,NNP-NNP-NNP,3,1
7507,23773.0,36,apologised,7,6,2,-4,5,33,1,-5,OUP,Oxford University Press,ORGANIZATION,ORGANIZATION-ORGANIZATION-ORGANIZATION,PROPN,PROPN-PROPN-PROPN,compound,compound-compound-nsubj,NNP,NNP-NNP-NNP,2,1
7508,23777.0,38,rose,4,1,10,9,0,27,3,6,Ospel,captain,PERSON,TITLE,NOUN,NOUN,nsubj,pobj,NN,NN,5,1
7509,23790.0,35,rejected,4,1,15,14,0,19,3,11,China National Aviation Corp,CNAC,ORGANIZATION-ORGANIZATION-ORGANIZATION-ORGANIZATION,ORGANIZATION,PROPN-PROPN-PROPN-PROPN,PROPN,compound-compound-compound-compound,compound,NNP-NNP-NNP-NNP,NNP,3,1
7510,34006.0,39,said,2,14,19,5,13,19,-12,17,China National Aviation Corp,CNAC,ORGANIZATION-ORGANIZATION-ORGANIZATION-ORGANIZATION,ORGANIZATION,PROPN-PROPN-PROPN-PROPN,PROPN,compound-compound-compound-compound,compound,NNP-NNP-NNP-NNP,NNP,7,1
7511,39531.0,42,slumped,2,2,17,15,1,24,0,15,China National Aviation Corp,CNAC,ORGANIZATION-ORGANIZATION-ORGANIZATION-ORGANIZATION,ORGANIZATION,PROPN-PROPN-PROPN-PROPN,PROPN,compound-compound-compound-compound,compound,NNP-NNP-NNP-NNP,NNP,1,1
7512,45557.0,39,fell,4,1,31,30,0,7,3,27,China National Aviation Corp,CNAC,ORGANIZATION-ORGANIZATION-ORGANIZATION-ORGANIZATION,ORGANIZATION,PROPN-PROPN-PROPN-PROPN,PROPN,compound-compound-compound-compound,compound,NNP-NNP-NNP-NNP,NNP,4,1
7513,47714.0,44,said,11,16,21,5,15,22,-5,10,China National Aviation Corp,CNAC,ORGANIZATION-ORGANIZATION-ORGANIZATION-ORGANIZATION,ORGANIZATION,PROPN-PROPN-PROPN-PROPN,PROPN,compound-compound-compound-compound,compound,NNP-NNP-NNP-NNP,NNP,3,1
7514,51426.0,39,proposed,15,1,7,6,0,31,14,-8,China National Aviation Corp,CNAC,ORGANIZATION-ORGANIZATION-ORGANIZATION-ORGANIZATION,ORGANIZATION,PROPN-PROPN-PROPN-PROPN,PROPN,compound-compound-compound-nsubj,conj,NNP-NNP-NNP-NNP,NNP,3,1
7515,23800.0,33,said,11,9,2,-7,8,30,2,-9,Herb Gibson,Denver,PERSON-PERSON,CITY,PROPN-PROPN,PROPN,compound-appos,compound,NNP-NNP,NNP,2,1
7516,23805.0,8,name,3,3,7,4,2,0,0,4,Trista,Blakesley,PERSON,PERSON,PROPN,PROPN,nsubj,appos,NNP,NNP,1,1
7517,23806.0,35,included,2,9,5,-4,8,29,-7,3,Robert M. Morgenthau,Manhattan,PERSON-PERSON-PERSON,CITY,PROPN-PROPN-PROPN,PROPN,compound-compound-appos,compound,NNP-NNP-NNP,NNP,3,1
7518,58390.0,26,described,16,13,9,-4,12,16,3,-7,Robert M. Morgenthau,Manhattan,PERSON-PERSON-PERSON,CITY,PROPN-PROPN-PROPN,PROPN,compound-compound-appos,compound,NNP-NNP-NNP,NNP,8,1
7519,60292.0,55,contributed,23,52,38,-14,51,16,-29,15,Robert M. Morgenthau,Manhattan,PERSON-PERSON-PERSON,CITY,PROPN-PROPN-PROPN,PROPN,compound-compound-appos,compound,NNP-NNP-NNP,NNP,3,1
7520,61342.0,55,contributed,23,52,38,-14,51,16,-29,15,Robert M. Morgenthau,Manhattan,PERSON-PERSON-PERSON,CITY,PROPN-PROPN-PROPN,PROPN,compound-compound-appos,compound,NNP-NNP-NNP,NNP,3,1
7521,64187.0,40,sat,1,10,18,8,9,21,-9,17,Robert M. Morgenthau,Manhattan,PERSON-PERSON-PERSON,CITY,PROPN-PROPN-PROPN,PROPN,compound-compound-pobj,compound,NNP-NNP-NNP,NNP,3,1
7522,67121.0,30,said,1,9,5,-4,8,24,-8,4,Robert M. Morgenthau,Manhattan,PERSON-PERSON-PERSON,CITY,PROPN-PROPN-PROPN,PROPN,compound-compound-appos,compound,NNP-NNP-NNP,NNP,3,1
7523,23819.0,41,said,24,5,7,2,4,33,19,-17,Binoche,43,PERSON,NUMBER,PROPN,NUM,nsubj,appos,NNP,CD,2,1
7524,23841.0,40,said,31,8,38,30,7,1,23,7,ITW,David Speer,ORGANIZATION,PERSON-PERSON,PROPN,PROPN-PROPN,compound,compound-conj,NNP,NNP-NNP,9,1
7525,42697.0,40,said,31,8,38,30,7,1,23,7,ITW,David Speer,ORGANIZATION,PERSON-PERSON,PROPN,PROPN-PROPN,compound,compound-conj,NNP,NNP-NNP,9,1
7526,23843.0,28,see,14,6,9,3,5,18,8,-5,Barnes Foundation,Merion,ORGANIZATION-ORGANIZATION,LOCATION,PROPN-PROPN,PROPN,compound-pobj,pobj,NNP-NNP,NNP,3,1
7527,27014.0,28,see,14,6,9,3,5,18,8,-5,Barnes Foundation,Merion,ORGANIZATION-ORGANIZATION,LOCATION,PROPN-PROPN,PROPN,compound-pobj,pobj,NNP-NNP,NNP,3,1
7528,34257.0,28,see,14,6,9,3,5,18,8,-5,Barnes Foundation,Merion,ORGANIZATION-ORGANIZATION,CITY,PROPN-PROPN,PROPN,compound-pobj,pobj,NNP-NNP,NNP,3,1
7529,23851.0,46,Council,4,42,7,-35,41,38,-38,3,Chen Cheng-hong,NSC,ORGANIZATION-ORGANIZATION,PERSON,PROPN-PROPN,PROPN,compound-nsubj,compound,NNP-NNP,NNP,5,1
7530,23863.0,31,reported,29,3,7,4,2,23,26,-22,Juanita Millender-McDonald,Democratic,PERSON-PERSON,ORGANIZATION,PROPN-PROPN,ADJ,compound-nsubj,appos,NNP-NNP,JJ,3,1
7531,23867.0,42,warning,9,14,37,23,13,4,-5,28,Chavez,President,PERSON,TITLE,PROPN,PROPN,ROOT,compound,NNP,NNP,4,1
7532,23875.0,36,told,26,29,12,-17,28,23,-3,-14,Philadelphia Inquirer,he,ORGANIZATION-ORGANIZATION,PERSON,PROPN-PROPN,PRON,compound-dobj,nsubj,NNP-NNP,PRP,10,1
7533,23882.0,27,says,4,1,3,2,0,23,3,-1,Chavez,53,PERSON,NUMBER,PROPN,NUM,nsubj,appos,NNP,CD,3,1
7534,42679.0,31,lost,4,1,3,2,0,27,3,-1,Chavez,53,PERSON,NUMBER,PROPN,NUM,nsubj,appos,NNP,CD,3,1
7535,50921.0,50,said,34,1,3,2,0,46,33,-31,Chavez,53,PERSON,NUMBER,PROPN,NUM,nsubj,appos,NNP,CD,2,1
7536,23895.0,46,left,11,11,27,16,10,18,0,16,Ospel,Swiss Banking Corporation,PERSON,ORGANIZATION-ORGANIZATION-ORGANIZATION,PROPN,PROPN-PROPN-PROPN,nsubj,compound-compound-dobj,NNP,NNP-NNP-NNP,5,1
7537,23898.0,28,was,4,15,11,-4,14,16,-11,7,Lewis Hamilton,Formula One,PERSON-PERSON,ORGANIZATION-ORGANIZATION,PROPN-PROPN,PROPN-NUM,compound-nsubj,nmod-nummod,NNP-NNP,NNP-CD,3,1
7538,30260.0,46,Formula,0,27,1,-26,26,44,-27,1,Lewis Hamilton,Formula One,PERSON-PERSON,ORGANIZATION-ORGANIZATION,PROPN-PROPN,PROPN-NUM,compound-pobj,ROOT-nummod,NNP-NNP,NNP-CD,-1,1
7539,66476.0,33,S,0,22,19,-3,21,13,-22,19,Lewis Hamilton,Formula One,PERSON-PERSON,ORGANIZATION-ORGANIZATION,PROPN-PROPN,PROPN-NUM,compound-dobj,nmod-nummod,NNP-NNP,NNP-CD,5,1
7540,23909.0,31,display,2,24,21,-3,23,9,-22,19,Chris Ivery,music executive producer,PERSON-PERSON,TITLE-TITLE-TITLE,PROPN-PROPN,NOUN-ADJ-NOUN,compound-appos,compound-compound-pobj,NNP-NNP,NN-JJ-NN,2,1
7541,23910.0,40,said,32,38,34,-4,37,5,-6,2,William Anderson,Air Force,PERSON-PERSON,ORGANIZATION-ORGANIZATION,PROPN-PROPN,PROPN-PROPN,compound-nsubj,compound-compound,NNP-NNP,NNP-NNP,4,1
7542,23917.0,21,says,19,19,17,-2,18,3,0,-2,pilot,31-year-old,PERSON,NUMBER,NOUN,NUM,nsubj,amod,NN,CD,1,1
7543,23922.0,15,is,1,7,1,-6,6,13,-6,0,Pompeo,She,PERSON,PERSON,PROPN,PRON,pobj,nsubj,NNP,PRP,4,1
7544,23932.0,20,said,11,5,1,-4,4,18,6,-10,ABA,Kevin Keane,ORGANIZATION,PERSON-PERSON,PROPN,PROPN-PROPN,poss,compound-nsubj,NNP,NNP-NNP,3,1
7545,23945.0,33,signed,18,18,11,-7,17,21,0,-7,he,University of Louisiana,PERSON,ORGANIZATION-ORGANIZATION-ORGANIZATION,PRON,PROPN-ADP-PROPN,nsubj,appos-prep-pobj,PRP,NNP-IN-NNP,3,1
7546,23955.0,27,said,15,17,22,5,16,4,-2,7,Robert McNair,executive,PERSON-PERSON,TITLE,PROPN-PROPN,NOUN,compound-nsubj,appos,NNP-NNP,NN,2,1
7547,23965.0,28,was,4,1,16,15,0,11,3,12,Knoxville,MTV,PERSON,ORGANIZATION,PROPN,PROPN,nsubj,compound,NNP,NNP,6,1
7548,23967.0,21,refused,11,1,7,6,0,13,10,-4,Her,Martin Luther King Sr.,PERSON,PERSON-PERSON-PERSON-PERSON,DET,PROPN-PROPN-PROPN-PROPN,poss,compound-compound-compound-appos,PRP$,NNP-NNP-NNP-NNP,3,1
7549,23979.0,32,took,5,13,9,-4,12,22,-8,4,Dee Dee Myers,White House Press,PERSON-PERSON-PERSON,ORGANIZATION-ORGANIZATION-ORGANIZATION,PROPN-PROPN-PROPN,PROPN-PROPN-PROPN,compound-compound-nsubj,compound-compound-compound,NNP-NNP-NNP,NNP-NNP-NNP,3,1
7550,23981.0,30,died,22,3,2,-1,2,27,19,-20,Steven B Derounian,Rep,PERSON-PERSON-PERSON,TITLE,PROPN-PROPN-PROPN,PROPN,compound-compound-nsubj,compound,NNP-NNP-NNP,NNP,1,1
7551,23992.0,39,said,36,7,5,-2,6,33,29,-31,Art Buchwald,Newspaper columnist,PERSON-PERSON,TITLE-TITLE,PROPN-PROPN,PROPN-NOUN,compound-nsubj,compound-compound,NNP-NNP,NNP-NN,5,1
7552,23998.0,36,hooked,18,24,23,-1,23,12,-6,5,Adam Senn,model,PERSON-PERSON,TITLE,PROPN-PROPN,NOUN,compound-pobj,compound,NNP-NNP,NN,1,1
7553,39821.0,40,is,15,19,18,-1,18,21,-4,3,Adam Senn,model,PERSON-PERSON,TITLE,PROPN-PROPN,NOUN,compound-attr,compound,NNP-NNP,NN,2,1
7554,47163.0,40,is,4,3,8,5,2,31,1,4,Adam Senn,model,PERSON-PERSON,TITLE,PROPN-PROPN,NOUN,compound-nsubj,attr,NNP-NNP,NN,4,1
7555,24000.0,26,welcomes,7,25,9,-16,24,16,-18,2,Scorpions,the Directorate of Special Operations,ORGANIZATION,ORGANIZATION-ORGANIZATION-ORGANIZATION-ORGANIZATION-ORGANIZATION,PROPN,DET-PROPN-ADP-PROPN-PROPN,pobj,det-dobj-prep-compound-pobj,NNPS,DT-NNP-IN-NNP-NNPS,3,1
7556,44492.0,44,report,6,5,15,10,4,28,1,9,Scorpions,the Directorate of Special Operations,ORGANIZATION,ORGANIZATION-ORGANIZATION-ORGANIZATION-ORGANIZATION-ORGANIZATION,PROPN,DET-PROPN-ADP-PROPN-PROPN,dobj,det-pobj-prep-compound-compound,NNPS,DT-NNP-IN-NNP-NNPS,6,1
7557,24034.0,38,rallied,21,24,31,7,23,6,-3,10,Castro,Fidel,PERSON,PERSON,PROPN,PROPN,pobj,appos,NNP,NNP,4,1
7558,64665.0,47,wrote,8,19,15,-4,18,31,-11,7,Castro,Fidel,PERSON,PERSON,PROPN,PROPN,compound,pobj,NNP,NNP,5,1
7559,24036.0,59,Association,4,2,7,5,1,51,2,3,National Military Family Association,wwwnmfaorg,ORGANIZATION-ORGANIZATION-ORGANIZATION-ORGANIZATION,URL,PROPN-PROPN-PROPN-PROPN,ADJ,compound-compound-compound-ROOT,acl,NNP-NNP-NNP-NNP,JJ,5,1
7560,24045.0,34,letting,17,9,10,1,8,23,8,-7,George Young,Young,PERSON-PERSON,PERSON,PROPN-PROPN,PROPN,compound-dobj,nsubj,NNP-NNP,NNP,3,1
7561,24050.0,43,been,23,40,1,-39,39,41,-17,-22,United National Congress,Basdeo Panday,ORGANIZATION-ORGANIZATION-ORGANIZATION,PERSON-PERSON,PROPN-PROPN-PROPN,PROPN-PROPN,compound-compound-dobj,compound-nsubj,NNP-NNP-NNP,NNP-NNP,3,1
7562,39944.0,30,refused,12,1,10,9,0,19,11,-2,United National Congress,Basdeo Panday,ORGANIZATION-ORGANIZATION-ORGANIZATION,PERSON-PERSON,PROPN-PROPN-PROPN,PROPN-PROPN,compound-compound-compound,compound-appos,NNP-NNP-NNP,NNP-NNP,4,1
7563,42156.0,32,says,15,4,13,9,3,18,11,-2,United National Congress,Basdeo Panday,ORGANIZATION-ORGANIZATION-ORGANIZATION,PERSON-PERSON,PROPN-PROPN-PROPN,PROPN-PROPN,compound-compound-nsubj,compound-pobj,NNP-NNP-NNP,NNP-NNP,4,1
7564,24051.0,38,been,4,3,2,-1,2,35,1,-2,Gonzales,Judge,PERSON,TITLE,PROPN,PROPN,nsubj,compound,NNP,NNP,1,1
7565,24052.0,25,served,20,11,9,-2,10,15,9,-11,Ali Larijani,security chief,PERSON-PERSON,TITLE-TITLE,PROPN-PROPN,NOUN-NOUN,compound-conj,compound-compound,NNP-NNP,NN-NN,1,1
7566,24053.0,32,gay,1,12,5,-7,11,26,-11,4,Servicemembers Legal Defense Network,Keith Kerr,ORGANIZATION-ORGANIZATION-ORGANIZATION-ORGANIZATION,PERSON-PERSON,PROPN-PROPN-PROPN-PROPN,PROPN-PROPN,compound-compound-compound-pobj,compound-dobj,NNP-NNP-NNP-NNP,NNP-NNP,5,1
7567,24066.0,44,given,11,6,8,2,5,35,5,-3,movement,Khalil Ibrahim,ORGANIZATION,PERSON-PERSON,NOUN,PROPN-PROPN,pobj,compound-appos,NN,NNP-NNP,4,1
7568,24084.0,44,lured,8,38,2,-36,37,41,-30,-6,he,"Oct. 8 , 2006",PERSON,DATE-DATE-DATE-DATE,PRON,PROPN-NUM-PUNCT-NUM,nsubj,pobj-nummod-punct-nummod,PRP,"NNP-CD-,-CD",5,1
7569,24091.0,37,said,23,1,9,8,0,27,22,-14,Shah Mahmood,tailor,PERSON-PERSON,TITLE,PROPN-PROPN,NOUN,compound-nsubj,compound,NNP-NNP,NN,2,1
7570,24092.0,66,lifted,3,37,44,7,36,21,-34,41,Hussein Kamel,Military Industrialization Corporation,PERSON-PERSON,ORGANIZATION-ORGANIZATION-ORGANIZATION,PROPN-PROPN,PROPN-PROPN-PROPN,compound-nsubj,compound-compound-pobj,NNP-NNP,NNP-NNP-NNP,4,1
7571,24106.0,23,BEE-1023105-very,0,17,13,-4,16,9,-17,13,OIC,Oracle Incentive Comp,ORGANIZATION,ORGANIZATION-ORGANIZATION-ORGANIZATION,PROPN,PROPN-PROPN-PROPN,compound,compound-compound-pobj,NNP,NNP-NNP-NNP,4,1
7572,24111.0,28,said,26,5,4,-1,4,23,21,-22,Awami League,her,ORGANIZATION-ORGANIZATION,PERSON,PROPN-PROPN,DET,compound-compound,poss,NNP-NNP,PRP$,1,1
7573,36036.0,14,have,5,12,9,-3,11,4,-7,4,Awami League,her,ORGANIZATION-ORGANIZATION,PERSON,PROPN-PROPN,DET,compound-pobj,poss,NNP-NNP,PRP$,2,1
7574,38992.0,26,dismissed,6,4,3,-1,3,22,2,-3,Awami League,her,ORGANIZATION-ORGANIZATION,PERSON,PROPN-PROPN,DET,compound-conj,poss,NNP-NNP,PRP$,1,1
7575,24115.0,23,get,3,19,21,2,18,1,-16,18,Cowell,Syco Music,PERSON,ORGANIZATION-ORGANIZATION,PROPN,PROPN-PROPN,poss,compound-pobj,NNP,NNP-NNP,2,1
7576,24122.0,26,said,11,19,23,4,18,2,-8,12,Crown Prosecution Service,Counter Terrorism Division,ORGANIZATION-ORGANIZATION-ORGANIZATION,ORGANIZATION-ORGANIZATION-ORGANIZATION,PROPN-PROPN-PROPN,PROPN-PROPN-PROPN,compound-compound-poss,compound-compound-pobj,NNP-NNP-NNP,NNP-NNP-NNP,3,1
7577,24132.0,27,told,6,1,5,4,0,21,5,-1,ConAgra,Gary Rodkin,ORGANIZATION,PERSON-PERSON,PROPN,PROPN-PROPN,poss,compound-nsubj,NNP,NNP-NNP,3,1
7578,24134.0,50,is,19,40,46,6,39,3,-21,27,Representatives,William Straus,ORGANIZATION,PERSON-PERSON,PROPN,PROPN-PROPN,compound,compound-conj,NNPS,NNP-NNP,5,1
7579,24148.0,37,married,12,12,29,17,11,7,0,17,she,typist,PERSON,TITLE,PRON,NOUN,nsubj,pobj,PRP,NN,7,1
7580,51177.0,37,married,12,12,29,17,11,7,0,17,she,typist,PERSON,TITLE,PRON,NOUN,nsubj,pobj,PRP,NN,7,1
7581,24154.0,50,became,21,2,24,22,1,25,19,3,Bellecourt,negotiator,PERSON,TITLE,PROPN,NOUN,nsubj,attr,NNP,NN,4,1
7582,26112.0,49,became,20,1,23,22,0,25,19,3,Bellecourt,negotiator,PERSON,TITLE,PROPN,NOUN,nsubj,attr,NNP,NN,4,1
7583,61991.0,50,became,21,2,24,22,1,25,19,3,Bellecourt,negotiator,PERSON,TITLE,PROPN,NOUN,nsubj,attr,NNP,NN,4,1
7584,24161.0,24,said,9,11,14,3,10,9,-2,5,Fred Dewey,director,PERSON-PERSON,TITLE,PROPN-PROPN,NOUN,compound-nsubj,appos,NNP-NNP,NN,2,1
7585,24164.0,21,Court,4,7,3,-4,6,17,-3,-1,TSE,Superior Electoral Court,ORGANIZATION,ORGANIZATION-ORGANIZATION-ORGANIZATION,PROPN,PROPN-PROPN-PROPN,compound,compound-compound-ROOT,NNP,NNP-NNP-NNP,2,1
7586,24165.0,35,given,4,13,2,-11,12,32,-9,-2,Sports Affairs Council,Liu Chao-shiuan,ORGANIZATION-ORGANIZATION-ORGANIZATION,PERSON-PERSON,PROPN-PROPN-PROPN,PROPN-PROPN,compound-compound-pobj,compound-nsubj,NNPS-NNPS-NNP,NNP-NNP,6,1
7587,24170.0,20,born,3,18,14,-4,17,5,-15,11,Harry Dent,Elizabeth Patch Dent,PERSON-PERSON,PERSON-PERSON-PERSON,PROPN-PROPN,PROPN-PROPN-PROPN,compound-conj,compound-compound-pobj,NNP-NNP,NNP-NNP-NNP,2,1
7588,24173.0,25,became,1,13,4,-9,12,20,-12,3,his,coach,PERSON,TITLE,DET,NOUN,poss,attr,PRP$,NN,4,1
7589,35164.0,27,promised,4,6,2,-4,5,24,-2,-2,his,coach,PERSON,TITLE,DET,NOUN,poss,compound,PRP$,NN,3,1
7590,37496.0,29,criticised,4,6,2,-4,5,26,-2,-2,his,coach,PERSON,TITLE,DET,NOUN,poss,compound,PRP$,NN,4,1
7591,40735.0,26,qualified,6,22,17,-5,21,8,-16,11,his,coach,PERSON,TITLE,DET,VERB,poss,compound,PRP$,VB,2,1
7592,43144.0,29,said,4,8,2,-6,7,26,-4,-2,his,coach,PERSON,TITLE,DET,NOUN,poss,compound,PRP$,NN,5,1
7593,24189.0,17,drew,5,5,13,8,4,3,0,8,Washburn,Alaska,PERSON,STATE_OR_PROVINCE,PROPN,PROPN,nsubj,pobj,NNP,NNP,5,1
7594,24196.0,42,names,1,9,13,4,8,28,-8,12,Chen,vice president,PERSON,TITLE-TITLE,PROPN,NOUN-NOUN,nsubj,compound-attr,NNP,NN-NN,4,1
7595,61181.0,28,Focus,2,18,20,2,17,7,-16,18,Chen,vice president,PERSON,TITLE-TITLE,PROPN,NOUN-NOUN,nsubj,compound-attr,NNP,NN-NN,2,1
7596,24200.0,45,said,32,40,34,-6,39,10,-8,2,Chunghwa Telecom Workers ' Union,Chuan Ping-tang,ORGANIZATION-ORGANIZATION-ORGANIZATION-ORGANIZATION-ORGANIZATION,PERSON-PERSON,PROPN-PROPN-PROPN-PART-PROPN,PROPN-PROPN,compound-compound-poss-case-pobj,compound-nsubj,NNP-NNP-NNPS-POS-NNP,NNP-NNP,2,1
7597,24204.0,33,aims,16,16,3,-13,15,29,0,-13,NCF,1989,ORGANIZATION,DATE,PROPN,NUM,nsubj,pobj,NNP,CD,2,1
7598,24214.0,21,was,1,1,9,8,0,11,0,8,He,U.S. House Budget Committee,PERSON,ORGANIZATION-ORGANIZATION-ORGANIZATION-ORGANIZATION,PRON,PROPN-PROPN-PROPN-PROPN,nsubj,compound-compound-compound-pobj,PRP,NNP-NNP-NNP-NNP,4,1
7599,24229.0,25,CORRECTIONS-NYT,0,10,16,6,9,8,-10,16,Richard Nolte,geographer,PERSON-PERSON,TITLE,PROPN-PROPN,NOUN,compound-pobj,conj,NNP-NNP,NN,3,1
7600,29277.0,24,obituary,6,9,15,6,8,8,-3,9,Richard Nolte,geographer,PERSON-PERSON,TITLE,PROPN-PROPN,NOUN,compound-pobj,conj,NNP-NNP,NN,4,1
7601,24235.0,32,said,14,6,10,4,5,21,8,-4,Richard Lindzen,Massachusetts Institute of Technology,PERSON-PERSON,ORGANIZATION-ORGANIZATION-ORGANIZATION-ORGANIZATION,PROPN-PROPN,PROPN-PROPN-ADP-PROPN,compound-nsubj,compound-pobj-prep-pobj,NNP-NNP,NNP-NNP-IN-NNP,3,1
7602,31788.0,42,argued,14,2,11,9,1,30,12,-3,Richard Lindzen,Massachusetts Institute of Technology,PERSON-PERSON,ORGANIZATION-ORGANIZATION-ORGANIZATION-ORGANIZATION,PROPN-PROPN,PROPN-PROPN-ADP-PROPN,compound-nsubj,compound-pobj-prep-pobj,NNP-NNP,NNP-NNP-IN-NNP,3,1
7603,32552.0,45,2007-09-27T09,0,5,14,9,4,30,-5,14,Richard Lindzen,Massachusetts Institute of Technology,PERSON-PERSON,ORGANIZATION-ORGANIZATION-ORGANIZATION-ORGANIZATION,PROPN-PROPN,PROPN-PROPN-ADP-PROPN,compound-nsubj,compound-pobj-prep-pobj,NNP-NNP,NNP-NNP-IN-NNP,8,1
7604,24239.0,51,came,3,15,6,-9,14,44,-12,3,Organization of the Islamic Conference,Ekmeleddin Ihsanoglu,ORGANIZATION-ORGANIZATION-ORGANIZATION-ORGANIZATION-ORGANIZATION,PERSON-PERSON,PROPN-ADP-DET-PROPN-PROPN,PROPN-PROPN,pobj-prep-det-compound-pobj,compound-nsubj,NNP-IN-DT-NNP-NNP,NNP-NNP,5,1
7605,28122.0,38,hosting,2,27,36,9,26,1,-25,34,Organization of the Islamic Conference,Ekmeleddin Ihsanoglu,ORGANIZATION-ORGANIZATION-ORGANIZATION-ORGANIZATION-ORGANIZATION,PERSON-PERSON,PROPN-ADP-DET-PROPN-PROPN,PROPN-PROPN,pobj-prep-det-compound-pobj,compound-appos,NNP-IN-DT-NNP-NNP,NNP-NNP,14,1
7606,33390.0,57,said,51,26,19,-7,25,37,25,-32,Organization of the Islamic Conference,Ekmeleddin Ihsanoglu,ORGANIZATION-ORGANIZATION-ORGANIZATION-ORGANIZATION-ORGANIZATION,PERSON-PERSON,PROPN-ADP-DET-PROPN-PROPN,PROPN-PROPN,pobj-prep-det-compound-pobj,compound-pobj,NNP-IN-DT-NNP-NNP,NNP-NNP,4,1
7607,40972.0,31,met,5,13,21,8,12,9,-8,16,Organization of the Islamic Conference,Ekmeleddin Ihsanoglu,ORGANIZATION-ORGANIZATION-ORGANIZATION-ORGANIZATION-ORGANIZATION,PERSON-PERSON,PROPN-ADP-DET-PROPN-PROPN,PROPN-PROPN,pobj-prep-det-compound-pobj,compound-ROOT,NNP-IN-DT-NNP-NNP,NNP-NNP,7,1
7608,54539.0,37,Organization,1,2,32,30,1,4,-1,31,Organization of the Islamic Conference,Ekmeleddin Ihsanoglu,ORGANIZATION-ORGANIZATION-ORGANIZATION-ORGANIZATION-ORGANIZATION,PERSON-PERSON,PROPN-ADP-DET-PROPN-PROPN,PROPN-PROPN,ROOT-prep-det-compound-pobj,compound-appos,NNP-IN-DT-NNP-NNP,NNP-NNP,5,1
7609,66761.0,39,said,25,34,27,-7,33,11,-9,2,Organization of the Islamic Conference,Ekmeleddin Ihsanoglu,ORGANIZATION-ORGANIZATION-ORGANIZATION-ORGANIZATION-ORGANIZATION,PERSON-PERSON,PROPN-ADP-DET-PROPN-PROPN,PROPN-PROPN,pobj-prep-det-compound-pobj,compound-nsubj,NNP-IN-DT-NNP-NNP,NNP-NNP,6,1
7610,24245.0,37,said,14,24,36,12,23,0,-10,22,International Crisis Group,Belgium,ORGANIZATION-ORGANIZATION-ORGANIZATION,COUNTRY,PROPN-PROPN-PROPN,PROPN,compound-compound-pobj,appos,NNP-NNP-NNP,NNP,8,1
7611,25439.0,46,says,13,2,12,10,1,33,11,-1,International Crisis Group,Belgium,ORGANIZATION-ORGANIZATION-ORGANIZATION,COUNTRY,PROPN-PROPN-PROPN,PROPN,compound-compound-nsubj,appos,NNP-NNP-NNP,NNP,3,1
7612,24250.0,25,elected,3,1,16,15,0,8,2,13,She,House Armed Services Committee,PERSON,ORGANIZATION-ORGANIZATION-ORGANIZATION-ORGANIZATION,PRON,PROPN-PROPN-PROPN-PROPN,nsubjpass,compound-compound-compound-pobj,PRP,NNP-NNP-NNPS-NNP,7,1
7613,24255.0,54,step,37,19,53,34,18,0,18,16,Cathleen P Black,IBM,PERSON-PERSON-PERSON,ORGANIZATION,PROPN-PROPN-PROPN,PROPN,compound-compound-appos,conj,NNP-NNP-NNP,NNP,9,1
7614,50965.0,89,have,30,1,88,87,0,0,29,58,Cathleen P Black,IBM,PERSON-PERSON-PERSON,ORGANIZATION,PROPN-PROPN-PROPN,PROPN,compound-compound-nsubj,conj,NNP-NNP-NNP,NNP,-1,1
7615,24256.0,40,charged,7,3,14,11,2,25,4,7,Brandon McInerney,hate crime,PERSON-PERSON,CRIMINAL_CHARGE-CRIMINAL_CHARGE,PROPN-PROPN,NOUN-NOUN,compound-nsubjpass,compound-conj,NNP-NNP,NN-NN,6,1
7616,24269.0,43,said,28,30,36,6,29,6,-2,8,Christopher Bentley,US Bureau of Citizenship and Immigration Services,PERSON-PERSON,ORGANIZATION-ORGANIZATION-ORGANIZATION-ORGANIZATION-ORGANIZATION-ORGANIZATION-ORGANIZATION,PROPN-PROPN,PROPN-PROPN-ADP-PROPN-CCONJ-PROPN-PROPN,compound-nsubj,compound-pobj-prep-nmod-cc-conj-pobj,NNP-NNP,NNP-NNP-IN-NNP-CC-NNP-NNPS,3,1
7617,24274.0,18,landed,2,11,16,5,10,1,-9,14,he,hair stylist,PERSON,TITLE-TITLE,PRON,NOUN-NOUN,nsubj,conj-attr,PRP,NN-NN,2,1
7618,24276.0,40,said,15,9,13,4,8,26,6,-2,International Crisis Group,Jakarta,ORGANIZATION-ORGANIZATION-ORGANIZATION,CITY,PROPN-PROPN-PROPN,PROPN,compound-compound-pobj,pobj,NNP-NNP-NNP,NNP,6,1
7619,24281.0,10,said,1,1,8,7,0,1,0,7,Sadia,Adriano Ferreira,ORGANIZATION,PERSON-PERSON,PROPN,PROPN-PROPN,nsubj,compound-dobj,NNP,NNP-NNP,3,1
7620,56999.0,32,said,1,1,8,7,0,23,0,7,Sadia,Adriano Ferreira,ORGANIZATION,PERSON-PERSON,PROPN,PROPN-PROPN,nsubj,compound-dobj,NNP,NNP-NNP,3,1
7621,24283.0,41,said,32,39,34,-5,38,6,-7,2,Marco Contiero,Greenpeace EU GMO,PERSON-PERSON,ORGANIZATION-ORGANIZATION-ORGANIZATION,PROPN-PROPN,PROPN-PROPN-PROPN,compound-nsubj,compound-compound-compound,NNP-NNP,NNP-NNP-NNP,4,1
7622,24300.0,32,said,5,12,17,5,11,14,-7,12,Hassan,Saddam Kamel,PERSON,PERSON-PERSON,PROPN,PROPN-PROPN,pobj,compound-appos,NNP,NNP-NNP,3,1
7623,24309.0,13,Visit,0,10,2,-8,9,10,-10,2,Royal Caribbean International,www.RoyalCaribbeanFan.com,ORGANIZATION-ORGANIZATION-ORGANIZATION,URL,PROPN-PROPN-PROPN,X,compound-compound-pobj,dobj,NNP-NNP-NNP,ADD,6,1
7624,24311.0,16,said,6,4,2,-2,3,13,2,-4,Berthold Huber,deputy,PERSON-PERSON,TITLE,PROPN-PROPN,NOUN,compound-appos,nsubj,NNP-NNP,NN,2,1
7625,47998.0,23,said,14,21,19,-2,20,3,-7,5,Berthold Huber,deputy,PERSON-PERSON,TITLE,PROPN-PROPN,NOUN,compound-nsubj,compound,NNP-NNP,NN,3,1
7626,52915.0,41,received,19,1,13,12,0,27,18,-6,Berthold Huber,deputy,PERSON-PERSON,TITLE,PROPN-PROPN,NOUN,compound-nsubj,pobj,NNP-NNP,NN,2,1
7627,24316.0,38,is,3,21,20,-1,20,17,-18,17,Li Jie,student,PERSON-PERSON,TITLE,PROPN-PROPN,NOUN,compound-attr,compound,NNP-NNP,NN,2,1
7628,24327.0,34,become,14,5,13,8,4,20,9,-1,CPC,China,ORGANIZATION,COUNTRY,PROPN,PROPN,nsubj,nsubj,NNP,NNP,3,1
7629,24330.0,35,sworn,2,1,33,32,0,1,1,31,Bolin,law department,PERSON,ORGANIZATION-ORGANIZATION,PROPN,NOUN-NOUN,nsubjpass,compound-pobj,NNP,NN-NN,4,1
7630,24331.0,38,overshadowed,16,1,13,12,0,24,15,-3,Waldheim,president,PERSON,TITLE,PROPN,NOUN,poss,pobj,NNP,NN,4,1
7631,28040.0,22,served,1,1,19,18,0,2,0,18,Waldheim,president,PERSON,TITLE,PROPN,NOUN,nsubj,oprd,NNP,NN,2,1
7632,24332.0,31,admitted,2,7,23,16,6,7,-5,21,International Monetary Fund,1944,ORGANIZATION-ORGANIZATION-ORGANIZATION,DATE,PROPN-PROPN-PROPN,NUM,compound-compound-nsubjpass,pobj,NNP-NNP-NNP,CD,4,1
7633,24334.0,38,said,30,4,32,28,3,5,26,2,Popular Resistance Committees,Abu Mujahed,ORGANIZATION-ORGANIZATION-ORGANIZATION,PERSON-PERSON,PROPN-PROPN-PROPN,PROPN-PROPN,compound-compound-compound,compound-nsubj,NNP-NNP-NNPS,NNP-NNP,5,1
7634,24364.0,32,received,16,28,3,-25,27,28,-12,-13,George Young,MP,PERSON-PERSON,TITLE,PROPN-PROPN,PROPN,compound-poss,compound,NNP-NNP,NNP,6,1
7635,24367.0,19,married,5,7,12,5,6,6,-2,7,Gunnar Forsberg,Swedish,PERSON-PERSON,NATIONALITY,PROPN-PROPN,ADJ,compound-dobj,amod,NNP-NNP,JJ,1,1
7636,24369.0,54,said,42,10,48,38,9,5,32,6,Asian Development Bank,US,ORGANIZATION-ORGANIZATION-ORGANIZATION,CITY,PROPN-PROPN-PROPN,PROPN,compound-compound-nsubj,compound,NNP-NNP-NNP,NNP,8,1
7637,66043.0,16,are,4,13,4,-9,12,11,-9,0,Asian Development Bank,US,ORGANIZATION-ORGANIZATION-ORGANIZATION,PERSON,PROPN-PROPN-PROPN,PROPN,compound-compound-pobj,conj,NNP-NNP-NNP,NNP,4,1
7638,24380.0,92,used,10,44,5,-39,43,86,-34,-5,Barry Goldwater,65,PERSON-PERSON,NUMBER,PROPN-PROPN,NUM,compound-pobj,dobj,NNP-NNP,CD,8,1
7639,24394.0,32,LUMPUR,1,18,9,-9,17,22,-17,8,Bernama,Radio24,ORGANIZATION,ORGANIZATION,PROPN,PROPN,pobj,nsubjpass,NNP,NNP,3,1
7640,24395.0,45,opposition,1,3,7,4,2,37,-2,6,United National Congress,UNC -RRB- Alliance,ORGANIZATION-ORGANIZATION-ORGANIZATION,ORGANIZATION-ORGANIZATION-ORGANIZATION,PROPN-PROPN-PROPN,PROPN-PROPN-PROPN,compound-compound-appos,compound-compound-appos,NNP-NNP-NNP,NNP-NNP-NNP,4,1
7641,24401.0,52,issued,11,7,1,-6,6,50,4,-10,Barbara Boxer,Senate Environment and Public Works,PERSON-PERSON,ORGANIZATION-ORGANIZATION-ORGANIZATION-ORGANIZATION-ORGANIZATION,PROPN-PROPN,PROPN-PROPN-CCONJ-PROPN-PROPN,compound-appos,compound-nsubj-cc-compound-compound,NNP-NNP,NNP-NNP-CC-NNP-NNP,1,1
7642,24418.0,16,has,6,2,4,2,1,11,4,-2,Scorpions,Leonard McCarthy,ORGANIZATION,PERSON-PERSON,PROPN,PROPN-PROPN,nsubj,compound-dobj,NNPS,NNP-NNP,1,1
7643,66446.0,38,is,3,10,13,3,9,24,-7,10,Scorpions,Leonard McCarthy,ORGANIZATION,PERSON-PERSON,PROPN,PROPN-PROPN,compound,compound-appos,NNPS,NNP-NNP,1,1
7644,24420.0,21,keep,4,6,11,5,5,9,-2,7,Tyco Healthcare,Mansfield,ORGANIZATION-ORGANIZATION,CITY,PROPN-PROPN,PROPN,compound-poss,pobj,NNP-NNP,NNP,4,1
7645,24425.0,38,died,33,1,35,34,0,2,32,2,Philip M. Kaiser,Thursday,PERSON-PERSON-PERSON,DATE,PROPN-PROPN-PROPN,PROPN,compound-compound-nsubj,npadvmod,NNP-NNP-NNP,NNP,3,1
7646,24431.0,41,was,2,27,12,-15,26,28,-25,10,her,Republican Party,PERSON,ORGANIZATION-ORGANIZATION,DET,PROPN-PROPN,poss,compound-pobj,PRP$,NNP-NNP,8,1
7647,24455.0,40,was,1,1,32,31,0,7,0,31,King,National Association for the Advancement of Colored People,PERSON,ORGANIZATION-ORGANIZATION-ORGANIZATION-ORGANIZATION-ORGANIZATION-ORGANIZATION-ORGANIZATION-ORGANIZATION,PROPN,PROPN-PROPN-ADP-DET-PROPN-ADP-PROPN-PROPN,nsubj,compound-conj-prep-det-pobj-prep-compound-pobj,NNP,NNP-NNP-IN-DT-NNP-IN-NNP-NNPS,2,1
7648,24458.0,36,was,7,7,12,5,6,23,0,5,Mitchell,Morgan State College,PERSON,ORGANIZATION-ORGANIZATION-ORGANIZATION,PROPN,PROPN-PROPN-PROPN,nsubj,compound-compound-pobj,NNP,NNP-NNP-NNP,4,1
7649,24462.0,21,cited,1,1,9,8,0,11,0,8,He,Japan,PERSON,COUNTRY,PRON,PROPN,nsubj,pobj,PRP,NNP,1,1
7650,24470.0,37,got,1,12,8,-4,11,28,-11,7,Golden Baseball League,Calgary Vipers,ORGANIZATION-ORGANIZATION-ORGANIZATION,ORGANIZATION-ORGANIZATION,PROPN-PROPN-PROPN,PROPN-PROPN,compound-compound-pobj,compound-pobj,NNP-NNP-NNP,NNP-NNPS,3,1
7651,24478.0,49,Party,2,15,22,7,14,26,-13,20,Awami League,Sheikh Hasian,ORGANIZATION-ORGANIZATION,PERSON-PERSON,PROPN-PROPN,PROPN-PROPN,compound-conj,compound-pobj,NNP-NNP,NNP-NNP,7,1
7652,24482.0,36,Neddo,1,9,8,-1,8,27,-8,7,Manila Economic and Cultural Office,Taipei-based,ORGANIZATION-ORGANIZATION-ORGANIZATION-ORGANIZATION-ORGANIZATION,CITY,PROPN-PROPN-CCONJ-PROPN-PROPN,PROPN,nmod-nmod-cc-conj-pobj,amod,NNP-NNP-CC-NNP-NNP,NNP,1,1
7653,24494.0,24,given,7,1,13,12,0,10,6,6,Beyonce,R&B artist,PERSON,TITLE-TITLE,PROPN,NOUN-NOUN,poss,compound-pobj,NNP,NN-NN,7,1
7654,24497.0,22,died,13,1,15,14,0,6,12,2,Carolyn Goodman,last month,PERSON-PERSON,DATE-DATE,PROPN-PROPN,ADJ-NOUN,compound-nsubj,amod-npadvmod,NNP-NNP,JJ-NN,2,1
7655,24500.0,18,are,11,1,11,10,0,6,10,0,Hugo Chavez,brothers,PERSON-PERSON,PERSON,PROPN-PROPN,NOUN,compound-poss,pobj,NNP-NNP,NNS,2,1
7656,24518.0,25,born,3,1,6,5,0,18,2,3,Raul Castro,"June 3 , 1931",PERSON-PERSON,DATE-DATE-DATE-DATE,PROPN-PROPN,PROPN-NUM-PUNCT-NUM,compound-nsubjpass,pobj-nummod-punct-nummod,NNP-NNP,"NNP-CD-,-CD",4,1
7657,37717.0,21,studied,9,8,3,-5,7,17,1,-6,Raul Castro,"June 3 , 1931",PERSON-PERSON,DATE-DATE-DATE-DATE,PROPN-PROPN,PROPN-NUM-PUNCT-NUM,compound-nsubj,pobj-nummod-punct-nummod,NNP-NNP,"NNP-CD-,-CD",5,1
7658,24525.0,29,said,15,3,17,14,2,11,12,2,Taiwan Research Institute,Ruan Ming,ORGANIZATION-ORGANIZATION-ORGANIZATION,PERSON-PERSON,PROPN-PROPN-PROPN,PROPN-PROPN,compound-compound-pobj,compound-nsubj,NNP-NNP-NNP,NNP-NNP,6,1
7659,34235.0,41,said,10,7,1,-6,6,39,3,-9,Taiwan Research Institute,Ruan Ming,ORGANIZATION-ORGANIZATION-ORGANIZATION,PERSON-PERSON,PROPN-PROPN-PROPN,PROPN-PROPN,compound-compound-pobj,compound-nsubj,NNP-NNP-NNP,NNP-NNP,4,1
7660,24539.0,23,backed,19,2,6,4,1,16,17,-13,EnergySolutions,Envirocare,ORGANIZATION,ORGANIZATION,PROPN,PROPN,nsubj,dobj,NNP,NNP,3,1
7661,24544.0,43,appointed,14,31,24,-7,30,18,-17,10,him,governor,PERSON,TITLE,PRON,NOUN,dobj,pobj,PRP,NN,4,1
7662,24553.0,31,named,5,17,7,-10,16,23,-12,2,Fidelity,Ellyn A. McColgan,ORGANIZATION,PERSON-PERSON-PERSON,PROPN,PROPN-PROPN-PROPN,poss,compound-compound-oprd,NNP,NNP-NNP-NNP,5,1
7663,24557.0,18,died,14,14,12,-2,13,5,0,-2,he,minister,PERSON,TITLE,PRON,NOUN,nsubj,appos,PRP,NN,1,1
7664,44183.0,20,considered,13,13,5,-8,12,14,0,-8,he,minister,PERSON,TITLE,PRON,NOUN,nsubj,appos,PRP,NN,2,1
7665,24560.0,25,said,22,9,24,15,8,0,13,2,Czech National Bank,Sunday,ORGANIZATION-ORGANIZATION-ORGANIZATION,DATE,PROPN-PROPN-PROPN,PROPN,compound-compound-compound,npadvmod,NNP-NNP-NNP,NNP,4,1
7666,24566.0,19,leave,6,12,17,5,11,1,-6,11,Option One,"1,400",ORGANIZATION-ORGANIZATION,NUMBER,PROPN-NUM,NUM,nmod-nummod,nummod,NNP-CD,CD,7,1
7667,24569.0,21,offered,17,4,8,4,3,12,13,-9,M. Enkhbold,chairman,PERSON-PERSON,TITLE,PROPN-PROPN,NOUN,compound-nsubj,appos,NNP-NNP,NN,2,1
7668,31644.0,34,won,10,20,25,5,19,8,-10,15,M. Enkhbold,chairman,PERSON-PERSON,TITLE,PROPN-PROPN,NOUN,compound-dobj,appos,NNP-NNP,NN,2,1
7669,34815.0,35,said,15,1,5,4,0,29,14,-10,M. Enkhbold,chairman,PERSON-PERSON,TITLE,PROPN-PROPN,NOUN,compound-nsubj,appos,NNP-NNP,NN,2,1
7670,43627.0,33,said,13,1,4,3,0,28,12,-9,M. Enkhbold,chairman,PERSON-PERSON,TITLE,PROPN-PROPN,NOUN,compound-nsubj,appos,NNP-NNP,NN,2,1
7671,24570.0,29,said,12,24,23,-1,23,5,-12,11,Multidisciplinary Association for Psychedelic Studies,Massachusetts-based,ORGANIZATION-ORGANIZATION-ORGANIZATION-ORGANIZATION-ORGANIZATION,STATE_OR_PROVINCE,PROPN-PROPN-ADP-PROPN-PROPN,PROPN,compound-dobj-prep-compound-pobj,amod,NNP-NNP-IN-NNP-NNPS,NNP,2,1
7672,24578.0,35,appealed,12,8,11,3,7,23,4,-1,MECO,Taipei,ORGANIZATION,CITY,PROPN,PROPN,compound,pobj,NNP,NNP,-1,1
7673,36019.0,38,said,20,34,37,3,33,0,-14,17,MECO,Taipei,ORGANIZATION,CITY,PROPN,PROPN,compound,pobj,NNP,NNP,-1,1
7674,24586.0,36,gave,5,16,33,17,15,2,-11,28,Ali Akbar Salehi,caretaker,PERSON-PERSON-PERSON,TITLE,PROPN-PROPN-PROPN,NOUN,compound-compound-nsubj,nmod,NNP-NNP-NNP,NN,2,1
7675,24589.0,42,said,6,9,14,5,8,27,-3,8,Abu Zubaydah,Palestinian,PERSON-PERSON,NATIONALITY,PROPN-PROPN,PROPN,compound-nsubjpass,appos,NNP-NNP,NNP,3,1
7676,37149.0,51,was,5,4,14,10,3,36,1,9,Abu Zubaydah,Palestinian,PERSON-PERSON,NATIONALITY,PROPN-PROPN,PROPN,compound-nsubj,appos,NNP-NNP,NNP,5,1
7677,24590.0,9,Feb.,0,5,1,-4,4,7,-5,1,George Kennedy,Feb. 18,PERSON-PERSON,DATE-DATE,PROPN-PROPN,PROPN-NUM,compound-nsubj,ROOT-nummod,NNP-NNP,NNP-CD,3,1
7678,24597.0,38,said,1,9,9,0,8,28,-8,8,Pentax,Pentax Corp.,ORGANIZATION,ORGANIZATION-ORGANIZATION,PROPN,PROPN-PROPN,nsubj,compound-pobj,NNP,NNP-NNP,0,1
7679,60818.0,49,said,40,3,3,0,2,45,37,-37,Pentax,Pentax Corp.,ORGANIZATION,ORGANIZATION-ORGANIZATION,PROPN,PROPN-PROPN,nsubj,compound-nsubj,NNP,NNP-NNP,0,1
7680,24598.0,30,Secretary,1,5,14,9,4,15,-4,13,Communist Party of China,Hu Jintao,ORGANIZATION-ORGANIZATION-ORGANIZATION-ORGANIZATION,PERSON-PERSON,PROPN-PROPN-ADP-PROPN,PROPN-PROPN,compound-pobj-prep-pobj,compound-nsubj,NNP-NNP-IN-NNP,NNP-NNP,-1,1
7681,24601.0,68,opposes,3,40,39,-1,39,28,-37,36,Justice and Equality Movement,Sudanese,ORGANIZATION-ORGANIZATION-ORGANIZATION-ORGANIZATION,COUNTRY,PROPN-CCONJ-PROPN-PROPN,PROPN,nmod-cc-conj-pobj,nmod,NNP-CC-NNP-NNP,NNP,1,1
7682,24605.0,38,said,33,19,28,9,18,9,14,-5,Iranian Revolutionary Guard-Quds Force,Iran,ORGANIZATION-ORGANIZATION-ORGANIZATION-ORGANIZATION,COUNTRY,ADJ-PROPN-PROPN-PROPN,PROPN,compound-compound-compound-pobj,pobj,JJ-NNP-NNPS-NNP,NNP,9,1
7683,24610.0,27,helped,1,1,26,25,0,0,0,25,Rothman,Calif.,PERSON,STATE_OR_PROVINCE,PROPN,PROPN,nsubj,appos,NNP,NNP,1,1
7684,24626.0,19,Telegram,4,6,11,5,5,7,-2,7,Alberto Gonzales,lawyer,PERSON-PERSON,TITLE,PROPN-PROPN,NOUN,compound-nsubj,attr,NNP-NNP,NN,3,1
7685,24634.0,31,TITLES,0,17,20,3,16,10,-17,20,minister,Revolutionary Armed Forces,PERSON,ORGANIZATION-ORGANIZATION-ORGANIZATION,NOUN,PROPN-PROPN-PROPN,appos,compound-compound-pobj,NN,NNP-NNP-NNPS,2,1
7686,24636.0,38,assured,10,9,2,-7,8,35,1,-8,DCR,Wendy Fox,ORGANIZATION,PERSON-PERSON,PROPN,PROPN-PROPN,pobj,compound-nsubj,NNP,NNP-NNP,2,1
7687,24641.0,27,headed,5,5,26,21,4,0,0,21,she,Mass.,PERSON,STATE_OR_PROVINCE,PRON,PROPN,nsubj,appos,PRP,NNP,1,1
7688,43930.0,27,headed,5,5,26,21,4,0,0,21,she,Mass.,PERSON,STATE_OR_PROVINCE,PRON,PROPN,nsubj,appos,PRP,NNP,1,1
7689,24646.0,34,said,29,22,28,6,21,5,7,-1,Don Wildmon,chairman,PERSON-PERSON,TITLE,PROPN-PROPN,NOUN,compound-nsubj,conj,NNP-NNP,NN,3,1
7690,24649.0,34,seemed,3,24,13,-11,23,20,-21,10,he,68-year-old,PERSON,DURATION,PRON,NUM,nsubj,nsubj,PRP,CD,9,1
7691,47457.0,28,said,2,21,8,-13,20,19,-19,6,he,68-year-old,PERSON,DURATION,PRON,NUM,nsubj,pobj,PRP,CD,12,1
7692,59605.0,42,found,7,19,5,-14,18,36,-12,-2,he,68-year-old,PERSON,DURATION,PRON,NUM,nsubj,compound,PRP,CD,11,1
7693,24675.0,23,was,7,1,6,5,0,16,6,-1,Morgan,August,PERSON,DATE,PROPN,PROPN,nsubj,pobj,NNP,NNP,3,1
7694,24685.0,18,said,2,1,10,9,0,7,1,8,Don Wildmon,AFA,PERSON-PERSON,ORGANIZATION,PROPN-PROPN,PROPN,compound-nsubj,pobj,NNP-NNP,NNP,3,1
7695,24696.0,37,said,6,5,25,20,4,11,1,19,Lee Jye,Chinese,PERSON-PERSON,NATIONALITY,PROPN-PROPN,ADJ,compound-nsubj,amod,NNP-NNP,JJ,5,1
7696,24729.0,43,turned,7,1,27,26,0,15,6,20,Medina Hospital,Mogadishu,ORGANIZATION-ORGANIZATION,CITY,PROPN-PROPN,PROPN,compound-nsubj,pobj,NNP-NNP,NNP,2,1
7697,24738.0,39,eased,4,22,3,-19,21,35,-18,-1,Paavo Nurmi,23-year-old,PERSON-PERSON,DURATION,PROPN-PROPN,NUM,compound-dobj,amod,NNP-NNP,CD,5,1
7698,51400.0,39,put,1,28,4,-24,27,34,-27,3,Paavo Nurmi,23-year-old,PERSON-PERSON,DURATION,PROPN-PROPN,NUM,compound-conj,amod,NNP-NNP,CD,10,1
7699,24743.0,36,said,34,8,1,-7,7,34,26,-33,Organization of the Islamic Conference,Abdullah,ORGANIZATION-ORGANIZATION-ORGANIZATION-ORGANIZATION-ORGANIZATION,PERSON,PROPN-ADP-DET-PROPN-PROPN,PROPN,pobj-prep-det-compound-pobj,nsubj,NNP-IN-DT-NNP-NNP,NNP,6,1
7700,24745.0,49,dropped,7,43,47,4,42,1,-36,40,Free Market Foundation,FMF,ORGANIZATION-ORGANIZATION-ORGANIZATION,ORGANIZATION,PROPN-PROPN-PROPN,PROPN,compound-compound-pobj,compound,NNP-NNP-NNP,NNP,7,1
7701,24746.0,28,based,11,4,5,1,3,22,7,-6,he,murdered hostages,PERSON,CRIMINAL_CHARGE-CRIMINAL_CHARGE,PRON,VERB-NOUN,nsubj,acl-dobj,PRP,VBD-NNS,1,1
7702,24755.0,15,survived,2,1,14,13,0,0,1,12,She,Bernice,PERSON,PERSON,PRON,PROPN,nsubjpass,conj,PRP,NNP,2,1
7703,24757.0,35,said,17,31,19,-12,30,15,-14,2,MF Global,Richard Feltes,ORGANIZATION-ORGANIZATION,PERSON-PERSON,PROPN-PROPN,PROPN-PROPN,compound-pobj,compound-nsubj,NNP-NNP,NNP-NNP,7,1
7704,37926.0,30,said,12,26,14,-12,25,15,-14,2,MF Global,Richard Feltes,ORGANIZATION-ORGANIZATION,PERSON-PERSON,PROPN-PROPN,PROPN-PROPN,compound-pobj,compound-nsubj,NNP-NNP,NNP-NNP,5,1
7705,48584.0,32,said,14,28,16,-12,27,15,-14,2,MF Global,Richard Feltes,ORGANIZATION-ORGANIZATION,PERSON-PERSON,PROPN-PROPN,PROPN-PROPN,compound-pobj,compound-nsubj,NNP-NNP,NNP-NNP,7,1
7706,24760.0,37,said,19,24,5,-19,23,31,-5,-14,him,German,PERSON,NATIONALITY,PRON,ADJ,dobj,amod,PRP,JJ,8,1
7707,24764.0,21,said,3,13,1,-12,12,19,-10,-2,Salehi,IAEA,PERSON,ORGANIZATION,PROPN,PROPN,nsubj,compound,NNP,NNP,2,1
7708,24770.0,23,makes,3,1,19,18,0,3,2,16,ConAgra Foods Inc.,Hebrew National,ORGANIZATION-ORGANIZATION-ORGANIZATION,ORGANIZATION-ORGANIZATION,PROPN-PROPN-PROPN,ADJ-ADJ,compound-compound-nsubj,nmod-nmod,NNP-NNP-NNP,JJ-JJ,9,1
7709,24773.0,40,are,17,31,36,5,30,3,-14,19,ADB,Japan,ORGANIZATION,COUNTRY,PROPN,PROPN,nmod,pobj,NNP,NNP,5,1
7710,24779.0,33,said,7,2,1,-1,1,31,5,-6,Sean Ross,Sgt.,PERSON-PERSON,TITLE,PROPN-PROPN,PROPN,compound-nsubj,compound,NNP-NNP,NNP,-1,1
7711,24782.0,33,appeared,5,5,3,-2,4,29,0,-2,she,actress,PERSON,TITLE,PRON,NOUN,nsubj,pobj,PRP,NN,1,1
7712,26770.0,26,had,20,12,2,-10,11,23,8,-18,she,actress,PERSON,TITLE,PRON,NOUN,nsubj,nsubj,PRP,NN,3,1
7713,24785.0,25,said,22,9,9,0,8,15,13,-13,Czech National Bank,Czech Republic,ORGANIZATION-ORGANIZATION-ORGANIZATION,COUNTRY-COUNTRY,PROPN-PROPN-PROPN,PROPN-PROPN,compound-compound-compound,compound-poss,NNP-NNP-NNP,NNP-NNP,0,1
7714,30247.0,31,became,10,3,3,0,2,27,7,-7,Czech National Bank,Czech Republic,ORGANIZATION-ORGANIZATION-ORGANIZATION,COUNTRY-COUNTRY,PROPN-PROPN-PROPN,PROPN-PROPN,compound-compound-pobj,compound-nsubjpass,NNP-NNP-NNP,NNP-NNP,0,1
7715,24792.0,31,Speculation,0,7,13,6,6,17,-7,13,Ipsco,Regina,ORGANIZATION,CITY,PROPN,PROPN,pobj,pobj,NNP,NNP,5,1
7716,24797.0,31,said,19,27,21,-6,26,9,-8,2,Madina Hospital,Dahir Mohamoud Mohammed,ORGANIZATION-ORGANIZATION,PERSON-PERSON-PERSON,PROPN-PROPN,PROPN-PROPN-PROPN,compound-pobj,compound-compound-nsubj,NNP-NNP,NNP-NNP-NNP,5,1
7717,24804.0,55,show,53,8,3,-5,7,51,45,-50,Kurnaz,Turk,PERSON,NATIONALITY,PROPN,PROPN,nsubj,npadvmod,NNP,NNP,1,1
7718,29954.0,25,is,1,1,5,4,0,19,0,4,Kurnaz,Turk,PERSON,NATIONALITY,PROPN,PROPN,nsubj,attr,NNP,NNP,2,1
7719,24818.0,43,said,24,27,26,-1,26,16,-3,2,Mamoor Khan,Maj.,PERSON-PERSON,TITLE,PROPN-PROPN,PROPN,compound-nsubj,compound,NNP-NNP,NNP,3,1
7720,24822.0,35,is,6,26,34,8,25,0,-20,28,Covidien PLC,Mansfield,ORGANIZATION-ORGANIZATION,CITY,PROPN-PROPN,PROPN,compound-pobj,pobj,NNP-NNP,NNP,4,1
7721,40292.0,37,said,15,2,11,9,1,25,13,-4,Covidien PLC,Mansfield,ORGANIZATION-ORGANIZATION,CITY,PROPN-PROPN,PROPN,compound-pobj,pobj,NNP-NNP,NNP,3,1
7722,24844.0,76,Keli,1,7,12,5,6,63,-6,11,Taiwan Research Institute,China Academy of Social Science,ORGANIZATION-ORGANIZATION-ORGANIZATION,ORGANIZATION-ORGANIZATION-ORGANIZATION-ORGANIZATION-ORGANIZATION,PROPN-PROPN-PROPN,PROPN-PROPN-ADP-PROPN-PROPN,compound-compound-pobj,compound-pobj-prep-compound-pobj,NNP-NNP-NNP,NNP-NNP-IN-NNP-NNP,5,1
7723,30016.0,43,Keli,1,7,12,5,6,30,-6,11,Taiwan Research Institute,China Academy of Social Science,ORGANIZATION-ORGANIZATION-ORGANIZATION,ORGANIZATION-ORGANIZATION-ORGANIZATION-ORGANIZATION-ORGANIZATION,PROPN-PROPN-PROPN,PROPN-PROPN-ADP-PROPN-PROPN,compound-compound-pobj,compound-pobj-prep-compound-pobj,NNP-NNP-NNP,NNP-NNP-IN-NNP-NNP,5,1
7724,24863.0,52,said,31,45,47,2,44,4,-14,16,ADB,Regional and Sustainable Development Department,ORGANIZATION,ORGANIZATION-ORGANIZATION-ORGANIZATION-ORGANIZATION-ORGANIZATION,PROPN,PROPN-CCONJ-PROPN-PROPN-PROPN,poss,amod-cc-conj-compound-pobj,NNP,NNP-CC-NNP-NNP-NNP,2,1
7725,64162.0,36,said,20,29,31,2,28,4,-9,11,ADB,Regional and Sustainable Development Department,ORGANIZATION,ORGANIZATION-ORGANIZATION-ORGANIZATION-ORGANIZATION-ORGANIZATION,PROPN,PROPN-CCONJ-PROPN-PROPN-PROPN,poss,amod-cc-conj-compound-pobj,NNP,NNP-CC-NNP-NNP-NNP,2,1
7726,24864.0,17,Philippines-based,3,5,4,-1,4,12,-2,1,ADB,Philippines-based,ORGANIZATION,COUNTRY,PROPN,ADJ,compound,ROOT,NNP,JJ,1,1
7727,24871.0,79,survived,8,4,7,3,3,71,4,-1,his,Meskill,PERSON,PERSON,DET,PROPN,poss,nsubjpass,PRP$,NNP,5,1
7728,24872.0,25,was,4,1,24,23,0,0,3,20,His,star,PERSON,TITLE,DET,NOUN,poss,pobj,PRP$,NN,10,1
7729,24874.0,41,maintained,16,16,39,23,15,1,0,23,Gonzales,Justice Department,PERSON,ORGANIZATION-ORGANIZATION,PROPN,PROPN-PROPN,nsubj,compound-pobj,NNP,NNP-NNP,8,1
7730,28511.0,37,indicates,14,16,35,19,15,1,-2,21,Gonzales,Justice Department,PERSON,ORGANIZATION-ORGANIZATION,PROPN,PROPN-PROPN,nsubj,compound-dobj,NNP,NNP-NNP,4,1
7731,24879.0,36,have,3,10,13,3,9,22,-7,10,USA HD,Universal HD,ORGANIZATION-ORGANIZATION,ORGANIZATION-ORGANIZATION,PROPN-PROPN,PROPN-PROPN,compound-conj,compound-conj,NNP-NNP,NNP-NNP,1,1
7732,24888.0,30,said,18,18,28,10,17,1,0,10,Chavez,Nancy Colmenares,PERSON,PERSON-PERSON,PROPN,PROPN-PROPN,nsubj,compound-pobj,NNP,NNP-NNP,6,1
7733,24890.0,37,skinny,1,21,15,-6,20,21,-20,14,NFC South,Saints,ORGANIZATION-ORGANIZATION,ORGANIZATION,PROPN-PROPN,PROPN,compound-pobj,nsubj,NNP-NNP,NNPS,2,1
7734,25930.0,26,refused,2,14,11,-3,13,14,-12,9,NFC South,Saints,ORGANIZATION-ORGANIZATION,ORGANIZATION,PROPN-PROPN,PROPN,compound-dobj,nsubj,NNP-NNP,NNPS,1,1
7735,47010.0,23,Dec.,0,21,12,-9,20,10,-21,12,NFC South,Saints,ORGANIZATION-ORGANIZATION,ORGANIZATION,PROPN-PROPN,PROPN,compound-pobj,pobj,NNP-NNP,NNPS,7,1
7736,53969.0,33,clinched,2,5,2,-3,4,30,-3,0,NFC South,Saints,ORGANIZATION-ORGANIZATION,ORGANIZATION,PROPN-PROPN,PROPN,compound-compound,nsubj,NNP-NNP,NNPS,2,1
7737,63662.0,31,is,11,10,3,-7,9,27,1,-8,NFC South,Saints,ORGANIZATION-ORGANIZATION,ORGANIZATION,PROPN-PROPN,PROPN,compound-nsubj,pobj,NNP-NNP,NNPS,4,1
7738,24897.0,31,became,9,9,14,5,8,16,0,5,Dodd,"Banking , Housing and Urban Affairs Committee",PERSON,ORGANIZATION-ORGANIZATION-ORGANIZATION-ORGANIZATION-ORGANIZATION-ORGANIZATION-ORGANIZATION,PROPN,PROPN-PUNCT-PROPN-CCONJ-PROPN-PROPN-PROPN,nsubj,nmod-punct-nmod-cc-compound-conj-pobj,NNP,"NNP-,-NNP-CC-NNP-NNPS-NNP",4,1
7739,24907.0,53,told,4,8,1,-7,7,51,-4,-3,his,Greenpeace,PERSON,ORGANIZATION,DET,NOUN,poss,compound,PRP$,NN,4,1
7740,24926.0,20,report,4,7,11,4,6,8,-3,7,Cathleen P. Black,president,PERSON-PERSON-PERSON,TITLE,PROPN-PROPN-PROPN,NOUN,compound-compound-pobj,appos,NNP-NNP-NNP,NN,3,1
7741,37548.0,46,said,22,4,8,4,3,37,18,-14,Cathleen P. Black,president,PERSON-PERSON-PERSON,TITLE,PROPN-PROPN-PROPN,NOUN,compound-compound-pobj,appos,NNP-NNP-NNP,NN,3,1
7742,53230.0,22,said,11,13,18,5,12,3,-2,7,Cathleen P. Black,president,PERSON-PERSON-PERSON,TITLE,PROPN-PROPN-PROPN,NOUN,compound-compound-nsubj,appos,NNP-NNP-NNP,NN,2,1
7743,65532.0,20,said,9,1,5,4,0,14,8,-4,Cathleen P. Black,president,PERSON-PERSON-PERSON,TITLE,PROPN-PROPN-PROPN,NOUN,compound-compound-nsubj,appos,NNP-NNP-NNP,NN,3,1
7744,24951.0,16,airlifted,5,1,15,14,0,0,4,10,Yoadimnadji,accident,PERSON,CAUSE_OF_DEATH,NOUN,NOUN,nsubjpass,dobj,NNS,NN,3,1
7745,24964.0,9,Ken,1,7,2,-5,6,6,-6,1,Crown Prosecution Service,Ken,ORGANIZATION-ORGANIZATION-ORGANIZATION,PERSON,PROPN-PROPN-PROPN,PROPN,compound-compound-pobj,ROOT,NNP-NNP-NNP,NNP,5,1
7746,24981.0,68,featured,22,37,45,8,36,22,-15,23,Chad White,movie star,PERSON-PERSON,TITLE-TITLE,PROPN-PROPN,NOUN-NOUN,compound-nmod,compound-nsubj,NNP-NNP,NN-NN,2,1
7747,24982.0,57,trying,47,19,7,-12,18,49,28,-40,Cathleen P. Black,Bloomberg,PERSON-PERSON-PERSON,ORGANIZATION,PROPN-PROPN-PROPN,PROPN,compound-compound-pobj,nsubj,NNP-NNP-NNP,NNP,8,1
7748,24983.0,28,said,20,14,8,-6,13,19,6,-12,US National Security Council,United States,ORGANIZATION-ORGANIZATION-ORGANIZATION-ORGANIZATION,COUNTRY-COUNTRY,PROPN-PROPN-PROPN-PROPN,PROPN-PROPN,compound-compound-compound-compound,compound-nsubj,NNP-NNP-NNP-NNP,NNP-NNP,8,1
7749,24992.0,54,shrugged,13,5,10,5,4,43,8,-3,U.S. National Security Council,Mike Hammer,ORGANIZATION-ORGANIZATION-ORGANIZATION-ORGANIZATION,PERSON-PERSON,PROPN-PROPN-PROPN-PROPN,PROPN-PROPN,compound-compound-compound-compound,compound-appos,NNP-NNP-NNP-NNP,NNP-NNP,3,1
7750,44466.0,31,denounced,21,1,6,5,0,24,20,-15,U.S. National Security Council,Mike Hammer,ORGANIZATION-ORGANIZATION-ORGANIZATION-ORGANIZATION,PERSON-PERSON,PROPN-PROPN-PROPN-PROPN,PROPN-PROPN,compound-compound-compound-compound,compound-nsubj,NNP-NNP-NNP-NNP,NNP-NNP,3,1
7751,24998.0,39,says,22,19,1,-18,18,37,3,-21,Detroit Medical Center,Khan,ORGANIZATION-ORGANIZATION-ORGANIZATION,PERSON,PROPN-PROPN-PROPN,PROPN,compound-compound-conj,nsubj,NNP-NNP-NNP,NNP,9,1
7752,25009.0,11,Ahearn,1,1,4,3,0,6,0,3,Pamela Ahearn,52,PERSON-PERSON,NUMBER,PROPN-PROPN,NUM,compound-ROOT,appos,NNP-NNP,CD,1,1
7753,43445.0,29,Ahearn,1,1,4,3,0,24,0,3,Pamela Ahearn,52,PERSON-PERSON,NUMBER,PROPN-PROPN,NUM,compound-ROOT,appos,NNP-NNP,CD,1,1
7754,25021.0,35,left,8,6,10,4,5,24,2,2,Ali Larijani,Tehran,PERSON-PERSON,LOCATION,PROPN-PROPN,PROPN,compound-appos,dobj,NNP-NNP,NNP,3,1
7755,38996.0,45,reported,42,7,33,26,6,11,35,-9,Ali Larijani,Tehran,PERSON-PERSON,LOCATION,PROPN-PROPN,PROPN,compound-appos,nsubj,NNP-NNP,NNP,8,1
7756,25027.0,33,Philip,1,2,13,11,1,19,-1,12,Philip,Cathay Pacific,PERSON,ORGANIZATION-ORGANIZATION,PROPN,PROPN-PROPN,ROOT,compound-compound,NNP,NNP-NNP,8,1
7757,25029.0,46,instituted,23,1,42,41,0,3,22,19,Thomas J Meskill,Delray Beach,PERSON-PERSON-PERSON,CITY-CITY,PROPN-PROPN-PROPN,PROPN-PROPN,compound-compound-nsubj,compound-pobj,NNP-NNP-NNP,NNP-NNP,5,1
7758,25040.0,24,approved,4,20,2,-18,19,21,-16,-2,Samsung,Roh Moo-hyun,ORGANIZATION,PERSON-PERSON,PROPN,PROPN-PROPN,amod,compound-nsubj,NNP,NNP-NNP,10,1
7759,25079.0,29,returned,7,13,10,-3,12,18,-6,3,his,Austria,PERSON,COUNTRY,DET,PROPN,poss,pobj,PRP$,NNP,2,1
7760,25080.0,51,is,44,44,50,6,43,0,0,6,Dodd,committee,PERSON,ORGANIZATION,PROPN,NOUN,nsubj,pobj,NNP,NN,1,1
7761,25081.0,25,is,1,9,1,-8,8,23,-8,0,International Monetary Fund,Bio-Tchane,ORGANIZATION-ORGANIZATION-ORGANIZATION,PERSON,PROPN-PROPN-PROPN,NOUN,compound-compound-pobj,nsubj,NNP-NNP-NNP,NN,6,1
7762,25083.0,30,announced,8,6,1,-5,5,28,2,-7,Hindalco Industries,Indian,ORGANIZATION-ORGANIZATION,COUNTRY,PROPN-PROPN,ADJ,compound-compound,amod,NNP-NNPS,JJ,2,1
7763,25085.0,39,said,18,36,2,-34,35,36,-18,-16,Highland Capital Partners,He,ORGANIZATION-ORGANIZATION-ORGANIZATION,PERSON,PROPN-PROPN-PROPN,PRON,compound-compound-pobj,nsubj,NNP-NNP-NNPS,PRP,9,1
7764,25086.0,14,turned,2,1,9,8,0,4,1,7,Malia Obama,her,PERSON-PERSON,PERSON,PROPN-PROPN,DET,compound-nsubj,poss,NNP-NNP,PRP$,3,1
7765,25088.0,35,NY-HOTLINE-MISTAKES,0,7,21,14,6,13,-7,21,OBIT-KOLLEK,Teddy Kollek,PERSON,PERSON-PERSON,PROPN,PROPN-PROPN,compound,compound-pobj,NNP,NNP-NNP,-1,1
7766,25092.0,15,dies,12,3,2,-1,2,12,9,-10,Parren Mitchell,Rep.,PERSON-PERSON,TITLE,PROPN-PROPN,PROPN,compound-nsubj,compound,NNP-NNP,NNP,1,1
7767,25097.0,42,said,5,1,3,2,0,38,4,-2,TSE,Carlos Ayres Britto,ORGANIZATION,PERSON-PERSON-PERSON,PROPN,PROPN-PROPN-PROPN,compound,compound-compound-nsubj,NNP,NNP-NNP-NNP,1,1
7768,30733.0,42,said,5,1,3,2,0,38,4,-2,TSE,Carlos Ayres Britto,ORGANIZATION,PERSON-PERSON-PERSON,PROPN,PROPN-PROPN-PROPN,compound,compound-compound-nsubj,NNP,NNP-NNP-NNP,1,1
7769,25103.0,11,Deaver,3,3,6,3,2,4,0,3,Michael Deaver,chief of staff,PERSON-PERSON,TITLE-TITLE-TITLE,PROPN-PROPN,NOUN-ADP-NOUN,compound-ROOT,appos-prep-pobj,NNP-NNP,NN-IN-NN,2,1
7770,66037.0,55,said,33,35,39,4,34,15,-2,6,Michael Deaver,chief of staff,PERSON-PERSON,TITLE-TITLE-TITLE,PROPN-PROPN,NOUN-ADP-NOUN,compound-nsubj,appos-prep-pobj,NNP-NNP,NN-IN-NN,2,1
7771,25149.0,24,announced,2,1,18,17,0,5,1,16,Blackburn Rovers,Premier League,ORGANIZATION-ORGANIZATION,ORGANIZATION-ORGANIZATION,PROPN-PROPN,PROPN-PROPN,compound-nsubj,compound-compound,NNP-NNP,NNP-NNP,7,1
7772,25151.0,31,credited,7,15,22,7,14,8,-8,15,Dent,special counsel,PERSON,TITLE-TITLE,PROPN,ADJ-NOUN,nsubjpass,amod-pobj,NNP,JJ-NN,5,1
7773,25159.0,10,am,1,7,9,2,6,0,-6,8,Adam,Allie,PERSON,PERSON,PROPN,PROPN,pobj,conj,NNP,NNP,5,1
7774,25160.0,29,said,18,27,20,-7,26,8,-9,2,MF Global,James F. O'Sullivan,ORGANIZATION-ORGANIZATION,PERSON-PERSON-PERSON,PROPN-PROPN,PROPN-PROPN-PROPN,compound-pobj,compound-compound-nsubj,NNP-NNP,NNP-NNP-NNP,5,1
7775,27631.0,32,said,21,30,23,-7,29,8,-9,2,MF Global,James F. O'Sullivan,ORGANIZATION-ORGANIZATION,PERSON-PERSON-PERSON,PROPN-PROPN,PROPN-PROPN-PROPN,compound-pobj,compound-compound-nsubj,NNP-NNP,NNP-NNP-NNP,5,1
7776,30343.0,31,said,24,22,15,-7,21,15,2,-9,MF Global,James F. O'Sullivan,ORGANIZATION-ORGANIZATION,PERSON-PERSON-PERSON,PROPN-PROPN,PROPN-PROPN-PROPN,compound-pobj,compound-compound-nsubj,NNP-NNP,NNP-NNP-NNP,5,1
7777,55962.0,25,said,14,23,16,-7,22,8,-9,2,MF Global,James F. O'Sullivan,ORGANIZATION-ORGANIZATION,PERSON-PERSON-PERSON,PROPN-PROPN,PROPN-PROPN-PROPN,compound-pobj,compound-compound-nsubj,NNP-NNP,NNP-NNP-NNP,5,1
7778,25172.0,6,died,2,1,5,4,0,0,1,3,Her,2006,PERSON,DATE,DET,NUM,poss,pobj,PRP$,CD,2,1
7779,25178.0,36,told,5,2,4,2,1,31,3,-1,ICG,Sidney Jones,ORGANIZATION,PERSON-PERSON,PROPN,PROPN-PROPN,poss,compound-nsubj,NNP,NNP-NNP,2,1
7780,25183.0,34,made,23,12,8,-4,11,25,11,-15,Communist Party of China,Standing Committee,ORGANIZATION-ORGANIZATION-ORGANIZATION-ORGANIZATION,ORGANIZATION-ORGANIZATION,PROPN-PROPN-ADP-PROPN,PROPN-PROPN,compound-pobj-prep-pobj,compound-pobj,NNP-NNP-IN-NNP,NNP-NNP,2,1
7781,25184.0,29,said,3,10,13,3,9,15,-7,10,he,cancer,PERSON,CAUSE_OF_DEATH,PRON,NOUN,nsubj,dobj,PRP,NN,1,1
7782,25185.0,46,moved,4,17,12,-5,16,33,-13,8,her,Syracuse,PERSON,CITY,DET,PROPN,poss,pobj,PRP$,NNP,3,1
7783,25193.0,39,urged,12,24,17,-7,23,21,-12,5,she,his,PERSON,PERSON,PRON,DET,nsubj,poss,PRP,PRP$,4,1
7784,38757.0,33,involving,3,26,20,-6,25,12,-23,17,she,his,PERSON,PERSON,PRON,DET,nsubj,poss,PRP,PRP$,7,1
7785,25197.0,61,Genetics,1,58,37,-21,57,23,-57,36,American Psychiatric Association,Paul Fink,ORGANIZATION-ORGANIZATION-ORGANIZATION,PERSON-PERSON,PROPN-PROPN-PROPN,PROPN-PROPN,compound-compound-pobj,compound-nsubj,NNP-NNP-NNP,NNP-NNP,6,1
7786,25201.0,15,D,6,3,9,6,2,5,3,3,John F. Kerry,MA,PERSON-PERSON-PERSON,STATE_OR_PROVINCE,PROPN-PROPN-PROPN,PROPN,compound-compound-compound,compound,NNP-NNP-NNP,NNP,3,1
7787,25204.0,14,born,2,1,5,4,0,8,1,3,Millender-McDonald,"Sept. 7 , 1938",PERSON,DATE-DATE-DATE-DATE,PROPN,PROPN-NUM-PUNCT-NUM,nsubjpass,pobj-nummod-punct-nummod,NNP,"NNP-CD-,-CD",3,1
7788,25206.0,27,received,9,9,4,-5,8,22,0,-5,she,Georgetown Visitation Preparatory School,PERSON,ORGANIZATION-ORGANIZATION-ORGANIZATION-ORGANIZATION,PRON,PROPN-PROPN-PROPN-PROPN,nsubj,compound-compound-compound-pobj,PRP,NNP-NNP-NNP-NNP,5,1
7789,25207.0,28,been,24,7,1,-6,6,26,17,-23,Fidelity Investments,Blackstone,ORGANIZATION-ORGANIZATION,ORGANIZATION,PROPN-PROPN,PROPN,compound-nsubj,poss,NNP-NNPS,NNP,3,1
7790,25215.0,52,paid,8,49,30,-19,48,21,-41,22,Founders Asset Management,Fyffes,ORGANIZATION-ORGANIZATION-ORGANIZATION,PERSON,PROPN-PROPN-PROPN,PROPN,compound-compound-conj,compound,NNP-NNP-NNP,NNP,12,1
7791,25228.0,23,said,8,10,16,6,9,6,-2,8,Chris Simcox,leader,PERSON-PERSON,TITLE,PROPN-PROPN,NOUN,compound-nsubj,appos,NNP-NNP,NN,3,1
7792,25229.0,32,Association,3,3,2,-1,2,29,0,-1,Multidisciplinary Association for Psychedelic Studies,California-based,ORGANIZATION-ORGANIZATION-ORGANIZATION-ORGANIZATION-ORGANIZATION,STATE_OR_PROVINCE,PROPN-PROPN-ADP-PROPN-PROPN,PROPN,compound-ROOT-prep-compound-pobj,compound,NNP-NNP-IN-NNP-NNPS,NNP,1,1
7793,25233.0,48,welcomed,14,19,40,21,18,7,-5,26,Royal Caribbean International,Rhapsody of the Seas,ORGANIZATION-ORGANIZATION-ORGANIZATION,ORGANIZATION-ORGANIZATION-ORGANIZATION-ORGANIZATION,PROPN-PROPN-PROPN,PROPN-ADP-DET-PROPN,compound-compound-pobj,appos-prep-det-pobj,NNP-NNP-NNP,NNP-IN-DT-NNPS,12,1
7794,25237.0,38,automakers,1,25,20,-5,24,17,-24,19,FAW,China First Automobile Works,ORGANIZATION,ORGANIZATION-ORGANIZATION-ORGANIZATION-ORGANIZATION,PROPN,PROPN-PROPN-PROPN-PROPN,compound,compound-compound-compound-pobj,NNP,NNP-NNP-NNP-NNPS,5,1
7795,25251.0,42,said,25,35,27,-8,34,14,-10,2,Saint Anselm College,Dante Scala,ORGANIZATION-ORGANIZATION-ORGANIZATION,PERSON-PERSON,PROPN-PROPN-PROPN,PROPN-PROPN,compound-compound-pobj,compound-nsubj,NNP-NNP-NNP,NNP-NNP,5,1
7796,25252.0,29,makes,3,2,1,-1,1,27,1,-2,Justin Theroux,Actor,PERSON-PERSON,TITLE,PROPN-PROPN,PROPN,compound-nsubj,compound,NNP-NNP,NNP,1,1
7797,32803.0,41,Weinstein/Genius,0,14,13,-1,13,27,-14,13,Justin Theroux,Actor,PERSON-PERSON,TITLE,PROPN-PROPN,PROPN,compound-nsubj,compound,NNP-NNP,NNP,6,1
7798,33189.0,14,Theroux,2,2,1,-1,1,12,0,-1,Justin Theroux,Actor,PERSON-PERSON,TITLE,PROPN-PROPN,PROPN,compound-ROOT,compound,NNP-NNP,NNP,1,1
7799,25261.0,12,survives,9,1,11,10,0,0,8,2,His,him,PERSON,PERSON,DET,PRON,poss,dobj,PRP$,PRP,2,1
7800,25266.0,66,said,13,10,2,-8,9,63,3,-11,R Nicholas Burns,US,PERSON-PERSON-PERSON,ORGANIZATION,PROPN-PROPN-PROPN,PROPN,compound-compound-appos,compound,NNP-NNP-NNP,NNP,2,1
7801,26007.0,53,said,20,1,7,6,0,45,19,-13,R Nicholas Burns,US,PERSON-PERSON-PERSON,ORGANIZATION,PROPN-PROPN-PROPN,PROPN,compound-compound-nsubj,compound,NNP-NNP-NNP,NNP,2,1
7802,25272.0,16,earned,9,11,14,3,10,1,-2,5,Meskill,Tough Tommy,PERSON,PERSON-PERSON,PROPN,PROPN-PROPN,dative,compound-appos,NNP,NNP-NNP,2,1
7803,25283.0,29,died,16,2,1,-1,1,27,14,-15,Juanita Millender-McDonald,US,PERSON-PERSON,NATIONALITY,PROPN-PROPN,PROPN,compound-nsubj,compound,NNP-NNP,NNP,2,1
7804,25289.0,32,said,30,29,15,-14,28,16,1,-15,Nicholas Burns,Europe,PERSON-PERSON,LOCATION,PROPN-PROPN,PROPN,compound-nsubj,pobj,NNP-NNP,NNP,10,1
7805,25302.0,38,said,3,29,11,-18,28,26,-26,8,Gunners,http://arsenaltomcom,ORGANIZATION,URL,PROPN,X,pobj,appos,NNPS,ADD,5,1
7806,25306.0,49,Crisp,1,1,6,5,0,42,0,5,Mary Crisp,GOP Official,PERSON-PERSON,TITLE-TITLE,PROPN-PROPN,PROPN-PROPN,compound-ROOT,compound-appos,NNP-NNP,NNP-NNP,1,1
7807,25310.0,31,arrived,15,15,8,-7,14,22,0,-7,McNair,Chicago,PERSON,CITY,PROPN,PROPN,nsubj,pobj,NNP,NNP,3,1
7808,25329.0,20,said,18,15,5,-10,14,14,3,-13,Chen,executive,PERSON,TITLE,PROPN,NOUN,dobj,nsubj,NNP,NN,2,1
7809,25361.0,15,led,1,1,3,2,0,11,0,2,He,Juventus,PERSON,ORGANIZATION,PRON,PROPN,nsubj,dobj,PRP,NNP,1,1
7810,25375.0,24,Shepard,1,9,14,5,8,9,-8,13,Focus Action,he,ORGANIZATION-ORGANIZATION,ORGANIZATION,PROPN-PROPN,PRON,compound-compound,nsubj,NNP-NNP,PRP,2,1
7811,25384.0,32,survived,7,6,18,12,5,13,1,11,he,Elva Corrales,PERSON,PERSON-PERSON,PRON,PROPN-PROPN,nsubjpass,compound-conj,PRP,NNP-NNP,7,1
7812,25385.0,27,Myers,2,1,3,2,0,23,1,1,Dee Dee Myers,Myers,PERSON-PERSON-PERSON,PERSON,PROPN-PROPN-PROPN,PROPN,compound-compound-ROOT,nsubj,NNP-NNP-NNP,NNP,2,1
7813,48701.0,83,expected,3,65,22,-43,64,60,-62,19,Dee Dee Myers,Myers,PERSON-PERSON-PERSON,PERSON,PROPN-PROPN-PROPN,PROPN,compound-compound-nsubj,dobj,NNP-NNP-NNP,NNP,7,1
7814,25396.0,22,grew,9,9,19,10,8,2,0,10,Deaver,Mojave,PERSON,LOCATION,PROPN,PROPN,nsubj,pobj,NNP,NNP,4,1
7815,25405.0,33,said,22,32,24,-8,31,8,-10,2,ABA,Kenneth Clayton,ORGANIZATION,PERSON-PERSON,NOUN,PROPN-PROPN,pobj,compound-nsubj,NN,NNP-NNP,4,1
7816,25412.0,25,sought,4,7,14,7,6,10,-3,10,Mark Buse,director,PERSON-PERSON,TITLE,PROPN-PROPN,NOUN,compound-dobj,appos,NNP-NNP,NN,2,1
7817,52802.0,50,earned,33,1,12,11,0,37,32,-21,Mark Buse,director,PERSON-PERSON,TITLE,PROPN-PROPN,NOUN,compound-nsubj,attr,NNP-NNP,NN,4,1
7818,25420.0,30,assembling,11,21,7,-14,20,22,-10,-4,Christopher Dodd,chairman,PERSON-PERSON,TITLE,PROPN-PROPN,NOUN,compound-nsubj,appos,NNP-NNP,NN,5,1
7819,37424.0,34,said,12,11,10,-1,10,23,1,-2,Christopher Dodd,chairman,PERSON-PERSON,TITLE,PROPN-PROPN,NOUN,compound-nsubj,compound,NNP-NNP,NN,1,1
7820,43637.0,42,worked,20,6,11,5,5,30,14,-9,Christopher Dodd,chairman,PERSON-PERSON,TITLE,PROPN-PROPN,NOUN,compound-pobj,appos,NNP-NNP,NN,1,1
7821,50372.0,29,said,14,2,8,6,1,20,12,-6,Christopher Dodd,chairman,PERSON-PERSON,TITLE,PROPN-PROPN,NOUN,compound-nsubj,appos,NNP-NNP,NN,2,1
7822,60310.0,45,said,30,33,39,6,32,5,-3,9,Christopher Dodd,chairman,PERSON-PERSON,TITLE,PROPN-PROPN,NOUN,compound-nsubj,conj,NNP-NNP,NN,3,1
7823,25421.0,24,decided,7,5,2,-3,4,21,2,-5,Spencer Pratt,reality TV star,PERSON-PERSON,TITLE-TITLE-TITLE,PROPN-PROPN,NOUN-NOUN-NOUN,compound-nsubj,compound-compound-compound,NNP-NNP,NN-NN-NN,2,1
7824,25428.0,41,said,38,8,7,-1,7,33,30,-31,Hu Sheng-cheng,Chairman,PERSON-PERSON,TITLE,PROPN-PROPN,PROPN,compound-nsubjpass,compound,NNP-NNP,NNP,2,1
7825,31297.0,74,Dec,2,24,23,-1,23,50,-22,21,Hu Sheng-cheng,Chairman,PERSON-PERSON,TITLE,PROPN-PROPN,PROPN,compound-nsubj,compound,NNP-NNP,NNP,2,1
7826,32033.0,58,PLANS,7,54,53,-1,53,4,-47,46,Hu Sheng-cheng,Chairman,PERSON-PERSON,TITLE,PROPN-PROPN,PROPN,compound-nsubj,compound,NNP-NNP,NNP,1,1
7827,42798.0,27,is,1,23,22,-1,22,4,-22,21,Hu Sheng-cheng,Chairman,PERSON-PERSON,TITLE,PROPN-PROPN,PROPN,compound-nsubj,compound,NNP-NNP,NNP,2,1
7828,25435.0,31,spent,1,19,29,10,18,1,-18,28,Golden Baseball League,United States,ORGANIZATION-ORGANIZATION-ORGANIZATION,COUNTRY-COUNTRY,PROPN-PROPN-PROPN,PROPN-PROPN,compound-compound-pobj,compound-pobj,NNP-NNP-NNP,NNP-NNP,9,1
7829,36772.0,33,managed,4,20,31,11,19,1,-16,27,Golden Baseball League,United States,ORGANIZATION-ORGANIZATION-ORGANIZATION,COUNTRY-COUNTRY,PROPN-PROPN-PROPN,PROPN-PROPN,compound-compound-pobj,compound-pobj,NNP-NNP-NNP,NNP-NNP,9,1
7830,25449.0,41,said,6,8,4,-4,7,36,-2,-2,he,FBI,PERSON,ORGANIZATION,PRON,PROPN,nsubj,compound,PRP,NNP,3,1
7831,25451.0,37,said,19,11,15,4,10,21,8,-4,Berthold Huber,new,PERSON-PERSON,TITLE,PROPN-PROPN,ADJ,compound-dobj,amod,NNP-NNP,JJ,3,1
7832,25466.0,19,said,17,10,16,6,9,2,7,-1,Gillmor,Bradley Mascho,PERSON,PERSON-PERSON,PROPN,PROPN-PROPN,nsubj,compound-appos,NNP,NNP-NNP,7,1
7833,25475.0,12,wants,8,8,1,-7,7,10,0,-7,Trista,Jillian Harris,PERSON,PERSON-PERSON,PROPN,PROPN-PROPN,nsubj,compound-nsubj,NNP,NNP-NNP,2,1
7834,25478.0,21,recruit,5,18,17,-1,17,3,-13,12,Old Lane,his,ORGANIZATION-ORGANIZATION,PERSON,PROPN-PROPN,DET,compound-compound,poss,NNP-NNP,PRP$,1,1
7835,25499.0,13,was,8,1,6,5,0,6,7,-2,Her,Matilda Emery,PERSON,PERSON-PERSON,DET,PROPN-PROPN,poss,compound-appos,PRP$,NNP-NNP,1,1
7836,25500.0,33,alleged,18,7,14,7,6,18,11,-4,Scorpions,Johannesburg,ORGANIZATION,CITY,PROPN,PROPN,pobj,dobj,NNPS,NNP,4,1
7837,25515.0,30,died,2,2,25,23,1,4,0,23,Goodman,1972,PERSON,DATE,PROPN,NUM,poss,pobj,NNP,CD,2,1
7838,25530.0,4,Hawkins,1,1,3,2,0,0,0,2,Augustus Hawkins,86,PERSON-PERSON,NUMBER,PROPN-PROPN,NUM,compound-ROOT,nummod,NNP-NNP,CD,1,1
7839,25541.0,30,sue,1,13,5,-8,12,24,-12,4,John R Miller,National Beef,ORGANIZATION-ORGANIZATION-ORGANIZATION,PERSON-PERSON,PROPN-PROPN-PROPN,PROPN-PROPN,compound-compound-nsubj,compound-appos,NNP-NNP-NNP,NNP-NNP,5,1
7840,25551.0,18,oversees,1,1,5,4,0,12,0,4,Negroponte,CIA,PERSON,ORGANIZATION,PROPN,PROPN,nsubj,dobj,NNP,NNP,2,1
7841,25553.0,26,announced,3,11,3,-8,10,22,-8,0,IPSCO,Evraz,ORGANIZATION,ORGANIZATION,PROPN,PROPN,compound,nsubj,NNP,NNP,2,1
7842,53561.0,40,said,28,24,5,-19,23,34,4,-23,IPSCO,Evraz,ORGANIZATION,ORGANIZATION,PROPN,PROPN,dobj,appos,NNP,NNP,8,1
7843,25560.0,36,oversee,16,1,10,9,0,25,15,-6,Ferrara,editor,PERSON,TITLE,PROPN,NOUN,nsubj,attr,NNP,NN,4,1
7844,25568.0,28,was,1,14,1,-13,13,26,-13,0,Project Islamic Hope,He,ORGANIZATION-ORGANIZATION-ORGANIZATION,PERSON,PROPN-PROPN-PROPN,PRON,compound-compound-appos,nsubj,NNP-NNP-NNP,PRP,6,1
7845,25571.0,60,claimed,5,8,10,2,7,49,-3,5,Pratt,24,PERSON,NUMBER,PROPN,NUM,nsubj,appos,NNP,CD,3,1
7846,25620.0,36,said,3,34,33,-1,33,2,-31,30,EnergySolutions,Utah-based,ORGANIZATION,STATE_OR_PROVINCE,PROPN,ADJ,compound,compound,NNP,JJ,1,1
7847,47393.0,51,seeks,2,49,48,-1,48,2,-47,46,EnergySolutions,Utah-based,ORGANIZATION,STATE_OR_PROVINCE,PROPN,ADJ,compound,compound,NNP,JJ,1,1
7848,25629.0,29,born,4,27,1,-26,26,27,-23,-3,Tema Kaiser,Philip Mayer Kaiser,PERSON-PERSON,PERSON-PERSON-PERSON,PROPN-PROPN,PROPN-PROPN-PROPN,compound-conj,compound-compound-nsubjpass,NNP-NNP,NNP-NNP-NNP,8,1
7849,25631.0,20,Group,5,11,4,-7,10,15,-6,-1,Tyco Healthcare,Monitoring Solutions Group of Covidien,ORGANIZATION-ORGANIZATION,ORGANIZATION-ORGANIZATION-ORGANIZATION-ORGANIZATION-ORGANIZATION,PROPN-PROPN,PROPN-PROPN-PROPN-ADP-PROPN,compound-nsubj,conj-compound-ROOT-prep-pobj,NNP-NNP,NNP-NNPS-NNP-IN-NNP,3,1
7850,25632.0,51,split,3,25,33,8,24,17,-22,30,Robert Morgenthau,Navy,PERSON-PERSON,ORGANIZATION,PROPN-PROPN,PROPN,compound-pobj,compound,NNP-NNP,NNP,9,1
7851,25646.0,21,remains,14,7,11,4,6,9,7,-3,Arsenal,Harry Redknapp,ORGANIZATION,PERSON-PERSON,PROPN,PROPN-PROPN,pobj,compound-pobj,NNP,NNP-NNP,1,1
7852,25657.0,23,was,5,12,8,-4,11,14,-7,3,FAW,Jetta,ORGANIZATION,LOCATION,PROPN,PROPN,compound,attr,NNP,NNP,3,1
7853,25671.0,31,gained,2,20,29,9,19,1,-18,27,his,Michael Mitchell,PERSON,PERSON-PERSON,DET,PROPN-PROPN,poss,compound-conj,PRP$,NNP-NNP,6,1
7854,25685.0,47,urges,12,6,11,5,5,35,6,-1,International Crisis Group,wwwcrisisgrouporg,ORGANIZATION-ORGANIZATION-ORGANIZATION,URL,PROPN-PROPN-PROPN,NOUN,compound-compound-pobj,pobj,NNP-NNP-NNP,NN,5,1
7855,25694.0,21,was,1,10,1,-9,9,19,-9,0,Spelman College,Zinn,ORGANIZATION-ORGANIZATION,PERSON,PROPN-PROPN,PROPN,compound-pobj,nsubj,NNP-NNP,NNP,5,1
7856,25695.0,36,included,3,1,12,11,0,23,2,9,Her,USA Today,PERSON,ORGANIZATION-ORGANIZATION,DET,PROPN-PROPN,poss,compound-pobj,PRP$,NNP-NNP,6,1
7857,25712.0,42,said,39,1,30,29,0,11,38,-9,John D Negroponte,State Department,PERSON-PERSON-PERSON,ORGANIZATION-ORGANIZATION,PROPN-PROPN-PROPN,PROPN-PROPN,compound-compound-nsubj,compound-poss,NNP-NNP-NNP,NNP-NNP,5,1
7858,25714.0,30,christened,5,16,2,-14,15,27,-11,-3,her,songstress,PERSON,TITLE,DET,NOUN,poss,compound,PRP$,NN,7,1
7859,50311.0,29,release,9,11,6,-5,10,22,-2,-3,her,songstress,PERSON,TITLE,DET,NOUN,poss,compound,PRP$,NN,5,1
7860,25718.0,24,is,4,4,10,6,3,13,0,6,CNAC,China National Aviation Holding Co.,ORGANIZATION,ORGANIZATION-ORGANIZATION-ORGANIZATION-ORGANIZATION-ORGANIZATION,PROPN,PROPN-PROPN-PROPN-PROPN-PROPN,nsubj,compound-compound-compound-compound-subtok,NNP,NNP-NNP-NNP-NNP-NNP,4,1
7861,25735.0,53,admit,2,47,51,4,46,1,-45,49,Madoff Investment Securities,New York,ORGANIZATION-ORGANIZATION-ORGANIZATION,CITY-CITY,PROPN-PROPN-PROPN,PROPN-PROPN,compound-compound-pobj,compound-pobj,NNP-NNP-NNPS,NNP-NNP,3,1
7862,27719.0,63,announced,27,36,41,5,35,21,-9,14,Madoff Investment Securities,New York,ORGANIZATION-ORGANIZATION-ORGANIZATION,CITY-CITY,PROPN-PROPN-PROPN,PROPN-PROPN,compound-compound-compound,compound-pobj,NNP-NNP-NNPS,NNP-NNP,4,1
7863,25737.0,57,shocking,7,2,16,14,1,40,5,9,he,Bachelorette,PERSON,ORGANIZATION,PRON,PROPN,nsubj,pobj,PRP,NNP,5,1
7864,25753.0,46,said,23,25,35,10,24,10,-2,12,Carson,Department of Homeland Security,PERSON,ORGANIZATION-ORGANIZATION-ORGANIZATION-ORGANIZATION,PROPN,PROPN-ADP-PROPN-PROPN,nsubj,pobj-prep-compound-pobj,NNP,NNP-IN-NNP-NNP,5,1
7865,25754.0,61,shown,14,55,26,-29,54,34,-41,12,St. Anselm College,N.H.,ORGANIZATION-ORGANIZATION-ORGANIZATION,STATE_OR_PROVINCE,PROPN-PROPN-PROPN,PROPN,compound-compound-pobj,appos,NNP-NNP-NNP,NNP,-1,1
7866,25763.0,31,expressed,15,2,13,11,1,17,13,-2,Department of Conservation and Recreation,Esplanade,ORGANIZATION-ORGANIZATION-ORGANIZATION-ORGANIZATION-ORGANIZATION,ORGANIZATION,PROPN-ADP-PROPN-CCONJ-PROPN,PROPN,nsubj-prep-pobj-cc-conj,dobj,NNP-IN-NNP-CC-NNP,NNP,3,1
7867,25776.0,31,said,12,10,1,-9,9,29,2,-11,Clipper Fund,Davis,ORGANIZATION-ORGANIZATION,PERSON,PROPN-PROPN,PROPN,compound-pobj,nsubj,NNP-NNP,NNP,6,1
7868,25780.0,48,died,37,17,19,2,16,28,20,-18,her,Andrew,PERSON,PERSON,DET,PROPN,poss,appos,PRP$,NNP,1,1
7869,26235.0,48,died,37,17,19,2,16,28,20,-18,her,Andrew,PERSON,PERSON,DET,PROPN,poss,appos,PRP$,NNP,1,1
7870,36662.0,48,died,37,17,19,2,16,28,20,-18,her,Andrew,PERSON,PERSON,DET,PROPN,poss,appos,PRP$,NNP,1,1
7871,47850.0,29,interviewed,2,6,25,19,5,3,-4,23,her,Andrew,PERSON,PERSON,DET,PROPN,poss,pobj,PRP$,NNP,7,1
7872,25787.0,20,born,2,1,9,8,0,10,1,7,Forsberg,Ala.,PERSON,STATE_OR_PROVINCE,PROPN,PROPN,nsubjpass,appos,NNP,NNP,2,1
7873,25799.0,10,holds,4,2,8,6,1,1,2,4,United National Congress,15,ORGANIZATION-ORGANIZATION-ORGANIZATION,NUMBER,PROPN-PROPN-PROPN,NUM,compound-compound-nsubj,nummod,NNP-NNP-NNP,CD,3,1
7874,63501.0,34,won,12,9,16,7,8,17,3,4,United National Congress,15,ORGANIZATION-ORGANIZATION-ORGANIZATION,NUMBER,PROPN-PROPN-PROPN,NUM,compound-compound-appos,nummod,NNP-NNP-NNP,CD,5,1
7875,25801.0,34,profiled,12,15,14,-1,14,19,-3,2,Jennifer Dunn,Rep.,PERSON-PERSON,TITLE,PROPN-PROPN,PROPN,compound-dobj,compound,NNP-NNP,NNP,1,1
7876,30715.0,69,include,5,23,22,-1,22,46,-18,17,Jennifer Dunn,Rep.,PERSON-PERSON,TITLE,PROPN-PROPN,PROPN,compound-appos,compound,NNP-NNP,NNP,1,1
7877,54861.0,29,promoted,4,2,1,-1,1,27,2,-3,Jennifer Dunn,Rep.,PERSON-PERSON,TITLE,PROPN-PROPN,PROPN,compound-nsubjpass,compound,NNP-NNP,NNP,1,1
7878,25811.0,39,BE,3,36,29,-7,35,9,-33,26,Federal Election Commission,Michael E Toner,ORGANIZATION-ORGANIZATION-ORGANIZATION,PERSON-PERSON-PERSON,PROPN-PROPN-PROPN,PROPN-PROPN-PROPN,compound-compound-pobj,compound-compound-nsubj,NNP-NNP-NNP,NNP-NNP-NNP,5,1
7879,25815.0,21,seeks,9,9,3,-6,8,17,0,-6,she,Heff,PERSON,PERSON,PRON,PROPN,nsubj,poss,PRP,NNP,6,1
7880,25820.0,50,born,2,1,30,29,0,19,1,28,Millender-McDonald,California State University,PERSON,ORGANIZATION-ORGANIZATION-ORGANIZATION,PROPN,PROPN-PROPN-PROPN,nsubjpass,compound-compound-pobj,NNP,NNP-NNP-NNP,9,1
7881,25823.0,44,said,20,24,22,-2,23,21,-4,2,John Kerry,Democratic,PERSON-PERSON,ORGANIZATION,PROPN-PROPN,ADJ,compound-nsubj,compound,NNP-NNP,JJ,3,1
7882,25829.0,51,died,40,1,13,12,0,37,39,-27,Richard Nolte,ambassador,PERSON-PERSON,TITLE,PROPN-PROPN,NOUN,compound-nsubj,pobj,NNP-NNP,NN,4,1
7883,25843.0,39,negated,8,16,18,2,15,20,-8,10,Sox,Ozzie Guillen,ORGANIZATION,PERSON-PERSON,PROPN,PROPN-PROPN,compound,compound-nsubj,NNP,NNP-NNP,1,1
7884,25860.0,66,survived,12,2,7,5,1,58,10,-5,his,author,PERSON,TITLE,DET,NOUN,poss,appos,PRP$,NN,2,1
7885,45539.0,44,died,34,38,8,-30,37,35,-4,-26,his,author,PERSON,TITLE,DET,NOUN,poss,pobj,PRP$,NN,6,1
7886,25880.0,33,said,11,8,1,-7,7,31,3,-10,American Bankers Association,Jim Chessen,ORGANIZATION-ORGANIZATION-ORGANIZATION,PERSON-PERSON,PROPN-PROPN-PROPN,PROPN-PROPN,compound-compound-pobj,compound-nsubj,NNP-NNPS-NNP,NNP-NNP,4,1
7887,25882.0,13,is,1,1,8,7,0,4,0,7,Blackburn,Premier League,ORGANIZATION,ORGANIZATION-ORGANIZATION,PROPN,PROPN-PROPN,nsubj,compound-pobj,NNP,NNP-NNP,4,1
7888,25906.0,32,wanted,3,3,8,5,2,23,0,5,she,her,PERSON,PERSON,PRON,DET,nsubj,poss,PRP,PRP$,3,1
7889,25908.0,28,was,2,1,5,4,0,22,1,3,Michael Sandy,28-year-old,PERSON-PERSON,DURATION,PROPN-PROPN,NUM,compound-nsubj,amod,NNP-NNP,CD,5,1
7890,62888.0,12,was,2,4,11,7,3,0,-2,9,Michael Sandy,28-year-old,PERSON-PERSON,DURATION,PROPN-PROPN,NUM,compound-attr,appos,NNP-NNP,CD,3,1
7891,25911.0,30,is,1,17,4,-13,16,25,-16,3,him,private detective,PERSON,TITLE-TITLE,PRON,ADJ-NOUN,pobj,amod-attr,PRP,JJ-NN,5,1
7892,25915.0,31,ATLANTA,0,15,28,13,14,2,-15,28,he,American Idol,PERSON,ORGANIZATION-ORGANIZATION,PRON,PROPN-PROPN,nsubj,compound-pobj,PRP,NNP-NNP,5,1
7893,25916.0,12,have,3,11,8,-3,10,3,-8,5,AMA,Moslems,ORGANIZATION,MISC,PROPN,NOUN,pobj,dobj,NNP,NNS,2,1
7894,25918.0,40,posted,11,1,7,6,0,32,10,-4,Chris Simcox,nonprofit border watch group,PERSON-PERSON,ORGANIZATION-ORGANIZATION-ORGANIZATION-ORGANIZATION,PROPN-PROPN,ADJ-NOUN-NOUN-NOUN,compound-nsubj,amod-compound-compound-pobj,NNP-NNP,JJ-NN-NN-NN,5,1
7895,25923.0,31,said,24,10,1,-9,9,29,14,-23,Northwood University,Rollie Massimino,ORGANIZATION-ORGANIZATION,PERSON-PERSON,PROPN-PROPN,PROPN-PROPN,compound-pobj,compound-nsubj,NNP-NNP,NNP-NNP,3,1
7896,30782.0,49,said,19,11,1,-10,10,47,8,-18,Northwood University,Rollie Massimino,ORGANIZATION-ORGANIZATION,PERSON-PERSON,PROPN-PROPN,PROPN-PROPN,compound-poss,compound-nsubj,NNP-NNP,NNP-NNP,4,1
7897,25924.0,22,retired,1,1,8,7,0,13,0,7,He,two-star general,PERSON,TITLE-TITLE,PRON,ADJ-NOUN,nsubj,amod-pobj,PRP,JJ-NN,4,1
7898,25931.0,45,predict,1,17,23,6,16,21,-16,22,Watson,him,PERSON,PERSON,PROPN,PRON,nsubj,dobj,NNP,PRP,6,1
7899,25939.0,31,purchased,14,4,13,9,3,17,10,-1,National Christmas Tree Association,US,ORGANIZATION-ORGANIZATION-ORGANIZATION-ORGANIZATION,COUNTRY,PROPN-PROPN-PROPN-PROPN,PROPN,compound-compound-compound-pobj,compound,NNP-NNP-NNP-NNP,NNP,6,1
7900,25942.0,49,said,35,44,37,-7,43,11,-9,2,International Crisis Group,Nick Grono,ORGANIZATION-ORGANIZATION-ORGANIZATION,PERSON-PERSON,PROPN-PROPN-PROPN,PROPN-PROPN,compound-compound-pobj,compound-nsubj,NNP-NNP-NNP,NNP-NNP,5,1
7901,25956.0,34,said,17,1,6,5,0,27,16,-11,Li Jie,colonel,PERSON-PERSON,TITLE,PROPN-PROPN,NOUN,compound-nsubj,appos,NNP-NNP,NN,2,1
7902,25987.0,37,cites,10,21,1,-20,20,35,-11,-9,his,Knoxville,PERSON,CITY,DET,PROPN,poss,nsubj,PRP$,NNP,8,1
7903,25991.0,29,launched,7,7,7,0,6,21,0,0,Bernama,Bernama TV,ORGANIZATION,ORGANIZATION-ORGANIZATION,PROPN,PROPN-PROPN,nsubj,compound-dobj,NNP,NNP-NNP,0,1
7904,26008.0,36,hooked,18,30,22,-8,29,13,-12,4,him,Gucci,PERSON,ORGANIZATION,PRON,PROPN,dobj,compound,PRP,NNP,3,1
7905,26016.0,44,thought,16,5,2,-3,4,41,11,-14,Richard Perle,American,PERSON-PERSON,NATIONALITY,PROPN-PROPN,ADJ,compound-pobj,amod,NNP-NNP,JJ,3,1
7906,26019.0,27,WATERS,1,5,11,6,4,15,-4,10,DEE DEE MYERS,Press Secretary,PERSON-PERSON-PERSON,TITLE-TITLE,PROPN-PROPN-PROPN,PROPN-PROPN,npadvmod-compound-ROOT,compound-appos,NNP-NNP-NNP,NNP-NNP,2,1
7907,26045.0,33,said,12,10,6,-4,9,26,2,-6,Bill McAllister,governor,PERSON-PERSON,TITLE,PROPN-PROPN,NOUN,compound-appos,poss,NNP-NNP,NN,5,1
7908,57498.0,19,said,9,17,15,-2,16,3,-8,6,Bill McAllister,governor,PERSON-PERSON,TITLE,PROPN-PROPN,NOUN,compound-appos,pobj,NNP-NNP,NN,2,1
7909,26046.0,37,2007-08-17T16,0,7,18,11,6,18,-7,18,Carolyn Goodman,Andrew Goodman,PERSON-PERSON,PERSON-PERSON,PROPN-PROPN,PROPN-PROPN,compound-nsubj,compound-pobj,NNP-NNP,NNP-NNP,5,1
7910,26049.0,32,been,8,2,7,5,1,24,6,-1,Saint Anselm College,Daniel,ORGANIZATION-ORGANIZATION-ORGANIZATION,PERSON,PROPN-PROPN-PROPN,PROPN,compound-compound-pobj,nsubj,NNP-NNP-NNP,NNP,4,1
7911,26058.0,47,been,24,23,10,-13,22,36,1,-14,Bellecourt,real estate agent,PERSON,TITLE-TITLE-TITLE,PROPN,ADJ-NOUN-NOUN,nsubj,amod-conj-pobj,NNP,JJ-NN-NN,7,1
7912,26062.0,32,examining,3,23,30,7,22,1,-20,27,Murat Kurnaz,Turkish,PERSON-PERSON,NATIONALITY,PROPN-PROPN,ADJ,compound-pobj,amod,NNP-NNP,JJ,3,1
7913,50495.0,28,took,4,9,7,-2,8,20,-5,3,Murat Kurnaz,Turkish,PERSON-PERSON,NATIONALITY,PROPN-PROPN,ADJ,compound-dobj,amod,NNP-NNP,JJ,1,1
7914,26065.0,20,accepted,8,8,17,9,7,2,0,9,Dent,Republican National Committee,PERSON,ORGANIZATION-ORGANIZATION-ORGANIZATION,PROPN,PROPN-PROPN-PROPN,nsubj,compound-compound-pobj,NNP,NNP-NNP-NNP,4,1
7915,26072.0,42,hearing,7,25,21,-4,24,20,-18,14,he,Canada,PERSON,COUNTRY,PRON,PROPN,nsubj,pobj,PRP,NNP,5,1
7916,26091.0,34,supported,5,1,3,2,0,30,4,-2,Glover,60,PERSON,NUMBER,PROPN,NUM,nsubj,appos,NNP,CD,3,1
7917,26095.0,20,wants,6,8,5,-3,7,14,-2,-1,her,Juliette Binoche,PERSON,PERSON-PERSON,DET,PROPN-PROPN,poss,compound-nsubj,PRP$,NNP-NNP,2,1
7918,26109.0,23,dropped,5,1,17,16,0,5,4,12,The `` Hills '' villian,Stephanie Pratt,PERSON-PERSON-PERSON-PERSON-PERSON,PERSON-PERSON,DET-PUNCT-PROPN-PUNCT-NOUN,PROPN-PROPN,det-punct-nmod-punct-nsubj,compound-appos,DT-``-NNP-''-NN,NNP-NNP,6,1
7919,26110.0,36,worked,1,1,5,4,0,30,0,4,He,probation officer,PERSON,TITLE-TITLE,PRON,NOUN-NOUN,nsubj,compound-pobj,PRP,NN-NN,2,1
7920,26114.0,23,signed,4,18,13,-5,17,9,-14,9,KGB,Federal Security Service,ORGANIZATION,ORGANIZATION-ORGANIZATION-ORGANIZATION,PROPN,PROPN-PROPN-PROPN,poss,compound-compound-pobj,NNP,NNP-NNP-NNP,9,1
7921,46299.0,38,fled,1,24,11,-13,23,26,-23,10,KGB,Federal Security Service,ORGANIZATION,ORGANIZATION-ORGANIZATION-ORGANIZATION,PROPN,PROPN-PROPN-PROPN,pobj,compound-compound-dobj,NNP,NNP-NNP-NNP,3,1
7922,26115.0,34,served,5,1,8,7,0,25,4,3,Gregory,White House Correspondent,PERSON,TITLE-TITLE-TITLE,NOUN,PROPN-PROPN-NOUN,nsubj,compound-compound-pobj,NN,NNP-NNP-NN,6,1
7923,26129.0,53,includes,3,12,8,-4,11,44,-9,5,Hector Elizondo,Hispanic-Americans,PERSON-PERSON,NATIONALITY,PROPN-PROPN,PROPN,compound-conj,pobj,NNP-NNP,NNP,2,1
7924,26150.0,8,minister,2,5,1,-4,4,6,-3,-1,ElBaradei,German,PERSON,NATIONALITY,PROPN,ADJ,appos,amod,NNP,JJ,3,1
7925,26151.0,20,included,3,14,3,-11,13,16,-11,0,Itochu Corp,Tokyo,ORGANIZATION-ORGANIZATION,CITY,PROPN-PROPN,PROPN,compound-conj,pobj,NNP-NNP,NNP,2,1
7926,26155.0,43,designated,17,16,26,10,15,16,1,9,JEM,Mohammed Masood Azhar Alvi,ORGANIZATION,PERSON-PERSON-PERSON-PERSON,PROPN,PROPN-PROPN-PROPN-PROPN,pobj,compound-compound-compound-nsubjpass,NNP,NNP-NNP-NNP-NNP,4,1
7927,65524.0,43,designated,17,16,26,10,15,16,1,9,JEM,Mohammed Masood Azhar Alvi,ORGANIZATION,PERSON-PERSON-PERSON-PERSON,PROPN,PROPN-PROPN-PROPN-PROPN,poss,compound-compound-compound-nsubjpass,NNP,NNP-NNP-NNP-NNP,4,1
7928,26156.0,44,died,26,16,31,15,15,12,10,5,her,congestive heart failure,PERSON,CAUSE_OF_DEATH-CAUSE_OF_DEATH-CAUSE_OF_DEATH,DET,ADJ-NOUN-NOUN,poss,amod-compound-pobj,PRP$,JJ-NN-NN,7,1
7929,26165.0,29,noted,1,14,16,2,13,12,-13,15,Alcatel-Lucent,Serge Tchuruk,ORGANIZATION,PERSON-PERSON,PROPN,PROPN-PROPN,amod,compound-nsubj,NNP,NNP-NNP,2,1
7930,26166.0,33,acting,14,1,4,3,0,28,13,-10,Raul Castro,Fidel 's brother,PERSON-PERSON,PERSON-PERSON-PERSON,PROPN-PROPN,PROPN-PART-NOUN,compound-nsubj,poss-case-appos,NNP-NNP,NNP-POS-NN,3,1
7931,26177.0,27,worked,12,18,3,-15,17,23,-6,-9,she,Tony Ciccone,PERSON,PERSON-PERSON,PRON,PROPN-PROPN,nsubj,compound-appos,PRP,NNP-NNP,4,1
7932,26184.0,25,declined,6,22,1,-21,21,23,-16,-5,Tokyo Stock Exchange,Japan,ORGANIZATION-ORGANIZATION-ORGANIZATION,COUNTRY,PROPN-PROPN-PROPN,PROPN,compound-compound-pobj,poss,NNP-NNP-NNP,NNP,8,1
7933,38900.0,34,was,2,31,8,-23,30,25,-29,6,Tokyo Stock Exchange,Japan,ORGANIZATION-ORGANIZATION-ORGANIZATION,COUNTRY,PROPN-PROPN-PROPN,PROPN,compound-compound-pobj,pobj,NNP-NNP-NNP,NNP,6,1
7934,26191.0,34,Inc,1,1,4,3,0,29,0,3,MBIA,http://wwwmbiacom,ORGANIZATION,URL,PROPN,X,compound,appos,NNP,ADD,2,1
7935,28886.0,12,Inc,1,1,4,3,0,7,0,3,MBIA,http://wwwmbiacom,ORGANIZATION,URL,PROPN,X,compound,appos,NNP,ADD,2,1
7936,26194.0,27,made,11,8,1,-7,7,25,3,-10,Mainland Affairs Council,Tung Chen-yuan,ORGANIZATION-ORGANIZATION-ORGANIZATION,PERSON-PERSON,PROPN-PROPN-PROPN,PROPN-PROPN,compound-compound-pobj,compound-nsubj,NNP-NNPS-NNP,NNP-NNP,5,1
7937,67110.0,40,said,20,17,1,-16,16,38,3,-19,Mainland Affairs Council,Tung Chen-yuan,ORGANIZATION-ORGANIZATION-ORGANIZATION,PERSON-PERSON,PROPN-PROPN-PROPN,PROPN-PROPN,compound-compound-pobj,compound-nsubj,NNP-NNPS-NNP,NNP-NNP,3,1
7938,26195.0,26,urged,13,8,15,7,7,10,5,2,Metro Atlanta Chamber of Commerce,Grady,ORGANIZATION-ORGANIZATION-ORGANIZATION-ORGANIZATION-ORGANIZATION,PERSON,PROPN-PROPN-PROPN-ADP-PROPN,PROPN,compound-compound-pobj-prep-pobj,dobj,NNP-NNP-NNP-IN-NNP,NNP,6,1
7939,26199.0,15,served,1,1,8,7,0,6,0,7,He,executive director,PERSON,TITLE-TITLE,PRON,ADJ-NOUN,nsubj,amod-pobj,PRP,JJ-NN,1,1
7940,26203.0,30,said,22,28,24,-4,27,5,-6,2,IMF,William Murray,ORGANIZATION,PERSON-PERSON,PROPN,PROPN-PROPN,compound,compound-nsubj,NNP,NNP-NNP,1,1
7941,26213.0,38,fought,24,23,21,-2,22,16,1,-3,she,secretary,PERSON,TITLE,PRON,NOUN,nsubjpass,pobj,PRP,NN,2,1
7942,26215.0,54,met,20,16,1,-15,15,52,4,-19,CPC,Liu Yunshan,ORGANIZATION,PERSON-PERSON,PROPN,PROPN-PROPN,compound,compound-nsubj,NNP,NNP-NNP,2,1
7943,26236.0,30,died,2,22,10,-12,21,19,-20,8,she,54,PERSON,NUMBER,PRON,NUM,nsubj,pobj,PRP,CD,4,1
7944,26243.0,34,------------------------------,0,7,26,19,6,7,-7,26,AAA,Ateneo Alumni Association,ORGANIZATION,ORGANIZATION-ORGANIZATION-ORGANIZATION,PROPN,PROPN-PROPN-PROPN,compound,compound-compound-pobj,NNP,NNPS-NNPS-NNP,9,1
7945,43101.0,21,Be,1,13,7,-6,12,13,-12,6,AAA,Ateneo Alumni Association,ORGANIZATION,ORGANIZATION-ORGANIZATION-ORGANIZATION,PROPN,PROPN-PROPN-PROPN,compound,compound-compound-pobj,NNP,NNPS-NNPS-NNP,6,1
7946,26247.0,43,convicted,20,34,39,5,33,3,-14,19,fatal,New York City,PERSON,CITY-CITY-CITY,ADJ,PROPN-PROPN-PROPN,amod,compound-compound-compound,JJ,NNP-NNP-NNP,4,1
7947,26252.0,51,said,5,29,32,3,28,18,-24,27,KGB,London,ORGANIZATION,CITY,PROPN,PROPN,compound,pobj,NNP,NNP,3,1
7948,40421.0,30,increased,3,20,10,-10,19,19,-17,7,KGB,London,ORGANIZATION,CITY,PROPN,PROPN,compound,pobj,NNP,NNP,4,1
7949,57795.0,44,said,1,41,16,-25,40,27,-40,15,KGB,London,ORGANIZATION,CITY,PROPN,PROPN,compound,pobj,NNP,NNP,7,1
7950,26266.0,31,put,15,9,2,-7,8,28,6,-13,Citi 's European operations,Win Bischoff,ORGANIZATION-ORGANIZATION-ORGANIZATION-ORGANIZATION,PERSON-PERSON,PROPN-PART-ADJ-NOUN,PROPN-PROPN,poss-case-amod-pobj,compound-nsubjpass,NNP-POS-JJ-NNS,NNP-NNP,2,1
7951,26276.0,15,born,5,1,8,7,0,6,4,3,Henry Bradford Washburn Jr,"June 7 , 1910",PERSON-PERSON-PERSON-PERSON,DATE-DATE-DATE-DATE,PROPN-PROPN-PROPN-PROPN,PROPN-NUM-PUNCT-NUM,compound-compound-compound-nsubjpass,pobj-nummod-punct-nummod,NNP-NNP-NNP-NNP,"NNP-CD-,-CD",5,1
7952,26280.0,29,before,1,17,23,6,16,5,-16,22,his,professor,PERSON,TITLE,DET,NOUN,poss,pobj,PRP$,NN,6,1
7953,26283.0,25,Dies,3,9,6,-3,8,18,-6,3,his,95,PERSON,NUMBER,DET,NUM,poss,pobj,PRP$,CD,5,1
7954,26293.0,33,report,3,11,14,3,10,18,-8,11,diversity institute,Orlando,ORGANIZATION-ORGANIZATION,CITY,NOUN-NOUN,PROPN,compound-pobj,pobj,NN-NN,NNP,3,1
7955,26294.0,10,taken,2,1,8,7,0,1,1,6,He,Feb. 14,PERSON,DATE-DATE,PRON,PROPN-NUM,nsubjpass,pobj-nummod,PRP,NNP-CD,4,1
7956,26310.0,56,died,40,1,47,46,0,8,39,7,Richard H Nolte,Hanover,PERSON-PERSON-PERSON,CITY,PROPN-PROPN-PROPN,PROPN,compound-compound-nsubj,pobj,NNP-NNP-NNP,NNP,-1,1
7957,26321.0,20,was,7,1,4,3,0,15,6,-3,Her,Gaius C Bolin,PERSON,PERSON-PERSON-PERSON,DET,PROPN-PROPN-PROPN,poss,compound-compound-appos,PRP$,NNP-NNP-NNP,2,1
7958,26337.0,19,chose,1,1,4,3,0,14,0,3,Deaver,German,PERSON,NATIONALITY,PROPN,ADJ,nsubj,amod,NNP,JJ,2,1
7959,26339.0,36,succeeded,7,15,5,-10,14,30,-8,-2,Pentax Corp,Hoya Corp,ORGANIZATION-ORGANIZATION,ORGANIZATION-ORGANIZATION,PROPN-PROPN,PROPN-PROPN,compound-dobj,compound-nsubj,NNP-NNP,NNP-NNP,5,1
7960,64309.0,36,said,6,19,5,-14,18,30,-13,-1,Pentax Corp,Hoya Corp,ORGANIZATION-ORGANIZATION,ORGANIZATION-ORGANIZATION,PROPN-PROPN,PROPN-PROPN,compound-pobj,compound-nsubj,NNP-NNP,NNP-NNP,6,1
7961,26344.0,42,said,10,7,9,2,6,32,3,-1,CMA,David Wong,ORGANIZATION,PERSON-PERSON,PROPN,PROPN-PROPN,compound,compound-nsubj,NNP,NNP-NNP,1,1
7962,26345.0,23,worked,1,1,6,5,0,16,0,5,He,New York University,PERSON,ORGANIZATION-ORGANIZATION-ORGANIZATION,PRON,PROPN-PROPN-PROPN,nsubj,compound-compound-pobj,PRP,NNP-NNP-NNP,3,1
7963,26346.0,31,said,10,3,1,-2,2,29,7,-9,Carolyn Maloney,US,PERSON-PERSON,ORGANIZATION,PROPN-PROPN,PROPN,compound-nsubj,compound,NNP-NNP,NNP,1,1
7964,33643.0,35,introduced,4,3,1,-2,2,33,1,-3,Carolyn Maloney,US,PERSON-PERSON,NATIONALITY,PROPN-PROPN,PROPN,compound-nsubj,compound,NNP-NNP,NNP,1,1
7965,26354.0,58,include,1,11,49,38,10,8,-10,48,Adrienne Gude,Sarah Callaghan,PERSON-PERSON,PERSON-PERSON,PROPN-PROPN,PROPN-PROPN,compound-conj,compound-conj,NNP-NNP,NNP-NNP,5,1
7966,26355.0,47,thought,2,31,27,-4,30,19,-29,25,FMR Corp,Bob Reynolds,ORGANIZATION-ORGANIZATION,PERSON-PERSON,PROPN-PROPN,PROPN-PROPN,compound-nmod,compound-dobj,NNP-NNP,NNP-NNP,2,1
7967,26356.0,41,continue,20,1,8,7,0,32,19,-12,Abrams,host,PERSON,TITLE,PROPN,NOUN,nsubj,pobj,NNP,NN,3,1
7968,26362.0,24,Coroner,2,5,1,-4,4,22,-3,-1,G Gary Kirchner,Lancaster County,PERSON-PERSON-PERSON,CITY-CITY,PROPN-PROPN-PROPN,PROPN-PROPN,compound-compound-nsubj,compound-compound,NNP-NNP-NNP,NNP-NNP,5,1
7969,50760.0,19,told,6,4,1,-3,3,17,2,-5,G Gary Kirchner,Lancaster County,PERSON-PERSON-PERSON,ORGANIZATION-ORGANIZATION,PROPN-PROPN-PROPN,PROPN-PROPN,compound-compound-nsubj,compound-compound,NNP-NNP-NNP,NNP-NNP,4,1
7970,26369.0,43,credited,20,31,8,-23,30,34,-11,-12,Samsung Electronics,South Korea,ORGANIZATION-ORGANIZATION,COUNTRY-COUNTRY,PROPN-PROPN,PROPN-PROPN,compound-dobj,compound-pobj,NNP-NNPS,NNP-NNP,7,1
7971,26371.0,47,be,3,27,8,-19,26,38,-24,5,MF Global,Wall Street,ORGANIZATION-ORGANIZATION,LOCATION-LOCATION,PROPN-PROPN,PROPN-PROPN,compound-poss,compound-pobj,NNP-NNP,NNP-NNP,9,1
7972,26383.0,10,Rothman,5,5,8,3,4,1,0,3,Lorraine Rothman,75,PERSON-PERSON,NUMBER,PROPN-PROPN,NUM,compound-ROOT,appos,NNP-NNP,CD,2,1
7973,32444.0,55,Rothman,5,5,8,3,4,46,0,3,Lorraine Rothman,75,PERSON-PERSON,NUMBER,PROPN-PROPN,NUM,compound-ROOT,appos,NNP-NNP,CD,1,1
7974,63715.0,10,Rothman,1,1,10,9,0,-1,0,9,Lorraine Rothman,75,PERSON-PERSON,NUMBER,PROPN-PROPN,NUM,compound-ROOT,pobj,NNP-NNP,CD,-1,1
7975,26411.0,23,CARACAS,0,8,14,6,7,8,-8,14,Hugo Chavez,"July 28 , 1954",PERSON-PERSON,DATE-DATE-DATE-DATE,PROPN-PROPN,PROPN-NUM-PUNCT-NUM,compound-nsubjpass,pobj-nummod-punct-nummod,NNP-NNP,"NNP-CD-,-CD",4,1
7976,26451.0,23,seen,2,6,5,-1,5,17,-4,3,Kelly Cutrone,power-publicist,PERSON-PERSON,TITLE,PROPN-PROPN,NOUN,compound-nsubj,compound,NNP-NNP,NN,1,1
7977,26459.0,25,born,4,1,7,6,0,17,3,3,Richmond McDavid Flowers,Dothan,PERSON-PERSON-PERSON,CITY,PROPN-PROPN-PROPN,PROPN,compound-compound-nsubjpass,pobj,NNP-NNP-NNP,NNP,3,1
7978,29716.0,25,born,4,1,7,6,0,17,3,3,Richmond McDavid Flowers,Dothan,PERSON-PERSON-PERSON,CITY,PROPN-PROPN-PROPN,PROPN,compound-compound-nsubjpass,pobj,NNP-NNP-NNP,NNP,3,1
7979,26482.0,60,moved,43,22,27,5,21,32,21,-16,Nuclear Suppliers ' Group,NSG,ORGANIZATION-ORGANIZATION-ORGANIZATION-ORGANIZATION,ORGANIZATION,PROPN-PROPN-PART-PROPN,PROPN,compound-poss-case-nmod,compound,NNP-NNPS-POS-NNP,NNP,4,1
7980,26494.0,29,UTC,3,14,24,10,13,4,-11,21,Hashim Ahmad al-Tai,atrocities against Kurds in 1980s,PERSON-PERSON-PERSON,CRIMINAL_CHARGE-CRIMINAL_CHARGE-CRIMINAL_CHARGE-CRIMINAL_CHARGE-CRIMINAL_CHARGE,PROPN-PROPN-PROPN,NOUN-ADP-PROPN-ADP-NUM,compound-appos-punct,pobj-prep-pobj-prep-pobj,NNP-NNP-NNP,NNS-IN-NNPS-IN-CD,4,1
7981,26508.0,48,died,37,1,6,5,0,41,36,-31,Carolyn Goodman,clinical psychologist,PERSON-PERSON,TITLE-TITLE,PROPN-PROPN,ADJ-NOUN,compound-nsubj,amod-appos,NNP-NNP,JJ-NN,1,1
7982,26510.0,19,said,2,1,7,6,0,11,1,5,MF Global,Bradley Abelow,ORGANIZATION-ORGANIZATION,PERSON-PERSON,PROPN-PROPN,PROPN-PROPN,compound-nsubj,compound-nsubj,NNP-NNP,NNP-NNP,3,1
7983,26529.0,31,ATLANTA,0,15,9,-6,14,21,-15,9,he,Buckhead,PERSON,LOCATION,PRON,PROPN,nsubj,compound,PRP,NNP,4,1
7984,51229.0,31,ATLANTA,0,15,9,-6,14,21,-15,9,he,Buckhead,PERSON,LOCATION,PRON,PROPN,nsubj,compound,PRP,NNP,4,1
7985,26539.0,29,receive,3,16,20,4,15,8,-13,17,International Monetary Fund,IMF,ORGANIZATION-ORGANIZATION-ORGANIZATION,ORGANIZATION,PROPN-PROPN-PROPN,PROPN,compound-compound-compound,compound,NNP-NNP-NNP,NNP,6,1
7986,30840.0,46,be,5,10,14,4,9,31,-5,9,International Monetary Fund,IMF,ORGANIZATION-ORGANIZATION-ORGANIZATION,ORGANIZATION,PROPN-PROPN-PROPN,PROPN,compound-compound-pobj,compound,NNP-NNP-NNP,NNP,5,1
7987,39210.0,34,says,8,3,7,4,2,26,5,-1,International Monetary Fund,IMF,ORGANIZATION-ORGANIZATION-ORGANIZATION,ORGANIZATION,PROPN-PROPN-PROPN,PROPN,compound-compound-nsubj,compound,NNP-NNP-NNP,NNP,-1,1
7988,40685.0,45,mission,2,6,10,4,5,34,-4,8,International Monetary Fund,IMF,ORGANIZATION-ORGANIZATION-ORGANIZATION,ORGANIZATION,PROPN-PROPN-PROPN,PROPN,compound-compound-compound,compound,NNP-NNP-NNP,NNP,4,1
7989,42298.0,31,The,0,2,6,4,1,24,-2,6,International Monetary Fund,IMF,ORGANIZATION-ORGANIZATION-ORGANIZATION,ORGANIZATION,PROPN-PROPN-PROPN,PROPN,compound-compound-compound,compound,NNP-NNP-NNP,NNP,2,1
7990,65725.0,36,is,25,7,5,-2,6,30,18,-20,International Monetary Fund,IMF,ORGANIZATION-ORGANIZATION-ORGANIZATION,ORGANIZATION,PROPN-PROPN-PROPN,PROPN,compound-compound-compound,compound,NNP-NNP-NNP,NNP,2,1
7991,66362.0,35,put,8,13,17,4,12,17,-5,9,International Monetary Fund,IMF,ORGANIZATION-ORGANIZATION-ORGANIZATION,ORGANIZATION,PROPN-PROPN-PROPN,PROPN,compound-compound-compound,pobj,NNP-NNP-NNP,NNP,5,1
7992,66714.0,31,said,3,19,23,4,18,7,-16,20,International Monetary Fund,IMF,ORGANIZATION-ORGANIZATION-ORGANIZATION,ORGANIZATION,PROPN-PROPN-PROPN,PROPN,compound-compound-compound,compound,NNP-NNP-NNP,NNP,4,1
7993,26581.0,51,said,15,5,9,4,4,41,10,-6,he,governor,PERSON,TITLE,PRON,NOUN,nsubj,pobj,PRP,NN,4,1
7994,27567.0,30,won,4,4,7,3,3,22,0,3,he,governor,PERSON,TITLE,PRON,NOUN,nsubj,poss,PRP,NN,3,1
7995,26591.0,36,said,34,33,32,-1,32,3,1,-2,Marco Contiero,spokesman,PERSON-PERSON,TITLE,PROPN-PROPN,NOUN,compound-nsubj,compound,NNP-NNP,NN,2,1
7996,26595.0,55,said,44,46,49,3,45,5,-2,5,Herb Gibson,director,PERSON-PERSON,TITLE,PROPN-PROPN,NOUN,compound-nsubj,appos,NNP-NNP,NN,2,1
7997,30394.0,30,said,19,21,25,4,20,4,-2,6,Herb Gibson,director,PERSON-PERSON,TITLE,PROPN-PROPN,NOUN,compound-nsubj,appos,NNP-NNP,NN,2,1
7998,30503.0,28,said,16,18,22,4,17,5,-2,6,Herb Gibson,director,PERSON-PERSON,TITLE,PROPN-PROPN,NOUN,compound-nsubj,appos,NNP-NNP,NN,2,1
7999,47374.0,33,said,11,9,4,-5,8,28,2,-7,Herb Gibson,director,PERSON-PERSON,TITLE,PROPN-PROPN,NOUN,compound-appos,nsubj,NNP-NNP,NN,2,1
8000,59366.0,37,said,20,22,28,6,21,8,-2,8,Herb Gibson,director,PERSON-PERSON,TITLE,PROPN-PROPN,NOUN,compound-nsubj,appos,NNP-NNP,NN,2,1
8001,26618.0,18,called,6,8,4,-4,7,13,-2,-2,Peterson,pianist,PERSON,TITLE,PROPN,NOUN,dobj,nsubj,NNP,NN,4,1
8002,26620.0,4,Sills,1,1,3,2,0,0,0,2,Beverly Sills,48,PERSON-PERSON,NUMBER,PROPN-PROPN,NUM,compound-ROOT,nummod,NNP-NNP,CD,1,1
8003,26627.0,30,is,10,7,1,-6,6,28,3,-9,Zagat,Ford,ORGANIZATION,ORGANIZATION,PROPN,PROPN,compound,nsubj,NNP,NNP,4,1
8004,48025.0,48,says,38,43,40,-3,42,7,-5,2,Zagat,Ford,PERSON,ORGANIZATION,PROPN,PROPN,amod,nsubj,NNP,NNP,3,1
8005,26632.0,33,told,28,23,11,-12,22,21,5,-17,Haifa University,Dan Schueftan,ORGANIZATION-ORGANIZATION,PERSON-PERSON,PROPN-PROPN,PROPN-PROPN,compound-pobj,compound-nsubj,NNP-NNP,NNP-NNP,7,1
8006,26644.0,29,is,1,1,8,7,0,20,0,7,Ali,Williamstown,PERSON,CITY,PROPN,PROPN,nsubj,pobj,NNP,NNP,1,1
8007,26649.0,24,picking,21,5,10,5,4,13,16,-11,AAA,St. Petersburg,ORGANIZATION,LOCATION-LOCATION,PROPN,PROPN-PROPN,poss,compound-pobj,NNP,NNP-NNP,4,1
8008,26654.0,14,attended,1,1,3,2,0,10,0,2,She,Wellesley College,PERSON,ORGANIZATION-ORGANIZATION,PRON,PROPN-PROPN,nsubj,compound-dobj,PRP,NNP-NNP,1,1
8009,26658.0,28,seems,18,15,3,-12,14,24,3,-15,Molly Malaney,he,PERSON-PERSON,PERSON,PROPN-PROPN,PRON,compound-pobj,nsubj,NNP-NNP,PRP,5,1
8010,26678.0,29,visited,18,17,11,-6,16,17,1,-7,OIC,Organisation of the Islamic Conference,ORGANIZATION,ORGANIZATION-ORGANIZATION-ORGANIZATION-ORGANIZATION-ORGANIZATION,PROPN,PROPN-ADP-DET-PROPN-PROPN,compound,pobj-prep-det-compound-pobj,NNP,NNP-IN-DT-NNP-NNP,7,1
8011,26724.0,36,was,16,1,5,4,0,30,15,-11,Beverly Sills,Opera Singer,PERSON-PERSON,TITLE-TITLE,PROPN-PROPN,PROPN-PROPN,compound-nsubj,compound-conj,NNP-NNP,NNP-NNP,1,1
8012,26731.0,24,retired,17,3,14,11,2,9,14,-3,he,Long Island,PERSON,LOCATION-LOCATION,PRON,PROPN-PROPN,nsubjpass,compound-pobj,PRP,NNP-NNP,3,1
8013,26742.0,22,wrote,0,9,2,-7,8,19,-9,2,International Crisis Group,Louise Arbour,ORGANIZATION-ORGANIZATION-ORGANIZATION,PERSON-PERSON,PROPN-PROPN-PROPN,PROPN-PROPN,compound-compound-pobj,compound-nsubj,NNP-NNP-NNP,NNP-NNP,4,1
8014,26746.0,31,evaluating,8,3,6,3,2,24,5,-2,ElBaradei,IAEA,PERSON,ORGANIZATION,PROPN,PROPN,pobj,nsubj,NNP,NNP,2,1
8015,67760.0,37,ask,3,20,18,-2,19,18,-17,15,ElBaradei,IAEA,PERSON,ORGANIZATION,PROPN,PROPN,nsubj,amod,NNP,NNP,3,1
8016,26759.0,42,reported,39,37,1,-36,36,40,2,-38,ABC,Australian Broadcasting Corporation,ORGANIZATION,ORGANIZATION-ORGANIZATION-ORGANIZATION,PROPN,PROPN-PROPN-PROPN,compound,compound-compound-appos,NNP,NNP-NNP-NNP,4,1
8017,41587.0,48,told,39,46,42,-4,45,5,-7,3,ABC,Australian Broadcasting Corporation,ORGANIZATION,ORGANIZATION-ORGANIZATION-ORGANIZATION,PROPN,PROPN-PROPN-PROPN,compound,compound-compound-dobj,NNP,NNP-NNP-NNP,3,1
8018,26771.0,24,gobbling,7,22,19,-3,21,4,-15,12,Christopher Bentley,immigration service,PERSON-PERSON,ORGANIZATION-ORGANIZATION,PROPN-PROPN,NOUN-NOUN,compound-pobj,compound-compound,NNP-NNP,NN-NN,2,1
8019,26779.0,28,said,1,1,9,8,0,18,0,8,Chavez,Costa Rica,PERSON,COUNTRY-COUNTRY,PROPN,PROPN-PROPN,nsubj,compound-pobj,NNP,NNP-NNP,3,1
8020,26814.0,18,Stop,0,8,17,9,7,0,-8,17,Bryan MacFadden,Kerry,PERSON-PERSON,PERSON,PROPN-PROPN,PROPN,compound-ccomp,appos,NNP-NNP,NNP,3,1
8021,26825.0,46,asked,17,5,13,8,4,32,12,-4,Farland,Virginia,PERSON,STATE_OR_PROVINCE,PROPN,PROPN,nsubjpass,compound,NNP,NNP,5,1
8022,26829.0,43,quoted,33,30,28,-2,29,14,3,-5,Gholam Ali Haddad Adel,Parliamentary Speaker,PERSON-PERSON-PERSON-PERSON,TITLE-TITLE,PROPN-PROPN-PROPN-PROPN,PROPN-PROPN,compound-compound-compound-nsubj,compound-compound,NNP-NNP-NNP-NNP,NNP-NNP,3,1
8023,26830.0,40,said,23,28,26,-2,27,13,-5,3,Mahmood Shah,Brig. Gen.,PERSON-PERSON,TITLE-TITLE,PROPN-PROPN,PROPN-PROPN,compound-nsubj,compound-compound,NNP-NNP,NNP-NNP,-1,1
8024,58678.0,50,say,2,17,15,-2,16,34,-15,13,Mahmood Shah,Brig. Gen.,PERSON-PERSON,TITLE-TITLE,PROPN-PROPN,PROPN-PROPN,compound-pobj,compound-compound,NNP-NNP,NNP-NNP,-1,1
8025,26831.0,32,TV-IDOL-JOHNS,5,15,19,4,14,12,-10,14,Michael Johns,Los Angeles,PERSON-PERSON,CITY-CITY,PROPN-PROPN,PROPN-PROPN,compound-nsubj,compound-pobj,NNP-NNP,NNP-NNP,-1,1
8026,26846.0,45,sent,3,12,9,-3,11,35,-9,6,National Red Cross,South Korea,ORGANIZATION-ORGANIZATION-ORGANIZATION,COUNTRY-COUNTRY,PROPN-PROPN-PROPN,PROPN-PROPN,compound-compound-compound,compound-poss,NNP-NNP-NNP,NNP-NNP,4,1
8027,26862.0,31,focus,8,5,7,2,4,23,3,-1,ADB,Bangladesh,ORGANIZATION,COUNTRY,PROPN,PROPN,pobj,pobj,NNP,NNP,5,1
8028,26880.0,26,include,5,15,10,-5,14,15,-10,5,Awami League,Shahabuddin Kiron,ORGANIZATION-ORGANIZATION,PERSON-PERSON,PROPN-PROPN,PROPN-PROPN,compound-compound,compound-conj,NNP-NNP,NNP-NNP,4,1
8029,49227.0,23,include,5,15,10,-5,14,12,-10,5,Awami League,Shahabuddin Kiron,ORGANIZATION-ORGANIZATION,PERSON-PERSON,PROPN-PROPN,PROPN-PROPN,compound-pobj,compound-conj,NNP-NNP,NNP-NNP,4,1
8030,26887.0,31,said,24,10,13,3,9,17,14,-11,Northwood University,West Palm Beach,ORGANIZATION-ORGANIZATION,CITY-CITY-CITY,PROPN-PROPN,PROPN-PROPN-PROPN,compound-pobj,compound-compound-pobj,NNP-NNP,NNP-NNP-NNP,3,1
8031,26917.0,25,has,1,1,20,19,0,4,0,19,DirecTV,Starz,ORGANIZATION,ORGANIZATION,PROPN,PROPN,nsubj,conj,NNP,NNP,7,1
8032,26926.0,89,have,30,1,3,2,0,85,29,-27,Cathleen P. Black,Black,PERSON-PERSON-PERSON,PERSON,PROPN-PROPN-PROPN,PROPN,compound-compound-nsubj,nsubj,NNP-NNP-NNP,NNP,3,1
8033,26936.0,46,detailed,7,27,32,5,26,13,-20,25,Raul Castro,his,PERSON-PERSON,PERSON,PROPN-PROPN,DET,compound-pobj,poss,NNP-NNP,PRP$,2,1
8034,26937.0,45,said,8,1,20,19,0,24,7,12,National Red Cross,Pasto,ORGANIZATION-ORGANIZATION-ORGANIZATION,CITY,PROPN-PROPN-PROPN,PROPN,amod-compound-compound,pobj,NNP-NNP-NNP,NNP,7,1
8035,26939.0,9,Dec.,0,5,4,-1,4,4,-5,4,Hector Elizondo,Actor,PERSON-PERSON,TITLE,PROPN-PROPN,PROPN,compound-nsubj,compound,NNP-NNP,NNP,1,1
8036,26941.0,12,included,5,10,5,-5,9,6,-5,0,Richard Perle,directors,PERSON-PERSON,TITLE,PROPN-PROPN,NOUN,compound-conj,nsubj,NNP-NNP,NNS,4,1
8037,26960.0,9,YORK,1,6,3,-3,5,5,-5,2,She,2007-08-17,PERSON,DATE,PRON,NUM,nsubj,nummod,PRP,CD,4,1
8038,26966.0,38,wins,1,21,35,14,20,2,-20,34,Lewis Hamilton,races,PERSON-PERSON,TITLE,PROPN-PROPN,NOUN,compound-nsubj,pobj,NNP-NNP,NNS,7,1
8039,26980.0,21,coaches,4,8,12,4,7,8,-4,8,Northwood University,Florida,ORGANIZATION-ORGANIZATION,STATE_OR_PROVINCE,PROPN-PROPN,PROPN,compound-pobj,pobj,NNP-NNP,NNP,3,1
8040,26981.0,28,said,17,7,25,18,6,2,10,8,Yolanda King,congestive heart failure,PERSON-PERSON,CAUSE_OF_DEATH-CAUSE_OF_DEATH-CAUSE_OF_DEATH,PROPN-PROPN,ADJ-NOUN-NOUN,compound-pobj,amod-compound-attr,NNP-NNP,JJ-NN-NN,7,1
8041,26988.0,67,dispatched,3,34,8,-26,33,58,-31,5,Badr Corps,Basra,ORGANIZATION-ORGANIZATION,LOCATION,PROPN-PROPN,PROPN,compound-compound,pobj,NNP-NNP,NNP,11,1
8042,26989.0,34,Description,0,32,13,-19,31,20,-32,13,Tyco Healthcare,"Mallinckrodt Baker , Inc.",ORGANIZATION-ORGANIZATION,ORGANIZATION-ORGANIZATION-ORGANIZATION-ORGANIZATION,PROPN-PROPN,PROPN-PROPN-PUNCT-PROPN,compound-pobj,compound-appos-punct-subtok,NNP-NNP,"NNP-NNP-,-NNP",-1,1
8043,26993.0,27,taught,8,8,24,16,7,2,0,16,he,South Central Bell,PERSON,ORGANIZATION-ORGANIZATION-ORGANIZATION,PRON,PROPN-PROPN-PROPN,nsubj,compound-compound-pobj,PRP,NNP-NNP-NNP,3,1
8044,27005.0,40,said,11,3,8,5,2,31,8,-3,Capitalia SpA,Matteo Arpe,ORGANIZATION-ORGANIZATION,PERSON-PERSON,PROPN-PROPN,PROPN-PROPN,compound-poss,compound-appos,NNP-NNP,NNP-NNP,2,1
8045,27015.0,32,noted,7,25,13,-12,24,18,-18,6,Daily News,Jeanie Buss,ORGANIZATION-ORGANIZATION,PERSON-PERSON,PROPN-PROPN,PROPN-PROPN,compound-pobj,compound-conj,NNP-NNP,NNP-NNP,7,1
8046,27016.0,37,wants,8,10,1,-9,9,35,-2,-7,Al Hubbard,House Energy and Commerce Committee,PERSON-PERSON,ORGANIZATION-ORGANIZATION-ORGANIZATION-ORGANIZATION-ORGANIZATION,PROPN-PROPN,PROPN-PROPN-CCONJ-PROPN-PROPN,compound-dobj,nmod-nmod-cc-conj-compound,NNP-NNP,NNP-NNP-CC-NNP-NNP,5,1
8047,27018.0,38,'s,28,12,17,5,11,20,16,-11,he,hollywood,PERSON,CITY,PRON,NOUN,nsubjpass,npadvmod,PRP,NN,3,1
8048,27026.0,35,was,1,1,5,4,0,29,0,4,King,co-director,PERSON,TITLE,PROPN,NOUN,nsubj,conj,NNP,NN,2,1
8049,27032.0,40,said,5,10,2,-8,9,37,-5,-3,IRGC,The Quds Force,ORGANIZATION,ORGANIZATION-ORGANIZATION-ORGANIZATION,PROPN,DET-PROPN-PROPN,poss,det-compound-nsubj,NNP,DT-NNPS-NNP,6,1
8050,27034.0,48,been,25,24,7,-17,23,40,1,-18,Bellecourt,hair stylist,PERSON,TITLE-TITLE,PROPN,NOUN-NOUN,nsubj,compound-nmod,NNP,NN-NN,5,1
8051,28540.0,47,been,24,23,7,-16,22,39,1,-17,Bellecourt,hair stylist,PERSON,TITLE-TITLE,PROPN,NOUN-NOUN,nsubj,compound-nmod,NNP,NN-NN,5,1
8052,45706.0,47,been,24,23,7,-16,22,39,1,-17,Bellecourt,hair stylist,PERSON,TITLE-TITLE,PROPN,NOUN-NOUN,nsubj,compound-nmod,NNP,NN-NN,5,1
8053,27045.0,34,said,6,1,5,4,0,28,5,-1,Raul Castro,Mariela Castro,PERSON-PERSON,PERSON-PERSON,PROPN-PROPN,PROPN-PROPN,compound-poss,compound-appos,NNP-NNP,NNP-NNP,2,1
8054,27047.0,45,say,1,10,15,5,9,29,-9,14,Jamaat al Muslimeen,JAM,ORGANIZATION-ORGANIZATION-ORGANIZATION,ORGANIZATION,PROPN-PROPN-PROPN,PROPN,compound-compound-pobj,conj,NNP-NNP-NNP,NNP,3,1
8055,27048.0,25,elected,19,1,5,4,0,19,18,-14,Gillmor,Ohio,PERSON,STATE_OR_PROVINCE,PROPN,PROPN,nsubjpass,poss,NNP,NNP,5,1
8056,28770.0,38,is,11,7,10,3,6,27,4,-1,Gillmor,Ohio,PERSON,STATE_OR_PROVINCE,PROPN,PROPN,appos,npadvmod,NNP,NNP,3,1
8057,27049.0,41,dismissed,5,35,27,-8,34,13,-30,22,Alberto Gonzales,President,PERSON-PERSON,TITLE,PROPN-PROPN,PROPN,compound-dobj,compound,NNP-NNP,NNP,4,1
8058,27054.0,27,died,6,16,5,-11,15,21,-10,-1,his,56,PERSON,NUMBER,DET,NUM,poss,attr,PRP$,CD,7,1
8059,27065.0,38,signed,11,4,6,2,3,31,7,-5,JEM,Darfur,ORGANIZATION,LOCATION,PROPN,PROPN,conj,poss,NNP,NNP,4,1
8060,30699.0,58,said,4,33,26,-7,32,31,-29,22,JEM,Darfur,ORGANIZATION,LOCATION,PROPN,PROPN,compound,poss,NNP,NNP,8,1
8061,52601.0,29,confined,2,1,7,6,0,21,1,5,JEM,Darfur,ORGANIZATION,LOCATION,PROPN,PROPN,nsubj,pobj,NNP,NNP,4,1
8062,59939.0,51,carried,25,2,8,6,1,42,23,-17,JEM,Darfur,ORGANIZATION,LOCATION,PROPN,PROPN,nsubj,compound,NNP,NNP,3,1
8063,27077.0,19,Catherine,0,7,18,11,6,0,-7,18,Juliette Binoche,poet,PERSON-PERSON,TITLE,PROPN-PROPN,NOUN,compound-nsubj,attr,NNP-NNP,NN,9,1
8064,27081.0,45,said,16,11,15,4,10,29,5,-1,Samsung,Yoon-Woo Lee,ORGANIZATION,PERSON-PERSON,PROPN,PROPN-PROPN,compound,compound-nsubj,NNP,NNP-NNP,4,1
8065,27780.0,37,offers,1,1,31,30,0,5,0,30,Samsung,Yoon-Woo Lee,ORGANIZATION,PERSON-PERSON,PROPN,PROPN-PROPN,nsubj,compound-appos,NNP,NNP-NNP,4,1
8066,27087.0,35,playing,8,1,29,28,0,5,7,21,His,boxer,PERSON,TITLE,DET,NOUN,poss,nsubj,PRP$,NN,8,1
8067,27089.0,15,-LRB-,2,1,6,5,0,8,1,4,Lewis Hamilton,McLaren - Mercedes,PERSON-PERSON,ORGANIZATION-ORGANIZATION-ORGANIZATION,PROPN-PROPN,PROPN-PUNCT-PROPN,compound-compound,nmod-punct-appos,NNP-NNP,NNP-HYPH-NNP,3,1
8068,27090.0,45,bid,9,1,33,32,0,11,8,24,New York Daily News,his,ORGANIZATION-ORGANIZATION-ORGANIZATION-ORGANIZATION,PERSON,PROPN-PROPN-PROPN-PROPN,DET,compound-compound-compound-compound,poss,NNP-NNP-NNP-NNP,PRP$,10,1
8069,27098.0,36,said,1,35,33,-2,34,2,-34,32,Citibank,U.S.,ORGANIZATION,COUNTRY,PROPN,PROPN,pobj,compound,NNP,NNP,9,1
8070,27099.0,31,said,22,8,12,4,7,18,14,-10,Samsung Group,Lee Hak-soo,ORGANIZATION-ORGANIZATION,PERSON-PERSON,PROPN-PROPN,PROPN-NOUN,compound-compound,compound-dobj,NNP-NNP,NNP-NN,3,1
8071,27101.0,45,include,1,28,34,6,27,10,-27,33,Gilbert Gude,Gregory Gude,PERSON-PERSON,PERSON-PERSON,PROPN-PROPN,PROPN-PROPN,compound-compound,compound-conj,NNP-NNP,NNP-NNP,4,1
8072,27105.0,32,appointed,4,26,21,-5,25,10,-22,17,FAW,Football Association of Wales,ORGANIZATION,ORGANIZATION-ORGANIZATION-ORGANIZATION-ORGANIZATION,PROPN,PROPN-PROPN-ADP-PROPN,compound,compound-appos-prep-pobj,NNP,NNP-NNP-IN-NNP,5,1
8073,61663.0,38,missed,4,33,28,-5,32,9,-29,24,FAW,Football Association of Wales,ORGANIZATION,ORGANIZATION-ORGANIZATION-ORGANIZATION-ORGANIZATION,PROPN,PROPN-PROPN-ADP-PROPN,compound,compound-dobj-prep-pobj,NNP,NNP-NNP-IN-NNP,9,1
8074,27107.0,29,cited,3,2,13,11,1,15,1,10,coroner,Pennsylvania,PERSON,STATE_OR_PROVINCE,NOUN,PROPN,nsubjpass,compound,NN,NNP,4,1
8075,27108.0,37,were,33,31,17,-14,30,19,2,-16,MF Global,Jon S. Corzine,ORGANIZATION-ORGANIZATION,PERSON-PERSON-PERSON,PROPN-PROPN,PROPN-PROPN-PROPN,compound-appos,compound-compound-conj,NNP-NNP,NNP-NNP-NNP,5,1
8076,27112.0,35,said,6,8,4,-4,7,30,-2,-2,Remy Ma,New York City,PERSON-PERSON,CITY-CITY-CITY,PROPN-PROPN,PROPN-PROPN-PROPN,compound-nsubj,compound-compound-pobj,NNP-NNP,NNP-NNP-NNP,6,1
8077,60259.0,16,plans,2,1,6,5,0,9,1,4,Remy Ma,New York City,PERSON-PERSON,CITY-CITY-CITY,PROPN-PROPN,PROPN-PROPN-PROPN,compound-nsubj,compound-compound-compound,NNP-NNP,NNP-NNP-NNP,6,1
8078,27135.0,36,studied,18,18,27,9,17,8,0,9,Waldheim,Consular Academy,PERSON,ORGANIZATION-ORGANIZATION,PROPN,PROPN-PROPN,nsubj,compound-dobj,NNP,NNP-NNP,2,1
8079,45439.0,36,studied,18,18,27,9,17,8,0,9,Waldheim,Consular Academy,PERSON,ORGANIZATION-ORGANIZATION,PROPN,PROPN-PROPN,nsubj,compound-dobj,NNP,NNP-NNP,2,1
8080,27148.0,38,cautioned,18,1,7,6,0,30,17,-11,US Rep Andre Carson,Indiana Democrat,PERSON-PERSON-PERSON-PERSON,ORGANIZATION-ORGANIZATION,PROPN-PROPN-PROPN-PROPN,PROPN-PROPN,compound-compound-compound-nsubj,compound-appos,NNP-NNP-NNP-NNP,NNP-NNP,2,1
8081,27150.0,59,Labels,0,14,7,-7,13,51,-14,7,Susan Boyle,Britain,PERSON-PERSON,COUNTRY,PROPN-PROPN,PROPN,compound-appos,poss,NNP-NNP,NNP,3,1
8082,65565.0,31,been,2,9,24,15,8,6,-7,22,Susan Boyle,Britain,PERSON-PERSON,COUNTRY,PROPN-PROPN,PROPN,compound-conj,poss,NNP-NNP,NNP,8,1
8083,27155.0,38,told,13,11,7,-4,10,30,2,-6,International Crisis Group,Seoul,ORGANIZATION-ORGANIZATION-ORGANIZATION,CITY,PROPN-PROPN-PROPN,PROPN,compound-compound-pobj,compound,NNP-NNP-NNP,NNP,3,1
8084,27157.0,37,said,28,13,15,2,12,21,15,-13,Sills,host,PERSON,TITLE,PROPN,NOUN,nsubj,attr,NNP,NN,2,1
8085,42774.0,34,was,21,21,33,12,20,0,0,12,Sills,host,PERSON,TITLE,PROPN,NOUN,nsubj,attr,NNP,NN,5,1
8086,27167.0,34,had,2,23,2,-21,22,31,-21,0,his,Waldheims,PERSON,PERSON,DET,PROPN,poss,nsubj,PRP$,NNPS,6,1
8087,27184.0,27,says,9,25,11,-14,24,15,-16,2,Spelman College,Sheila S. Walker,ORGANIZATION-ORGANIZATION,PERSON-PERSON-PERSON,PROPN-PROPN,PROPN-PROPN-PROPN,compound-pobj,compound-compound-nsubj,NNP-NNP,NNP-NNP-NNP,6,1
8088,27186.0,25,said,12,1,11,10,0,13,11,-1,Sean Parker,Causes,PERSON-PERSON,ORGANIZATION,PROPN-PROPN,PROPN,compound-nsubj,dobj,NNP-NNP,NNP,2,1
8089,27199.0,27,said,25,4,20,16,3,6,21,-5,Pascal Yoadimnadji,heart attack,PERSON-PERSON,CAUSE_OF_DEATH-CAUSE_OF_DEATH,PROPN-PROPN,NOUN-NOUN,compound-nsubj,compound-pobj,NNP-NNP,NN-NN,6,1
8090,27201.0,52,drawn,4,13,35,22,12,16,-9,31,American Bar Association,U.S.,ORGANIZATION-ORGANIZATION-ORGANIZATION,COUNTRY,PROPN-PROPN-PROPN,PROPN,compound-compound-compound,compound,NNP-NNP-NNP,NNP,7,1
8091,27210.0,32,locked,3,14,12,-2,13,19,-11,9,Gholam Ali Hadad Adel,parliament,PERSON-PERSON-PERSON-PERSON,ORGANIZATION,PROPN-PROPN-PROPN-PROPN,NOUN,compound-compound-compound-pobj,compound,NNP-NNP-NNP-NNP,NN,1,1
8092,27217.0,45,carried,4,27,16,-11,26,28,-23,12,Richard Perle,Jewish,PERSON-PERSON,RELIGION,PROPN-PROPN,ADJ,compound-conj,amod,NNP-NNP,JJ,10,1
8093,27228.0,40,said,1,25,21,-4,24,18,-24,20,Hussein Kamel,killing,PERSON-PERSON,CAUSE_OF_DEATH,PROPN-PROPN,NOUN,compound-compound,pobj,NNP-NNP,NN,2,1
8094,27229.0,10,included,2,4,9,5,3,0,-2,7,Aerolineas,Austral,ORGANIZATION,ORGANIZATION,PROPN,PROPN,poss,appos,NNP,NNP,4,1
8095,27233.0,33,called,10,4,8,4,3,24,6,-2,Carolyn Maloney,Manhattan,PERSON-PERSON,CITY,PROPN-PROPN,PROPN,compound-nsubj,compound,NNP-NNP,NNP,1,1
8096,45431.0,40,agreed,5,16,22,6,15,17,-11,17,Carolyn Maloney,Manhattan,PERSON-PERSON,CITY,PROPN-PROPN,PROPN,compound-pobj,poss,NNP-NNP,NNP,5,1
8097,27241.0,24,reported,22,15,19,4,14,4,7,-3,Ali Larijani,speaker,PERSON-PERSON,TITLE,PROPN-PROPN,NOUN,compound-dobj,pobj,NNP-NNP,NN,4,1
8098,59774.0,34,said,12,11,10,-1,10,23,1,-2,Ali Larijani,speaker,PERSON-PERSON,TITLE,PROPN-PROPN,NOUN,compound-pobj,compound,NNP-NNP,NN,1,1
8099,27246.0,21,was,11,9,3,-6,8,17,2,-8,Quds Force,Qasem Soleimani,ORGANIZATION-ORGANIZATION,PERSON-PERSON,PROPN-PROPN,PROPN-PROPN,compound-pobj,compound-nsubj,NNPS-NNP,NNP-NNP,3,1
8100,27249.0,21,said,6,1,5,4,0,15,5,-1,Hindalco,Debu Bhattacharya,ORGANIZATION,PERSON-PERSON,PROPN,PROPN-PROPN,poss,compound-appos,NNP,NNP-NNP,3,1
8101,27270.0,20,played,8,1,2,1,0,17,7,-6,The,22-year,PERSON,NUMBER,DET,ADJ,det,nummod,DT,JJ,2,1
8102,27292.0,31,officiate,8,13,16,3,12,14,-5,8,ADB,Bindu N Lohani,ORGANIZATION,PERSON-PERSON-PERSON,PROPN,PROPN-PROPN-PROPN,compound,compound-compound-nsubj,NNP,NNP-NNP-NNP,3,1
8103,27299.0,30,DENT,1,1,4,3,0,25,0,3,HARRY DENT,77,PERSON-PERSON,NUMBER,PROPN-PROPN,NUM,compound-ROOT,appos,NNP-NNP,CD,1,1
8104,27313.0,26,said,16,21,19,-2,20,6,-5,3,Ezra Levant,political activist,PERSON-PERSON,TITLE-TITLE,PROPN-PROPN,ADJ-NOUN,compound-nsubj,amod-compound,NNP-NNP,JJ-NN,3,1
8105,27345.0,30,upgraded,3,18,15,-3,17,14,-15,12,Michael Sandy,Brooklyn,PERSON-PERSON,CITY,PROPN-PROPN,PROPN,compound-pobj,compound,NNP-NNP,NNP,3,1
8106,27347.0,30,held,16,1,29,28,0,0,15,13,Zubaydah,Cuba,PERSON,COUNTRY,PROPN,PROPN,nsubjpass,appos,NNP,NNP,9,1
8107,27354.0,36,Works,3,6,1,-5,5,34,-3,-2,FAW,China First Automotive Works,ORGANIZATION,ORGANIZATION-ORGANIZATION-ORGANIZATION-ORGANIZATION,PROPN,PROPN-PROPN-PROPN-PROPN,compound,compound-compound-compound-ROOT,NNP,NNP-NNP-NNP-NNP,3,1
8108,27356.0,32,decried,12,7,30,23,6,1,5,18,Federal Motor Carrier Safety Administration,protectionism,ORGANIZATION-ORGANIZATION-ORGANIZATION-ORGANIZATION-ORGANIZATION,IDEOLOGY,PROPN-PROPN-PROPN-PROPN-PROPN,NOUN,compound-compound-compound-compound-pobj,conj,NNP-NNP-NNP-NNP-NNP,NN,14,1
8109,27357.0,33,named,4,2,12,10,1,20,2,8,John Kerry,US Senate,PERSON-PERSON,ORGANIZATION-ORGANIZATION,PROPN-PROPN,PROPN-PROPN,compound-nsubjpass,compound-poss,NNP-NNP,NNP-NNP,5,1
8110,29466.0,24,facing,8,1,20,19,0,3,7,12,John Kerry,US Senate,PERSON-PERSON,ORGANIZATION-ORGANIZATION,PROPN-PROPN,PROPN-PROPN,compound-nsubj,compound-pobj,NNP-NNP,NNP-NNP,4,1
8111,27358.0,11,Ahearn,1,1,10,9,0,0,0,9,Pamela Ahearn,U.S.,PERSON-PERSON,COUNTRY,PROPN-PROPN,PROPN,compound-ROOT,compound,NNP-NNP,NNP,3,1
8112,27375.0,46,fact,1,7,12,5,6,33,-6,11,his,illustrator,PERSON,TITLE,DET,NOUN,poss,nsubj,PRP$,NN,5,1
8113,27383.0,64,corresponds,7,11,10,-1,10,53,-4,3,Barry Goldwater,Senator,PERSON-PERSON,TITLE,PROPN-PROPN,PROPN,compound-pobj,compound,NNP-NNP,NNP,1,1
8114,27384.0,20,received,1,1,8,7,0,11,0,7,Kaiser,University of Wisconsin,PERSON,ORGANIZATION-ORGANIZATION-ORGANIZATION,PROPN,PROPN-ADP-PROPN,nsubj,pobj-prep-pobj,NNP,NNP-IN-NNP,3,1
8115,27388.0,43,Agency,4,11,19,8,10,23,-7,15,Federal Aviation Administration,United States,ORGANIZATION-ORGANIZATION-ORGANIZATION,COUNTRY-COUNTRY,PROPN-PROPN-PROPN,PROPN-PROPN,compound-compound-conj,compound-pobj,NNP-NNP-NNP,NNP-NNP,5,1
8116,47594.0,40,said,35,5,2,-3,4,37,30,-33,Federal Aviation Administration,United States,ORGANIZATION-ORGANIZATION-ORGANIZATION,COUNTRY-COUNTRY,PROPN-PROPN-PROPN,PROPN-PROPN,compound-compound-nsubj,compound-poss,NNP-NNP-NNP,NNP-NNP,2,1
8117,27403.0,37,convicted,11,9,19,10,8,17,2,8,Remy Ma,coercion,PERSON-PERSON,CRIMINAL_CHARGE,PROPN-PROPN,NOUN,compound-nsubjpass,conj,NNP-NNP,NN,6,1
8118,27412.0,41,submit,11,1,27,26,0,13,10,16,Hubbard,White House,PERSON,LOCATION-LOCATION,PROPN,PROPN-PROPN,nsubj,compound-compound,NNP,NNP-NNP,6,1
8119,27414.0,64,said,14,6,1,-5,5,62,8,-13,NSC,Chen Dung-sheng,ORGANIZATION,PERSON-PERSON,PROPN,PROPN-PROPN,poss,compound-nsubj,NNP,NNP-NNP,3,1
8120,27420.0,63,has,1,25,29,4,24,33,-24,28,Dewey,leader,PERSON,TITLE,PROPN,NOUN,nmod,pobj,NNP,NN,3,1
8121,27422.0,38,made,28,26,19,-7,25,18,2,-9,Royal Caribbean,"6,300",ORGANIZATION-ORGANIZATION,NUMBER,PROPN-PROPN,NUM,compound-pobj,nummod,NNP-NNP,CD,5,1
8122,27430.0,40,said,6,6,35,29,5,4,0,29,Carson,Indiana Department of Homeland Security,PERSON,ORGANIZATION-ORGANIZATION-ORGANIZATION-ORGANIZATION-ORGANIZATION,PROPN,PROPN-PROPN-ADP-PROPN-PROPN,nsubj,compound-pobj-prep-compound-pobj,NNP,NNP-NNP-IN-NNP-NNP,9,1
8123,27439.0,20,names,16,16,12,-4,15,7,0,-4,Jeremy,Philadelphia,PERSON,CITY,PROPN,PROPN,conj,compound,NNP,NNP,4,1
8124,27443.0,40,noted,14,10,2,-8,9,37,4,-12,House member from Massachusetts,Edward J Markey,ORGANIZATION-ORGANIZATION-ORGANIZATION-ORGANIZATION,PERSON-PERSON-PERSON,PROPN-NOUN-ADP-PROPN,PROPN-PROPN-PROPN,compound-appos-prep-pobj,compound-compound-nsubj,NNP-NN-IN-NNP,NNP-NNP-NNP,3,1
8125,27448.0,29,was,13,13,9,-4,12,19,0,-4,King,Montgomery,PERSON,CITY,PROPN,PROPN,nsubj,pobj,NNP,NNP,4,1
8126,63529.0,26,born,2,1,7,6,0,18,1,5,King,Montgomery,PERSON,CITY,PROPN,PROPN,nsubjpass,pobj,NNP,NNP,4,1
8127,27474.0,43,quit,13,24,30,6,23,12,-11,17,ABC,populist,ORGANIZATION,IDEOLOGY,PROPN,ADJ,compound,amod,NNP,JJ,2,1
8128,27476.0,28,Focus,2,18,25,7,17,2,-16,23,Chen,Academy of Sciences,PERSON,ORGANIZATION-ORGANIZATION-ORGANIZATION,PROPN,PROPN-ADP-PROPN,nsubj,pobj-prep-pobj,NNP,NNP-IN-NNPS,4,1
8129,27485.0,28,BABE,1,11,27,16,10,0,-10,26,Jamie Lynn Spears,Mississippi,PERSON-PERSON-PERSON,STATE_OR_PROVINCE,PROPN-PROPN-PROPN,PROPN,compound-compound-pobj,appos,NNP-NNP-NNPS,NNP,6,1
8130,27503.0,41,saw,2,40,9,-31,39,31,-38,7,QMS,one,ORGANIZATION,NUMBER,PROPN,NUM,pobj,nummod,NNP,CD,6,1
8131,27504.0,28,said,26,3,1,-2,2,26,23,-25,Crown Prosecution service,Britain,ORGANIZATION-ORGANIZATION-ORGANIZATION,COUNTRY,PROPN-PROPN-NOUN,PROPN,compound-compound-nsubj,poss,NNP-NNP-NN,NNP,3,1
8132,27508.0,37,Adelman,1,21,17,-4,20,19,-20,16,Perle,Defense Policy Board,PERSON,ORGANIZATION-ORGANIZATION-ORGANIZATION,PROPN,PROPN-PROPN-PROPN,pobj,compound-compound-pobj,NNP,NNP-NNP-NNP,4,1
8133,27524.0,39,employs,7,2,1,-1,1,37,5,-6,Zagat Survey,Nina Zagat,ORGANIZATION-ORGANIZATION,PERSON-PERSON,PROPN-PROPN,PROPN-PROPN,compound-pobj,compound-nsubj,NNP-NNP,NNP-NNP,1,1
8134,27530.0,15,rebounded,5,3,4,1,2,10,2,-1,Samsung,Group,ORGANIZATION,ORGANIZATION,PROPN,PROPN,compound,compound,NNP,NNP,1,1
8135,27531.0,49,added,47,2,15,13,1,33,45,-32,IRGC,Muslim,ORGANIZATION,RELIGION,NOUN,PROPN,nsubj,pobj,NN,NNP,5,1
8136,27542.0,40,commissioned,5,9,7,-2,8,32,-4,2,Charles Wuorinen,American,PERSON-PERSON,NATIONALITY,PROPN-PROPN,ADJ,compound-dobj,amod,NNP-NNP,JJ,1,1
8137,58461.0,54,said,5,43,19,-24,42,34,-38,14,Charles Wuorinen,American,PERSON-PERSON,NATIONALITY,PROPN-PROPN,ADJ,compound-poss,amod,NNP-NNP,JJ,8,1
8138,63548.0,40,commissioned,5,9,7,-2,8,32,-4,2,Charles Wuorinen,American,PERSON-PERSON,NATIONALITY,PROPN-PROPN,ADJ,compound-dobj,amod,NNP-NNP,JJ,1,1
8139,27546.0,39,said,7,17,15,-2,16,23,-10,8,IPSCO,Canadian,ORGANIZATION,COUNTRY,PROPN,ADJ,dobj,amod,NNP,JJ,3,1
8140,27547.0,31,said,29,4,19,15,3,11,25,-10,his,leader,PERSON,TITLE,DET,NOUN,poss,compound,PRP$,NN,10,1
8141,42749.0,34,wavered,19,29,33,4,28,0,-10,14,his,leader,PERSON,TITLE,DET,NOUN,poss,pobj,PRP$,NN,6,1
8142,58119.0,52,wrote,22,25,8,-17,24,43,-3,-14,his,leader,PERSON,TITLE,DET,NOUN,poss,pobj,PRP$,NN,8,1
8143,60078.0,35,winner,3,33,15,-18,32,19,-30,12,his,leader,PERSON,TITLE,DET,NOUN,poss,pobj,PRP$,NN,9,1
8144,27557.0,21,disagreed,6,9,4,-5,8,16,-3,-2,Lee,United States,PERSON,COUNTRY-COUNTRY,PROPN,PROPN-PROPN,poss,compound-nsubj,NNP,NNP-NNP,5,1
8145,27564.0,32,UTC,5,3,10,7,2,21,2,5,Pennsylvania,Justice Thomas Saylor,ORGANIZATION,PERSON-PERSON-PERSON,PROPN,PROPN-PROPN-PROPN,npadvmod,compound-compound-pobj,NNP,NNP-NNP-NNP,6,1
8146,27569.0,26,spent,1,15,15,0,14,10,-14,14,China National Aviation Corp.,China,ORGANIZATION-ORGANIZATION-ORGANIZATION-ORGANIZATION,COUNTRY,PROPN-PROPN-PROPN-PROPN,PROPN,compound-compound-compound-pobj,pobj,NNP-NNP-NNP-NNP,NNP,0,1
8147,27575.0,19,returned,5,1,3,2,0,15,4,-2,Blackburn,Ryan Nelsen,ORGANIZATION,PERSON-PERSON,NOUN,PROPN-PROPN,compound,compound-nsubj,NN,NNP-NNP,1,1
8148,27585.0,12,been,5,4,2,-2,3,9,1,-3,banker,58-year-old,PERSON,NUMBER,NOUN,NUM,nsubj,amod,NN,CD,3,1
8149,27587.0,44,spoke,10,2,7,5,1,36,8,-3,her,Globe,PERSON,ORGANIZATION,DET,PROPN,poss,pobj,PRP$,NNP,4,1
8150,27593.0,16,died,9,1,4,3,0,11,8,-5,Barnes Foundation,http://wwwbarnesfoundationorg,ORGANIZATION-ORGANIZATION,URL,PROPN-PROPN,PUNCT,compound-nsubj,ccomp,NNP-NNP,.,2,1
8151,43132.0,57,http://wwwbarnesfoundationorg,3,1,4,3,0,52,2,1,Barnes Foundation,http://wwwbarnesfoundationorg,ORGANIZATION-ORGANIZATION,URL,PROPN-PROPN,PROPN,compound-nsubj,ROOT,NNP-NNP,NNP,4,1
8152,27596.0,21,said,4,2,6,4,1,14,2,2,Popular Resistance Committees,Abu Said Qarmout,ORGANIZATION-ORGANIZATION-ORGANIZATION,PERSON-PERSON-PERSON,PROPN-PROPN-PROPN,PROPN-VERB-PROPN,compound-compound-nsubj,compound-compound-nsubjpass,NNP-NNP-NNPS,NNP-VBD-NNP,4,1
8153,27597.0,26,think,4,16,11,-5,15,14,-12,7,his,mayor,PERSON,TITLE,DET,NOUN,poss,attr,PRP$,NN,6,1
8154,27600.0,34,studied,4,4,2,-2,3,31,0,-2,he,Oxford,PERSON,CITY,PRON,PROPN,nsubj,pobj,PRP,NNP,1,1
8155,27607.0,19,says,3,2,1,-1,1,17,1,-2,Ellen Pompeo,Actress,PERSON-PERSON,TITLE,PROPN-PROPN,PROPN,compound-nsubj,compound,NNP-NNP,NNP,1,1
8156,27610.0,28,said,17,7,10,3,6,17,10,-7,Yolanda King,she,PERSON-PERSON,PERSON,PROPN-PROPN,PRON,compound-pobj,nsubj,NNP-NNP,PRP,3,1
8157,27615.0,25,said,12,24,14,-10,23,10,-12,2,ABA,Ken Clayton,ORGANIZATION,PERSON-PERSON,NOUN,PROPN-PROPN,pobj,compound-nsubj,NN,NNP-NNP,2,1
8158,27616.0,14,played,1,8,5,-3,7,8,-7,4,ABA,Nuggets,ORGANIZATION,ORGANIZATION,PROPN,PROPN,pobj,pobj,NNP,NNPS,2,1
8159,27626.0,39,arrested,14,4,12,8,3,26,10,-2,Irene Morgan,1917,PERSON-PERSON,DATE,PROPN-PROPN,NUM,compound-appos,pobj,NNP-NNP,CD,3,1
8160,56307.0,36,arrested,11,4,9,5,3,26,7,-2,Irene Morgan,1917,PERSON-PERSON,DATE,PROPN-PROPN,NUM,compound-appos,pobj,NNP-NNP,CD,3,1
8161,27637.0,24,said,1,1,3,2,0,20,0,2,Ospel,second-quarter,PERSON,DATE,NOUN,ADJ,nsubj,amod,NN,JJ,4,1
8162,27644.0,40,said,32,38,36,-2,37,3,-6,4,William Anderson,Assistant Secretary,PERSON-PERSON,TITLE-TITLE,PROPN-PROPN,PROPN-PROPN,compound-nsubj,compound-compound,NNP-NNP,NNP-NNP,3,1
8163,27658.0,24,born,4,2,19,17,1,4,2,15,Gertrude Dittmars Roraback,Albert,PERSON-PERSON-PERSON,PERSON,PROPN-PROPN-PROPN,PROPN,conj-compound-appos,pobj,NNP-NNP-NNP,NNP,8,1
8164,27664.0,52,include,1,20,15,-5,19,36,-19,14,Harry Dent,SC,PERSON-PERSON,STATE_OR_PROVINCE,PROPN-PROPN,PROPN,compound-compound,conj,NNP-NNP,NNP,4,1
8165,27666.0,79,survived,8,7,47,40,6,31,1,39,Meskill,Thomas,PERSON,PERSON,PROPN,PROPN,nsubjpass,conj,NNP,NNP,13,1
8166,27680.0,41,led,5,30,32,2,29,8,-25,27,Raul,76,PERSON,NUMBER,PROPN,NUM,appos,appos,NNP,CD,4,1
8167,55479.0,33,come,3,20,22,2,19,10,-17,19,Raul,76,PERSON,NUMBER,PROPN,NUM,appos,appos,NNP,CD,4,1
8168,27697.0,36,lagged,5,31,34,3,30,1,-26,29,AAA,automobile club,ORGANIZATION,ORGANIZATION-ORGANIZATION,PROPN,NOUN-NOUN,pobj,compound-appos,NNP,NN-NN,2,1
8169,59552.0,44,said,32,39,42,3,38,1,-7,10,AAA,automobile club,ORGANIZATION,ORGANIZATION-ORGANIZATION,PROPN,NOUN-NOUN,pobj,compound-appos,NNP,NN-NN,5,1
8170,27723.0,45,include,1,28,13,-15,27,31,-27,12,Gilbert Gude,Washington,PERSON-PERSON,STATE_OR_PROVINCE,PROPN-PROPN,PROPN,compound-compound,pobj,NNP-NNP,NNP,5,1
8171,27735.0,40,*,0,2,9,7,1,30,-2,9,Richard Perle,Defense Advisory Board,PERSON-PERSON,ORGANIZATION-ORGANIZATION-ORGANIZATION,PROPN-PROPN,PROPN-PROPN-PROPN,compound-nsubj,compound-compound-pobj,NNP-NNP,NNP-NNP-NNP,4,1
8172,27740.0,46,is,7,41,43,2,40,2,-34,36,Waratahs,Phil Waugh,ORGANIZATION,PERSON-PERSON,PROPN,PROPN-PROPN,compound,compound-nsubj,NNP,NNP-NNP,5,1
8173,56708.0,25,said,4,1,3,2,0,21,3,-1,Waratahs,Phil Waugh,ORGANIZATION,PERSON-PERSON,PROPN,PROPN-PROPN,compound,compound-nsubj,NNP,NNP-NNP,1,1
8174,27750.0,90,like,4,38,3,-35,37,86,-34,-1,MNLF,Philippines,ORGANIZATION,COUNTRY,PROPN,PROPN,pobj,nsubj,NNP,NNPS,10,1
8175,40364.0,37,was,1,11,36,25,10,0,-10,35,MNLF,Philippines,ORGANIZATION,COUNTRY,PROPN,PROPN,compound,appos,NNP,NNP,2,1
8176,27753.0,35,began,3,10,22,12,9,12,-7,19,New Jerusalem Foundation,Talansky,ORGANIZATION-ORGANIZATION-ORGANIZATION,PERSON,PROPN-PROPN-PROPN,PROPN,compound-compound-pobj,pobj,NNP-NNP-NNP,NNP,9,1
8177,31885.0,39,show,3,20,6,-14,19,32,-17,3,New Jerusalem Foundation,Talansky,ORGANIZATION-ORGANIZATION-ORGANIZATION,PERSON,PROPN-PROPN-PROPN,PROPN,compound-compound-pobj,nsubj,NNP-NNP-NNP,NNP,7,1
8178,45493.0,24,is,1,9,1,-8,8,22,-8,0,New Jerusalem Foundation,Talansky,ORGANIZATION-ORGANIZATION-ORGANIZATION,PERSON,PROPN-PROPN-PROPN,PROPN,compound-compound-pobj,nsubj,NNP-NNP-NNP,NNP,4,1
8179,27757.0,39,convicted,7,4,18,14,3,20,3,11,Hashim Ahmad al-Tai,genocide,PERSON-PERSON-PERSON,CRIMINAL_CHARGE,PROPN-PROPN-PROPN,NOUN,compound-nsubjpass-punct,pobj,NNP-NNP-NNP,NN,7,1
8180,27760.0,16,said,13,15,8,-7,14,7,-2,-5,Abrams,NBC,PERSON,ORGANIZATION,PROPN,PROPN,nsubj,compound,NNP,NNP,4,1
8181,27778.0,36,shocked,2,12,5,-7,11,30,-10,3,Blackburn Rovers,Sam Allardyce,ORGANIZATION-ORGANIZATION,PERSON-PERSON,PROPN-PROPN,PROPN-PROPN,compound-pobj,compound-nsubjpass,NNP-NNP,NNP-NNP,7,1
8182,27789.0,28,have,6,12,24,12,11,3,-6,18,ABA,Spurs,ORGANIZATION,ORGANIZATION,NOUN,PROPN,pobj,pobj,NN,NNPS,7,1
8183,27797.0,44,said,34,32,16,-16,31,27,2,-18,Denso Corp,Guangdong Province,ORGANIZATION-ORGANIZATION,LOCATION-LOCATION,PROPN-PROPN,PROPN-PROPN,compound-appos,compound-pobj,NNP-NNP,NNP-NNP,7,1
8184,27825.0,22,said,10,2,20,18,1,1,8,10,He,attorney general,PERSON,TITLE-TITLE,PRON,NOUN-NOUN,nsubj,compound-pobj,PRP,NN-NN,8,1
8185,27862.0,30,was,6,6,4,-2,5,25,0,-2,he,Washington,PERSON,STATE_OR_PROVINCE,PRON,PROPN,nsubj,pobj,PRP,NNP,1,1
8186,27866.0,14,gets,3,2,13,11,1,0,1,10,Remy Ma,NYC nightclub,PERSON-PERSON,LOCATION-LOCATION,PROPN-PROPN,PROPN-NOUN,compound-nsubj,compound-pobj,NNP-NNP,NNP-NN,5,1
8187,27881.0,45,changed,23,1,21,20,0,23,22,-2,Irene Morgan Kirkaldy,Va.,PERSON-PERSON-PERSON,STATE_OR_PROVINCE,PROPN-PROPN-PROPN,PROPN,compound-compound-nsubj,appos,NNP-NNP-NNP,NNP,2,1
8188,64342.0,40,lay,21,1,39,38,0,0,20,18,Irene Morgan Kirkaldy,Va.,PERSON-PERSON-PERSON,STATE_OR_PROVINCE,PROPN-PROPN-PROPN,PROPN,compound-compound-nsubj,appos,NNP-NNP-NNP,NNP,3,1
8189,27884.0,36,said,12,8,1,-7,7,34,4,-11,Servicemembers Legal Defense Network,Kevin Nix,ORGANIZATION-ORGANIZATION-ORGANIZATION-ORGANIZATION,PERSON-PERSON,PROPN-PROPN-PROPN-PROPN,PROPN-PROPN,compound-compound-compound-pobj,compound-nsubj,NNP-NNP-NNP-NNP,NNP-NNP,5,1
8190,68063.0,27,said,15,23,17,-6,22,9,-8,2,Servicemembers Legal Defense Network,Kevin Nix,ORGANIZATION-ORGANIZATION-ORGANIZATION-ORGANIZATION,PERSON-PERSON,PROPN-PROPN-PROPN-PROPN,PROPN-PROPN,compound-compound-compound-pobj,compound-nsubj,NNP-NNP-NNP-NNP,NNP-NNP,5,1
8191,27889.0,35,ordered,6,3,1,-2,2,33,3,-5,Ayatollah Ali Khamenei,Supreme,PERSON-PERSON-PERSON,ORGANIZATION,PROPN-PROPN-PROPN,PROPN,compound-compound-nsubj,compound,NNP-NNP-NNP,NNP,2,1
8192,61548.0,22,began,5,3,1,-2,2,20,2,-4,Ayatollah Ali Khamenei,Supreme,PERSON-PERSON-PERSON,ORGANIZATION,PROPN-PROPN-PROPN,PROPN,compound-compound-nsubj,compound,NNP-NNP-NNP,NNP,2,1
8193,27891.0,31,Dobson,2,8,2,-6,7,28,-6,0,FOF,James Dobson,ORGANIZATION,PERSON-PERSON,PROPN,PROPN-PROPN,pobj,compound-ROOT,NNP,NNP-NNP,4,1
8194,27894.0,24,is,4,7,18,11,6,5,-3,14,American Psychological Association,Nicholas A Cummings,ORGANIZATION-ORGANIZATION-ORGANIZATION,PERSON-PERSON-PERSON,PROPN-PROPN-PROPN,PROPN-PROPN-PROPN,compound-compound-attr,compound-compound-conj,NNP-NNP-NNP,NNP-NNP-NNP,5,1
8195,27903.0,16,having,12,8,5,-3,7,10,4,-7,Steve McPherson,Entertainment Group,PERSON-PERSON,ORGANIZATION-ORGANIZATION,PROPN-PROPN,PROPN-PROPN,compound-appos,compound-compound,NNP-NNP,NNP-NNP,2,1
8196,27910.0,26,accused,14,3,1,-2,2,24,11,-13,Ali Larijani,Parliament,PERSON-PERSON,ORGANIZATION,PROPN-PROPN,NOUN,compound-nsubj,compound,NNP-NNP,NN,1,1
8197,27911.0,28,said,7,2,5,3,1,22,5,-2,FMF,Decio De Maria,ORGANIZATION,PERSON-PERSON-PERSON,PROPN,PROPN-PROPN-PROPN,nmod,compound-compound-appos,NNP,NNP-NNP-NNP,3,1
8198,27916.0,19,Cutrone,0,1,5,4,0,13,-1,5,Cutrone,New Yorker,PERSON,LOCATION-LOCATION,NOUN,PROPN-PROPN,ROOT,compound-attr,NN,NNP-NNP,2,1
8199,27923.0,31,surprised,4,3,6,3,2,24,1,2,MBIA Inc.,Wall Street,ORGANIZATION-ORGANIZATION,LOCATION-LOCATION,PROPN-PROPN,PROPN-PROPN,compound-nsubj,compound-dobj,NNP-NNP,NNP-NNP,2,1
8200,27954.0,44,recorded,24,17,1,-16,16,42,7,-23,Jewish National Fund,Yosef Nachmani,ORGANIZATION-ORGANIZATION-ORGANIZATION,PERSON-PERSON,ADJ-PROPN-PROPN,PROPN-PROPN,amod-compound-pobj,compound-nsubj,JJ-NNP-NNP,NNP-NNP,4,1
8201,27960.0,13,became,9,3,3,0,2,9,6,-6,Richmond Jr,Richmond III,PERSON-PERSON,PERSON-PERSON,PROPN-PROPN,PROPN-PROPN,compound-appos,compound-conj,NNP-NNP,NNP-NNP,0,1
8202,27962.0,50,died,35,1,7,6,0,42,34,-28,Gilbert Gude,congressman,PERSON-PERSON,TITLE,PROPN-PROPN,NOUN,compound-nsubj,appos,NNP-NNP,NN,2,1
8203,27964.0,6,Chavez,1,5,1,-4,4,4,-4,0,Hugo Chavez,Anibal Chavez,PERSON-PERSON,PERSON-PERSON,PROPN-PROPN,PROPN-PROPN,compound-appos,compound-ROOT,NNP-NNP,NNP-NNP,1,1
8204,27970.0,32,survived,7,12,23,11,11,8,-5,16,his,Kelly Harris,PERSON,PERSON-PERSON,DET,PROPN-PROPN,poss,compound-conj,PRP$,NNP-NNP,5,1
8205,27977.0,58,WAS,2,36,34,-2,35,23,-34,32,Kate Gosselin,Jon,PERSON-PERSON,PERSON,PROPN-PROPN,PROPN,conj-conj,pobj,NNP-NNP,NNP,1,1
8206,47164.0,30,says,3,11,9,-2,10,20,-8,6,Kate Gosselin,Jon,PERSON-PERSON,PERSON,PROPN-PROPN,PROPN,conj-appos,nmod,NNP-NNP,NNP,2,1
8207,27980.0,26,Season,0,4,25,21,3,0,-4,25,Trista Rehn,him,PERSON-PERSON,PERSON,PROPN-PROPN,PRON,ROOT-ROOT,dobj,NNP-NNP,PRP,2,1
8208,27985.0,74,said,41,43,61,18,42,12,-2,20,Lindsay M Hayes,Massachusetts Department of Correction,PERSON-PERSON-PERSON,ORGANIZATION-ORGANIZATION-ORGANIZATION-ORGANIZATION,PROPN-PROPN-PROPN,PROPN-PROPN-ADP-PROPN,compound-compound-nsubj,compound-pobj-prep-pobj,NNP-NNP-NNP,NNP-NNP-IN-NNP,6,1
8209,27995.0,24,presented,5,11,9,-2,10,14,-6,4,Haddad Adel,Majlis,PERSON-PERSON,ORGANIZATION,PROPN-PROPN,PROPN,compound-pobj,compound,NNP-NNP,NNP,1,1
8210,28007.0,36,involve,4,32,27,-5,31,8,-28,23,China National Aviation Co.,CNAC,ORGANIZATION-ORGANIZATION-ORGANIZATION-ORGANIZATION,ORGANIZATION,PROPN-PROPN-PROPN-PROPN,PROPN,compound-compound-compound-pobj,compound,NNP-NNP-NNP-NNP,NNP,-1,1
8211,28021.0,35,said,17,25,34,9,24,0,-8,17,Focus on the Family,Colo,ORGANIZATION-ORGANIZATION-ORGANIZATION-ORGANIZATION,STATE_OR_PROVINCE,PROPN-ADP-DET-PROPN,PROPN,pobj-prep-det-compound,appos,NNP-IN-DT-NNP,NNP,3,1
8212,28043.0,18,worked,1,1,12,11,0,5,0,11,He,Maryland House of Delegates,PERSON,ORGANIZATION-ORGANIZATION-ORGANIZATION-ORGANIZATION,PRON,PROPN-PROPN-ADP-PROPN,nsubj,compound-pobj-prep-pobj,PRP,NNP-NNP-IN-NNPS,4,1
8213,28054.0,63,said,1,38,54,16,37,8,-37,53,Ownit Mortgage Solutions,800,ORGANIZATION-ORGANIZATION-ORGANIZATION,NUMBER,PROPN-PROPN-PROPN,NUM,compound-compound-compound,nummod,NNP-NNP-NNPS,CD,13,1
8214,28063.0,24,opened,15,17,13,-4,16,10,-2,-2,her,host,PERSON,TITLE,DET,NOUN,poss,compound,PRP$,NN,3,1
8215,28072.0,38,Meanwhile,0,8,19,11,7,18,-8,19,Adam,model,PERSON,TITLE,PROPN,NOUN,dobj,nsubj,NNP,NN,-1,1
8216,28079.0,40,predicted,15,6,9,3,5,30,9,-6,Al Hubbard,chairman of the National Economic Council,PERSON-PERSON,ORGANIZATION-ORGANIZATION-ORGANIZATION-ORGANIZATION-ORGANIZATION-ORGANIZATION,PROPN-PROPN,NOUN-ADP-DET-PROPN-PROPN-PROPN,compound-nsubj,appos-prep-det-compound-compound-pobj,NNP-NNP,NN-IN-DT-NNP-NNP-NNP,2,1
8217,28090.0,54,survived,2,29,8,-21,28,45,-27,6,David Kaiser,Hannah Greeley Kaiser,PERSON-PERSON,PERSON-PERSON-PERSON,PROPN-PROPN,PROPN-PROPN-PROPN,compound-appos,compound-compound-appos,NNP-NNP,NNP-NNP-NNP,4,1
8218,28092.0,53,said,14,51,47,-4,50,5,-37,33,FMF,Foreign Military Fund,ORGANIZATION,ORGANIZATION-ORGANIZATION-ORGANIZATION,PROPN,PROPN-PROPN-PROPN,compound,compound-compound-pobj,NNP,NNP-NNP-NNP,7,1
8219,28096.0,25,stars,5,19,7,-12,18,17,-14,2,Sean Parker,Jesse Eisenberg,PERSON-PERSON,PERSON-PERSON,PROPN-PROPN,PROPN-PROPN,compound-pobj,compound-dobj,NNP-NNP,NNP-NNP,5,1
8220,28109.0,23,left,11,18,18,0,17,4,-7,7,Phoenix Baptist Church,Phoenix,ORGANIZATION-ORGANIZATION-ORGANIZATION,STATE_OR_PROVINCE,PROPN-PROPN-PROPN,PROPN,compound-compound-pobj,pobj,NNP-NNP-NNP,NNP,0,1
8221,28111.0,57,offer,20,1,9,8,0,47,19,-11,Chunghwa Telecom Co.,9.5 million,ORGANIZATION-ORGANIZATION-ORGANIZATION,NUMBER-NUMBER,PROPN-PROPN-PROPN,NUM-NUM,compound-compound-nsubj,compound-nummod,NNP-NNP-NNP,CD-CD,4,1
8222,28134.0,31,went,3,11,22,11,10,8,-8,19,Cowell,producer,PERSON,TITLE,PROPN,NOUN,pobj,conj,NNP,NN,3,1
8223,28139.0,40,announced,38,2,36,34,1,3,36,-2,Bernama,Mohd Annuar Zaini,ORGANIZATION,PERSON-PERSON-PERSON,PROPN,PROPN-PROPN-PROPN,compound,compound-compound-nsubj,NNP,NNP-NNP-NNP,4,1
8224,67906.0,43,LUMPUR,1,9,11,2,8,31,-8,10,Bernama,Mohd Annuar Zaini,ORGANIZATION,PERSON-PERSON-PERSON,PROPN,PROPN-PROPN-PROPN,compound,compound-compound-nsubj,NNP,NNP-NNP-NNP,2,1
8225,28146.0,20,fought,13,13,4,-9,12,15,0,-9,Bolin,Domestic Relations Court,PERSON,ORGANIZATION-ORGANIZATION-ORGANIZATION,PROPN,PROPN-PROPN-PROPN,nsubj,compound-compound-pobj,NNP,NNP-NNPS-NNP,5,1
8226,28147.0,24,owned,3,19,6,-13,18,17,-16,3,Federal Motor Carrier Safety Administration,Northeast Carriers LLC,ORGANIZATION-ORGANIZATION-ORGANIZATION-ORGANIZATION-ORGANIZATION,ORGANIZATION-ORGANIZATION-ORGANIZATION,PROPN-PROPN-PROPN-PROPN-PROPN,PROPN-PROPN-PROPN,compound-compound-compound-compound-pobj,compound-compound-pobj,NNP-NNP-NNP-NNP-NNP,NNP-NNP-NNP,7,1
8227,28150.0,38,added,1,1,7,6,0,30,0,6,He,US,PERSON,COUNTRY,PRON,PROPN,nsubj,nmod,PRP,NNP,6,1
8228,28151.0,22,is,2,1,20,19,0,1,1,18,Option One,California,ORGANIZATION-ORGANIZATION,STATE_OR_PROVINCE,NOUN-NUM,PROPN,compound-nsubj,compound,NN-CD,NNP,3,1
8229,28154.0,22,started,1,1,7,6,0,14,0,6,He,lawyer,PERSON,TITLE,PRON,NOUN,nsubj,pobj,PRP,NN,1,1
8230,28158.0,24,LCronin09,0,4,23,19,3,0,-4,23,Olivia,Elle,PERSON,ORGANIZATION,PROPN,PROPN,nsubj,pobj,NNP,NNP,2,1
8231,36981.0,14,focusing,3,1,12,11,0,1,2,9,Olivia,Elle,PERSON,ORGANIZATION,PROPN,PROPN,nsubj,compound,NNP,NNP,3,1
8232,28172.0,29,accompanied,6,1,4,3,0,24,5,-2,His,Barbara,PERSON,PERSON,DET,PROPN,poss,appos,PRP$,NNP,2,1
8233,28182.0,40,was,1,1,18,17,0,21,0,17,King,Southern Christian Leadership Conference,PERSON,ORGANIZATION-ORGANIZATION-ORGANIZATION-ORGANIZATION,PROPN,PROPN-PROPN-PROPN-PROPN,nsubj,compound-compound-compound-pobj,NNP,NNP-NNP-NNP-NNP,5,1
8234,28196.0,59,said,38,56,47,-9,55,11,-18,9,Highland Capital Partners,Lexington,ORGANIZATION-ORGANIZATION-ORGANIZATION,CITY,PROPN-PROPN-PROPN,PROPN,compound-compound-pobj,nmod,NNP-NNP-NNPS,NNP,5,1
8235,30153.0,27,said,12,22,26,4,21,0,-10,14,Highland Capital Partners,Lexington,ORGANIZATION-ORGANIZATION-ORGANIZATION,CITY,PROPN-PROPN-PROPN,PROPN,compound-compound-pobj,pobj,NNP-NNP-NNP,NNP,2,1
8236,34116.0,44,said,15,24,28,4,23,15,-9,13,Highland Capital Partners,Lexington,ORGANIZATION-ORGANIZATION-ORGANIZATION,CITY,PROPN-PROPN-PROPN,PROPN,compound-compound-pobj,pobj,NNP-NNP-NNP,NNP,5,1
8237,44708.0,33,said,11,21,25,4,20,7,-10,14,Highland Capital Partners,Lexington,ORGANIZATION-ORGANIZATION-ORGANIZATION,CITY,PROPN-PROPN-PROPN,PROPN,compound-compound-pobj,pobj,NNP-NNP-NNP,NNP,2,1
8238,54856.0,33,said,11,21,25,4,20,7,-10,14,Highland Capital Partners,Lexington,ORGANIZATION-ORGANIZATION-ORGANIZATION,CITY,PROPN-PROPN-PROPN,PROPN,compound-compound-pobj,pobj,NNP-NNP-NNP,NNP,2,1
8239,64272.0,28,is,2,9,18,9,8,9,-7,16,Highland Capital Partners,Lexington,ORGANIZATION-ORGANIZATION-ORGANIZATION,CITY,PROPN-PROPN-PROPN,PROPN,compound-compound-attr,pobj,NNP-NNP-NNPS,NNP,5,1
8240,66574.0,27,said,12,22,26,4,21,0,-10,14,Highland Capital Partners,Lexington,ORGANIZATION-ORGANIZATION-ORGANIZATION,CITY,PROPN-PROPN-PROPN,PROPN,compound-compound-pobj,pobj,NNP-NNP-NNP,NNP,2,1
8241,28204.0,37,said,32,3,2,-1,2,34,29,-30,Hawkins,Congressman,PERSON,TITLE,PROPN,PROPN,nsubj,compound,NNP,NNP,1,1
8242,29668.0,37,said,32,3,2,-1,2,34,29,-30,Hawkins,Congressman,PERSON,ORGANIZATION,PROPN,PROPN,nsubj,compound,NNP,NNP,1,1
8243,28220.0,91,have,30,1,90,89,0,0,29,60,Cathleen P. Black,IBM,PERSON-PERSON-PERSON,ORGANIZATION,PROPN-PROPN-PROPN,PROPN,compound-compound-nsubj,conj,NNP-NNP-NNP,NNP,-1,1
8244,52532.0,36,step,19,1,35,34,0,0,18,16,Cathleen P. Black,IBM,PERSON-PERSON-PERSON,ORGANIZATION,PROPN-PROPN-PROPN,PROPN,compound-compound-nsubj,conj,NNP-NNP-NNP,NNP,8,1
8245,28222.0,17,pronounced,3,1,15,14,0,1,2,12,Mrs Gude,Rockville,PERSON-PERSON,CITY,PROPN-PROPN,PROPN,compound-compound,pobj,NNP-NNP,NNP,4,1
8246,28229.0,28,said,15,6,4,-2,5,23,9,-11,Citibank,Haiti,ORGANIZATION,COUNTRY,PROPN,PROPN,pobj,poss,NNP,NNP,5,1
8247,28240.0,17,dies,2,1,5,4,0,11,1,3,Art Buchwald,81,PERSON-PERSON,NUMBER,PROPN-PROPN,NUM,compound-nsubj,pobj,NNP-NNP,CD,2,1
8248,36701.0,21,said,18,7,15,8,6,5,11,-3,Art Buchwald,81,PERSON-PERSON,NUMBER,PROPN-PROPN,NUM,compound-conj,pobj,NNP-NNP,CD,4,1
8249,28249.0,50,APPEAL,4,21,17,-4,20,32,-17,13,Christopher J Dodd,Senate,PERSON-PERSON-PERSON,ORGANIZATION,PROPN-PROPN-PROPN,PROPN,compound-compound-pobj,compound,NNP-NNP-NNP,NNP,5,1
8250,28250.0,16,is,6,2,4,2,1,11,4,-2,brother,Mohammad Javad,PERSON,PERSON-PERSON,NOUN,PROPN-PROPN,nsubj,compound-appos,NN,NNP-NNP,2,1
8251,28254.0,13,Leader,1,9,2,-7,8,10,-8,1,George Young,Leader,PERSON-PERSON,TITLE,PROPN-PROPN,NOUN,compound-compound,ROOT,NNP-NNP,NN,2,1
8252,28259.0,27,been,2,1,26,25,0,0,1,24,He,India,PERSON,COUNTRY,PRON,PROPN,nsubj,pobj,PRP,NNP,2,1
8253,28269.0,49,licensed,4,10,41,31,9,7,-6,37,Alcatel - Lucent,Bell Labs,ORGANIZATION-ORGANIZATION-ORGANIZATION,ORGANIZATION-ORGANIZATION,PROPN-PUNCT-PROPN,PROPN-PROPN,compound-punct-pobj,compound-conj,NNP-HYPH-NNP,NNP-NNPS,8,1
8254,28276.0,40,proposed,14,6,25,19,5,14,8,11,Marcel Ospel,49,PERSON-PERSON,NUMBER,PROPN-PROPN,NUM,compound-nsubj,appos,NNP-NNP,CD,5,1
8255,28284.0,42,acquired,38,27,1,-26,26,40,11,-37,Old Lane LP,Citigroup,ORGANIZATION-ORGANIZATION-ORGANIZATION,ORGANIZATION,PROPN-PROPN-PROPN,PROPN,compound-compound-appos,pobj,NNP-NNP-NNP,NNP,6,1
8256,28289.0,29,began,9,5,28,23,4,0,4,19,his,writer,PERSON,TITLE,DET,NOUN,poss,pobj,PRP$,NN,5,1
8257,28300.0,55,comes,12,4,10,6,3,44,8,-2,Julian Bond,All Families Campaign,PERSON-PERSON,ORGANIZATION-ORGANIZATION-ORGANIZATION,PROPN-PROPN,DET-PROPN-PROPN,compound-pobj,det-compound-pobj,NNP-NNP,DT-NNPS-NNP,7,1
8258,28327.0,26,interviewed,8,7,5,-2,6,20,1,-3,Bill McAllister,TV reporter,PERSON-PERSON,TITLE-TITLE,PROPN-PROPN,NOUN-NOUN,compound-nsubj,compound-compound,NNP-NNP,NN-NN,1,1
8259,28330.0,33,founded,11,4,18,14,3,14,7,7,Asian Development Bank,China,ORGANIZATION-ORGANIZATION-ORGANIZATION,COUNTRY,PROPN-PROPN-PROPN,PROPN,compound-compound-pobj,dobj,NNP-NNP-NNP,NNP,6,1
8260,28338.0,13,spent,5,1,8,7,0,4,4,3,His,New Jersey,PERSON,STATE_OR_PROVINCE-STATE_OR_PROVINCE,DET,PROPN-PROPN,poss,compound-poss,PRP$,NNP-NNP,6,1
8261,28343.0,28,called,11,21,14,-7,20,13,-10,3,AQR Capital,Clifford S. Asness,ORGANIZATION-ORGANIZATION,PERSON-PERSON-PERSON,PROPN-PROPN,PROPN-PROPN-PROPN,compound-pobj,compound-compound-dobj,NNP-NNP,NNP-NNP-NNP,6,1
8262,28356.0,49,DOTHAN,0,7,4,-3,6,44,-7,4,Flowers,2007-08-10,PERSON,DATE,PROPN,NUM,nsubjpass,nummod,NNPS,CD,3,1
8263,28367.0,36,announced,32,16,1,-15,15,34,16,-31,Gholam Ali Haddad Adel,Majlis,PERSON-PERSON-PERSON-PERSON,ORGANIZATION,PROPN-PROPN-PROPN-PROPN,PROPN,compound-compound-compound-nsubj,compound,NNP-NNP-NNP-NNP,NNP,3,1
8264,28384.0,24,came,1,1,19,18,0,4,0,18,Johns,Tifton,PERSON,CITY,PROPN,PROPN,nsubj,nmod,NNP,NNP,3,1
8265,28386.0,28,received,1,21,19,-2,20,8,-20,18,Institute for Diversity and Ethics in Sports,Florida,ORGANIZATION-ORGANIZATION-ORGANIZATION-ORGANIZATION-ORGANIZATION-ORGANIZATION-ORGANIZATION,STATE_OR_PROVINCE,PROPN-ADP-PROPN-CCONJ-PROPN-ADP-PROPN,PROPN,pobj-prep-pobj-cc-conj-prep-pobj,poss,NNP-IN-NNP-CC-NNP-IN-NNPS,NNP,2,1
8266,28388.0,43,said,36,13,15,2,12,27,23,-21,NEC,National Electoral Commission,ORGANIZATION,ORGANIZATION-ORGANIZATION-ORGANIZATION,PROPN,PROPN-PROPN-PROPN,nmod,compound-compound-compound,NNP,NNP-NNP-NNP,3,1
8267,28401.0,26,established,3,2,8,6,1,17,1,5,ADB,31,ORGANIZATION,NUMBER,PROPN,NUM,nsubjpass,nummod,NNP,CD,3,1
8268,28412.0,37,shows,1,16,4,-12,15,32,-15,3,Gillmor,congressman,PERSON,ORGANIZATION,PROPN,NOUN,poss,nsubj,NNP,NN,6,1
8269,28415.0,31,formed,3,2,6,4,1,24,1,3,IMF,1944,ORGANIZATION,DATE,PROPN,NUM,nsubjpass,pobj,NNP,CD,3,1
8270,28416.0,60,survived,2,11,8,-3,10,51,-9,6,Josephine Robinson McNair,63 years,PERSON-PERSON-PERSON,DURATION-DURATION,PROPN-PROPN-PROPN,NUM-NOUN,compound-compound-appos,nummod-pobj,NNP-NNP-NNP,CD-NNS,7,1
8271,28422.0,13,was,1,1,7,6,0,5,0,6,He,Phillips Exeter Academy,PERSON,ORGANIZATION-ORGANIZATION-ORGANIZATION,PRON,PROPN-PROPN-PROPN,nsubj,compound-compound-pobj,PRP,NNP-NNP-NNP,5,1
8272,28465.0,30,became,1,1,10,9,0,19,0,9,Davis,Congress,PERSON,ORGANIZATION,PROPN,PROPN,nsubj,pobj,NNP,NNP,3,1
8273,28469.0,48,rose,42,6,13,7,5,34,36,-29,Roraback,executive director,PERSON,TITLE-TITLE,PROPN,ADJ-NOUN,nsubj,amod-nsubj,NNP,JJ-NN,1,1
8274,28481.0,37,IAEA,10,2,11,9,1,25,8,1,Iranian ambassador,IAEA,PERSON-PERSON,ORGANIZATION,ADJ-NOUN,PROPN,amod-nsubj,ROOT,JJ-NN,NNP,1,1
8275,28484.0,22,says,3,5,12,7,4,9,-2,9,Kate Gosselin,caretaker,PERSON-PERSON,TITLE,PROPN-PROPN,NOUN,compound-nsubj,pobj,NNP-NNP,NN,4,1
8276,28493.0,43,said,41,39,28,-11,38,14,2,-13,IAPA,General Assembly of the Inter American Press Association,ORGANIZATION,ORGANIZATION-ORGANIZATION-ORGANIZATION-ORGANIZATION-ORGANIZATION-ORGANIZATION-ORGANIZATION-ORGANIZATION,PROPN,PROPN-PROPN-ADP-DET-PROPN-PROPN-PROPN-PROPN,poss,compound-pobj-prep-det-compound-compound-compound-pobj,NNP,NNP-NNP-IN-DT-NNP-NNP-NNP-NNP,7,1
8277,28494.0,24,born,4,1,19,18,0,4,3,15,Catherine Gertrude Roraback,Albert and Gertrude Dittmars Roraback,PERSON-PERSON-PERSON,PERSON-PERSON-PERSON-PERSON-PERSON,PROPN-PROPN-PROPN,PROPN-CCONJ-PROPN-PROPN-PROPN,compound-compound-nsubjpass,pobj-cc-conj-compound-npadvmod,NNP-NNP-NNP,NNP-CC-NNP-NNP-NNP,9,1
8278,28499.0,33,Philip,1,2,21,19,1,11,-1,20,Philip -LRB- Chen,representative,PERSON-PERSON-PERSON,TITLE,PROPN-PROPN-PROPN,NOUN,ROOT-punct-compound,pobj,NNP-NNP-NNP,NN,9,1
8279,28512.0,41,was,2,31,20,-11,30,20,-29,18,Dennis Dunn,she,PERSON-PERSON,PERSON,PROPN-PROPN,PRON,compound-appos,nsubj,NNP-NNP,PRP,4,1
8280,28533.0,33,said,7,2,4,2,1,28,5,-3,Larijani,President,PERSON,TITLE,PROPN,PROPN,nsubj,compound,NNP,NNP,3,1
8281,28536.0,36,sighed,9,11,17,6,10,18,-2,8,Abdul Jalil Jan,cleric,PERSON-PERSON-PERSON,TITLE,PROPN-PROPN-PROPN,NOUN,compound-compound-nsubj,appos,NNP-NNP-NNP,NN,5,1
8282,28543.0,48,died,37,42,45,3,41,2,-5,8,her,Fullerton,PERSON,CITY,DET,PROPN,poss,pobj,PRP$,NNP,3,1
8283,28559.0,41,said,39,1,22,21,0,18,38,-17,China National Aviation,Shandong Airlines,ORGANIZATION-ORGANIZATION-ORGANIZATION,ORGANIZATION-ORGANIZATION,PROPN-PROPN-PROPN,PROPN-PROPN,compound-compound-nsubj,compound-pobj,NNP-NNP-NNP,NNP-NNP,6,1
8284,28583.0,20,said,12,8,1,-7,7,18,4,-11,Medina Hospital,Sheikh Don Salad,ORGANIZATION-ORGANIZATION,PERSON-PERSON-PERSON,PROPN-PROPN,PROPN-PROPN-PROPN,compound-pobj,compound-compound-compound,NNP-NNP,NNP-NNP-NNP,4,1
8285,28585.0,35,said,16,25,34,9,24,0,-9,18,National Military Family Association,Va.,ORGANIZATION-ORGANIZATION-ORGANIZATION-ORGANIZATION,STATE_OR_PROVINCE,PROPN-PROPN-PROPN-PROPN,PROPN,compound-compound-compound-pobj,appos,NNP-NNP-NNP-NNP,NNP,8,1
8286,28589.0,36,called,25,8,1,-7,7,34,17,-24,New York Immigration Coalition,Chung-Hwa Hong,ORGANIZATION-ORGANIZATION-ORGANIZATION-ORGANIZATION,PERSON-PERSON,PROPN-PROPN-PROPN-PROPN,PROPN-PROPN,compound-compound-compound-pobj,compound-nsubj,NNP-NNP-NNP-NNP,NNP-NNP,5,1
8287,28603.0,4,was,1,1,3,2,0,0,0,2,She,57,PERSON,NUMBER,PRON,NUM,nsubj,attr,PRP,CD,1,1
8288,28608.0,30,died,2,1,22,21,0,7,1,20,Robert Goodman,she,PERSON-PERSON,PERSON,PROPN-PROPN,PRON,compound-nsubj,nsubj,NNP-NNP,PRP,5,1
8289,28618.0,62,APRIL,0,6,14,8,5,47,-6,14,Bryan Fuller,NBC,PERSON-PERSON,ORGANIZATION,PROPN-PROPN,PROPN,compound-nsubj,poss,NNP-NNP,NNP,5,1
8290,30207.0,24,returning,9,6,19,13,5,4,3,10,Bryan Fuller,NBC,PERSON-PERSON,ORGANIZATION,PROPN-PROPN,PROPN,compound-nsubj,poss,NNP-NNP,NNP,9,1
8291,31593.0,62,APRIL,0,6,14,8,5,47,-6,14,Bryan Fuller,NBC,PERSON-PERSON,ORGANIZATION,PROPN-PROPN,PROPN,compound-nsubj,poss,NNP-NNP,NNP,5,1
8292,49478.0,52,Mahandra,0,15,21,6,14,30,-15,21,Bryan Fuller,NBC,PERSON-PERSON,ORGANIZATION,PROPN-PROPN,PROPN,compound-nsubj,poss,NNP-NNP,NNP,5,1
8293,66069.0,34,cancel,2,16,29,13,15,4,-14,27,Bryan Fuller,NBC,PERSON-PERSON,ORGANIZATION,PROPN-PROPN,PROPN,compound-nsubj,poss,NNP-NNP,NNP,9,1
8294,28629.0,41,noted,9,8,40,32,7,0,1,31,Raul Castro,Fidel,PERSON-PERSON,PERSON,PROPN-PROPN,PROPN,compound-nsubj,appos,NNP-NNP,NNP,2,1
8295,34896.0,49,decision,1,26,37,11,25,11,-25,36,Raul Castro,Fidel,PERSON-PERSON,PERSON,PROPN-PROPN,PROPN,compound-pobj,appos,NNP-NNP,NNP,5,1
8296,51467.0,15,made,9,1,4,3,0,10,8,-5,Raul Castro,Fidel,PERSON-PERSON,PERSON,PROPN-PROPN,PROPN,compound-nsubj,poss,NNP-NNP,NNP,3,1
8297,63561.0,28,replaced,7,2,11,9,1,16,5,4,Raul Castro,Fidel,PERSON-PERSON,PERSON,PROPN-PROPN,PROPN,compound-nsubj,appos,NNP-NNP,NNP,2,1
8298,64108.0,29,took,8,6,18,12,5,10,2,10,Raul Castro,Fidel,PERSON-PERSON,PERSON,PROPN-PROPN,PROPN,compound-appos,nsubj,NNP-NNP,NNP,7,1
8299,28633.0,40,said,38,19,18,-1,18,21,19,-20,Abu Zubaydah,lieutenant,PERSON-PERSON,TITLE,PROPN-PROPN,NOUN,compound-pobj,compound,NNP-NNP,NN,1,1
8300,32772.0,15,Zubaydah,1,1,8,7,0,6,0,7,Abu Zubaydah,lieutenant,PERSON-PERSON,TITLE,PROPN-PROPN,NOUN,compound-ROOT,nsubj,NNP-NNP,NN,2,1
8301,28639.0,28,employed,6,12,16,4,11,11,-6,10,her,cook-trainee,PERSON,TITLE,DET,NOUN,poss,pobj,PRP$,NN,7,1
8302,28655.0,57,told,5,25,20,-5,24,36,-20,15,Chad White,Desoto Central Middle School,PERSON-PERSON,ORGANIZATION-ORGANIZATION-ORGANIZATION-ORGANIZATION,PROPN-PROPN,PROPN-PROPN-PROPN-PROPN,compound-compound,compound-compound-compound-pobj,NNP-NNP,NNP-NNP-NNP-NNP,5,1
8303,28670.0,31,ran,20,9,5,-4,8,25,11,-15,Anderson,Navy,PERSON,ORGANIZATION,PROPN,PROPN,nsubj,pobj,NNP,NNP,4,1
8304,28679.0,30,said,7,1,6,5,0,23,6,-1,Sheldon,deputy,PERSON,TITLE,PROPN,NOUN,nsubj,appos,NNP,NN,3,1
8305,28687.0,45,said,22,12,1,-11,11,43,10,-21,American Bar Association,Neal Sonnett,ORGANIZATION-ORGANIZATION-ORGANIZATION,PERSON-PERSON,PROPN-PROPN-PROPN,PROPN-PROPN,compound-compound-compound,compound-nsubj,NNP-NNP-NNP,NNP-NNP,5,1
8306,28701.0,24,said,8,6,1,-5,5,22,2,-7,FAA,Laura J. Brown,ORGANIZATION,PERSON-PERSON-PERSON,PROPN,PROPN-PROPN-PROPN,compound,compound-compound-nsubj,NNP,NNP-NNP-NNP,2,1
8307,28711.0,25,arrived,13,5,12,7,4,12,8,-1,Communist Party of China,Wu Guanzheng,ORGANIZATION-ORGANIZATION-ORGANIZATION-ORGANIZATION,PERSON-PERSON,PROPN-PROPN-ADP-PROPN,PROPN-PROPN,compound-pobj-prep-pobj,compound-nsubj,NNP-NNP-IN-NNP,NNP-NNP,4,1
8308,28713.0,8,Wednesday,6,2,5,3,1,2,4,-1,MAC,Fu Dong-cheng,ORGANIZATION,PERSON-PERSON,PROPN,PROPN-PROPN,compound,compound-compound,NNP,NNP-NNP,3,1
8309,59033.0,37,made,5,1,4,3,0,32,4,-1,MAC,Fu Dong-cheng,ORGANIZATION,PERSON-PERSON,PROPN,PROPN-PROPN,compound,compound-appos,NNP,NNP-NNP,4,1
8310,28718.0,35,said,8,26,1,-25,25,33,-18,-7,he,Iran,PERSON,COUNTRY,PRON,PROPN,nsubj,pobj,PRP,NNP,5,1
8311,28760.0,17,said,15,1,4,3,0,12,14,-11,Maloney,the next day,PERSON,DATE-DATE-DATE,PROPN,DET-ADJ-NOUN,nsubj,det-amod-npadvmod,NNP,DT-JJ-NN,2,1
8312,28762.0,21,expressed,5,15,20,5,14,0,-10,15,Inter American Press Association,Caracas,ORGANIZATION-ORGANIZATION-ORGANIZATION-ORGANIZATION,CITY,PROPN-PROPN-PROPN-PROPN,PROPN,compound-compound-compound-pobj,pobj,NNP-NNP-NNP-NNP,NNP,4,1
8313,28798.0,43,Hooper,3,3,3,0,2,39,0,0,Jeremy Hooper,Jeremy,PERSON-PERSON,PERSON,PROPN-PROPN,PROPN,compound-ROOT,poss,NNP-NNP,NNP,0,1
8314,28801.0,45,agreed,24,12,7,-5,11,37,12,-17,Highland Capital Partners,Dan Nova,ORGANIZATION-ORGANIZATION-ORGANIZATION,PERSON-PERSON,PROPN-PROPN-PROPN,PROPN-PROPN,compound-compound-pobj,compound-appos,NNP-NNP-NNPS,NNP-NNP,3,1
8315,39233.0,40,include,7,25,19,-6,24,20,-18,12,Highland Capital Partners,Dan Nova,ORGANIZATION-ORGANIZATION-ORGANIZATION,PERSON-PERSON,PROPN-PROPN-PROPN,PROPN-PROPN,compound-compound-pobj,compound-conj,NNP-NNP-NNPS,NNP-NNP,4,1
8316,54300.0,40,include,7,25,19,-6,24,20,-18,12,Highland Capital Partners,Dan Nova,ORGANIZATION-ORGANIZATION-ORGANIZATION,PERSON-PERSON,PROPN-PROPN-PROPN,PROPN-PROPN,compound-compound-pobj,compound-conj,NNP-NNP-NNPS,NNP-NNP,4,1
8317,28811.0,18,succeeded,2,14,5,-9,13,12,-12,3,chief executive and chairman,Joseph W Brown Jr,ORGANIZATION-ORGANIZATION-ORGANIZATION-ORGANIZATION,PERSON-PERSON-PERSON-PERSON,ADJ-NOUN-CCONJ-NOUN,PROPN-PROPN-PROPN-PROPN,amod-pobj-cc-conj,compound-compound-compound-pobj,JJ-NN-CC-NN,NNP-NNP-NNP-NNP,4,1
8318,28812.0,21,housetv,19,7,20,13,6,0,12,1,the House,housetv,ORGANIZATION-ORGANIZATION,URL,DET-PROPN,NOUN,det-compound,ROOT,DT-NNP,NN,6,1
8319,28816.0,50,said,45,43,36,-7,42,13,2,-9,beverage association,Susan K Neely,ORGANIZATION-ORGANIZATION,PERSON-PERSON-PERSON,NOUN-NOUN,PROPN-PROPN-PROPN,compound-pobj,compound-compound-attr,NN-NN,NNP-NNP-NNP,5,1
8320,28827.0,27,drafted,1,26,17,-9,25,9,-25,16,ABA,Spirits of St Louis,ORGANIZATION,ORGANIZATION-ORGANIZATION-ORGANIZATION-ORGANIZATION,NOUN,PROPN-ADP-PROPN-PROPN,pobj,pobj-prep-compound-pobj,NN,NNPS-IN-NNP-NNP,5,1
8321,28841.0,45,said,39,36,3,-33,35,41,3,-36,American Bankers Association,Frank,ORGANIZATION-ORGANIZATION-ORGANIZATION,PERSON,PROPN-PROPN-PROPN,PROPN,compound-compound-pobj,nsubj,NNP-NNPS-NNP,NNP,7,1
8322,28845.0,49,said,28,34,6,-28,33,42,-6,-22,MAC,Lai,ORGANIZATION,PERSON,PROPN,PROPN,compound,dobj,NNP,NNP,5,1
8323,28851.0,43,sat,12,2,9,7,1,33,10,-3,he,Shreveport,PERSON,CITY,PRON,PROPN,nsubj,pobj,PRP,NNP,2,1
8324,40736.0,43,sat,12,2,9,7,1,33,10,-3,he,Shreveport,PERSON,CITY,PRON,PROPN,nsubj,pobj,PRP,NNP,2,1
8325,52922.0,43,sat,12,2,9,7,1,33,10,-3,he,Shreveport,PERSON,CITY,PRON,PROPN,nsubj,pobj,PRP,NNP,2,1
8326,28860.0,59,is,4,13,20,7,12,38,-9,16,Paul Watson,Sea ShepherdConservation Society,PERSON-PERSON,ORGANIZATION-ORGANIZATION-ORGANIZATION,PROPN-PROPN,PROPN-PROPN-PROPN,compound-pobj,compound-compound-pobj,NNP-NNP,NNP-NNP-NNP,3,1
8327,28861.0,24,died,5,1,4,3,0,19,4,-1,Sills,Peter Greenough,PERSON,PERSON-PERSON,PROPN,PROPN-PROPN,poss,compound-appos,NNP,NNP-NNP,3,1
8328,47740.0,24,died,8,1,6,5,0,17,7,-2,Sills,Peter Greenough,PERSON,PERSON-PERSON,PROPN,PROPN-PROPN,poss,compound-appos,NNP,NNP-NNP,3,1
8329,28865.0,33,Philip,1,12,13,1,11,19,-11,12,his,Cathay Pacific,PERSON,ORGANIZATION-ORGANIZATION,DET,PROPN-PROPN,poss,compound-compound,PRP$,NNP-NNP,3,1
8330,28867.0,28,labeled,18,5,25,20,4,2,13,7,Kerry,Democratic Party,PERSON,ORGANIZATION-ORGANIZATION,PROPN,PROPN-PROPN,compound,compound-pobj,NNP,NNP-NNP,6,1
8331,47119.0,33,run,4,2,27,25,1,5,2,23,Kerry,Democratic Party,PERSON,ORGANIZATION-ORGANIZATION,PROPN,PROPN-PROPN,nsubj,compound-poss,NNP,NNP-NNP,7,1
8332,55803.0,35,wrote,33,26,13,-13,25,21,7,-20,Kerry,Democratic Party,PERSON,ORGANIZATION-ORGANIZATION,PROPN,PROPN-PROPN,poss,compound-poss,NNP,NNP-NNP,6,1
8333,28870.0,33,notes,12,29,25,-4,28,7,-17,13,Marywood University,Human Performance Lab,ORGANIZATION-ORGANIZATION,ORGANIZATION-ORGANIZATION-ORGANIZATION,PROPN-PROPN,PROPN-PROPN-PROPN,compound-pobj,compound-compound-pobj,NNP-NNP,NNP-NNP-NNP,5,1
8334,28871.0,18,announced,2,11,10,-1,10,7,-9,8,Marcel Ospel,executive,PERSON-PERSON,TITLE,PROPN-PROPN,NOUN,compound-appos,conj,NNP-NNP,NN,1,1
8335,28875.0,48,recalled,1,14,39,25,13,8,-13,38,Hussein Kamel,February 1996,PERSON-PERSON,DATE-DATE,PROPN-PROPN,PROPN-NUM,compound-compound,pobj-nummod,NNP-NNP,NNP-CD,7,1
8336,28879.0,22,are,5,20,18,-2,19,3,-15,13,Chris Simcox,MCDC,PERSON-PERSON,ORGANIZATION,PROPN-PROPN,PROPN,compound-pobj,compound,NNP-NNP,NNP,2,1
8337,28897.0,14,has,8,7,10,3,6,3,1,2,organization,57,ORGANIZATION,NUMBER,NOUN,NUM,nsubj,nummod,NN,CD,3,1
8338,28914.0,32,survived,7,6,21,15,5,10,1,14,he,Robert,PERSON,PERSON,PRON,PROPN,nsubjpass,conj,PRP,NNP,9,1
8339,28924.0,48,made,2,7,11,4,6,36,-5,9,Chunghwa Telecom Co,CTC,ORGANIZATION-ORGANIZATION-ORGANIZATION,ORGANIZATION,PROPN-PROPN-PROPN,PROPN,compound-compound-compound,compound,NNP-NNP-NNP,NNP,2,1
8340,28936.0,22,lived,4,1,7,6,0,14,3,3,Nolte,Beirut,PERSON,CITY,PROPN,PROPN,nsubj,pobj,NNP,NNP,3,1
8341,28944.0,32,called,7,1,4,3,0,27,6,-3,Red Cross,Jacob Kellenberger,ORGANIZATION-ORGANIZATION,PERSON-PERSON,PROPN-PROPN,PROPN-PROPN,compound-compound,compound-nsubj,NNP-NNP,NNP-NNP,2,1
8342,28946.0,28,extends,4,4,8,4,3,19,0,4,Lashkar-e-Taiba,"150,000",ORGANIZATION,NUMBER,PROPN,NUM,pobj,nummod,NNP,CD,1,1
8343,28954.0,21,is,8,6,16,10,5,4,2,8,EnergySolutions,America,ORGANIZATION,COUNTRY,PROPN,PROPN,pobj,pobj,NNPS,NNP,8,1
8344,28959.0,19,be,5,17,10,-7,16,8,-12,5,NFC South,Tampa Bay,ORGANIZATION-ORGANIZATION,LOCATION-LOCATION,PROPN-PROPN,PROPN-PROPN,compound-dobj,compound-nsubj,NNP-NNP,NNP-NNP,3,1
8345,28960.0,23,said,4,3,1,-2,2,21,1,-3,Lee Jye,Defence minister,PERSON-PERSON,ORGANIZATION-ORGANIZATION,PROPN-PROPN,NOUN-NOUN,compound-nsubj,compound-compound,NNP-NNP,NN-NN,1,1
8346,28968.0,37,was,8,7,24,17,6,12,1,16,Parren Mitchell,University of Maryland,PERSON-PERSON,ORGANIZATION-ORGANIZATION-ORGANIZATION,PROPN-PROPN,PROPN-ADP-PROPN,compound-nsubj,pobj-prep-pobj,NNP-NNP,NNP-IN-NNP,5,1
8347,45656.0,38,------,0,8,25,17,7,12,-8,25,Parren Mitchell,University of Maryland,PERSON-PERSON,ORGANIZATION-ORGANIZATION-ORGANIZATION,PROPN-PROPN,PROPN-ADP-PROPN,compound-nsubj,pobj-prep-pobj,NNP-NNP,NNP-IN-NNP,5,1
8348,28970.0,37,sat,2,20,14,-6,19,22,-18,12,Red Sox,Don Zimmer,ORGANIZATION-ORGANIZATION,PERSON-PERSON,PROPN-PROPN,PROPN-PROPN,compound-pobj,compound-nsubj,NNP-NNPS,NNP-NNP,4,1
8349,28971.0,25,Peterson,1,1,17,16,0,7,0,16,Oscar Peterson,kidney failure,PERSON-PERSON,CAUSE_OF_DEATH-CAUSE_OF_DEATH,PROPN-PROPN,NOUN-NOUN,compound-ROOT,compound-pobj,NNP-NNP,NN-NN,-1,1
8350,28974.0,31,said,19,9,1,-8,8,29,10,-18,National Action Network,Paula Peebles,ORGANIZATION-ORGANIZATION-ORGANIZATION,PERSON-PERSON,PROPN-PROPN-PROPN,PROPN-PROPN,compound-compound-pobj,compound-nsubj,NNP-NNP-NNP,NNP-NNP,4,1
8351,28978.0,26,said,24,2,24,22,1,1,22,0,Goodman,David,PERSON,PERSON,PROPN,PROPN,nsubj,appos,NNP,NNP,3,1
8352,28986.0,40,said,27,23,15,-8,22,24,4,-12,IMF,Juha Kahkonen,ORGANIZATION,PERSON-PERSON,PROPN,PROPN-PROPN,poss,compound-nsubj,NNP,NNP-NNP,5,1
8353,29003.0,10,was,2,2,4,2,1,5,0,2,he,editor,PERSON,TITLE,PRON,NOUN,nsubj,attr,PRP,NN,2,1
8354,30366.0,24,wrote,2,17,8,-9,16,15,-15,6,he,editor,PERSON,TITLE,PRON,NOUN,nsubj,pobj,PRP,NN,2,1
8355,29013.0,37,populated,9,20,18,-2,19,18,-11,9,Raul Castro,Defense Secretary,PERSON-PERSON,TITLE-TITLE,PROPN-PROPN,PROPN-PROPN,compound-pobj,compound-compound,NNP-NNP,NNP-NNP,1,1
8356,29023.0,43,have,2,41,31,-10,40,11,-39,29,Kendra Wilkinson,Hugh Hefner,PERSON-PERSON,PERSON-PERSON,PROPN-PROPN,PROPN-PROPN,compound-conj,compound-pobj,NNP-NNP,NNP-NNP,6,1
8357,29027.0,30,noticed,5,14,22,8,13,7,-9,17,Beverly Sills,New York City Opera,PERSON-PERSON,LOCATION-LOCATION-LOCATION-LOCATION,PROPN-PROPN,PROPN-PROPN-PROPN-PROPN,compound-pobj,compound-compound-compound-pobj,NNP-NNP,NNP-NNP-NNP-NNP,4,1
8358,29051.0,27,told,7,2,22,20,1,4,5,15,Kurnaz,associated with a suicide bomber,PERSON,CRIMINAL_CHARGE-CRIMINAL_CHARGE-CRIMINAL_CHARGE-CRIMINAL_CHARGE-CRIMINAL_CHARGE,PROPN,VERB-ADP-DET-NOUN-NOUN,poss,advcl-prep-det-compound-pobj,NNP,VBN-IN-DT-NN-NN,7,1
8359,29062.0,33,said,11,9,2,-7,8,30,2,-9,Medina Hospital,Mohamed Osman Burane,ORGANIZATION-ORGANIZATION,PERSON-PERSON-PERSON,PROPN-PROPN,PROPN-PROPN-PROPN,compound-pobj,compound-compound-nsubj,NNP-NNP,NNP-NNP-NNP,4,1
8360,29074.0,38,put,3,2,32,30,1,5,1,29,her,Professional Children 's School,PERSON,ORGANIZATION-ORGANIZATION-ORGANIZATION-ORGANIZATION,DET,PROPN-PROPN-PART-PROPN,poss,compound-poss-case-conj,PRP$,NNP-NNPS-POS-NNP,10,1
8361,29080.0,44,said,22,11,2,-9,10,41,11,-20,Chunghwa Telecom,Taiwan 's,ORGANIZATION-ORGANIZATION,CITY-CITY,PROPN-PROPN,PROPN-PART,compound-nsubj,poss-case,NNP-NNP,NNP-POS,5,1
8362,29091.0,25,born,4,1,12,11,0,12,3,8,Richard Henry Nolte,"Dec. 27 , 1920",PERSON-PERSON-PERSON,DATE-DATE-DATE-DATE,PROPN-PROPN-PROPN,PROPN-NUM-PUNCT-NUM,compound-compound-nsubjpass,pobj-nummod-punct-nummod,NNP-NNP-NNP,"NNP-CD-,-CD",5,1
8363,29094.0,37,said,24,24,32,8,23,4,0,8,Watson,St Andrews,PERSON,CITY-CITY,PROPN,PROPN-PROPN,nsubj,compound-pobj,NNP,NNP-NNP,5,1
8364,29096.0,33,wrote,13,27,31,4,26,1,-14,18,he,UBS,PERSON,ORGANIZATION,PRON,PROPN,nsubj,compound,PRP,NNP,4,1
8365,29105.0,31,told,7,1,6,5,0,24,6,-1,Mainland Affairs Council,Kao Charng,ORGANIZATION-ORGANIZATION-ORGANIZATION,PERSON-PERSON,PROPN-PROPN-PROPN,PROPN-PROPN,compound-compound-compound,compound-nsubj,NNP-NNPS-NNP,NNP-NNP,3,1
8366,54631.0,42,explained,15,9,1,-8,8,40,6,-14,Mainland Affairs Council,Kao Charng,ORGANIZATION-ORGANIZATION-ORGANIZATION,PERSON-PERSON,PROPN-PROPN-PROPN,PROPN-PROPN,compound-compound-pobj,compound-nsubj,NNP-NNPS-NNP,NNP-NNP,4,1
8367,29119.0,32,told,21,20,19,-1,19,12,1,-2,Berthold Huber,chairman,PERSON-PERSON,TITLE,PROPN-PROPN,NOUN,compound-nsubj,compound,NNP-NNP,NN,2,1
8368,65144.0,38,FRANKFURT,0,31,30,-1,30,7,-31,30,Berthold Huber,chairman,PERSON-PERSON,TITLE,PROPN-PROPN,NOUN,compound-nsubj,compound,NNP-NNP,NN,2,1
8369,29130.0,40,Eighty-eight-year-old,0,9,14,5,8,25,-9,14,his,86-year-old,PERSON,DURATION,DET,NUM,poss,nummod,PRP$,CD,5,1
8370,29136.0,20,noted,7,1,4,3,0,15,6,-3,Kennedy,Missouri,PERSON,STATE_OR_PROVINCE,PROPN,PROPN,nsubj,compound,NNP,NNP,2,1
8371,29137.0,22,said,12,6,10,4,5,11,6,-2,Awami National Party,Asfandyar Wali,ORGANIZATION-ORGANIZATION-ORGANIZATION,PERSON-PERSON,PROPN-PROPN-PROPN,PROPN-PROPN,compound-compound-pobj,compound-appos,NNP-NNP-NNP,NNP-NNP,4,1
8372,29139.0,25,arises,2,17,16,-1,16,8,-15,14,G Gary Kirchner,Coroner,PERSON-PERSON-PERSON,TITLE,PROPN-PROPN-PROPN,PROPN,compound-compound-poss,compound,NNP-NNP-NNP,NNP,2,1
8373,57548.0,19,told,6,4,3,-1,3,15,2,-3,G Gary Kirchner,Coroner,PERSON-PERSON-PERSON,TITLE,PROPN-PROPN-PROPN,PROPN,compound-compound-nsubj,compound,NNP-NNP-NNP,NNP,2,1
8374,29148.0,33,said,19,7,11,4,6,21,12,-8,American Beverage Association,Susan K Neely,ORGANIZATION-ORGANIZATION-ORGANIZATION,PERSON-PERSON-PERSON,PROPN-PROPN-PROPN,PROPN-PROPN-PROPN,compound-compound-pobj,compound-compound-nsubj,NNP-NNP-NNP,NNP-NNP-NNP,8,1
8375,62590.0,32,said,14,11,1,-10,10,30,3,-13,American Beverage Association,Susan K Neely,ORGANIZATION-ORGANIZATION-ORGANIZATION,PERSON-PERSON-PERSON,PROPN-PROPN-PROPN,PROPN-PROPN-PROPN,compound-compound-pobj,compound-compound-nsubj,NNP-NNP-NNP,NNP-NNP-NNP,5,1
8376,29162.0,23,help,12,18,9,-9,17,13,-6,-3,MF Global,Corzine,ORGANIZATION-ORGANIZATION,PERSON,PROPN-PROPN,PROPN,compound-poss,poss,NNP-NNP,NNP,12,1
8377,29164.0,27,said,17,23,19,-4,22,7,-6,2,NCF,Rebecca Wang,ORGANIZATION,PERSON-PERSON,PROPN,PROPN-PROPN,poss,compound-nsubj,NNP,NNP-NNP,3,1
8378,29167.0,37,Paris-based,0,8,7,-1,7,29,-8,7,Inter - American Press Association,Miami-based,ORGANIZATION-ORGANIZATION-ORGANIZATION-ORGANIZATION-ORGANIZATION,CITY,PROPN-ADJ-PROPN-PROPN-PROPN,ADJ,compound-punct-compound-compound-conj,amod,NNP-JJ-NNP-NNP-NNP,JJ,3,1
8379,29172.0,26,founded,3,1,7,6,0,18,2,4,He,Media Lab,PERSON,ORGANIZATION-ORGANIZATION,PRON,PROPN-PROPN,nsubj,compound-dobj,PRP,NNP-NNP,2,1
8380,29195.0,17,says,6,8,11,3,7,5,-2,5,he,Kate,PERSON,PERSON,PRON,PROPN,nsubj,conj,PRP,NNP,2,1
8381,29200.0,27,met,11,24,7,-17,23,19,-13,-4,Saint Anselm College,New Mexico,ORGANIZATION-ORGANIZATION-ORGANIZATION,STATE_OR_PROVINCE-STATE_OR_PROVINCE,PROPN-PROPN-PROPN,PROPN-PROPN,compound-compound-pobj,compound-compound,NNP-NNP-NNP,NNP-NNP,9,1
8382,29224.0,14,playboys,3,8,3,-5,7,10,-5,0,Frankie Delgado,Hollywood,PERSON-PERSON,CITY,PROPN-PROPN,PROPN,compound-conj,nsubj,NNP-NNP,NNP,3,1
8383,29226.0,13,served,2,1,12,11,0,0,1,10,Yoadimnadji,minister,PERSON,TITLE,NOUN,NOUN,nsubj,pobj,NNS,NN,2,1
8384,29229.0,41,noted,1,34,31,-3,33,9,-33,30,Mainland Affairs Council,Cabinet,ORGANIZATION-ORGANIZATION-ORGANIZATION,ORGANIZATION,PROPN-PROPN-PROPN,PROPN,compound-compound-pobj,compound,NNP-NNPS-NNP,NNP,4,1
8385,29232.0,30,said,23,1,8,7,0,21,22,-15,Forsberg,City College,PERSON,ORGANIZATION-ORGANIZATION,PROPN,PROPN-PROPN,nsubj,compound-pobj,NNP,NNP-NNP,4,1
8386,42339.0,59,launched,16,16,10,-6,15,48,0,-6,Forsberg,City College,PERSON,ORGANIZATION-ORGANIZATION,PROPN,PROPN-PROPN,nsubj,compound-pobj,NNP,NNP-NNP,4,1
8387,63566.0,28,appointed,6,5,23,18,4,4,1,17,Forsberg,City College,PERSON,ORGANIZATION-ORGANIZATION,PROPN,PROPN-PROPN,nsubjpass,compound-pobj,NNP,NNP-NNP,7,1
8388,29235.0,40,said,32,35,38,3,34,1,-3,6,his,San Francisco,PERSON,CITY-CITY,DET,PROPN-PROPN,poss,compound-pobj,PRP$,NNP-NNP,4,1
8389,29243.0,52,says,35,49,43,-6,48,8,-14,8,American Psychological Association,Divisions for Social Justice,ORGANIZATION-ORGANIZATION-ORGANIZATION,ORGANIZATION-ORGANIZATION-ORGANIZATION-ORGANIZATION,PROPN-PROPN-PROPN,PROPN-ADP-PROPN-PROPN,compound-compound-pobj,pobj-prep-compound-pobj,NNP-NNP-NNP,NNPS-IN-NNP-NNP,3,1
8390,29258.0,35,told,27,21,26,5,20,8,6,-1,Awami League,Abdul Muhit,ORGANIZATION-ORGANIZATION,PERSON-PERSON,PROPN-PROPN,PROPN-PROPN,compound-compound,compound-nsubj,NNP-NNP,NNP-NNP,3,1
8391,29261.0,28,went,2,7,2,-5,6,25,-5,0,NFC South,Buccaneers,ORGANIZATION-ORGANIZATION,ORGANIZATION,PROPN-PROPN,PROPN,compound-pobj,nsubj,NNP-NNP,NNPS,2,1
8392,29263.0,62,see,2,41,54,13,40,7,-39,52,AMA,Barrett,ORGANIZATION,PERSON,PROPN,PROPN,poss,nsubj,NNP,NNP,6,1
8393,29265.0,33,blogger,2,23,3,-20,22,29,-21,1,Jeremy Hooper,blogger,PERSON-PERSON,TITLE,PROPN-PROPN,VERB,compound-ROOT,compound,NNP-NNP,VBP,-1,1
8394,29267.0,47,told,24,22,4,-18,21,42,2,-20,Rajat Nag,a briefing,ORGANIZATION-ORGANIZATION,PERSON-PERSON,PROPN-PROPN,DET-NOUN,compound-appos,det-dobj,NNP-NNP,DT-NN,6,1
8395,29284.0,29,'s,2,23,9,-14,22,19,-21,7,American Beverage Association,America,ORGANIZATION-ORGANIZATION-ORGANIZATION,COUNTRY,PROPN-PROPN-PROPN,PROPN,compound-compound-pobj,poss,NNP-NNP-NNP,NNP,9,1
8396,55682.0,30,said,18,24,9,-15,23,20,-6,-9,American Beverage Association,America,ORGANIZATION-ORGANIZATION-ORGANIZATION,COUNTRY,PROPN-PROPN-PROPN,PROPN,compound-compound-pobj,poss,NNP-NNP-NNP,NNP,9,1
8397,65633.0,45,said,18,28,9,-19,27,35,-10,-9,American Beverage Association,America,ORGANIZATION-ORGANIZATION-ORGANIZATION,COUNTRY,PROPN-PROPN-PROPN,PROPN,compound-compound-pobj,poss,NNP-NNP-NNP,NNP,10,1
8398,29285.0,32,struggling,22,2,10,8,1,21,20,-12,Christopher J. Dodd,chairman,PERSON-PERSON-PERSON,TITLE,PROPN-PROPN-PROPN,NOUN,compound-compound-nsubj,conj,NNP-NNP-NNP,NN,4,1
8399,29289.0,23,operates,4,1,19,18,0,3,3,15,Royal Caribbean,CDF Croisieres de France,ORGANIZATION-ORGANIZATION,ORGANIZATION-ORGANIZATION-ORGANIZATION-ORGANIZATION,ADJ-ADJ,PROPN-PROPN-PROPN-PROPN,compound-compound,compound-compound-compound-conj,JJ-JJ,NNP-NNP-NNP-NNP,8,1
8400,29290.0,45,include,1,3,9,6,2,35,-2,8,his,Jane Callaghan Gude,PERSON,PERSON-PERSON-PERSON,DET,PROPN-PROPN-PROPN,poss,compound-compound-appos,PRP$,NNP-NNP-NNP,2,1
8401,46865.0,50,include,1,3,9,6,2,40,-2,8,his,Jane Callaghan Gude,PERSON,PERSON-PERSON-PERSON,DET,PROPN-PROPN-PROPN,poss,compound-compound-appos,PRP$,NNP-NNP-NNP,2,1
8402,29294.0,62,gave,26,49,1,-48,48,60,-23,-25,Spelman College,She,ORGANIZATION-ORGANIZATION,PERSON,PROPN-PROPN,PRON,compound-pobj,nsubj,NNP-NNP,PRP,-1,1
8403,48253.0,50,continued,1,39,1,-38,38,48,-38,0,Spelman College,She,ORGANIZATION-ORGANIZATION,PERSON,PROPN-PROPN,PRON,compound-pobj,nsubj,NNP-NNP,PRP,6,1
8404,29296.0,42,involved,12,35,10,-25,34,31,-23,-2,KCNA,South Korea,ORGANIZATION,COUNTRY-COUNTRY,PROPN,PROPN-PROPN,compound,compound-pobj,NNP,NNP-NNP,7,1
8405,29297.0,45,changed,23,16,19,3,15,25,7,-4,her,Gloucester,PERSON,CITY,DET,PROPN,poss,pobj,PRP$,NNP,3,1
8406,29298.0,47,said,19,27,36,9,26,10,-8,17,Inter American Press Association,Miami,ORGANIZATION-ORGANIZATION-ORGANIZATION-ORGANIZATION,CITY,PROPN-PROPN-PROPN-PROPN,PROPN,compound-compound-compound-pobj,pobj,NNP-NNP-NNP-NNP,NNP,4,1
8407,29299.0,21,said,4,8,1,-7,7,19,-4,-3,he,Iranian,PERSON,NATIONALITY,PRON,ADJ,nsubj,amod,PRP,JJ,4,1
8408,29303.0,39,faced,11,8,2,-6,7,36,3,-9,Remy,entertainer,PERSON,TITLE,PROPN,ADJ,compound,nsubj,NNP,JJR,3,1
8409,29308.0,30,published,1,1,19,18,0,10,0,18,Washburn,director,PERSON,TITLE,NOUN,NOUN,nsubj,oprd,NN,NN,3,1
8410,29312.0,42,is,4,19,2,-17,18,39,-15,-2,ITOCHU Corp,Brunei Methanol Company,ORGANIZATION-ORGANIZATION,ORGANIZATION-ORGANIZATION-ORGANIZATION,PROPN-PROPN,PROPN-PROPN-PROPN,compound-conj,compound-compound-nsubj,NNP-NNP,NNP-NNP-NNP,6,1
8411,29328.0,33,pleaded,5,4,11,7,3,21,1,6,Brandon McInerney,first-degree murder,PERSON-PERSON,CRIMINAL_CHARGE-CRIMINAL_CHARGE,PROPN-PROPN,ADJ-NOUN,compound-nsubj,amod-pobj,NNP-NNP,JJ-NN,6,1
8412,54169.0,36,found,25,1,9,8,0,26,24,-16,Brandon McInerney,first-degree murder,PERSON-PERSON,CRIMINAL_CHARGE-CRIMINAL_CHARGE,PROPN-PROPN,ADJ-NOUN,compound-nsubjpass,amod-pobj,NNP-NNP,JJ-NN,6,1
8413,29335.0,33,sung,6,9,14,5,8,18,-3,8,Brian McFadden,pop star,PERSON-PERSON,TITLE-TITLE,PROPN-PROPN,NOUN-NOUN,compound-pobj,compound-appos,NNP-NNP,NN-NN,3,1
8414,29336.0,58,include,1,16,20,4,15,37,-15,19,Gilbert Gude Jr.,Gregory Gude,PERSON-PERSON-PERSON,PERSON-PERSON,PROPN-PROPN-PROPN,PROPN-PROPN,compound-compound-conj,compound-conj,NNP-NNP-NNP,NNP-NNP,2,1
8415,67088.0,50,include,1,28,34,6,27,15,-27,33,Gilbert Gude Jr.,Gregory Gude,PERSON-PERSON-PERSON,PERSON-PERSON,PROPN-PROPN-PROPN,PROPN-PROPN,compound-compound-conj,compound-conj,NNP-NNP-NNP,NNP-NNP,4,1
8416,29340.0,59,know,3,51,49,-2,50,9,-48,46,Fleet Marine Force,FMF,ORGANIZATION-ORGANIZATION-ORGANIZATION,ORGANIZATION,PROPN-PROPN-PROPN,PROPN,nmod-compound-compound,nmod,NNP-NNP-NNP,NNP,-1,1
8417,29347.0,31,released,11,2,1,-1,1,29,9,-10,China National Aviation Corp,Air China,ORGANIZATION-ORGANIZATION-ORGANIZATION-ORGANIZATION,ORGANIZATION-ORGANIZATION,PROPN-PROPN-PROPN-PROPN,PROPN-PROPN,compound-compound-compound-compound,compound-compound,NNP-NNP-NNP-NNP,NNP-NNP,1,1
8418,32145.0,39,proposed,15,1,13,12,0,25,14,-2,China National Aviation Corp,Air China,ORGANIZATION-ORGANIZATION-ORGANIZATION-ORGANIZATION,ORGANIZATION-ORGANIZATION,PROPN-PROPN-PROPN-PROPN,PROPN-PROPN,compound-compound-compound-nsubj,compound-pobj,NNP-NNP-NNP-NNP,NNP-NNP,5,1
8419,40268.0,51,thrown,4,9,22,13,8,28,-5,18,China National Aviation Corp,Air China,ORGANIZATION-ORGANIZATION-ORGANIZATION-ORGANIZATION,ORGANIZATION-ORGANIZATION,PROPN-PROPN-PROPN-PROPN,PROPN-PROPN,compound-compound-compound-compound,compound-appos,NNP-NNP-NNP-NNP,NNP-NNP,7,1
8420,58033.0,32,said,1,8,7,-1,7,24,-7,6,China National Aviation Corp,Air China,ORGANIZATION-ORGANIZATION-ORGANIZATION-ORGANIZATION,ORGANIZATION-ORGANIZATION,PROPN-PROPN-PROPN-PROPN,PROPN-PROPN,compound-compound-compound-appos,compound-dobj,NNP-NNP-NNP-NNP,NNP-NNP,1,1
8421,29357.0,31,introduced,23,20,30,10,19,0,3,7,Jo Ann S. Davis,House,PERSON-PERSON-PERSON-PERSON,ORGANIZATION,PROPN-PROPN-PROPN-PROPN,PROPN,compound-compound-compound-conj,pobj,NNP-NNP-NNP-NNP,NNP,7,1
8422,29363.0,19,battle,3,3,16,13,2,2,0,13,Zagat,Tim Zagat,ORGANIZATION,PERSON-PERSON,PROPN,PROPN-PROPN,compound,compound-nsubj,NNP,NNP-NNP,4,1
8423,29373.0,43,2008-07-06T13,0,3,7,4,2,35,-3,7,Paul Sculfor,model,PERSON-PERSON,TITLE,PROPN-PROPN,NOUN,compound-nsubj,attr,NNP-NNP,NN,5,1
8424,30945.0,50,spotted,3,48,47,-1,47,2,-45,44,Paul Sculfor,model,PERSON-PERSON,TITLE,PROPN-PROPN,NOUN,compound-appos,compound,NNP-NNP,NN,1,1
8425,38312.0,41,is,2,1,5,4,0,35,1,3,Paul Sculfor,model,PERSON-PERSON,TITLE,PROPN-PROPN,NOUN,compound-nsubj,attr,NNP-NNP,NN,3,1
8426,54579.0,39,dating,3,13,6,-7,12,32,-10,3,Paul Sculfor,model,PERSON-PERSON,TITLE,PROPN-PROPN,NOUN,compound-dobj,dobj,NNP-NNP,NN,3,1
8427,57158.0,24,reports,22,18,17,-1,17,6,4,-5,Paul Sculfor,model,PERSON-PERSON,TITLE,PROPN-PROPN,NOUN,compound-nsubj,compound,NNP-NNP,NN,2,1
8428,58065.0,27,model,6,8,7,-1,7,19,-2,1,Paul Sculfor,model,PERSON-PERSON,TITLE,PROPN-PROPN,NOUN,compound-nsubj,ROOT,NNP-NNP,NN,1,1
8429,60298.0,29,linked,10,19,18,-1,18,10,-9,8,Paul Sculfor,model,PERSON-PERSON,TITLE,PROPN-PROPN,NOUN,compound-appos,compound,NNP-NNP,NN,1,1
8430,29378.0,31,said,25,27,29,2,26,1,-2,4,PRC,Abu Mujahed,ORGANIZATION,PERSON-PERSON,PROPN,PROPN-PROPN,compound,compound-nsubj,NNP,NNP-NNP,3,1
8431,39570.0,52,said,21,30,23,-7,29,28,-9,2,PRC,Abu Mujahed,ORGANIZATION,PERSON-PERSON,PROPN,PROPN-PROPN,pobj,compound-nsubj,NNP,NNP-NNP,4,1
8432,59112.0,55,said,29,41,31,-10,40,23,-12,2,PRC,Abu Mujahed,ORGANIZATION,PERSON-PERSON,PROPN,PROPN-PROPN,compound,compound-nsubj,NNP,NNP-NNP,3,1
8433,29382.0,56,collapse,7,1,18,17,0,37,6,11,Capitalia SpA,Cesare Geronzi,ORGANIZATION-ORGANIZATION,PERSON-PERSON,PROPN-PROPN,PROPN-PROPN,compound-compound,compound-appos,NNP-NNP,NNP-NNP,3,1
8434,49202.0,49,MILAN,0,8,11,3,7,37,-8,11,Capitalia SpA,Cesare Geronzi,ORGANIZATION-ORGANIZATION,PERSON-PERSON,PROPN-PROPN,PROPN-PROPN,compound-compound,compound-appos,NNP-NNP,NNP-NNP,2,1
8435,29385.0,50,added,1,32,21,-11,31,28,-31,20,NSC,Tree of Life and Encyclopedia of Life,ORGANIZATION,ORGANIZATION-ORGANIZATION-ORGANIZATION-ORGANIZATION-ORGANIZATION-ORGANIZATION-ORGANIZATION,PROPN,PROPN-ADP-PROPN-CCONJ-PROPN-ADP-PROPN,compound,conj-prep-pobj-cc-conj-prep-pobj,NNP,NNP-IN-NNP-CC-NNP-IN-NNP,7,1
8436,29394.0,41,said,31,7,6,-1,6,34,24,-25,ElBaradei,Dr,PERSON,TITLE,PROPN,PROPN,nsubj,compound,NNP,NNP,1,1
8437,29395.0,28,said,11,24,19,-5,23,8,-13,8,Inter American Press Association,press freedom committee,ORGANIZATION-ORGANIZATION-ORGANIZATION-ORGANIZATION,ORGANIZATION-ORGANIZATION-ORGANIZATION,PROPN-PROPN-PROPN-PROPN,NOUN-NOUN-NOUN,compound-compound-compound-pobj,compound-compound-pobj,NNP-NNP-NNP-NNP,NN-NN-NN,4,1
8438,29398.0,30,made,3,12,15,3,11,14,-9,12,OIC,Abdelouahed Belkeziz,ORGANIZATION,PERSON-PERSON,PROPN,PROPN-PROPN,compound,compound-ROOT,NNP,NNP-NNP,2,1
8439,29420.0,33,are,27,9,13,4,8,19,18,-14,Fedotwosky,advertising accounts manager,PERSON,TITLE-TITLE-TITLE,PROPN,NOUN-VERB-NOUN,conj,compound-compound-appos,NNP,NN-VBZ-NN,4,1
8440,29422.0,7,died,1,1,6,5,0,0,0,5,She,Saturday,PERSON,DATE,PRON,PROPN,nsubj,npadvmod,PRP,NNP,1,1
8441,29424.0,44,seen,20,9,13,4,8,30,11,-7,David Banda,Malawian,PERSON-PERSON,NATIONALITY,PROPN-PROPN,ADJ,compound-pobj,amod,NNP-NNP,JJ,1,1
8442,29609.0,40,wants,3,25,1,-24,24,38,-22,-2,David Banda,Malawian,PERSON-PERSON,COUNTRY,PROPN-PROPN,ADJ,compound-pobj,amod,NNP-NNP,JJ,-1,1
8443,31166.0,35,adopting,8,17,14,-3,16,20,-9,6,David Banda,Malawian,PERSON-PERSON,NATIONALITY,PROPN-PROPN,ADJ,compound-appos,amod,NNP-NNP,JJ,2,1
8444,62459.0,30,said,28,14,12,-2,13,17,14,-16,David Banda,Malawian,PERSON-PERSON,NATIONALITY,PROPN-PROPN,ADJ,compound-appos,amod,NNP-NNP,JJ,1,1
8445,29436.0,21,is,4,1,3,2,0,17,3,-1,Watson,57,PERSON,NUMBER,PROPN,NUM,nsubj,appos,NNP,CD,3,1
8446,29461.0,40,broken,14,28,31,3,27,8,-14,17,Jeremy Hooper,Andrew Shulman,PERSON-PERSON,PERSON-PERSON,PROPN-PROPN,PROPN-PROPN,compound-dobj,compound-conj,NNP-NNP,NNP-NNP,1,1
8447,29464.0,44,said,37,5,42,37,4,1,32,5,Covidien,Richard Melia,ORGANIZATION,PERSON-PERSON,PROPN,PROPN-PROPN,nmod,compound-nsubj,NNP,NNP-NNP,3,1
8448,29472.0,49,said,1,13,19,6,12,29,-12,18,David Gregory,John Dickerson,PERSON-PERSON,PERSON-PERSON,PROPN-PROPN,PROPN-PROPN,compound-conj,compound-conj,NNP-NNP,NNP-NNP,2,1
8449,29483.0,28,dates,3,25,22,-3,24,5,-22,19,Abdul Rahim Noor,national police,PERSON-PERSON-PERSON,ORGANIZATION-ORGANIZATION,PROPN-PROPN-PROPN,ADJ-NOUN,compound-compound-appos,amod-pobj,NNP-NNP-NNP,JJ-NNS,6,1
8450,29507.0,30,is,16,1,5,4,0,24,15,-11,Sculfor,actor,PERSON,TITLE,PROPN,NOUN,nsubj,appos,NNP,NN,3,1
8451,29513.0,44,asked,21,18,11,-7,17,32,3,-10,Massachusetts House of Representatives,United States,ORGANIZATION-ORGANIZATION-ORGANIZATION-ORGANIZATION,COUNTRY-COUNTRY,PROPN-PROPN-ADP-PROPN,PROPN-PROPN,compound-nsubj-prep-pobj,compound-compound,NNP-NNP-IN-NNPS,NNP-NNP,7,1
8452,29515.0,11,thinks,2,4,2,-2,3,8,-2,0,he,She,PERSON,PERSON,PRON,PRON,nsubj,nsubj,PRP,PRP,3,1
8453,29517.0,20,specialized,6,6,3,-3,5,16,0,-3,Goodman,psychologist,PERSON,TITLE,PROPN,NOUN,nsubj,pobj,NNP,NN,1,1
8454,29525.0,27,helped,1,1,16,15,0,10,0,15,Rothman,executive director,PERSON,TITLE-TITLE,PROPN,ADJ-NOUN,nsubj,amod-attr,NNP,JJ-NN,2,1
8455,43097.0,28,helped,2,2,17,15,1,10,0,15,Rothman,executive director,PERSON,TITLE-TITLE,PROPN,ADJ-NOUN,nsubj,amod-attr,NNP,JJ-NN,2,1
8456,29531.0,20,CARACAS,0,5,3,-2,4,16,-5,3,Inter American Press Association,Venezuela,ORGANIZATION-ORGANIZATION-ORGANIZATION-ORGANIZATION,COUNTRY,PROPN-PROPN-PROPN-PROPN,PROPN,compound-compound-compound-nsubj,poss,NNP-NNP-NNP-NNP,NNP,3,1
8457,29533.0,38,watched,9,15,6,-9,14,31,-6,-3,National Museum of Women in the Arts,Susan Fisher Sterling,ORGANIZATION-ORGANIZATION-ORGANIZATION-ORGANIZATION-ORGANIZATION-ORGANIZATION-ORGANIZATION,PERSON-PERSON-PERSON,PROPN-PROPN-ADP-PROPN-ADP-DET-NOUN,PROPN-PROPN-PROPN,compound-pobj-prep-pobj-prep-det-pobj,compound-compound-nsubj,NNP-NNP-IN-NNPS-IN-DT-NNS,NNP-NNP-NNP,5,1
8458,29541.0,42,feature,20,32,28,-4,31,13,-12,8,Babyshambles,English,ORGANIZATION,COUNTRY,PROPN,ADJ,nsubj,amod,NNPS,JJ,2,1
8459,29545.0,51,died,41,1,9,8,0,41,40,-32,Richmond M. Flowers,attorney general,PERSON-PERSON-PERSON,TITLE-TITLE,PROPN-PROPN-PROPN,NOUN-NOUN,compound-compound-nsubj,compound-pobj,NNP-NNP-NNP,NN-NN,4,1
8460,29546.0,49,said,7,2,6,4,1,42,5,-1,Federal Election Commission,Robert Lenhardt,ORGANIZATION-ORGANIZATION-ORGANIZATION,PERSON-PERSON,PROPN-PROPN-PROPN,PROPN-PROPN,compound-compound-compound,compound-nsubj,NNP-NNP-NNP,NNP-NNP,3,1
8461,29548.0,34,proposed,5,3,1,-2,2,32,2,-4,Marcel Ospel,Board chairman,PERSON-PERSON,TITLE-TITLE,PROPN-PROPN,NOUN-NOUN,compound-nsubj,compound-compound,NNP-NNP,NN-NN,1,1
8462,29550.0,35,served,2,1,24,23,0,10,1,22,Huber,Germany,PERSON,COUNTRY,PROPN,PROPN,nsubj,poss,NNP,NNP,12,1
8463,29553.0,45,is,4,15,11,-4,14,33,-11,7,Larijani,Iranian,PERSON,NATIONALITY,PROPN,ADJ,poss,amod,NNP,JJ,7,1
8464,40969.0,34,suggesting,9,3,6,3,2,27,6,-3,Larijani,Iranian,PERSON,NATIONALITY,ADJ,ADJ,nsubj,amod,JJ,JJ,2,1
8465,29561.0,25,alleged,2,5,24,19,4,0,-3,22,he,Kandahar,PERSON,LOCATION,PRON,PROPN,nsubjpass,pobj,PRP,NNP,3,1
8466,29574.0,21,confirmed,3,1,13,12,0,7,2,10,His,Ontario,PERSON,STATE_OR_PROVINCE,DET,PROPN,poss,conj,PRP$,NNP,8,1
8467,29585.0,36,Post,4,9,18,9,8,17,-5,14,Jefferson J deblanc Sr,Marine Corps,PERSON-PERSON-PERSON-PERSON,TITLE-TITLE,PROPN-PROPN-VERB-PROPN,PROPN-PROPN,compound-conj-compound-appos,compound-compound,NNP-NNP-VB-NNP,NNP-NNP,3,1
8468,29601.0,30,said,21,23,28,5,22,1,-2,7,Chunghwa Telecom,Chang Feng-Hsiung,ORGANIZATION-ORGANIZATION,PERSON-PERSON,PROPN-PROPN,PROPN-PROPN,compound-compound,compound-nsubj,NNP-NNP,NNP-NNP,2,1
8469,29605.0,18,lit,11,1,10,9,0,7,10,-1,Her,Dexter,PERSON,PERSON,DET,PROPN,poss,conj,PRP$,NNP,1,1
8470,29612.0,21,remembers,13,1,7,6,0,13,12,-6,George Sheldon,state Department of Children and Families,PERSON-PERSON,ORGANIZATION-ORGANIZATION-ORGANIZATION-ORGANIZATION-ORGANIZATION-ORGANIZATION,PROPN-PROPN,NOUN-PROPN-ADP-PROPN-CCONJ-PROPN,compound-nsubj,compound-pobj-prep-pobj-cc-conj,NNP-NNP,NN-NNP-IN-NNP-CC-NNPS,3,1
8471,29616.0,43,closed,7,3,29,26,2,13,4,22,Department of Conservation and Recreation,Myles Standish State Forest,ORGANIZATION-ORGANIZATION-ORGANIZATION-ORGANIZATION-ORGANIZATION,LOCATION-LOCATION-LOCATION-LOCATION,PROPN-ADP-PROPN-CCONJ-PROPN,PROPN-PROPN-PROPN-PROPN,nsubj-prep-pobj-cc-conj,compound-compound-compound-conj,NNP-IN-NNP-CC-NNP,NNP-NNP-NNP-NNP,7,1
8472,29644.0,22,shared,15,12,7,-5,11,14,3,-8,William Verity,secretary of commerce,PERSON-PERSON,TITLE-TITLE-TITLE,PROPN-PROPN,NOUN-ADP-NOUN,compound-compound,pobj-prep-pobj,NNP-NNP,NN-IN-NN,3,1
8473,29647.0,33,named,4,2,9,7,1,23,2,5,John Kerry,chairman,PERSON-PERSON,TITLE,PROPN-PROPN,NOUN,compound-nsubjpass,oprd,NNP-NNP,NN,3,1
8474,29680.0,47,covered,17,4,44,40,3,2,13,27,his,Nightly News,PERSON,ORGANIZATION-ORGANIZATION,DET,PROPN-PROPN,poss,advmod-appos,PRP$,NNP-NNP,8,1
8475,29687.0,58,DENVER,0,34,42,8,33,15,-34,42,Carolyn Maloney,author,PERSON-PERSON,TITLE,PROPN-PROPN,NOUN,compound-pobj,conj,NNP-NNP,NN,2,1
8476,29709.0,38,died,33,1,9,8,0,28,32,-24,Philip M Kaiser,Austria,PERSON-PERSON-PERSON,COUNTRY,PROPN-PROPN-PROPN,PROPN,compound-compound-nsubj,pobj,NNP-NNP-NNP,NNP,5,1
8477,46590.0,40,died,37,1,10,9,0,29,36,-27,Philip M Kaiser,Austria,PERSON-PERSON-PERSON,COUNTRY,PROPN-PROPN-PROPN,PROPN,compound-compound-nsubj,pobj,NNP-NNP-NNP,NNP,5,1
8478,29724.0,25,Title,0,13,20,7,12,4,-13,20,Covidien,United States,ORGANIZATION,COUNTRY-COUNTRY,PROPN,PROPN-PROPN,compound,compound-conj,NNP,NNP-NNP,3,1
8479,60868.0,59,had,1,1,57,56,0,1,0,56,Covidien,United States,ORGANIZATION,COUNTRY-COUNTRY,PROPN,PROPN-PROPN,nsubj,compound-pobj,NNP,NNP-NNP,7,1
8480,29726.0,41,won,17,1,23,22,0,17,16,6,Gillmor,Ohio state senate,PERSON,ORGANIZATION-ORGANIZATION-ORGANIZATION,PROPN,PROPN-NOUN-NOUN,nsubj,compound-compound-pobj,NNP,NNP-NN-NN,5,1
8481,29730.0,39,says,18,31,20,-11,30,18,-13,2,Carnival,Arison,ORGANIZATION,PERSON,PROPN,PROPN,compound,nsubj,NNP,NNP,5,1
8482,29732.0,28,said,8,18,7,-11,17,20,-10,-1,Disney,Andrew Kam,ORGANIZATION,PERSON-PERSON,PROPN,PROPN-PROPN,pobj,compound-nsubj,NNP,NNP-NNP,6,1
8483,29735.0,30,daughter,4,15,6,-9,14,23,-11,2,him,Isabel,PERSON,PERSON,PRON,PROPN,dobj,compound,PRP,NNP,-1,1
8484,29749.0,19,died,1,14,15,1,13,3,-13,14,her,manager,PERSON,TITLE,DET,NOUN,poss,nsubj,PRP$,NN,1,1
8485,29755.0,25,contends,2,4,17,13,3,7,-2,15,Haifa University,university,ORGANIZATION-ORGANIZATION,ORGANIZATION,PROPN-PROPN,NOUN,compound-compound,poss,NNP-NNP,NN,7,1
8486,29758.0,21,is,7,5,1,-4,4,19,2,-6,current speaker,Salvatore DiMasi,ORGANIZATION-ORGANIZATION,PERSON-PERSON,ADJ-NOUN,PROPN-PROPN,amod-appos,compound-nsubj,JJ-NN,NNP-NNP,1,1
8487,29766.0,32,did,1,14,31,17,13,0,-13,30,FAA,US,ORGANIZATION,COUNTRY,PROPN,PROPN,npadvmod,pobj,NNP,NNP,4,1
8488,29776.0,47,Tipped,1,34,38,4,33,8,-33,37,Madoff firm,Bernard L Madoff Investment Securities LLC,ORGANIZATION-ORGANIZATION,ORGANIZATION-ORGANIZATION-ORGANIZATION-ORGANIZATION-ORGANIZATION-ORGANIZATION,PROPN-NOUN,PROPN-PROPN-PROPN-PROPN-PROPN-PROPN,compound-pobj,compound-compound-compound-compound-compound-dobj,NNP-NN,NNP-NNP-NNP-NNP-NNPS-NNP,9,1
8489,29784.0,17,Wednesday,2,15,2,-13,14,14,-13,0,his,last Wednesday,PERSON,DATE-DATE,DET,ADJ-PROPN,poss,amod-ROOT,PRP$,JJ-NNP,3,1
8490,29787.0,46,said,37,17,17,0,16,28,20,-20,Army Medical Command,Army,ORGANIZATION-ORGANIZATION-ORGANIZATION,ORGANIZATION,PROPN-PROPN-PROPN,PROPN,compound-compound-pobj,pobj,NNP-NNP-NNP,NNP,0,1
8491,33805.0,38,led,25,15,15,0,14,22,10,-10,Army Medical Command,Army,ORGANIZATION-ORGANIZATION-ORGANIZATION,ORGANIZATION,PROPN-PROPN-PROPN,PROPN,compound-compound-pobj,compound,NNP-NNP-NNP,NNP,0,1
8492,40925.0,46,said,37,17,17,0,16,28,20,-20,Army Medical Command,Army,ORGANIZATION-ORGANIZATION-ORGANIZATION,ORGANIZATION,PROPN-PROPN-PROPN,PROPN,compound-compound-pobj,compound,NNP-NNP-NNP,NNP,0,1
8493,29797.0,71,starry,0,57,48,-9,56,22,-57,48,Charles Wuorinen,MODERN COMPOSERS,PERSON-PERSON,TITLE-TITLE,PROPN-PROPN,PROPN-VERB,compound-appos,compound-appos,NNP-NNP,NNP-VBZ,-1,1
8494,29803.0,34,al-Kharafi,5,13,10,-3,12,23,-8,5,Gholam Ali Haddad Adel,Shura Council,PERSON-PERSON-PERSON-PERSON,ORGANIZATION-ORGANIZATION,PROPN-PROPN-PROPN-PROPN,PROPN-PROPN,compound-compound-compound-nsubj,compound-compound,NNP-NNP-NNP-NNP,NNP-NNP,2,1
8495,29807.0,56,got,36,1,42,41,0,13,35,6,Richard H. Nolte,Nov. 22,PERSON-PERSON-PERSON,DATE-DATE,PROPN-PROPN-PROPN,PROPN-NUM,compound-compound-nsubj,npadvmod-nummod,NNP-NNP-NNP,NNP-CD,-1,1
8496,29809.0,33,said,18,27,20,-7,26,12,-9,2,MF Global Inc,Andrew Lebow,ORGANIZATION-ORGANIZATION-ORGANIZATION,PERSON-PERSON,PROPN-PROPN-PROPN,PROPN-PROPN,compound-compound-pobj,compound-nsubj,NNP-NNP-NNP,NNP-NNP,5,1
8497,29813.0,43,WHAT,0,4,10,6,3,32,-4,10,Department of Conservation and Recreation,DCR,ORGANIZATION-ORGANIZATION-ORGANIZATION-ORGANIZATION-ORGANIZATION,ORGANIZATION,PROPN-ADP-PROPN-CCONJ-PROPN,PROPN,npadvmod-prep-pobj-cc-conj,compound,NNP-IN-NNP-CC-NNP,NNP,4,1
8498,61052.0,40,WHAT,0,4,10,6,3,29,-4,10,Department of Conservation and Recreation,DCR,ORGANIZATION-ORGANIZATION-ORGANIZATION-ORGANIZATION-ORGANIZATION,ORGANIZATION,PROPN-ADP-PROPN-CCONJ-PROPN,PROPN,npadvmod-prep-pobj-cc-conj,compound,NNP-IN-NNP-CC-NNP,NNP,4,1
8499,29819.0,29,named,5,11,1,-10,10,27,-6,-4,Fidelity,Edward C. Johnson IV,ORGANIZATION,PERSON-PERSON-PERSON-PERSON,PROPN,PROPN-PROPN-PROPN-PROPN,compound,compound-compound-compound-nsubjpass,NNP,NNP-NNP-NNP-NNP,4,1
8500,29828.0,27,called,18,8,1,-7,7,25,10,-17,Servicemembers Legal Defense Network,C. Dixon Osburn,ORGANIZATION-ORGANIZATION-ORGANIZATION-ORGANIZATION,PERSON-PERSON-PERSON,PROPN-PROPN-PROPN-PROPN,PROPN-PROPN-PROPN,compound-compound-compound-pobj,compound-compound-nsubj,NNP-NNP-NNP-NNP,NNP-NNP-NNP,6,1
8501,29831.0,47,know,2,45,43,-2,44,3,-43,41,Kelly Cutrone,PR maven,PERSON-PERSON,TITLE-TITLE,PROPN-PROPN,PROPN-NOUN,compound-dobj,conj-ccomp,NNP-NNP,NNP-NN,3,1
8502,29849.0,38,made,13,9,13,4,8,24,4,0,International Monetary Fund,Mogae,ORGANIZATION-ORGANIZATION-ORGANIZATION,PERSON,PROPN-PROPN-PROPN,PROPN,compound-compound-pobj,nsubj,NNP-NNP-NNP,NNP,4,1
8503,29850.0,31,chosen,12,2,17,15,1,13,10,5,Bond,president,PERSON,TITLE,PROPN,NOUN,poss,pobj,NNP,NN,7,1
8504,29881.0,26,told,4,22,13,-9,21,12,-18,9,she,he,PERSON,PERSON,PRON,PRON,nsubj,nsubj,PRP,PRP,4,1
8505,64964.0,18,died,14,4,14,10,3,3,10,0,she,he,PERSON,PERSON,PRON,PRON,nsubj,nsubj,PRP,PRP,1,1
8506,29898.0,30,said,12,18,27,9,17,2,-6,15,New York Immigration Coalition,Long Island,ORGANIZATION-ORGANIZATION-ORGANIZATION-ORGANIZATION,LOCATION-LOCATION,PROPN-PROPN-PROPN-PROPN,PROPN-PROPN,compound-compound-compound-compound,compound-compound,NNP-NNP-NNP-NNP,NNP-NNP,3,1
8507,29907.0,32,planning,5,3,2,-1,2,29,2,-3,Melanie Fiona,singer/songwriter,PERSON-PERSON,TITLE,PROPN-PROPN,PROPN,compound-nsubj,compound,NNP-NNP,NNP,1,1
8508,53202.0,40,is,1,6,24,18,5,15,-5,23,Melanie Fiona,singer/songwriter,PERSON-PERSON,TITLE,PROPN-PROPN,PROPN,compound-poss,poss,NNP-NNP,NNP,10,1
8509,29919.0,40,says,23,34,25,-9,33,14,-11,2,National Security Council,R.P. Eddy,ORGANIZATION-ORGANIZATION-ORGANIZATION,PERSON-PERSON,PROPN-PROPN-PROPN,PROPN-PROPN,compound-compound-pobj,compound-nsubj,NNP-NNP-NNP,NNP-NNP,4,1
8510,29938.0,32,quoted,15,1,12,11,0,19,14,-3,Ali Akbar Salehi,atomic organisation,PERSON-PERSON-PERSON,ORGANIZATION-ORGANIZATION,PROPN-PROPN-PROPN,ADJ-NOUN,compound-compound-nsubjpass,amod-pobj,NNP-NNP-NNP,JJ-NN,7,1
8511,29946.0,47,said,35,46,37,-9,45,9,-11,2,FAA,Laura J. Browne,ORGANIZATION,PERSON-PERSON-PERSON,PROPN,PROPN-PROPN-PROPN,pobj,compound-compound-nsubj,NNP,NNP-NNP-NNP,4,1
8512,29952.0,33,issued,4,15,22,7,14,10,-11,18,Fidelity,FMR Corp.,ORGANIZATION,ORGANIZATION-ORGANIZATION,PROPN,PROPN-PROPN,poss,compound-pobj,NNP,NNP-NNP,5,1
8513,29956.0,42,said,24,31,26,-5,30,15,-7,2,University of Haifa,Itai Kloog,ORGANIZATION-ORGANIZATION-ORGANIZATION,PERSON-PERSON,PROPN-ADP-PROPN,PROPN-PROPN,pobj-prep-pobj,compound-nsubj,NNP-IN-NNP,NNP-NNP,3,1
8514,29958.0,47,targeted,8,27,23,-4,26,23,-19,15,Badr Organization,Mohammed Waeli,ORGANIZATION-ORGANIZATION,PERSON-PERSON,PROPN-PROPN,PROPN-PROPN,compound-conj,compound-pobj,NNP-NNP,NNP-NNP,1,1
8515,29959.0,40,told,15,12,29,17,11,10,3,14,Gholam Ali Haddad Adel,Israel,PERSON-PERSON-PERSON-PERSON,COUNTRY,PROPN-PROPN-PROPN-PROPN,PROPN,compound-compound-compound-nsubj,compound,NNP-NNP-NNP-NNP,NNP,8,1
8516,29965.0,19,survived,7,1,13,12,0,5,6,6,Roraback,Elizabeth Schmidt,PERSON,PERSON-PERSON,PROPN,PROPN-PROPN,nsubjpass,compound-appos,NNP,NNP-NNP,5,1
8517,37754.0,19,survived,7,1,13,12,0,5,6,6,Roraback,Elizabeth Schmidt,PERSON,PERSON-PERSON,PROPN,PROPN-PROPN,nsubjpass,compound-appos,NNP,NNP-NNP,5,1
8518,29973.0,13,'s,3,12,9,-3,11,3,-9,6,Babyshambles,UK,ORGANIZATION,COUNTRY,PROPN,PROPN,appos,compound,NNPS,NNP,4,1
8519,29985.0,39,said,16,13,1,-12,12,37,3,-15,Oxford University Press,Kate Farquhar-Thomson,ORGANIZATION-ORGANIZATION-ORGANIZATION,PERSON-PERSON,PROPN-PROPN-PROPN,PROPN-PROPN,compound-compound-pobj,compound-nsubj,NNP-NNP-NNP,NNP-NNP,7,1
8520,30006.0,23,worked,1,1,15,14,0,7,0,14,He,Fordham University Law School,PERSON,ORGANIZATION-ORGANIZATION-ORGANIZATION-ORGANIZATION,PRON,PROPN-PROPN-PROPN-PROPN,nsubj,compound-compound-compound-conj,PRP,NNP-NNP-NNP-NNP,2,1
8521,30007.0,23,operates,4,1,16,15,0,6,3,12,Royal Caribbean,Azamara Cruises,ORGANIZATION-ORGANIZATION,ORGANIZATION-ORGANIZATION,ADJ-ADJ,PROPN-PROPN,compound-compound,compound-conj,JJ-JJ,NNP-NNPS,6,1
8522,30022.0,23,was,15,1,11,10,0,11,14,-4,Bolin,Poughkeepsie,PERSON,CITY,PROPN,PROPN,nsubj,pobj,NNP,NNP,5,1
8523,30032.0,53,said,7,40,9,-31,39,43,-33,2,Beyonce,Sony BMG,PERSON,ORGANIZATION-ORGANIZATION,PROPN,PROPN-PROPN,pobj,compound-nsubj,NNP,NNP-NNP,6,1
8524,30034.0,43,is,16,11,2,-9,10,40,5,-14,China National Aviation Holding Company,Hong Kong-based,ORGANIZATION-ORGANIZATION-ORGANIZATION-ORGANIZATION-ORGANIZATION,CITY-CITY,PROPN-PROPN-PROPN-PROPN-PROPN,PROPN-PROPN,compound-compound-compound-compound-pobj,compound-compound,NNP-NNP-NNP-NNP-NNP,NNP-NNP,5,1
8525,30039.0,21,ramblings,3,1,13,12,0,7,2,10,Spencer,Heidi Montag,PERSON,PERSON-PERSON,PROPN,PROPN-PROPN,poss,compound-appos,NNP,NNP-NNP,6,1
8526,35167.0,20,Credit,0,5,7,2,4,12,-5,7,Spencer,Heidi Montag,PERSON,PERSON-PERSON,PROPN,PROPN-PROPN,appos,compound-dobj,NNP,NNP-NNP,3,1
8527,30040.0,33,said,13,11,29,18,10,3,2,16,Vietnam Economic and Cultural Office,VECO,ORGANIZATION-ORGANIZATION-ORGANIZATION-ORGANIZATION-ORGANIZATION,ORGANIZATION,PROPN-PROPN-CCONJ-PROPN-PROPN,PROPN,nmod-nmod-cc-conj-pobj,compound,NNP-NNP-CC-NNP-NNP,NNP,-1,1
8528,30041.0,28,survived,2,1,12,11,0,15,1,10,He,Brenda L. Stevenson,PERSON,PERSON-PERSON-PERSON,PRON,PROPN-PROPN-PROPN,nsubjpass,compound-compound-conj,PRP,NNP-NNP-NNP,5,1
8529,30043.0,32,went,1,24,31,7,23,0,-23,30,Mia Farrow,Prudence,PERSON-PERSON,PERSON,PROPN-PROPN,PROPN,compound-appos,appos,NNP-NNP,NNP,5,1
8530,30044.0,32,sold,4,1,23,22,0,8,3,19,Nottingham-Spirk Design Associates,Invacare,ORGANIZATION-ORGANIZATION-ORGANIZATION,ORGANIZATION,PROPN-PROPN-PROPN,PROPN,amod-compound-nsubj,conj,NNP-NNP-NNPS,NNP,10,1
8531,30046.0,28,reshuffled,11,20,27,7,19,0,-9,16,Philip Chen,director,PERSON-PERSON,TITLE,PROPN-PROPN,NOUN,compound-dobj,pobj,NNP-NNP,NN,3,1
8532,62656.0,31,canceling,4,18,17,-1,17,13,-14,13,Philip Chen,director,PERSON-PERSON,TITLE,PROPN-PROPN,NOUN,compound-nsubjpass,compound,NNP-NNP,NN,2,1
8533,30048.0,34,said,22,8,24,16,7,9,14,2,Army Medical Command,Margaret Tippy,ORGANIZATION-ORGANIZATION-ORGANIZATION,PERSON-PERSON,PROPN-PROPN-PROPN,PROPN-PROPN,compound-compound-pobj,compound-nsubj,NNP-NNP-NNP,NNP-NNP,4,1
8534,30050.0,37,said,22,28,24,-4,27,12,-6,2,IMF,Jerald Schiff,ORGANIZATION,PERSON-PERSON,PROPN,PROPN-PROPN,poss,compound-nsubj,NNP,NNP-NNP,3,1
8535,30055.0,24,reported,22,6,8,2,5,15,16,-14,Ospel,57,PERSON,NUMBER,PROPN,NUM,appos,appos,NNP,CD,4,1
8536,30057.0,22,said,11,6,10,4,5,11,5,-1,ABA,Tom Doyle,ORGANIZATION,PERSON-PERSON,NOUN,PROPN-PROPN,nmod,compound-appos,NN,NNP-NNP,3,1
8537,30070.0,29,Founded,0,15,3,-12,14,25,-15,3,CNR,China Northern Locomotive & Rolling Stock Industry -LRB- Group -RRB- Corporation,ORGANIZATION,ORGANIZATION-ORGANIZATION-ORGANIZATION-ORGANIZATION-ORGANIZATION-ORGANIZATION-ORGANIZATION-ORGANIZATION-ORGANIZATION-ORGANIZATION-ORGANIZATION,PROPN,PROPN-PROPN-PROPN-CCONJ-PROPN-PROPN-PROPN-PROPN-PROPN-PROPN-PROPN,compound,compound-compound-pobj-cc-compound-compound-conj-compound-compound-compound-ROOT,NNP,NNP-NNP-NNP-CC-NNP-NNP-NNP-NNP-NNP-NNP-NNP,4,1
8538,30094.0,36,survived,12,30,35,5,29,0,-18,23,Katarina Forsberg,Mass.,PERSON-PERSON,STATE_OR_PROVINCE,PROPN-PROPN,PROPN,compound-appos,appos,NNP-NNP,NNP,5,1
8539,30095.0,27,said,9,8,1,-7,7,25,1,-8,ABA,Sally Miller,ORGANIZATION,PERSON-PERSON,NOUN,PROPN-PROPN,pobj,compound-nsubj,NN,NNP-NNP,2,1
8540,30102.0,52,given,10,27,51,24,26,0,-17,41,U.S. Army Medical Command,Texas,ORGANIZATION-ORGANIZATION-ORGANIZATION-ORGANIZATION,STATE_OR_PROVINCE,PROPN-PROPN-PROPN-PROPN,PROPN,compound-compound-compound-pobj,appos,NNP-NNP-NNP-NNP,NNP,2,1
8541,30104.0,33,said,17,1,14,13,0,18,16,-3,Royal Caribbean Cruises Ltd.,Celebrity Cruise,ORGANIZATION-ORGANIZATION-ORGANIZATION-ORGANIZATION,ORGANIZATION-ORGANIZATION,ADJ-PROPN-PROPN-PROPN,PROPN-PROPN,compound-compound-compound-nsubj,compound-conj,JJ-NNP-NNPS-NNP,NNP-NNP,5,1
8542,30140.0,21,said,19,1,5,4,0,15,18,-14,Boxer,the Senate Environment Committee,PERSON,ORGANIZATION-ORGANIZATION-ORGANIZATION-ORGANIZATION,PROPN,DET-PROPN-PROPN-PROPN,nsubj,det-compound-compound-dobj,NNP,DT-NNP-NNP-NNP,4,1
8543,30141.0,11,survived,2,1,8,7,0,2,1,6,Bolin,Yorke B Mizelle,PERSON,PERSON-PERSON-PERSON,PROPN,PROPN-PROPN-PROPN,nsubjpass,compound-compound-appos,NNP,NNP-NNP-NNP,5,1
8544,30147.0,62,*,0,2,18,16,1,43,-2,18,Britney Spears,singer,PERSON-PERSON,TITLE,PROPN-NOUN,NOUN,compound-ROOT,nsubjpass,NNP-NNS,NN,4,1
8545,30151.0,28,congratulated,17,11,14,3,10,13,6,-3,Awami National Party,Mohammad Afzal,ORGANIZATION-ORGANIZATION-ORGANIZATION,PERSON-PERSON,PROPN-PROPN-PROPN,PROPN-PROPN,compound-compound-compound,compound-compound,NNP-NNP-NNP,NNP-NNP,4,1
8546,30189.0,17,deploy,3,1,5,4,0,11,2,2,Royal Caribbean,Legend of the Seas,ORGANIZATION-ORGANIZATION,ORGANIZATION-ORGANIZATION-ORGANIZATION-ORGANIZATION,ADJ-PROPN,PROPN-ADP-DET-PROPN,compound-nsubj,dobj-prep-det-pobj,JJ-NNP,NNP-IN-DT-NNPS,3,1
8547,30196.0,66,use,1,18,23,5,17,42,-17,22,Professional Rodeo Cowboys Association,http://wwwprorodeocom,ORGANIZATION-ORGANIZATION-ORGANIZATION-ORGANIZATION,URL,PROPN-PROPN-PROPN-PROPN,X,compound-compound-compound-pobj,ROOT,NNP-NNP-NNPS-NNP,ADD,5,1
8548,39395.0,77,Days,2,6,11,5,5,65,-4,9,Professional Rodeo Cowboys Association,http://wwwprorodeocom,ORGANIZATION-ORGANIZATION-ORGANIZATION-ORGANIZATION,URL,PROPN-PROPN-PROPN-PROPN,X,compound-compound-compound-ROOT,ROOT,NNP-NNP-NNPS-NNP,ADD,3,1
8549,30234.0,29,said,11,26,13,-13,25,15,-15,2,St. Anselm College,Jennifer Donahue,ORGANIZATION-ORGANIZATION-ORGANIZATION,PERSON-PERSON,PROPN-PROPN-PROPN,PROPN-PROPN,compound-compound-pobj,compound-nsubj,NNP-NNP-NNP,NNP-NNP,7,1
8550,30240.0,44,is,6,2,5,3,1,38,4,-1,Barbara Boxer,69,PERSON-PERSON,NUMBER,PROPN-PROPN,NUM,compound-nsubj,appos,NNP-NNP,CD,2,1
8551,30251.0,18,Stop,0,11,17,6,10,0,-11,17,his,Kerry,PERSON,PERSON,DET,PROPN,poss,appos,PRP$,NNP,5,1
8552,30272.0,17,was,8,4,13,9,3,3,4,5,Pamela Martin & Associates,1993,ORGANIZATION-ORGANIZATION-ORGANIZATION-ORGANIZATION,DATE,PROPN-PROPN-CCONJ-PROPN,NUM,compound-conj-cc-conj,pobj,NNP-NNP-CC-NNPS,CD,3,1
8553,30279.0,45,appears,6,6,6,0,5,38,0,0,Capitalia,Capitalia,ORGANIZATION,ORGANIZATION,PROPN,PROPN,pobj,pobj,NNP,NNP,0,1
8554,30289.0,15,challenging,2,1,12,11,0,2,1,10,EnergySolutions,U.S.,ORGANIZATION,COUNTRY,PROPN,PROPN,nsubj,compound,NNP,NNP,6,1
8555,30295.0,52,*,0,3,17,14,2,34,-3,17,Massachusetts Department of Conservation and Recreation,Executive Office of Energy and Environmental Affairs,ORGANIZATION-ORGANIZATION-ORGANIZATION-ORGANIZATION-ORGANIZATION-ORGANIZATION,ORGANIZATION-ORGANIZATION-ORGANIZATION-ORGANIZATION-ORGANIZATION-ORGANIZATION-ORGANIZATION,PROPN-PROPN-ADP-PROPN-CCONJ-PROPN,PROPN-PROPN-ADP-PROPN-CCONJ-PROPN-PROPN,compound-nsubj-prep-pobj-cc-conj,compound-pobj-prep-nmod-cc-conj-pobj,NNP-NNP-IN-NNP-CC-NNP,NNP-NNP-IN-NNP-CC-NNP-NNPS,4,1
8556,30301.0,38,cautioned,18,3,1,-2,2,36,15,-17,Andre Carson,US,PERSON-PERSON,COUNTRY,PROPN-PROPN,PROPN,compound-nsubj,compound,NNP-NNP,NNP,1,1
8557,30310.0,28,reports,4,12,8,-4,11,19,-8,4,FEC,Federal Election Commission,ORGANIZATION,ORGANIZATION-ORGANIZATION-ORGANIZATION,PROPN,PROPN-PROPN-PROPN,compound,compound-compound-pobj,NNP,NNP-NNP-NNP,5,1
8558,54859.0,70,Today,0,19,15,-4,18,54,-19,15,FEC,Federal Election Commission,ORGANIZATION,ORGANIZATION-ORGANIZATION-ORGANIZATION,PROPN,PROPN-PROPN-PROPN,compound,compound-compound-dobj,NNP,NNP-NNP-NNP,4,1
8559,30315.0,45,said,18,28,34,6,27,10,-10,16,American Beverage Association,Coca-Cola Co.,ORGANIZATION-ORGANIZATION-ORGANIZATION,ORGANIZATION-ORGANIZATION,PROPN-PROPN-PROPN,PROPN-PROPN,compound-compound-pobj,compound-dobj,NNP-NNP-NNP,NNP-NNP,7,1
8560,33026.0,31,called,14,2,8,6,1,22,12,-6,American Beverage Association,Coca-Cola Co.,ORGANIZATION-ORGANIZATION-ORGANIZATION,ORGANIZATION-ORGANIZATION,PROPN-PROPN-PROPN,PROPN-PROPN,compound-compound-nsubj,compound-dobj,NNP-NNP-NNP,NNP-NNP,4,1
8561,30329.0,22,said,14,8,11,3,7,10,6,-3,his,Glendale,PERSON,CITY,DET,PROPN,poss,pobj,PRP$,NNP,2,1
8562,63815.0,22,said,14,8,11,3,7,10,6,-3,his,Glendale,PERSON,CITY,DET,PROPN,poss,pobj,PRP$,NNP,2,1
8563,30331.0,21,picked,6,8,15,7,7,5,-2,9,Sheldon,Department of Children and Families,PERSON,ORGANIZATION-ORGANIZATION-ORGANIZATION-ORGANIZATION-ORGANIZATION,PROPN,PROPN-ADP-PROPN-CCONJ-PROPN,dobj,pobj-prep-pobj-cc-conj,NNP,NNP-IN-NNP-CC-NNPS,5,1
8564,30336.0,38,said,22,2,4,2,1,33,20,-18,Kaiser,president,PERSON,TITLE,PROPN,NOUN,nsubj,appos,NNP,NN,3,1
8565,30354.0,35,is,5,15,4,-11,14,30,-10,-1,Marcel Ospel,59,PERSON-PERSON,NUMBER,PROPN-PROPN,NUM,compound-dobj,appos,NNP-NNP,CD,5,1
8566,30367.0,20,said,8,1,7,6,0,12,7,-1,Bill McAllister,secretary,PERSON-PERSON,TITLE,PROPN-PROPN,NOUN,compound-nsubj,appos,NNP-NNP,NN,2,1
8567,52386.0,37,reported,2,12,10,-2,11,26,-10,8,Bill McAllister,secretary,PERSON-PERSON,TITLE,PROPN-PROPN,NOUN,compound-appos,nsubj,NNP-NNP,NN,2,1
8568,30371.0,38,said,11,13,16,3,12,21,-2,5,William Anderson,author,PERSON-PERSON,TITLE,PROPN-PROPN,NOUN,compound-nsubj,appos,NNP-NNP,NN,2,1
8569,30373.0,21,log,7,5,15,10,4,5,2,8,ABA,http://www.abanet.org/abanet/common/MyABA/home.cfm,ORGANIZATION,URL,PROPN,NOUN,compound,pobj,NNP,NN,4,1
8570,30384.0,35,pleaded,8,7,6,-1,6,28,1,-2,Mia Farrow,ambassador,PERSON-PERSON,TITLE,PROPN-PROPN,NOUN,compound-appos,conj,NNP-NNP,NN,1,1
8571,30387.0,50,whines,14,40,14,-26,39,35,-26,0,Spencer,she,PERSON,PERSON,PROPN,PRON,pobj,nsubj,NNP,PRP,4,1
8572,30397.0,22,said,20,20,10,-10,19,11,0,-10,Chen,U.S.,PERSON,COUNTRY,PROPN,PROPN,nsubj,conj,NNP,NNP,6,1
8573,30398.0,20,advised,15,8,11,3,7,8,7,-4,Northland Church,Orlando,ORGANIZATION-ORGANIZATION,CITY,PROPN-PROPN,PROPN,compound-pobj,pobj,NNP-NNP,NNP,3,1
8574,35169.0,27,carries,15,2,12,10,1,14,13,-3,Northland Church,Orlando,ORGANIZATION-ORGANIZATION,CITY,PROPN-PROPN,PROPN,compound-pobj,pobj,NNP-NNP,NNP,3,1
8575,44026.0,32,told,13,7,10,3,6,21,6,-3,Northland Church,Orlando,ORGANIZATION-ORGANIZATION,CITY,PROPN-PROPN,PROPN,compound-pobj,pobj,NNP-NNP,NNP,3,1
8576,44679.0,52,said,22,16,19,3,15,32,6,-3,Northland Church,Orlando,ORGANIZATION-ORGANIZATION,CITY,PROPN-PROPN,PROPN,compound-pobj,pobj,NNP-NNP,NNP,2,1
8577,30400.0,29,said,26,20,25,5,19,3,6,-1,MF Global,Rob Laughlin,ORGANIZATION-ORGANIZATION,PERSON-PERSON,PROPN-PROPN,PROPN-PROPN,nmod-amod,compound-nsubj,NNP-NNP,NNP-NNP,3,1
8578,30401.0,32,died,5,5,13,8,4,18,0,8,Bellecourt,complications of pneumonia,PERSON,CAUSE_OF_DEATH-CAUSE_OF_DEATH-CAUSE_OF_DEATH,PROPN,NOUN-ADP-NOUN,nsubj,pobj-prep-pobj,NNP,NNS-IN-NN,6,1
8579,30404.0,41,said,36,33,27,-6,32,13,3,-9,Carnival Cruise Lines,Gerry Cahill,ORGANIZATION-ORGANIZATION-ORGANIZATION,PERSON-PERSON,PROPN-PROPN-PROPN,PROPN-PROPN,compound-compound-pobj,compound-nsubj,NNP-NNP-NNP,NNP-NNP,5,1
8580,36815.0,28,said,14,22,16,-6,21,11,-8,2,Carnival Cruise Lines,Gerry Cahill,ORGANIZATION-ORGANIZATION-ORGANIZATION,PERSON-PERSON,PROPN-PROPN-NOUN,PROPN-PROPN,compound-compound-pobj,compound-nsubj,NNP-NNP-NNS,NNP-NNP,4,1
8581,30408.0,33,said,3,30,22,-8,29,10,-27,19,IRGC-QF,Iranian Revolutionary Guard Corps - Quds Force,ORGANIZATION,ORGANIZATION-ORGANIZATION-ORGANIZATION-ORGANIZATION-ORGANIZATION-ORGANIZATION-ORGANIZATION,PROPN,ADJ-PROPN-PROPN-PROPN-PUNCT-PROPN-PROPN,compound,compound-compound-compound-compound-punct-compound-compound,NNP,JJ-NNP-NNP-NNP-HYPH-NNP-NNP,7,1
8582,30421.0,41,won,17,1,11,10,0,29,16,-6,Gillmor,Air Force,PERSON,ORGANIZATION-ORGANIZATION,PROPN,PROPN-PROPN,nsubj,compound-pobj,NNP,NNP-NNP,6,1
8583,30422.0,25,worked,6,6,4,-2,5,20,0,-2,Crisp,activist,PERSON,TITLE,PROPN,NOUN,nsubj,oprd,NNP,NN,1,1
8584,30431.0,23,said,9,1,5,4,0,17,8,-4,Chris Bentley,U.S.,PERSON-PERSON,COUNTRY,PROPN-PROPN,PROPN,compound-nsubj,compound,NNP-NNP,NNP,3,1
8585,30436.0,28,reported,2,10,9,-1,9,18,-8,7,FMR LLC,Boston-based,ORGANIZATION-ORGANIZATION,CITY,PROPN-PROPN,VERB,compound-nsubj,amod,NNP-NNP,VBD,1,1
8586,30441.0,25,received,1,1,7,6,0,17,0,6,He,Harvard,PERSON,ORGANIZATION,PRON,PROPN,nsubj,pobj,PRP,NNP,1,1
8587,30466.0,21,follows,4,8,13,5,7,7,-4,9,he,DNI,PERSON,ORGANIZATION,PRON,PROPN,nsubj,pobj,PRP,NNP,1,1
8588,30478.0,39,image,1,17,21,4,16,17,-16,20,Spears,Parklane Academy,PERSON,ORGANIZATION-ORGANIZATION,PROPN,PROPN-PROPN,nsubj,compound-pobj,NNP,NNP-NNP,7,1
8589,30480.0,70,boast,10,27,5,-22,26,64,-17,-5,Melanie Fiona,`` Catfights,PERSON-PERSON,ORGANIZATION-ORGANIZATION,PROPN-PROPN,PUNCT-PROPN,compound-compound,punct-pobj,NNP-NNP,``-NNPS,3,1
8590,30484.0,30,are,8,5,20,15,4,9,3,12,Raul Castro,Caribbean,PERSON-PERSON,NATIONALITY,PROPN-PROPN,ADJ,compound-nsubj,conj,NNP-NNP,JJ,9,1
8591,30485.0,33,said,25,23,2,-21,22,30,2,-23,Psychiatric Association,Alan F Schatzburg,ORGANIZATION-ORGANIZATION,PERSON-PERSON-PERSON,PROPN-PROPN,PROPN-PROPN-PROPN,compound-pobj,compound-compound-nsubj,NNP-NNP,NNP-NNP-NNP,10,1
8592,30488.0,61,Haddad-Adel,1,1,8,7,0,52,0,7,Gholam-Ali Haddad-Adel,Parliament,PERSON-PERSON,ORGANIZATION,PROPN-PROPN,PROPN,compound-ROOT,pobj,NNP-NNP,NNP,3,1
8593,40126.0,42,included,1,16,13,-3,15,28,-15,12,Gholam-Ali Haddad-Adel,Parliament,PERSON-PERSON,ORGANIZATION,PROPN-PROPN,PROPN,compound-ROOT,appos,NNP-NNP,NNP,-1,1
8594,30497.0,59,said,22,28,39,11,27,19,-6,17,Jamaat al Muslimeen,Trinidad,ORGANIZATION-ORGANIZATION-ORGANIZATION,COUNTRY,PROPN-PROPN-PROPN,PROPN,compound-compound-poss,pobj,NNP-NNP-NNP,NNP,6,1
8595,30506.0,31,said,10,3,9,6,2,21,7,-1,Carolyn Maloney,Democrat,PERSON-PERSON,ORGANIZATION,PROPN-PROPN,PROPN,compound-nsubj,appos,NNP-NNP,NNP,2,1
8596,30509.0,21,served,10,9,14,5,8,6,1,4,Hawkins,legislator,PERSON,TITLE,PROPN,NOUN,nsubj,pobj,NNP,NN,2,1
8597,30533.0,45,phwoarrrrr,0,8,6,-2,7,38,-8,6,Adam Senn,23-year,PERSON-PERSON,NUMBER,PROPN-PROPN,ADJ,compound-nsubj,punct,NNP-NNP,JJ,1,1
8598,30535.0,35,survived,2,11,22,11,10,12,-9,20,Emily Ann Kennard Derounian,Lexington,PERSON-PERSON-PERSON-PERSON,CITY,PROPN-PROPN-PROPN-PROPN,PROPN,compound-compound-compound-appos,pobj,NNP-NNP-NNP-NNP,NNP,7,1
8599,30542.0,44,arrives,5,4,3,-1,3,40,1,-2,Frankie Delgado,star,PERSON-PERSON,TITLE,PROPN-PROPN,NOUN,compound-nsubj,compound,NNP-NNP,NN,1,1
8600,30563.0,28,played,1,1,26,25,0,1,0,25,He,PGA Tour,PERSON,ORGANIZATION-ORGANIZATION,PRON,PROPN-PROPN,nsubj,compound-pobj,PRP,NNP-NNP,8,1
8601,30564.0,33,said,18,3,21,18,2,11,15,3,her,he,PERSON,PERSON,DET,PRON,poss,nsubjpass,PRP$,PRP,5,1
8602,38149.0,22,told,1,13,18,5,12,3,-12,17,her,he,PERSON,PERSON,PRON,PRON,dobj,nsubj,PRP,PRP,7,1
8603,64250.0,26,'s,1,14,12,-2,13,13,-13,11,her,he,PERSON,PERSON,PRON,PRON,dobj,nsubj,PRP,PRP,1,1
8604,30575.0,27,convicted,6,12,9,-3,11,17,-6,3,Michael Deaver,perjury,PERSON-PERSON,CRIMINAL_CHARGE,PROPN-PROPN,NOUN,compound-nsubj,pobj,NNP-NNP,NN,5,1
8605,30576.0,26,found,3,15,13,-2,14,12,-12,10,Barbara Boxer,US,PERSON-PERSON,COUNTRY,PROPN-PROPN,PROPN,compound-pobj,compound,NNP-NNP,NNP,1,1
8606,46588.0,37,declared,4,3,1,-2,2,35,1,-3,Barbara Boxer,US,PERSON-PERSON,ORGANIZATION,PROPN-PROPN,PROPN,compound-nsubj,compound,NNP-NNP,NNP,1,1
8607,30603.0,17,come,2,10,8,-2,9,8,-8,6,Alberto Gonzales,Attorney General,PERSON-PERSON,TITLE-TITLE,PROPN-PROPN,PROPN-PROPN,compound-poss,compound-compound,NNP-NNP,NNP-NNP,1,1
8608,33077.0,33,learned,4,3,1,-2,2,31,1,-3,Alberto Gonzales,Attorney General,PERSON-PERSON,TITLE-TITLE,PROPN-PROPN,PROPN-PROPN,compound-nsubj,compound-compound,NNP-NNP,NNP-NNP,1,1
8609,41777.0,29,sent,2,12,10,-2,11,18,-10,8,Alberto Gonzales,Attorney General,PERSON-PERSON,TITLE-TITLE,PROPN-PROPN,PROPN-PROPN,compound-pobj,compound-compound,NNP-NNP,NNP-NNP,2,1
8610,57657.0,24,Text,1,16,14,-2,15,9,-15,13,Alberto Gonzales,Attorney General,PERSON-PERSON,TITLE-TITLE,PROPN-PROPN,PROPN-PROPN,compound-pobj,compound-compound,NNP-NNP,NNP-NNP,1,1
8611,30610.0,45,changed,2,38,17,-21,37,27,-36,15,he,Anthony Fortunato,PERSON,PERSON-PERSON,PRON,PROPN-PROPN,nsubj,compound-appos,PRP,NNP-NNP,5,1
8612,30617.0,36,obtain,5,11,21,10,10,14,-6,16,Nuclear Suppliers Group,45,ORGANIZATION-ORGANIZATION-ORGANIZATION,NUMBER,PROPN-PROPN-PROPN,NUM,compound-compound-pobj,nummod,NNP-NNPS-NNP,CD,8,1
8613,59143.0,19,lifted,8,5,2,-3,4,16,3,-6,Nuclear Suppliers Group,45,ORGANIZATION-ORGANIZATION-ORGANIZATION,NUMBER,PROPN-PROPN-PROPN,NUM,compound-compound-nsubj,nummod,NNP-NNPS-NNP,CD,3,1
8614,30618.0,37,said,32,1,32,31,0,4,31,0,Wuffli,UBS,PERSON,ORGANIZATION,PROPN,PROPN,nsubjpass,nsubj,NNP,NNP,2,1
8615,30619.0,5,Works,2,1,5,4,0,-1,1,3,Illinois Tool Works,http://www.itw.com/,ORGANIZATION-ORGANIZATION-ORGANIZATION,URL,PROPN-PROPN-VERB,PUNCT,compound-compound-ROOT,appos,NNP-NNP-VBZ,.,-1,1
8616,30622.0,50,is,1,25,18,-7,24,31,-24,17,AQR Capital Management,Clifford S. Asness,ORGANIZATION-ORGANIZATION-ORGANIZATION,PERSON-PERSON-PERSON,PROPN-PROPN-PROPN,PROPN-PROPN-PROPN,compound-compound-pobj,compound-compound-pobj,NNP-NNP-NNP,NNP-NNP-NNP,4,1
8617,51264.0,45,is,16,21,1,-20,20,43,-5,-15,AQR Capital Management,Clifford S. Asness,ORGANIZATION-ORGANIZATION-ORGANIZATION,PERSON-PERSON-PERSON,PROPN-PROPN-PROPN,PROPN-PROPN-PROPN,compound-compound-pobj,compound-compound-nsubj,NNP-NNP-NNP,NNP-NNP-NNP,6,1
8618,52856.0,30,says,15,8,1,-7,7,28,7,-14,AQR Capital Management,Clifford S. Asness,ORGANIZATION-ORGANIZATION-ORGANIZATION,PERSON-PERSON-PERSON,PROPN-PROPN-PROPN,PROPN-PROPN-PROPN,compound-compound-pobj,compound-compound-nsubj,NNP-NNP-NNP,NNP-NNP-NNP,6,1
8619,61166.0,52,is,26,9,2,-7,8,49,17,-24,AQR Capital Management,Clifford S. Asness,ORGANIZATION-ORGANIZATION-ORGANIZATION,PERSON-PERSON-PERSON,PROPN-PROPN-PROPN,PROPN-PROPN-PROPN,compound-compound-pobj,compound-compound-nsubj,NNP-NNP-NNP,NNP-NNP-NNP,6,1
8620,30625.0,42,forming,20,1,9,8,0,32,19,-11,Dan Abrams,NBC News,PERSON-PERSON,ORGANIZATION-ORGANIZATION,PROPN-PROPN,PROPN-PROPN,compound-nsubj,compound-pobj,NNP-NNP,NNP-NNP,3,1
8621,33775.0,36,admitted,10,1,8,7,0,27,9,-2,Dan Abrams,NBC News,PERSON-PERSON,ORGANIZATION-ORGANIZATION,PROPN-PROPN,PROPN-PROPN,compound-nsubj,compound-pobj,NNP-NNP,NNP-NNP,3,1
8622,40189.0,24,News,1,14,1,-13,13,22,-13,0,Dan Abrams,NBC News,PERSON-PERSON,ORGANIZATION-ORGANIZATION,PROPN-PROPN,PROPN-PROPN,compound-pobj,compound-ROOT,NNP-NNP,NNP-NNP,2,1
8623,30628.0,21,was,4,4,13,9,3,7,0,9,Ahearn,Group of Seven Summit,PERSON,ORGANIZATION-ORGANIZATION-ORGANIZATION-ORGANIZATION,PROPN,PROPN-ADP-PROPN-PROPN,nsubj,dobj-prep-compound-pobj,NNP,NNP-IN-NNP-NNP,7,1
8624,30629.0,25,is,8,1,5,4,0,19,7,-3,MTC,Dayton,ORGANIZATION,CITY,PROPN,PROPN,nsubj,pobj,NNP,NNP,5,1
8625,30631.0,20,be,7,2,19,17,1,0,5,12,his,China,PERSON,COUNTRY,DET,PROPN,poss,pobj,PRP$,NNP,4,1
8626,30632.0,11,survived,2,1,8,7,0,2,1,6,Bolin,Yorke B. Mizelle,PERSON,PERSON-PERSON-PERSON,PROPN,PROPN-PROPN-PROPN,nsubjpass,compound-compound-appos,NNP,NNP-NNP-NNP,5,1
8627,30637.0,40,published,18,6,22,16,5,17,12,4,she,Arms Control Reporter,PERSON,ORGANIZATION-ORGANIZATION-ORGANIZATION,PRON,PROPN-PROPN-PROPN,nsubj,compound-compound-dobj,PRP,NNP-NNP-NNP,5,1
8628,39731.0,40,published,18,6,22,16,5,17,12,4,she,Arms Control Reporter,PERSON,ORGANIZATION-ORGANIZATION-ORGANIZATION,PRON,PROPN-PROPN-PROPN,nsubj,compound-compound-dobj,PRP,NNP-NNP-NNP,5,1
8629,50073.0,40,published,18,6,22,16,5,17,12,4,she,Arms Control Reporter,PERSON,ORGANIZATION-ORGANIZATION-ORGANIZATION,PRON,PROPN-PROPN-PROPN,nsubj,compound-compound-dobj,PRP,NNP-NNP-NNP,5,1
8630,30639.0,38,spent,3,1,15,14,0,22,2,12,He,Iran,PERSON,COUNTRY,PRON,PROPN,nsubj,poss,PRP,NNP,4,1
8631,30654.0,61,means,1,42,39,-3,41,21,-41,38,Zagat,zagatcom,ORGANIZATION,URL,PROPN,NOUN,appos,appos,NNP,NN,6,1
8632,30660.0,31,was,1,25,27,2,24,3,-24,26,MNLF,Nur Misuari,ORGANIZATION,PERSON-PERSON,PROPN,PROPN-PROPN,compound,compound-dobj,NNP,NNP-NNP,1,1
8633,63045.0,41,signed,3,3,25,22,2,15,0,22,MNLF,Nur Misuari,ORGANIZATION,PERSON-PERSON,PROPN,PROPN-PROPN,nsubj,compound-appos,NNP,NNP-NNP,8,1
8634,30683.0,26,attended,5,16,19,3,15,6,-11,14,Sean Preston,two,PERSON-PERSON,NUMBER,PROPN-PROPN,NUM,compound-pobj,appos,NNP-NNP,CD,2,1
8635,30684.0,54,are,36,3,6,3,2,47,33,-30,MAC,Johnnason Liu,ORGANIZATION,PERSON-PERSON,PROPN,PROPN-PROPN,compound,compound-pobj,NNP,NNP-NNP,2,1
8636,30695.0,25,been,4,2,8,6,1,16,2,4,Hassan,driver,PERSON,TITLE,PROPN,NOUN,nsubj,attr,NNP,NN,2,1
8637,30720.0,21,MYERS,2,1,5,4,0,15,1,3,DEE DEE MYERS,White House,PERSON-PERSON-PERSON,ORGANIZATION-ORGANIZATION,PROPN-PROPN-PROPN,PROPN-PROPN,compound-compound-ROOT,compound-compound,NNP-NNP-NNP,NNP-NNP,3,1
8638,30731.0,45,propped,12,12,6,-6,11,38,0,-6,Negroponte,Honduras,PERSON,COUNTRY,PROPN,PROPN,nsubj,pobj,NNP,NNP,3,1
8639,30749.0,68,released,48,8,11,3,7,56,40,-37,Ellen DeGeneres,Portia,PERSON-PERSON,PERSON,PROPN-PROPN,PROPN,compound-pobj,conj,NNP-NNP,NNP,7,1
8640,30753.0,8,Football,0,5,8,3,4,-1,-5,8,Ferrara,coach,PERSON,TITLE,PROPN,NOUN,dobj,pobj,NNP,NN,-1,1
8641,30756.0,27,is,1,17,13,-4,16,13,-16,12,Jamie Lynn,Lynne,PERSON-PERSON,PERSON,PROPN-PROPN,PROPN,compound-appos,appos,NNP-NNP,NNP,2,1
8642,30757.0,77,said,42,57,61,4,56,15,-15,19,American Bar Association,Banking Law Committee,ORGANIZATION-ORGANIZATION-ORGANIZATION,ORGANIZATION-ORGANIZATION-ORGANIZATION,PROPN-PROPN-PROPN,PROPN-PROPN-PROPN,compound-compound-poss,compound-compound-pobj,NNP-NNP-NNP,NNP-NNP-NNP,2,1
8643,30777.0,39,caused,35,2,25,23,1,13,33,-10,"he made his debut in Melbourne this year at the season - opening Australian Grand Prix , Hamilton",Afro - Carribean,PERSON-PERSON-PERSON-PERSON-PERSON-PERSON-PERSON-PERSON-PERSON-PERSON-PERSON-PERSON-PERSON-PERSON-PERSON-PERSON-PERSON-PERSON,CITY-CITY-CITY,PRON-VERB-DET-NOUN-ADP-PROPN-DET-NOUN-ADP-DET-NOUN-PUNCT-VERB-PROPN-PROPN-PROPN-PUNCT-PROPN,PROPN-PUNCT-ADJ,nsubj-advcl-poss-dobj-prep-pobj-det-npadvmod-prep-det-npadvmod-punct-amod-compound-compound-pobj-punct-appos,compound-punct-amod,"PRP-VBD-PRP$-NN-IN-NNP-DT-NN-IN-DT-NN-HYPH-VBG-NNP-NNP-NNP-,-NNP",NNP-HYPH-JJ,8,1
8644,30793.0,30,replaced,10,12,16,4,11,13,-2,6,Al Hubbard,Indianapolis,PERSON-PERSON,CITY,PROPN-PROPN,PROPN,compound-dobj,compound,NNP-NNP,NNP,1,1
8645,30797.0,46,said,43,3,1,-2,2,44,40,-42,Chunghwa Telecom Co,Taiwan,ORGANIZATION-ORGANIZATION-ORGANIZATION,STATE_OR_PROVINCE,PROPN-PROPN-PROPN,PROPN,compound-compound-nsubj,poss,NNP-NNP-NNP,NNP,3,1
8646,30803.0,29,recalled,2,2,1,-1,1,27,0,-1,DeBlanc,Rev.,PERSON,TITLE,PROPN,PROPN,nsubj,compound,NNP,NNP,1,1
8647,30804.0,37,took,18,10,14,4,9,22,8,-4,DeBlanc,lieutenant,PERSON,TITLE,PROPN,NOUN,nsubj,appos,NNP,NN,3,1
8648,65378.0,35,took,16,8,12,4,7,22,8,-4,DeBlanc,lieutenant,PERSON,TITLE,PROPN,NOUN,nsubj,appos,NNP,NN,3,1
8649,66312.0,35,took,16,8,12,4,7,22,8,-4,DeBlanc,lieutenant,PERSON,TITLE,PROPN,NOUN,nsubj,appos,NNP,NN,3,1
8650,30808.0,35,is,6,26,18,-8,25,16,-20,12,Covidien PLC,Mallinockrodt Inc.,ORGANIZATION-ORGANIZATION,ORGANIZATION-ORGANIZATION,PROPN-PROPN,PROPN-PROPN,compound-pobj,compound-pobj,NNP-NNP,NNP-NNP,4,1
8651,30813.0,36,manage,22,15,1,-14,14,34,7,-21,Marywood University,Rundell,ORGANIZATION-ORGANIZATION,PERSON,PROPN-PROPN,PROPN,compound-pobj,nsubj,NNP-NNP,NNP,5,1
8652,30830.0,25,said,10,7,1,-6,6,23,3,-9,American Beverage Association,Susan Feely,ORGANIZATION-ORGANIZATION-ORGANIZATION,PERSON-PERSON,PROPN-PROPN-PROPN,PROPN-PROPN,compound-compound-pobj,compound-nsubj,NNP-NNP-NNP,NNP-NNP,5,1
8653,30845.0,39,nn,0,14,17,3,13,21,-14,17,Abu Zubaydah,Pakistan,PERSON-PERSON,COUNTRY,PROPN-PROPN,PROPN,compound-oprd,pobj,NNP-NNP,NNP,2,1
8654,50258.0,17,arrested,13,4,16,12,3,0,9,3,Abu Zubaydah,Pakistan,PERSON-PERSON,COUNTRY,PROPN-PROPN,PROPN,compound-conj,pobj,NNP-NNP,NNP,3,1
8655,30849.0,71,is,6,15,49,34,14,21,-9,43,his,actor,PERSON,TITLE,DET,NOUN,poss,compound,PRP$,NN,-1,1
8656,30851.0,25,telling,10,12,2,-10,11,22,-2,-8,her,congresswoman,PERSON,TITLE,DET,NOUN,poss,nsubj,PRP$,NN,4,1
8657,30852.0,35,said,29,33,15,-18,32,19,-4,-14,Chris Bentley,United States,PERSON-PERSON,COUNTRY-COUNTRY,PROPN-PROPN,PROPN-PROPN,compound-nsubj,compound-dobj,NNP-NNP,NNP-NNP,7,1
8658,30864.0,37,complete,3,26,19,-7,25,17,-23,16,Jo Ann Davis,Ohio,PERSON-PERSON-PERSON,STATE_OR_PROVINCE,PROPN-PROPN-PROPN,PROPN,compound-compound-conj,compound,NNP-NNP-NNP,NNP,8,1
8659,30872.0,23,graduated,1,1,22,21,0,0,0,21,She,engineer,PERSON,TITLE,PRON,NOUN,nsubj,pobj,PRP,NN,1,1
8660,30882.0,22,continued,4,3,21,18,2,0,1,17,Covidien,Bermuda,ORGANIZATION,LOCATION,PROPN,PROPN,nsubj,pobj,NNP,NNP,2,1
8661,30888.0,37,said,3,20,2,-18,19,34,-17,-1,she,TLC,PERSON,ORGANIZATION,PRON,PROPN,nsubj,compound,PRP,NNP,4,1
8662,30896.0,25,detained,12,9,1,-8,8,23,3,-11,Lashkar-e-Taiba,Hafiz Mohammad Saeed,ORGANIZATION,PERSON-PERSON-PERSON,PROPN,PROPN-PROPN-PROPN,compound,compound-compound-nsubjpass,NNP,NNP-NNP-NNP,5,1
8663,51521.0,35,announced,5,1,3,2,0,31,4,-2,Lashkar-e-Taiba,Hafiz Mohammad Saeed,ORGANIZATION,PERSON-PERSON-PERSON,PROPN,PROPN-PROPN-PROPN,compound,compound-compound-nsubj,NNP,NNP-NNP-NNP,3,1
8664,30902.0,62,follow,6,46,3,-43,45,58,-40,-3,Juliette Binoche,Paris,PERSON-PERSON,CITY,PROPN-PROPN,PROPN,compound-compound,pobj,NNP-NNP,NNP,-1,1
8665,30917.0,31,nationalized,5,2,23,21,1,7,3,18,Hugo Chavez,Caracas,PERSON-PERSON,CITY,PROPN-PROPN,PROPN,compound-poss,pobj,NNP-NNP,NNP,5,1
8666,30919.0,29,said,27,6,13,7,5,15,21,-14,DirecTV,MountainWest Sports Network,ORGANIZATION,ORGANIZATION-ORGANIZATION-ORGANIZATION,VERB,PROPN-PROPN-PROPN,npadvmod,compound-compound-nsubj,VBD,NNP-NNPS-NNP,4,1
8667,30923.0,35,LANCASTER,0,16,3,-13,15,31,-16,3,Kirchner,Pennsylvania,PERSON,COUNTRY,PROPN,PROPN,nsubj,npadvmod,NNP,NNP,7,1
8668,30928.0,47,down,1,12,15,3,11,31,-11,14,Red Sox,Tom Yawkey,ORGANIZATION-ORGANIZATION,PERSON-PERSON,PROPN-PROPN,PROPN-PROPN,compound-compound,compound-pobj,NNP-NNPS,NNP-NNP,2,1
8669,30932.0,42,made,5,29,33,4,28,8,-24,28,her,Syco Music / Epic Records,PERSON,ORGANIZATION-ORGANIZATION-ORGANIZATION-ORGANIZATION-ORGANIZATION,DET,PROPN-PROPN-SYM-PROPN-PROPN,poss,nmod-nmod-punct-compound-pobj,PRP$,NNP-NNP-SYM-NNP-NNPS,2,1
8670,30936.0,25,said,23,2,4,2,1,20,21,-19,Defense,Robert Gates,ORGANIZATION,PERSON-PERSON,PROPN,PROPN-PROPN,compound,compound-nsubj,NNP,NNP-NNP,1,1
8671,30937.0,25,jailed,2,20,15,-5,19,9,-18,13,him,murder,PERSON,CRIMINAL_CHARGE,PRON,NOUN,dobj,compound,PRP,NN,3,1
8672,30944.0,24,declared,14,22,20,-2,21,3,-8,6,Dan Abrams,general manager,PERSON-PERSON,TITLE-TITLE,PROPN-PROPN,ADJ-NOUN,compound-conj,amod-compound,NNP-NNP,JJ-NN,3,1
8673,61047.0,44,had,18,10,36,26,9,7,8,18,Dan Abrams,general manager,PERSON-PERSON,TITLE-TITLE,PROPN-PROPN,ADJ-NOUN,compound-pobj,amod-attr,NNP-NNP,JJ-NN,7,1
8674,61896.0,36,continue,20,1,7,6,0,28,19,-13,Dan Abrams,general manager,PERSON-PERSON,TITLE-TITLE,PROPN-PROPN,ADJ-NOUN,compound-nsubj,amod-appos,NNP-NNP,JJ-NN,1,1
8675,30954.0,35,dropped,16,25,23,-2,24,11,-9,7,Royal Caribbean International,Labadee,ORGANIZATION-ORGANIZATION-ORGANIZATION,LOCATION,PROPN-PROPN-PROPN,PROPN,compound-compound-nsubj,pobj,NNP-NNP-NNP,NNP,3,1
8676,30962.0,32,won,7,1,5,4,0,26,6,-2,Kerry,December 1943,PERSON,DATE-DATE,PROPN,PROPN-NUM,nsubj,pobj-nummod,NNP,NNP-CD,5,1
8677,30967.0,32,confirmed,3,14,10,-4,13,21,-11,7,Multidisciplinary Association for Psychedelic Studies,Boston-based,ORGANIZATION-ORGANIZATION-ORGANIZATION-ORGANIZATION-ORGANIZATION,MISC,PROPN-PROPN-ADP-PROPN-PROPN,ADJ,compound-pobj-prep-compound-pobj,amod,NNP-NNP-IN-NNP-NNPS,JJ,5,1
8678,30968.0,31,recounted,17,19,7,-12,18,23,-2,-10,his,Germany,PERSON,COUNTRY,DET,PROPN,poss,pobj,PRP$,NNP,6,1
8679,30982.0,20,named,5,10,12,2,9,7,-5,7,KGB,First Main Directorate,ORGANIZATION,ORGANIZATION-ORGANIZATION-ORGANIZATION,PROPN,PROPN-PROPN-PROPN,poss,compound-compound-pobj,NNP,NNP-NNP-NNP,3,1
8680,30994.0,25,was,1,15,10,-5,14,14,-14,9,he,St. Martinville,PERSON,LOCATION-LOCATION,PRON,PROPN-PROPN,nsubj,compound-compound,PRP,NNP-NNP,5,1
8681,30995.0,37,maintains,3,29,21,-8,28,15,-26,18,Abu Zubaydah,al - Qaida,PERSON-PERSON,ORGANIZATION-ORGANIZATION-ORGANIZATION,PROPN-PROPN,PROPN-PUNCT-PROPN,compound-conj,compound-punct-compound,NNP-NNP,NNP-HYPH-NNP,4,1
8682,31001.0,41,told,36,31,34,3,30,6,5,-2,OIC,Atta El-Manan Bakhit,ORGANIZATION,PERSON-PERSON-PERSON,PROPN,PROPN-PROPN-PROPN,compound,compound-compound-nsubj,NNP,NNP-NNP-NNP,4,1
8683,31004.0,35,wanted,15,11,33,22,10,1,4,18,Myers,Washington,PERSON,STATE_OR_PROVINCE,PROPN,PROPN,nsubj,compound,NNP,NNP,7,1
8684,31019.0,23,ripped,3,11,16,5,10,6,-8,13,ConAgra Foods Inc.,Garner,ORGANIZATION-ORGANIZATION-ORGANIZATION,CITY,PROPN-PROPN-PROPN,PROPN,compound-compound-compound,pobj,NNP-NNPS-NNP,NNP,1,1
8685,31041.0,41,said,11,9,17,8,8,23,2,6,Ayatollah Ali Khamenei,Islamic Republic,PERSON-PERSON-PERSON,LOCATION-LOCATION,PROPN-PROPN-PROPN,PROPN-PROPN,compound-compound-appos,compound-nsubjpass,NNP-NNP-NNP,NNP-NNP,4,1
8686,31050.0,53,said,6,1,4,3,0,48,5,-2,Simon Cowell,47,PERSON-PERSON,NUMBER,PROPN-PROPN,NUM,compound-nsubj,appos,NNP-NNP,CD,2,1
8687,33257.0,43,Cowell,1,1,27,26,0,15,0,26,Simon Cowell,47,PERSON-PERSON,NUMBER,PROPN-PROPN,NUM,compound-ROOT,appos,NNP-NNP,CD,2,1
8688,31064.0,47,died,36,1,42,41,0,4,35,6,Vernon Bellecourt,pneumonia,PERSON-PERSON,CAUSE_OF_DEATH,PROPN-PROPN,NOUN,compound-nsubj,pobj,NNP-NNP,NN,2,1
8689,63600.0,48,died,36,1,43,42,0,4,35,7,Vernon Bellecourt,pneumonia,PERSON-PERSON,CAUSE_OF_DEATH,PROPN-PROPN,NOUN,compound-nsubj,pobj,NNP-NNP,NN,2,1
8690,31066.0,10,Football,0,3,10,7,2,-1,-3,10,Arsenal,Everton,ORGANIZATION,ORGANIZATION,PROPN,PROPN,poss,pobj,NNP,NNP,-1,1
8691,31068.0,24,attended,5,5,7,2,4,16,0,2,Buchwald,Jamaica High School and Forest Hills High School,PERSON,ORGANIZATION-ORGANIZATION-ORGANIZATION-ORGANIZATION-ORGANIZATION-ORGANIZATION-ORGANIZATION-ORGANIZATION,PROPN,PROPN-PROPN-PROPN-CCONJ-PROPN-PROPN-PROPN-PROPN,nsubj,compound-compound-dobj-cc-compound-compound-compound-conj,NNP,NNP-NNP-NNP-CC-NNP-NNP-NNP-NNP,2,1
8692,31080.0,35,put,2,23,23,0,22,11,-21,21,NFC South,NFC West,ORGANIZATION-ORGANIZATION,ORGANIZATION-ORGANIZATION,PROPN-PROPN,PROPN-PROPN,compound-conj,compound-conj,NNP-NNP,NNP-NNP,0,1
8693,31105.0,30,needs,12,5,10,5,4,19,7,-2,Black,Hearst Magazines,PERSON,ORGANIZATION-ORGANIZATION,PROPN,PROPN-PROPN,nsubj,compound-pobj,NNP,NNP-NNP,4,1
8694,31107.0,9,Submariner,0,4,7,3,3,1,-4,7,William Anderson,85,PERSON-PERSON,NUMBER,PROPN-PROPN,NUM,compound-conj,appos,NNP-NNP,CD,3,1
8695,31108.0,39,said,4,21,8,-13,20,30,-17,4,Denso,Japan,ORGANIZATION,COUNTRY,PROPN,PROPN,dobj,pobj,NNP,NNP,3,1
8696,37781.0,45,slashes,3,3,1,-2,2,43,0,-2,Denso,Japan,ORGANIZATION,COUNTRY,PROPN,PROPN,nsubj,poss,NNP,NNP,3,1
8697,52908.0,38,said,22,24,37,13,23,0,-2,15,Denso,Japan,ORGANIZATION,COUNTRY,PROPN,PROPN,compound,appos,NNP,NNP,7,1
8698,52979.0,45,slashes,3,3,1,-2,2,43,0,-2,Denso,Japan,ORGANIZATION,COUNTRY,PROPN,PROPN,nsubj,poss,NNP,NNP,3,1
8699,57412.0,70,said,36,3,1,-2,2,68,33,-35,Denso,Japan,ORGANIZATION,COUNTRY,PROPN,PROPN,nsubj,poss,NNP,NNP,3,1
8700,31112.0,34,said,12,7,3,-4,6,30,5,-9,National Action Network,Horace Sheffield,ORGANIZATION-ORGANIZATION-ORGANIZATION,PERSON-PERSON,PROPN-PROPN-PROPN,PROPN-PROPN,compound-compound-compound,compound-nsubj,NNP-NNP-NNP,NNP-NNP,3,1
8701,31113.0,11,dominating,1,9,1,-8,8,9,-8,0,Jacksonville Jaguars,JAGS,ORGANIZATION-ORGANIZATION,ORGANIZATION,PROPN-PROPN,PROPN,compound-pobj,nsubj,NNP-NNPS,NNP,4,1
8702,31117.0,12,Davis,3,2,1,-1,1,10,1,-2,Jo Ann Davis,Representative,PERSON-PERSON-PERSON,TITLE,PROPN-PROPN-PROPN,PROPN,compound-compound-ROOT,compound,NNP-NNP-NNP,NNP,2,1
8703,53332.0,21,Davis,3,2,1,-1,1,19,1,-2,Jo Ann Davis,Representative,PERSON-PERSON-PERSON,TITLE,PROPN-PROPN-PROPN,PROPN,compound-compound-ROOT,compound,NNP-NNP-NNP,NNP,2,1
8704,31124.0,44,said,24,10,1,-9,9,42,14,-23,M Enkhbold,Mongolian People 's Revolutionary Party,PERSON-PERSON,ORGANIZATION-ORGANIZATION-ORGANIZATION-ORGANIZATION-ORGANIZATION,PROPN-PROPN,PROPN-PROPN-PART-PROPN-PROPN,compound-pobj,compound-poss-case-compound-pobj,NNP-NNP,NNP-NNPS-POS-NNP-NNP,6,1
8705,31125.0,5,http://www.christmastree.org/,4,1,5,4,0,-1,3,1,National Christmas Tree Association,http://www.christmastree.org/,ORGANIZATION-ORGANIZATION-ORGANIZATION-ORGANIZATION,URL,PROPN-PROPN-PROPN-PROPN,PUNCT,compound-compound-compound-compound,ROOT,NNP-NNP-NNP-NNP,.,-1,1
8706,31133.0,50,include,1,34,45,11,33,4,-33,44,Gregory Gude,Md.,PERSON-PERSON,STATE_OR_PROVINCE,PROPN-PROPN,PROPN,compound-conj,appos,NNP-NNP,NNP,8,1
8707,31137.0,40,told,34,33,30,-3,32,9,1,-4,Chen Zhu,Chinese,PERSON-PERSON,NATIONALITY,PROPN-PROPN,ADJ,compound-nsubj,amod,NNP-NNP,JJ,2,1
8708,33767.0,19,said,16,15,5,-10,14,13,1,-11,Chen Zhu,Chinese,PERSON-PERSON,NATIONALITY,PROPN-PROPN,PROPN,compound-nsubj,nsubjpass,NNP-NNP,NNPS,4,1
8709,34900.0,31,said,27,26,23,-3,25,7,1,-4,Chen Zhu,Chinese,PERSON-PERSON,NATIONALITY,PROPN-PROPN,ADJ,compound-nsubj,compound,NNP-NNP,JJ,3,1
8710,48306.0,36,told,29,28,25,-3,27,10,1,-4,Chen Zhu,Chinese,PERSON-PERSON,NATIONALITY,PROPN-PROPN,PROPN,compound-nsubj,compound,NNP-NNP,NNP,3,1
8711,31139.0,20,received,1,3,19,16,2,0,-2,18,his,scholar,PERSON,TITLE,DET,NOUN,poss,pobj,PRP$,NN,3,1
8712,31201.0,22,portraying,8,1,5,4,0,16,7,-3,Sean Parker,17-year-old,PERSON-PERSON,DURATION,PROPN-PROPN,NUM,compound-nsubj,compound,NNP-NNP,CD,4,1
8713,31209.0,40,said,16,1,8,7,0,31,15,-8,ConAgra Foods Inc.,Banquet,ORGANIZATION-ORGANIZATION-ORGANIZATION,LOCATION,PROPN-PROPN-PROPN,PROPN,compound-compound-nsubj,dobj,NNP-NNP-NNP,NNP,4,1
8714,31218.0,40,hopes,11,11,39,28,10,0,0,28,AAA,AAAcom,ORGANIZATION,URL,PROPN,PROPN,nsubj,pobj,NNP,NNP,1,1
8715,31230.0,21,established,6,8,1,-7,7,19,-2,-5,the foundation,Barnes,ORGANIZATION-ORGANIZATION,PERSON,DET-NOUN,NOUN,det-dobj,nsubj,DT-NN,NNS,3,1
8716,31238.0,26,is,12,10,20,10,9,5,2,8,Scorpions,NPA,ORGANIZATION,ORGANIZATION,PROPN,PROPN,oprd,pobj,NNPS,NNP,6,1
8717,64958.0,21,are,2,2,9,7,1,11,0,7,Scorpions,NPA,ORGANIZATION,ORGANIZATION,PROPN,PROPN,nsubj,pobj,NNPS,NNP,3,1
8718,31242.0,60,survived,2,21,11,-10,20,48,-19,9,Robert E. Jr.,Josephine Robinson McNair,PERSON-PERSON-PERSON,PERSON-PERSON-PERSON,PROPN-PROPN-PROPN,PROPN-PROPN-PROPN,compound-compound-appos,compound-compound-appos,NNP-NNP-NNP,NNP-NNP-NNP,4,1
8719,31252.0,15,formed,3,8,6,-2,7,8,-5,3,Patterson Energy,2001,ORGANIZATION-ORGANIZATION,DATE,PROPN-PROPN,NUM,compound-poss,pobj,NNP-NNP,CD,2,1
8720,31258.0,41,Command,3,2,5,3,1,35,1,2,Army Medical Command,http://wwwarmymedicinearmymil,ORGANIZATION-ORGANIZATION-ORGANIZATION,URL,PROPN-PROPN-PROPN,PUNCT,compound-compound-ROOT,punct,NNP-NNP-NNP,:,4,1
8721,31269.0,23,wrote,7,16,15,-1,15,7,-9,8,Beverly Sills,singer,PERSON-PERSON,TITLE,PROPN-PROPN,NOUN,compound-pobj,compound,NNP-NNP,NN,1,1
8722,31276.0,15,is,1,1,6,5,0,8,0,5,He,Harvard Law School,PERSON,ORGANIZATION-ORGANIZATION-ORGANIZATION,PRON,PROPN-PROPN-PROPN,nsubj,compound-compound-pobj,PRP,NNP-NNP-NNP,4,1
8723,31277.0,25,left,2,8,15,7,7,9,-6,13,her,Brooklyn,PERSON,CITY,DET,PROPN,poss,compound,PRP$,NNP,2,1
8724,42757.0,38,put,3,2,29,27,1,8,1,26,her,Brooklyn,PERSON,CITY,DET,PROPN,poss,pobj,PRP$,NNP,8,1
8725,31282.0,42,responded,16,1,7,6,0,34,15,-9,Robert McNair,Carolina,PERSON-PERSON,STATE_OR_PROVINCE,PROPN-PROPN,PROPN,compound-nsubj,pobj,NNP-NNP,NNP,1,1
8726,31284.0,32,said,12,8,11,3,7,20,4,-1,IMF,Shakour Shaalan,ORGANIZATION,PERSON-PERSON,PROPN,PROPN-PROPN,compound,compound-nsubj,NNP,NNP-NNP,3,1
8727,31286.0,21,describes,9,7,6,-1,6,14,2,-3,Paul Watson,Canadian,PERSON-PERSON,NATIONALITY,PROPN-PROPN,ADJ,compound-pobj,compound,NNP-NNP,JJ,1,1
8728,31292.0,30,called,17,3,2,-1,2,27,14,-15,American Beverage Association,Washington-based,ORGANIZATION-ORGANIZATION-ORGANIZATION,STATE_OR_PROVINCE,PROPN-PROPN-PROPN,ADJ,compound-compound-nsubj,amod,NNP-NNP-NNP,JJ,1,1
8729,31314.0,62,was,29,11,16,5,10,45,18,-13,Farland,agent,PERSON,TITLE,PROPN,NOUN,nsubj,appos,NNP,NN,3,1
8730,31337.0,20,'s,1,18,16,-2,17,3,-17,15,Jerry Robbins,director-choreographer,PERSON-PERSON,TITLE,PROPN-PROPN,NOUN,compound-conj,amod,NNP-NNP,NN,2,1
8731,31340.0,41,trying,11,3,8,5,2,32,8,-3,Jamie,Lynne Spears,PERSON,PERSON-PERSON,PROPN,PROPN-PROPN,compound,compound-appos,NNP,NNP-NNP,2,1
8732,31354.0,47,survived,2,1,29,28,0,17,1,27,Henebry,Mary Henebry,PERSON,PERSON-PERSON,NOUN,PROPN-PROPN,nsubjpass,compound-appos,NN,NNP-NNP,4,1
8733,31356.0,27,taught,8,8,12,4,7,14,0,4,he,New Iberia,PERSON,CITY-CITY,PRON,PROPN-PROPN,nsubj,compound-pobj,PRP,NNP-NNP,2,1
8734,31362.0,32,says,19,15,1,-14,14,30,4,-18,Paralyzed Veterans of America,Ben Ritter,ORGANIZATION-ORGANIZATION-ORGANIZATION-ORGANIZATION,PERSON-PERSON,PROPN-PROPN-ADP-PROPN,PROPN-PROPN,compound-pobj-prep-pobj,compound-nsubj,NNP-NNPS-IN-NNP,NNP-NNP,5,1
8735,31367.0,24,left,1,3,21,18,2,2,-2,20,her,Live Nation Inc.,PERSON,ORGANIZATION-ORGANIZATION-ORGANIZATION,DET,PROPN-PROPN-PROPN,poss,compound-compound-pobj,PRP$,NNP-NNP-NNP,6,1
8736,31369.0,48,said,17,1,8,7,0,39,16,-9,Paul Manuel,New Hampshire Institute of Politics,ORGANIZATION-ORGANIZATION,PERSON-PERSON-PERSON-PERSON-PERSON,PROPN-PROPN,PROPN-PROPN-PROPN-ADP-PROPN,compound-nsubj,compound-compound-pobj-prep-pobj,NNP-NNP,NNP-NNP-NNP-IN-NNP,4,1
8737,31371.0,54,formed,3,10,6,-4,9,47,-7,3,NAN,National Action Network,ORGANIZATION,ORGANIZATION-ORGANIZATION-ORGANIZATION,PROPN,PROPN-PROPN-PROPN,compound,compound-compound-dobj,NNP,NNP-NNP-NNP,3,1
8738,31389.0,22,said,14,8,13,5,7,8,6,-1,his,Ariz.,PERSON,STATE_OR_PROVINCE,DET,PROPN,poss,appos,PRP$,NNP,4,1
8739,54512.0,22,said,14,8,13,5,7,8,6,-1,his,Ariz.,PERSON,STATE_OR_PROVINCE,DET,PROPN,poss,appos,PRP$,NNP,4,1
8740,31396.0,42,elevated,17,5,34,29,4,7,12,17,Fidelity,Rodger A. Lawson,ORGANIZATION,PERSON-PERSON-PERSON,PROPN,PROPN-PROPN-PROPN,nsubj,compound-compound-appos,NNP,NNP-NNP-NNP,4,1
8741,31397.0,28,said,10,7,1,-6,6,26,3,-9,Fidelity Investor,James Lowell,ORGANIZATION-ORGANIZATION,PERSON-PERSON,PROPN-PROPN,PROPN-PROPN,compound-compound,compound-nsubj,NNP-NNP,NNP-NNP,3,1
8742,31401.0,31,found,5,1,3,2,0,27,4,-2,Hamilton,22,PERSON,NUMBER,PROPN,NUM,nsubj,appos,NNP,CD,4,1
8743,62121.0,36,taken,5,1,3,2,0,32,4,-2,Hamilton,22,PERSON,NUMBER,PROPN,NUM,nsubj,appos,NNP,CD,3,1
8744,31419.0,18,Rumour,0,3,9,6,2,8,-3,9,Adam,Magic City Memoirs,PERSON,ORGANIZATION-ORGANIZATION-ORGANIZATION,PROPN,PROPN-PROPN-PROPN,nsubj,compound-compound-appos,NNP,NNP-NNP-NNPS,5,1
8745,31435.0,33,SEOUL,0,12,3,-9,11,29,-12,3,Samsung Group,South Korea,ORGANIZATION-ORGANIZATION,COUNTRY-COUNTRY,PROPN-PROPN,PROPN-PROPN,compound-pobj,compound-npadvmod,NNP-NNP,NNP-NNP,5,1
8746,31441.0,30,received,2,1,23,22,0,6,1,21,He,Johns Hopkins School,PERSON,ORGANIZATION-ORGANIZATION-ORGANIZATION,PRON,PROPN-PROPN-PROPN,nsubj,compound-compound-pobj,PRP,NNP-NNP-NNP,10,1
8747,31456.0,47,announced,13,31,26,-5,30,20,-18,13,Mainland Affairs Council,Su Chi,ORGANIZATION-ORGANIZATION-ORGANIZATION,PERSON-PERSON,PROPN-PROPN-PROPN,PROPN-PROPN,compound-compound-compound,compound-pobj,NNP-NNPS-NNP,NNP-NNP,3,1
8748,31468.0,19,was,9,13,11,-2,12,7,-4,2,her,12,PERSON,NUMBER,DET,NUM,poss,attr,PRP$,CD,2,1
8749,31474.0,41,set,6,20,37,17,19,3,-14,31,China National Aviation Corporation,Air China,ORGANIZATION-ORGANIZATION-ORGANIZATION-ORGANIZATION,LOCATION-LOCATION,PROPN-PROPN-PROPN-PROPN,PROPN-PROPN,compound-compound-compound-pobj,compound-poss,NNP-NNP-NNP-NNP,NNP-NNP,8,1
8750,31481.0,20,said,18,17,3,-14,16,16,1,-15,her,Rep.,PERSON,TITLE,DET,PROPN,poss,compound,PRP$,NNP,4,1
8751,33825.0,47,likes,13,16,1,-15,15,45,-3,-12,her,Rep.,PERSON,TITLE,DET,PROPN,poss,compound,PRP$,NNP,3,1
8752,60457.0,47,likes,13,16,1,-15,15,45,-3,-12,her,Rep.,PERSON,TITLE,DET,PROPN,poss,compound,PRP$,NNP,3,1
8753,31509.0,45,basked,1,43,30,-13,42,14,-42,29,Chris Dodd,senator,PERSON-PERSON,TITLE,PROPN-PROPN,NOUN,compound-dobj,compound,NNP-NNP,NN,4,1
8754,31542.0,64,LUANDA,0,50,59,9,49,4,-50,59,National Union of the Total Independence of Angola,UNITA,ORGANIZATION-ORGANIZATION-ORGANIZATION-ORGANIZATION-ORGANIZATION-ORGANIZATION-ORGANIZATION-ORGANIZATION,ORGANIZATION,PROPN-PROPN-ADP-DET-PROPN-PROPN-ADP-PROPN,PROPN,compound-appos-prep-det-compound-pobj-prep-pobj,compound,NNP-NNP-IN-DT-NNP-NNP-IN-NNP,NNP,9,1
8755,31557.0,32,was,21,12,21,9,11,10,9,0,her,Pratt,PERSON,PERSON,DET,PROPN,poss,nsubj,PRP$,NNP,3,1
8756,31572.0,33,been,20,7,2,-5,6,30,13,-18,his,Prince,PERSON,TITLE,DET,PROPN,poss,compound,PRP$,NNP,3,1
8757,31615.0,26,started,12,7,10,3,6,15,5,-2,her,Robert Goodman,PERSON,PERSON-PERSON,DET,PROPN-PROPN,poss,compound-appos,PRP$,NNP-NNP,1,1
8758,31627.0,31,'m,1,11,9,-2,10,21,-10,8,Carolyn Maloney,Representative,PERSON-PERSON,TITLE,PROPN-PROPN,PROPN,compound-npadvmod,pobj,NNP-NNP,NNP,2,1
8759,38886.0,21,praised,16,3,2,-1,2,18,13,-14,Carolyn Maloney,Representative,PERSON-PERSON,TITLE,PROPN-PROPN,PROPN,compound-nsubj,compound,NNP-NNP,NNP,1,1
8760,54367.0,32,released,5,4,3,-1,3,28,1,-2,Carolyn Maloney,Representative,PERSON-PERSON,TITLE,PROPN-PROPN,PROPN,compound-nsubj,compound,NNP-NNP,NNP,1,1
8761,61628.0,29,said,23,27,26,-1,26,2,-4,3,Carolyn Maloney,Representative,PERSON-PERSON,TITLE,PROPN-PROPN,PROPN,compound-nsubj,compound,NNP-NNP,NNP,2,1
8762,62659.0,58,DENVER,0,34,33,-1,33,24,-34,33,Carolyn Maloney,Representative,PERSON-PERSON,TITLE,PROPN-PROPN,PROPN,compound-pobj,compound,NNP-NNP,NNP,1,1
8763,31635.0,37,2007-08-17T16,0,7,3,-4,6,33,-7,3,Carolyn Goodman,2007-08-17T15,PERSON-PERSON,DATE,PROPN-PROPN,NUM,compound-nsubj,ROOT,NNP-NNP,CD,2,1
8764,31642.0,36,come,2,7,13,6,6,22,-5,11,Mohamed ElBaradei,UN International Atomic Energy Agency,PERSON-PERSON,ORGANIZATION-ORGANIZATION-ORGANIZATION-ORGANIZATION-ORGANIZATION,PROPN-PROPN,PROPN-PROPN-PROPN-PROPN-PROPN,compound-nsubj,compound-compound-compound-compound-pobj,NNP-NNP,NNP-NNP-NNP-NNP-NNP,5,1
8765,58129.0,50,said,48,47,41,-6,46,8,1,-7,Mohamed ElBaradei,UN International Atomic Energy Agency,PERSON-PERSON,ORGANIZATION-ORGANIZATION-ORGANIZATION-ORGANIZATION-ORGANIZATION,PROPN-PROPN,PROPN-PROPN-PROPN-PROPN-PROPN,compound-nsubj,compound-compound-compound-compound-compound,NNP-NNP,NNP-NNP-NNP-NNP-NNP,4,1
8766,31652.0,36,said,8,5,1,-4,4,34,3,-7,SAC,Wu Lung-shan,ORGANIZATION,PERSON-PERSON,PROPN,PROPN-PROPN,compound,compound-nsubj,NNP,NNP-NNP,3,1
8767,31654.0,51,said,26,36,40,4,35,10,-10,14,American Automobile Association,Foundation for Traffic Safety,ORGANIZATION-ORGANIZATION-ORGANIZATION,ORGANIZATION-ORGANIZATION-ORGANIZATION-ORGANIZATION,PROPN-PROPN-PROPN,PROPN-ADP-PROPN-PROPN,compound-compound-poss,pobj-prep-compound-pobj,NNP-NNP-NNP,NNP-IN-NNP-NNP,2,1
8768,31663.0,17,schedule,5,15,1,-14,14,15,-10,-4,her,Virginia,PERSON,STATE_OR_PROVINCE,DET,PROPN,poss,compound,PRP$,NNP,6,1
8769,31664.0,38,said,36,9,15,6,8,22,27,-21,GMAC,Residential Capital LLC,ORGANIZATION,STATE_OR_PROVINCE-STATE_OR_PROVINCE-STATE_OR_PROVINCE,PROPN,PROPN-PROPN-PROPN,poss,compound-compound-appos,NNP,NNP-NNP-NNP,4,1
8770,31666.0,7,plans,3,2,1,-1,1,5,1,-2,Remy Ma,Rapper,PERSON-PERSON,TITLE,PROPN-PROPN,PROPN,compound-nsubj,compound,NNP-NNP,NNP,1,1
8771,31682.0,44,seen,4,37,13,-24,36,30,-33,9,Sean Preston,Jayden James,PERSON-PERSON,PERSON-PERSON,PROPN-PROPN,PROPN-PROPN,compound-appos,compound-compound,NNP-NNP,NNP-NNP,10,1
8772,58472.0,27,arrives,7,13,16,3,12,10,-6,9,Sean Preston,Jayden James,PERSON-PERSON,PERSON-PERSON,PROPN-PROPN,PROPN-PROPN,compound-dobj,compound-conj,NNP-NNP,NNP-NNP,2,1
8773,31698.0,32,has,6,2,17,15,1,14,4,11,Paul Gillmor,Columbus,PERSON-PERSON,CITY,PROPN-PROPN,PROPN,compound-nsubj,nmod,NNP-NNP,NNP,3,1
8774,31703.0,23,died,14,2,22,20,1,0,12,8,Carolyn Goodman,91,PERSON-PERSON,NUMBER,PROPN-PROPN,NUM,compound-nsubj,pobj,NNP-NNP,CD,2,1
8775,40530.0,10,Dies,7,2,10,8,1,-1,5,3,Carolyn Goodman,91,PERSON-PERSON,NUMBER,PROPN-PROPN,NUM,compound-nsubj,pobj,NNP-NNP,CD,-1,1
8776,50047.0,14,dies,13,1,4,3,0,9,12,-9,Carolyn Goodman,91,PERSON-PERSON,NUMBER,PROPN-PROPN,NUM,compound-nsubj,appos,NNP-NNP,CD,1,1
8777,51365.0,8,Goodman,2,2,8,6,1,-1,0,6,Carolyn Goodman,91,PERSON-PERSON,NUMBER,PROPN-PROPN,NUM,compound-ROOT,appos,NNP-NNP,CD,-1,1
8778,64521.0,37,2007-08-17T16,0,7,10,3,6,26,-7,10,Carolyn Goodman,91,PERSON-PERSON,NUMBER,PROPN-PROPN,NUM,compound-nsubj,appos,NNP-NNP,CD,1,1
8779,31721.0,26,applied,12,12,10,-2,11,15,0,-2,she,Yale,PERSON,ORGANIZATION,PRON,PROPN,nsubj,pobj,PRP,NNP,1,1
8780,31724.0,13,was,1,1,11,10,0,1,0,10,He,Yale University,PERSON,ORGANIZATION-ORGANIZATION,PRON,PROPN-PROPN,nsubj,compound-conj,PRP,NNP-NNP,3,1
8781,31728.0,43,ANGELES,1,10,14,4,9,28,-9,13,Yolanda King,Los Angeles,PERSON-PERSON,CITY-CITY,PROPN-PROPN,PROPN-PROPN,compound-nsubj,compound-pobj,NNP-NNP,NNP-NNP,3,1
8782,31731.0,56,died,36,2,48,46,1,7,34,12,Jefferson J. DeBlanc Sr.,Lafayette,PERSON-PERSON-PERSON-PERSON,CITY,PROPN-PROPN-PROPN-PROPN,PROPN,compound-compound-compound-nsubj,pobj,NNP-NNP-NNP-NNP,NNP,-1,1
8783,31735.0,13,elected,3,7,1,-6,6,11,-4,-2,Massachusetts House of Representatives,Smith,ORGANIZATION-ORGANIZATION-ORGANIZATION-ORGANIZATION,PERSON,PROPN-PROPN-ADP-PROPN,PROPN,compound-pobj-prep-pobj,nsubjpass,NNP-NNP-IN-NNPS,NNP,3,1
8784,31773.0,23,trumped,5,10,8,-2,9,14,-5,3,Illinois Tool Works,US,ORGANIZATION-ORGANIZATION-ORGANIZATION,COUNTRY,PROPN-PROPN-VERB,PROPN,compound-compound-dobj,compound,NNP-NNP-VBZ,NNP,2,1
8785,32329.0,27,LONDON,0,14,12,-2,13,14,-14,12,Illinois Tool Works,US,ORGANIZATION-ORGANIZATION-ORGANIZATION,COUNTRY,PROPN-PROPN-VERB,PROPN,compound-compound-dobj,compound,NNP-NNP-VBZ,NNP,4,1
8786,31777.0,27,says,21,19,1,-18,18,25,2,-20,Fidelity Investments,Bernard S. Donefer,ORGANIZATION-ORGANIZATION,PERSON-PERSON-PERSON,PROPN-PROPN,PROPN-PROPN-PROPN,compound-pobj,compound-compound-nsubj,NNP-NNP,NNP-NNP-NNP,4,1
8787,31778.0,55,said,50,9,1,-8,8,53,41,-49,Aerolineas Argentinas,Spain,ORGANIZATION-ORGANIZATION,COUNTRY,PROPN-PROPN,PROPN,compound-dobj,poss,NNP-NNP,NNP,4,1
8788,51043.0,32,see,20,26,5,-21,25,26,-6,-15,Aerolineas Argentinas,Spain,ORGANIZATION-ORGANIZATION,COUNTRY,PROPN-PROPN,PROPN,compound-poss,poss,NNP-NNP,NNP,8,1
8789,68031.0,54,is,3,33,22,-11,32,31,-30,19,Aerolineas Argentinas,Spain,ORGANIZATION-ORGANIZATION,COUNTRY,PROPN-PROPN,PROPN,compound-compound,poss,NNP-NNP,NNP,12,1
8790,31792.0,21,lived,9,8,5,-3,7,15,1,-4,she,Navy,PERSON,ORGANIZATION,PRON,PROPN,nsubj,compound,PRP,NNP,5,1
8791,31813.0,27,worked,8,12,5,-7,11,21,-4,-3,Federal Aviation Administration,Weld,ORGANIZATION-ORGANIZATION-ORGANIZATION,PERSON,PROPN-PROPN-PROPN,PROPN,compound-compound-pobj,conj,NNP-NNP-NNP,NNP,8,1
8792,31816.0,52,said,10,23,51,28,22,0,-13,41,his,Taiwan,PERSON,COUNTRY,DET,PROPN,poss,pobj,PRP$,NNP,7,1
8793,31821.0,20,say,8,16,3,-13,15,16,-8,-5,Kurt Waldheim,Austria,PERSON-PERSON,COUNTRY,PROPN-PROPN,PROPN,compound-nsubj,nmod,NNP-NNP,NNP,6,1
8794,49236.0,38,brought,22,6,9,3,5,28,16,-13,Kurt Waldheim,Austria,PERSON-PERSON,COUNTRY,PROPN-PROPN,PROPN,compound-pobj,pobj,NNP-NNP,NNP,1,1
8795,50870.0,25,inaugurated,5,3,8,5,2,16,2,3,Kurt Waldheim,Austria,PERSON-PERSON,COUNTRY,PROPN-PROPN,PROPN,compound-nsubjpass,poss,NNP-NNP,NNP,5,1
8796,31830.0,25,married,1,19,10,-9,18,14,-18,9,David,Marita,PERSON,PERSON,PROPN,PROPN,pobj,appos,NNP,NNP,4,1
8797,31842.0,19,is,9,7,18,11,6,0,2,9,Federal Aviation Administration,Washington,ORGANIZATION-ORGANIZATION-ORGANIZATION,STATE_OR_PROVINCE,PROPN-PROPN-PROPN,PROPN,compound-compound-pobj,pobj,NNP-NNP-NNP,NNP,6,1
8798,37724.0,32,said,7,5,2,-3,4,29,2,-5,Federal Aviation Administration,Washington,ORGANIZATION-ORGANIZATION-ORGANIZATION,STATE_OR_PROVINCE,PROPN-PROPN-PROPN,PROPN,compound-compound-nsubj,pobj,NNP-NNP-NNP,NNP,3,1
8799,31847.0,9,Dead,6,5,2,-3,4,6,1,-4,Vernon Bellecourt Dead,American,PERSON-PERSON-PERSON,NATIONALITY,PROPN-PROPN-PROPN,PROPN,compound-compound-ROOT,compound,NNP-NNP-NNP,NNP,3,1
8800,31852.0,27,said,25,11,22,11,10,4,14,-3,North Phoenix Baptist Church,Christian,ORGANIZATION-ORGANIZATION-ORGANIZATION-ORGANIZATION,RELIGION,PROPN-PROPN-PROPN-PROPN,PROPN,compound-compound-compound-dobj,attr,NNP-NNP-NNP-NNP,NNP,5,1
8801,31862.0,42,said,37,1,3,2,0,38,36,-34,ADB,Board of Directors,ORGANIZATION,ORGANIZATION-ORGANIZATION-ORGANIZATION,PROPN,PROPN-ADP-PROPN,poss,nsubj-prep-pobj,NNP,NNP-IN-NNPS,3,1
8802,31868.0,48,said,1,1,47,46,0,0,0,46,McAllister,governor,PERSON,TITLE,PROPN,NOUN,nsubj,pobj,NNP,NN,1,1
8803,46759.0,62,raised,9,59,18,-41,58,43,-50,9,McAllister,governor,PERSON,TITLE,PROPN,NOUN,nsubj,pobj,NNP,NN,-1,1
8804,31875.0,35,said,14,16,27,11,15,7,-2,13,Bond,American University,PERSON,ORGANIZATION-ORGANIZATION,PROPN,PROPN-PROPN,nsubj,compound-conj,NNP,NNP-NNP,5,1
8805,31878.0,6,research,3,1,6,5,0,-1,2,3,American Beverage Association,http://www.schoolbeverages.com,ORGANIZATION-ORGANIZATION-ORGANIZATION,URL,PROPN-PROPN-PROPN,X,compound-compound-compound,appos,NNP-NNP-NNP,ADD,-1,1
8806,31889.0,15,revolutionized,10,9,7,-2,8,7,1,-3,Art Buchwald,humor columnist,PERSON-PERSON,TITLE-TITLE,PROPN-PROPN,NOUN-NOUN,compound-nsubj,compound-compound,NNP-NNP,NN-NN,1,1
8807,31907.0,56,include,1,10,24,14,9,31,-9,23,Verity,William Wymond Verity,PERSON,PERSON-PERSON-PERSON,PROPN,PROPN-PROPN-PROPN,compound,compound-compound-conj,NNP,NNP-NNP-NNP,7,1
8808,31913.0,25,said,12,20,14,-6,19,10,-8,2,Metro Atlanta Chamber of Commerce,Sam Williams,ORGANIZATION-ORGANIZATION-ORGANIZATION-ORGANIZATION-ORGANIZATION,PERSON-PERSON,PROPN-PROPN-PROPN-ADP-PROPN,PROPN-PROPN,compound-compound-pobj-prep-pobj,compound-nsubj,NNP-NNP-NNP-IN-NNP,NNP-NNP,5,1
8809,42463.0,31,said,18,26,20,-6,25,10,-8,2,Metro Atlanta Chamber of Commerce,Sam Williams,ORGANIZATION-ORGANIZATION-ORGANIZATION-ORGANIZATION-ORGANIZATION,PERSON-PERSON,PROPN-PROPN-PROPN-ADP-PROPN,PROPN-PROPN,compound-compound-pobj-prep-pobj,compound-nsubj,NNP-NNP-NNP-IN-NNP,NNP-NNP,5,1
8810,48063.0,40,lobbied,12,4,10,6,3,29,8,-2,Metro Atlanta Chamber of Commerce,Sam Williams,ORGANIZATION-ORGANIZATION-ORGANIZATION-ORGANIZATION-ORGANIZATION,PERSON-PERSON,PROPN-PROPN-PROPN-ADP-PROPN,PROPN-PROPN,nmod-nmod-nmod-prep-pobj,compound-pobj,NNP-NNP-NNP-IN-NNP,NNP-NNP,5,1
8811,31914.0,35,said,6,8,27,19,7,7,-2,21,Remy Ma,United States,PERSON-PERSON,COUNTRY-COUNTRY,PROPN-PROPN,PROPN-PROPN,compound-nsubj,compound-dobj,NNP-NNP,NNP-NNP,4,1
8812,63502.0,38,said,14,2,30,28,1,7,12,16,Remy Ma,United States,PERSON-PERSON,COUNTRY-COUNTRY,PROPN-PROPN,PROPN-PROPN,compound-poss,compound-dobj,NNP-NNP,NNP-NNP,5,1
8813,31933.0,20,said,11,19,13,-6,18,6,-8,2,chamber,Sam Williams,ORGANIZATION,PERSON-PERSON,NOUN,PROPN-PROPN,pobj,compound-nsubj,NN,NNP-NNP,4,1
8814,31943.0,32,said,5,4,3,-1,3,28,1,-2,MF Global,Bermuda-based,ORGANIZATION-ORGANIZATION,COUNTRY,PROPN-PROPN,ADJ,compound-nsubj,amod,NNP-NNP,JJ,1,1
8815,31948.0,66,comes,2,47,52,5,46,13,-45,50,Donald Wildmon,minister,PERSON-PERSON,TITLE,PROPN-PROPN,NOUN,compound-pobj,appos,NNP-NNP,NN,2,1
8816,63398.0,22,is,7,15,14,-1,14,7,-8,7,Donald Wildmon,minister,PERSON-PERSON,TITLE,PROPN-PROPN,NOUN,compound-appos,pobj,NNP-NNP,NN,1,1
8817,31949.0,23,survived,17,5,4,-1,4,18,12,-13,Roy Scheider,star,PERSON-PERSON,TITLE,PROPN-PROPN,NOUN,compound-nsubj,compound,NNP-NNP,NN,1,1
8818,64289.0,12,Oscar-nominated,0,6,5,-1,5,6,-6,5,Roy Scheider,star,PERSON-PERSON,TITLE,PROPN-PROPN,NOUN,compound-nsubjpass,compound,NNP-NNP,NN,1,1
8819,31955.0,61,announced,5,25,2,-23,24,58,-20,-3,ConAgra Foods,Commodity Futures Trading Commission,ORGANIZATION-ORGANIZATION,ORGANIZATION-ORGANIZATION-ORGANIZATION-ORGANIZATION,PROPN-PROPN,PROPN-PROPN-PROPN-PROPN,compound-pobj,compound-compound-compound-nsubj,NNP-NNP,NNP-NNPS-NNP-NNP,11,1
8820,31957.0,12,died,8,1,5,4,0,6,7,-3,Rothman,Alvin H. Rothman,PERSON,PERSON-PERSON-PERSON,PROPN,PROPN-PROPN-PROPN,poss,compound-compound-appos,NNP,NNP-NNP-NNP,4,1
8821,48618.0,13,died,9,2,6,4,1,6,7,-3,Rothman,Alvin H. Rothman,PERSON,PERSON-PERSON-PERSON,PROPN,PROPN-PROPN-PROPN,poss,compound-compound-appos,NNP,NNP-NNP-NNP,4,1
8822,31962.0,29,reported,24,16,1,-15,15,27,8,-23,Itochu Corp.,Kan,ORGANIZATION-ORGANIZATION,PERSON,PROPN-PROPN,PROPN,compound-pobj,nsubjpass,NNP-NNP,NNP,6,1
8823,31963.0,37,said,19,26,34,8,25,2,-7,15,Royal Caribbean,Azamara,ORGANIZATION-ORGANIZATION,ORGANIZATION,PROPN-PROPN,PROPN,compound-pobj,conj,NNP-NNP,NNP,5,1
8824,46005.0,26,includes,8,5,22,17,4,3,3,14,Royal Caribbean,Azamara,ORGANIZATION-ORGANIZATION,ORGANIZATION,PROPN-PROPN,PROPN,compound-poss,conj,NNP-NNP,NNP,11,1
8825,31966.0,35,moved,24,24,28,4,23,6,0,4,he,Glendale,PERSON,CITY,PRON,PROPN,nsubj,pobj,PRP,NNP,1,1
8826,31967.0,32,confirmed,29,4,3,-1,3,28,25,-26,Parren J. Mitchell,Rep.,PERSON-PERSON-PERSON,TITLE,PROPN-PROPN-PROPN,PROPN,compound-compound-nsubj,compound,NNP-NNP-NNP,NNP,2,1
8827,31974.0,75,said,27,1,8,7,0,66,26,-19,"IMF director for Africa , who is leading an IMF",Cyrille Briancon,ORGANIZATION-ORGANIZATION-ORGANIZATION-ORGANIZATION-ORGANIZATION-ORGANIZATION-ORGANIZATION-ORGANIZATION-ORGANIZATION-ORGANIZATION,PERSON-PERSON,PROPN-NOUN-ADP-PROPN-PUNCT-PRON-VERB-VERB-DET-PROPN,PROPN-PROPN,compound-appos-prep-pobj-punct-nsubj-aux-relcl-det-compound,compound-appos,"NNP-NN-IN-NNP-,-WP-VBZ-VBG-DT-NNP",NNP-NNP,3,1
8828,31978.0,9,Insider,2,6,9,3,5,-1,-4,7,CMA Nominee Report,http://www.cmt.com/shows/dyn/cmt_insider/144806/episode.jhtml,ORGANIZATION-ORGANIZATION-ORGANIZATION,URL,PROPN-PROPN-PROPN,PUNCT,compound-compound-appos,appos,NNP-NNP-NNP,.,-1,1
8829,31996.0,32,said,29,10,13,3,9,18,19,-16,Yolanda King,the first family of the United States ' civil rights movement,PERSON-PERSON,PERSON-PERSON-PERSON-PERSON-PERSON-PERSON-PERSON-PERSON-PERSON-PERSON-PERSON,PROPN-PROPN,DET-ADJ-NOUN-ADP-DET-PROPN-PROPN-PART-ADJ-NOUN-NOUN,compound-pobj,det-amod-pobj-prep-det-compound-poss-case-amod-compound-pobj,NNP-NNP,DT-JJ-NN-IN-DT-NNP-NNP-POS-JJ-NNS-NN,2,1
8830,31998.0,62,Dies,9,1,36,35,0,25,8,27,Roy Scheider,Maximillia Connelly Lord,PERSON-PERSON,PERSON-PERSON-PERSON,PROPN-PROPN,PROPN-ADV-PROPN,compound-nsubj,compound-compound-conj,NNP-NNP,NNP-RB-NNP,4,1
8831,31999.0,25,credited,9,7,17,10,6,7,2,8,Juanita Millender-McDonald,African American,PERSON-PERSON,NATIONALITY-NATIONALITY,PROPN-PROPN,PROPN-PROPN,compound-pobj,amod-attr,NNP-NNP,NNP-NNP,9,1
8832,32006.0,32,Jordan,3,8,7,-1,7,24,-5,4,Opera National de Paris,Paris,ORGANIZATION-ORGANIZATION-ORGANIZATION-ORGANIZATION,CITY,PROPN-PROPN-PROPN-PROPN,PROPN,compound-compound-compound-pobj,dobj,NNP-NNP-NNP-NNP,NNP,2,1
8833,32007.0,30,persevered,20,15,25,10,14,4,5,5,her,Yale Law School,PERSON,ORGANIZATION-ORGANIZATION-ORGANIZATION,DET,PROPN-PROPN-PROPN,poss,compound-compound-pobj,PRP$,NNP-NNP-NNP,7,1
8834,32019.0,61,attended,3,29,27,-2,28,33,-26,24,Paul Kim,Vanteus Academy,PERSON-PERSON,ORGANIZATION-ORGANIZATION,PROPN-PROPN,PROPN-PROPN,compound-appos,compound-compound,NNP-NNP,NNP-NNP,3,1
8835,32025.0,45,sent,3,12,15,3,11,29,-9,12,National Red Cross,Yoo Chong-ha,ORGANIZATION-ORGANIZATION-ORGANIZATION,PERSON-PERSON,PROPN-PROPN-PROPN,PROPN-PROPN,compound-compound-compound,compound-pobj,NNP-NNP-NNP,NNP-NNP,4,1
8836,37020.0,44,sent,2,11,14,3,10,29,-9,12,National Red Cross,Yoo Chong-ha,ORGANIZATION-ORGANIZATION-ORGANIZATION,PERSON-PERSON,PROPN-PROPN-PROPN,PROPN-PROPN,compound-compound-compound,compound-pobj,NNP-NNP-NNP,NNP-NNP,4,1
8837,32027.0,33,said,20,28,22,-6,27,10,-8,2,Department of Conservation and Recreation,Richard Sullivan,ORGANIZATION-ORGANIZATION-ORGANIZATION-ORGANIZATION-ORGANIZATION,PERSON-PERSON,PROPN-ADP-PROPN-CCONJ-PROPN,PROPN-PROPN,pobj-prep-pobj-cc-conj,compound-nsubj,NNP-IN-NNP-CC-NNP,NNP-NNP,4,1
8838,32043.0,23,earned,9,19,8,-11,18,14,-10,-1,servant,48-year-old,PERSON,NUMBER,NOUN,NOUN,pobj,nsubj,NN,NN,8,1
8839,32051.0,91,contacted,3,45,9,-36,44,81,-42,6,he,46-year-old,PERSON,DURATION,PRON,NUM,nsubj,compound,PRP,CD,9,1
8840,32076.0,41,helped,5,1,25,24,0,15,4,20,His,National Association for the Advancement of Colored People,PERSON,ORGANIZATION-ORGANIZATION-ORGANIZATION-ORGANIZATION-ORGANIZATION-ORGANIZATION-ORGANIZATION-ORGANIZATION,DET,PROPN-PROPN-ADP-DET-PROPN-ADP-PROPN-PROPN,poss,compound-pobj-prep-det-pobj-prep-compound-pobj,PRP$,NNP-NNP-IN-DT-NNP-IN-NNP-NNPS,5,1
8841,32082.0,41,said,1,29,18,-11,28,22,-28,17,he,Darfur,PERSON,LOCATION,PRON,PROPN,nsubj,pobj,PRP,NNP,10,1
8842,32087.0,44,said,9,43,22,-21,42,21,-34,13,FEC,Spakovsky,ORGANIZATION,PERSON,PROPN,PROPN,pobj,poss,NNP,NNP,10,1
8843,32093.0,33,ruled,3,21,11,-10,20,21,-18,8,Fyffes,Jim Flavin,ORGANIZATION,PERSON-PERSON,PROPN,PROPN-PROPN,amod,compound-nsubj,NNP,NNP-NNP,5,1
8844,60130.0,44,ruled,3,22,12,-10,21,31,-19,9,Fyffes,Jim Flavin,ORGANIZATION,PERSON-PERSON,PROPN,PROPN-PROPN,compound,compound-appos,NNP,NNP-NNP,6,1
8845,32117.0,23,appears,3,1,6,5,0,16,2,3,Kate Gosselin,ABC,PERSON-PERSON,ORGANIZATION,PROPN-PROPN,PROPN,compound-nsubj,poss,NNP-NNP,NNP,5,1
8846,32129.0,6,is,3,2,5,3,1,0,1,2,Johnny Knoxville,37,PERSON-PERSON,NUMBER,PROPN-PROPN,NUM,compound-nsubj,attr,NNP-NNP,CD,2,1
8847,32135.0,34,delayed,8,5,7,2,4,26,3,-1,Sox,Tim Wakefield,ORGANIZATION,PERSON-PERSON,PROPN,PROPN-PROPN,compound,compound-nsubj,NNP,NNP-NNP,2,1
8848,32136.0,39,outlined,14,9,11,2,8,27,5,-3,ConAgra,Gary M Rodkin,ORGANIZATION,PERSON-PERSON-PERSON,PROPN,PROPN-PROPN-PROPN,pobj,compound-compound-appos,NNP,NNP-NNP-NNP,3,1
8849,32146.0,41,told,6,2,5,3,1,35,4,-1,Barbara Boxer,D-Calif.,PERSON-PERSON,LOCATION,PROPN-PROPN,PROPN,compound-nsubj,appos,NNP-NNP,NNP,1,1
8850,39305.0,29,said,11,14,17,3,13,11,-3,6,Barbara Boxer,D-Calif.,PERSON-PERSON,LOCATION,PROPN-PROPN,PROPN,compound-nsubj,appos,NNP-NNP,NNP,2,1
8851,40924.0,51,called,24,2,5,3,1,45,22,-19,Barbara Boxer,D-Calif.,PERSON-PERSON,LOCATION,PROPN-PROPN,PROPN,compound-nsubj,appos,NNP-NNP,NNP,1,1
8852,44352.0,36,vowed,20,2,5,3,1,30,18,-15,Barbara Boxer,D-Calif.,PERSON-PERSON,LOCATION,PROPN-PROPN,PROPN,compound-nsubj,appos,NNP-NNP,NNP,1,1
8853,32147.0,27,done,15,7,13,6,6,13,8,-2,American Bankers Association,Community Bankers,ORGANIZATION-ORGANIZATION-ORGANIZATION,ORGANIZATION-ORGANIZATION,PROPN-PROPN-PROPN,PROPN-PROPN,compound-compound-pobj,compound-conj,NNP-NNPS-NNP,NNP-NNPS,2,1
8854,32153.0,25,sidelined,17,15,13,-2,14,11,2,-4,Li Jie,Chinese,PERSON-PERSON,NATIONALITY,PROPN-PROPN,ADJ,compound-nsubjpass,amod,NNP-NNP,JJ,1,1
8855,32174.0,44,broke,13,12,9,-3,11,34,1,-4,Steve McPherson,President of Entertainment,PERSON-PERSON,TITLE-TITLE-TITLE,PROPN-PROPN,PROPN-ADP-PROPN,compound-pobj,pobj-prep-compound,NNP-NNP,NNP-IN-NNP,1,1
8856,32178.0,52,died,37,1,7,6,0,44,36,-30,Pamela Gardner Ahearn,nine years,PERSON-PERSON-PERSON,DURATION-DURATION,PROPN-PROPN-PROPN,NUM-NOUN,compound-compound-nsubj,nummod-dobj,NNP-NNP-NNP,CD-NNS,3,1
8857,32204.0,31,noted,2,19,30,11,18,0,-17,28,he,army,PERSON,ORGANIZATION,PRON,NOUN,nsubj,pobj,PRP,NN,2,1
8858,32211.0,31,been,6,5,13,8,4,17,1,7,Bellecourt,American Indian,PERSON,NATIONALITY-NATIONALITY,PROPN,ADJ-ADJ,nsubj,amod-amod,NNP,JJ-JJ,6,1
8859,32215.0,21,warned,7,1,6,5,0,14,6,-1,Citibank,Robert Buckland,ORGANIZATION,PERSON-PERSON,PROPN,PROPN-PROPN,amod,compound-nsubj,NNP,NNP-NNP,2,1
8860,32220.0,35,resist,8,8,6,-2,7,28,0,-2,Bond,NAACP,PERSON,ORGANIZATION,PROPN,PROPN,pobj,poss,NNP,NNP,5,1
8861,32223.0,47,joined,32,9,43,34,8,3,23,11,National Military Family Association,Smart Television Alliance,ORGANIZATION-ORGANIZATION-ORGANIZATION-ORGANIZATION,ORGANIZATION-ORGANIZATION-ORGANIZATION,PROPN-PROPN-PROPN-PROPN,PROPN-PROPN-PROPN,compound-compound-compound-conj,compound-compound-pobj,NNP-NNP-NNP-NNP,NNP-NNP-NNP,7,1
8862,32225.0,24,is,1,18,21,3,17,2,-17,20,Abu Zubaydah,Khalid Shaikh Muhammad,PERSON-PERSON,PERSON-PERSON-PERSON,PROPN-PROPN,PROPN-PROPN-PROPN,compound-pobj,compound-compound-conj,NNP-NNP,NNP-NNP-NNP,2,1
8863,32247.0,38,says,11,22,13,-9,21,24,-11,2,Awami National Party,Lateef Afridi,ORGANIZATION-ORGANIZATION-ORGANIZATION,PERSON-PERSON,PROPN-PROPN-PROPN,PROPN-PROPN,compound-compound-pobj,compound-nsubj,NNP-NNP-NNP,NNP-NNP,5,1
8864,32253.0,29,said,15,3,28,25,2,0,12,13,Taiwan Research Institute,Taipei,ORGANIZATION-ORGANIZATION-ORGANIZATION,CITY,PROPN-PROPN-PROPN,PROPN,compound-compound-pobj,pobj,NNP-NNP-NNP,NNP,10,1
8865,32266.0,24,said,9,11,22,11,10,1,-2,13,Li Jie,Liaoyuan City,PERSON-PERSON,LOCATION-LOCATION,PROPN-PROPN,PROPN-PROPN,compound-nsubj,compound-pobj,NNP-NNP,NNP-NNP,5,1
8866,32279.0,32,are,2,21,10,-11,20,21,-19,8,Badr Organization,Baghdad,ORGANIZATION-ORGANIZATION,CITY,PROPN-PROPN,PROPN,compound-pobj,pobj,NNP-NNP,NNP,3,1
8867,32287.0,43,died,41,1,6,5,0,36,40,-35,Roy Scheider,boxer,PERSON-PERSON,TITLE,PROPN-PROPN,NOUN,compound-nsubj,appos,NNP-NNP,NN,2,1
8868,32295.0,28,died,21,1,9,8,0,18,20,-12,Sills,New York City Opera,PERSON,ORGANIZATION-ORGANIZATION-ORGANIZATION-ORGANIZATION,NOUN,PROPN-PROPN-PROPN-PROPN,nsubj,compound-compound-compound-pobj,NNS,NNP-NNP-NNP-NNP,5,1
8869,32297.0,23,make,11,1,5,4,0,17,10,-6,ITW,"60,000",ORGANIZATION,NUMBER,PROPN,NUM,nsubj,nummod,NNP,CD,3,1
8870,54530.0,23,make,11,1,5,4,0,17,10,-6,ITW,"60,000",ORGANIZATION,NUMBER,PROPN,NUM,nsubj,nummod,NNP,CD,3,1
8871,32303.0,52,obtained,16,16,14,-2,15,37,0,-2,Peterson,Montreal,PERSON,CITY,PROPN,PROPN,nsubj,pobj,NNP,NNP,1,1
8872,52500.0,40,began,9,9,7,-2,8,32,0,-2,Peterson,Montreal,PERSON,CITY,PROPN,PROPN,nsubj,pobj,NNP,NNP,1,1
8873,32313.0,25,wrote,23,8,7,-1,7,17,15,-16,Mike Deaver,Washington,PERSON-PERSON,STATE_OR_PROVINCE,PROPN-PROPN,PROPN,compound-pobj,compound,NNP-NNP,NNP,6,1
8874,32315.0,30,survived,2,5,8,3,4,21,-3,6,his,Carol Ann Bellecourt,PERSON,PERSON-PERSON-PERSON,DET,PROPN-PROPN-PROPN,poss,compound-compound-appos,PRP$,NNP-NNP-NNP,2,1
8875,42814.0,26,include,2,4,7,3,3,18,-2,5,his,Carol Ann Bellecourt,PERSON,PERSON-PERSON-PERSON,DET,PROPN-PROPN-PROPN,poss,compound-compound-appos,PRP$,NNP-NNP-NNP,2,1
8876,67562.0,30,survived,2,5,8,3,4,21,-3,6,his,Carol Ann Bellecourt,PERSON,PERSON-PERSON-PERSON,DET,PROPN-PROPN-PROPN,poss,compound-compound-appos,PRP$,NNP-NNP-NNP,2,1
8877,32316.0,14,sold,2,8,10,2,7,3,-6,8,DirecTV,2008,ORGANIZATION,DATE,VERB,NUM,npadvmod,pobj,VBN,CD,2,1
8878,32337.0,9,born,4,2,7,5,1,1,2,3,Lorraine,San Francisco,PERSON,CITY-CITY,PROPN,PROPN-PROPN,compound,compound-pobj,NNP,NNP-NNP,3,1
8879,32341.0,29,was,18,5,27,22,4,1,13,9,her,United States,PERSON,COUNTRY-COUNTRY,DET,PROPN-PROPN,poss,compound-pobj,PRP$,NNP-NNP,6,1
8880,32346.0,25,born,4,1,9,8,0,15,3,5,Richmond McDavid Flowers,"Nov. 11 , 1918",PERSON-PERSON-PERSON,DATE-DATE-DATE-DATE,PROPN-PROPN-PROPN,PROPN-NUM-PUNCT-NUM,compound-compound-nsubjpass,pobj-nummod-punct-nummod,NNP-NNP-NNP,"NNP-CD-,-CD",5,1
8881,32352.0,51,report,6,5,10,5,4,40,1,4,Robert Morgenthau,district attorney,PERSON-PERSON,TITLE-TITLE,PROPN-PROPN,NOUN-NOUN,compound-pobj,compound-nsubj,NNP-NNP,NN-NN,6,1
8882,37910.0,36,said,34,33,31,-2,32,4,1,-3,Robert Morgenthau,district attorney,PERSON-PERSON,TITLE-TITLE,PROPN-PROPN,NOUN-NOUN,compound-nsubj,compound-compound,NNP-NNP,NN-NN,1,1
8883,65464.0,40,said,25,27,32,5,26,7,-2,7,Robert Morgenthau,district attorney,PERSON-PERSON,TITLE-TITLE,PROPN-PROPN,NOUN-NOUN,compound-nsubj,compound-appos,NNP-NNP,NN-NN,6,1
8884,32361.0,29,co-founder,1,6,2,-4,5,26,-5,1,Country Music Association,co-founder,ORGANIZATION-ORGANIZATION-ORGANIZATION,PERSON,PROPN-PROPN-PROPN,NOUN,compound-compound-pobj,ROOT,NNP-NNP-NNP,NN,6,1
8885,32370.0,56,practice,21,6,14,8,5,41,15,-7,Barbara Boxer,Senate Environmental and Public Works Committee,PERSON-PERSON,ORGANIZATION-ORGANIZATION-ORGANIZATION-ORGANIZATION-ORGANIZATION-ORGANIZATION,PROPN-PROPN,PROPN-PROPN-CCONJ-PROPN-PROPN-PROPN,compound-pobj,nmod-nmod-cc-compound-conj-pobj,NNP-NNP,NNP-NNP-CC-NNP-NNP-NNP,5,1
8886,32371.0,23,is,3,7,1,-6,6,21,-4,-2,Spelman College,Beverly Daniel Tatum,ORGANIZATION-ORGANIZATION,PERSON-PERSON-PERSON,PROPN-PROPN,PROPN-PROPN-PROPN,compound-pobj,compound-compound-nsubj,NNP-NNP,NNP-NNP-NNP,5,1
8887,36584.0,37,said,17,25,19,-6,24,17,-8,2,Spelman College,Beverly Daniel Tatum,ORGANIZATION-ORGANIZATION,PERSON-PERSON-PERSON,PROPN-PROPN,PROPN-PROPN-PROPN,compound-pobj,compound-compound-nsubj,NNP-NNP,NNP-NNP-NNP,5,1
8888,62769.0,22,said,11,20,13,-7,19,8,-9,2,Spelman College,Beverly Daniel Tatum,ORGANIZATION-ORGANIZATION,PERSON-PERSON-PERSON,PROPN-PROPN,PROPN-PROPN-PROPN,compound-pobj,compound-compound-nsubj,NNP-NNP,NNP-NNP-NNP,5,1
8889,32378.0,33,Roundup,0,18,22,4,17,10,-18,22,Ali Larijani,director,PERSON-PERSON,TITLE,PROPN-PROPN,NOUN,compound-attr,appos,NNP-NNP,NN,2,1
8890,32385.0,33,said,14,27,16,-11,26,16,-13,2,Marywood University,Kenneth Rundell,ORGANIZATION-ORGANIZATION,PERSON-PERSON,PROPN-PROPN,PROPN-PROPN,compound-pobj,compound-nsubj,NNP-NNP,NNP-NNP,5,1
8891,40693.0,33,said,13,27,16,-11,26,16,-14,3,Marywood University,Kenneth Rundell,ORGANIZATION-ORGANIZATION,PERSON-PERSON,PROPN-PROPN,PROPN-PROPN,compound-pobj,compound-nsubj,NNP-NNP,NNP-NNP,7,1
8892,65504.0,47,said,19,13,2,-11,12,44,6,-17,Marywood University,Kenneth Rundell,ORGANIZATION-ORGANIZATION,PERSON-PERSON,PROPN-PROPN,PROPN-PROPN,compound-pobj,compound-nsubj,NNP-NNP,NNP-NNP,5,1
8893,32404.0,14,was,2,1,7,6,0,6,1,5,Fraser Robinson,organizer,PERSON-PERSON,TITLE,PROPN-PROPN,NOUN,compound-nsubj,attr,NNP-NNP,NN,4,1
8894,32415.0,15,is,1,13,9,-4,12,5,-12,8,Chris Ivery,her,PERSON-PERSON,PERSON,PROPN-PROPN,DET,compound-appos,poss,NNP-NNP,PRP$,3,1
8895,32429.0,36,said,15,28,20,-8,27,15,-13,5,Organization of the Islamic Conference,Abdoulaye Wade,ORGANIZATION-ORGANIZATION-ORGANIZATION-ORGANIZATION-ORGANIZATION,PERSON-PERSON,PROPN-ADP-DET-PROPN-PROPN,PROPN-PROPN,pobj-prep-det-compound-pobj,compound-nsubj,NNP-IN-DT-NNP-NNP,NNP-NNP,6,1
8896,32432.0,29,is,7,16,2,-14,15,26,-9,-5,American Psychological Association,APA Concise Dictionary of Psychology,ORGANIZATION-ORGANIZATION-ORGANIZATION,ORGANIZATION-ORGANIZATION-ORGANIZATION-ORGANIZATION-ORGANIZATION,PROPN-PROPN-PROPN,PROPN-PROPN-PROPN-ADP-PROPN,compound-compound-pobj,compound-compound-nsubj-prep-pobj,NNP-NNP-NNP,NNP-NNP-NNP-IN-NNP,6,1
8897,32470.0,37,complete,3,26,8,-18,25,28,-23,5,Jo Ann Davis,Rep,PERSON-PERSON-PERSON,TITLE,PROPN-PROPN-PROPN,PROPN,compound-compound-conj,compound,NNP-NNP-NNP,NNP,3,1
8898,66082.0,34,said,32,3,2,-1,2,31,29,-30,Jo Ann Davis,Rep,PERSON-PERSON-PERSON,TITLE,PROPN-PROPN-PROPN,PROPN,compound-compound-nsubj,compound,NNP-NNP-NNP,NNP,2,1
8899,32471.0,56,died,40,1,9,8,0,46,39,-31,Richard H Nolte,executive director,PERSON-PERSON-PERSON,TITLE-TITLE,PROPN-PROPN-PROPN,ADJ-NOUN,compound-compound-nsubj,amod-appos,NNP-NNP-NNP,JJ-NN,2,1
8900,32477.0,40,benefit,5,38,11,-27,37,28,-33,6,FMR Corp,Abigail P Johnson,ORGANIZATION-ORGANIZATION,PERSON-PERSON-PERSON,PROPN-PROPN,PROPN-PROPN-PROPN,compound-appos,compound-compound-appos,NNP-NNP,NNP-NNP-NNP,8,1
8901,46885.0,47,'s,1,45,19,-26,44,27,-44,18,FMR Corp,Abigail P Johnson,ORGANIZATION-ORGANIZATION,PERSON-PERSON-PERSON,PROPN-PROPN,PROPN-PROPN-PROPN,compound-pobj,compound-compound-appos,NNP-NNP,NNP-NNP-NNP,11,1
8902,32482.0,26,born,3,19,11,-8,18,14,-16,8,he,Orange,PERSON,CITY,PRON,PROPN,nsubj,pobj,PRP,NNP,4,1
8903,47565.0,26,born,3,19,11,-8,18,14,-16,8,he,Orange,PERSON,CITY,PRON,PROPN,nsubjpass,pobj,PRP,NNP,4,1
8904,32492.0,57,set,36,31,34,3,30,22,5,-2,USA Network,Burn Notice,ORGANIZATION-ORGANIZATION,ORGANIZATION-ORGANIZATION,PROPN-PROPN,PROPN-PROPN,compound-poss,compound-appos,NNP-NNP,NNP-NNP,1,1
8905,52132.0,42,Burn,1,6,2,-4,5,39,-5,1,USA Network,Burn Notice,ORGANIZATION-ORGANIZATION,ORGANIZATION-ORGANIZATION,PROPN-PROPN,VERB-PROPN,compound-poss,ROOT-dobj,NNP-NNP,VB-NNP,3,1
8906,53613.0,25,deploys,19,13,16,3,12,8,6,-3,USA Network,Burn Notice,ORGANIZATION-ORGANIZATION,ORGANIZATION-ORGANIZATION,PROPN-PROPN,PROPN-PROPN,compound-poss,compound-pobj,NNP-NNP,NNP-NNP,1,1
8907,32498.0,38,said,8,10,2,-8,9,35,-2,-6,he,20-year-old,PERSON,DURATION,PRON,NUM,nsubj,amod,PRP,CD,4,1
8908,32505.0,34,pointed,21,2,13,11,1,20,19,-8,she,judge,PERSON,TITLE,PRON,NOUN,nsubj,pobj,PRP,NN,3,1
8909,34008.0,33,ended,7,7,5,-2,6,27,0,-2,she,judge,PERSON,TITLE,PRON,NOUN,nsubj,pobj,PRP,NN,1,1
8910,63624.0,10,sworn,4,3,9,6,2,0,1,5,she,judge,PERSON,TITLE,PRON,NOUN,nsubjpass,pobj,PRP,NN,2,1
8911,32509.0,30,promoted,15,1,29,28,0,0,14,14,Lee Jye,35,PERSON-PERSON,NUMBER,PROPN-PROPN,NUM,compound-nsubj,pobj,NNP-NNP,CD,2,1
8912,32520.0,8,is,1,1,7,6,0,0,0,6,She,singer,PERSON,TITLE,PRON,NOUN,nsubj,conj,PRP,NN,1,1
8913,32523.0,46,says,1,12,35,23,11,10,-11,34,Jackson Hewitt,Smart Tax/Jackson Hewitt,ORGANIZATION-ORGANIZATION,ORGANIZATION-ORGANIZATION-ORGANIZATION,PROPN-PROPN,PROPN-PROPN-PROPN,compound-compound,compound-compound-compound,NNP-NNP,NNP-NNP-NNP,8,1
8914,32530.0,39,praised,1,5,25,20,4,13,-4,24,her,Washington,PERSON,STATE_OR_PROVINCE,DET,PROPN,poss,compound,PRP$,NNP,12,1
8915,32536.0,34,Credit,0,5,26,21,4,7,-5,26,Olivia,ELLE,PERSON,ORGANIZATION,PROPN,PROPN,nsubjpass,poss,NNP,NNP,6,1
8916,32540.0,30,stripped,2,14,1,-13,13,28,-12,-1,CPC,Zhu,ORGANIZATION,PERSON,PROPN,NOUN,compound,nsubjpass,NNP,NN,2,1
8917,32542.0,21,picked,6,8,12,4,7,8,-2,6,Sheldon,secretary,PERSON,TITLE,PROPN,NOUN,dobj,attr,NNP,NN,3,1
8918,32546.0,49,survived,2,1,30,29,0,18,1,28,She,Murray,PERSON,PERSON,PRON,PROPN,nsubjpass,conj,PRP,NNP,5,1
8919,32553.0,26,played,7,10,17,7,9,8,-3,10,Hector Elizondo,actor,PERSON-PERSON,TITLE,PROPN-PROPN,NOUN,compound-pobj,conj,NNP-NNP,NN,3,1
8920,33629.0,38,means,1,6,5,-1,5,32,-5,4,Hector Elizondo,actor,PERSON-PERSON,TITLE,PROPN-PROPN,NOUN,compound-dobj,compound,NNP-NNP,NN,1,1
8921,59806.0,38,means,1,6,5,-1,5,32,-5,4,Hector Elizondo,actor,PERSON-PERSON,TITLE,PROPN-PROPN,NOUN,compound-dobj,compound,NNP-NNP,NN,1,1
8922,32574.0,8,CENTER,1,1,7,6,0,0,0,6,KENNEDY,WASHINGTON,ORGANIZATION,STATE_OR_PROVINCE,PROPN,PROPN,compound,npadvmod,NNP,NNP,1,1
8923,32586.0,20,said,13,2,9,7,1,10,11,-4,Jerusalem Foundation,Kollek,ORGANIZATION-ORGANIZATION,PERSON,PROPN-PROPN,PROPN,compound-nsubj,pobj,NNP-NNP,NNP,5,1
8924,67322.0,22,said,13,2,9,7,1,12,11,-4,Jerusalem Foundation,Kollek,ORGANIZATION-ORGANIZATION,PERSON,PROPN-PROPN,PROPN,compound-nsubj,pobj,NNP-NNP,NNP,5,1
8925,32588.0,37,dropped,5,34,18,-16,33,18,-29,13,Option One Mortgage,Cerberus,ORGANIZATION-ORGANIZATION-ORGANIZATION,ORGANIZATION,PROPN-NUM-NOUN,PROPN,compound-nummod-appos,pobj,NNP-CD-NN,NNP,6,1
8926,32589.0,49,seemed,2,15,32,17,14,16,-13,30,Dillinger,DCF,PERSON,ORGANIZATION,PROPN,PROPN,pobj,dobj,NNP,NNP,5,1
8927,32599.0,23,said,3,3,5,2,2,17,0,2,Simcox,he,PERSON,PERSON,PROPN,PRON,nsubj,nsubj,NNP,PRP,1,1
8928,32601.0,23,said,6,22,19,-3,21,3,-16,13,Gonzales,Houston,PERSON,CITY,PROPN,PROPN,pobj,compound,NNP,NNP,5,1
8929,32622.0,42,said,23,32,2,-30,31,39,-9,-21,Awami National Party,Pakistan,ORGANIZATION-ORGANIZATION-ORGANIZATION,COUNTRY,PROPN-PROPN-PROPN,PROPN,compound-compound-pobj,attr,NNP-NNP-NNP,NNP,7,1
8930,32637.0,26,been,3,8,12,4,7,13,-5,9,ABC,India,ORGANIZATION,COUNTRY,PROPN,PROPN,poss,pobj,NNP,NNP,5,1
8931,32663.0,13,brother,3,1,6,5,0,6,2,3,John Kerry,Cam Kerry,PERSON-PERSON,PERSON-PERSON,PROPN-PROPN,PROPN-PROPN,compound-poss,compound-appos,NNP-NNP,NNP-NNP,2,1
8932,32666.0,47,circulated,23,25,8,-17,24,38,-2,-15,his,Iran,PERSON,COUNTRY,DET,PROPN,poss,poss,PRP$,NNP,9,1
8933,61463.0,27,ISTANBUL,0,12,3,-9,11,23,-12,3,his,Iran,PERSON,COUNTRY,DET,PROPN,poss,poss,PRP$,NNP,6,1
8934,32685.0,44,crashed,5,42,15,-27,41,28,-37,10,Lee Jye,Singaporean,PERSON-PERSON,NATIONALITY,PROPN-PROPN,ADJ,compound-pobj,amod,NNP-NNP,JJ,11,1
8935,32687.0,45,At,0,34,25,-9,33,19,-34,25,National Action Network,Charlie King,ORGANIZATION-ORGANIZATION-ORGANIZATION,PERSON-PERSON,PROPN-PROPN-PROPN,PROPN-PROPN,compound-compound-pobj,compound-pobj,NNP-NNP-NNP,NNP-NNP,4,1
8936,32689.0,29,scooping,15,11,6,-5,10,22,4,-9,Highland Capital Partners,his,ORGANIZATION-ORGANIZATION-ORGANIZATION,PERSON,PROPN-PROPN-PROPN,DET,compound-compound-appos,poss,NNP-NNP-NNP,PRP$,3,1
8937,32699.0,40,died,32,3,14,11,2,25,29,-18,John P Henebry,Army Air Forces,PERSON-PERSON-PERSON,ORGANIZATION-ORGANIZATION-ORGANIZATION,PROPN-PROPN-PROPN,PROPN-PROPN-PROPN,compound-compound-nsubj,compound-compound-poss,NNP-NNP-NNP,NNP-NNP-NNPS,7,1
8938,32728.0,32,became,8,8,4,-4,7,27,0,-4,Millender-McDonald,Birmingham,PERSON,CITY,PROPN,PROPN,nsubj,pobj,NNP,NNP,6,1
8939,35436.0,50,born,2,1,5,4,0,44,1,3,Millender-McDonald,Birmingham,PERSON,CITY,PROPN,PROPN,nsubjpass,pobj,NNP,NNP,3,1
8940,32735.0,33,convicted,5,30,27,-3,29,5,-25,22,Jewish National Fund,Israel,ORGANIZATION-ORGANIZATION-ORGANIZATION,COUNTRY,PROPN-PROPN-PROPN,PROPN,amod-compound-conj,pobj,NNP-NNP-NNP,NNP,3,1
8941,51989.0,35,orders,5,7,1,-6,6,33,-2,-4,Jewish National Fund,Israel,ORGANIZATION-ORGANIZATION-ORGANIZATION,COUNTRY,PROPN-PROPN-PROPN,PROPN,amod-compound-dobj,poss,NNP-NNP-NNP,NNP,5,1
8942,52777.0,29,serves,2,12,28,16,11,0,-10,26,Jewish National Fund,Israel,ORGANIZATION-ORGANIZATION-ORGANIZATION,COUNTRY,ADJ-PROPN-PROPN,PROPN,compound-compound-pobj,pobj,JJ-NNP-NNP,NNP,8,1
8943,52960.0,92,Weitz,1,7,75,68,6,16,-6,74,Jewish National Fund,Israel,ORGANIZATION-ORGANIZATION-ORGANIZATION,COUNTRY,ADJ-PROPN-PROPN,PROPN,amod-compound-pobj,pobj,JJ-NNP-NNP,NNP,-1,1
8944,56599.0,32,told,27,19,26,7,18,5,8,-1,Jewish National Fund,Israel,ORGANIZATION-ORGANIZATION-ORGANIZATION,COUNTRY,ADJ-PROPN-PROPN,PROPN,amod-compound-pobj,pobj,JJ-NNP-NNP,NNP,9,1
8945,32737.0,38,ran,1,1,8,7,0,29,0,7,Flowers,governor,PERSON,TITLE,NOUN,NOUN,nsubj,pobj,NNS,NN,1,1
8946,32746.0,54,was,1,1,34,33,0,19,0,33,Nolte,National Geographic Society,PERSON,ORGANIZATION-ORGANIZATION-ORGANIZATION,PROPN,PROPN-PROPN-PROPN,nsubj,compound-compound-conj,NNP,NNP-NNP-NNP,5,1
8947,32778.0,8,contributed,3,2,1,-1,1,6,1,-2,Li Jie,Researcher,PERSON-PERSON,TITLE,PROPN-PROPN,PROPN,compound-nsubj,compound,NNP-NNP,NNP,1,1
8948,41760.0,10,contributed,5,2,1,-1,1,8,3,-4,Li Jie,Researcher,PERSON-PERSON,TITLE,PROPN-PROPN,PROPN,compound-nsubj,compound,NNP-NNP,NNP,1,1
8949,32786.0,18,graduated,1,1,4,3,0,13,0,3,He,West Virginia University,PERSON,ORGANIZATION-ORGANIZATION-ORGANIZATION,PRON,PROPN-PROPN-PROPN,nsubj,compound-compound-pobj,PRP,NNP-NNP-NNP,3,1
8950,32793.0,39,believed,2,1,8,7,0,30,1,6,He,field commander,PERSON,TITLE-TITLE,PRON,NOUN-NOUN,nsubjpass,compound-attr,PRP,NN-NN,3,1
8951,32795.0,19,see,2,10,4,-6,9,14,-8,2,Dan Abrams,MSNBC Hosts,PERSON-PERSON,ORGANIZATION-ORGANIZATION,PROPN-PROPN,PROPN-PROPN,compound-conj,compound-nmod,NNP-NNP,NNP-NNPS,2,1
8952,32799.0,26,born,14,13,25,12,12,0,1,11,Kollek,Vienna,PERSON,CITY,PROPN,PROPN,nsubjpass,pobj,NNP,NNP,2,1
8953,32823.0,19,wearing,2,1,18,17,0,0,1,16,Olivia,Leighton,PERSON,PERSON,PROPN,PROPN,dobj,pobj,NNP,NNP,3,1
8954,32835.0,37,said,23,34,27,-7,33,9,-11,4,University of Haifa,Simone Shamay-Tsoory,ORGANIZATION-ORGANIZATION-ORGANIZATION,PERSON-PERSON,PROPN-ADP-PROPN,PROPN-PROPN,pobj-prep-pobj,compound-nsubj,NNP-IN-NNP,NNP-NNP,3,1
8955,32851.0,30,referred,18,26,18,-8,25,11,-8,0,his,he,PERSON,PERSON,DET,PRON,poss,nsubj,PRP$,PRP,7,1
8956,45891.0,25,spent,3,7,13,6,6,11,-4,10,his,he,PERSON,PERSON,DET,PRON,poss,nsubj,PRP$,PRP,4,1
8957,32852.0,35,joined,3,23,1,-22,22,33,-20,-2,FAA,Andrews,ORGANIZATION,PERSON,PROPN,PROPN,nsubj,nsubj,NNP,NNP,9,1
8958,32855.0,50,worked,9,9,23,14,8,26,0,14,Buse,AT&T,PERSON,ORGANIZATION,PROPN,PROPN,nsubj,conj,NNP,NNP,4,1
8959,32882.0,46,said,36,36,25,-11,35,20,0,-11,Gonzales,United States,PERSON,ORGANIZATION-ORGANIZATION,PROPN,PROPN-PROPN,nsubj,compound-pobj,NNP,NNP-NNP,11,1
8960,67539.0,38,is,1,1,36,35,0,1,0,35,Gonzales,United States,PERSON,COUNTRY-COUNTRY,PROPN,PROPN-PROPN,nsubj,compound-pobj,NNP,NNP-NNP,13,1
8961,32887.0,30,issued,8,5,1,-4,4,28,3,-7,Lee Jye,Taiwan,PERSON-PERSON,COUNTRY,PROPN-PROPN,PROPN,compound-nsubj,poss,NNP-NNP,NNP,3,1
8962,41156.0,47,came,4,1,24,23,0,22,3,20,Lee Jye,Taiwan,PERSON-PERSON,ORGANIZATION,PROPN-PROPN,PROPN,compound-poss,dobj,NNP-NNP,NNP,5,1
8963,45841.0,36,said,5,4,20,16,3,15,1,15,Lee Jye,Taiwan,PERSON-PERSON,NATIONALITY,PROPN-PROPN,PROPN,compound-nsubj,compound,NNP-NNP,NNP,6,1
8964,32888.0,33,received,5,5,12,7,4,20,0,7,she,St John 's University,PERSON,ORGANIZATION-ORGANIZATION-ORGANIZATION-ORGANIZATION,PRON,PROPN-PROPN-PART-PROPN,nsubj,compound-poss-case-pobj,PRP,NNP-NNP-POS-NNP,3,1
8965,32899.0,49,dropped,7,47,43,-4,46,5,-40,36,FMF,Free Market Foundation,ORGANIZATION,ORGANIZATION-ORGANIZATION-ORGANIZATION,PROPN,PROPN-PROPN-PROPN,compound,compound-compound-pobj,NNP,NNP-NNP-NNP,7,1
8966,32949.0,22,was,9,1,8,7,0,13,8,-1,Ezra Levant,author,PERSON-PERSON,TITLE,PROPN-PROPN,NOUN,compound-nsubj,conj,NNP-NNP,NN,2,1
8967,47947.0,20,declined,2,12,11,-1,11,8,-10,9,Ezra Levant,author,PERSON-PERSON,TITLE,PROPN-PROPN,NOUN,compound-nsubj,compound,NNP-NNP,NN,1,1
8968,55611.0,21,declined,3,13,12,-1,12,8,-10,9,Ezra Levant,author,PERSON-PERSON,TITLE,PROPN-PROPN,NOUN,compound-nsubj,compound,NNP-NNP,NN,1,1
8969,32950.0,47,was,9,1,6,5,0,40,8,-3,Sills,Monday,PERSON,DATE,NOUN,PROPN,nsubj,pobj,NNS,NNP,3,1
8970,32953.0,47,said,41,1,14,13,0,32,40,-27,Hawkins,Legislature,PERSON,ORGANIZATION,PROPN,PROPN,nsubj,pobj,NNP,NNP,4,1
8971,32958.0,30,suffered,4,3,14,11,2,15,1,10,Castro,Vilma Espin,PERSON,PERSON-PERSON,PROPN,PROPN-PROPN,nsubj,compound-appos,NNP,NNP-NNP,4,1
8972,32965.0,6,Johns,2,2,5,3,1,0,0,3,Michael Johns,29,PERSON-PERSON,NUMBER,PROPN-PROPN,NUM,compound-ROOT,appos,NNP-NNP,CD,1,1
8973,58837.0,19,Johns,1,1,4,3,0,14,0,3,Michael Johns,29,PERSON-PERSON,NUMBER,PROPN-PROPN,NUM,compound-ROOT,nummod,NNP-NNP,CD,-1,1
8974,32977.0,43,Hooper,3,3,6,3,2,36,0,3,Jeremy Hooper,author,PERSON-PERSON,TITLE,PROPN-PROPN,NOUN,compound-ROOT,appos,NNP-NNP,NN,2,1
8975,33001.0,61,said,3,17,10,-7,16,50,-14,7,TACC,IAEA Technical Assistance and Cooperation Committee,ORGANIZATION,ORGANIZATION-ORGANIZATION-ORGANIZATION-ORGANIZATION-ORGANIZATION-ORGANIZATION,PROPN,PROPN-PROPN-PROPN-CCONJ-PROPN-PROPN,compound,nmod-nmod-nmod-cc-conj-pobj,NNP,NNP-NNP-NNP-CC-NNP-NNP,-1,1
8976,33006.0,45,said,36,22,44,22,21,0,14,8,National Center for Disaster Preparedness,Port-au-Prince,ORGANIZATION-ORGANIZATION-ORGANIZATION-ORGANIZATION-ORGANIZATION,CITY,PROPN-PROPN-ADP-PROPN-PROPN,PROPN,compound-pobj-prep-compound-pobj,pobj,NNP-NNP-IN-NNP-NNP,NNP,14,1
8977,33008.0,22,admits,12,4,10,6,3,11,8,-2,Olivia Palermo,Elle,PERSON-PERSON,ORGANIZATION,PROPN-PROPN,PROPN,compound-nsubj,pobj,NNP-NNP,NNP,3,1
8978,51296.0,34,Credit,0,20,25,5,19,8,-20,25,Olivia Palermo,Elle,PERSON-PERSON,ORGANIZATION,PROPN-PROPN,PROPN,compound-nsubj,pobj,NNP-NNP,NNP,2,1
8979,33014.0,22,born,3,1,21,20,0,0,2,18,Theodor Kollek,Austria,PERSON-PERSON,COUNTRY,PROPN-PROPN,PROPN,compound-nsubjpass,appos,NNP-NNP,NNP,2,1
8980,33029.0,29,include,5,11,15,4,10,13,-6,10,Bradford Washburn,mountaineer,PERSON-PERSON,TITLE,PROPN-PROPN,NOUN,compound-pobj,appos,NNP-NNP,NN,2,1
8981,44173.0,43,shows,27,8,12,4,7,30,19,-15,Bradford Washburn,mountaineer,PERSON-PERSON,TITLE,PROPN-PROPN,NOUN,compound-nsubj,appos,NNP-NNP,NN,2,1
8982,33030.0,10,tips,4,6,1,-5,5,8,-2,-3,Berthold Huber,German,PERSON-PERSON,NATIONALITY,PROPN-PROPN,ADJ,compound-dobj,amod,NNP-NNP,JJ,3,1
8983,62325.0,33,called,7,6,18,12,5,14,1,11,Berthold Huber,German,PERSON-PERSON,NATIONALITY,PROPN-PROPN,ADJ,compound-nsubj,amod,NNP-NNP,JJ,4,1
8984,33031.0,26,died,18,14,17,3,13,8,4,-1,his,past,PERSON,DATE,DET,NOUN,poss,appos,PRP$,NN,9,1
8985,33032.0,37,bypassed,25,22,6,-16,21,30,3,-19,Jennifer Dunn,Seattle,PERSON-PERSON,CITY,PROPN-PROPN,PROPN,compound-conj,compound,NNP-NNP,NNP,11,1
8986,33041.0,38,'',0,11,18,7,10,19,-11,18,Spencer,Stephanie Pratt,PERSON,PERSON-PERSON,PROPN,PROPN-PROPN,poss,compound-appos,NNP,NNP-NNP,9,1
8987,33045.0,17,said,11,13,15,2,12,1,-2,4,Sox,Terry Francona,ORGANIZATION,PERSON-PERSON,PROPN,PROPN-PROPN,compound,compound-nsubj,NNP,NNP-NNP,3,1
8988,33050.0,24,born,4,1,5,4,0,18,3,1,Catherine Gertrude Roraback,"born in Brooklyn on Sept 17 , 1920",PERSON-PERSON-PERSON,NUMBER-NUMBER-NUMBER-NUMBER-NUMBER-NUMBER-NUMBER-NUMBER,PROPN-PROPN-PROPN,VERB-ADP-PROPN-ADP-PROPN-NUM-PUNCT-NUM,compound-compound-nsubjpass,ROOT-prep-pobj-prep-pobj-nummod-punct-nummod,NNP-NNP-NNP,"VBN-IN-NNP-IN-NNP-CD-,-CD",3,1
8989,33066.0,27,married,12,12,5,-7,11,21,0,-7,he,Exeter Academy,PERSON,ORGANIZATION-ORGANIZATION,PRON,PROPN-PROPN,nsubj,compound-appos,PRP,NNP-NNP,2,1
8990,33076.0,25,returned,10,10,8,-2,9,16,0,-2,he,pilot,PERSON,TITLE,PRON,NOUN,nsubj,pobj,PRP,NN,1,1
8991,35947.0,26,became,9,9,14,5,8,11,0,5,he,pilot,PERSON,TITLE,PRON,NOUN,nsubj,attr,PRP,NN,1,1
8992,36973.0,47,makes,40,18,23,5,17,23,22,-17,he,pilot,PERSON,TITLE,PRON,NOUN,nsubj,attr,PRP,NN,3,1
8993,56542.0,32,is,9,9,7,-2,8,24,0,-2,he,pilot,PERSON,TITLE,PRON,NOUN,nsubj,attr,PRP,NN,1,1
8994,33101.0,14,says,13,8,10,2,7,3,5,-3,his,Wednesday,PERSON,DATE,DET,PROPN,poss,npadvmod,PRP$,NNP,4,1
8995,63862.0,13,says,12,7,9,2,6,3,5,-3,his,Wednesday,PERSON,DATE,DET,PROPN,poss,npadvmod,PRP$,NNP,4,1
8996,33103.0,31,declined,17,28,1,-27,27,29,-11,-16,IPSCO,Tom Filstrup,ORGANIZATION,PERSON-PERSON,PROPN,PROPN-PROPN,nsubj,compound-nsubj,NNP,NNP-NNP,8,1
8997,33118.0,54,was,1,1,27,26,0,26,0,26,Nolte,Arctic Institute of North America,PERSON,ORGANIZATION-ORGANIZATION-ORGANIZATION-ORGANIZATION-ORGANIZATION,PROPN,PROPN-PROPN-ADP-PROPN-PROPN,nsubj,compound-appos-prep-compound-pobj,NNP,NNP-NNP-IN-NNP-NNP,3,1
8998,33128.0,34,said,22,28,24,-4,27,9,-6,2,PRC,Abu Abeers,ORGANIZATION,PERSON-PERSON,PROPN,PROPN-PROPN,nmod,compound-nsubj,NNP,NNP-NNP,3,1
8999,33130.0,38,said,12,21,14,-7,20,23,-9,2,American Bar Association,William H Neukom,ORGANIZATION-ORGANIZATION-ORGANIZATION,PERSON-PERSON-PERSON,PROPN-PROPN-PROPN,PROPN-PROPN-PROPN,compound-compound-pobj,compound-compound-nsubj,NNP-NNP-NNP,NNP-NNP-NNP,5,1
9000,33132.0,35,found,33,31,4,-27,30,30,2,-29,American Bankers Association,U.S.,ORGANIZATION-ORGANIZATION-ORGANIZATION,COUNTRY,PROPN-PROPN-PROPN,PROPN,compound-compound-pobj,compound,NNP-NNPS-NNP,NNP,8,1
9001,38034.0,39,said,18,29,6,-23,28,32,-11,-12,American Bankers Association,U.S.,ORGANIZATION-ORGANIZATION-ORGANIZATION,COUNTRY,PROPN-PROPN-PROPN,PROPN,compound-compound-pobj,compound,NNP-NNPS-NNP,NNP,11,1
9002,33135.0,36,say,5,2,31,29,1,4,3,26,Castro,Alex,PERSON,PERSON,PROPN,PROPN,nsubj,conj,NNP,NNP,7,1
9003,33149.0,22,said,10,12,20,8,11,1,-2,10,Mahmood Shah,army,PERSON-PERSON,ORGANIZATION,PROPN-PROPN,NOUN,compound-nsubj,compound,NNP-NNP,NN,2,1
9004,33152.0,21,respond,12,3,6,3,2,14,9,-6,Clyde Bellecourt,Vernon Bellecourt,PERSON-PERSON,PERSON-PERSON,PROPN-PROPN,PROPN-PROPN,compound-nsubj,compound-poss,NNP-NNP,NNP-NNP,2,1
9005,33163.0,48,conceded,26,21,29,8,20,18,5,3,Federal Motor Carrier Safety Administration,his,ORGANIZATION-ORGANIZATION-ORGANIZATION-ORGANIZATION-ORGANIZATION,PERSON,PROPN-PROPN-PROPN-PROPN-PROPN,DET,compound-compound-compound-compound-pobj,poss,NNP-NNP-NNP-NNP-NNP,PRP$,9,1
9006,62329.0,52,said,14,5,24,19,4,27,9,10,Federal Motor Carrier Safety Administration,his,ORGANIZATION-ORGANIZATION-ORGANIZATION-ORGANIZATION-ORGANIZATION,PERSON,PROPN-PROPN-PROPN-PROPN-PROPN,DET,compound-compound-compound-compound-pobj,poss,NNP-NNP-NNP-NNP-NNP,PRP$,8,1
9007,33166.0,30,get,12,28,20,-8,27,9,-16,8,John Hewitt,Liberty,PERSON-PERSON,ORGANIZATION,PROPN-PROPN,PROPN,compound-pobj,compound,NNP-NNP,NNP,7,1
9008,33184.0,37,pronounced,18,19,24,5,18,12,-1,6,pronounced uh-HURN,chief of protocol,PERSON-PERSON,TITLE-TITLE-TITLE,VERB-PROPN,NOUN-ADP-NOUN,ROOT-compound,oprd-prep-pobj,VBD-NNP,NN-IN-NN,3,1
9009,33185.0,12,served,2,1,5,4,0,6,1,3,She,chairman,PERSON,TITLE,PRON,NOUN,nsubj,pobj,PRP,NN,4,1
9010,33196.0,14,born,2,1,5,4,0,8,1,3,Rothman,San Francisco,PERSON,CITY-CITY,PROPN,PROPN-PROPN,nsubjpass,compound-pobj,NNP,NNP-NNP,3,1
9011,33202.0,21,look,5,5,15,10,4,5,0,10,Abrams,he,PERSON,PERSON,PROPN,PRON,nsubj,nsubj,NNP,PRP,1,1
9012,33210.0,29,point,4,22,27,5,21,1,-18,23,Ezra Levant,Western Standard,PERSON-PERSON,ORGANIZATION-ORGANIZATION,PROPN-PROPN,PROPN-PROPN,compound-appos,compound-pobj,NNP-NNP,NNP-NNP,2,1
9013,55240.0,22,was,9,1,15,14,0,6,8,6,Ezra Levant,Western Standard,PERSON-PERSON,ORGANIZATION-ORGANIZATION,PROPN-PROPN,ADJ-PROPN,compound-nsubj,compound-compound,NNP-NNP,JJ-NNP,5,1
9014,33215.0,33,has,17,1,20,19,0,12,16,3,IPSCO,"4,300",ORGANIZATION,NUMBER,PROPN,NUM,nsubj,nummod,NNP,CD,3,1
9015,33218.0,64,2008-05-14T09,0,7,3,-4,6,60,-7,3,Chelsea District Library,McKune Memorial Library,ORGANIZATION-ORGANIZATION-ORGANIZATION,ORGANIZATION-ORGANIZATION-ORGANIZATION,PROPN-PROPN-PROPN,PROPN-PROPN-PROPN,compound-compound-compound,compound-nmod-nmod,NNP-NNP-NNP,NNP-NNP-NNP,4,1
9016,33229.0,52,--,0,30,28,-2,29,23,-30,28,Alberto Gonzalez,Attorney General,PERSON-PERSON,TITLE-TITLE,PROPN-PROPN,PROPN-PROPN,compound-nsubj,compound-compound,NNP-NNP,NNP-NNP,4,1
9017,33232.0,13,born,2,1,4,3,0,8,1,2,She,Belle Silverman,PERSON,PERSON-PERSON,PRON,PROPN-PROPN,nsubjpass,compound-oprd,PRP,NNP-NNP,2,1
9018,33235.0,76,be,6,1,46,45,0,29,5,40,Frankie Delgado,celebrity,PERSON-PERSON,TITLE,PROPN-PROPN,NOUN,compound-nsubj,ROOT,NNP-NNP,NN,6,1
9019,33245.0,24,founded,2,1,12,11,0,11,1,10,Lashkar-e-Taiba,Hafiz Muhammad Saeed,ORGANIZATION,PERSON-PERSON-PERSON,PROPN,PROPN-PROPN-PROPN,nsubjpass,compound-compound-oprd,NNP,NNP-NNP-NNP,4,1
9020,54066.0,48,invited,3,17,8,-9,16,39,-14,5,Lashkar-e-Taiba,Hafiz Muhammad Saeed,ORGANIZATION,PERSON-PERSON-PERSON,PROPN,PROPN-PROPN-PROPN,compound,compound-compound-attr,NNP,NNP-NNP-NNP,7,1
9021,56303.0,41,added,6,25,8,-17,24,32,-19,2,Lashkar-e-Taiba,Hafiz Muhammad Saeed,ORGANIZATION,PERSON-PERSON-PERSON,PROPN,PROPN-PROPN-PROPN,appos,compound-compound-dobj,NNP,NNP-NNP-NNP,7,1
9022,33247.0,50,statement,1,48,17,-31,47,32,-47,16,NSC,Tony Nezianya,ORGANIZATION,PERSON-PERSON,PROPN,PROPN-PROPN,compound,compound-appos,NNP,NNP-NNP,-1,1
9023,33255.0,36,say,5,2,29,27,1,6,3,24,Castro,Antonio,PERSON,PERSON,PROPN,PROPN,compound,conj,NNP,NNP,6,1
9024,33263.0,31,accuses,3,5,20,15,4,10,-2,17,him,62,PERSON,NUMBER,PRON,NUM,dobj,appos,PRP,CD,4,1
9025,33273.0,20,is,12,12,10,-2,11,9,0,-2,Larijani,Iraq,PERSON,COUNTRY,PROPN,PROPN,nsubj,pobj,NNP,NNP,1,1
9026,33282.0,36,Trek,4,16,30,14,15,5,-12,26,Fuller,West Adams,PERSON,LOCATION-LOCATION,PROPN,PROPN-PROPN,nsubj,nmod-compound,NNP,NNP-NNP,8,1
9027,33284.0,36,merged,9,25,13,-12,24,22,-16,4,Sports Affairs Council,Ministry of Education,ORGANIZATION-ORGANIZATION-ORGANIZATION,ORGANIZATION-ORGANIZATION-ORGANIZATION,PROPN-PROPN-PROPN,PROPN-ADP-PROPN,compound-compound-nsubjpass,pobj-prep-pobj,NNPS-NNPS-NNP,NNP-IN-NNP,6,1
9028,33285.0,33,played,5,4,7,3,3,25,1,2,McNair,host,PERSON,TITLE,PROPN,NOUN,nsubj,dobj,NNP,NN,2,1
9029,56387.0,33,played,5,4,7,3,3,25,1,2,McNair,host,PERSON,TITLE,PROPN,NOUN,nsubj,dobj,NNP,NN,2,1
9030,33286.0,27,honoured,14,12,11,-1,11,15,2,-3,Paul Watson,chief,PERSON-PERSON,TITLE,PROPN-PROPN,NOUN,compound-nsubjpass,compound,NNP-NNP,NN,2,1
9031,33295.0,20,said,8,6,1,-5,5,18,2,-7,Brian McFadden,Her,PERSON-PERSON,PERSON,PROPN-PROPN,DET,compound-appos,poss,NNP-NNP,PRP$,2,1
9032,33300.0,52,include,1,3,42,39,2,9,-2,41,his,Jack Dent,PERSON,PERSON-PERSON,DET,PROPN-PROPN,poss,compound-conj,PRP$,NNP-NNP,12,1
9033,33311.0,38,described,1,20,1,-19,19,36,-19,0,Sports Affairs Council,Lee,ORGANIZATION-ORGANIZATION-ORGANIZATION,PERSON,PROPN-PROPN-PROPN,PROPN,compound-compound-pobj,nsubj,NNPS-NNPS-NNP,NNP,5,1
9034,33328.0,27,delayed,5,13,26,13,12,0,-8,21,EnergySolutions Inc.,U.S.,ORGANIZATION-ORGANIZATION,COUNTRY,PROPN-PROPN,PROPN,compound-nsubj,pobj,NNP-NNP,NNP,5,1
9035,40637.0,29,said,4,16,28,12,15,0,-12,24,EnergySolutions Inc.,U.S.,ORGANIZATION-ORGANIZATION,COUNTRY,PROPN-PROPN,PROPN,compound-nsubj,pobj,NNP-NNP,NNP,5,1
9036,33347.0,27,died,6,12,10,-2,11,16,-6,4,he,Italy,PERSON,COUNTRY,PRON,PROPN,nsubj,pobj,PRP,NNP,2,1
9037,33350.0,24,said,10,12,15,3,11,8,-2,5,Chad White,34,PERSON-PERSON,NUMBER,PROPN-PROPN,NUM,compound-nsubj,appos,NNP-NNP,CD,2,1
9038,33353.0,7,Association,4,2,7,5,1,-1,2,3,National Military Family Association,www.nmfa.org,ORGANIZATION-ORGANIZATION-ORGANIZATION-ORGANIZATION,URL,PROPN-PROPN-PROPN-PROPN,NOUN,compound-compound-compound-ROOT,appos,NNP-NNP-NNP-NNP,NN,-1,1
9039,33356.0,17,August,0,5,1,-4,4,15,-5,1,Irene Morgan Kirkaldy,"August 13 , 2007",PERSON-PERSON-PERSON,DATE-DATE-DATE-DATE,PROPN-PROPN-PROPN,PROPN-NUM-PUNCT-NUM,compound-compound-appos,ROOT-nummod-punct-npadvmod,NNP-NNP-NNP,"NNP-CD-,-CD",3,1
9040,33368.0,35,is,4,9,12,3,8,22,-5,8,Chen Zhu,former vice president,PERSON-PERSON,TITLE-TITLE-TITLE,PROPN-PROPN,ADJ-NOUN-NOUN,compound-pobj,amod-compound-appos,NNP-NNP,JJ-NN-NN,2,1
9041,33389.0,40,FIRED,18,10,25,15,9,14,8,7,NATIONAL SECURITY COUNCIL,he,ORGANIZATION-ORGANIZATION-ORGANIZATION,PERSON,PROPN-PROPN-NOUN,PRON,compound-compound-pobj,nsubj,NNP-NNP-NNS,PRP,7,1
9042,33391.0,15,refuse,1,8,5,-3,7,9,-7,4,Red Sox,Boston Americans,ORGANIZATION-ORGANIZATION,ORGANIZATION-ORGANIZATION,PROPN-PROPN,PROPN-PROPN,compound-compound,compound-dobj,NNP-NNPS,NNP-NNPS,3,1
9043,33394.0,41,sent,8,14,20,6,13,20,-6,12,Chinese Communist Party,Central Committee,ORGANIZATION-ORGANIZATION-ORGANIZATION,ORGANIZATION-ORGANIZATION,PROPN-PROPN-PROPN,PROPN-PROPN,compound-compound-pobj,compound-conj,NNP-NNP-NNP,NNP-NNP,2,1
9044,33396.0,37,ATLANTA,0,3,12,9,2,24,-3,12,Jackson Hewitt Tax Services,Fred Goldberg,ORGANIZATION-ORGANIZATION-ORGANIZATION-ORGANIZATION,PERSON-PERSON,PROPN-PROPN-PROPN-PROPN,PROPN-PROPN,compound-compound-compound-nsubj,compound-dobj,NNP-NNP-NNP-NNPS,NNP-NNP,4,1
9045,33407.0,50,opened,2,25,32,7,24,17,-23,30,Illinois Tool Works Inc.,Glenview,ORGANIZATION-ORGANIZATION-ORGANIZATION-ORGANIZATION,CITY,PROPN-PROPN-PROPN-PROPN,PROPN,compound-compound-compound-nsubj,pobj,NNP-NNP-NNP-NNP,NNP,5,1
9046,33408.0,33,is,4,1,1,0,0,31,3,-3,Royal Caribbean International,Royal Caribbean Cruises Ltd.,ORGANIZATION-ORGANIZATION-ORGANIZATION,ORGANIZATION-ORGANIZATION-ORGANIZATION-ORGANIZATION,PROPN-PROPN-PROPN,ADJ-PROPN-PROPN-PROPN,compound-compound-dobj,compound-compound-compound-nsubj,NNP-NNP-NNP,JJ-NNP-NNPS-NNP,0,1
9047,33412.0,40,made,1,17,9,-8,16,30,-16,8,Taiwan Research Institute,Cross-Strait Think Tanks Forum,ORGANIZATION-ORGANIZATION-ORGANIZATION,ORGANIZATION-ORGANIZATION-ORGANIZATION-ORGANIZATION,PROPN-PROPN-PROPN,ADJ-VERB-NOUN-PROPN,compound-compound-conj,amod-compound-compound-appos,NNP-NNP-NNP,JJ-VBP-NNS-NNP,3,1
9048,33428.0,56,acn,5,33,31,-2,32,24,-28,26,Raul Castro,vice President,PERSON-PERSON,TITLE-TITLE,PROPN-PROPN,NOUN-PROPN,compound-pobj,compound-compound,NNP-NNP,NN-NNP,1,1
9049,33436.0,28,founded,1,4,1,-3,3,26,-3,0,Multidisciplinary Association for Psychedelic Studies,Doblin,ORGANIZATION-ORGANIZATION-ORGANIZATION-ORGANIZATION-ORGANIZATION,PERSON,PROPN-PROPN-ADP-PROPN-PROPN,PROPN,compound-dobj-prep-compound-pobj,nsubj,NNP-NNP-IN-NNP-NNPS,NNP,1,1
9050,33439.0,39,became,4,13,3,-10,12,35,-9,-1,her,48,PERSON,NUMBER,DET,NUM,poss,appos,PRP$,CD,5,1
9051,33441.0,16,June,1,15,7,-8,14,8,-14,6,UNITA,Isaias Samakvu,ORGANIZATION,PERSON-PERSON,PROPN,PROPN-PROPN,pobj,compound-nsubjpass,NNP,NNP-NNP,2,1
9052,33442.0,24,UTC,2,4,9,5,3,14,-2,7,He,Texas,PERSON,ORGANIZATION,PRON,PROPN,nsubj,poss,PRP,NNP,6,1
9053,33449.0,35,moved,24,5,12,7,4,22,19,-12,Herrera,Phoenix,PERSON,CITY,PROPN,PROPN,nsubj,pobj,NNP,NNP,5,1
9054,60056.0,35,declared,14,4,29,25,3,5,10,15,Herrera,Phoenix,PERSON,CITY,PROPN,PROPN,nsubj,pobj,NNP,NNP,3,1
9055,33467.0,28,founded,2,1,4,3,0,23,1,2,Lashkar-e-Taiba,20 years ago,ORGANIZATION,DATE-DATE-DATE,PROPN,NUM-NOUN-ADV,nsubjpass,nummod-npadvmod-advmod,NNP,CD-NNS-RB,2,1
9056,33472.0,20,born,3,1,14,13,0,5,2,11,Mary Dent,Elizabeth Patch Dent,PERSON-PERSON,PERSON-PERSON-PERSON,PROPN-PROPN,PROPN-PROPN-PROPN,compound-nsubjpass,compound-compound-pobj,NNP-NNP,NNP-NNP-NNP,5,1
9057,33480.0,24,contested,4,2,17,15,1,6,2,13,Awami League,Sylhet,ORGANIZATION-ORGANIZATION,LOCATION,PROPN-PROPN,PROPN,compound-compound,pobj,NNP-NNP,NNP,5,1
9058,33485.0,19,LUMPUR,1,11,8,-3,10,10,-10,7,Abdul Rahim Noor,Inspector-General of Police,PERSON-PERSON-PERSON,TITLE-TITLE-TITLE,PROPN-PROPN-PROPN,PROPN-ADP-PROPN,compound-compound-poss,nsubj-prep-compound,NNP-NNP-NNP,NNP-IN-NNP,3,1
9059,33488.0,29,is,1,1,26,25,0,2,0,25,He,E!,PERSON,ORGANIZATION,PRON,PROPN,nsubj,compound,PRP,NNP,7,1
9060,33491.0,39,died,28,1,14,13,0,24,27,-14,Bradford Washburn,Museum of Science,PERSON-PERSON,ORGANIZATION-ORGANIZATION-ORGANIZATION,PROPN-PROPN,PROPN-ADP-PROPN,compound-nsubj,pobj-prep-pobj,NNP-NNP,NNP-IN-NNP,6,1
9061,33499.0,50,Elektra,5,14,9,-5,13,40,-9,4,FAW,First Automobile Works Group,ORGANIZATION,ORGANIZATION-ORGANIZATION-ORGANIZATION-ORGANIZATION,PROPN,PROPN-PROPN-PROPN-PROPN,compound,compound-compound-compound-dobj,NNP,NNP-NNP-NNP-NNP,3,1
9062,33516.0,33,was,21,8,12,4,7,20,13,-9,her,general director,PERSON,TITLE-TITLE,DET,ADJ-NOUN,poss,amod-pobj,PRP$,JJ-NN,3,1
9063,33550.0,34,studied,4,18,12,-6,17,21,-14,8,his,Balliol College,PERSON,ORGANIZATION-ORGANIZATION,DET,PROPN-PROPN,poss,compound-pobj,PRP$,NNP-NNP,4,1
9064,33558.0,12,survives,9,1,6,5,0,5,8,-3,His,Barbara Teel Polk,PERSON,PERSON-PERSON-PERSON,DET,PROPN-PROPN-PROPN,poss,compound-compound-appos,PRP$,NNP-NNP-NNP,2,1
9065,33560.0,23,played,3,7,13,6,6,9,-4,10,ABA,New Jersey Americans,ORGANIZATION,ORGANIZATION-ORGANIZATION-ORGANIZATION,NOUN,PROPN-PROPN-PROPN,pobj,compound-compound-pobj,NN,NNP-NNP-NNPS,6,1
9066,33568.0,24,knew,10,4,12,8,3,11,6,2,Olivia,her,PERSON,PERSON,PROPN,PRON,nsubj,pobj,NNP,PRP,4,1
9067,33570.0,55,approved,9,28,20,-8,27,34,-19,11,Marsans.Aerolineas Argentinas,Austral,ORGANIZATION-ORGANIZATION,MISC,PROPN-PROPN,PROPN,compound-appos,conj,NNP-NNP,NNP,3,1
9068,33580.0,41,returned,3,9,7,-2,8,33,-6,4,her,U.S.,PERSON,COUNTRY,DET,PROPN,poss,pobj,PRP$,NNP,1,1
9069,34831.0,41,returned,3,9,7,-2,8,33,-6,4,her,U.S.,PERSON,COUNTRY,PRON,PROPN,dobj,pobj,PRP,NNP,1,1
9070,64192.0,20,said,18,17,2,-15,16,17,1,-16,her,U.S.,PERSON,COUNTRY,DET,PROPN,poss,compound,PRP$,NNP,4,1
9071,33600.0,44,said,17,19,39,20,18,4,-2,22,Bill McAllister,Montana,PERSON-PERSON,STATE_OR_PROVINCE,PROPN-PROPN,PROPN,compound-nsubj,pobj,NNP-NNP,NNP,8,1
9072,33604.0,15,practiced,1,1,12,11,0,2,0,11,Derounian,New York,PERSON,STATE_OR_PROVINCE-STATE_OR_PROVINCE,ADJ,PROPN-PROPN,nsubj,compound-compound,JJ,NNP-NNP,5,1
9073,33616.0,56,said,23,18,21,3,17,34,5,-2,Robert Morgenthau,New York,PERSON-PERSON,STATE_OR_PROVINCE-STATE_OR_PROVINCE,PROPN-PROPN,PROPN-PROPN,compound-conj,compound-pobj,NNP-NNP,NNP-NNP,2,1
9074,33642.0,34,said,12,11,8,-3,10,25,1,-4,Peterson,composer,PERSON,TITLE,PROPN,NOUN,nsubj,attr,NNP,NN,3,1
9075,46110.0,32,said,12,11,8,-3,10,23,1,-4,Peterson,composer,PERSON,TITLE,PROPN,NOUN,nsubj,attr,NNP,NN,3,1
9076,33650.0,54,found,12,9,12,3,8,41,3,0,Ghent University,Belgium,ORGANIZATION-ORGANIZATION,COUNTRY,PROPN-PROPN,PROPN,compound-conj,pobj,NNP-NNP,NNP,3,1
9077,43293.0,29,said,11,19,22,3,18,6,-8,11,Ghent University,Belgium,ORGANIZATION-ORGANIZATION,COUNTRY,PROPN-PROPN,PROPN,compound-pobj,pobj,NNP-NNP,NNP,3,1
9078,44700.0,42,gave,17,14,17,3,13,24,3,0,Ghent University,Belgium,ORGANIZATION-ORGANIZATION,COUNTRY,PROPN-PROPN,PROPN,compound-pobj,pobj,NNP-NNP,NNP,2,1
9079,64255.0,20,Delanghe,18,12,15,3,11,4,6,-3,Ghent University,Belgium,ORGANIZATION-ORGANIZATION,COUNTRY,PROPN-PROPN,PROPN,compound-pobj,pobj,NNP-NNP,NNP,5,1
9080,33657.0,21,pulls,10,1,20,19,0,0,9,10,Lindsey Hord,Naples,PERSON-PERSON,CITY,PROPN-PROPN,PROPN,compound-nsubj,pobj,NNP-NNP,NNP,2,1
9081,33666.0,26,said,15,24,17,-7,23,8,-9,2,Citibank China,Anand Selva,ORGANIZATION-ORGANIZATION,PERSON-PERSON,PROPN-PROPN,PROPN-PROPN,compound-pobj,compound-nsubj,NNP-NNP,NNP-NNP,3,1
9082,33686.0,61,acquired,1,9,50,41,8,10,-8,49,she,Brooklyn,PERSON,CITY,PRON,PROPN,nsubj,compound,PRP,NNP,5,1
9083,51978.0,37,Silverman,3,8,6,-2,7,30,-5,3,she,Brooklyn,PERSON,CITY,PRON,PROPN,nsubj,pobj,PRP,NNP,2,1
9084,33705.0,47,died,32,1,37,36,0,9,31,5,Jennifer Dunn,Inova Alexandria,PERSON-PERSON,LOCATION-LOCATION,PROPN-PROPN,PROPN-PROPN,compound-nsubj,compound-compound,NNP-NNP,NNP-NNP,5,1
9085,33714.0,25,VERITY-OBIT-MCC,0,2,5,3,1,19,-2,5,Verity,"Jan 26 , 1917",PERSON,DATE-DATE-DATE-DATE,PROPN,PROPN-NUM-PUNCT-NUM,nsubjpass,npadvmod-nummod-punct-nummod,NNP,"NNP-CD-,-CD",2,1
9086,51822.0,24,born,2,1,4,3,0,19,1,2,Verity,"Jan 26 , 1917",PERSON,DATE-DATE-DATE-DATE,NOUN,PROPN-NUM-PUNCT-NUM,nsubjpass,npadvmod-nummod-punct-nummod,NN,"NNP-CD-,-CD",3,1
9087,33717.0,94,2009-06-03T04,0,36,76,40,35,17,-36,76,Bernama,http://wwwbernamacom/bernama/v5/newsindexphp?id=415205,ORGANIZATION,URL,PROPN,PROPN,compound,ccomp,NNP,NNP,-1,1
9088,33725.0,33,The,0,6,4,-2,5,28,-6,4,APA,Australia,ORGANIZATION,COUNTRY,PROPN,PROPN,compound,pobj,NNP,NNP,3,1
9089,33733.0,25,was,1,1,7,6,0,17,0,6,He,teacher,PERSON,TITLE,PRON,NOUN,nsubj,attr,PRP,NN,2,1
9090,33735.0,44,came,5,39,24,-15,38,19,-34,19,Murat Kurnaz,German,PERSON-PERSON,NATIONALITY,PROPN-PROPN,ADJ,compound-dobj,amod,NNP-NNP,JJ,7,1
9091,48560.0,52,found,1,33,7,-26,32,44,-32,6,Murat Kurnaz,German,PERSON-PERSON,NATIONALITY,PROPN-PROPN,ADJ,compound-poss,amod,NNP-NNP,JJ,-1,1
9092,53356.0,49,accused,8,31,21,-10,30,27,-23,13,Murat Kurnaz,German,PERSON-PERSON,NATIONALITY,PROPN-PROPN,ADJ,compound-nsubj,conj,NNP-NNP,JJ,9,1
9093,61410.0,27,turned,8,5,12,7,4,14,3,4,Murat Kurnaz,German,PERSON-PERSON,NATIONALITY,PROPN-PROPN,ADJ,compound-appos,amod,NNP-NNP,JJ,4,1
9094,33736.0,40,urged,12,8,2,-6,7,37,4,-10,R Nicholas Burns,Secretary of State,PERSON-PERSON-PERSON,ORGANIZATION-ORGANIZATION-ORGANIZATION,PROPN-PROPN-PROPN,PROPN-ADP-PROPN,compound-compound-nsubj,nmod-prep-pobj,NNP-NNP-NNP,NNP-IN-NNP,5,1
9095,33739.0,24,will,2,4,10,6,3,13,-2,8,Jake,Jim Pavelka,PERSON,PERSON-PERSON,PROPN,PROPN-PROPN,poss,compound-conj,NNP,NNP-NNP,4,1
9096,33742.0,36,Council,4,7,32,25,6,3,-3,28,NSC,Yang Hung-dun,ORGANIZATION,PERSON-PERSON,PROPN,PROPN-PROPN,compound,compound-nsubj,NNP,NNP-NNP,5,1
9097,33744.0,22,NASHVILLE,0,7,11,4,6,10,-7,11,Country Music Association,http://wwwcmaworldcom,ORGANIZATION-ORGANIZATION-ORGANIZATION,URL,PROPN-PROPN-PROPN,X,compound-compound-appos,dep,NNP-NNP-NNP,ADD,6,1
9098,33749.0,35,rejected,2,19,14,-5,18,20,-17,12,Moro National Liberation Front,Conference,ORGANIZATION-ORGANIZATION-ORGANIZATION-ORGANIZATION,MISC,PROPN-PROPN-PROPN-PROPN,PROPN,compound-compound-compound-compound,pobj,NNP-NNP-NNP-NNP,NNP,8,1
9099,33754.0,27,",",0,6,9,3,5,17,-6,9,Buchwald,humor columnist,PERSON,TITLE-TITLE,PROPN,NOUN-NOUN,nsubj,compound-appos,NNP,NN-NN,2,1
9100,33793.0,54,include,1,25,15,-10,24,38,-24,14,Frank DeBlanc,Louisiana,PERSON-PERSON,STATE_OR_PROVINCE,PROPN-PROPN,PROPN,compound-appos,conj,NNP-NNP,NNP,3,1
9101,33796.0,38,called,1,18,22,4,17,15,-17,21,Chavez,Sabaneta,PERSON,CITY,PROPN,PROPN,poss,pobj,NNP,NNP,2,1
9102,33798.0,25,Gregory,0,1,12,11,0,12,-1,12,Gregory,NBC,PERSON,ORGANIZATION,NOUN,PROPN,ROOT,pobj,NN,NNP,5,1
9103,33807.0,36,said,33,9,17,8,8,18,24,-16,Denso,Toyota Motor Corp,ORGANIZATION,ORGANIZATION-ORGANIZATION-ORGANIZATION,PROPN,PROPN-PROPN-PROPN,compound,compound-compound-pobj,NNP,NNP-NNP-NNP,4,1
9104,33811.0,26,was,5,13,10,-3,12,15,-8,5,Federal Election Commission,1975,ORGANIZATION-ORGANIZATION-ORGANIZATION,DATE,PROPN-PROPN-PROPN,NUM,compound-compound-pobj,pobj,NNP-NNP-NNP,CD,2,1
9105,43934.0,44,compelled,28,22,18,-4,21,25,6,-10,Federal Election Commission,1975,ORGANIZATION-ORGANIZATION-ORGANIZATION,DATE,PROPN-PROPN-PROPN,NUM,compound-compound-pobj,nummod,NNP-NNP-NNP,CD,2,1
9106,66771.0,24,set,1,5,9,4,4,14,-4,8,Federal Election Commission,1975,ORGANIZATION-ORGANIZATION-ORGANIZATION,DATE,PROPN-PROPN-PROPN,NUM,compound-compound-dobj,pobj,NNP-NNP-NNP,CD,3,1
9107,33822.0,25,served,1,1,5,4,0,19,0,4,Gude,Army Medical Corps,PERSON,ORGANIZATION-ORGANIZATION-ORGANIZATION,PROPN,PROPN-PROPN-PROPN,nsubj,compound-compound-pobj,NNP,NNP-NNP-NNP,3,1
9108,33830.0,18,said,5,1,3,2,0,14,4,-2,DeGeneres,49,PERSON,NUMBER,PROPN,NUM,nsubj,appos,NNP,CD,3,1
9109,33837.0,24,is,2,6,9,3,5,14,-4,7,Johnny Knoxville,36,PERSON-PERSON,NUMBER,PROPN-PROPN,NUM,compound-nsubj,attr,NNP-NNP,CD,3,1
9110,45016.0,6,is,3,2,5,3,1,0,1,2,Johnny Knoxville,36,PERSON-PERSON,NUMBER,PROPN-PROPN,NUM,compound-nsubj,attr,NNP-NNP,CD,2,1
9111,33858.0,52,said,50,19,44,25,18,7,31,-6,Central American Parliament,Nicaragua,ORGANIZATION-ORGANIZATION-ORGANIZATION,ORGANIZATION,ADJ-PROPN-PROPN,PROPN,compound-compound-pobj,conj,JJ-NNP-NNP,NNP,23,1
9112,33867.0,26,Scorpions,1,2,10,8,1,15,-1,9,Scorpions,interior ministry,ORGANIZATION,ORGANIZATION-ORGANIZATION,PROPN,ADJ-NOUN,ROOT,compound-pobj,NNPS,JJ-NN,4,1
9113,33870.0,89,WITH,0,13,80,67,12,8,-13,80,Dewey,Bob Maclestone,PERSON,PERSON-PERSON,PROPN,PROPN-PROPN,compound,compound-compound,NNP,NNP-NNP,-1,1
9114,33872.0,35,survived,2,1,30,29,0,4,1,28,Derounian,Austin,PERSON,ORGANIZATION,PROPN,PROPN,nsubjpass,pobj,NNP,NNP,9,1
9115,33877.0,40,said,6,2,28,26,1,11,4,22,Barbara Boxer,America,PERSON-PERSON,COUNTRY,PROPN-PROPN,PROPN,compound-nsubj,nsubj,NNP-NNP,NNP,3,1
9116,33878.0,36,said,13,10,5,-5,9,30,3,-8,Awami National Party,Adeel,ORGANIZATION-ORGANIZATION-ORGANIZATION,PERSON,PROPN-PROPN-PROPN,PROPN,compound-compound-pobj,pobj,NNP-NNP-NNP,NNP,4,1
9117,33892.0,41,said,39,8,7,-1,7,33,31,-32,Huber,Berthold Huber,PERSON,PERSON-PERSON,PROPN,PROPN-PROPN,nsubj,compound-pobj,NNP,NNP-NNP,1,1
9118,33906.0,49,was,23,12,16,4,11,32,11,-7,25-year-old from Saratoga,Calif,PERSON-PERSON-PERSON,STATE_OR_PROVINCE,NUM-ADP-PROPN,PROPN,appos-prep-pobj,appos,CD-IN-NNP,NNP,3,1
9119,33916.0,36,said,13,10,1,-9,9,34,3,-12,Awami National Party,Zahid Khan,ORGANIZATION-ORGANIZATION-ORGANIZATION,PERSON-PERSON,PROPN-PROPN-PROPN,PROPN-PROPN,compound-compound-pobj,compound-nsubj,NNP-NNP-NNP,NNP-NNP,4,1
9120,33919.0,37,am,2,33,32,-1,32,4,-31,30,Morgenthau,90-year-old,PERSON,DURATION,PROPN,ADJ,pobj,compound,NNPS,JJ,2,1
9121,33931.0,36,acknowledged,2,1,15,14,0,20,1,13,Abu Zubaydah,Muslim,PERSON-PERSON,RELIGION,PROPN-PROPN,ADJ,compound-nsubj,amod,NNP-NNP,JJ,6,1
9122,33940.0,51,died,41,1,50,49,0,0,40,9,Richmond M. Flowers,Ala.,PERSON-PERSON-PERSON,STATE_OR_PROVINCE,PROPN-PROPN-PROPN,PROPN,compound-compound-nsubj,appos,NNP-NNP-NNP,NNP,3,1
9123,33941.0,31,said,25,29,28,-1,28,2,-4,3,Carolyn Maloney,Congresswoman,PERSON-PERSON,TITLE,PROPN-PROPN,PROPN,compound-nsubj,compound,NNP-NNP,NNP,1,1
9124,51465.0,37,decried,15,14,13,-1,13,23,1,-2,Carolyn Maloney,Congresswoman,PERSON-PERSON,TITLE,PROPN-PROPN,PROPN,compound-appos,compound,NNP-NNP,NNP,1,1
9125,56849.0,37,said,10,7,6,-1,6,30,3,-4,Carolyn Maloney,Congresswoman,PERSON-PERSON,TITLE,PROPN-PROPN,PROPN,compound-poss,compound,NNP-NNP,NNP,1,1
9126,60841.0,12,is,1,7,11,4,6,0,-6,10,Carolyn Maloney,Congresswoman,PERSON-PERSON,TITLE,PROPN-PROPN,PROPN,compound-pobj,appos,NNP-NNP,NNP,4,1
9127,33944.0,7,business,2,1,5,4,0,1,1,3,Citibank,India,ORGANIZATION,COUNTRY,PROPN,PROPN,poss,pobj,NNP,NNP,3,1
9128,33961.0,31,lived,12,1,15,14,0,15,11,3,Irene Morgan Kirkaldy,Long Island,PERSON-PERSON-PERSON,LOCATION-LOCATION,PROPN-PROPN-PROPN,PROPN-PROPN,compound-compound-nsubj,compound-pobj,NNP-NNP-NNP,NNP-NNP,4,1
9129,33970.0,31,teamed,1,4,28,24,3,2,-3,27,Chris Simcox,Arizona,PERSON-PERSON,STATE_OR_PROVINCE,PROPN-PROPN,PROPN,compound-pobj,pobj,NNP-NNP,NNP,6,1
9130,33973.0,36,made,2,10,20,10,9,15,-8,18,Alberto Gonzales,Houston,PERSON-PERSON,CITY,PROPN-PROPN,PROPN,compound-poss,pobj,NNP-NNP,NNP,5,1
9131,61165.0,41,acknowledged,7,4,28,24,3,12,3,21,Alberto Gonzales,Houston,PERSON-PERSON,CITY,PROPN-PROPN,PROPN,compound-nsubj,compound,NNP-NNP,NNP,4,1
9132,33976.0,34,signed,8,7,3,-4,6,30,1,-5,SAC,Shenyang Aircraft Corp,ORGANIZATION,ORGANIZATION-ORGANIZATION-ORGANIZATION,PROPN,PROPN-PROPN-PROPN,compound,compound-compound-compound,NNP,NNP-NNP-NNP,3,1
9133,33977.0,37,said,12,20,2,-18,19,34,-8,-10,International Crisis Group,China,ORGANIZATION-ORGANIZATION-ORGANIZATION,COUNTRY,PROPN-PROPN-PROPN,PROPN,compound-compound-pobj,pobj,NNP-NNP-NNP,NNP,5,1
9134,33979.0,29,came,2,7,11,4,6,17,-5,9,Chunghwa Telecom Co.,Taiwan,ORGANIZATION-ORGANIZATION-ORGANIZATION,COUNTRY,PROPN-PROPN-PROPN,PROPN,compound-compound-nsubj,poss,NNP-NNP-NNP,NNP,4,1
9135,40092.0,41,TAIPEI,0,7,3,-4,6,37,-7,3,Chunghwa Telecom Co.,Taiwan,ORGANIZATION-ORGANIZATION-ORGANIZATION,COUNTRY,PROPN-PROPN-PROPN,PROPN,compound-compound-nsubj,poss,NNP-NNP-NNP,NNP,5,1
9136,47258.0,46,said,11,1,5,4,0,40,10,-6,Chunghwa Telecom Co.,Taiwan,ORGANIZATION-ORGANIZATION-ORGANIZATION,COUNTRY,PROPN-PROPN-PROPN,PROPN,compound-compound-nsubj,poss,NNP-NNP-NNP,NNP,4,1
9137,33981.0,24,scheduled,13,1,6,5,0,17,12,-7,Covidien,Tyco Electronics,ORGANIZATION,ORGANIZATION-ORGANIZATION,ADJ,PROPN-PROPN,compound,compound-conj,JJ,NNP-NNP,3,1
9138,34005.0,43,tried,7,22,37,15,21,5,-15,30,MNLF,11 years ago,ORGANIZATION,DATE-DATE-DATE,PROPN,NUM-NOUN-ADV,compound,nummod-npadvmod-advmod,NNP,CD-NNS-RB,4,1
9139,34012.0,20,'s,11,11,9,-2,10,10,0,-2,he,Westlife,PERSON,LOCATION,PRON,PROPN,nsubj,pobj,PRP,NNP,1,1
9140,34016.0,36,approves,3,15,19,4,14,16,-12,16,Illinois Tool Works,http://wwwitwcom/,ORGANIZATION-ORGANIZATION-ORGANIZATION,URL,PROPN-PROPN-VERB,PROPN,compound-compound-ROOT,ROOT,NNP-NNP-VBZ,NNP,6,1
9141,34022.0,21,respond,12,6,3,-3,5,17,6,-9,Vernon Bellecourt,Clyde Bellecourt,PERSON-PERSON,PERSON-PERSON,PROPN-PROPN,PROPN-PROPN,compound-poss,compound-nsubj,NNP-NNP,NNP-NNP,2,1
9142,34049.0,35,said,14,8,3,-5,7,31,6,-11,Taiwan Research Institute,Liu Guosheng,ORGANIZATION-ORGANIZATION-ORGANIZATION,PERSON-PERSON,PROPN-PROPN-PROPN,PROPN-PROPN,compound-compound-pobj,compound-nsubj,NNP-NNP-NNP,NNP-NNP,4,1
9143,34052.0,38,causes,2,22,26,4,21,11,-20,24,Canadian National Railway,CN Railway,ORGANIZATION-ORGANIZATION-ORGANIZATION,ORGANIZATION-ORGANIZATION,PROPN-PROPN-PROPN,PROPN-PROPN,compound-compound-compound,compound-compound,NNP-NNP-NNP,NNP-NNP,5,1
9144,34054.0,30,said,16,24,26,2,23,3,-8,10,ADB,Private Sector Operations Department,ORGANIZATION,ORGANIZATION-ORGANIZATION-ORGANIZATION-ORGANIZATION,PROPN,PROPN-PROPN-PROPN-PROPN,poss,compound-compound-compound-pobj,NNP,NNP-NNP-NNP-NNP,4,1
9145,55039.0,50,said,35,15,46,31,14,3,20,11,ADB,Private Sector Operations Department,ORGANIZATION,ORGANIZATION-ORGANIZATION-ORGANIZATION-ORGANIZATION,PROPN,PROPN-PROPN-PROPN-PROPN,pobj,compound-compound-compound-attr,NNP,NNP-NNP-NNP-NNP,6,1
9146,34063.0,50,is,19,40,41,1,39,8,-21,22,Representatives,Michael Costello,ORGANIZATION,PERSON-PERSON,PROPN,PROPN-PROPN,compound,compound-conj,NNPS,NNP-NNP,3,1
9147,34066.0,30,moving,10,28,5,-23,27,24,-18,-5,USA Network,General Electric Co.,ORGANIZATION-ORGANIZATION,ORGANIZATION-ORGANIZATION-ORGANIZATION,PROPN-PROPN,PROPN-PROPN-PROPN,compound-appos,compound-compound-pobj,NNP-NNP,NNP-NNP-NNP,-1,1
9148,34067.0,39,said,35,9,12,3,8,26,26,-23,NSC,Nigeria,ORGANIZATION,COUNTRY,PROPN,PROPN,compound,poss,NNP,NNP,3,1
9149,34076.0,25,appointed,2,1,8,7,0,16,1,6,DeBlanc,USNR,PERSON,ORGANIZATION,PROPN,PROPN,nsubjpass,appos,NNP,NNP,3,1
9150,34082.0,31,said,13,15,30,15,14,0,-2,17,William Anderson,Adidas,PERSON-PERSON,ORGANIZATION,PROPN-PROPN,PROPN,compound-nsubj,pobj,NNP-NNP,NNP,6,1
9151,34089.0,19,held,4,17,7,-10,16,11,-13,3,Philadelphia Inquirer,Lou Ureneck,ORGANIZATION-ORGANIZATION,PERSON-PERSON,PROPN-PROPN,PROPN-PROPN,compound-pobj,compound-pobj,NNP-NNP,NNP-NNP,3,1
9152,34093.0,30,Chen,0,5,3,-2,4,26,-5,3,Lee Jye,defence,PERSON-PERSON,ORGANIZATION,PROPN-PROPN,NOUN,compound-conj,compound,NNP-NNP,NN,1,1
9153,34124.0,30,served,1,1,5,4,0,24,0,4,She,writer,PERSON,TITLE,PRON,NOUN,nsubj,pobj,PRP,NN,3,1
9154,34144.0,43,tried,7,17,28,11,16,14,-10,21,Moro National Liberation Front,separatist,ORGANIZATION-ORGANIZATION-ORGANIZATION-ORGANIZATION,RELIGION,PROPN-PROPN-PROPN-PROPN,ADJ,compound-compound-compound-pobj,amod,NNP-NNP-NNP-NNP,JJ,9,1
9155,67981.0,37,was,1,6,29,23,5,7,-5,28,Moro National Liberation Front,separatist,ORGANIZATION-ORGANIZATION-ORGANIZATION-ORGANIZATION,IDEOLOGY,PROPN-PROPN-PROPN-PROPN,ADJ,compound-compound-compound-pobj,amod,NNP-NNP-NNP-NNP,JJ,10,1
9156,34147.0,41,said,35,30,34,4,29,6,5,-1,NEC,Takao Ono,ORGANIZATION,PERSON-PERSON,PROPN,PROPN-PROPN,nmod,compound-nsubj,NNP,NNP-NNP,4,1
9157,61129.0,39,told,36,31,35,4,30,3,5,-1,NEC,Takao Ono,ORGANIZATION,PERSON-PERSON,PROPN,PROPN-PROPN,npadvmod,compound-nsubj,NNP,NNP-NNP,2,1
9158,34154.0,41,needs,2,35,21,-14,34,19,-33,19,Le Point,France,ORGANIZATION-ORGANIZATION,COUNTRY,PROPN-PROPN,PROPN,compound-pobj,pobj,NNP-NNP,NNP,9,1
9159,53092.0,23,described,2,5,17,12,4,5,-3,15,Le Point,France,ORGANIZATION-ORGANIZATION,COUNTRY,PROPN-PROPN,PROPN,compound-poss,poss,NNP-NNP,NNP,9,1
9160,34158.0,21,made,13,4,13,9,3,7,9,0,she,25-year-old,PERSON,NUMBER,PRON,NUM,nsubj,nsubj,PRP,CD,4,1
9161,34166.0,41,said,5,4,3,-1,3,37,1,-2,Marco Contiero,campaigner,PERSON-PERSON,TITLE,PROPN-PROPN,NOUN,compound-nsubj,compound,NNP-NNP,NN,1,1
9162,34173.0,27,won,1,1,6,5,0,20,0,5,He,U.S. House of Representatives,PERSON,ORGANIZATION-ORGANIZATION-ORGANIZATION-ORGANIZATION,PRON,PROPN-PROPN-ADP-PROPN,nsubj,compound-pobj-prep-pobj,PRP,NNP-NNP-IN-NNPS,2,1
9163,34176.0,46,started,1,1,7,6,0,38,0,6,Abrams,analyst,PERSON,TITLE,PROPN,NOUN,nsubj,pobj,NNP,NN,3,1
9164,66074.0,41,described,32,13,18,5,12,22,19,-14,Abrams,analyst,PERSON,TITLE,PROPN,NOUN,poss,appos,NNP,NN,3,1
9165,34177.0,65,survived,2,18,42,24,17,22,-16,40,Sherwood Morgan Jr.,Justine Walker,PERSON-PERSON-PERSON,PERSON-PERSON,PROPN-PROPN-PROPN,PROPN-PROPN,compound-compound-appos,compound-appos,NNP-NNP-NNP,NNP-NNP,10,1
9166,34183.0,51,died,44,3,47,44,2,3,41,3,Robert E. McNair,Nov. 17,PERSON-PERSON-PERSON,DATE-DATE,PROPN-PROPN-PROPN,PROPN-NUM,compound-compound-nsubj,pobj-nummod,NNP-NNP-NNP,NNP-CD,5,1
9167,34190.0,46,said,14,29,32,3,28,13,-15,18,CPS,Ken Macdonald,ORGANIZATION,PERSON-PERSON,NOUN,PROPN-PROPN,compound,compound-pobj,NN,NNP-NNP,3,1
9168,34191.0,36,saw,6,12,32,20,11,3,-6,26,Paavo Nurmi,Olympian,PERSON-PERSON,MISC,PROPN-PROPN,PROPN,compound-appos,pobj,NNP-NNP,NNP,7,1
9169,34196.0,27,were,4,10,13,3,9,13,-6,9,SAC,Europe,ORGANIZATION,LOCATION,PROPN,PROPN,compound,pobj,NNP,NNP,3,1
9170,34199.0,21,said,6,1,5,4,0,15,5,-1,Kennedy Space Center,Bill Parsons,ORGANIZATION-ORGANIZATION-ORGANIZATION,PERSON-PERSON,PROPN-PROPN-PROPN,PROPN-PROPN,compound-compound-compound,compound-nsubj,NNP-NNP-NNP,NNP-NNP,3,1
9171,34210.0,18,commissed,6,12,8,-4,11,9,-6,2,Charles Wuorinen,70-year-old,PERSON-PERSON,DURATION,PROPN-PROPN,NUM,compound-dobj,amod,NNP-NNP,CD,4,1
9172,34212.0,11,BORN,0,1,8,7,0,2,-1,8,BORN,Stevenage,PERSON,CITY,PROPN,PROPN,ROOT,nmod,NNP,NNP,4,1
9173,34223.0,65,Directed,0,8,50,42,7,14,-8,50,Justin Theroux,Stuart Cornfeld,PERSON-PERSON,PERSON-PERSON,PROPN-PROPN,PROPN-PROPN,compound-pobj,compound-pobj,NNP-NNP,NNP-NNP,8,1
9174,34232.0,32,made,5,13,4,-9,12,27,-8,-1,council,Tung Cheng-yuan,ORGANIZATION,PERSON-PERSON,NOUN,PROPN-PROPN,pobj,compound-nsubj,NN,NNP-NNP,7,1
9175,34236.0,15,seems,10,8,4,-4,7,10,2,-6,Olivia Palermo,New York,PERSON-PERSON,CITY-CITY,PROPN-PROPN,PROPN-PROPN,compound-appos,compound-compound,NNP-NNP,NNP-NNP,2,1
9176,34250.0,36,made,5,1,4,3,0,31,4,-1,Chunghwa Telecom,Ho Chen-tan,ORGANIZATION-ORGANIZATION,PERSON-PERSON,PROPN-PROPN,PROPN-X,compound-compound,nsubj-nsubj,NNP-NNP,NNP-XX,3,1
9177,45868.0,39,joined,4,17,20,3,16,18,-13,16,Chunghwa Telecom,Ho Chen-tan,ORGANIZATION-ORGANIZATION,PERSON-PERSON,PROPN-PROPN,PROPN-X,conj-compound,compound-pobj,NNP-NNP,NNP-XX,3,1
9178,34259.0,18,died,14,4,6,2,3,11,10,-8,she,Walter P. Offutt Jr.,PERSON,PERSON-PERSON-PERSON-PERSON,PRON,PROPN-PROPN-PROPN-PROPN,nsubj,compound-compound-compound-dobj,PRP,NNP-NNP-NNP-NNP,2,1
9179,34261.0,32,survived,7,16,12,-4,15,19,-9,5,Silvestre,his,PERSON,PERSON,PROPN,DET,appos,poss,NNP,PRP$,3,1
9180,34262.0,52,died,37,1,15,14,0,36,36,-22,Pamela Gardner Ahearn,U.S. House of Representatives,PERSON-PERSON-PERSON,ORGANIZATION-ORGANIZATION-ORGANIZATION-ORGANIZATION,PROPN-PROPN-PROPN,PROPN-PROPN-ADP-PROPN,compound-compound-nsubj,compound-pobj-prep-pobj,NNP-NNP-NNP,NNP-NNP-IN-NNPS,7,1
9181,34264.0,32,threatened,20,1,5,4,0,26,19,-15,Watson,Sea Shepherd,PERSON,ORGANIZATION-ORGANIZATION,PROPN,PROPN-PROPN,nsubj,compound-dobj,NNP,NNP-NNP,3,1
9182,35748.0,46,given,4,6,40,34,5,5,-2,36,Watson,Sea Shepherd,PERSON,ORGANIZATION-ORGANIZATION,PROPN,PROPN-PROPN,compound,compound-poss,NNP,NNP-NNP,6,1
9183,47320.0,30,accused,6,4,1,-3,3,28,2,-5,Watson,Sea Shepherd,PERSON,ORGANIZATION-ORGANIZATION,PROPN,PROPN-PROPN,nsubjpass,compound-poss,NNP,NNP-NNP,3,1
9184,34266.0,35,expected,17,1,6,5,0,28,16,-11,Ray Ferrara,ProVise Management Group,PERSON-PERSON,ORGANIZATION-ORGANIZATION-ORGANIZATION,PROPN-PROPN,PROPN-PROPN-PROPN,compound-nsubj,nmod-nmod-nmod,NNP-NNP,NNP-NNP-NNP,5,1
9185,34277.0,14,was,1,1,3,2,0,10,0,2,Kaiser,assistant secretary of labor,PERSON,TITLE-TITLE-TITLE-TITLE,PROPN,ADJ-NOUN-ADP-NOUN,nsubj,amod-attr-prep-pobj,NNP,JJ-NN-IN-NN,1,1
9186,34293.0,44,declared,24,36,30,-6,35,13,-12,6,ABA,Neal Sonnett,ORGANIZATION,PERSON-PERSON,PROPN,PROPN-PROPN,compound,compound-nsubj,NNP,NNP-NNP,4,1
9187,34299.0,31,involved,3,1,15,14,0,15,2,12,He,Bureau of Indian Affairs,PERSON,ORGANIZATION-ORGANIZATION-ORGANIZATION-ORGANIZATION,PRON,PROPN-ADP-PROPN-PROPN,nsubjpass,pobj-prep-compound-compound,PRP,NNP-IN-NNP-NNPS,8,1
9188,34314.0,63,reverend,25,57,18,-39,56,44,-32,-7,Danny Glover,Ryan,PERSON-PERSON,PERSON,PROPN-PROPN,PROPN,compound-compound,compound,NNP-NNP,NNP,-1,1
9189,34330.0,26,Parker,0,1,3,2,0,22,-1,3,Parker,27,PERSON,NUMBER,PROPN,NUM,ROOT,appos,NNP,CD,2,1
9190,34340.0,22,honored,4,1,16,15,0,5,3,12,Yolanda King,Smith College,PERSON-PERSON,ORGANIZATION-ORGANIZATION,PROPN-PROPN,PROPN-PROPN,compound-nsubjpass,compound-conj,NNP-NNP,NNP-NNP,8,1
9191,34364.0,32,survived,7,16,4,-12,15,27,-9,-3,Silvestre,Kempfer,PERSON,PERSON,PROPN,PROPN,appos,pobj,NNP,NNP,7,1
9192,34378.0,25,said,23,1,1,0,0,23,22,-22,Lashkar-e-Taiba al-Almi,Lashkar-e-Taiba,ORGANIZATION-ORGANIZATION,ORGANIZATION,PROPN-PROPN,PROPN,compound-nsubj,pobj,NNP-NNP,NNP,0,1
9193,34394.0,24,said,8,10,5,-5,9,18,-2,-3,Burns,the State Department,PERSON,ORGANIZATION-ORGANIZATION-ORGANIZATION,PROPN,DET-PROPN-PROPN,nsubj,det-compound-compound,NNP,DT-NNP-NNP,5,1
9194,34401.0,39,says,28,35,30,-5,34,8,-7,2,the Tax Policy Center,Len Burman,ORGANIZATION-ORGANIZATION-ORGANIZATION-ORGANIZATION,PERSON-PERSON,DET-PROPN-PROPN-PROPN,PROPN-PROPN,det-compound-compound-pobj,compound-nsubj,DT-NNP-NNP-NNP,NNP-NNP,5,1
9195,34414.0,29,sentenced,1,10,7,-3,9,21,-9,6,Hashim Ahmad al-Tai,defense minister,PERSON-PERSON-PERSON,TITLE-TITLE,PROPN-PROPN-X,NOUN-NOUN,compound-attr-punct,compound-compound,NNP-NNP-ADD,NN-NN,2,1
9196,34439.0,53,ordered,12,27,51,24,26,1,-15,39,NSC,Erlin,ORGANIZATION,LOCATION,PROPN,PROPN,compound,compound,NNP,NNP,-1,1
9197,34441.0,33,said,27,23,26,3,22,6,4,-1,ADB,Ursula Schaefer-Preuss,ORGANIZATION,PERSON-PERSON,PROPN,PROPN-PROPN,compound,compound-nsubj,NNP,NNP-NNP,3,1
9198,34445.0,35,used,2,2,14,12,1,20,0,12,MNLF,Islamic,ORGANIZATION,IDEOLOGY,PROPN,ADJ,nsubj,amod,NNP,JJ,5,1
9199,34448.0,36,backs,1,3,23,20,2,12,-2,22,Danny Glover,director,PERSON-PERSON,TITLE,PROPN-PROPN,NOUN,compound-poss,compound,NNP-NNP,NN,-1,1
9200,34449.0,42,left,30,4,11,7,3,30,26,-19,she,House Administration Committee,PERSON,ORGANIZATION-ORGANIZATION-ORGANIZATION,PRON,PROPN-PROPN-PROPN,nsubj,compound-compound-pobj,PRP,NNP-NNP-NNP,5,1
9201,34456.0,24,won,17,16,4,-12,15,19,1,-13,younger Dodd,Thomas J Dodd,PERSON-PERSON,PERSON-PERSON-PERSON,ADJ-PROPN,PROPN-PROPN-PROPN,amod-nsubj,compound-compound-appos,JJR-NNP,NNP-NNP-NNP,5,1
9202,34458.0,20,played,8,2,8,6,1,11,6,0,22-year old native,Oregon,PERSON-PERSON-PERSON,STATE_OR_PROVINCE,ADJ-ADJ-NOUN,PROPN,nummod-amod-advcl,nsubj,JJ-JJ-NN,NNP,5,1
9203,34459.0,28,was,6,6,19,13,5,8,0,13,he,University of Texas at Austin,PERSON,ORGANIZATION-ORGANIZATION-ORGANIZATION-ORGANIZATION-ORGANIZATION,PRON,PROPN-ADP-PROPN-ADP-PROPN,nsubj,pobj-prep-pobj-prep-pobj,PRP,NNP-IN-NNP-IN-NNP,4,1
9204,34479.0,44,said,25,34,36,2,33,7,-9,11,ADB,South Asia Department,ORGANIZATION,ORGANIZATION-ORGANIZATION-ORGANIZATION,PROPN,PROPN-PROPN-PROPN,poss,compound-compound-pobj,NNP,NNP-NNP-NNP,3,1
9205,48669.0,42,said,29,37,39,2,36,2,-8,10,ADB,South Asia Department,ORGANIZATION,ORGANIZATION-ORGANIZATION-ORGANIZATION,PROPN,PROPN-PROPN-PROPN,poss,compound-compound-pobj,NNP,NNP-NNP-NNP,3,1
9206,34485.0,58,include,1,11,20,9,10,37,-10,19,Adrienne Gude,Gregory Gude,PERSON-PERSON,PERSON-PERSON,PROPN-PROPN,PROPN-PROPN,compound-conj,compound-conj,NNP-NNP,NNP-NNP,4,1
9207,34492.0,35,survived,2,5,27,22,4,7,-3,25,his,Eleanor Derounian,PERSON,PERSON-PERSON,DET,PROPN-PROPN,poss,compound-conj,PRP$,NNP-NNP,6,1
9208,34497.0,16,represented,8,1,7,6,0,8,7,-1,Hawkins,Gus,PERSON,PERSON,PROPN,PROPN,nsubj,pobj,NNP,NNP,3,1
9209,34500.0,52,declared,4,12,40,28,11,11,-8,36,Lashkar-e-Taiba,Saeed,ORGANIZATION,PERSON,PROPN,PROPN,pobj,dobj,NNP,NNP,7,1
9210,68120.0,25,run,2,20,1,-19,19,23,-18,-1,Lashkar-e-Taiba,Saeed,ORGANIZATION,PERSON,PROPN,PROPN,appos,nsubj,NNP,NNP,10,1
9211,34518.0,10,finds,2,10,9,-1,9,0,-8,7,Sculfor,model,PERSON,TITLE,PROPN,NOUN,appos,compound,NNP,NN,-1,1
9212,34521.0,11,died,7,1,4,3,0,6,6,-3,Her,Coretta Scott Kind,PERSON,PERSON-PERSON-PERSON,DET,PROPN-PROPN-PROPN,poss,compound-compound-appos,PRP$,NNP-NNP-NNP,2,1
9213,34534.0,30,said,12,12,9,-3,11,20,0,-3,Farrow,Connecticut,PERSON,STATE_OR_PROVINCE,PROPN,PROPN,nsubj,compound,NNP,NNP,3,1
9214,34546.0,18,died,1,4,16,12,3,1,-3,15,her,pulmonary embolism,PERSON,CAUSE_OF_DEATH-CAUSE_OF_DEATH,DET,ADJ-NOUN,poss,amod-pobj,PRP$,JJ-NN,6,1
9215,34547.0,13,died,9,6,1,-5,5,11,3,-8,Louise B. DeBlanc,Col.,PERSON-PERSON-PERSON,TITLE,PROPN-PROPN-PROPN,PROPN,compound-compound-appos,compound,NNP-NNP-NNP,NNP,4,1
9216,34558.0,15,Q,0,13,7,-6,12,7,-13,7,Carnival Cruise Lines,John Heald,ORGANIZATION-ORGANIZATION-ORGANIZATION,PERSON-PERSON,PROPN-PROPN-NOUN,PROPN-PROPN,compound-compound-pobj,compound-pobj,NNP-NNP-NNS,NNP-NNP,4,1
9217,34566.0,58,was,2,9,12,3,8,45,-7,10,Brad Washburn,27,PERSON-PERSON,NUMBER,PROPN-PROPN,NUM,compound-appos,attr,NNP-NNP,CD,4,1
9218,34582.0,43,trying,11,21,32,11,20,10,-10,21,Ownit Mortgage Solutions,late last year,ORGANIZATION-ORGANIZATION-ORGANIZATION,DATE-DATE-DATE,PROPN-PROPN-PROPN,ADV-ADJ-NOUN,compound-compound-pobj,advmod-amod-npadvmod,NNP-NNP-NNPS,RB-JJ-NN,5,1
9219,34602.0,31,said,6,5,3,-2,4,27,1,-3,Gholam-Ali Haddad-Adel,Majlis,PERSON-PERSON,ORGANIZATION,PROPN-PROPN,PROPN,compound-nsubj,compound,NNP-NNP,NNP,2,1
9220,34613.0,36,hooked,18,24,22,-2,23,13,-6,4,Adam Senn,Gucci,PERSON-PERSON,ORGANIZATION,PROPN-PROPN,PROPN,compound-pobj,compound,NNP-NNP,NNP,1,1
9221,57155.0,40,is,15,19,17,-2,18,22,-4,2,Adam Senn,Gucci,PERSON-PERSON,ORGANIZATION,PROPN-PROPN,PROPN,compound-attr,compound,NNP-NNP,NNP,3,1
9222,34614.0,26,retired,2,1,7,6,0,18,1,5,He,Beaufort,PERSON,CITY,PRON,PROPN,nsubj,poss,PRP,NNP,6,1
9223,34616.0,47,survived,2,1,24,23,0,22,1,22,Henebry,Patricia Callahan,PERSON,PERSON-PERSON,NOUN,PROPN-PROPN,nsubjpass,compound-appos,NN,NNP-NNP,3,1
9224,34623.0,33,admits,6,4,1,-3,3,31,2,-5,FMCSA,Hill,ORGANIZATION,PERSON,NOUN,PROPN,compound,nsubj,NN,NNP,2,1
9225,34626.0,29,was,13,13,11,-2,12,17,0,-2,King,Alabama,PERSON,STATE_OR_PROVINCE,PROPN,PROPN,nsubj,appos,NNP,NNP,1,1
9226,34627.0,56,died,36,2,46,44,1,9,34,10,Jefferson J. DeBlanc Sr.,pneumonia,PERSON-PERSON-PERSON-PERSON,CAUSE_OF_DEATH,PROPN-PROPN-PROPN-PROPN,NOUN,compound-compound-compound-nsubj,pobj,NNP-NNP-NNP-NNP,NN,-1,1
9227,34640.0,37,said,24,33,18,-15,32,18,-9,-6,Myers,president,PERSON,TITLE,PROPN,NOUN,dobj,poss,NNP,NN,6,1
9228,34645.0,22,said,1,3,16,13,2,5,-2,15,Yolanda King,activist,PERSON-PERSON,TITLE,PROPN-PROPN,NOUN,compound-nsubj,conj,NNP-NNP,NN,5,1
9229,34654.0,54,said,49,21,12,-9,20,41,28,-37,he,Ohio,PERSON,STATE_OR_PROVINCE,PRON,PROPN,nsubj,pobj,PRP,NNP,12,1
9230,45573.0,54,said,49,21,12,-9,20,41,28,-37,he,Ohio,PERSON,STATE_OR_PROVINCE,PRON,PROPN,nsubj,pobj,PRP,NNP,12,1
9231,34686.0,41,holds,13,31,3,-28,30,37,-18,-10,Red Sox,New England Sports Ventures,ORGANIZATION-ORGANIZATION,ORGANIZATION-ORGANIZATION-ORGANIZATION-ORGANIZATION,PROPN-PROPN,PROPN-PROPN-PROPN-PROPN,compound-dobj,compound-compound-compound-pobj,NNP-NNPS,NNP-NNP-NNPS-NNPS,8,1
9232,51101.0,46,paid,2,21,13,-8,20,32,-19,11,Red Sox,New England Sports Ventures,ORGANIZATION-ORGANIZATION,ORGANIZATION-ORGANIZATION-ORGANIZATION-ORGANIZATION,PROPN-PROPN,PROPN-PROPN-PROPN-PROPN,compound-dobj,compound-compound-compound-pobj,NNP-NNPS,NNP-NNP-NNPS-NNPS,3,1
9233,34693.0,31,said,21,27,23,-4,26,7,-6,2,IMF,Vasuki Shastry,ORGANIZATION,PERSON-PERSON,PROPN,PROPN-PROPN,compound,compound-nsubj,NNP,NNP-NNP,3,1
9234,34699.0,44,died,26,16,28,12,15,15,10,2,her,March 24,PERSON,DATE-DATE,DET,PROPN-NUM,poss,npadvmod-nummod,PRP$,NNP-CD,5,1
9235,34707.0,18,Truth,2,5,9,4,4,8,-3,7,Child Protective Services,Foster care,ORGANIZATION-ORGANIZATION-ORGANIZATION,ORGANIZATION-ORGANIZATION,PROPN-PROPN-PROPN,PROPN-NOUN,compound-compound-pobj,compound-conj,NNP-NNP-NNPS,NNP-NN,2,1
9236,34732.0,28,came,4,7,3,-4,6,24,-3,-1,Spelman,Sylvia Bozeman,ORGANIZATION,PERSON-PERSON,PROPN,PROPN-PROPN,pobj,compound-nsubj,NNP,NNP-NNP,2,1
9237,34741.0,29,found,2,1,16,15,0,12,1,14,Bond,Atlanta,PERSON,CITY,NOUN,PROPN,nsubj,pobj,NN,NNP,2,1
9238,34750.0,24,worked,7,22,11,-11,21,12,-15,4,Oscar Peterson,director,PERSON-PERSON,TITLE,PROPN-PROPN,NOUN,compound-conj,pobj,NNP-NNP,NN,3,1
9239,34763.0,24,become,12,4,1,-3,3,22,8,-11,Carnival Corp,David Bernstein,ORGANIZATION-ORGANIZATION,PERSON-PERSON,PROPN-PROPN,PROPN-PROPN,compound-poss,compound-nsubj,NNP-NNP,NNP-NNP,2,1
9240,34792.0,52,took,11,1,39,38,0,12,10,28,Salehi,diplomat,PERSON,TITLE,PROPN,NOUN,nsubj,appos,NNP,NN,8,1
9241,34797.0,19,went,2,13,10,-3,12,8,-11,8,Jacksonville Jaguars,Tom Coughlin,ORGANIZATION-ORGANIZATION,PERSON-PERSON,PROPN-PROPN,PROPN-PROPN,compound-pobj,compound-poss,NNP-NNPS,NNP-NNP,3,1
9242,34799.0,32,said,30,4,29,25,3,2,26,-1,Carnival Cruise Lines,Vance Gulliksen,ORGANIZATION-ORGANIZATION-ORGANIZATION,PERSON-PERSON,PROPN-PROPN-NOUN,PROPN-PROPN,compound-compound-nsubj,compound-nsubj,NNP-NNP-NNS,NNP-NNP,4,1
9243,34824.0,23,earned,10,10,5,-5,9,17,0,-5,Scheider,Orange,PERSON,CITY,PROPN,PROPN,nsubj,pobj,NNP,NNP,4,1
9244,34839.0,42,picked,7,29,16,-13,28,25,-22,9,Andre Carson,superdelegates,PERSON-PERSON,TITLE,PROPN-PROPN,NOUN,compound-appos,pobj,NNP-NNP,NNS,2,1
9245,36278.0,39,picked,6,26,13,-13,25,25,-20,7,Andre Carson,superdelegates,PERSON-PERSON,TITLE,PROPN-PROPN,NOUN,compound-appos,pobj,NNP-NNP,NNS,2,1
9246,34857.0,38,said,28,1,6,5,0,31,27,-22,Kate,Jon,PERSON,PERSON,PROPN,PROPN,nsubj,pobj,NNP,NNP,3,1
9247,34883.0,37,said,34,3,1,-2,2,35,31,-33,Itochu Corporation,Japan,ORGANIZATION-ORGANIZATION,COUNTRY,PROPN-PROPN,PROPN,compound-nsubj,poss,NNP-NNP,NNP,2,1
9248,45513.0,29,announced,10,27,25,-2,26,3,-17,15,Itochu Corporation,Japan,ORGANIZATION-ORGANIZATION,COUNTRY,PROPN-PROPN,PROPN,compound-pobj,poss,NNP-NNP,NNP,2,1
9249,34902.0,39,took,3,9,6,-3,8,32,-6,3,Mahmood Shah,police chief Major,PERSON-PERSON,TITLE-TITLE-TITLE,PROPN-PROPN,NOUN-NOUN-PROPN,compound-dobj,compound-compound-compound,NNP-NNP,NN-NN-NNP,1,1
9250,34919.0,22,born,2,1,10,9,0,11,1,8,Deaver,Bakersfield,PERSON,CITY,PROPN,PROPN,nsubjpass,pobj,NNP,NNP,4,1
9251,34929.0,21,husband,1,1,3,2,0,17,0,2,My,Tom,PERSON,PERSON,DET,PROPN,poss,appos,PRP$,NNP,1,1
9252,34934.0,44,expressed,19,12,17,5,11,26,7,-2,he,Brazil,PERSON,COUNTRY,PRON,PROPN,nsubjpass,pobj,PRP,NNP,4,1
9253,34938.0,44,was,2,1,10,9,0,33,1,8,Jennifer Dunn,Republican Party,PERSON-PERSON,ORGANIZATION-ORGANIZATION,PROPN-PROPN,PROPN-PROPN,compound-nsubj,compound-pobj,NNP-NNP,NNP-NNP,4,1
9254,34939.0,15,dies,12,3,1,-2,2,13,9,-11,Parren Mitchell,U.S.,PERSON-PERSON,COUNTRY,PROPN-PROPN,PROPN,compound-nsubj,compound,NNP-NNP,NNP,1,1
9255,34941.0,20,is,1,17,1,-16,16,18,-16,0,American Psychological Association,He,ORGANIZATION-ORGANIZATION-ORGANIZATION,PERSON,PROPN-PROPN-PROPN,PRON,compound-compound-pobj,nsubj,NNP-NNP-NNP,PRP,5,1
9256,34946.0,24,wrote,2,17,1,-16,16,22,-15,-1,he,Rev.,PERSON,TITLE,PRON,PROPN,nsubj,compound,PRP,NNP,5,1
9257,34954.0,31,said,11,8,10,2,7,20,3,-1,IMF,Christoph Rosenberg,ORGANIZATION,PERSON-PERSON,PROPN,PROPN-PROPN,compound,compound-nsubj,NNP,NNP-NNP,1,1
9258,34958.0,33,DIRECTOR,1,4,2,-2,3,30,-3,1,Justin Theroux,DIRECTOR,PERSON-PERSON,TITLE,PROPN-PROPN,PROPN,compound-compound,ROOT,NNP-NNP,NNP,2,1
9259,34969.0,56,vans,3,25,28,3,24,27,-22,25,Fyffes,Britain,ORGANIZATION,COUNTRY,PROPN,PROPN,nsubj,pobj,NNP,NNP,2,1
9260,34970.0,31,graduated,19,19,16,-3,18,14,0,-3,she,Harry Dent,PERSON,PERSON-PERSON,PRON,PROPN-PROPN,nsubj,compound-conj,PRP,NNP-NNP,10,1
9261,34971.0,44,said,15,19,6,-13,18,37,-4,-9,he,representative,PERSON,TITLE,PRON,NOUN,nsubj,nsubj,PRP,NN,4,1
9262,47700.0,45,said,11,15,6,-9,14,38,-4,-5,he,representative,PERSON,TITLE,PRON,NOUN,nsubj,nsubj,PRP,NN,4,1
9263,64119.0,46,DAMASCUS,0,19,5,-14,18,40,-19,5,he,representative,PERSON,TITLE,PRON,NOUN,nsubj,nsubj,PRP,NN,4,1
9264,65079.0,49,DAMASCUS,0,20,5,-15,19,43,-20,5,he,representative,PERSON,TITLE,PRON,NOUN,nsubj,nsubj,PRP,NN,4,1
9265,34976.0,50,made,18,11,14,3,10,35,7,-4,Justin Theroux,36,PERSON-PERSON,NUMBER,PROPN-PROPN,NUM,compound-conj,appos,NNP-NNP,CD,2,1
9266,34979.0,21,-LRB-,2,1,9,8,0,11,1,7,Paul Kim,Saratoga,PERSON-PERSON,CITY,PROPN-PROPN,PROPN,compound-compound,pobj,NNP-NNP,NNP,4,1
9267,34982.0,18,remember,15,10,1,-9,9,16,5,-14,Massachusetts House of Representatives,Salvatore F. DiMasi,ORGANIZATION-ORGANIZATION-ORGANIZATION-ORGANIZATION,PERSON-PERSON-PERSON,PROPN-PROPN-ADP-PROPN,PROPN-PROPN-PROPN,compound-pobj-prep-pobj,compound-compound-nsubj,NNP-NNP-IN-NNPS,NNP-NNP-NNP,4,1
9268,34984.0,25,said,20,17,19,2,16,5,3,-1,ARD,Fritz Raff,ORGANIZATION,PERSON-PERSON,PROPN,PROPN-PROPN,compound,compound-nsubj,NNP,NNP-NNP,3,1
9269,34992.0,30,buried,19,1,13,12,0,16,18,-6,McNair,Low Country of South Carolina,PERSON,LOCATION-LOCATION-LOCATION-LOCATION-LOCATION,PROPN,PROPN-PROPN-ADP-PROPN-PROPN,nsubjpass,compound-pobj-prep-compound-pobj,NNP,NNP-NNP-IN-NNP-NNP,4,1
9270,34997.0,19,was,4,7,17,10,6,1,-3,13,Augustus F. Hawkins,98th Congresses,PERSON-PERSON-PERSON,ORGANIZATION-ORGANIZATION,PROPN-PROPN-PROPN,ADJ-PROPN,compound-compound-attr,conj-pobj,NNP-NNP-NNP,JJ-NNPS,6,1
9271,35006.0,59,Share,0,14,35,21,13,23,-14,35,Cowell,Fox,PERSON,ORGANIZATION,PROPN,PROPN,poss,pobj,NNP,NNP,10,1
9272,35017.0,48,died,37,1,39,38,0,8,36,2,Lorraine Rothman,Sept. 25,PERSON-PERSON,DATE-DATE,PROPN-PROPN,PROPN-NUM,compound-nsubj,npadvmod-nummod,NNP-NNP,NNP-CD,3,1
9273,35033.0,21,is,3,2,15,13,1,5,1,12,Jake Pavelka,bachelor,PERSON-PERSON,TITLE,PROPN-PROPN,NOUN,compound-nsubj,compound,NNP-NNP,NN,6,1
9274,35035.0,39,named,16,1,5,4,0,33,15,-11,Awami League,Sheikh Mujibur Rahman,ORGANIZATION-ORGANIZATION,PERSON-PERSON-PERSON,PROPN-PROPN,PROPN-PROPN-PROPN,compound-compound,compound-compound-nsubjpass,NNP-NNP,NNP-NNP-NNP,3,1
9275,35056.0,33,Brody,3,22,27,5,21,5,-19,24,his,Lorraine Gary,PERSON,PERSON-PERSON,DET,PROPN-PROPN,poss,compound-compound,PRP$,NNP-NNP,1,1
9276,35057.0,32,",",0,3,6,3,2,25,-3,6,her,Sherwood Morgan Sr,PERSON,PERSON-PERSON-PERSON,DET,PROPN-PROPN-PROPN,poss,compound-compound-pobj,PRP$,NNP-NNP-NNP,3,1
9277,35059.0,15,said,8,1,13,12,0,1,7,5,``,Yoshikazu Maruyama,ORGANIZATION,PERSON-PERSON,PUNCT,PROPN-PROPN,punct,compound-nsubj,``,NNP-NNP,4,1
9278,35074.0,27,met,5,4,1,-3,3,25,1,-4,M. Enkhbold,Mongolian,PERSON-PERSON,NATIONALITY,PROPN-PROPN,ADJ,compound-nsubj,amod,NNP-NNP,JJ,2,1
9279,52755.0,31,met,2,27,20,-7,26,10,-25,18,M. Enkhbold,Mongolian,PERSON-PERSON,NATIONALITY,PROPN-PROPN,ADJ,compound-conj,amod,NNP-NNP,JJ,2,1
9280,58491.0,29,said,5,4,1,-3,3,27,1,-4,M. Enkhbold,Mongolian,PERSON-PERSON,NATIONALITY,PROPN-PROPN,ADJ,compound-nsubj,amod,NNP-NNP,JJ,2,1
9281,35078.0,50,backs,2,41,37,-4,40,12,-39,35,OIC,Babacar,ORGANIZATION,PERSON,PROPN,PROPN,poss,compound,NNP,NNP,3,1
9282,35079.0,30,said,20,2,2,0,1,27,18,-18,Carnival Cruise Lines,Carnival Splendor,ORGANIZATION-ORGANIZATION-ORGANIZATION,ORGANIZATION-ORGANIZATION,PROPN-PROPN-PROPN,PROPN-PROPN,compound-compound-nsubj,compound-compound,NNP-NNP-NNPS,NNP-NNP,0,1
9283,35088.0,27,promoted,7,6,10,4,5,16,1,3,he,brigadier general,PERSON,TITLE-TITLE,PRON,NOUN-NOUN,nsubjpass,xcomp-dobj,PRP,NN-NN,3,1
9284,35089.0,37,was,1,1,17,16,0,19,0,16,She,Wall Street Journal,PERSON,ORGANIZATION-ORGANIZATION-ORGANIZATION,PRON,PROPN-PROPN-PROPN,nsubj,compound-compound-poss,PRP,NNP-NNP-NNP,11,1
9285,35091.0,35,left,18,13,8,-5,12,26,5,-10,Chinese Communist Party of China,Beijing Municipal Committee,ORGANIZATION-ORGANIZATION-ORGANIZATION-ORGANIZATION-ORGANIZATION,ORGANIZATION-ORGANIZATION-ORGANIZATION,PROPN-PROPN-PROPN-ADP-PROPN,PROPN-PROPN-PROPN,compound-compound-pobj-prep-pobj,compound-compound-pobj,NNP-NNP-NNP-IN-NNP,NNP-NNP-NNP,4,1
9286,35098.0,26,quits,1,9,1,-8,8,24,-8,0,Arsenal,Dein,ORGANIZATION,PERSON,PROPN,NOUN,compound,nsubj,NNP,NN,5,1
9287,35100.0,34,said,26,28,32,4,27,1,-2,6,MF Global,Kevin Grady,ORGANIZATION-ORGANIZATION,PERSON-PERSON,PROPN-PROPN,PROPN-PROPN,compound-amod,compound-nsubj,NNP-NNP,NNP-NNP,3,1
9288,35108.0,48,made,2,7,14,7,6,33,-5,12,Chunghwa Telecom,Hochen Tan,ORGANIZATION-ORGANIZATION,PERSON-PERSON,PROPN-PROPN,PROPN-PROPN,compound-compound,compound-nsubj,NNP-NNP,NNP-NNP,5,1
9289,35111.0,34,said,1,1,14,13,0,19,0,13,Chavez,PSUV,PERSON,ORGANIZATION,PROPN,PROPN,nsubj,ROOT,NNP,NNP,1,1
9290,35135.0,27,said,25,3,25,22,2,1,22,0,Sports Affairs Council,Tai,ORGANIZATION-ORGANIZATION-ORGANIZATION,PERSON,PROPN-PROPN-PROPN,PROPN,compound-compound-nsubj,nsubj,NNPS-NNPS-NNP,NNP,5,1
9291,35149.0,25,pays,1,19,17,-2,18,7,-18,16,Raul Castro,defense chief,PERSON-PERSON,TITLE-TITLE,PROPN-PROPN,NOUN-NOUN,compound-appos,compound-compound,NNP-NNP,NN-NN,1,1
9292,35161.0,66,survived,12,11,47,36,10,18,1,35,Kaiser,David,PERSON,PERSON,PROPN,PROPN,nsubjpass,conj,NNP,NNP,6,1
9293,35162.0,30,presided,14,14,21,7,13,8,0,7,Kollek,Jewish,PERSON,RELIGION,PROPN,ADJ,nsubj,amod,NNP,JJ,4,1
9294,35185.0,30,are,1,5,13,8,4,16,-4,12,DIRECTV,Hughes Electronics,ORGANIZATION,PERSON-PERSON,PROPN,PROPN-PROPN,nsubjpass,compound-pobj,NNP,NNP-NNPS,4,1
9295,35186.0,50,said,1,26,4,-22,25,45,-25,3,him,TLC,PERSON,ORGANIZATION,PRON,PROPN,dobj,nsubj,PRP,NNP,6,1
9296,35198.0,41,U.S.,0,9,31,22,8,9,-9,31,R. Nicholas Burns,United States,PERSON-PERSON-PERSON,COUNTRY-COUNTRY,PROPN-PROPN-PROPN,PROPN-PROPN,compound-compound-nsubj,compound-pobj,NNP-NNP-NNP,NNP-NNP,6,1
9297,35207.0,48,'s,23,43,38,-5,42,9,-20,15,Haifa University,National Security Studies Center,ORGANIZATION-ORGANIZATION,ORGANIZATION-ORGANIZATION-ORGANIZATION-ORGANIZATION,PROPN-PROPN,PROPN-PROPN-PROPN-PROPN,compound-pobj,compound-compound-compound-pobj,NNP-NNP,NNP-NNP-NNPS-NNP,6,1
9298,35223.0,40,called,6,21,9,-12,20,30,-15,3,Sean Preston,her,PERSON-PERSON,PERSON,PROPN-PROPN,DET,compound-appos,poss,NNP-NNP,PRP$,6,1
9299,35226.0,48,advancing,23,17,3,-14,16,44,6,-20,Herrera,private first class,PERSON,TITLE-TITLE-TITLE,PROPN,ADJ-ADJ-NOUN,conj,amod-amod-nsubj,NNP,JJ-JJ-NN,7,1
9300,35243.0,29,*****************************************************************,0,17,23,6,16,5,-17,23,DirecTV,Hughes Electronics,ORGANIZATION,ORGANIZATION-ORGANIZATION,NOUN,PROPN-PROPN,appos,compound-pobj,NN,NNP-NNP,2,1
9301,35246.0,30,was,1,6,24,18,5,5,-5,23,Andrew Goodman,Philadelphia,PERSON-PERSON,CITY,PROPN-PROPN,PROPN,compound-pobj,pobj,NNP-NNP,NNP,11,1
9302,35255.0,38,became,13,1,11,10,0,26,12,-2,Sills,Jewish,PERSON,RELIGION,NOUN,ADJ,nsubj,amod,NNS,JJ,6,1
9303,35263.0,21,noted,4,9,8,-1,8,12,-5,4,shipbuilder,24-year-old,PERSON,NUMBER,NOUN,NUM,nsubjpass,amod,NN,CD,1,1
9304,35266.0,8,http://www.pentaxsailaway.com/,0,7,1,-6,6,6,-7,1,PENTAX,http://www.pentaxsailaway.com/,ORGANIZATION,URL,NOUN,X,compound,ROOT,NN,ADD,6,1
9305,35272.0,28,received,1,21,10,-11,20,17,-20,9,Institute for Diversity and Ethics in Sports,Richard Lapchick,ORGANIZATION-ORGANIZATION-ORGANIZATION-ORGANIZATION-ORGANIZATION-ORGANIZATION-ORGANIZATION,PERSON-PERSON,PROPN-ADP-PROPN-CCONJ-PROPN-ADP-PROPN,PROPN-PROPN,pobj-prep-pobj-cc-conj-prep-pobj,compound-pobj,NNP-IN-NNP-CC-NNP-IN-NNPS,NNP-NNP,8,1
9306,35273.0,34,sold,13,10,21,11,9,12,3,8,Konica,Sony,ORGANIZATION,ORGANIZATION,PROPN,PROPN,pobj,pobj,NNP,NNP,8,1
9307,35279.0,34,born,4,1,7,6,0,26,3,3,Philip Mayer Kaiser,Brooklyn,PERSON-PERSON-PERSON,CITY,PROPN-PROPN-PROPN,PROPN,compound-compound-nsubjpass,pobj,NNP-NNP-NNP,NNP,5,1
9308,48766.0,29,born,4,1,7,6,0,21,3,3,Philip Mayer Kaiser,Brooklyn,PERSON-PERSON-PERSON,CITY,PROPN-PROPN-PROPN,PROPN,compound-compound-nsubjpass,pobj,NNP-NNP-NNP,NNP,5,1
9309,35281.0,28,'m,1,21,9,-12,20,18,-20,8,his,Massachusetts,PERSON,STATE_OR_PROVINCE,DET,PROPN,poss,pobj,PRP$,NNP,10,1
9310,35282.0,17,is,5,10,1,-9,9,15,-5,-4,B 's Purses,Trista Sutter,PERSON-PERSON-PERSON,ORGANIZATION-ORGANIZATION,PROPN-PART-NOUN,PROPN-PROPN,poss-case-pobj,compound-nsubj,NNP-POS-NNS,NNP-NNP,6,1
9311,35299.0,38,is,3,24,18,-6,23,19,-21,15,she,21-year-old,PERSON,DURATION,PRON,NUM,nsubj,amod,PRP,CD,3,1
9312,35311.0,37,cites,10,21,24,3,20,12,-11,14,his,Melanie Lynn Clapp,PERSON,PERSON-PERSON-PERSON,DET,PROPN-PROPN-PROPN,poss,compound-compound-pobj,PRP$,NNP-NNP-NNP,5,1
9313,35318.0,40,served,19,7,17,10,6,22,12,-2,William Robert Anderson,Navy,PERSON-PERSON-PERSON,ORGANIZATION,PROPN-PROPN-PROPN,PROPN,compound-compound-appos,pobj,NNP-NNP-NNP,NNP,5,1
9314,35326.0,28,said,26,1,15,14,0,12,25,-11,Mr Scheider,complications from a staph infection,PERSON-PERSON,CAUSE_OF_DEATH-CAUSE_OF_DEATH-CAUSE_OF_DEATH-CAUSE_OF_DEATH-CAUSE_OF_DEATH,PROPN-PROPN,NOUN-ADP-DET-NOUN-NOUN,compound-nsubj,pobj-prep-det-compound-pobj,NNP-NNP,NNS-IN-DT-NN-NN,3,1
9315,35330.0,66,decided,5,41,35,-6,40,30,-36,30,Scorpions,Directorate of Special Operatioins,ORGANIZATION,ORGANIZATION-ORGANIZATION-ORGANIZATION-ORGANIZATION,PROPN,PROPN-ADP-PROPN-PROPN,conj,pobj-prep-compound-pobj,NNPS,NNP-IN-NNP-NNP,4,1
9316,35332.0,49,Meanwhile,0,19,32,13,18,16,-19,32,FAPA,D.C.,ORGANIZATION,LOCATION,PROPN,PROPN,compound,appos,NNP,NNP,5,1
9317,35337.0,30,went,6,18,10,-8,17,19,-12,4,Bradford Washburn,Harvard,PERSON-PERSON,ORGANIZATION,PROPN-PROPN,PROPN,compound-dobj,pobj,NNP-NNP,NNP,3,1
9318,35349.0,41,served,2,1,11,10,0,29,1,9,Hubbard,trans - Atlantic Economic Council,PERSON,ORGANIZATION-ORGANIZATION-ORGANIZATION-ORGANIZATION-ORGANIZATION,PROPN,ADJ-PROPN-PROPN-PROPN-PROPN,nsubj,nmod-punct-compound-compound-pobj,NNP,JJ-NNP-NNP-NNP-NNP,6,1
9319,35375.0,24,is,3,15,23,8,14,0,-12,20,Jerry Robbins,director,PERSON-PERSON,TITLE,PROPN-PROPN,NOUN,compound-pobj,pobj,NNP-NNP,NN,6,1
9320,35382.0,36,died,27,7,25,18,6,10,20,-2,her,motivational speaker,PERSON,TITLE-TITLE,DET,ADJ-NOUN,poss,amod-conj,PRP$,JJ-NN,8,1
9321,35402.0,23,ZURICH,0,10,7,-3,9,15,-10,7,Marcel Ospel,UBS AG,PERSON-PERSON,ORGANIZATION-ORGANIZATION,PROPN-PROPN,PROPN-PROPN,compound-nsubj,compound-compound,NNP-NNP,NNP-NNP,8,1
9322,42832.0,32,said,6,5,2,-3,4,29,1,-4,Marcel Ospel,UBS AG,PERSON-PERSON,ORGANIZATION-ORGANIZATION,PROPN-PROPN,PROPN-PROPN,compound-nsubj,compound-compound,NNP-NNP,NNP-NNP,2,1
9323,62035.0,22,urged,5,4,1,-3,3,20,1,-4,Marcel Ospel,UBS AG,PERSON-PERSON,ORGANIZATION-ORGANIZATION,PROPN-PROPN,PROPN-PROPN,compound-nsubj,compound-compound,NNP-NNP,NNP-NNP,2,1
9324,67302.0,21,urges,5,4,1,-3,3,19,1,-4,Marcel Ospel,UBS AG,PERSON-PERSON,ORGANIZATION-ORGANIZATION,PROPN-PROPN,PROPN-PROPN,compound-nsubj,compound-compound,NNP-NNP,NNP-NNP,2,1
9325,35403.0,86,Bryanston,2,2,2,0,1,83,0,0,CNR Main,CNR,ORGANIZATION-ORGANIZATION,ORGANIZATION,PROPN-PROPN,PROPN,compound-pobj,compound,NNP-NNP,NNP,0,1
9326,35404.0,9,finished,2,7,6,-1,6,2,-5,4,George Young,Canadian,PERSON-PERSON,NATIONALITY,PROPN-PROPN,PROPN,compound-appos,amod,NNP-NNP,NNP,2,1
9327,35409.0,50,opened,2,25,25,0,24,24,-23,23,Illinois Tool Works,Illinois,ORGANIZATION-ORGANIZATION-ORGANIZATION,STATE_OR_PROVINCE,PROPN-PROPN-PROPN,PROPN,compound-compound-compound,appos,NNP-NNP-NNP,NNP,0,1
9328,47872.0,46,------,0,16,16,0,15,29,-16,16,Illinois Tool Works,Illinois,ORGANIZATION-ORGANIZATION-ORGANIZATION,STATE_OR_PROVINCE,PROPN-PROPN-PROPN,PROPN,compound-compound-pobj,appos,NNP-NNP-NNP,NNP,0,1
9329,35427.0,55,said,30,37,32,-5,36,22,-7,2,AQR Capital,Cliff Asness,ORGANIZATION-ORGANIZATION,PERSON-PERSON,PROPN-PROPN,PROPN-PROPN,compound-pobj,compound-nsubj,NNP-NNP,NNP-NNP,5,1
9330,35434.0,44,set,8,22,32,10,21,11,-14,24,Mainland Affairs Council,his,ORGANIZATION-ORGANIZATION-ORGANIZATION,PERSON,PROPN-PROPN-PROPN,DET,compound-compound-appos,poss,NNP-NNPS-NNP,PRP$,5,1
9331,35460.0,54,djamena,12,21,14,-7,20,39,-9,2,Justice and Equality Movement,Mohamed Abdallah,ORGANIZATION-ORGANIZATION-ORGANIZATION-ORGANIZATION,PERSON-PERSON,PROPN-CCONJ-PROPN-PROPN,PROPN-PROPN,nmod-cc-conj-pobj,compound-dobj,NNP-CC-NNP-NNP,NNP-NNP,12,1
9332,35462.0,37,led,26,7,16,9,6,20,19,-10,his,Clyde,PERSON,PERSON,DET,PROPN,poss,appos,PRP$,NNP,7,1
9333,35487.0,45,recalled,19,15,14,-1,14,30,4,-5,ConAgra Foods,US-based,ORGANIZATION-ORGANIZATION,COUNTRY,PROPN-PROPN,PROPN,compound-compound,punct,NNP-NNP,NNP,1,1
9334,35495.0,31,benefit,7,15,9,-6,14,21,-8,2,Safe Passage,Camino Seguro,ORGANIZATION-ORGANIZATION,ORGANIZATION-ORGANIZATION,PROPN-PROPN,PROPN-PROPN,compound-compound,compound-dobj,NNP-NNP,NNP-NNP,-1,1
9335,35506.0,15,affiliated,5,11,2,-9,10,12,-6,-3,Focus On The Family,Arkansas Family Council,ORGANIZATION-ORGANIZATION-ORGANIZATION-ORGANIZATION,ORGANIZATION-ORGANIZATION-ORGANIZATION,PROPN-ADP-DET-PROPN,PROPN-PROPN-PROPN,pobj-prep-det-pobj,compound-compound-nsubjpass,NNP-IN-DT-NNP,NNP-NNP-NNP,5,1
9336,35510.0,49,expressed,13,24,22,-2,23,26,-11,9,David Banda,African,PERSON-PERSON,NATIONALITY,PROPN-PROPN,ADJ,compound-appos,amod,NNP-NNP,JJ,3,1
9337,35513.0,38,said,10,4,7,3,3,30,6,-3,His,Yohane Banda,PERSON,PERSON-PERSON,DET,PROPN-PROPN,poss,compound-appos,PRP$,NNP-NNP,1,1
9338,35518.0,16,found,9,8,12,4,7,3,1,3,Roraback,Connecticut Civil Liberties Union,PERSON,ORGANIZATION-ORGANIZATION-ORGANIZATION-ORGANIZATION,PROPN,PROPN-PROPN-PROPN-PROPN,nsubj,compound-compound-compound-dobj,NNP,NNP-NNP-NNPS-NNP,4,1
9339,35521.0,45,serves,13,12,18,6,11,26,1,5,Chen,the Third World Academy of Sciences,PERSON,ORGANIZATION-ORGANIZATION-ORGANIZATION-ORGANIZATION-ORGANIZATION-ORGANIZATION,PROPN,DET-PROPN-PROPN-PROPN-ADP-PROPN,pobj,det-compound-compound-conj-prep-pobj,NNP,DT-NNP-NNP-NNP-IN-NNPS,6,1
9340,35545.0,48,Note,0,3,39,36,2,8,-3,39,Veterans For Peace,US,ORGANIZATION-ORGANIZATION-ORGANIZATION,COUNTRY,NOUN-ADP-NOUN,PROPN,nsubj-prep-pobj,compound,NNS-IN-NN,NNP,11,1
9341,35553.0,40,is,4,18,31,13,17,8,-14,27,his,star,PERSON,TITLE,DET,NOUN,poss,attr,PRP$,NN,3,1
9342,48633.0,29,says,5,7,3,-4,6,25,-2,-2,his,star,PERSON,TITLE,DET,NOUN,poss,compound,PRP$,NN,6,1
9343,35569.0,39,says,4,7,31,24,6,7,-3,27,Lashkar-e-Taiba,fundamentalist Wahhab,ORGANIZATION,RELIGION-RELIGION,PROPN,ADJ-PROPN,nsubj,amod-compound,NNP,JJ-NNP,-1,1
9344,35579.0,43,Admits,2,15,2,-13,14,40,-13,0,International Monetary Fund,Director,ORGANIZATION-ORGANIZATION-ORGANIZATION,PERSON,PROPN-PROPN-PROPN,PROPN,compound-compound-pobj,compound,NNP-NNP-NNP,NNP,6,1
9345,35606.0,69,said,30,22,32,10,21,36,8,2,tax policy,Leonard E Burman,ORGANIZATION-ORGANIZATION,PERSON-PERSON-PERSON,NOUN-NOUN,PROPN-PROPN-PROPN,compound-compound,compound-compound-nsubj,NN-NN,NNP-NNP-NNP,5,1
9346,35627.0,14,died,8,6,11,5,5,2,2,3,explorer,heart failure,PERSON,CAUSE_OF_DEATH-CAUSE_OF_DEATH,NOUN,NOUN-NOUN,conj,compound-pobj,NN,NN-NN,5,1
9347,35645.0,39,says,4,7,36,29,6,2,-3,32,Lashkar-e-Taiba,Sunni Muslim,ORGANIZATION,RELIGION-RELIGION,PROPN,PROPN-PROPN,nsubj,amod-compound,NNP,NNP-NNP,-1,1
9348,35647.0,58,nbsp,1,56,51,-5,55,6,-55,50,FMF,Federal Ministry of Finance,ORGANIZATION,ORGANIZATION-ORGANIZATION-ORGANIZATION-ORGANIZATION,PROPN,PROPN-PROPN-ADP-PROPN,compound,compound-pobj-prep-pobj,NNP,NNP-NNP-IN-NNP,8,1
9349,35653.0,24,taught,2,1,5,4,0,18,1,3,He,Dartmouth College,PERSON,ORGANIZATION-ORGANIZATION,PRON,PROPN-PROPN,nsubj,compound-pobj,PRP,NNP-NNP,3,1
9350,35658.0,19,married,5,7,13,6,6,5,-2,8,Gunnar Forsberg,student,PERSON-PERSON,TITLE,PROPN-PROPN,NOUN,compound-dobj,appos,NNP-NNP,NN,2,1
9351,35661.0,70,check,23,26,29,3,25,40,-3,6,Alice Dellal,Skull and Bones,PERSON-PERSON,ORGANIZATION-ORGANIZATION-ORGANIZATION,PROPN-PROPN,PROPN-CCONJ-PROPN,compound-poss,nmod-cc-conj,NNP-NNP,NNP-CC-NNP,2,1
9352,35662.0,34,backed,5,1,11,10,0,22,4,6,ABC,he,ORGANIZATION,PERSON,PROPN,PRON,compound,nsubj,NNP,PRP,5,1
9353,41140.0,45,said,13,11,15,4,10,29,2,2,ABC,he,ORGANIZATION,PERSON,PROPN,PRON,compound,nsubj,NNP,PRP,3,1
9354,35664.0,36,said,34,22,15,-7,21,20,12,-19,Royal Caribbean International,Vision of the Seas,ORGANIZATION-ORGANIZATION-ORGANIZATION,ORGANIZATION-ORGANIZATION-ORGANIZATION-ORGANIZATION,PROPN-PROPN-PROPN,PROPN-ADP-DET-PROPN,compound-compound-pobj,appos-prep-det-pobj,NNP-NNP-NNP,NNP-IN-DT-NNPS,4,1
9355,35673.0,40,was,14,6,11,5,5,28,8,-3,Paralyzed Veterans of America,New Mexico,ORGANIZATION-ORGANIZATION-ORGANIZATION-ORGANIZATION,STATE_OR_PROVINCE-STATE_OR_PROVINCE,PROPN-PROPN-ADP-PROPN,PROPN-PROPN,compound-pobj-prep-poss,compound-compound,NNP-NNPS-IN-NNP,NNP-NNP,3,1
9356,35694.0,27,relied,10,25,17,-8,24,9,-15,7,Haifa University,Ilan Pappe,ORGANIZATION-ORGANIZATION,PERSON-PERSON,PROPN-PROPN,PROPN-PROPN,compound-pobj,compound-pobj,NNP-NNP,NNP-NNP,5,1
9357,35697.0,24,born,5,1,13,12,0,10,4,8,Jefferson Joseph DeBlanc Sr.,"Feb. 15 , 1921",PERSON-PERSON-PERSON-PERSON,DATE-DATE-DATE-DATE,PROPN-PROPN-PROPN-PROPN,PROPN-NUM-PUNCT-NUM,compound-compound-compound-nsubjpass,pobj-nummod-punct-nummod,NNP-NNP-NNP-NNP,"NNP-CD-,-CD",4,1
9358,35700.0,31,includes,18,3,22,19,2,8,15,4,OIC,Malaysia,ORGANIZATION,COUNTRY,PROPN,PROPN,compound,conj,NNP,NNP,8,1
9359,35707.0,46,denounced,7,10,34,24,9,11,-3,27,Inter American Press Association,U.S.,ORGANIZATION-ORGANIZATION-ORGANIZATION-ORGANIZATION,COUNTRY,PROPN-PROPN-PROPN-PROPN,PROPN,compound-compound-compound-dobj,compound,NNP-NNP-NNP-NNP,NNP,9,1
9360,35714.0,73,said,24,27,31,4,26,41,-3,7,Paul E. Gillmor,R-Ohio,PERSON-PERSON-PERSON,LOCATION,PROPN-PROPN-PROPN,PROPN,compound-compound-nsubj,appos,NNP-NNP-NNP,NNP,3,1
9361,35715.0,47,wanted,12,1,7,6,0,39,11,-5,George Young,general manager,PERSON-PERSON,TITLE-TITLE,PROPN-PROPN,ADJ-NOUN,compound-nsubj,amod-appos,NNP-NNP,JJ-NN,1,1
9362,51616.0,40,went,14,27,22,-5,26,17,-13,8,George Young,general manager,PERSON-PERSON,TITLE-TITLE,PROPN-PROPN,ADJ-NOUN,compound-appos,amod-pobj,NNP-NNP,JJ-NN,1,1
9363,55946.0,31,said,1,11,18,7,10,12,-10,17,George Young,general manager,PERSON-PERSON,TITLE-TITLE,PROPN-PROPN,ADJ-NOUN,compound-pobj,amod-pobj,NNP-NNP,JJ-NN,3,1
9364,58680.0,23,used,11,1,9,8,0,13,10,-2,George Young,general manager,PERSON-PERSON,TITLE-TITLE,PROPN-PROPN,ADJ-NOUN,compound-nsubj,amod-appos,NNP-NNP,JJ-NN,1,1
9365,66521.0,32,hired,11,1,7,6,0,24,10,-4,George Young,general manager,PERSON-PERSON,TITLE-TITLE,PROPN-PROPN,ADJ-NOUN,compound-nsubjpass,amod-pobj,NNP-NNP,JJ-NN,3,1
9366,35721.0,29,said,1,25,16,-9,24,12,-24,15,Babyshambles,Dublin,PERSON,CITY,PROPN,PROPN,poss,pobj,NNPS,NNP,6,1
9367,35725.0,24,was,1,4,14,10,3,9,-3,13,ABC TV,NBC,ORGANIZATION-ORGANIZATION,ORGANIZATION,PROPN-NOUN,PROPN,compound-compound,nmod,NNP-NN,NNP,5,1
9368,35753.0,63,wrote,23,32,45,13,31,17,-9,22,John Kerry,ex-lieutenant governor,PERSON-PERSON,TITLE-TITLE,PROPN-PROPN,ADJ-NOUN,compound-attr,amod-attr,NNP-NNP,JJ-NN,-1,1
9369,35770.0,44,preached,1,1,22,21,0,21,0,21,He,Israel,PERSON,COUNTRY,PRON,PROPN,nsubj,poss,PRP,NNP,8,1
9370,35772.0,42,described,15,9,7,-2,8,34,6,-8,Babyshambles,singer,PERSON,TITLE,PROPN,NOUN,pobj,appos,NNPS,NN,2,1
9371,67799.0,29,snapped,16,3,4,1,2,24,13,-12,Babyshambles,singer,PERSON,TITLE,PROPN,NOUN,compound,nsubjpass,NNP,NN,1,1
9372,35778.0,6,Kerry,3,2,1,-1,1,4,1,-2,John F Kerry,Sen,PERSON-PERSON-PERSON,ORGANIZATION,PROPN-PROPN-PROPN,PROPN,compound-compound-ROOT,compound,NNP-NNP-NNP,NNP,2,1
9373,35783.0,20,founded,5,7,1,-6,6,18,-2,-4,Safe Passage,Hanley Denning,ORGANIZATION-ORGANIZATION,PERSON-PERSON,PROPN-PROPN,PROPN-PROPN,compound-dobj,compound-nsubj,NNP-NNP,NNP-NNP,2,1
9374,35790.0,53,elected,20,26,32,6,25,20,-6,12,Robert Morgenthau,DA,PERSON-PERSON,ORGANIZATION,PROPN-PROPN,PROPN,compound-dobj,poss,NNP-NNP,NNP,4,1
9375,35800.0,11,has,1,1,4,3,0,6,0,3,Covidien,"2,000",ORGANIZATION,NUMBER,PROPN,NUM,nsubj,nummod,NNP,CD,1,1
9376,46821.0,24,has,14,7,20,13,6,3,7,6,Covidien,"2,000",ORGANIZATION,NUMBER,PROPN,NUM,nsubj,nummod,NNP,CD,7,1
9377,35817.0,61,means,1,42,57,15,41,3,-41,56,Zagat,zagatmobi,ORGANIZATION,URL,PROPN,NOUN,appos,compound,NNP,NN,3,1
9378,35818.0,36,survived,12,11,35,24,10,0,1,23,Forsberg,Mass.,PERSON,STATE_OR_PROVINCE,PROPN,PROPN,nsubjpass,appos,NNP,NNP,8,1
9379,35821.0,49,was,23,9,14,5,8,34,14,-9,Kim,Saratoga,PERSON,CITY,PROPN,PROPN,pobj,pobj,NNP,NNP,3,1
9380,35825.0,61,BOLIN,1,1,25,24,0,35,0,24,JANE BOLIN,Yale Law School,PERSON-PERSON,ORGANIZATION-ORGANIZATION-ORGANIZATION,PROPN-PROPN,PROPN-PROPN-PROPN,compound-ROOT,compound-compound-pobj,NNP-NNP,NNP-NNP-NNP,6,1
9381,35826.0,56,said,31,40,33,-7,39,22,-9,2,Mainland Affairs Council,Fu Dong-cheng,ORGANIZATION-ORGANIZATION-ORGANIZATION,PERSON-PERSON,PROPN-PROPN-PROPN,PROPN-PROPN,compound-compound-pobj,compound-nsubj,NNP-NNPS-NNP,NNP-NNP,5,1
9382,35830.0,32,was,5,5,3,-2,4,28,0,-2,she,legislator,PERSON,TITLE,PRON,NOUN,nsubj,pobj,PRP,NN,1,1
9383,35832.0,32,elected,1,7,12,5,6,19,-6,11,Chen Zhu,Minister of Health,PERSON-PERSON,ORGANIZATION-ORGANIZATION-ORGANIZATION,PROPN-PROPN,PROPN-ADP-PROPN,compound-pobj,appos-prep-pobj,NNP-NNP,NNP-IN-NNP,2,1
9384,35836.0,32,said,12,14,19,5,13,12,-2,7,International Skating Union,Jane Moran,ORGANIZATION-ORGANIZATION-ORGANIZATION,PERSON-PERSON,PROPN-PROPN-PROPN,PROPN-PROPN,nmod-nmod-nmod,compound-nsubj,NNP-NNP-NNP,NNP-NNP,4,1
9385,35840.0,30,criticised,2,10,23,13,9,6,-8,21,Ayatollah Ali Khamenei,Tehran,PERSON-PERSON-PERSON,LOCATION,PROPN-PROPN-PROPN,PROPN,compound-compound-appos,pobj,NNP-NNP-NNP,NNP,8,1
9386,35855.0,18,is,1,6,5,-1,5,12,-5,4,Raul Castro,General,PERSON-PERSON,TITLE,PROPN-PROPN,PROPN,compound-poss,compound,NNP-NNP,NNP,1,1
9387,35856.0,20,began,2,7,11,4,6,8,-5,9,Murat Kurnaz,German-born,PERSON-PERSON,COUNTRY,PROPN-PROPN,PROPN,compound-nsubjpass,compound,NNP-NNP,NNP,3,1
9388,35857.0,23,born,2,1,10,9,0,12,1,8,Ahearn,Nashville,PERSON,CITY,PROPN,PROPN,nsubjpass,pobj,NNP,NNP,4,1
9389,44616.0,23,born,2,1,10,9,0,12,1,8,Ahearn,Nashville,PERSON,CITY,PROPN,PROPN,nsubjpass,pobj,NNP,NNP,4,1
9390,35888.0,25,removed,14,8,12,4,7,12,6,-2,his,Sandy,PERSON,PERSON,DET,PROPN,poss,poss,PRP$,NNP,7,1
9391,35896.0,32,said,25,20,11,-9,19,20,5,-14,him,Nick Burns,PERSON,PERSON-PERSON,PRON,PROPN-PROPN,nsubj,compound-nsubj,PRP,NNP-NNP,6,1
9392,35911.0,17,known,4,3,2,-1,2,14,1,-2,Pratt,26-year-old,PERSON,DURATION,PROPN,NOUN,nsubjpass,nummod,NNP,NN,1,1
9393,47439.0,18,Kelli,0,4,3,-1,3,14,-4,3,Pratt,26-year-old,PERSON,NUMBER,PROPN,NOUN,nsubjpass,compound,NNP,NN,1,1
9394,35917.0,39,moved,24,14,13,-1,13,25,10,-11,Hamilton,Lewis Hamilton,PERSON,PERSON-PERSON,PROPN,PROPN-PROPN,pobj,compound-dobj,NNP,NNP-NNP,1,1
9395,35924.0,30,stipulate,1,27,29,2,26,0,-26,28,David,London,PERSON,CITY,PROPN,PROPN,dobj,pobj,NNP,NNP,1,1
9396,48262.0,42,expected,4,20,27,7,19,14,-16,23,David,London,PERSON,CITY,PROPN,PROPN,dobj,pobj,NNP,NNP,3,1
9397,35928.0,16,appointed,2,1,13,12,0,2,1,11,He,Panama,PERSON,COUNTRY,PRON,PROPN,nsubjpass,pobj,PRP,NNP,2,1
9398,35930.0,50,acts,9,35,33,-2,34,16,-26,24,Trista Rehn,judge,PERSON-PERSON,TITLE,PROPN-PROPN,NOUN,compound-conj,pobj,NNP-NNP,NN,1,1
9399,35949.0,47,Secretary,3,42,1,-41,41,45,-39,-2,MAC,Hong Kong,ORGANIZATION,CITY-CITY,PROPN,PROPN-PROPN,compound,compound-pobj,NNP,NNP-NNP,6,1
9400,35950.0,62,be,4,6,61,55,5,0,-2,57,Tyco Electronics,Massachusetts,ORGANIZATION-ORGANIZATION,STATE_OR_PROVINCE,PROPN-PROPN,PROPN,compound-appos,appos,NNP-NNP,NNP,2,1
9401,35953.0,25,was,1,15,7,-8,14,17,-14,6,he,teacher,PERSON,TITLE,PRON,NOUN,nsubj,attr,PRP,NN,3,1
9402,35983.0,33,died,12,10,16,6,9,16,2,4,Robert McNair,her,PERSON-PERSON,PERSON,PROPN-PROPN,DET,compound-pobj,poss,NNP-NNP,PRP$,6,1
9403,66547.0,33,died,12,10,16,6,9,16,2,4,Robert McNair,her,PERSON-PERSON,PERSON,PROPN-PROPN,DET,compound-pobj,poss,NNP-NNP,PRP$,6,1
9404,35985.0,50,died,35,1,6,5,0,43,34,-29,Gilbert Gude,Republican,PERSON-PERSON,ORGANIZATION,PROPN-PROPN,ADJ,compound-nsubj,amod,NNP-NNP,JJ,1,1
9405,35997.0,51,said,19,5,1,-4,4,49,14,-18,Pamela Martin and Associates,Palfrey,ORGANIZATION-ORGANIZATION-ORGANIZATION-ORGANIZATION,PERSON,PROPN-PROPN-CCONJ-PROPN,PROPN,compound-appos-cc-conj,poss,NNP-NNP-CC-NNPS,NNP,3,1
9406,36015.0,37,said,17,8,1,-7,7,35,9,-16,International Crisis Group,Alain Deletroz,ORGANIZATION-ORGANIZATION-ORGANIZATION,PERSON-PERSON,PROPN-PROPN-PROPN,PROPN-PROPN,compound-compound-pobj,compound-nsubj,NNP-NNP-NNP,NNP-NNP,4,1
9407,36022.0,32,is,4,1,1,0,0,30,3,-3,NEC,NEC Electronics Corp,ORGANIZATION,ORGANIZATION-ORGANIZATION-ORGANIZATION,PROPN,PROPN-PROPN-PROPN,poss,compound-compound-pobj,NNP,NNP-NNP-NNP,0,1
9408,63056.0,48,says,3,3,3,0,2,44,0,0,NEC,NEC Electronics Corp,ORGANIZATION,ORGANIZATION-ORGANIZATION-ORGANIZATION,PROPN,PROPN-PROPN-PROPN,nsubj,compound-compound-nsubj,NNP,NNP-NNP-NNP,0,1
9409,36023.0,25,asked,23,8,23,15,7,1,15,0,25-year-old advertising account manager,CA,PERSON-PERSON-PERSON-PERSON,STATE_OR_PROVINCE,NUM-NOUN-NOUN-NOUN,PROPN,amod-compound-compound-pobj,nsubj,CD-NN-NN-NN,NNP,10,1
9410,36025.0,94,redemption,1,50,36,-14,49,57,-49,35,he,asian,PERSON,NATIONALITY,PRON,ADJ,nsubj,amod,PRP,JJ,12,1
9411,43026.0,94,redemption,1,50,36,-14,49,57,-49,35,he,asian,PERSON,NATIONALITY,PRON,ADJ,nsubj,amod,PRP,JJ,12,1
9412,36030.0,26,was,11,2,2,0,1,23,9,-9,Badr Organization,Badr Brigade,ORGANIZATION-ORGANIZATION,ORGANIZATION-ORGANIZATION,PROPN-PROPN,PROPN-PROPN,compound-nsubj,compound-pobj,NNP-NNP,NNP-NNP,0,1
9413,36046.0,56,Cost,0,14,16,2,13,39,-14,16,CPS,Mohammad Obeidat,ORGANIZATION,PERSON-PERSON,PROPN,PROPN-PROPN,pobj,compound-appos,NNP,NNP-NNP,2,1
9414,36048.0,31,led,9,11,9,-2,10,21,-2,0,MBIA,Brown,ORGANIZATION,PERSON,PROPN,PROPN,dobj,nsubj,NNP,NNP,1,1
9415,36065.0,50,died,35,1,12,11,0,37,34,-23,Gilbert Gude,Md,PERSON-PERSON,STATE_OR_PROVINCE,PROPN-PROPN,PROPN,compound-nsubj,appos,NNP-NNP,NNP,5,1
9416,45906.0,50,died,35,1,12,11,0,37,34,-23,Gilbert Gude,Md,PERSON-PERSON,STATE_OR_PROVINCE,PROPN-PROPN,PROPN,compound-nsubj,appos,NNP-NNP,NNP,5,1
9417,36073.0,26,member,5,8,8,0,7,17,-3,3,Pennsylvania State House of Representatives,Pennsylvania,ORGANIZATION-ORGANIZATION-ORGANIZATION-ORGANIZATION-ORGANIZATION,STATE_OR_PROVINCE,PROPN-PROPN-PROPN-ADP-PROPN,PROPN,compound-compound-pobj-prep-pobj,pobj,NNP-NNP-NNP-IN-NNPS,NNP,0,1
9418,36074.0,54,include,1,17,15,-2,16,38,-16,14,Richard DeBlanc,Louisiana,PERSON-PERSON,STATE_OR_PROVINCE,PROPN-PROPN,PROPN,compound-conj,conj,NNP-NNP,NNP,2,1
9419,36082.0,22,joined,4,1,13,12,0,8,3,9,Hubbard,National Economic Council,PERSON,ORGANIZATION-ORGANIZATION-ORGANIZATION,PROPN,PROPN-PROPN-PROPN,nsubj,compound-compound-pobj,NNP,NNP-NNP-NNP,7,1
9420,36099.0,30,died,22,3,29,26,2,0,19,7,Steven B. Derounian,Texas,PERSON-PERSON-PERSON,STATE_OR_PROVINCE,PROPN-PROPN-PROPN,PROPN,compound-compound-nsubj,appos,NNP-NNP-NNP,NNP,3,1
9421,36102.0,34,include,1,16,20,4,15,13,-15,19,Gilbert Gude Jr,Gregory Gude,PERSON-PERSON-PERSON,PERSON-PERSON,PROPN-PROPN-PROPN,PROPN-PROPN,compound-compound-conj,compound-conj,NNP-NNP-NNP,NNP-NNP,2,1
9422,36105.0,32,BOGOTA,0,11,8,-3,10,23,-11,8,Millonarios,Colombian league,ORGANIZATION,ORGANIZATION-ORGANIZATION,PROPN,ADJ-NOUN,nsubj,amod-compound,NNP,JJ-NN,4,1
9423,36107.0,36,2009-11-02T00,0,3,31,28,2,4,-3,31,Focus on the Family,Colorado Springs-based,ORGANIZATION-ORGANIZATION-ORGANIZATION-ORGANIZATION,CITY-CITY,PROPN-ADP-DET-PROPN,PROPN-VERB,nsubj-prep-det-compound,nsubj-ROOT,NNP-IN-DT-NNP,NNP-VBD,9,1
9424,36120.0,51,said,15,2,13,11,1,37,13,-2,FAA,U.S.,ORGANIZATION,COUNTRY,PROPN,PROPN,nsubj,compound,NNP,NNP,3,1
9425,41180.0,39,says,8,8,7,-1,7,31,0,-1,FAA,U.S.,ORGANIZATION,COUNTRY,PROPN,PROPN,nsubj,compound,NNP,NNP,1,1
9426,36131.0,45,made,13,12,35,23,11,9,1,22,CPC,Hu Jintao,ORGANIZATION,PERSON-PERSON,PROPN,PROPN-PROPN,compound,compound-nsubj,NNP,NNP-NNP,5,1
9427,36135.0,29,inspected,1,21,19,-2,20,9,-20,18,Korean Central News Agency,North,ORGANIZATION-ORGANIZATION-ORGANIZATION-ORGANIZATION,LOCATION,PROPN-PROPN-PROPN-PROPN,PROPN,compound-compound-compound-dobj,poss,NNP-NNP-NNP-NNP,NNP,3,1
9428,36140.0,60,include,1,37,20,-17,36,39,-36,19,Reagan Dunn,Wash.,PERSON-PERSON,STATE_OR_PROVINCE,PROPN-PROPN,PROPN,compound-conj,appos,NNP-NNP,NNP,7,1
9429,36158.0,65,course,1,12,15,3,11,49,-11,14,Bryan Fuller,director/producer,PERSON-PERSON,TITLE,PROPN-PROPN,PROPN,compound-ROOT,conj,NNP-NNP,NNP,2,1
9430,36169.0,30,said,22,24,28,4,23,1,-2,6,MF Global,Bob Yawger,ORGANIZATION-ORGANIZATION,PERSON-PERSON,PROPN-PROPN,PROPN-PROPN,compound-amod,compound-appos,NNP-NNP,NNP-NNP,3,1
9431,49817.0,33,said,22,24,31,7,23,1,-2,9,MF Global,Bob Yawger,ORGANIZATION-ORGANIZATION,PERSON-PERSON,PROPN-PROPN,PROPN-PROPN,compound-amod,compound-nsubj,NNP-NNP,NNP-NNP,3,1
9432,36174.0,4,was,1,1,3,2,0,0,0,2,He,84,PERSON,NUMBER,PRON,NUM,nsubj,attr,PRP,CD,1,1
9433,36188.0,24,told,7,15,3,-12,14,20,-8,-4,his,Abu Zumam,ORGANIZATION,PERSON-PERSON,DET,PROPN-PROPN,poss,compound-nsubj,PRP$,NNP-NNP,5,1
9434,36211.0,30,died,2,1,10,9,0,19,1,8,Robert Goodman,54,PERSON-PERSON,NUMBER,PROPN-PROPN,NUM,compound-nsubj,pobj,NNP-NNP,CD,3,1
9435,36213.0,26,working,3,11,14,3,10,11,-8,11,SAC,China,ORGANIZATION,COUNTRY,PROPN,PROPN,compound,pobj,NNP,NNP,4,1
9436,36218.0,31,been,6,5,23,18,4,7,1,17,Bellecourt,National Coalition on Racism in Sports and Media,PERSON,ORGANIZATION-ORGANIZATION-ORGANIZATION-ORGANIZATION-ORGANIZATION-ORGANIZATION-ORGANIZATION-ORGANIZATION,PROPN,PROPN-PROPN-ADP-PROPN-ADP-PROPN-CCONJ-PROPN,nsubj,compound-pobj-prep-pobj-prep-pobj-cc-conj,NNP,NNP-NNP-IN-NNP-IN-NNPS-CC-NNP,11,1
9437,36226.0,59,said,38,56,49,-7,55,9,-18,11,Highland Capital Partners,Mass.,ORGANIZATION-ORGANIZATION-ORGANIZATION,STATE_OR_PROVINCE,PROPN-PROPN-PROPN,PROPN,compound-compound-pobj,nmod,NNP-NNP-NNPS,NNP,4,1
9438,47387.0,28,is,2,9,20,11,8,7,-7,18,Highland Capital Partners,Mass.,ORGANIZATION-ORGANIZATION-ORGANIZATION,STATE_OR_PROVINCE,PROPN-PROPN-PROPN,PROPN,compound-compound-attr,appos,NNP-NNP-NNPS,NNP,5,1
9439,36227.0,22,promised,11,8,7,-1,7,14,3,-4,Awami League,left-leaning,ORGANIZATION-ORGANIZATION,RELIGION,PROPN-PROPN,ADJ,compound-pobj,amod,NNP-NNP,JJ,1,1
9440,36231.0,11,GH-SEL,2,7,5,-2,6,5,-5,3,Ghent University,INTEC,ORGANIZATION-ORGANIZATION,ORGANIZATION,PROPN-PROPN,PROPN,compound-conj,conj,NNP-NNP,NNP,3,1
9441,36233.0,35,awaiting,12,24,9,-15,23,25,-12,-3,SLDN,Legal Defense Network,ORGANIZATION,ORGANIZATION-ORGANIZATION-ORGANIZATION,PROPN,PROPN-PROPN-PROPN,nsubj,compound-compound-pobj,NNP,NNP-NNP-NNP,6,1
9442,36238.0,36,said,10,1,5,4,0,30,9,-5,John Ring,PVA,ORGANIZATION-ORGANIZATION,PERSON,PROPN-PROPN,PROPN,compound-nsubj,poss,NNP-NNP,NNP,3,1
9443,36264.0,30,christened,5,3,2,-1,2,27,2,-3,Melanie Fiona,songstress,PERSON-PERSON,TITLE,PROPN-PROPN,NOUN,compound-nsubj,compound,NNP-NNP,NN,1,1
9444,36285.0,20,suspected,6,13,19,6,12,0,-7,13,Badr Corps,SCIRI,ORGANIZATION-ORGANIZATION,ORGANIZATION,PROPN-PROPN,PROPN,compound-pobj,pobj,NNP-NNP,NNP,6,1
9445,36303.0,25,is,8,15,11,-4,14,13,-7,3,Chad White,22-year old,PERSON-PERSON,NUMBER-NUMBER,PROPN-PROPN,ADJ-ADJ,compound-appos,nummod-amod,NNP-NNP,JJ-JJ,2,1
9446,36336.0,24,said,4,6,18,12,5,5,-2,14,he,American,PERSON,NATIONALITY,PRON,ADJ,nsubj,amod,PRP,JJ,4,1
9447,66673.0,40,announced,12,12,35,23,11,4,0,23,he,American,PERSON,NATIONALITY,PRON,ADJ,nsubj,amod,PRP,JJ,3,1
9448,36340.0,29,said,15,1,14,13,0,14,14,-1,Covidien Ltd.,Bermuda,ORGANIZATION-ORGANIZATION,LOCATION,PROPN-PROPN,PROPN,compound-nsubj,pobj,NNP-NNP,NNP,2,1
9449,36343.0,55,says,7,23,31,8,22,23,-16,24,Alberto Gonzales,United States of America,PERSON-PERSON,COUNTRY-COUNTRY-COUNTRY-COUNTRY,PROPN-PROPN,PROPN-PROPN-ADP-PROPN,compound-pobj,compound-pobj-prep-pobj,NNP-NNP,NNP-NNP-IN-NNP,8,1
9450,36371.0,23,was,9,6,1,-5,5,21,3,-8,Juanita Jackson Mitchell,Parren Mitchell,PERSON-PERSON-PERSON,PERSON-PERSON,PROPN-PROPN-PROPN,PROPN-PROPN,compound-compound-appos,compound-poss,NNP-NNP-NNP,NNP-NNP,3,1
9451,36374.0,36,putting,5,11,33,22,10,2,-6,28,her,Infiniti Le Mode,PERSON,ORGANIZATION-ORGANIZATION-ORGANIZATION,DET,PROPN-PROPN-PROPN,poss,compound-compound-appos,PRP$,NNP-NNP-NNP,6,1
9452,36397.0,7,HILL,1,1,4,3,0,2,0,3,ANP HILL,Afghanistan,ORGANIZATION-ORGANIZATION,COUNTRY,PROPN-PROPN,PROPN,compound-ROOT,npadvmod,NNP-NNP,NNP,2,1
9453,36400.0,34,appeared,8,26,26,0,25,7,-18,18,Kendra Wilkinson,Kendra Baskett,PERSON-PERSON,PERSON-PERSON,PROPN-PROPN,PROPN-PROPN,compound-pobj,compound-conj,NNP-NNP,NNP-NNP,0,1
9454,36405.0,55,Council,3,2,9,7,1,45,1,6,Sports Affairs Council,Taiwan,ORGANIZATION-ORGANIZATION-ORGANIZATION,COUNTRY,PROPN-PROPN-PROPN,PROPN,compound-compound-ROOT,poss,NNPS-NNPS-NNP,NNP,6,1
9455,58458.0,33,announced,3,8,15,7,7,17,-5,12,Sports Affairs Council,Taiwan,ORGANIZATION-ORGANIZATION-ORGANIZATION,COUNTRY,PROPN-PROPN-PROPN,PROPN,compound-compound-nsubjpass,poss,NNPS-NNPS-NNP,NNP,3,1
9456,36407.0,34,seen,23,2,27,25,1,6,21,4,papers,Doherty,ORGANIZATION,PERSON,NOUN,PROPN,nsubj,nsubj,NNS,NNP,4,1
9457,36411.0,33,made,1,12,7,-5,11,25,-11,6,Golden League,Chico Outlaws,ORGANIZATION-ORGANIZATION,ORGANIZATION-ORGANIZATION,PROPN-PROPN,PROPN-PROPN,compound-pobj,compound-pobj,NNP-NNP,NNP-NNPS,2,1
9458,36436.0,29,became,1,22,24,2,21,4,-21,23,Paul,Anthony,PERSON,PERSON,PROPN,PROPN,appos,nsubj,NNP,NNP,2,1
9459,36440.0,27,tells,9,7,5,-2,6,21,2,-4,Hector Elizondo,coach,PERSON-PERSON,TITLE,PROPN-PROPN,NOUN,compound-compound,nsubj,NNP-NNP,NN,-1,1
9460,36445.0,20,became,2,4,10,6,3,9,-2,8,CMA,Gerber,ORGANIZATION,PERSON,PROPN,PROPN,attr,nsubj,NNP,NNP,4,1
9461,36452.0,58,rendered,9,12,21,9,11,36,-3,12,APA,APA'a,ORGANIZATION,MISC,PROPN,PROPN,poss,compound,NNP,NNP,7,1
9462,36472.0,48,been,10,21,26,5,20,21,-11,16,Badr Corps,Supreme Islamic Iraqi Council,ORGANIZATION-ORGANIZATION,ORGANIZATION-ORGANIZATION-ORGANIZATION-ORGANIZATION,PROPN-PROPN,PROPN-PROPN-PROPN-PROPN,compound-compound,compound-compound-compound-pobj,NNP-NNP,NNP-NNP-NNP-NNP,4,1
9463,36483.0,22,said,13,1,11,10,0,10,12,-2,Crisp,a stroke,PERSON,CAUSE_OF_DEATH-CAUSE_OF_DEATH,PROPN,DET-NOUN,nsubj,det-pobj,NNP,DT-NN,3,1
9464,36487.0,32,underwent,4,1,17,16,0,14,3,13,Binoche,dancer,PERSON,TITLE,PROPN,NOUN,nsubj,appos,NNP,NN,9,1
9465,55893.0,22,turns,2,2,4,2,1,17,0,2,Binoche,dancer,PERSON,TITLE,PROPN,NOUN,nsubj,dobj,NNP,NN,1,1
9466,36497.0,44,was,14,2,7,5,1,36,12,-7,Daily News,Associated Newspapers of Zimbabwe,ORGANIZATION-ORGANIZATION,ORGANIZATION-ORGANIZATION-ORGANIZATION-ORGANIZATION,PROPN-PROPN,PROPN-PROPN-ADP-PROPN,compound-nsubj,compound-pobj-prep-compound,NNP-NNP,NNP-NNPS-IN-NNP,3,1
9467,36499.0,65,picked,8,50,37,-13,49,27,-42,29,KGB,FSB,ORGANIZATION,ORGANIZATION,PROPN,PROPN,pobj,pobj,NNP,NNP,3,1
9468,36501.0,27,named,6,8,15,7,7,11,-2,9,KGB,Yuri Andropov,ORGANIZATION,PERSON-PERSON,PROPN,PROPN-PROPN,compound,compound-appos,NNP,NNP-NNP,4,1
9469,36517.0,33,said,30,1,9,8,0,23,29,-21,Canadian National Railway,Canada,ORGANIZATION-ORGANIZATION-ORGANIZATION,COUNTRY,PROPN-PROPN-PROPN,PROPN,amod-compound-nsubj,pobj,NNP-NNP-NNP,NNP,4,1
9470,36522.0,44,showed,16,2,11,9,1,32,14,-5,Hong Kong Disneyland,Walt Disney Co,ORGANIZATION-ORGANIZATION-ORGANIZATION,ORGANIZATION-ORGANIZATION-ORGANIZATION,PROPN-PROPN-PROPN,PROPN-PROPN-PROPN,compound-compound-poss,compound-compound-poss,NNP-NNP-NNP,NNP-NNP-NNP,7,1
9471,36547.0,26,died,18,1,20,19,0,5,17,2,Waldheim,Thursday,PERSON,DATE,PROPN,PROPN,nsubj,npadvmod,NNP,NNP,3,1
9472,36549.0,69,Boxer,0,27,16,-11,26,52,-27,16,Barbara Boxer,Senate Environment and Public Works Committee,PERSON-PERSON,ORGANIZATION-ORGANIZATION-ORGANIZATION-ORGANIZATION-ORGANIZATION-ORGANIZATION,PROPN-PROPN,PROPN-PROPN-CCONJ-PROPN-PROPN-PROPN,compound-conj,compound-nsubj-cc-compound-compound-compound,NNP-NNP,NNP-NNP-CC-NNP-NNP-NNP,7,1
9473,48409.0,37,hailed,17,2,11,9,1,25,15,-6,Barbara Boxer,Senate Environment and Public Works Committee,PERSON-PERSON,ORGANIZATION-ORGANIZATION-ORGANIZATION-ORGANIZATION-ORGANIZATION-ORGANIZATION,PROPN-PROPN,PROPN-PROPN-CCONJ-PROPN-PROPN-PROPN,compound-nsubj,compound-pobj-cc-compound-compound-conj,NNP-NNP,NNP-NNP-CC-NNP-NNP-NNP,4,1
9474,60965.0,35,hoped,18,8,1,-7,7,33,10,-17,Barbara Boxer,Senate Environment and Public Works Committee,PERSON-PERSON,ORGANIZATION-ORGANIZATION-ORGANIZATION-ORGANIZATION-ORGANIZATION-ORGANIZATION,PROPN-PROPN,PROPN-PROPN-CCONJ-PROPN-PROPN-PROPN,compound-conj,compound-nsubj-cc-compound-compound-compound,NNP-NNP,NNP-NNP-CC-NNP-NNP-NNP,1,1
9475,66001.0,55,asked,15,1,9,8,0,45,14,-6,Barbara Boxer,Senate Environment and Public Works Committee,PERSON-PERSON,ORGANIZATION-ORGANIZATION-ORGANIZATION-ORGANIZATION-ORGANIZATION-ORGANIZATION,PROPN-PROPN,PROPN-PROPN-CCONJ-PROPN-PROPN-PROPN,compound-nsubj,compound-pobj-cc-compound-compound-conj,NNP-NNP,NNP-NNP-CC-NNP-NNP-NNP,5,1
9476,67264.0,47,said,36,2,8,6,1,38,34,-28,Barbara Boxer,Senate Environment and Public Works Committee,PERSON-PERSON,ORGANIZATION-ORGANIZATION-ORGANIZATION-ORGANIZATION-ORGANIZATION-ORGANIZATION,PROPN-PROPN,PROPN-PROPN-CCONJ-PROPN-PROPN-PROPN,compound-nsubj,compound-dobj-cc-compound-compound-conj,NNP-NNP,NNP-NNP-CC-NNP-NNP-NNP,2,1
9477,36556.0,23,says,2,1,11,10,0,11,1,9,Holly Montag,Heidi,PERSON-PERSON,PERSON,PROPN-PROPN,PROPN,compound-nsubj,appos,NNP-NNP,NNP,4,1
9478,59107.0,38,LCronin09,0,22,25,3,21,12,-22,25,Holly Montag,Heidi,PERSON-PERSON,PERSON,PROPN-PROPN,PROPN,compound-compound,poss,NNP-NNP,NNP,2,1
9479,36562.0,49,met,17,20,29,9,19,19,-3,12,Raul Castro,Council of State and Ministers,PERSON-PERSON,ORGANIZATION-ORGANIZATION-ORGANIZATION-ORGANIZATION-ORGANIZATION,PROPN-PROPN,PROPN-ADP-PROPN-CCONJ-PROPN,compound-compound,pobj-prep-pobj-cc-conj,NNP-NNP,NNP-IN-NNP-CC-NNP,5,1
9480,36569.0,18,said,8,15,10,-5,14,7,-7,2,Project Islamic HOPE,Najee Ali,ORGANIZATION-ORGANIZATION-ORGANIZATION,PERSON-PERSON,PROPN-PROPN-VERB,PROPN-PROPN,compound-compound-pobj,compound-nsubj,NNP-NNP-VBD,NNP-NNP,5,1
9481,36576.0,45,said,43,9,22,13,8,22,34,-21,Chris Dodd,Senator,PERSON-PERSON,TITLE,PROPN-PROPN,PROPN,compound-nsubj,compound,NNP-NNP,NNP,2,1
9482,59950.0,33,said,3,18,1,-17,17,31,-15,-2,Chris Dodd,Senator,PERSON-PERSON,TITLE,PROPN-PROPN,PROPN,compound-nsubj,compound,NNP-NNP,NNP,5,1
9483,36582.0,33,was,12,1,7,6,0,25,11,-5,Christopher Dodd,Thomas Dodd,PERSON-PERSON,PERSON-PERSON,PROPN-PROPN,PROPN-PROPN,compound-nsubj,compound-poss,NNP-NNP,NNP-NNP,4,1
9484,36586.0,27,was,19,19,22,3,18,4,0,3,he,judge,PERSON,TITLE,PRON,NOUN,nsubj,attr,PRP,NN,1,1
9485,36614.0,24,said,13,9,15,6,8,8,4,2,the Tax Policy Center,Leonard Burman,ORGANIZATION-ORGANIZATION-ORGANIZATION-ORGANIZATION,PERSON-PERSON,DET-PROPN-PROPN-PROPN,PROPN-PROPN,det-compound-compound-pobj,compound-nsubj,DT-NNP-NNP-NNP,NNP-NNP,5,1
9486,52335.0,40,said,11,15,20,5,14,19,-4,9,the Tax Policy Center,Leonard Burman,ORGANIZATION-ORGANIZATION-ORGANIZATION-ORGANIZATION,PERSON-PERSON,DET-PROPN-PROPN-PROPN,PROPN-PROPN,det-compound-compound-pobj,compound-appos,DT-NNP-NNP-NNP,NNP-NNP,4,1
9487,36634.0,25,said,15,11,17,6,10,7,4,2,New York Immigration Coalition,she,ORGANIZATION-ORGANIZATION-ORGANIZATION-ORGANIZATION,PERSON,PROPN-PROPN-PROPN-PROPN,PRON,compound-compound-compound-pobj,nsubj,NNP-NNP-NNP-NNP,PRP,9,1
9488,36642.0,30,acknowledged,13,27,1,-26,26,28,-14,-12,his,Hanna,PERSON,PERSON,DET,PROPN,poss,nsubj,PRP$,NNP,5,1
9489,36648.0,34,said,32,24,2,-22,23,31,8,-30,Scorpions,South Africa,ORGANIZATION,COUNTRY-COUNTRY,PROPN,PROPN-PROPN,nmod,compound-compound,NNPS,NNP-NNP,8,1
9490,63771.0,40,said,25,9,22,13,8,17,16,-3,Scorpions,South Africa,ORGANIZATION,COUNTRY-COUNTRY,PROPN,PROPN-PROPN,pobj,compound-pobj,NNPS,NNP-NNP,7,1
9491,36671.0,29,sent,10,1,8,7,0,20,9,-2,Chen,Shanghai,PERSON,CITY,PROPN,PROPN,nsubjpass,pobj,NNP,NNP,3,1
9492,36675.0,32,collected,19,2,9,7,1,22,17,-10,Jerusalem Foundation,1966,ORGANIZATION-ORGANIZATION,DATE,PROPN-PROPN,NUM,compound-nsubj,pobj,NNP-NNP,CD,3,1
9493,36692.0,37,came,2,18,13,-5,17,23,-16,11,John Negroponte,Deputy,PERSON-PERSON,TITLE,PROPN-PROPN,PROPN,compound-pobj,nmod,NNP-NNP,NNP,2,1
9494,36693.0,53,BANGKOK,0,27,19,-8,26,33,-27,19,Samsung,Thai company TWZ Corp,ORGANIZATION,ORGANIZATION-ORGANIZATION-ORGANIZATION-ORGANIZATION,PROPN,PROPN-NOUN-PROPN-PROPN,amod,compound-compound-compound-nsubj,NNP,NNP-NN-NNP-NNP,4,1
9495,36708.0,29,identified,3,5,5,0,4,23,-2,2,Ghent University,Ghent,ORGANIZATION-ORGANIZATION,LOCATION,PROPN-PROPN,PROPN,compound-dobj,pobj,NNP-NNP,NNP,0,1
9496,36717.0,12,included,5,10,3,-7,9,8,-5,-2,Richard Perle,company,PERSON-PERSON,ORGANIZATION,PROPN-PROPN,NOUN,compound-conj,poss,NNP-NNP,NN,5,1
9497,36731.0,36,is,1,1,7,6,0,28,0,6,Wildmon,American Family Association,PERSON,ORGANIZATION-ORGANIZATION-ORGANIZATION,PROPN,PROPN-PROPN-PROPN,nsubj,compound-compound-pobj,NNP,NNP-NNP-NNP,4,1
9498,36732.0,42,lifted,5,41,17,-24,40,24,-36,12,company,Deborah Jeane Palfrey,ORGANIZATION,PERSON-PERSON-PERSON,NOUN,PROPN-PROPN-PROPN,pobj,compound-compound-ccomp,NN,NNP-NNP-NNP,10,1
9499,36737.0,32,Weitz,2,6,2,-4,5,29,-4,0,Jewish National Fund,Joseph Weitz,ORGANIZATION-ORGANIZATION-ORGANIZATION,PERSON-PERSON,ADJ-PROPN-PROPN,PROPN-PROPN,amod-compound-compound,compound-ROOT,JJ-NNP-NNP,NNP-NNP,3,1
9500,36750.0,40,told,37,33,32,-1,32,7,4,-5,Christopher Dodd,Chairman,PERSON-PERSON,TITLE,PROPN-PROPN,PROPN,compound-nsubj,compound,NNP-NNP,NNP,2,1
9501,47883.0,30,planned,3,26,25,-1,25,4,-23,22,Christopher Dodd,Chairman,PERSON-PERSON,TITLE,PROPN-PROPN,PROPN,compound-ROOT,compound,NNP-NNP,NNP,1,1
9502,49747.0,25,called,8,5,4,-1,4,20,3,-4,Christopher Dodd,Chairman,PERSON-PERSON,TITLE,PROPN-PROPN,PROPN,compound-nsubj,compound,NNP-NNP,NNP,1,1
9503,54425.0,29,told,20,16,15,-1,15,13,4,-5,Christopher Dodd,Chairman,PERSON-PERSON,TITLE,PROPN-PROPN,PROPN,compound-nsubj,compound,NNP-NNP,NNP,1,1
9504,36760.0,12,was,1,1,11,10,0,0,0,10,She,Queens,PERSON,LOCATION,PRON,PROPN,nsubj,appos,PRP,NNP,1,1
9505,36811.0,49,received,6,8,5,-3,7,43,-2,-1,his,Col.,PERSON,TITLE,DET,PROPN,poss,compound,PRP$,NNP,4,1
9506,36818.0,54,needed,2,33,2,-31,32,51,-31,0,George Young,Hoops,PERSON-PERSON,ORGANIZATION,PROPN-PROPN,PROPN,compound-appos,nsubj,NNP-NNP,NNPS,8,1
9507,36819.0,25,UTC,2,5,8,3,4,16,-3,6,Donald Wildmon,69,PERSON-PERSON,NUMBER,PROPN-PROPN,NUM,compound-ROOT,appos,NNP-NNP,CD,3,1
9508,36822.0,19,said,6,1,5,4,0,13,5,-1,Awami League,Abdul Jalil,ORGANIZATION-ORGANIZATION,PERSON-PERSON,PROPN-PROPN,PROPN-PROPN,compound-compound,compound-nsubj,NNP-NNP,NNP-NNP,2,1
9509,40324.0,19,said,8,17,10,-7,16,8,-9,2,Awami League,Abdul Jalil,ORGANIZATION-ORGANIZATION,PERSON-PERSON,PROPN-PROPN,PROPN-PROPN,compound-pobj,compound-nsubj,NNP-NNP,NNP-NNP,3,1
9510,36825.0,55,survived,15,14,21,7,13,33,1,6,she,William Dent Crisp,PERSON,PERSON-PERSON-PERSON,PRON,PROPN-PROPN-PROPN,nsubjpass,compound-compound-appos,PRP,NNP-NNP-NNP,4,1
9511,36836.0,33,said,28,1,19,18,0,13,27,-9,Aerolineas Argentinas,SkyTeam,ORGANIZATION-ORGANIZATION,ORGANIZATION,PROPN-PROPN,PROPN,compound-nsubj,nsubj,NNP-NNP,NNP,3,1
9512,36847.0,16,described,2,9,1,-8,8,14,-7,-1,seminal,Dan Yeary,ORGANIZATION,PERSON-PERSON,ADJ,PROPN-PROPN,amod,compound-nsubj,JJ,NNP-NNP,5,1
9513,36850.0,18,born,2,1,9,8,0,8,1,7,He,1909,PERSON,DATE,PRON,NUM,nsubjpass,pobj,PRP,CD,2,1
9514,36851.0,35,survived,2,11,5,-6,10,29,-9,3,Emily Ann Kennard Derounian,his,PERSON-PERSON-PERSON-PERSON,PERSON,PROPN-PROPN-PROPN-PROPN,DET,compound-compound-compound-appos,poss,NNP-NNP-NNP-NNP,PRP$,5,1
9515,36866.0,37,placed,19,13,17,4,12,19,6,-2,his,Kate Moss,PERSON,PERSON-PERSON,DET,PROPN-PROPN,poss,compound-pobj,PRP$,NNP-NNP,2,1
9516,36876.0,28,is,1,23,27,4,22,0,-22,26,Chinese Communist Party,Beijing,ORGANIZATION-ORGANIZATION-ORGANIZATION,CITY,PROPN-PROPN-PROPN,PROPN,compound-compound-pobj,pobj,NNP-NNP-NNP,NNP,8,1
9517,36880.0,28,said,12,8,14,6,7,13,4,2,Inter American Press Association,he,ORGANIZATION-ORGANIZATION-ORGANIZATION-ORGANIZATION,PERSON,PROPN-PROPN-PROPN-PROPN,PRON,compound-compound-compound-pobj,nsubj,NNP-NNP-NNP-NNP,PRP,5,1
9518,66334.0,28,said,12,8,14,6,7,13,4,2,Inter American Press Association,he,ORGANIZATION-ORGANIZATION-ORGANIZATION-ORGANIZATION,PERSON,PROPN-PROPN-PROPN-PROPN,PRON,compound-compound-compound-pobj,nsubj,NNP-NNP-NNP-NNP,PRP,5,1
9519,66585.0,16,found,4,7,3,-4,6,12,-3,-1,Inter American Press Association,he,ORGANIZATION-ORGANIZATION-ORGANIZATION-ORGANIZATION,PERSON,PROPN-PROPN-PROPN-PROPN,PRON,compound-compound-compound-dobj,nsubj,NNP-NNP-NNP-NNP,PRP,3,1
9520,36895.0,23,plotting,7,5,4,-1,4,18,2,-3,Melanie Fiona,artist,PERSON-PERSON,TITLE,PROPN-PROPN,NOUN,compound-dobj,compound,NNP-NNP,NN,1,1
9521,59474.0,55,mokhal,0,16,15,-1,15,39,-16,15,Melanie Fiona,artist,PERSON-PERSON,TITLE,PROPN-PROPN,NOUN,compound-nsubj,compound,NNP-NNP,NN,3,1
9522,36910.0,13,run,2,10,5,-5,9,7,-8,3,Lashkar-e-Taiba,Hafiz Saeed,ORGANIZATION,PERSON-PERSON,PROPN,PROPN-PROPN,dobj,compound-pobj,NNP,NNP-NNP,4,1
9523,36930.0,24,pointed,15,13,6,-7,12,17,2,-9,APA,Steven Sharfstein,ORGANIZATION,PERSON-PERSON,PROPN,PROPN-PROPN,pobj,compound-pobj,NNP,NNP-NNP,5,1
9524,36935.0,31,discovered,10,9,7,-2,8,23,1,-3,Augustus Hawkins,California,PERSON-PERSON,STATE_OR_PROVINCE,PROPN-PROPN,PROPN,compound-conj,compound,NNP-NNP,NNP,1,1
9525,57354.0,31,discovered,10,9,7,-2,8,23,1,-3,Augustus Hawkins,California,PERSON-PERSON,STATE_OR_PROVINCE,PROPN-PROPN,PROPN,compound-conj,compound,NNP-NNP,NNP,1,1
9526,36956.0,21,bundles,1,3,1,-2,2,19,-2,0,DirecTV,Qwest,ORGANIZATION,ORGANIZATION,NOUN,ADJ,appos,amod,NN,JJ,2,1
9527,36969.0,40,Securities,5,4,8,4,3,31,1,3,Madoff Investment Securities,1960,ORGANIZATION-ORGANIZATION-ORGANIZATION,DATE,PROPN-PROPN-PROPN,NUM,compound-compound-ROOT,pobj,NNP-NNP-NNPS,CD,2,1
9528,36985.0,33,signed,3,21,8,-13,20,24,-18,5,ConAgra Foods,Smart Choices Program,ORGANIZATION-ORGANIZATION,ORGANIZATION-ORGANIZATION-ORGANIZATION,PROPN-PROPN,PROPN-PROPN-PROPN,compound-conj,compound-compound-pobj,NNP-NNP,NNP-NNPS-NNP,8,1
9529,36986.0,37,is,1,21,3,-18,20,33,-20,2,Awami National Party,secular,ORGANIZATION-ORGANIZATION-ORGANIZATION,RELIGION,PROPN-PROPN-PROPN,ADJ,compound-compound-pobj,acomp,NNP-NNP-NNP,JJ,9,1
9530,36989.0,41,said,10,7,40,33,6,0,3,30,Taiwan Research Institute,China,ORGANIZATION-ORGANIZATION-ORGANIZATION,COUNTRY,PROPN-PROPN-PROPN,PROPN,compound-compound-pobj,conj,NNP-NNP-NNP,NNP,6,1
9531,47336.0,34,said,16,25,33,8,24,0,-9,17,Taiwan Research Institute,China,ORGANIZATION-ORGANIZATION-ORGANIZATION,COUNTRY,PROPN-PROPN-PROPN,PROPN,compound-compound-pobj,pobj,NNP-NNP-NNP,NNP,6,1
9532,36998.0,34,promoted,3,26,1,-25,25,32,-23,-2,Lou Ferrara,The Associated Press,PERSON-PERSON,ORGANIZATION-ORGANIZATION-ORGANIZATION,PROPN-PROPN,DET-PROPN-PROPN,compound-conj,det-compound-nsubj,NNP-NNP,DT-NNP-NNP,5,1
9533,37010.0,84,are,1,6,19,13,5,64,-5,18,JL,LA,PERSON,STATE_OR_PROVINCE,PROPN,PROPN,pobj,nsubj,NNP,NNP,2,1
9534,37011.0,35,survived,2,5,12,7,4,22,-3,10,his,Ann Banks,PERSON,PERSON-PERSON,DET,PROPN-PROPN,poss,compound-conj,PRP$,NNP-NNP,4,1
9535,37022.0,41,Rothman,3,4,7,3,3,33,-1,4,Rothman,schoolteacher,PERSON,TITLE,PROPN,NOUN,ROOT,appos,NNP,NN,3,1
9536,58589.0,34,developed,7,1,6,5,0,27,6,-1,Rothman,schoolteacher,PERSON,TITLE,PROPN,NOUN,nsubj,attr,NNP,NN,3,1
9537,37030.0,31,told,6,25,15,-10,24,15,-19,9,National Security Council,Washington,ORGANIZATION-ORGANIZATION-ORGANIZATION,STATE_OR_PROVINCE,PROPN-PROPN-PROPN,PROPN,compound-compound-conj,pobj,NNP-NNP-NNP,NNP,3,1
9538,37053.0,22,are,5,20,19,-1,19,2,-15,14,Chris Simcox,president,PERSON-PERSON,TITLE,PROPN-PROPN,NOUN,compound-pobj,compound,NNP-NNP,NN,1,1
9539,37068.0,52,YANGON,0,3,1,-2,2,50,-3,1,Myanmar Timber Enterprise,YANGON,ORGANIZATION-ORGANIZATION-ORGANIZATION,LOCATION,PROPN-PROPN-PROPN,ADJ,compound-compound-pobj,ROOT,NNP-NNP-NNP,JJ,2,1
9540,37072.0,34,said,30,29,28,-1,28,5,1,-2,Chen Zhu,minister,PERSON-PERSON,TITLE,PROPN-PROPN,NOUN,compound-nsubj,compound,NNP-NNP,NN,1,1
9541,54271.0,31,told,6,4,2,-2,3,28,2,-4,Chen Zhu,minister,PERSON-PERSON,TITLE,PROPN-PROPN,NOUN,compound-appos,nsubj,NNP-NNP,NN,2,1
9542,57754.0,38,been,18,4,8,4,3,29,14,-10,Chen Zhu,minister,PERSON-PERSON,TITLE,PROPN-PROPN,NOUN,compound-conj,conj,NNP-NNP,NN,2,1
9543,62811.0,24,approved,2,8,23,15,7,0,-6,21,Chen Zhu,minister,PERSON-PERSON,TITLE,PROPN-PROPN,NOUN,compound-pobj,pobj,NNP-NNP,NN,4,1
9544,64610.0,32,said,26,30,29,-1,29,2,-4,3,Chen Zhu,minister,PERSON-PERSON,TITLE,PROPN-PROPN,NOUN,compound-nsubj,compound,NNP-NNP,NN,2,1
9545,37073.0,49,tells,27,16,5,-11,15,43,11,-22,MF Global,John Brady,ORGANIZATION-ORGANIZATION,PERSON-PERSON,PROPN-PROPN,PROPN-PROPN,compound-pobj,compound-nsubj,NNP-NNP,NNP-NNP,5,1
9546,37103.0,4,report,1,1,4,3,0,-1,0,3,APA,http://www.apa.org/pi/wpo/sexualization.html,ORGANIZATION,URL,PROPN,INTJ,compound,intj,NNP,UH,-1,1
9547,37126.0,27,liked,1,16,18,2,15,8,-15,17,his,United Kingdom,PERSON,COUNTRY-COUNTRY,DET,PROPN-PROPN,poss,compound-pobj,PRP$,NNP-NNP,1,1
9548,37130.0,29,announced,2,11,22,11,10,6,-9,20,Option One Mortgage Corp,Cerberus Capital Management LP,ORGANIZATION-ORGANIZATION-ORGANIZATION-ORGANIZATION,ORGANIZATION-ORGANIZATION-ORGANIZATION-ORGANIZATION,PROPN-PROPN-PROPN-PROPN,PROPN-PROPN-PROPN-PROPN,compound-compound-compound-dobj,compound-compound-compound-pobj,NNP-NNP-NNP-NNP,NNP-NNP-NNP-NNP,7,1
9549,37155.0,33,wrote,1,14,18,4,13,14,-13,17,CC,River,ORGANIZATION,LOCATION,PROPN,PROPN,pobj,dobj,NNP,NNP,2,1
9550,37165.0,16,Jafar,2,6,15,9,5,0,-4,13,He,Soltam,PERSON,ORGANIZATION,PRON,PROPN,nsubj,appos,PRP,NNP,-1,1
9551,37170.0,40,had,2,16,4,-12,15,35,-14,2,Britney Spears,his,PERSON-PERSON,PERSON,PROPN-PROPN,DET,compound-appos,poss,NNP-NNPS,PRP$,6,1
9552,37216.0,25,said,17,2,19,17,1,5,15,2,DirecTV,Jon Gieselman,ORGANIZATION,PERSON-PERSON,NOUN,PROPN-PROPN,compound,compound-nsubj,NN,NNP-NNP,4,1
9553,37219.0,25,merged,6,6,4,-2,5,20,0,-2,Minolta,Konica Minolta Holdings Inc.,ORGANIZATION,ORGANIZATION-ORGANIZATION-ORGANIZATION-ORGANIZATION,PROPN,PROPN-PROPN-PROPN-PROPN,conj,compound-compound-compound-dobj,NNP,NNP-NNP-NNP-NNP,2,1
9554,37228.0,39,helped,18,37,35,-2,36,3,-19,17,Li Jie,central defender,PERSON-PERSON,TITLE-TITLE,PROPN-PROPN,ADJ-NOUN,compound-nsubj,amod-compound,NNP-NNP,JJ-NN,3,1
9555,37230.0,49,accused,28,11,31,20,10,17,17,3,IAPA,Miami,ORGANIZATION,CITY,PROPN,PROPN,dobj,npadvmod,NNP,NNP,5,1
9556,37241.0,28,is,2,11,16,5,10,11,-9,14,Badr Corps,Revolutionary Guards in Iran,ORGANIZATION-ORGANIZATION,ORGANIZATION-ORGANIZATION-ORGANIZATION-ORGANIZATION,PROPN-PROPN,PROPN-PROPN-ADP-PROPN,compound-pobj,compound-pobj-prep-pobj,NNP-NNP,NNP-NNPS-IN-NNP,3,1
9557,37255.0,25,seek,9,16,8,-8,15,16,-7,-1,Jacksonville Jaguars,Florida,ORGANIZATION-ORGANIZATION,STATE_OR_PROVINCE,PROPN-PROPN,PROPN,compound-pobj,compound,NNP-NNPS,NNP,3,1
9558,37258.0,33,said,22,1,15,14,0,17,21,-7,Yolanda Denise King,Martin Luther King Jr.,PERSON-PERSON-PERSON,PERSON-PERSON-PERSON-PERSON,PROPN-PROPN-PROPN,PROPN-PROPN-PROPN-PROPN,compound-compound-nsubj,compound-compound-compound-appos,NNP-NNP-NNP,NNP-NNP-NNP-NNP,6,1
9559,37266.0,38,formed,14,1,22,21,0,15,13,8,Alcatel-Lucent,Lucent Technologies,ORGANIZATION,ORGANIZATION-ORGANIZATION,ADJ,PROPN-PROPN,nsubjpass,compound-pobj,JJ,NNP-NNP,5,1
9560,37277.0,42,is,37,6,1,-5,5,40,31,-36,Art Buchwald,WASHINGTON,PERSON-PERSON,STATE_OR_PROVINCE,PROPN-PROPN,PROPN,compound-conj,compound,NNP-NNP,NNP,2,1
9561,37290.0,36,said,27,34,29,-5,33,6,-7,2,Citibank,Richard Stanley,ORGANIZATION,PERSON-PERSON,PROPN,PROPN-PROPN,compound,compound-nsubj,NNP,NNP-NNP,5,1
9562,60912.0,32,said,19,24,21,-3,23,10,-5,2,Citibank,Richard Stanley,ORGANIZATION,PERSON-PERSON,PROPN,PROPN-PROPN,compound,compound-nsubj,NNP,NNP-NNP,2,1
9563,37291.0,28,said,11,1,7,6,0,20,10,-4,Christopher Bentley,Citizenship and Immigration Services,PERSON-PERSON,ORGANIZATION-ORGANIZATION-ORGANIZATION-ORGANIZATION,PROPN-PROPN,PROPN-CCONJ-PROPN-PROPN,compound-nsubj,nmod-cc-conj-pobj,NNP-NNP,NNP-CC-NNP-NNPS,5,1
9564,37292.0,39,football,7,33,4,-29,32,34,-26,-3,NFC South,New Orleans Saints,ORGANIZATION-ORGANIZATION,ORGANIZATION-ORGANIZATION-ORGANIZATION,PROPN-PROPN,PROPN-PROPN-PROPN,compound-pobj,compound-compound-conj,NNP-NNP,NNP-NNP-NNPS,-1,1
9565,38578.0,37,see,25,15,20,5,14,16,10,-5,NFC South,New Orleans Saints,ORGANIZATION-ORGANIZATION,ORGANIZATION-ORGANIZATION-ORGANIZATION,PROPN-PROPN,PROPN-PROPN-PROPN,compound-compound,compound-compound-pobj,NNP-NNP,NNP-NNP-NNPS,4,1
9566,44461.0,35,bye,33,26,17,-9,25,17,7,-16,NFC South,New Orleans Saints,ORGANIZATION-ORGANIZATION,ORGANIZATION-ORGANIZATION-ORGANIZATION,PROPN-PROPN,PROPN-PROPN-PROPN,compound-compound,compound-compound-dobj,NNP-NNP,NNP-NNP-NNPS,6,1
9567,37315.0,38,declared,3,16,29,13,15,8,-13,26,AL,Hasina,ORGANIZATION,PERSON,PROPN,PROPN,compound,poss,NNP,NNP,7,1
9568,37332.0,50,said,47,38,46,8,37,3,9,-1,Mainland Affairs Council,Liu Te-hsun,ORGANIZATION-ORGANIZATION-ORGANIZATION,PERSON-PERSON,PROPN-PROPN-PROPN,PROPN-PROPN,compound-compound-nsubj,compound-nsubj,NNP-NNPS-NNP,NNP-NNP,14,1
9569,37339.0,56,Cutrone,1,1,51,50,0,4,0,50,Kelly Cutrone,New York,PERSON-PERSON,CITY-CITY,PROPN-PROPN,PROPN-PROPN,compound-compound,compound-pobj,NNP-NNP,NNP-NNP,-1,1
9570,37343.0,26,sued,7,4,10,6,3,15,3,3,he,libel,PERSON,CRIMINAL_CHARGE,PRON,NOUN,nsubjpass,pobj,PRP,NN,2,1
9571,37365.0,32,saw,1,19,21,2,18,10,-18,20,Citibank,Shaukat Aziz,ORGANIZATION,PERSON-PERSON,PROPN,PROPN-PROPN,compound,compound-nsubj,NNP,NNP-NNP,2,1
9572,37372.0,40,quoted,9,3,6,3,2,33,6,-3,JEM,Mohammed Bahr Hamdeen,ORGANIZATION,PERSON-PERSON-PERSON,PROPN,PROPN-PROPN-PROPN,compound,compound-compound-oprd,NNP,NNP-NNP-NNP,3,1
9573,37390.0,23,ran,1,1,4,3,0,18,0,3,She,Institute for Defense and Disarmament Studies,PERSON,ORGANIZATION-ORGANIZATION-ORGANIZATION-ORGANIZATION-ORGANIZATION-ORGANIZATION,PRON,PROPN-ADP-PROPN-CCONJ-PROPN-PROPN,nsubj,dobj-prep-nmod-cc-conj-pobj,PRP,NNP-IN-NNP-CC-NNP-NNPS,2,1
9574,37400.0,72,declared,30,52,63,11,51,8,-22,33,Chris Dodd,Senate,PERSON-PERSON,ORGANIZATION,PROPN-PROPN,PROPN,compound-nsubj,pobj,NNP-NNP,NNP,2,1
9575,42940.0,26,trying,2,21,24,3,20,1,-19,22,Chris Dodd,Senate,PERSON-PERSON,ORGANIZATION,PROPN-PROPN,PROPN,compound-poss,compound,NNP-NNP,NNP,3,1
9576,37410.0,26,said,13,23,15,-8,22,10,-10,2,American Bankers Association,Keith Leggett,ORGANIZATION-ORGANIZATION-ORGANIZATION,PERSON-PERSON,PROPN-PROPN-PROPN,PROPN-PROPN,compound-compound-pobj,compound-nsubj,NNP-NNPS-NNP,NNP-NNP,5,1
9577,37412.0,23,See,0,18,22,4,17,0,-18,22,Federal Election Commission,www.fec.gov,ORGANIZATION-ORGANIZATION-ORGANIZATION,URL,PROPN-PROPN-PROPN,PROPN,compound-compound-pobj,pobj,NNP-NNP-NNP,NNP,5,1
9578,37417.0,39,said,12,8,10,2,7,28,4,-2,Denso,North America,ORGANIZATION,LOCATION-LOCATION,PROPN,PROPN-PROPN,pobj,compound-pobj,NNP,NNP-NNP,1,1
9579,37448.0,40,played,15,22,2,-20,21,37,-7,-13,his,Canadian,PERSON,NATIONALITY,DET,ADJ,poss,amod,PRP$,JJ,6,1
9580,45548.0,44,is,2,18,26,8,17,17,-16,24,his,Canadian,PERSON,NATIONALITY,DET,ADJ,poss,amod,PRP$,JJ,8,1
9581,37457.0,41,has,2,15,15,0,14,25,-13,13,Royal Caribbean,Royal Caribbean,ORGANIZATION-ORGANIZATION,ORGANIZATION-ORGANIZATION,ADJ-PROPN,ADJ-ADJ,compound-appos,compound-amod,JJ-NNP,JJ-JJ,0,1
9582,37486.0,36,said,4,7,3,-4,6,32,-3,-1,his,72,PERSON,NUMBER,DET,NUM,poss,appos,PRP$,CD,3,1
9583,37497.0,42,said,16,13,9,-4,12,32,3,-7,Oxford University Press,academic division,ORGANIZATION-ORGANIZATION-ORGANIZATION,ORGANIZATION-ORGANIZATION,PROPN-PROPN-PROPN,ADJ-NOUN,compound-compound-pobj,amod-pobj,NNP-NNP-NNP,JJ-NN,4,1
9584,37498.0,39,expecting,2,29,34,5,28,4,-27,32,Barbara Boxer,Leader,PERSON-PERSON,TITLE,PROPN-PROPN,PROPN,compound-dep,conj,NNP-NNP,NNP,4,1
9585,37510.0,32,reported,30,18,21,3,17,10,12,-9,NSC,Thawil Pliensri,ORGANIZATION,PERSON-PERSON,PROPN,PROPN-PROPN,compound,compound-appos,NNP,NNP-NNP,2,1
9586,37517.0,33,died,12,10,19,9,9,13,2,7,Robert McNair,Berkeley County,PERSON-PERSON,LOCATION-LOCATION,PROPN-PROPN,PROPN-PROPN,compound-pobj,compound-pobj,NNP-NNP,NNP-NNP,8,1
9587,37519.0,39,found,19,14,16,2,13,22,5,-3,Farrow,Dream for Darfur,PERSON,ORGANIZATION-ORGANIZATION-ORGANIZATION,PROPN,PROPN-ADP-PROPN,nsubj,conj-prep-pobj,NNP,NNP-IN-NNP,2,1
9588,37524.0,33,was,9,9,8,-1,8,24,0,-1,Ferrara,42-year-old,PERSON,DURATION,PROPN,NUM,nsubj,nummod,NNP,CD,1,1
9589,52734.0,33,began,9,9,8,-1,8,24,0,-1,Ferrara,42-year-old,PERSON,DURATION,PROPN,NUM,nsubj,compound,NNP,CD,1,1
9590,37526.0,45,recalls,21,38,43,5,37,1,-17,22,he,Carolina Ballet,PERSON,ORGANIZATION-ORGANIZATION,PRON,PROPN-PROPN,nsubj,compound-pobj,PRP,NNP-NNP,5,1
9591,37556.0,42,admin,0,4,41,37,3,0,-4,41,Ali Fedotowsky,Facebook,PERSON-PERSON,ORGANIZATION,PROPN-PROPN,PROPN,compound-nsubj,pobj,NNP-NNP,NNP,-1,1
9592,57517.0,32,reports,2,11,7,-4,10,24,-9,5,Ali Fedotowsky,Facebook,PERSON-PERSON,ORGANIZATION,PROPN-PROPN,PROPN,compound-dobj,compound,NNP-NNP,NNP,4,1
9593,37572.0,51,died,40,1,12,11,0,38,39,-28,Richard Nolte,American,PERSON-PERSON,NATIONALITY,PROPN-PROPN,ADJ,compound-nsubj,amod,NNP-NNP,JJ,2,1
9594,46042.0,51,died,40,1,12,11,0,38,39,-28,Richard Nolte,American,PERSON-PERSON,NATIONALITY,PROPN-PROPN,ADJ,compound-nsubj,amod,NNP-NNP,JJ,2,1
9595,37576.0,37,was,12,3,8,5,2,28,9,-4,Harry Dent,author,PERSON-PERSON,TITLE,PROPN-PROPN,NOUN,compound-nsubj,dobj,NNP-NNP,NN,4,1
9596,37585.0,44,told,13,11,1,-10,10,42,2,-12,Hugo Chavez,Adan Chavez,PERSON-PERSON,PERSON-PERSON,PROPN-PROPN,PROPN-PROPN,compound-pobj,compound-nsubj,NNP-NNP,NNP-NNP,4,1
9597,37592.0,49,met,18,16,13,-3,15,35,2,-5,Ali Larijani,chief nuclear,PERSON-PERSON,TITLE-TITLE,PROPN-PROPN,ADJ-ADJ,compound-pobj,amod-amod,NNP-NNP,JJ-JJ,1,1
9598,37593.0,29,continued,12,1,10,9,0,18,11,-2,Ellen DeGeneres,union,PERSON-PERSON,ORGANIZATION,PROPN-PROPN,NOUN,compound-nsubj,pobj,NNP-NNP,NN,2,1
9599,37607.0,38,Project,5,28,9,-19,27,28,-23,4,American Bar Association,US,ORGANIZATION-ORGANIZATION-ORGANIZATION,COUNTRY,PROPN-PROPN-PROPN,PROPN,compound-compound-compound,compound,NNP-NNP-NNP,NNP,11,1
9600,65994.0,36,complains,4,16,1,-15,15,34,-12,-3,American Bar Association,US,ORGANIZATION-ORGANIZATION-ORGANIZATION,COUNTRY,PROPN-PROPN-PROPN,PROPN,compound-compound-pobj,compound,NNP-NNP-NNP,NNP,9,1
9601,37615.0,17,said,11,13,15,2,12,1,-2,4,FEC,Robert Lenhard,ORGANIZATION,PERSON-PERSON,PROPN,PROPN-PROPN,compound,compound-nsubj,NNP,NNP-NNP,3,1
9602,37619.0,47,died,32,1,13,12,0,33,31,-19,Jennifer Dunn,House of Representatives,PERSON-PERSON,ORGANIZATION-ORGANIZATION-ORGANIZATION,PROPN-PROPN,PROPN-ADP-PROPN,compound-nsubj,pobj-prep-pobj,NNP-NNP,NNP-IN-NNPS,5,1
9603,37625.0,22,won,4,1,13,12,0,8,3,9,Olivia,US Elle,PERSON,ORGANIZATION-ORGANIZATION,PROPN,PROPN-PROPN,poss,compound-pobj,NNP,NNP-NNP,8,1
9604,37629.0,28,is,9,25,17,-8,24,10,-16,8,Carnival Cruise Lines,Robert Blythman,ORGANIZATION-ORGANIZATION-ORGANIZATION,PERSON-PERSON,PROPN-PROPN-NOUN,PROPN-PROPN,compound-compound-pobj,compound-pobj,NNP-NNP-NNS,NNP-NNP,6,1
9605,37630.0,36,fans,1,6,4,-2,5,31,-5,3,Millonarios,Bogota,ORGANIZATION,CITY,PROPN,PROPN,pobj,poss,NNP,NNP,5,1
9606,37637.0,28,said,11,24,19,-5,23,8,-13,8,Jackson Hewitt,tax preparer,PERSON-PERSON,TITLE-TITLE,PROPN-PROPN,NOUN-NOUN,compound-pobj,compound-compound,NNP-NNP,NN-NN,4,1
9607,66174.0,12,is,2,1,7,6,0,4,1,5,Jackson Hewitt,tax preparer,PERSON-PERSON,TITLE-TITLE,PROPN-PROPN,NOUN-NOUN,compound-nsubj,compound-attr,NNP-NNP,NN-NN,3,1
9608,37644.0,39,Prefers,5,1,23,22,0,15,4,18,Shannon York <shannony@wallacom> Juliette Binoche,actress,PERSON-PERSON-PERSON-PERSON-PERSON,TITLE,PROPN-PROPN-PROPN-PROPN-PROPN,NOUN,compound-npadvmod-appos-compound-compound,compound,NNP-NNP-NNP-NNP-NNP,NN,3,1
9609,37646.0,47,delivered,11,8,20,12,7,26,3,9,CPC,Political Bureau of the CPC Central Committee,ORGANIZATION,ORGANIZATION-ORGANIZATION-ORGANIZATION-ORGANIZATION-ORGANIZATION-ORGANIZATION-ORGANIZATION,PROPN,PROPN-PROPN-ADP-DET-PROPN-PROPN-PROPN,pobj,compound-pobj-prep-det-compound-compound-pobj,NNP,NNP-NNP-IN-DT-NNP-NNP-NNP,9,1
9610,37649.0,12,served,2,1,8,7,0,3,1,6,She,Washington State Republican Party,PERSON,ORGANIZATION-ORGANIZATION-ORGANIZATION-ORGANIZATION,PRON,PROPN-PROPN-PROPN-PROPN,nsubj,compound-compound-compound-pobj,PRP,NNP-NNP-NNP-NNP,6,1
9611,37663.0,27,seized,3,9,23,14,8,3,-6,20,NFC South,National Football League,ORGANIZATION-ORGANIZATION,ORGANIZATION-ORGANIZATION-ORGANIZATION,PROPN-PROPN,PROPN-PROPN-PROPN,compound-compound,compound-compound-compound,NNP-NNP,NNP-NNP-NNP,8,1
9612,67494.0,35,find,12,31,22,-9,30,12,-19,10,NFC South,National Football League,ORGANIZATION-ORGANIZATION,ORGANIZATION-ORGANIZATION-ORGANIZATION,PROPN-PROPN,PROPN-PROPN-PROPN,compound-dobj,compound-compound-compound,NNP-NNP,NNP-NNP-NNP,10,1
9613,37667.0,36,announced,4,2,11,9,1,24,2,7,American Red Cross,Gail J McGovern,ORGANIZATION-ORGANIZATION-ORGANIZATION,PERSON-PERSON-PERSON,PROPN-PROPN-PROPN,PROPN-PROPN-PROPN,compound-compound-nsubj,compound-compound-dobj,NNP-NNP-NNP,NNP-NNP-NNP,5,1
9614,37673.0,64,added,2,9,25,16,8,38,-7,23,IAPA,Venezuela,ORGANIZATION,COUNTRY,PROPN,PROPN,compound,conj,NNP,NNP,8,1
9615,37675.0,50,immersed,6,4,2,-2,3,47,2,-4,Juliet Binoche,French,PERSON-PERSON,NATIONALITY,PROPN-PROPN,ADJ,compound-nsubj,amod,NNP-NNP,JJ,1,1
9616,37679.0,22,said,1,1,11,10,0,10,0,10,Salehi said Iran should try to satisfy the International Atomic,Energy Agency,PERSON-PERSON-PERSON-PERSON-PERSON-PERSON-PERSON-PERSON-PERSON-PERSON,ORGANIZATION-ORGANIZATION,PROPN-VERB-PROPN-VERB-VERB-PART-VERB-DET-PROPN-PROPN,PROPN-PROPN,nsubj-ROOT-nsubj-aux-ccomp-aux-xcomp-det-compound-compound,compound-dobj,NNP-VBD-NNP-MD-VB-TO-VB-DT-NNP-NNP,NNP-NNP,3,1
9617,37688.0,34,is,1,33,17,-16,32,16,-32,16,KGB,USSR,ORGANIZATION,LOCATION,PROPN,PROPN,conj,pobj,NNP,NNP,3,1
9618,37693.0,21,dies,10,1,6,5,0,14,9,-4,Yolanda King,Martin Luther King Jr,PERSON-PERSON,PERSON-PERSON-PERSON-PERSON,PROPN-PROPN,PROPN-PROPN-PROPN-PROPN,compound-nsubj,compound-compound-compound-pobj,NNP-NNP,NNP-NNP-NNP-NNP,4,1
9619,54127.0,26,dies,10,1,6,5,0,19,9,-4,Yolanda King,Martin Luther King Jr,PERSON-PERSON,PERSON-PERSON-PERSON-PERSON,PROPN-PROPN,PROPN-PROPN-PROPN-PROPN,compound-nsubj,compound-compound-compound-pobj,NNP-NNP,NNP-NNP-NNP-NNP,4,1
9620,58464.0,32,dies,10,1,6,5,0,25,9,-4,Yolanda King,Martin Luther King Jr,PERSON-PERSON,PERSON-PERSON-PERSON-PERSON,PROPN-PROPN,PROPN-PROPN-PROPN-PROPN,compound-nsubj,compound-compound-compound-pobj,NNP-NNP,NNP-NNP-NNP-NNP,4,1
9621,37713.0,15,survived,2,1,11,10,0,3,1,9,She,Dexter,PERSON,PERSON,PRON,PROPN,nsubjpass,conj,PRP,NNP,4,1
9622,37729.0,28,reshuffled,11,20,1,-19,19,26,-9,-10,Philip Chen,Cathay Pacific Airways Ltd.,PERSON-PERSON,ORGANIZATION-ORGANIZATION-ORGANIZATION-ORGANIZATION,PROPN-PROPN,PROPN-PROPN-PROPN-PROPN,compound-dobj,compound-compound-compound-nsubj,NNP-NNP,NNP-NNP-NNP-NNP,4,1
9623,37733.0,34,born,4,1,9,8,0,24,3,5,Philip Mayer Kaiser,N.Y.,PERSON-PERSON-PERSON,STATE_OR_PROVINCE,PROPN-PROPN-PROPN,PROPN,compound-compound-nsubjpass,appos,NNP-NNP-NNP,NNP,3,1
9624,37735.0,43,opened,17,1,6,5,0,36,16,-11,Raul Castro,Alejandro Castro Espin,PERSON-PERSON,PERSON-PERSON-PERSON,PROPN-PROPN,PROPN-PROPN-PROPN,compound-nsubj,compound-compound-pobj,NNP-NNP,NNP-NNP-NNP,4,1
9625,37736.0,70,TAIWANESE,4,37,41,4,36,28,-33,37,Taiwan Research Institute,Lee An-ni,ORGANIZATION-ORGANIZATION-ORGANIZATION,PERSON-PERSON,PROPN-PROPN-PROPN,PROPN-PROPN,compound-compound-pobj,compound-nsubj,NNP-NNP-NNP,NNP-NNP,4,1
9626,43733.0,48,said,20,15,19,4,14,28,5,-1,Taiwan Research Institute,Lee An-ni,ORGANIZATION-ORGANIZATION-ORGANIZATION,PERSON-PERSON,PROPN-PROPN-PROPN,PROPN-PROPN,compound-compound-pobj,compound-nsubj,NNP-NNP-NNP,NNP-NNP,4,1
9627,37738.0,21,told,2,4,13,9,3,7,-2,11,Brandon McInerney,Young Marines,PERSON-PERSON,ORGANIZATION-ORGANIZATION,PROPN-PROPN,PROPN-PROPN,compound-dobj,compound-compound,NNP-NNP,NNP-NNPS,4,1
9628,37743.0,16,co-sponsored,3,15,13,-2,14,2,-12,10,IAPA,Mexico,ORGANIZATION,COUNTRY,PROPN,PROPN,conj,poss,NNP,NNP,4,1
9629,37746.0,20,fought,13,10,13,3,9,6,3,0,Family,Bolin,PERSON,ORGANIZATION,PROPN,PROPN,compound,nsubj,NNP,NNP,2,1
9630,37751.0,44,said,9,1,8,7,0,35,8,-1,George Young,house,PERSON-PERSON,ORGANIZATION,PROPN-PROPN,NOUN,compound-nsubj,pobj,NNP-NNP,NN,2,1
9631,37752.0,46,founded,3,20,17,-3,19,28,-17,14,Zagat,Tim,ORGANIZATION,PERSON,PROPN,PROPN,conj,pobj,NNP,NNP,4,1
9632,45713.0,48,put,35,1,13,12,0,34,34,-22,Zagat,Tim,ORGANIZATION,PERSON,PROPN,PROPN,compound,pobj,NNP,NNP,7,1
9633,37753.0,46,said,44,32,36,4,31,9,12,-8,ConAgra Foods,U.S.,ORGANIZATION-ORGANIZATION,COUNTRY,PROPN-PROPN,PROPN,compound-conj,compound,NNP-NNP,NNP,1,1
9634,37760.0,36,accepted,10,10,10,0,9,25,0,0,Jacksonville,Jacksonville,ORGANIZATION,ORGANIZATION,PROPN,PROPN,nsubj,pobj,NNP,NNP,0,1
9635,37767.0,40,quoted,7,4,25,21,3,14,3,18,Korean Central News Agency,South Korea,ORGANIZATION-ORGANIZATION-ORGANIZATION-ORGANIZATION,COUNTRY-COUNTRY,PROPN-PROPN-PROPN-PROPN,PROPN-PROPN,compound-compound-compound-nsubj,compound-pobj,NNP-NNP-NNP-NNP,NNP-NNP,6,1
9636,37769.0,64,said,31,39,33,-6,38,30,-8,2,Multidisciplinary Association for Psychedelic Studies,Richard Doblin,ORGANIZATION-ORGANIZATION-ORGANIZATION-ORGANIZATION-ORGANIZATION,PERSON-PERSON,PROPN-PROPN-ADP-PROPN-PROPN,PROPN-PROPN,compound-pobj-prep-compound-pobj,compound-nsubj,NNP-NNP-IN-NNP-NNPS,NNP-NNP,5,1
9637,63706.0,29,said,12,24,14,-10,23,14,-12,2,Multidisciplinary Association for Psychedelic Studies,Richard Doblin,ORGANIZATION-ORGANIZATION-ORGANIZATION-ORGANIZATION-ORGANIZATION,PERSON-PERSON,PROPN-PROPN-ADP-PROPN-PROPN,PROPN-PROPN,compound-dobj-prep-compound-pobj,compound-nsubj,NNP-NNP-IN-NNP-NNPS,NNP-NNP,6,1
9638,37776.0,27,promoted,7,6,14,8,5,12,1,7,he,Air Force Reserve,PERSON,ORGANIZATION-ORGANIZATION-ORGANIZATION,PRON,PROPN-PROPN-PROPN,nsubjpass,compound-compound-pobj,PRP,NNP-NNP-NNP,4,1
9639,37795.0,28,was,4,1,7,6,0,20,3,3,Knoxville,executive producer,PERSON,TITLE-TITLE,PROPN,ADJ-NOUN,nsubj,amod-attr,NNP,JJ-NN,3,1
9640,37810.0,37,was,5,5,10,5,4,26,0,5,she,instructor,PERSON,TITLE,PRON,NOUN,nsubj,attr,PRP,NN,4,1
9641,37829.0,38,*,0,5,2,-3,4,35,-5,2,Britney,Kevin Federline,PERSON,PERSON-PERSON,PROPN,PROPN-PROPN,nsubj,compound-nsubj,NNP,NNP-NNP,3,1
9642,37835.0,29,called,22,8,1,-7,7,27,14,-21,his,IAEA,PERSON,ORGANIZATION,DET,PROPN,poss,compound,PRP$,NNP,6,1
9643,37840.0,43,held,13,20,19,-1,19,23,-7,6,Gholamali Haddad Adel,Speaker,PERSON-PERSON-PERSON,TITLE,PROPN-PROPN-PROPN,PROPN,compound-compound-pobj,compound,NNP-NNP-NNP,NNP,1,1
9644,37862.0,14,turned,2,9,11,2,8,2,-7,9,her,Sasha,PERSON,PERSON,DET,PROPN,poss,appos,PRP$,NNP,1,1
9645,37870.0,32,was,16,16,18,2,15,13,0,2,Kaiser,deputy chief,PERSON,TITLE-TITLE,PROPN,ADJ-NOUN,nsubj,amod-attr,NNP,JJ-NN,1,1
9646,37871.0,9,succeeded,7,7,2,-5,6,6,0,-5,he,lieutenant governor,PERSON,TITLE-TITLE,PRON,NOUN-NOUN,nsubj,amod-pobj,PRP,NN-NN,2,1
9647,61278.0,29,succeeded,7,7,2,-5,6,26,0,-5,he,lieutenant governor,PERSON,TITLE-TITLE,PRON,NOUN-NOUN,nsubj,amod-pobj,PRP,NN-NN,2,1
9648,37885.0,27,argued,25,1,20,19,0,6,24,-5,Spears,Federline,PERSON,PERSON,NOUN,PROPN,nsubj,poss,NNS,NNP,-1,1
9649,37892.0,35,Sills,1,1,5,4,0,29,0,4,Beverly Sills,Star,PERSON-PERSON,TITLE,PROPN-PROPN,PROPN,compound-ROOT,appos,NNP-NNP,NNP,2,1
9650,37903.0,48,wrote,5,14,12,-2,13,35,-9,7,Michael Sandy,New Yorker,PERSON-PERSON,CITY-CITY,PROPN-PROPN,PROPN-PROPN,compound-pobj,compound-compound,NNP-NNP,NNP-NNP,1,1
9651,37929.0,33,added,31,10,20,10,9,12,21,-11,Chunghwa Telecom Co.,Tatung Group,ORGANIZATION-ORGANIZATION-ORGANIZATION,ORGANIZATION-ORGANIZATION,PROPN-PROPN-PROPN,PROPN-PROPN,compound-compound-pobj,compound-conj,NNP-NNP-NNP,NNP-NNP,3,1
9652,37931.0,23,CONAKRY,0,5,1,-4,4,21,-5,1,Mia Farrow,CONAKRY,PERSON-PERSON,CITY,PROPN-PROPN,ADJ,compound-nsubj,ROOT,NNP-NNP,JJ,-1,1
9653,37932.0,34,says,9,1,5,4,0,28,8,-4,Al Hubbard,president,PERSON-PERSON,TITLE,PROPN-PROPN,NOUN,compound-nsubj,poss,NNP-NNP,NN,3,1
9654,37937.0,45,said,31,21,11,-10,20,33,10,-20,FMR Co,Stephen P Jonas,ORGANIZATION-ORGANIZATION,PERSON-PERSON-PERSON,PROPN-PROPN,PROPN-PROPN-PROPN,nmod-nmod,compound-compound-dobj,NNP-NNP,NNP-NNP-NNP,6,1
9655,37944.0,35,was,2,1,26,25,0,8,1,24,She,International Neighbors Society,PERSON,ORGANIZATION-ORGANIZATION-ORGANIZATION,PRON,PROPN-PROPN-PROPN,nsubj,compound-compound-conj,PRP,NNP-NNPS-NNP,6,1
9656,37954.0,31,'s,1,28,23,-5,27,7,-27,22,American Psychological Association,Kazdin,ORGANIZATION-ORGANIZATION-ORGANIZATION,PERSON,PROPN-PROPN-PROPN,PROPN,compound-compound-pobj,dep,NNP-NNP-NNP,NNP,5,1
9657,37975.0,15,is,1,13,3,-10,12,11,-12,2,Paul Sculfor,36-year old,PERSON-PERSON,DURATION-DURATION,PROPN-PROPN,ADJ-ADJ,compound-conj,nummod-amod,NNP-NNP,JJ-JJ,5,1
9658,37981.0,35,was,4,11,4,-7,10,30,-7,0,Citibank,Citigroup,ORGANIZATION,ORGANIZATION,PROPN,PROPN,compound,nsubj,NNP,NNP,2,1
9659,66093.0,33,fell,1,17,1,-16,16,31,-16,0,Citibank,Citigroup,ORGANIZATION,ORGANIZATION,PROPN,PROPN,appos,nsubj,NNP,NNP,2,1
9660,38019.0,38,said,36,1,7,6,0,30,35,-29,FAW,Volkswagen AG,ORGANIZATION,ORGANIZATION-ORGANIZATION,PROPN,PROPN-PROPN,nsubj,compound-pobj,NNP,NNP-NNP,4,1
9661,38030.0,54,CORRECTIONS,3,20,51,31,19,2,-17,48,Jane Bolin,lawyer,PERSON-PERSON,TITLE,PROPN-PROPN,NOUN,compound-pobj,pobj,NNP-NNP,NN,11,1
9662,38041.0,25,been,16,9,2,-7,8,22,7,-14,Britney,Jamie Lynn,PERSON,PERSON-PERSON,PROPN,PROPN-PROPN,poss,compound-poss,NNP,NNP-NNP,4,1
9663,38042.0,45,dies,12,3,1,-2,2,43,9,-11,Parren Mitchell,US,PERSON-PERSON,NATIONALITY,PROPN-PROPN,PROPN,compound-nsubj,compound,NNP-NNP,NNP,1,1
9664,39038.0,38,dies,12,3,1,-2,2,36,9,-11,Parren Mitchell,US,PERSON-PERSON,ORGANIZATION,PROPN-PROPN,PROPN,compound-nsubj,compound,NNP-NNP,NNP,1,1
9665,38044.0,36,had,20,26,13,-13,25,22,-6,-7,CPS,Tucson,ORGANIZATION,CITY,PROPN,PROPN,nsubj,pobj,NNP,NNP,8,1
9666,38053.0,34,worked,18,18,13,-5,17,20,0,-5,Mitchell,House Small Business Committee,PERSON,ORGANIZATION-ORGANIZATION-ORGANIZATION-ORGANIZATION,PROPN,PROPN-PROPN-PROPN-PROPN,nsubj,compound-compound-compound-pobj,NNP,NNP-NNP-NNP-NNP,6,1
9667,38055.0,38,expected,5,10,9,-1,9,28,-5,4,Raul Castro,76-year-old,PERSON-PERSON,NUMBER,PROPN-PROPN,NUM,compound-dobj,compound,NNP-NNP,CD,1,1
9668,38058.0,41,attended,24,1,23,22,0,17,23,-1,Black,Coca-Cola,PERSON,ORGANIZATION,PROPN,PROPN,nsubj,pobj,NNP,NNP,12,1
9669,38071.0,45,said,28,1,8,7,0,36,27,-20,Richard Perle,Pentagon,PERSON-PERSON,ORGANIZATION,PROPN-PROPN,PROPN,compound-nsubj,poss,NNP-NNP,NNP,5,1
9670,49458.0,17,FACT,0,15,4,-11,14,12,-15,4,Richard Perle,Pentagon,PERSON-PERSON,ORGANIZATION,PROPN-PROPN,PROPN,compound-oprd,nsubj,NNP-NNP,NNP,6,1
9671,50767.0,44,singles,22,40,38,-2,39,5,-18,16,Richard Perle,Pentagon,PERSON-PERSON,ORGANIZATION,PROPN-PROPN,PROPN,compound-conj,compound,NNP-NNP,NNP,1,1
9672,38073.0,59,-LRB-,0,15,7,-8,14,51,-15,7,American Basketball Association,Anaheim Amigos,ORGANIZATION-ORGANIZATION-ORGANIZATION,ORGANIZATION-ORGANIZATION,PROPN-PROPN-PROPN,PROPN-PROPN,compound-compound-pobj,compound-poss,NNP-NNP-NNP,NNP-NNP,4,1
9673,38084.0,48,City,2,21,8,-13,20,39,-19,6,Option One Mortgage,company,ORGANIZATION-ORGANIZATION-ORGANIZATION,ORGANIZATION,PROPN-NUM-NOUN,NOUN,nmod-nummod-dobj,appos,NNP-CD-NN,NN,5,1
9674,38088.0,21,said,7,9,14,5,8,6,-2,7,Yoadimnadji,Val de Grace,PERSON,LOCATION-LOCATION-LOCATION,PROPN,PROPN-X-PROPN,nsubj,nmod-nmod-nmod,NNP,NNP-FW-NNP,4,1
9675,38090.0,57,Football,0,25,30,5,24,26,-25,30,Blackburn,wwwroverscouk,ORGANIZATION,URL,PROPN,NOUN,poss,dep,NNP,NN,8,1
9676,38100.0,42,said,23,40,31,-9,39,10,-17,8,Haifa University,"Centre for Tourism , Pilgrimage and Recreation Research",ORGANIZATION-ORGANIZATION,ORGANIZATION-ORGANIZATION-ORGANIZATION-ORGANIZATION-ORGANIZATION-ORGANIZATION-ORGANIZATION-ORGANIZATION,PROPN-PROPN,PROPN-ADP-PROPN-PUNCT-PROPN-CCONJ-PROPN-PROPN,compound-pobj,pobj-prep-pobj-punct-conj-cc-compound-conj,NNP-NNP,"NNP-IN-NNP-,-NNP-CC-NNP-NNP",6,1
9677,38112.0,30,said,14,26,22,-4,25,7,-12,8,Korean Central News Agency,communist,ORGANIZATION-ORGANIZATION-ORGANIZATION-ORGANIZATION,RELIGION,PROPN-PROPN-PROPN-PROPN,ADJ,compound-compound-compound-pobj,amod,NNP-NNP-NNP-NNP,JJ,3,1
9678,49944.0,37,quoted,24,20,30,10,19,6,4,6,Korean Central News Agency,communist,ORGANIZATION-ORGANIZATION-ORGANIZATION-ORGANIZATION,RELIGION,PROPN-PROPN-PROPN-PROPN,ADJ,compound-compound-compound-pobj,amod,NNP-NNP-NNP-NNP,JJ,8,1
9679,38158.0,23,emigrated,4,17,14,-3,16,8,-13,10,his,Russia,PERSON,COUNTRY,DET,PROPN,poss,pobj,PRP$,NNP,4,1
9680,38162.0,25,has,18,1,17,16,0,7,17,-1,She,Meredith,PERSON,PERSON,PRON,PROPN,nsubj,appos,PRP,NNP,3,1
9681,38175.0,25,EXPERIENCE,0,11,5,-6,10,19,-11,5,Larijani,culture minister,PERSON,TITLE-TITLE,PROPN,NOUN-NOUN,nsubj,compound-nsubj,NNP,NN-NN,2,1
9682,38181.0,48,died,37,1,8,7,0,39,36,-29,Lorraine Rothman,feminist health movement,PERSON-PERSON,ORGANIZATION-ORGANIZATION-ORGANIZATION,PROPN-PROPN,ADJ-NOUN-NOUN,compound-nsubj,amod-compound-pobj,NNP-NNP,JJ-NN-NN,4,1
9683,38182.0,36,survived,12,11,22,11,10,13,1,10,Forsberg,Greenwich,PERSON,CITY,PROPN,PROPN,nsubjpass,pobj,NNP,NNP,5,1
9684,38190.0,34,received,7,20,9,-11,19,24,-13,2,him,Mexico,PERSON,COUNTRY,PRON,PROPN,pobj,poss,PRP,NNP,7,1
9685,38202.0,23,made,10,1,4,3,0,18,9,-6,Philip Chen,president,PERSON-PERSON,TITLE,PROPN-PROPN,NOUN,compound-nsubj,appos,NNP-NNP,NN,2,1
9686,38203.0,22,said,14,1,16,15,0,5,13,2,Herrera,Mona Kempfer,PERSON,PERSON-PERSON,NOUN,PROPN-PROPN,nsubj,compound-nsubj,NN,NNP-NNP,1,1
9687,59842.0,22,said,14,1,16,15,0,5,13,2,Herrera,Mona Kempfer,PERSON,PERSON-PERSON,NOUN,PROPN-PROPN,nsubj,compound-nsubj,NN,NNP-NNP,1,1
9688,38213.0,31,arrived,15,15,22,7,14,8,0,7,McNair,Southern Governors Conference,PERSON,ORGANIZATION-ORGANIZATION-ORGANIZATION,PROPN,PROPN-PROPN-PROPN,nsubj,compound-compound-pobj,NNP,NNP-NNPS-NNP,5,1
9689,38224.0,59,came,6,31,29,-2,30,29,-25,23,John,her,PERSON,PERSON,PROPN,DET,appos,poss,NNP,PRP$,1,1
9690,38230.0,22,accompanied,4,18,10,-8,17,11,-14,6,she,Lourdes,PERSON,PERSON,PRON,PROPN,nsubj,appos,PRP,NNP,3,1
9691,38233.0,31,convicted,4,12,25,13,11,5,-8,21,Michael Sandy,last year,PERSON-PERSON,DATE-DATE,PROPN-PROPN,ADJ-NOUN,compound-compound,amod-npadvmod,NNP-NNP,JJ-NN,7,1
9692,38239.0,15,is,1,1,6,5,0,8,0,5,He,Harvard School of Business Administration,PERSON,ORGANIZATION-ORGANIZATION-ORGANIZATION-ORGANIZATION-ORGANIZATION,PRON,PROPN-PROPN-ADP-PROPN-PROPN,nsubj,compound-nmod-prep-pobj-conj,PRP,NNP-NNP-IN-NNP-NNP,4,1
9693,38240.0,19,died,9,1,6,5,0,12,8,-3,Her,Walter Offutt Jr,PERSON,PERSON-PERSON-PERSON,DET,PROPN-PROPN-PROPN,poss,compound-compound-nsubj,PRP$,NNP-NNP-NNP,3,1
9694,38244.0,13,Crisp,1,1,6,5,0,6,0,5,Mary Crisp,GOP,PERSON-PERSON,ORGANIZATION,PROPN-PROPN,PROPN,compound-ROOT,compound,NNP-NNP,NNP,1,1
9695,38249.0,23,was,9,2,5,3,1,17,7,-4,Gude,"March 9 , 1923",PERSON,DATE-DATE-DATE-DATE,PROPN,PROPN-NUM-PUNCT-NUM,nsubj,npadvmod-nummod-punct-nummod,NNP,"NNP-CD-,-CD",4,1
9696,38254.0,24,decided,7,5,4,-1,4,19,2,-3,Spencer Pratt,star,PERSON-PERSON,TITLE,PROPN-PROPN,NOUN,compound-nsubj,compound,NNP-NNP,NN,1,1
9697,38255.0,36,said,28,33,30,-3,32,5,-5,2,MAC,Kao Charng,ORGANIZATION,PERSON-PERSON,PROPN,PROPN-PROPN,compound,compound-nsubj,NNP,NNP-NNP,2,1
9698,38266.0,31,gave,5,7,25,18,6,5,-2,20,Dillinger,drugs,PERSON,CRIMINAL_CHARGE,PROPN,NOUN,dative,pobj,NNP,NNS,7,1
9699,38271.0,28,KIRKALDY,2,1,5,4,0,22,1,3,IRENE MORGAN KIRKALDY,90,PERSON-PERSON-PERSON,NUMBER,PROPN-PROPN-PROPN,NUM,compound-compound-ROOT,appos,NNP-NNP-NNP,CD,2,1
9700,38276.0,48,died,37,17,45,28,16,2,20,8,her,Upper West Side,PERSON,LOCATION-LOCATION-LOCATION,DET,PROPN-PROPN-PROPN,poss,compound-compound-pobj,PRP$,NNP-NNP-NNP,12,1
9701,38278.0,10,refused,8,6,1,-5,5,8,2,-7,Irene Morgan,Kirkaldy,PERSON-PERSON,PERSON,PROPN-PROPN,PROPN,compound-pobj,nsubj,NNP-NNP,NNP,4,1
9702,42783.0,36,arrested,11,4,1,-3,3,34,7,-10,Irene Morgan,Kirkaldy,PERSON-PERSON,PERSON,PROPN-PROPN,PROPN,compound-appos,nsubjpass,NNP-NNP,NNP,2,1
9703,66444.0,24,refused,22,10,5,-5,9,18,12,-17,Irene Morgan,Kirkaldy,PERSON-PERSON,PERSON,PROPN-PROPN,PROPN,compound-pobj,dobj,NNP-NNP,NNP,4,1
9704,38280.0,25,organized,1,4,3,-1,3,21,-3,2,Moro National Liberation Front,the early 1970s,ORGANIZATION-ORGANIZATION-ORGANIZATION-ORGANIZATION,DATE-DATE-DATE,PROPN-PROPN-PROPN-PROPN,DET-ADJ-NOUN,compound-compound-compound-dobj,det-amod-pobj,NNP-NNP-NNP-NNP,DT-JJ-NNS,2,1
9705,38287.0,39,decide,7,31,25,-6,30,13,-24,18,he,Oksana Grigorieva,PERSON,PERSON-PERSON,PRON,PROPN-PROPN,nsubj,compound-pobj,PRP,NNP-NNP,9,1
9706,38306.0,65,course,1,12,11,-1,11,53,-11,10,Bryan Fuller,creator/producer,PERSON-PERSON,TITLE,PROPN-PROPN,PROPN,compound-ROOT,subtok,NNP-NNP,NNP,1,1
9707,38335.0,40,said,37,33,25,-8,32,14,4,-12,Carnival Corp,Costa Crociere SpA,ORGANIZATION-ORGANIZATION,ORGANIZATION-ORGANIZATION-ORGANIZATION,PROPN-PROPN,PROPN-PROPN-PROPN,compound-pobj,compound-compound-pobj,NNP-NNP,NNP-NNP-NNP,3,1
9708,38341.0,36,caught,2,4,10,6,3,25,-2,8,Cowell,British,PERSON,NATIONALITY,PROPN,ADJ,poss,amod,NNP,JJ,6,1
9709,38342.0,35,elected,9,1,14,13,0,20,8,5,Flowers,Senate,PERSON,ORGANIZATION,NOUN,PROPN,nsubjpass,pobj,NNS,NNP,3,1
9710,38350.0,32,was,17,1,21,20,0,10,16,4,Dent,director,PERSON,TITLE,PROPN,NOUN,nsubj,nsubj,NNP,NN,4,1
9711,38440.0,17,was,1,7,13,6,6,3,-6,12,Mohamed ElBaradei,U.N.,PERSON-PERSON,ORGANIZATION,PROPN-PROPN,PROPN,compound-dobj,poss,NNP-NNP,NNP,5,1
9712,38450.0,23,Ahmad,3,3,15,12,2,7,0,12,Hashim Ahmad al-Tai,Iraqi Army 1st Corps,PERSON-PERSON-PERSON,ORGANIZATION-ORGANIZATION-ORGANIZATION-ORGANIZATION,PROPN-PROPN-PROPN,ADJ-PROPN-NOUN-PROPN,compound-ROOT-punct,compound-compound-compound-pobj,NNP-NNP-NNP,JJ-NNP-NN-NNP,5,1
9713,38479.0,32,became,8,8,6,-2,7,25,0,-2,Millender-McDonald,Alabama,PERSON,STATE_OR_PROVINCE,PROPN,PROPN,nsubj,conj,NNP,NNP,3,1
9714,38485.0,34,said,16,29,18,-11,28,15,-13,2,his,Prime Minister,PERSON,TITLE-TITLE,DET,PROPN-PROPN,poss,compound-compound,PRP$,NNP-NNP,6,1
9715,38490.0,33,Client,0,4,17,13,3,15,-4,17,ConAgra Foods,Omaha,ORGANIZATION-ORGANIZATION,CITY,PROPN-PROPN,PROPN,compound-ROOT,appos,NNP-NNPS,NNP,-1,1
9716,38496.0,27,stranded,4,16,21,5,15,5,-12,17,Aerolineas Argentina,Austral,ORGANIZATION-ORGANIZATION,ORGANIZATION,PROPN-PROPN,PROPN,compound-pobj,appos,NNP-NNP,NNP,6,1
9717,38503.0,53,wrote,6,12,9,-3,11,43,-6,3,Le Point,right-wing,ORGANIZATION-ORGANIZATION,IDEOLOGY,PROPN-PROPN,ADJ,compound-appos,amod,NNP-NNP,JJ,2,1
9718,38506.0,38,taught,16,3,6,3,2,31,13,-10,George Young,pastor,PERSON-PERSON,TITLE,PROPN-PROPN,NOUN,compound-nsubj,appos,NNP-NNP,NN,2,1
9719,38510.0,24,grew,13,13,19,6,12,4,0,6,Negroponte,Switzerland,PERSON,COUNTRY,PROPN,PROPN,nsubj,conj,NNP,NNP,4,1
9720,38526.0,37,said,19,24,16,-8,23,20,-5,-3,him,president,PERSON,TITLE,PRON,NOUN,dobj,pobj,PRP,NN,3,1
9721,38534.0,41,resigned,28,37,31,-6,36,9,-9,3,Pro Rodeo Cowboys Association,his,ORGANIZATION-ORGANIZATION-ORGANIZATION-ORGANIZATION,PERSON,PROPN-PROPN-PROPN-PROPN,DET,compound-compound-compound-pobj,poss,NNP-NNP-NNPS-NNP,PRP$,8,1
9722,38548.0,32,got,21,7,16,9,6,15,14,-5,Buse,Fannie,PERSON,ORGANIZATION,PROPN,PROPN,nsubj,pobj,NNP,NNP,5,1
9723,38550.0,22,told,1,18,21,3,17,0,-17,20,he,1986,PERSON,DATE,PRON,NUM,nsubj,pobj,PRP,CD,2,1
9724,38552.0,22,were,13,7,15,8,6,6,6,2,Fidelity Investments,Clear Channel,ORGANIZATION-ORGANIZATION,ORGANIZATION-ORGANIZATION,PROPN-PROPN,PROPN-PROPN,compound-conj,compound-poss,NNP-NNPS,NNP-NNP,5,1
9725,38560.0,60,credited,25,1,15,14,0,44,24,-10,Forsberg,Massachusetts Institute of Technology,PERSON,ORGANIZATION-ORGANIZATION-ORGANIZATION-ORGANIZATION,PROPN,PROPN-PROPN-ADP-PROPN,nsubjpass,compound-pobj-prep-pobj,NNP,NNP-NNP-IN-NNP,5,1
9726,42142.0,23,launched,1,1,19,18,0,3,0,18,Forsberg,Massachusetts Institute of Technology,PERSON,ORGANIZATION-ORGANIZATION-ORGANIZATION-ORGANIZATION,PROPN,PROPN-PROPN-ADP-PROPN,nsubj,compound-pobj-prep-pobj,NNP,NNP-NNP-IN-NNP,5,1
9727,38576.0,33,spoke,10,15,22,7,14,10,-5,12,Focus on the Family,Tom Minnery,ORGANIZATION-ORGANIZATION-ORGANIZATION-ORGANIZATION,PERSON-PERSON,PROPN-ADP-DET-PROPN,PROPN-PROPN,appos-prep-det-nmod,compound-appos,NNP-IN-DT-NNP,NNP-NNP,2,1
9728,38579.0,43,says,7,6,14,8,5,28,1,7,FirstGroup PLC,Laidlaw International Inc.,ORGANIZATION-ORGANIZATION,ORGANIZATION-ORGANIZATION-ORGANIZATION,PROPN-PROPN,PROPN-PROPN-PROPN,compound-nsubj,compound-compound-dobj,NNP-NNP,NNP-NNP-NNP,5,1
9729,38580.0,53,say,1,3,45,42,2,7,-2,44,ConAgra Foods Inc.,America,ORGANIZATION-ORGANIZATION-ORGANIZATION,COUNTRY,PROPN-PROPN-PROPN,PROPN,compound-compound-poss,poss,NNP-NNPS-NNP,NNP,10,1
9730,38600.0,49,said,7,5,3,-2,4,45,2,-4,Paul Watson,leader,PERSON-PERSON,TITLE,PROPN-PROPN,NOUN,compound-appos,nsubj,NNP-NNP,NN,2,1
9731,55314.0,47,told,8,6,4,-2,5,42,2,-4,Paul Watson,leader,PERSON-PERSON,TITLE,PROPN-PROPN,NOUN,compound-appos,nsubj,NNP-NNP,NN,2,1
9732,38602.0,18,DAYBOOK,1,14,10,-4,13,7,-13,9,MAC,Taipei City,ORGANIZATION,CITY-CITY,PROPN,PROPN-PROPN,compound,compound-compound,NNP,NNP-NNP,4,1
9733,38609.0,42,are,6,29,20,-9,28,21,-23,14,USA network,Bonnie Hammer,ORGANIZATION-ORGANIZATION,PERSON-PERSON,PROPN-NOUN,PROPN-PROPN,compound-pobj,compound-appos,NNP-NN,NNP-NNP,3,1
9734,38621.0,31,involved,3,1,7,6,0,23,2,4,He,negotiator,PERSON,TITLE,PRON,NOUN,nsubjpass,pobj,PRP,NN,4,1
9735,38623.0,49,said,35,46,37,-9,45,11,-11,2,International Crisis Group,Mark L Schneider,ORGANIZATION-ORGANIZATION-ORGANIZATION,PERSON-PERSON-PERSON,PROPN-PROPN-PROPN,PROPN-PROPN-PROPN,compound-compound-pobj,compound-compound-nsubj,NNP-NNP-NNP,NNP-NNP-NNP,4,1
9736,38625.0,11,denied,7,4,1,-3,3,9,3,-6,Awami League,She,ORGANIZATION-ORGANIZATION,PERSON,PROPN-PROPN,PRON,compound-compound,nsubj,NNP-NNP,PRP,3,1
9737,38637.0,30,claims,3,6,12,6,5,17,-3,9,CCP,Tibet,ORGANIZATION,LOCATION,PROPN,PROPN,nsubj,pobj,NNP,NNP,2,1
9738,38661.0,38,said,36,2,1,-1,1,36,34,-35,Democratic senator,US,PERSON-PERSON,ORGANIZATION,ADJ-NOUN,PROPN,amod-nsubj,nmod,JJ-NN,NNP,1,1
9739,38672.0,27,say,14,4,2,-2,3,24,10,-12,Paul Watson,Shepherd captain,PERSON-PERSON,TITLE-TITLE,PROPN-PROPN,PROPN-NOUN,compound-nsubj,compound-compound,NNP-NNP,NNP-NN,1,1
9740,38691.0,38,fell,6,6,31,25,5,6,0,25,Hindalco,Novelis,ORGANIZATION,ORGANIZATION,PROPN,PROPN,appos,pobj,NNP,NNP,8,1
9741,38693.0,50,is,14,12,33,21,11,16,2,19,Haifa University,he,ORGANIZATION-ORGANIZATION,PERSON,PROPN-PROPN,PRON,compound-pobj,nsubj,NNP-NNP,PRP,15,1
9742,38700.0,38,Okay,0,4,27,23,3,10,-4,27,she,Jake,PERSON,PERSON,PRON,PROPN,nsubj,nsubj,PRP,NNP,3,1
9743,44844.0,38,Okay,0,4,27,23,3,10,-4,27,she,Jake,PERSON,PERSON,PRON,PROPN,nsubj,nsubj,PRP,NNP,3,1
9744,38721.0,52,told,29,23,1,-22,22,50,6,-28,Mainland Affairs Council,Lai Hsing-yuan,ORGANIZATION-ORGANIZATION-ORGANIZATION,PERSON-PERSON,PROPN-PROPN-PROPN,PROPN-PROPN,compound-compound-appos,compound-nsubj,NNP-NNPS-NNP,NNP-NNP,3,1
9745,51824.0,72,told,25,10,3,-7,9,68,15,-22,Mainland Affairs Council,Lai Hsing-yuan,ORGANIZATION-ORGANIZATION-ORGANIZATION,PERSON-PERSON,PROPN-PROPN-PROPN,PROPN-PROPN,compound-compound-pobj,compound-nsubj,NNP-NNPS-NNP,NNP-NNP,6,1
9746,38725.0,35,Football,0,8,10,2,7,24,-8,10,Arsenal,Edelman,ORGANIZATION,PERSON,PROPN,PROPN,compound,dobj,NNP,NNP,3,1
9747,38728.0,37,ferrying,15,28,3,-25,27,33,-13,-12,Awami League,BNP,ORGANIZATION-ORGANIZATION,ORGANIZATION,PROPN-PROPN,PROPN,compound-appos,nsubj,NNP-NNP,NNP,4,1
9748,38781.0,23,questioned,16,13,1,-12,12,21,3,-15,American Bankers Association,Robert G. Rowe III,ORGANIZATION-ORGANIZATION-ORGANIZATION,PERSON-PERSON-PERSON-PERSON,PROPN-PROPN-PROPN,PROPN-PROPN-PROPN-PROPN,compound-compound-pobj,compound-compound-compound-nsubj,NNP-NNPS-NNP,NNP-NNP-NNP-NNP,5,1
9749,38783.0,32,told,6,1,4,3,0,27,5,-2,Her,Brenda Bacquie,PERSON,PERSON-PERSON,DET,PROPN-PROPN,poss,compound-appos,PRP$,NNP-NNP,1,1
9750,38784.0,36,said,9,28,34,6,27,1,-19,25,Waldheim,war crimes,PERSON,CRIMINAL_CHARGE-CRIMINAL_CHARGE,PROPN,NOUN-NOUN,dobj,compound-pobj,NNP,NN-NNS,8,1
9751,38789.0,16,won,6,6,1,-5,5,14,0,-5,Inquirer,Roberts,ORGANIZATION,PERSON,PROPN,PROPN,pobj,poss,NNP,NNP,3,1
9752,38796.0,21,says,18,1,14,13,0,6,17,-4,Kelly,People 's Revolution,PERSON,ORGANIZATION-ORGANIZATION-ORGANIZATION,PROPN,PROPN-PART-PROPN,nsubj,poss-case-pobj,NNP,NNPS-POS-NNP,4,1
9753,38797.0,27,was,19,19,12,-7,18,14,0,-7,he,2nd U.S. Circuit Court of Appeals,PERSON,ORGANIZATION-ORGANIZATION-ORGANIZATION-ORGANIZATION-ORGANIZATION-ORGANIZATION,PRON,ADJ-PROPN-PROPN-PROPN-ADP-PROPN,nsubj,amod-compound-compound-pobj-prep-pobj,PRP,JJ-NNP-NNP-NNP-IN-NNPS,4,1
9754,38800.0,15,said,9,11,13,2,10,1,-2,4,her,Janine Bacquie,PERSON,PERSON-PERSON,DET,PROPN-PROPN,nsubj,compound-appos,PRP$,NNP-NNP,1,1
9755,38806.0,33,obituary,6,9,21,12,8,11,-3,15,Yolanda King,Martin Luther King Jr.,PERSON-PERSON,PERSON-PERSON-PERSON-PERSON,PROPN-PROPN,PROPN-PROPN-PROPN-PROPN,compound-pobj,compound-compound-compound-appos,NNP-NNP,NNP-NNP-NNP-NNP,5,1
9756,41229.0,32,ATLANTA,0,3,8,5,2,23,-3,8,Yolanda King,Martin Luther King Jr.,PERSON-PERSON,PERSON-PERSON-PERSON-PERSON,PROPN-PROPN,PROPN-PROPN-PROPN-PROPN,compound-nsubj,compound-compound-compound-poss,NNP-NNP,NNP-NNP-NNP-NNP,3,1
9757,54148.0,14,dies,13,1,9,8,0,4,12,-4,Yolanda King,Martin Luther King Jr.,PERSON-PERSON,PERSON-PERSON-PERSON-PERSON,PROPN-PROPN,PROPN-PROPN-PROPN-PROPN,compound-nsubj,compound-compound-compound-pobj,NNP-NNP,NNP-NNP-NNP-NNP,4,1
9758,38807.0,27,married,12,12,15,3,11,11,0,3,he,Diana Villiers,PERSON,PERSON-PERSON,PRON,PROPN-PROPN,nsubj,compound-dobj,PRP,NNP-NNPS,1,1
9759,38810.0,16,were,5,5,14,9,4,1,0,9,Blackburn,Football League,ORGANIZATION,ORGANIZATION-ORGANIZATION,PROPN,PROPN-PROPN,nsubj,compound-pobj,NNP,NNP-NNP,5,1
9760,38814.0,39,said,36,4,10,6,3,28,32,-26,Hong Kong Disneyland,2005,ORGANIZATION-ORGANIZATION-ORGANIZATION,DATE,PROPN-PROPN-PROPN,NUM,compound-compound-compound,pobj,NNP-NNP-NNP,CD,5,1
9761,38830.0,24,wasting,13,11,6,-5,10,17,2,-7,Kelly Cutrone,Publicist,PERSON-PERSON,TITLE,PROPN-PROPN,PROPN,compound-nsubj,amod,NNP-NNP,NNP,2,1
9762,38840.0,26,borrowed,9,8,1,-7,7,24,1,-8,ABA,Edward L. Yingling,ORGANIZATION,PERSON-PERSON-PERSON,PROPN,PROPN-PROPN-PROPN,pobj,compound-compound-nsubj,NNP,NNP-NNP-NNP,3,1
9763,38849.0,44,has,21,1,17,16,0,26,20,-4,Kendra Wilkinson,Girls Next Door,PERSON-PERSON,ORGANIZATION-ORGANIZATION-ORGANIZATION,PROPN-PROPN,PROPN-PROPN-PROPN,compound-nsubj,appos-compound-appos,NNP-NNP,NNP-NNP-NNP,3,1
9764,53554.0,43,appear,32,7,25,18,6,17,25,-7,Kendra Wilkinson,Girls Next Door,PERSON-PERSON,ORGANIZATION-ORGANIZATION-ORGANIZATION,PROPN-PROPN,PROPN-PROPN-PROPN,compound-conj,compound-compound-nmod,NNP-NNP,NNP-NNP-NNP,8,1
9765,38874.0,17,asked,5,12,2,-10,11,14,-7,-3,Christian denomination,Arizona,ORGANIZATION-ORGANIZATION,STATE_OR_PROVINCE,ADJ-NOUN,PROPN,amod-pcomp,compound,JJ-NN,NNP,4,1
9766,38887.0,65,survived,2,8,42,34,7,22,-6,40,Brenda Morgan Bacquie,Justine Walker,PERSON-PERSON-PERSON,PERSON-PERSON,PROPN-PROPN-PROPN,PROPN-PROPN,compound-compound-appos,compound-appos,NNP-NNP-NNP,NNP-NNP,8,1
9767,38911.0,54,survived,2,5,29,24,4,24,-3,27,his,David Kaiser,PERSON,PERSON-PERSON,DET,PROPN-PROPN,poss,compound-appos,PRP$,NNP-NNP,4,1
9768,38918.0,37,pursued,1,28,17,-11,27,19,-27,16,ABA,him,ORGANIZATION,PERSON,PROPN,PRON,pobj,dobj,NNP,PRP,4,1
9769,38919.0,53,said,18,15,1,-14,14,51,3,-17,National Red Cross,Fransico Cecile,ORGANIZATION-ORGANIZATION-ORGANIZATION,PERSON-PERSON,PROPN-PROPN-PROPN,PROPN-PROPN,compound-compound-pobj,compound-nsubj,NNP-NNP-NNP,NNP-NNP,8,1
9770,38935.0,50,died,35,1,40,39,0,9,34,5,Gilbert Gude,congestive heart failure,PERSON-PERSON,CAUSE_OF_DEATH-CAUSE_OF_DEATH-CAUSE_OF_DEATH,PROPN-PROPN,ADJ-NOUN-NOUN,compound-nsubj,amod-compound-pobj,NNP-NNP,JJ-NN-NN,4,1
9771,53785.0,50,died,35,1,40,39,0,9,34,5,Gilbert Gude,congestive heart failure,PERSON-PERSON,CAUSE_OF_DEATH-CAUSE_OF_DEATH-CAUSE_OF_DEATH,PROPN-PROPN,ADJ-NOUN-NOUN,compound-nsubj,amod-compound-pobj,NNP-NNP,JJ-NN-NN,4,1
9772,38943.0,26,meeting,14,5,11,6,4,14,9,-3,Mia Farrow,founder,PERSON-PERSON,TITLE,PROPN-PROPN,NOUN,compound-nsubj,appos,NNP-NNP,NN,3,1
9773,38945.0,31,received,16,1,5,4,0,25,15,-11,Her,Keith McDonald,PERSON,PERSON-PERSON,DET,PROPN-PROPN,poss,compound-appos,PRP$,NNP-NNP,1,1
9774,38946.0,28,said,6,15,15,0,14,12,-9,9,FAA,FAA,ORGANIZATION,ORGANIZATION,PROPN,PROPN,compound,compound,NNP,NNP,0,1
9775,38952.0,23,began,2,11,22,11,10,0,-9,20,AQR Capital Management,Conn,ORGANIZATION-ORGANIZATION-ORGANIZATION,STATE_OR_PROVINCE,PROPN-PROPN-PROPN,PROPN,compound-compound-pobj,appos,NNP-NNP-NNP,NNP,5,1
9776,38977.0,37,began,9,26,15,-11,25,21,-17,6,he,Marshall College,PERSON,ORGANIZATION-ORGANIZATION,PRON,PROPN-PROPN,nsubj,compound-conj,PRP,NNP-NNP,8,1
9777,38978.0,32,said,19,25,21,-4,24,10,-6,2,International Monetary Fund,Alex Segura-Ubiergo,ORGANIZATION-ORGANIZATION-ORGANIZATION,PERSON-PERSON,PROPN-PROPN-PROPN,PROPN-PROPN,compound-compound-poss,compound-nsubj,NNP-NNP-NNP,NNP-NNP,4,1
9778,38989.0,28,gets,1,3,15,12,2,12,-2,14,her,New York,PERSON,STATE_OR_PROVINCE-STATE_OR_PROVINCE,DET,PROPN-PROPN,poss,compound-pobj,PRP$,NNP-NNP,5,1
9779,38999.0,45,struggling,32,41,13,-28,40,31,-9,-19,DMC,Detroit,ORGANIZATION,CITY,PROPN,PROPN,poss,pobj,NNP,NNP,13,1
9780,42112.0,42,is,12,21,2,-19,20,39,-9,-10,DMC,Detroit,ORGANIZATION,CITY,PROPN,PROPN,pobj,pobj,NNP,NNP,3,1
9781,39006.0,33,said,7,2,5,3,1,27,5,-2,Awami League,Saber Hossain Chowdhury,ORGANIZATION-ORGANIZATION,PERSON-PERSON-PERSON,PROPN-PROPN,PROPN-PROPN-PROPN,compound-compound,compound-compound-nsubj,NNP-NNP,NNP-NNP-NNP,3,1
9782,64306.0,29,said,27,22,25,3,21,3,5,-2,Awami League,Saber Hossain Chowdhury,ORGANIZATION-ORGANIZATION,PERSON-PERSON-PERSON,PROPN-PROPN,PROPN-PROPN-PROPN,compound-compound,compound-compound-nsubj,NNP-NNP,NNP-NNP-NNP,4,1
9783,39010.0,31,passes,3,12,6,-6,11,24,-9,3,Norwegian University of science and Technology,Trondheim,ORGANIZATION-ORGANIZATION-ORGANIZATION-ORGANIZATION-ORGANIZATION-ORGANIZATION,ORGANIZATION,PROPN-PROPN-ADP-NOUN-CCONJ-PROPN,PROPN,compound-pobj-prep-pobj-cc-conj,npadvmod,NNP-NNP-IN-NN-CC-NNP,NNP,3,1
9784,39020.0,42,moved,16,3,15,12,2,26,13,-1,his,Paris,PERSON,CITY,DET,PROPN,poss,pobj,PRP$,NNP,3,1
9785,41901.0,26,built,1,3,6,3,2,19,-2,5,his,Paris,PERSON,CITY,DET,PROPN,poss,pobj,PRP$,NNP,4,1
9786,39026.0,43,MANILA,0,39,41,2,38,1,-39,41,ADB,Pacific Department,ORGANIZATION,ORGANIZATION-ORGANIZATION,PROPN,PROPN-PROPN,poss,compound-pobj,NNP,NNP-NNP,2,1
9787,39032.0,37,apologized,5,14,20,6,13,16,-9,15,Nitschmann Middle School,Pennsylvania,ORGANIZATION-ORGANIZATION-ORGANIZATION,STATE_OR_PROVINCE,PROPN-PROPN-PROPN,PROPN,compound-compound-pobj,appos,NNP-NNP-NNP,NNP,2,1
9788,39969.0,43,apologized,11,20,3,-17,19,39,-9,-8,Nitschmann Middle School,Pennsylvania,ORGANIZATION-ORGANIZATION-ORGANIZATION,STATE_OR_PROVINCE,PROPN-PROPN-PROPN,PROPN,compound-compound-pobj,appos,NNP-NNP-NNP,NNP,7,1
9789,39044.0,27,said,12,18,14,-4,17,12,-6,2,IMF,Daniel Citrin,ORGANIZATION,PERSON-PERSON,PROPN,PROPN-PROPN,poss,compound-nsubj,NNP,NNP-NNP,3,1
9790,39067.0,49,SINGAPORE,0,40,35,-5,39,13,-40,35,Royal Caribbean,Adam Goldstein,ORGANIZATION-ORGANIZATION,PERSON-PERSON,PROPN-PROPN,PROPN-PROPN,compound-pobj,compound-nsubj,NNP-NNP,NNP-NNP,9,1
9791,39077.0,27,Aug.,2,16,1,-15,15,25,-14,-1,Susan Boyle,SHANGHAI,PERSON-PERSON,CITY,PROPN-PROPN,PROPN,compound-nsubj,npadvmod,NNP-NNP,NNP,-1,1
9792,39093.0,30,led,13,6,1,-5,5,28,7,-12,Carnival Corp,Florida,ORGANIZATION-ORGANIZATION,STATE_OR_PROVINCE,PROPN-PROPN,PROPN,compound-nmod,nsubj,NNP-NNP,NNP,4,1
9793,39099.0,23,said,8,10,14,4,9,8,-2,6,Chris Simcox,Phoenix-based,PERSON-PERSON,CITY,PROPN-PROPN,ADJ,compound-nsubj,amod,NNP-NNP,JJ,4,1
9794,39102.0,14,passed,8,7,12,5,6,1,1,4,Vernon Bellecourt,the weekend,PERSON-PERSON,DATE-DATE,PROPN-PROPN,DET-NOUN,compound-appos,det-pobj,NNP-NNP,DT-NN,3,1
9795,39135.0,41,noted,1,11,13,2,10,27,-10,12,Defense,Robert M. Gates,ORGANIZATION,PERSON-PERSON-PERSON,PROPN,PROPN-PROPN-PROPN,compound,compound-compound-pobj,NNP,NNP-NNP-NNP,2,1
9796,39138.0,22,include,3,1,13,12,0,8,2,10,His,Shanghai,PERSON,CITY,DET,PROPN,poss,pobj,PRP$,NNP,8,1
9797,39140.0,55,remained,24,3,23,20,2,31,21,-1,Moro National Liberation Front,Islamic,ORGANIZATION-ORGANIZATION-ORGANIZATION-ORGANIZATION,RELIGION,PROPN-PROPN-PROPN-PROPN,ADJ,compound-compound-compound-nsubj,amod,NNP-NNP-NNP-NNP,JJ,5,1
9798,39152.0,32,is,5,3,2,-1,2,29,2,-3,International Crisis Group,Brussels-headquarters,ORGANIZATION-ORGANIZATION-ORGANIZATION,CITY,PROPN-PROPN-PROPN,PROPN,compound-compound-nsubj,compound,NNP-NNP-NNP,NNPS,1,1
9799,39157.0,16,December,0,5,1,-4,4,14,-5,1,Jefferson DeBlanc,"December 6 , 2007",PERSON-PERSON,DATE-DATE-DATE-DATE,PROPN-PROPN,PROPN-NUM-PUNCT-NUM,compound-conj,ROOT-nummod-punct-nummod,NNP-NNP,"NNP-CD-,-CD",2,1
9800,39163.0,63,moving,6,29,31,2,28,31,-23,25,DMC,Harper Hospital,ORGANIZATION,ORGANIZATION-ORGANIZATION,PROPN,PROPN-PROPN,poss,compound-pobj,NNP,NNP-NNP,2,1
9801,39165.0,26,said,4,13,6,-7,12,19,-9,2,Citibank,Peter Knitzer,ORGANIZATION,PERSON-PERSON,PROPN,PROPN-PROPN,compound,compound-nsubj,NNP,NNP-NNP,4,1
9802,39175.0,17,was,1,1,14,13,0,2,0,13,She,Alabama,PERSON,STATE_OR_PROVINCE,PRON,PROPN,nsubj,nmod,PRP,NNP,5,1
9803,39182.0,19,married,5,5,7,2,4,11,0,2,she,Gunnar Forsberg,PERSON,PERSON-PERSON,PRON,PROPN-PROPN,nsubj,compound-dobj,PRP,NNP-NNP,1,1
9804,39193.0,38,said,11,9,2,-7,8,35,2,-9,Haifa University,Sammy Smooha,ORGANIZATION-ORGANIZATION,PERSON-PERSON,PROPN-PROPN,PROPN-PROPN,compound-pobj,compound-nsubj,NNP-NNP,NNP-NNP,3,1
9805,39215.0,28,died,21,1,6,5,0,21,20,-15,Sills,director,PERSON,TITLE,NOUN,NOUN,nsubj,appos,NNS,NN,3,1
9806,65639.0,31,died,24,1,9,8,0,21,23,-15,Sills,director,PERSON,TITLE,NOUN,NOUN,nsubj,attr,NNS,NN,5,1
9807,39225.0,26,Parker,0,1,12,11,0,13,-1,12,Parker,Founders Fund,PERSON,ORGANIZATION-ORGANIZATION,PROPN,PROPN-PROPN,ROOT,compound-dobj,NNP,NNP-NNP,2,1
9808,39235.0,22,brought,10,1,12,11,0,9,9,2,John D Negroponte,US,PERSON-PERSON-PERSON,COUNTRY,PROPN-PROPN-PROPN,PROPN,compound-compound-nsubj,compound,NNP-NNP-NNP,NNP,3,1
9809,39237.0,22,died,18,1,5,4,0,16,17,-13,Vernon Bellecourt,Lakota,PERSON-PERSON,CITY,PROPN-PROPN,PROPN,compound-nsubj,appos,NNP-NNP,NNP,2,1
9810,39266.0,24,was,8,8,18,10,7,5,0,10,Ahearn,State Department 's Office of Protocol,PERSON,ORGANIZATION-ORGANIZATION-ORGANIZATION-ORGANIZATION-ORGANIZATION-ORGANIZATION,PROPN,PROPN-PROPN-PART-PROPN-ADP-PROPN,nsubj,compound-poss-case-pobj-prep-pobj,NNP,NNP-NNP-POS-NNP-IN-NNP,8,1
9811,39273.0,59,said,38,56,40,-16,55,18,-18,2,Highland Capital Partners,Dan Rosen,ORGANIZATION-ORGANIZATION-ORGANIZATION,PERSON-PERSON,PROPN-PROPN-PROPN,PROPN-PROPN,compound-compound-pobj,compound-nsubj,NNP-NNP-NNPS,NNP-NNP,7,1
9812,39277.0,23,said,21,9,1,-8,8,21,12,-20,Awami National Party,Ali,ORGANIZATION-ORGANIZATION-ORGANIZATION,PERSON,PROPN-PROPN-PROPN,PROPN,compound-compound-appos,nsubj,NNP-NNP-NNP,NNP,6,1
9813,39287.0,14,worked,6,4,1,-3,3,12,2,-5,Fraser Robinson,Her,PERSON-PERSON,PERSON,PROPN-PROPN,DET,compound-appos,poss,NNP-NNP,PRP$,1,1
9814,39300.0,44,said,40,8,1,-7,7,42,32,-39,Nuclear Suppliers Group,Russia,ORGANIZATION-ORGANIZATION-ORGANIZATION,COUNTRY,PROPN-PROPN-PROPN,PROPN,compound-compound-pobj,nsubj,NNP-NNPS-NNP,NNP,5,1
9815,39302.0,30,told,27,20,15,-5,19,14,7,-12,Justice and Equality Movement,London,ORGANIZATION-ORGANIZATION-ORGANIZATION-ORGANIZATION,CITY,PROPN-CCONJ-PROPN-PROPN,PROPN,nmod-cc-compound-poss,npadvmod,NNP-CC-NNP-NNP,NNP,1,1
9816,39314.0,26,said,6,3,5,2,2,20,3,-1,Rovers,John Williams,ORGANIZATION,PERSON-PERSON,PROPN,PROPN-PROPN,compound,compound-nsubj,NNPS,NNP-NNP,1,1
9817,39327.0,41,is,11,1,39,38,0,1,10,28,Alberto Gonzales,Air Force,PERSON-PERSON,ORGANIZATION-ORGANIZATION,PROPN-PROPN,PROPN-PROPN,compound-poss,compound-pobj,NNP-NNP,NNP-NNP,11,1
9818,39328.0,31,said,1,1,12,11,0,18,0,11,Larijani,Hezbollah,PERSON,ORGANIZATION,PROPN,PROPN,nsubj,appos,NNP,NNP,7,1
9819,39333.0,49,Crisp,1,1,23,22,0,25,0,22,Mary Crisp,director,PERSON-PERSON,TITLE,PROPN-PROPN,NOUN,compound-ROOT,pobj,NNP-NNP,NN,5,1
9820,39345.0,53,lists,7,43,24,-19,42,28,-36,17,Abigail P Johnson,FMR LLC,ORGANIZATION-ORGANIZATION-ORGANIZATION,PERSON-PERSON,PROPN-PROPN-PROPN,PROPN-PROPN,compound-compound-conj,compound-pobj,NNP-NNP-NNP,NNP-NNP,4,1
9821,39360.0,42,moved,16,11,3,-8,10,38,5,-13,he,his,PERSON,PERSON,PRON,DET,nsubj,poss,PRP,PRP$,2,1
9822,62678.0,45,changed,2,38,22,-16,37,22,-36,20,he,his,PERSON,PERSON,PRON,DET,nsubj,poss,PRP,PRP$,6,1
9823,39368.0,32,Association,3,3,9,6,2,22,0,6,Multidisciplinary Association for Psychedelic Studies,Maps,ORGANIZATION-ORGANIZATION-ORGANIZATION-ORGANIZATION-ORGANIZATION,ORGANIZATION,PROPN-PROPN-ADP-PROPN-PROPN,PROPN,compound-ROOT-prep-compound-pobj,compound,NNP-NNP-IN-NNP-NNPS,NNP,3,1
9824,39370.0,35,said,26,33,28,-5,32,6,-7,2,FMCSA,Melissa Mazzella DeLaney,ORGANIZATION,PERSON-PERSON-PERSON,PROPN,PROPN-PROPN-PROPN,compound,compound-compound-nsubj,NNP,NNP-NNP-NNP,3,1
9825,39389.0,40,said,19,35,37,2,34,2,-16,18,ADB 's,Southeast Asia Department,ORGANIZATION-ORGANIZATION,ORGANIZATION-ORGANIZATION-ORGANIZATION,PROPN-PART,PROPN-PROPN-PROPN,poss-case,compound-compound-pobj,NNP-POS,NNP-NNP-NNP,3,1
9826,39427.0,43,paired,2,34,38,4,33,4,-32,36,Spencer Pratt,manager,PERSON-PERSON,TITLE,PROPN-PROPN,NOUN,compound-nsubj,appos,NNP-NNP,NN,2,1
9827,39432.0,38,wants,11,21,6,-15,20,31,-10,-5,his,Frank,PERSON,PERSON,DET,PROPN,poss,compound,PRP$,NNP,6,1
9828,39439.0,40,made,1,17,27,10,16,12,-16,26,Taiwan Research Institute,Chung-hua Institution for Economic Research and China 's Fujian Southeast Competitiveness Research Institute,ORGANIZATION-ORGANIZATION-ORGANIZATION,ORGANIZATION-ORGANIZATION-ORGANIZATION-ORGANIZATION-ORGANIZATION-ORGANIZATION-ORGANIZATION-ORGANIZATION-ORGANIZATION-ORGANIZATION-ORGANIZATION-ORGANIZATION-ORGANIZATION,PROPN-PROPN-PROPN,PROPN-PROPN-ADP-PROPN-PROPN-CCONJ-PROPN-PART-PROPN-PROPN-PROPN-PROPN-PROPN,compound-compound-conj,compound-conj-prep-compound-pobj-cc-poss-case-compound-compound-compound-compound-conj,NNP-NNP-NNP,NNP-NNP-IN-NNP-NNP-CC-NNP-POS-NNP-NNP-NNP-NNP-NNP,3,1
9829,39440.0,37,accepts,4,33,31,-2,32,5,-29,27,M Enkhbold,Prime Minister,PERSON-PERSON,TITLE-TITLE,PROPN-PROPN,PROPN-PROPN,compound-pobj,compound-compound,NNP-NNP,NNP-NNP,1,1
9830,52688.0,27,met,5,4,2,-2,3,24,1,-3,M Enkhbold,Prime Minister,PERSON-PERSON,TITLE-TITLE,PROPN-PROPN,PROPN-PROPN,compound-nsubj,compound-compound,NNP-NNP,NNP-NNP,1,1
9831,39451.0,53,said,1,1,22,21,0,30,0,21,Ferrara,racketeering,PERSON,CRIMINAL_CHARGE,PROPN,NOUN,nsubj,compound,NNP,NN,4,1
9832,39453.0,36,ousted,5,31,12,-19,30,23,-26,7,Red Cross,Mark Everson,ORGANIZATION-ORGANIZATION,PERSON-PERSON,PROPN-PROPN,PROPN-PROPN,compound-compound,compound-appos,NNP-NNP,NNP-NNP,13,1
9833,42194.0,38,said,29,11,31,20,10,6,18,2,Red Cross,Mark Everson,ORGANIZATION-ORGANIZATION,PERSON-PERSON,PROPN-PROPN,PROPN-PROPN,compound-nsubj,compound-nsubj,NNP-NNP,NNP-NNP,6,1
9834,39455.0,11,Outgoing,0,7,2,-5,6,8,-7,2,his,Iowa,PERSON,STATE_OR_PROVINCE,DET,PROPN,poss,compound,PRP$,NNP,3,1
9835,39464.0,34,elevated,23,3,2,-1,2,31,20,-21,Myers,33-year-old,PERSON,DURATION,PROPN,NUM,nsubjpass,nummod,NNP,CD,1,1
9836,39475.0,37,said,24,32,34,2,31,2,-8,10,APA,Zero Tolerance Taskforce,ORGANIZATION,ORGANIZATION-ORGANIZATION-ORGANIZATION,PROPN,PROPN-PROPN-PROPN,poss,compound-compound-pobj,NNP,NNP-NNP-NNP,2,1
9837,39494.0,44,was,4,3,2,-1,2,41,1,-2,Lewis Hamilton,pilot,PERSON-PERSON,TITLE,PROPN-PROPN,NOUN,compound-nsubj,compound,NNP-NNP,NN,1,1
9838,65610.0,85,led,4,45,44,-1,44,40,-41,40,Lewis Hamilton,pilot,PERSON-PERSON,TITLE,PROPN-PROPN,NOUN,compound-compound,compound,NNP-NNP,NN,2,1
9839,39496.0,48,explained,26,39,35,-4,38,12,-13,9,NCF,Noordhoff Craniofacial Foundation,ORGANIZATION,ORGANIZATION-ORGANIZATION-ORGANIZATION,PROPN,PROPN-PROPN-PROPN,compound,compound-compound-compound,NNP,NNP-NNP-NNP,6,1
9840,47978.0,48,organized,39,35,31,-4,34,16,4,-8,NCF,Noordhoff Craniofacial Foundation,ORGANIZATION,ORGANIZATION-ORGANIZATION-ORGANIZATION,PROPN,PROPN-PROPN-PROPN,compound,compound-compound-pobj,NNP,NNP-NNP-NNP,5,1
9841,39506.0,48,said,38,41,45,4,40,2,-3,7,International Crisis Group,Ernst Jan Hogendoorn,ORGANIZATION-ORGANIZATION-ORGANIZATION,PERSON-PERSON-PERSON,PROPN-PROPN-PROPN,PROPN-PROPN-PROPN,compound-compound-poss,compound-compound-nsubj,NNP-NNP-NNP,NNP-NNP-NNP,3,1
9842,39512.0,37,said,34,14,1,-13,13,35,20,-33,US National Security Council,Japan,ORGANIZATION-ORGANIZATION-ORGANIZATION-ORGANIZATION,COUNTRY,PROPN-PROPN-PROPN-PROPN,PROPN,compound-compound-compound-pobj,poss,NNP-NNP-NNP-NNP,NNP,9,1
9843,39514.0,28,extends,4,4,7,3,3,20,0,3,Lashkar-e-Taiba,"about 150,000",ORGANIZATION,NUMBER-NUMBER,PROPN,ADP-NUM,pobj,quantmod-nummod,NNP,IN-CD,2,1
9844,39518.0,28,said,21,2,11,9,1,16,19,-10,Steve McPherson,ABC Entertainment Group,PERSON-PERSON,ORGANIZATION-ORGANIZATION-ORGANIZATION,PROPN-PROPN,PROPN-PROPN-PROPN,compound-nsubj,compound-compound-appos,NNP-NNP,NNP-NNP-NNP,5,1
9845,55032.0,22,continued,20,10,15,5,9,6,10,-5,Steve McPherson,ABC Entertainment Group,PERSON-PERSON,ORGANIZATION-ORGANIZATION-ORGANIZATION,PROPN-PROPN,PROPN-PROPN-PROPN,compound-poss,compound-compound-pobj,NNP-NNP,NNP-NNP-NNP,5,1
9846,39522.0,41,said,1,3,10,7,2,30,-2,9,Black,USA Today,PERSON,ORGANIZATION-ORGANIZATION,PROPN,PROPN-PROPN,nsubjpass,compound-dobj,NNP,NNP-NNP,4,1
9847,39524.0,32,avoided,16,9,13,4,8,18,7,-3,Covidien,Tyco HealthCare,ORGANIZATION,ORGANIZATION-ORGANIZATION,PROPN,PROPN-PROPN,nsubj,compound-appos,NNP,NNP-NNP,6,1
9848,39532.0,31,said,12,5,1,-4,4,29,7,-11,International Monetary Fund,Thomas Baunsgaard,ORGANIZATION-ORGANIZATION-ORGANIZATION,PERSON-PERSON,PROPN-PROPN-PROPN,PROPN-PROPN,compound-compound-poss,compound-nsubj,NNP-NNP-NNP,NNP-NNP,3,1
9849,39533.0,19,Johns,1,1,16,15,0,2,0,15,Michael Johns,Perth,PERSON-PERSON,CITY,PROPN-PROPN,PROPN,compound-ROOT,pobj,NNP-NNP,NNP,-1,1
9850,39548.0,23,was,4,4,7,3,3,15,0,3,Fuller,co-executive producer,PERSON,TITLE-TITLE,PROPN,ADJ-NOUN,nsubj,amod-attr,NNP,JJ-NN,2,1
9851,39552.0,48,was,25,14,10,-4,13,37,11,-15,Badr Corps,Iran,ORGANIZATION-ORGANIZATION,COUNTRY,PROPN-PROPN,PROPN,compound-dobj,poss,NNP-NNP,NNP,4,1
9852,39568.0,32,became,8,8,13,5,7,18,0,5,Millender-McDonald,House Committee on House Administration,PERSON,ORGANIZATION-ORGANIZATION-ORGANIZATION-ORGANIZATION-ORGANIZATION,PROPN,PROPN-PROPN-ADP-PROPN-PROPN,nsubj,compound-pobj-prep-compound-pobj,NNP,NNP-NNP-IN-NNP-NNP,6,1
9853,39573.0,39,host,25,1,4,3,0,34,24,-21,Olivia Palermo,MTV,PERSON-PERSON,ORGANIZATION,PROPN-PROPN,PROPN,compound-nsubj,poss,NNP-NNP,NNP,4,1
9854,53306.0,36,2009-12-05T22,0,34,25,-9,33,10,-34,25,Olivia Palermo,MTV,PERSON-PERSON,ORGANIZATION,PROPN-PROPN,PROPN,compound-conj,poss,NNP-NNP,NNP,4,1
9855,39579.0,40,expelled,7,11,9,-2,10,30,-4,2,Lee Jye,defence minister,PERSON-PERSON,TITLE-TITLE,PROPN-PROPN,NOUN-NOUN,compound-dobj,compound-compound,NNP-NNP,NN-NN,1,1
9856,39599.0,29,-RRB-,5,1,5,4,0,23,4,0,Asian Development Bank,ABD,ORGANIZATION-ORGANIZATION-ORGANIZATION,ORGANIZATION,PROPN-PROPN-PROPN,PROPN,amod-compound-compound,compound,NNP-NNP-NNP,NNP,-1,1
9857,39602.0,48,died,37,1,5,4,0,42,36,-32,Carolyn Goodman,Manhattan,PERSON-PERSON,CITY,PROPN-PROPN,PROPN,compound-nsubj,nmod,NNP-NNP,NNP,2,1
9858,39603.0,48,Standings,0,34,3,-31,33,44,-34,3,Millonarios,Cucuta,ORGANIZATION,ORGANIZATION,PROPN,PROPN,conj,appos,NNP,NNP,5,1
9859,39605.0,44,were,1,18,6,-12,17,37,-17,5,Li Jie,deputy,PERSON-PERSON,TITLE,PROPN-PROPN,NOUN,compound-conj,compound,NNP-NNP,NN,2,1
9860,39637.0,16,CNAH,11,6,15,9,5,0,5,4,China National Aviation,October,ORGANIZATION-ORGANIZATION-ORGANIZATION,DATE,PROPN-PROPN-PROPN,PROPN,compound-compound-compound,pobj,NNP-NNP-NNP,NNP,-1,1
9861,39644.0,27,appear,10,17,8,-9,16,18,-7,-2,Afghan Taliban,North-West Frontier Province,ORGANIZATION-ORGANIZATION,STATE_OR_PROVINCE-STATE_OR_PROVINCE-STATE_OR_PROVINCE,PROPN-PROPN,PROPN-PROPN-PROPN,compound-compound,compound-compound-pobj,NNP-NNP,NNP-NNP-NNP,8,1
9862,39645.0,21,heads,4,3,7,4,2,13,1,3,Alberto Gonzales,Justice Department,PERSON-PERSON,ORGANIZATION-ORGANIZATION,PROPN-PROPN,PROPN-PROPN,compound-nsubj,compound-dobj,NNP-NNP,NNP-NNP,2,1
9863,39646.0,33,say,7,11,11,0,10,21,-4,4,NEC Corp,NEC,ORGANIZATION-ORGANIZATION,ORGANIZATION,PROPN-PROPN,PROPN,compound-pobj,nsubj,NNP-NNP,NNP,0,1
9864,62267.0,56,said,5,4,4,0,3,51,1,-1,NEC Corp,NEC,ORGANIZATION-ORGANIZATION,ORGANIZATION,PROPN-PROPN,PROPN,compound-nsubj,nsubj,NNP-NNP,NNP,0,1
9865,39647.0,51,said,37,39,34,-5,38,16,-2,-3,Mahmood Shah,North Waziristan,PERSON-PERSON,LOCATION-LOCATION,PROPN-PROPN,PROPN-PROPN,compound-nsubj,compound-pobj,NNP-NNP,NNP-NNP,7,1
9866,39658.0,22,assume,12,18,11,-7,17,10,-6,-1,National Beef,JBS,ORGANIZATION-ORGANIZATION,ORGANIZATION,PROPN-PROPN,PROPN,compound-poss,nsubj,NNP-NNP,NNP,5,1
9867,39670.0,43,formed,15,7,10,3,6,32,8,-5,Lashkar-e-Taiba,Army of the Righteous,ORGANIZATION,ORGANIZATION-ORGANIZATION-ORGANIZATION-ORGANIZATION,PROPN,PROPN-ADP-DET-PROPN,pobj,conj-prep-det-pobj,NNP,NNP-IN-DT-NNP,3,1
9868,39680.0,20,coming,4,2,8,6,1,11,2,4,Philip Chen,Dragonair,PERSON-PERSON,ORGANIZATION,PROPN-PROPN,PROPN,compound-nsubj,pobj,NNP-NNP,NNP,5,1
9869,47153.0,28,reshuffled,11,20,18,-2,19,9,-9,7,Philip Chen,Dragonair,PERSON-PERSON,ORGANIZATION,PROPN-PROPN,PROPN,compound-dobj,compound,NNP-NNP,NNP,1,1
9870,62836.0,28,reshuffled,11,20,18,-2,19,9,-9,7,Philip Chen,Dragonair,PERSON-PERSON,ORGANIZATION,PROPN-PROPN,PROPN,compound-dobj,compound,NNP-NNP,NNP,1,1
9871,39688.0,26,said,7,16,9,-7,15,16,-9,2,Awami League,Suranjit Sengupta,ORGANIZATION-ORGANIZATION,PERSON-PERSON,PROPN-PROPN,PROPN-PROPN,compound-pobj,compound-nsubj,NNP-NNP,NNP-NNP,5,1
9872,39692.0,9,born,4,2,7,5,1,1,2,3,Lorraine Fleishman,San Francisco,PERSON-PERSON,CITY-CITY,PROPN-PROPN,PROPN-PROPN,compound-nsubjpass,compound-pobj,NNP-NNP,NNP-NNP,3,1
9873,39706.0,28,Association,2,1,5,4,0,22,1,3,Inter-American Press Association,http://wwwsipiapacom,ORGANIZATION-ORGANIZATION-ORGANIZATION,URL,ADJ-PROPN-PROPN,X,amod-compound-ROOT,ROOT,JJ-NNP-NNP,ADD,2,1
9874,39712.0,33,trained,18,9,3,-6,8,29,9,-15,Detroit Medical Center,Providence Hospital,ORGANIZATION-ORGANIZATION-ORGANIZATION,LOCATION-LOCATION,PROPN-PROPN-PROPN,PROPN-PROPN,compound-compound-compound,compound-pobj,NNP-NNP-NNP,NNP-NNP,5,1
9875,39718.0,41,said,4,32,40,8,31,0,-28,36,National Beef Packing Co,Missouri,ORGANIZATION-ORGANIZATION-ORGANIZATION-ORGANIZATION,STATE_OR_PROVINCE,PROPN-PROPN-PROPN-PROPN,PROPN,compound-compound-compound-appos,appos,NNP-NNP-NNP-NNP,NNP,5,1
9876,39721.0,44,said,27,23,19,-4,22,24,4,-8,Mainland Affairs Council,Tsai,ORGANIZATION-ORGANIZATION-ORGANIZATION,PERSON,PROPN-PROPN-PROPN,PROPN,compound-compound-compound,nsubj,NNP-NNPS-NNP,NNP,4,1
9877,39745.0,39,arrived,9,26,2,-24,25,36,-17,-7,Awami National Party,Syed,ORGANIZATION-ORGANIZATION-ORGANIZATION,PERSON,PROPN-PROPN-PROPN,PROPN,compound-compound-pobj,compound,NNP-NNP-NNP,NNP,10,1
9878,39775.0,37,received,12,12,21,9,11,15,0,9,he,New York University School of Law,PERSON,ORGANIZATION-ORGANIZATION-ORGANIZATION-ORGANIZATION-ORGANIZATION-ORGANIZATION,PRON,PROPN-PROPN-PROPN-PROPN-ADP-PROPN,nsubj,compound-compound-compound-pobj-prep-pobj,PRP,NNP-NNP-NNP-NNP-IN-NNP,4,1
9879,39785.0,44,said,24,26,32,6,25,11,-2,8,R. Nicholas Burns,professor,PERSON-PERSON-PERSON,TITLE,PROPN-PROPN-PROPN,NOUN,compound-compound-nsubj,appos,NNP-NNP-NNP,NN,2,1
9880,39799.0,38,began,7,7,5,-2,6,32,0,-2,DeGeneres,1958,PERSON,DATE,PROPN,NUM,nsubj,pobj,NNP,CD,1,1
9881,39815.0,37,'s,2,30,20,-10,29,16,-28,18,her,actor,PERSON,TITLE,DET,NOUN,poss,compound,PRP$,NN,8,1
9882,39833.0,26,CRISP,2,1,3,2,0,22,1,1,MARY,CRISP,PERSON,PERSON,PROPN,PROPN,compound,ROOT,NNP,NNP,2,1
9883,39853.0,43,explained,17,23,24,1,22,18,-6,7,her,nanny,PERSON,TITLE,DET,NOUN,poss,amod,PRP$,NN,1,1
9884,39855.0,14,declined,2,7,1,-6,6,12,-5,-1,DeGeneres,Fox,PERSON,PERSON,PROPN,PROPN,poss,compound,NNP,NNP,6,1
9885,39878.0,48,is,16,34,28,-6,33,19,-18,12,PVA,Homer S. Townsend Jr.,ORGANIZATION,PERSON-PERSON-PERSON-PERSON,PROPN,PROPN-PROPN-PROPN-PROPN,poss,compound-compound-compound-nsubj,NNP,NNP-NNP-NNP-NNP,3,1
9886,39890.0,68,appeared,1,1,15,14,0,52,0,14,She,The Bachelorette,PERSON,ORGANIZATION-ORGANIZATION,PRON,DET-PROPN,nsubj,det-conj,PRP,DT-NNP,5,1
9887,39892.0,20,said,18,17,14,-3,16,5,1,-4,her,breast cancer,PERSON,CAUSE_OF_DEATH-CAUSE_OF_DEATH,DET,NOUN-NOUN,poss,compound-pobj,PRP$,NN-NN,5,1
9888,39902.0,19,King,0,1,6,5,0,12,-1,6,King,Martin Luther King III,PERSON,PERSON-PERSON-PERSON-PERSON,PROPN,PROPN-PROPN-PROPN-PROPN,ROOT,compound-compound-compound-conj,NNP,NNP-NNP-NNP-NNP,4,1
9889,39914.0,20,is,10,9,7,-2,8,12,1,-3,Kendra Wilkinson,Playboy,PERSON-PERSON,ORGANIZATION,PROPN-PROPN,PROPN,compound-nsubj,compound,NNP-NNP,NNP,1,1
9890,39919.0,42,Night,3,17,17,0,16,24,-14,14,Chelsea Library,Chelsea District Library,ORGANIZATION-ORGANIZATION,ORGANIZATION-ORGANIZATION-ORGANIZATION,PROPN-PROPN,PROPN-PROPN-PROPN,compound-nsubj,compound-compound-compound,NNP-NNP,NNP-NNP-NNP,0,1
9891,58905.0,80,recognizes,3,18,18,0,17,61,-15,15,Chelsea Library,Chelsea District Library,ORGANIZATION-ORGANIZATION,ORGANIZATION-ORGANIZATION-ORGANIZATION,PROPN-PROPN,PROPN-PROPN-PROPN,compound-pobj,compound-compound-compound,NNP-NNP,NNP-NNP-NNP,0,1
9892,39948.0,25,said,16,1,15,14,0,9,15,-1,Millender-McDonald,California,PERSON,STATE_OR_PROVINCE,PROPN,PROPN,nsubj,appos,NNP,NNP,7,1
9893,57230.0,26,said,17,1,16,15,0,9,16,-1,Millender-McDonald,California,PERSON,STATE_OR_PROVINCE,PROPN,PROPN,nsubj,appos,NNP,NNP,7,1
9894,39949.0,32,survived,7,12,21,9,11,10,-5,14,his,Robert,PERSON,PERSON,DET,PROPN,poss,conj,PRP$,NNP,5,1
9895,39964.0,38,said,21,20,23,3,19,14,1,2,Atlanta Chamber of Commerce,Jorge Fernandez,ORGANIZATION-ORGANIZATION-ORGANIZATION-ORGANIZATION,PERSON-PERSON,PROPN-PROPN-ADP-PROPN,PROPN-PROPN,compound-pobj-prep-pobj,compound-nsubj,NNP-NNP-IN-NNP,NNP-NNP,2,1
9896,39989.0,26,escaped,1,1,16,15,0,9,0,15,He,Southern Baptist,PERSON,RELIGION-RELIGION,PRON,PROPN-PROPN,nsubj,compound-pobj,PRP,NNP-NNP,4,1
9897,39994.0,29,Cuomo,1,15,14,-1,14,14,-14,13,Carolyn Maloney,Reps,PERSON-PERSON,TITLE,PROPN-PROPN,PROPN,compound-conj,compound,NNP-NNP,NNPS,1,1
9898,43600.0,24,bring,16,3,2,-1,2,21,13,-14,Carolyn Maloney,Reps,PERSON-PERSON,TITLE,PROPN-PROPN,PROPN,compound-nsubj,compound,NNP-NNP,NNPS,1,1
9899,39996.0,22,was,8,18,8,-10,17,13,-10,0,Focus on the Family,Jarvis,ORGANIZATION-ORGANIZATION-ORGANIZATION-ORGANIZATION,PERSON,PROPN-ADP-DET-PROPN,PROPN,appos-prep-det-pobj,nsubj,NNP-IN-DT-NNP,NNP,5,1
9900,40034.0,30,survived,9,8,18,10,7,11,1,9,DeBlanc,Barbara DeBlanc Romero,PERSON,PERSON-PERSON-PERSON,PROPN,PROPN-PROPN-PROPN,nsubjpass,compound-compound-appos,NNP,NNP-NNP-NNP,6,1
9901,40039.0,40,reported,37,34,6,-28,33,33,3,-31,New York Daily News,US,ORGANIZATION-ORGANIZATION-ORGANIZATION-ORGANIZATION,COUNTRY,PROPN-PROPN-PROPN-PROPN,PROPN,compound-compound-compound-nsubj,compound,NNP-NNP-NNP-NNP,NNP,6,1
9902,40046.0,16,leaked,1,13,12,-1,12,3,-12,11,Alberto Gonzales,counsel,PERSON-PERSON,TITLE,PROPN-PROPN,NOUN,compound-pobj,compound,NNP-NNP,NN,1,1
9903,40048.0,34,said,1,1,10,9,0,23,0,9,Chavez,United Socialist party,PERSON,ORGANIZATION-ORGANIZATION-ORGANIZATION,PROPN,PROPN-PROPN-NOUN,nsubj,compound-amod-dobj,NNP,NNP-NNP-NN,3,1
9904,40052.0,33,said,10,2,9,7,1,23,8,-1,George Young,Commons,PERSON-PERSON,ORGANIZATION,PROPN-PROPN,PROPN,compound-nsubj,pobj,NNP-NNP,NNPS,2,1
9905,40069.0,29,said,13,4,10,6,3,18,9,-3,Denso,Toyota Motor Corp.,ORGANIZATION,ORGANIZATION-ORGANIZATION-ORGANIZATION,PROPN,PROPN-PROPN-PROPN,pobj,compound-compound-pobj,NNP,NNP-NNP-NNP,4,1
9906,40071.0,24,said,1,13,18,5,12,5,-12,17,North Phoenix Baptist Church,Arizona,ORGANIZATION-ORGANIZATION-ORGANIZATION-ORGANIZATION,STATE_OR_PROVINCE,PROPN-PROPN-PROPN-PROPN,PROPN,compound-compound-compound-pobj,pobj,NNP-NNP-NNP-NNP,NNP,5,1
9907,40073.0,50,said,6,25,15,-10,24,34,-19,9,Covidien Ltd.,Mallinckrodt Inc.,ORGANIZATION-ORGANIZATION,ORGANIZATION-ORGANIZATION,PROPN-PROPN,PROPN-PROPN,compound-pobj,compound-pobj,NNP-NNP,NNP-NNP,3,1
9908,40081.0,47,are,18,42,41,-1,41,5,-24,23,Ellen DeGeneres,comedian,PERSON-PERSON,TITLE,PROPN-PROPN,NOUN,compound-appos,compound,NNP-NNP,NN,1,1
9909,40083.0,32,be,19,1,5,4,0,26,18,-14,Jake Pavelka,pilot,PERSON-PERSON,TITLE,PROPN-PROPN,NOUN,compound-nsubj,appos,NNP-NNP,NN,3,1
9910,42334.0,36,has,32,22,21,-1,21,14,10,-11,Jake Pavelka,pilot,PERSON-PERSON,TITLE,PROPN-PROPN,NOUN,compound-pobj,compound,NNP-NNP,NN,1,1
9911,62882.0,16,are,1,10,9,-1,9,6,-9,8,Jake Pavelka,pilot,PERSON-PERSON,TITLE,PROPN-PROPN,NOUN,compound-conj,compound,NNP-NNP,NN,1,1
9912,65091.0,42,admin,0,11,15,4,10,26,-11,15,Jake Pavelka,pilot,PERSON-PERSON,TITLE,PROPN-PROPN,NOUN,compound-pobj,appos,NNP-NNP,NN,4,1
9913,40085.0,43,Hooper,3,3,36,33,2,6,0,33,Jeremy,PBS,PERSON,ORGANIZATION,PROPN,PROPN,poss,nmod,NNP,NNP,-1,1
9914,40096.0,60,were,21,10,32,22,9,27,11,11,Abu Zubaida,leader,PERSON-PERSON,TITLE,PROPN-PROPN,NOUN,compound-appos,dobj,NNP-NNP,NN,8,1
9915,40109.0,18,says,16,1,6,5,0,11,15,-10,Spears,her,PERSON,PERSON,NOUN,DET,nsubj,poss,NNS,PRP$,2,1
9916,40119.0,26,Xu,0,8,1,-7,7,24,-8,1,FAW Group,Xu,ORGANIZATION-ORGANIZATION,PERSON,PROPN-PROPN,PROPN,compound-pobj,ROOT,NNP-NNP,NNP,4,1
9917,40122.0,27,grew,4,1,11,10,0,15,3,7,Harry Shuler Dent,S.C.,PERSON-PERSON-PERSON,STATE_OR_PROVINCE,PROPN-PROPN-PROPN,PROPN,compound-compound-nsubj,appos,NNP-NNP-NNP,NNP,3,1
9918,62080.0,27,grew,4,1,11,10,0,15,3,7,Harry Shuler Dent,S.C.,PERSON-PERSON-PERSON,STATE_OR_PROVINCE,PROPN-PROPN-PROPN,PROPN,compound-compound-nsubj,appos,NNP-NNP-NNP,NNP,3,1
9919,40130.0,25,VERITY-OBIT-MCC,0,2,21,19,1,3,-2,21,Verity,Calvin William Verity Sr,PERSON,PERSON-PERSON-PERSON-PERSON,PROPN,PROPN-PROPN-PROPN-PROPN,nsubjpass,compound-compound-compound-conj,NNP,NNP-NNP-NNP-NNP,9,1
9920,40132.0,19,acknowledged,9,1,1,0,0,17,8,-8,Red Sox,Red Sox officials,ORGANIZATION-ORGANIZATION,PERSON-PERSON-PERSON,PROPN-PROPN,PROPN-PROPN-NOUN,compound-compound,compound-compound-pobj,NNP-NNP,NNP-NNPS-NNS,0,1
9921,40147.0,23,born,2,1,15,14,0,7,1,13,ElBaradei,"universities of Cairo , Geneva",PERSON,ORGANIZATION-ORGANIZATION-ORGANIZATION-ORGANIZATION-ORGANIZATION,PROPN,NOUN-ADP-PROPN-PUNCT-PROPN,nsubjpass,pobj-prep-pobj-punct-conj,NNP,"NNS-IN-NNP-,-NNP",5,1
9922,40152.0,51,claimed,5,42,41,-1,41,9,-37,36,Paavo Nurmi,runner,PERSON-PERSON,TITLE,PROPN-PROPN,NOUN,compound-conj,compound,NNP-NNP,NN,2,1
9923,40154.0,19,PARIS,0,8,15,7,7,3,-8,15,Yoadimnadji,cardiovascular problem,PERSON,CAUSE_OF_DEATH-CAUSE_OF_DEATH,PROPN,ADJ-NOUN,nsubj,amod-pobj,NNP,JJ-NN,4,1
9924,40162.0,20,noted,7,1,5,4,0,14,6,-2,Kennedy,professor,PERSON,TITLE,PROPN,NOUN,nsubj,appos,NNP,NN,3,1
9925,40193.0,30,said,23,1,8,7,0,21,22,-15,Forsberg,City College of New York,PERSON,ORGANIZATION-ORGANIZATION-ORGANIZATION-ORGANIZATION-ORGANIZATION,PROPN,PROPN-PROPN-ADP-PROPN-PROPN,nsubj,compound-pobj-prep-compound-pobj,NNP,NNP-NNP-IN-NNP-NNP,4,1
9926,40195.0,26,catch,2,6,25,19,5,0,-4,23,Spencer,MTV,PERSON,ORGANIZATION,PROPN,PROPN,conj,pobj,NNP,NNP,4,1
9927,40209.0,37,features,3,13,34,21,12,2,-10,31,Kerry,Teresa Heinz Kerry,PERSON,PERSON-PERSON-PERSON,PROPN,PROPN-PROPN-PROPN,poss,compound-compound-appos,NNP,NNP-NNP-NNP,11,1
9928,40210.0,61,saw,2,11,25,14,10,35,-9,23,Paul Sculfor,CA,PERSON-PERSON,STATE_OR_PROVINCE,PROPN-PROPN,PROPN,compound-appos,compound,NNP-NNP,NNP,7,1
9929,40216.0,25,served,6,6,11,5,5,13,0,5,he,Austrian,PERSON,NATIONALITY,PRON,ADJ,nsubj,amod,PRP,JJ,3,1
9930,40219.0,34,has,20,14,32,18,13,1,6,12,Denso Corp,Nansha District,ORGANIZATION-ORGANIZATION,LOCATION-LOCATION,PROPN-PROPN,PROPN-PROPN,compound-nsubj,compound-pobj,NNP-NNP,NNP-NNP,6,1
9931,40226.0,21,spotted,14,11,8,-3,10,12,3,-6,Spencer Pratt,her,PERSON-PERSON,PERSON,PROPN-PROPN,DET,compound-appos,poss,NNP-NNP,PRP$,1,1
9932,40228.0,37,convicted,11,9,16,7,8,20,2,5,Remy Ma,weapons possession,PERSON-PERSON,CRIMINAL_CHARGE-CRIMINAL_CHARGE,PROPN-PROPN,NOUN-NOUN,compound-nsubjpass,compound-conj,NNP-NNP,NNS-NN,5,1
9933,40232.0,36,fallen,2,8,10,2,7,25,-6,8,Arsenal,Arsene Wenger,ORGANIZATION,PERSON-PERSON,PROPN,PROPN-PROPN,compound,compound-pobj,NNP,NNP-NNP,1,1
9934,50275.0,44,said,5,1,3,2,0,40,4,-2,Arsenal,Arsene Wenger,ORGANIZATION,PERSON-PERSON,ADJ,PROPN-PROPN,compound,compound-nsubj,JJ,NNP-NNP,1,1
9935,40233.0,25,appointed,4,1,13,12,0,11,3,9,Czech National Bank,Miroslav Singer,ORGANIZATION-ORGANIZATION-ORGANIZATION,PERSON-PERSON,PROPN-PROPN-PROPN,PROPN-PROPN,compound-compound-compound,compound-dobj,NNP-NNP-NNP,NNP-NNP,4,1
9936,64992.0,26,said,6,1,5,4,0,20,5,-1,Czech National Bank,Miroslav Singer,ORGANIZATION-ORGANIZATION-ORGANIZATION,PERSON-PERSON,PROPN-PROPN-PROPN,PROPN-PROPN,compound-compound-compound,compound-nsubj,NNP-NNP-NNP,NNP-NNP,3,1
9937,40265.0,43,met,16,16,15,-1,15,27,0,-1,NSG,45-member,ORGANIZATION,NUMBER,PROPN,ADJ,nsubj,compound,NNP,JJ,1,1
9938,40274.0,40,announced,17,5,28,23,4,11,12,11,Altael-Lucent,Serge Tchuruk,ORGANIZATION,PERSON-PERSON,ADJ,PROPN-PROPN,amod,compound-nsubj,JJ,NNP-NNP,8,1
9939,40278.0,50,earned,33,1,31,30,0,18,32,-2,Mark Buse,ML Strategies,PERSON-PERSON,ORGANIZATION-ORGANIZATION,PROPN-PROPN,PROPN-PROPN,compound-nsubj,compound-appos,NNP-NNP,NNP-NNP,4,1
9940,40283.0,23,is,1,9,8,-1,8,14,-8,7,Jo Ann Davis,Congresswoman,PERSON-PERSON-PERSON,TITLE,PROPN-PROPN-PROPN,PROPN,compound-compound-pobj,compound,NNP-NNP-NNP,NNP,2,1
9941,40285.0,24,declined,20,10,1,-9,9,22,10,-19,SAC,Jonathan Gasthalter,ORGANIZATION,PERSON-PERSON,PROPN,PROPN-PROPN,appos,compound-nsubj,NNP,NNP-NNP,5,1
9942,40286.0,55,said,42,15,13,-2,14,41,27,-29,NEC Corp.,Japan,ORGANIZATION-ORGANIZATION,COUNTRY,PROPN-PROPN,PROPN,compound-conj,poss,NNP-NNP,NNP,4,1
9943,40311.0,36,say,5,2,35,33,1,0,3,30,Castro,Alexis,PERSON,PERSON,PROPN,PROPN,nsubj,conj,NNP,NNP,2,1
9944,40320.0,45,warrant,9,25,18,-7,24,26,-16,9,Haifa University,Emmanuel Gross,ORGANIZATION-ORGANIZATION,PERSON-PERSON,PROPN-PROPN,PROPN-PROPN,compound-pobj,compound-pobj,NNP-NNP,NNP-NNP,3,1
9945,40338.0,39,denied,9,2,15,13,1,23,7,6,IAPA,association,ORGANIZATION,ORGANIZATION,PROPN,NOUN,poss,dobj,NNP,NN,5,1
9946,40346.0,36,been,5,32,2,-30,31,33,-27,-3,her,Catholic,PERSON,RELIGION,DET,PROPN,poss,compound,PRP$,NNP,8,1
9947,40355.0,27,praised,20,12,1,-11,11,25,8,-19,APA,Perry Halkitis,ORGANIZATION,PERSON-PERSON,PROPN,PROPN-PROPN,compound,compound-nsubj,NNP,NNP-NNP,3,1
9948,40360.0,40,PARIS,0,34,10,-24,33,29,-34,10,Pascal Yoadimnadji,President,PERSON-PERSON,TITLE,PROPN-PROPN,PROPN,compound-pobj,compound,NNP-NNPS,NNP,9,1
9949,40376.0,32,survived,7,6,4,-2,5,27,1,-3,he,Kempfer,PERSON,PERSON,PRON,PROPN,nsubjpass,pobj,PRP,NNP,2,1
9950,40377.0,29,Ahearn,1,1,10,9,0,18,0,9,Pamela Ahearn,US House,PERSON-PERSON,ORGANIZATION-ORGANIZATION,PROPN-PROPN,PROPN-PROPN,compound-ROOT,compound-pobj,NNP-NNP,NNP-NNP,3,1
9951,40385.0,27,arrived,10,9,1,-8,8,25,1,-9,Mohamed ElBaradei,The United Nations,PERSON-PERSON,ORGANIZATION-ORGANIZATION-ORGANIZATION,PROPN-PROPN,DET-PROPN-PROPN,compound-appos,det-compound-poss,NNP-NNP,DT-NNP-NNP,3,1
9952,40390.0,26,al-Amiri,1,8,1,-7,7,24,-7,0,Badr Organization,Hadi al-Amiri,ORGANIZATION-ORGANIZATION,PERSON-PERSON,PROPN-PROPN,PROPN-PROPN,compound-pobj,compound-ROOT,NNP-NNP,NNP-NNP,5,1
9953,52189.0,58,was,1,49,43,-6,48,14,-48,42,Badr Organization,Hadi al-Amiri,ORGANIZATION-ORGANIZATION,PERSON-PERSON,PROPN-PROPN,PROPN-PROPN,compound-dobj,compound-conj,NNP-NNP,NNP-NNP,3,1
9954,60204.0,21,went,6,16,19,3,15,1,-10,13,Badr Organization,Hadi al-Amiri,ORGANIZATION-ORGANIZATION,PERSON-PERSON,PROPN-PROPN,PROPN-PROPN,compound-pobj,compound-appos,NNP-NNP,NNP-NNP,4,1
9955,40391.0,16,said,4,3,2,-1,2,13,1,-2,George Kennedy,chairman,PERSON-PERSON,TITLE,PROPN-PROPN,NOUN,compound-nsubj,compound,NNP-NNP,NN,1,1
9956,40393.0,33,said,7,2,6,4,1,26,5,-1,Sean Ross,cook,PERSON-PERSON,TITLE,PROPN-PROPN,VERB,compound-nsubj,conj,NNP-NNP,VB,2,1
9957,40397.0,36,putting,5,11,1,-10,10,34,-6,-4,her,Singer/songwriter,PERSON,TITLE,DET,PROPN,poss,compound,PRP$,NNP,4,1
9958,40402.0,40,was,37,8,11,3,7,28,29,-26,Independent Steelworkers Union,President Mark Glyptis,ORGANIZATION-ORGANIZATION-ORGANIZATION,PERSON-PERSON-PERSON,PROPN-PROPN-PROPN,PROPN-PROPN-PROPN,compound-compound-compound,compound-compound-nsubj,NNP-NNPS-NNP,NNP-NNP-NNP,4,1
9959,40468.0,34,died,28,1,6,5,0,27,27,-22,Vernon Bellecourt,Indian,PERSON-PERSON,NATIONALITY,PROPN-PROPN,PROPN,compound-nsubj,appos,NNP-NNP,NNP,3,1
9960,40474.0,27,said,4,2,10,8,1,16,2,6,Chinese Petroleum Corp.,CPC Corp.,ORGANIZATION-ORGANIZATION-ORGANIZATION,ORGANIZATION-ORGANIZATION,PROPN-PROPN-PROPN,PROPN-PROPN,compound-compound-nsubj,compound-attr,NNP-NNP-NNP,NNP-NNP,4,1
9961,40475.0,31,said,8,1,7,6,0,23,7,-1,Manila Economic and Cultural Office,Rodolfo Sabulao,ORGANIZATION-ORGANIZATION-ORGANIZATION-ORGANIZATION-ORGANIZATION,PERSON-PERSON,PROPN-PROPN-CCONJ-PROPN-PROPN,PROPN-PROPN,amod-nmod-cc-conj-compound,compound-nsubj,NNP-NNP-CC-NNP-NNP,NNP-NNP,3,1
9962,40476.0,18,born,5,1,8,7,0,9,4,3,Thomas Joseph Meskill Jr.,New Britain,PERSON-PERSON-PERSON-PERSON,CITY-CITY,PROPN-PROPN-PROPN-PROPN,PROPN-PROPN,compound-compound-compound-nsubjpass,compound-pobj,NNP-NNP-NNP-NNP,NNP-NNP,4,1
9963,40480.0,18,sentenced,2,1,11,10,0,6,1,9,He,insurrection,PERSON,CRIMINAL_CHARGE,PRON,NOUN,nsubjpass,nsubj,PRP,NN,2,1
9964,40494.0,41,explained,16,16,12,-4,15,28,0,-4,Chen,Chinese,PERSON,NATIONALITY,PROPN,ADJ,nsubj,amod,NNP,JJ,7,1
9965,62239.0,22,declined,1,15,7,-8,14,14,-14,6,Chen,Chinese,PERSON,NATIONALITY,PROPN,ADJ,nsubj,amod,NNP,JJ,6,1
9966,40500.0,26,serve,6,1,4,3,0,21,5,-2,PRCA Board,Keith Martin,ORGANIZATION-ORGANIZATION,PERSON-PERSON,PROPN-PROPN,PROPN-PROPN,compound-compound,compound-nsubj,NNP-NNP,NNP-NNP,2,1
9967,40542.0,11,co-authored,3,6,10,4,5,0,-3,7,Farrow,Ronan,PERSON,PERSON,PROPN,PROPN,poss,appos,NNP,NNP,2,1
9968,40543.0,33,taped,21,1,8,7,0,24,20,-13,Buchwald,kidney disease,PERSON,CAUSE_OF_DEATH-CAUSE_OF_DEATH,PROPN,NOUN-NOUN,nsubjpass,compound-pobj,NNP,NN-NN,4,1
9969,40553.0,31,told,26,22,17,-5,21,13,4,-9,FMF,Decio de Maria,ORGANIZATION,PERSON-PERSON-PERSON,PROPN,PROPN-X-PROPN,poss,compound-compound-nsubj,NNP,NNP-FW-NNP,3,1
9970,43889.0,28,said,13,27,15,-12,26,12,-14,2,FMF,Decio de Maria,ORGANIZATION,PERSON-PERSON-PERSON,PROPN,PROPN-X-PROPN,conj,compound-compound-nsubj,NNP,NNP-FW-NNP,3,1
9971,50138.0,30,said,7,6,1,-5,5,28,1,-6,FMF,Decio de Maria,ORGANIZATION,PERSON-PERSON-PERSON,PROPN,PROPN-X-PROPN,appos,compound-compound-nsubj,NNP,NNP-FW-NNP,3,1
9972,40563.0,47,facing,19,43,27,-16,42,19,-24,8,UNC,Congress,ORGANIZATION,ORGANIZATION,PROPN,PROPN,compound,pobj,NNP,NNP,7,1
9973,40567.0,75,calls,1,18,27,9,17,47,-17,26,Organization of the Islamic Conference,Ekmeleddin Ibsanoglu,ORGANIZATION-ORGANIZATION-ORGANIZATION-ORGANIZATION-ORGANIZATION,PERSON-PERSON,PROPN-ADP-DET-PROPN-PROPN,PROPN-PROPN,pobj-prep-det-compound-pobj,compound-appos,NNP-IN-DT-NNP-NNP,NNP-NNP,-1,1
9974,40573.0,25,read,6,10,2,-8,9,22,-4,-4,her,his,PERSON,PERSON,DET,DET,poss,poss,PRP$,PRP$,5,1
9975,66366.0,22,plays,2,14,11,-3,13,10,-12,9,her,his,PERSON,PERSON,DET,DET,poss,poss,PRP$,PRP$,5,1
9976,40579.0,21,is,3,2,10,8,1,10,1,7,Denso,rockauto.com,ORGANIZATION,URL,PROPN,X,nsubj,pobj,NNP,ADD,3,1
9977,40584.0,45,phwoarrrrr,0,8,12,4,7,32,-8,12,Adam Senn,American,PERSON-PERSON,NATIONALITY,PROPN-PROPN,ADJ,compound-nsubj,amod,NNP-NNP,JJ,3,1
9978,40587.0,44,criticized,19,1,5,4,0,38,18,-14,Larijani,politician,PERSON,TITLE,PROPN,NOUN,nsubj,appos,NNP,NN,3,1
9979,40588.0,14,be,5,13,3,-10,12,10,-8,-2,museum,Susan Sterling,ORGANIZATION,PERSON-PERSON,NOUN,PROPN-PROPN,pobj,compound-nsubj,NN,NNP-NNP,2,1
9980,40595.0,25,poised,1,6,13,7,5,11,-5,12,Central American Parliament,1991,ORGANIZATION-ORGANIZATION-ORGANIZATION,DATE,ADJ-PROPN-PROPN,NUM,amod-compound-compound,pobj,JJ-NNP-NNP,CD,7,1
9981,40624.0,40,died,7,10,5,-5,9,34,-3,-2,his,pancreatic cancer,PERSON,CAUSE_OF_DEATH-CAUSE_OF_DEATH,DET,ADJ-NOUN,poss,amod-dobj,PRP$,JJ-NN,5,1
9982,40625.0,44,given,2,19,1,-18,18,42,-17,-1,Disney,TWDC,ORGANIZATION,ORGANIZATION,PROPN,PROPN,compound,nsubj,NNP,NNP,4,1
9983,40630.0,44,told,37,3,32,29,2,11,34,-5,Raul Castro,Latin American,PERSON-PERSON,NATIONALITY-NATIONALITY,PROPN-PROPN,ADJ-ADJ,compound-nsubj,amod-amod,NNP-NNP,JJ-JJ,6,1
9984,40632.0,22,charge,1,20,17,-3,19,4,-19,16,he,Justice Department,PERSON,ORGANIZATION-ORGANIZATION,PRON,PROPN-PROPN,nsubj,compound-pobj,PRP,NNP-NNP,3,1
9985,40640.0,36,was,25,9,17,8,8,18,16,-8,his,kidney failure,PERSON,CAUSE_OF_DEATH-CAUSE_OF_DEATH,DET,NOUN-NOUN,poss,compound-pobj,PRP$,NN-NN,5,1
9986,40692.0,35,released,2,27,30,3,26,4,-25,28,MNLF,Saudi Arabia,ORGANIZATION,COUNTRY-COUNTRY,PROPN,PROPN-PROPN,compound,compound-pobj,NNP,NNP-NNP,2,1
9987,40695.0,35,said,24,26,30,4,25,4,-2,6,International Monetary Fund,chairman Youssef Boutros - Ghali,ORGANIZATION-ORGANIZATION-ORGANIZATION,PERSON-PERSON-PERSON-PERSON-PERSON,PROPN-PROPN-PROPN,NOUN-PROPN-PROPN-PUNCT-PROPN,compound-compound-compound,compound-compound-compound-punct-nsubj,NNP-NNP-NNP,NN-NNP-NNP-HYPH-NNP,2,1
9988,40702.0,29,accompanied,6,8,14,6,7,14,-2,8,him,she,PERSON,PERSON,PRON,PRON,dobj,nsubj,PRP,PRP,2,1
9989,57616.0,29,accompanied,6,8,14,6,7,14,-2,8,him,she,PERSON,PERSON,PRON,PRON,dobj,nsubj,PRP,PRP,2,1
9990,40705.0,42,expelled,9,8,5,-3,7,36,1,-4,Perle,government agent,PERSON,TITLE-TITLE,PROPN,NOUN-NOUN,nsubjpass,compound-nsubjpass,NNP,NN-NN,2,1
9991,40711.0,46,Party,3,11,8,-3,10,37,-8,5,Shah Mahmood Quraishi,Punjab,PERSON-PERSON-PERSON,LOCATION,PROPN-PROPN-PROPN,PROPN,compound-compound-appos,compound,NNP-NNP-NNP,NNP,2,1
9992,40716.0,13,said,11,9,4,-5,8,8,2,-7,his,complications of a stroke,PERSON,CAUSE_OF_DEATH-CAUSE_OF_DEATH-CAUSE_OF_DEATH-CAUSE_OF_DEATH,DET,NOUN-ADP-DET-NOUN,poss,attr-prep-det-pobj,PRP$,NNS-IN-DT-NN,4,1
9993,40717.0,54,survived,2,47,29,-18,46,24,-45,27,Charles Kaiser,David Kaiser,PERSON-PERSON,PERSON-PERSON,PROPN-PROPN,PROPN-PROPN,compound-conj,compound-appos,NNP-NNP,NNP-NNP,1,1
9994,40723.0,25,been,5,20,23,3,19,1,-15,18,Communist China,1949,ORGANIZATION-ORGANIZATION,DATE,PROPN-PROPN,NUM,compound-poss,nsubj,NNP-NNP,CD,3,1
9995,40733.0,18,said,5,1,3,2,0,14,4,-2,ABA,Karen J. Mathis,ORGANIZATION,PERSON-PERSON-PERSON,PROPN,PROPN-PROPN-PROPN,compound,compound-compound-nsubj,NNP,NNP-NNP-NNP,2,1
9996,40770.0,67,be,2,20,59,39,19,7,-18,57,IMF,Michael Kuhn,ORGANIZATION,PERSON-PERSON,PROPN,PROPN-PROPN,compound,compound-conj,NNP,NNP-NNP,5,1
9997,40788.0,61,extended,13,33,28,-5,32,32,-20,15,Asian Development Bank,Cambodia,ORGANIZATION-ORGANIZATION-ORGANIZATION,COUNTRY,PROPN-PROPN-PROPN,PROPN,compound-compound-pobj,conj,NNP-NNP-NNP,NNP,12,1
9998,40796.0,27,made,13,6,10,4,5,16,7,-3,Sandy,Denise Sandy,PERSON,PERSON-PERSON,PROPN,PROPN-PROPN,poss,compound-appos,NNP,NNP-NNP,3,1
9999,40799.0,41,said,27,39,29,-10,38,11,-12,2,Red Cross,Mark W Everson,ORGANIZATION-ORGANIZATION,PERSON-PERSON-PERSON,PROPN-PROPN,PROPN-PROPN-PROPN,compound-pobj,compound-compound-nsubj,NNP-NNP,NNP-NNP-NNP,5,1
10000,40826.0,38,were,7,25,29,4,24,8,-18,22,William Verity,secretary,PERSON-PERSON,TITLE,PROPN-PROPN,NOUN,compound-conj,compound,NNP-NNP,NN,2,1
10001,40857.0,33,was,6,8,9,1,7,23,-2,3,Representative,John Tierney,ORGANIZATION,PERSON-PERSON,PROPN,PROPN-PROPN,compound,compound-nsubj,NNP,NNP-NNP,1,1
10002,40861.0,31,grew,16,3,20,17,2,10,13,4,driver,Stevenage,PERSON,CITY,NOUN,PROPN,nsubj,pobj,NN,NNP,5,1
10003,40895.0,35,bestowed,8,12,11,-1,11,23,-4,3,Michael Johns,Aussie,PERSON-PERSON,NATIONALITY,PROPN-PROPN,PROPN,compound-pobj,compound,NNP-NNP,NNP,1,1
10004,40900.0,25,20-29,9,23,5,-18,22,19,-14,-4,NFC South,Allen,ORGANIZATION-ORGANIZATION,PERSON,PROPN-PROPN,PROPN,compound-pobj,pobj,NNP-NNP,NNP,4,1
10005,40913.0,25,pleaded,11,11,15,4,10,9,0,4,Dent,aiding an illegal fundraising operation,PERSON,CRIMINAL_CHARGE-CRIMINAL_CHARGE-CRIMINAL_CHARGE-CRIMINAL_CHARGE-CRIMINAL_CHARGE,PROPN,VERB-DET-ADJ-NOUN-NOUN,nsubj,pcomp-det-amod-compound-dobj,NNP,VBG-DT-JJ-NN-NN,5,1
10006,40916.0,28,made,1,1,15,14,0,12,0,14,FirstGroup,US-based Ryder Public Transportation Services,ORGANIZATION,ORGANIZATION-ORGANIZATION-ORGANIZATION-ORGANIZATION-ORGANIZATION,PROPN,PROPN-PROPN-PROPN-PROPN-PROPN,nsubj,punct-compound-compound-compound-pobj,NNP,NNP-NNP-NNP-NNP-NNPS,6,1
10007,40921.0,31,be,4,9,17,8,8,13,-5,13,Larijani,representative,PERSON,TITLE,PROPN,NOUN,nsubj,pobj,NNP,NN,4,1
10008,40922.0,66,said,32,40,34,-6,39,31,-8,2,Itochu Corp.,Maruyama,ORGANIZATION-ORGANIZATION,PERSON,PROPN-PROPN,PROPN,compound-subtok,nsubj,NNP-NNP,NNP,3,1
10009,66460.0,28,said,21,19,13,-6,18,14,2,-8,Itochu Corp.,Maruyama,ORGANIZATION-ORGANIZATION,PERSON,PROPN-PROPN,PROPN,compound-pobj,nsubj,NNP-NNP,NNP,4,1
10010,40936.0,42,deliberated,1,13,38,25,12,3,-12,37,Michael Sandy,"Oct 8 , 2006",PERSON-PERSON,DATE-DATE-DATE-DATE,PROPN-PROPN,PROPN-NUM-PUNCT-NUM,compound-pobj,pobj-nummod-punct-appos,NNP-NNP,"NNP-CD-,-CD",16,1
10011,40938.0,49,Police,2,5,15,10,4,33,-3,13,ANP,ISAF,ORGANIZATION,ORGANIZATION,PROPN,PROPN,compound,compound,NNP,NNP,2,1
10012,40946.0,28,was,6,6,4,-2,5,23,0,-2,he,Austin,PERSON,CITY,PRON,PROPN,nsubj,pobj,PRP,NNP,1,1
10013,40959.0,27,left,1,1,9,8,0,17,0,8,Haddad-Adel,Cuban,PERSON,NATIONALITY,PUNCT,ADJ,nsubj,amod,:,JJ,5,1
10014,40964.0,21,said,1,18,15,-3,17,5,-17,14,he,grader,PERSON,TITLE,PRON,NOUN,nsubj,nsubj,PRP,NN,1,1
10015,40973.0,46,asked,17,5,12,7,4,33,12,-5,Farland,West Virginia,PERSON,STATE_OR_PROVINCE-STATE_OR_PROVINCE,PROPN,PROPN-PROPN,nsubjpass,nmod-compound,NNP,NNP-NNP,5,1
10016,40994.0,31,was,1,13,17,4,12,13,-12,16,McPherson,Disney,PERSON,ORGANIZATION,PROPN,PROPN,pobj,poss,NNP,NNP,5,1
10017,41000.0,19,arrived,1,1,4,3,0,14,0,3,Triet,Venezula,PERSON,ORGANIZATION,PROPN,PROPN,nsubj,pobj,NNP,NNP,1,1
10018,41007.0,26,said,8,19,10,-9,18,15,-11,2,American Bar Association,Mitchell Karpf,ORGANIZATION-ORGANIZATION-ORGANIZATION,PERSON-PERSON,PROPN-PROPN-PROPN,PROPN-PROPN,compound-compound-poss,compound-nsubj,NNP-NNP-NNP,NNP-NNP,6,1
10019,41009.0,58,include,1,46,49,3,45,8,-45,48,her,Sarah Callaghan,PERSON,PERSON-PERSON,DET,PROPN-PROPN,poss,compound-conj,PRP$,NNP-NNP,1,1
10020,41022.0,27,wants,5,5,2,-3,4,24,0,-3,company,Salt Lake,ORGANIZATION,CITY-CITY,NOUN,PROPN-PROPN,nsubj,compound-compound,NN,NNP-NNP,2,1
10021,41032.0,68,said,21,15,35,20,14,32,6,14,Morgenthau,Nabors,PERSON,ORGANIZATION,PROPN,PROPN,poss,pobj,NNP,NNP,9,1
10022,41061.0,52,took,5,41,26,-15,40,25,-36,21,she,Detroit,PERSON,CITY,PRON,PROPN,nsubj,pobj,PRP,NNP,2,1
10023,41065.0,38,said,31,10,25,15,9,12,21,-6,the school,Acerra,ORGANIZATION-ORGANIZATION,PERSON,DET-NOUN,PROPN,det-pobj,nsubj,DT-NN,NNP,12,1
10024,41078.0,33,said,7,7,10,3,6,22,0,3,Beyonce,star,PERSON,TITLE,PROPN,NOUN,pobj,nsubj,NNP,NN,3,1
10025,41095.0,21,spoke,1,14,13,-1,13,7,-13,12,Abbas Musawi,Sheik,PERSON-PERSON,TITLE,PROPN-PROPN,PROPN,compound-appos,compound,NNP-NNP,NNP,1,1
10026,41108.0,42,went,1,19,23,4,18,18,-18,22,Beverly Sills,chairman,PERSON-PERSON,TITLE,PROPN-PROPN,NOUN,compound-appos,appos,NNP-NNP,NN,2,1
10027,41110.0,26,said,17,1,14,13,0,11,16,-3,Millender-McDonald,Carson,PERSON,CITY,PROPN,PROPN,nsubj,pobj,NNP,NNP,5,1
10028,64033.0,38,includes,8,1,17,16,0,20,7,9,Millender-McDonald,Carson,PERSON,CITY,PROPN,PROPN,meta,pobj,NNP,NNP,5,1
10029,65810.0,25,said,16,1,13,12,0,11,15,-3,Millender-McDonald,Carson,PERSON,CITY,PROPN,PROPN,nsubj,pobj,NNP,NNP,5,1
10030,41144.0,44,fled,4,32,40,8,31,3,-28,36,Justice and Equality Movement,Suleiman Sandal,ORGANIZATION-ORGANIZATION-ORGANIZATION-ORGANIZATION,PERSON-PERSON,PROPN-CCONJ-PROPN-PROPN,PROPN-PROPN,conj-cc-conj-pobj,compound-nsubj,NNP-CC-NNP-NNP,NNP-NNP,7,1
10031,41150.0,25,Good,1,6,5,-1,5,19,-5,4,Jeremy Hooper,blogger/activist,PERSON-PERSON,TITLE,PROPN-PROPN,VERB,compound-nsubj,compound,NNP-NNP,VBP,1,1
10032,41164.0,60,survived,9,8,33,25,7,26,1,24,Nolte,Roger,PERSON,PERSON,PROPN,PROPN,nsubjpass,appos,NNP,NNP,6,1
10033,41168.0,17,giving,8,6,1,-5,5,15,2,-7,Ellen DeGeneres,Comedian,PERSON-PERSON,TITLE,PROPN-PROPN,ADJ,compound-nsubj,amod,NNP-NNP,JJ,3,1
10034,41174.0,19,set,6,1,10,9,0,8,5,4,The Inter American Press Association,the 1940s,ORGANIZATION-ORGANIZATION-ORGANIZATION-ORGANIZATION-ORGANIZATION,DATE-DATE,DET-PROPN-PROPN-PROPN-PROPN,DET-NOUN,det-compound-compound-compound-nsubjpass,det-pobj,DT-NNP-NNP-NNP-NNP,DT-NNS,4,1
10035,41179.0,25,born,4,1,22,21,0,2,3,18,Richmond McDavid Flowers,Ila McDavid Flowers,PERSON-PERSON-PERSON,PERSON-PERSON-PERSON,PROPN-PROPN-PROPN,PROPN-PROPN-PROPN,compound-compound-nsubjpass,compound-compound-conj,NNP-NNP-NNP,NNP-NNP-NNP,11,1
10036,41226.0,50,include,1,28,9,-19,27,40,-27,8,Gilbert Gude Jr.,Jane Callaghan Gude,PERSON-PERSON-PERSON,PERSON-PERSON-PERSON,PROPN-PROPN-PROPN,PROPN-PROPN-PROPN,compound-compound-conj,compound-compound-appos,NNP-NNP-NNP,NNP-NNP-NNP,5,1
10037,41242.0,28,is,2,26,1,-25,25,26,-24,-1,Frankie Delgado,Brody Jenner,PERSON-PERSON,PERSON-PERSON,PROPN-PROPN,PROPN-PROPN,compound-dobj,compound-nsubj,NNP-NNP,NNP-NNP,5,1
10038,41263.0,45,denies,1,9,41,32,8,3,-8,40,Pamela Martin & Associates,US,ORGANIZATION-ORGANIZATION-ORGANIZATION-ORGANIZATION,COUNTRY,PROPN-PROPN-CCONJ-PROPN,PROPN,compound-appos-cc-conj,compound,NNP-NNP-CC-NNPS,NNP,18,1
10039,41281.0,42,said,21,19,1,-18,18,40,2,-20,NSC,Patrick Ekeji,ORGANIZATION,PERSON-PERSON,PROPN,PROPN-PROPN,compound,compound-nsubj,NNP,NNP-NNP,1,1
10040,64617.0,22,said,8,6,7,1,5,14,2,-1,NSC,Patrick Ekeji,ORGANIZATION,PERSON-PERSON,PROPN,PROPN-PROPN,compound,compound-pobj,NNP,NNP-NNP,1,1
10041,41288.0,51,said,20,18,9,-9,17,41,2,-11,Raul Castro,Mariela Castro Espin,PERSON-PERSON,PERSON-PERSON-PERSON,PROPN-PROPN,PROPN-PROPN-PROPN,compound-pobj,compound-compound-nsubj,NNP-NNP,NNP-NNP-NNP,4,1
10042,41300.0,47,urged,2,21,17,-4,20,29,-19,15,Organization of the Islamic Conference,57,ORGANIZATION-ORGANIZATION-ORGANIZATION-ORGANIZATION-ORGANIZATION,NUMBER,PROPN-ADP-DET-PROPN-PROPN,NUM,pobj-prep-det-compound-pobj,nummod,NNP-IN-DT-NNP-NNP,CD,3,1
10043,41306.0,35,said,23,32,26,-6,31,8,-9,3,American Psychiatric Association,Carolyn Robinowitz,ORGANIZATION-ORGANIZATION-ORGANIZATION,PERSON-PERSON,PROPN-PROPN-PROPN,PROPN-PROPN,compound-compound-pobj,compound-nsubj,NNP-NNP-NNP,NNP-NNP,3,1
10044,62642.0,40,said,11,8,2,-6,7,37,3,-9,American Psychiatric Association,Carolyn Robinowitz,ORGANIZATION-ORGANIZATION-ORGANIZATION,PERSON-PERSON,PROPN-PROPN-PROPN,PROPN-PROPN,compound-compound-pobj,compound-nsubj,NNP-NNP-NNP,NNP-NNP,4,1
10045,41310.0,54,is,8,1,7,6,0,46,7,-1,CNR,Quebec,ORGANIZATION,STATE_OR_PROVINCE,PROPN,PROPN,nsubj,appos,NNP,NNP,3,1
10046,41338.0,21,native,7,13,12,-1,12,8,-6,5,Paul Watson,conservationist,PERSON-PERSON,TITLE,PROPN-PROPN,NOUN,compound-pobj,compound,NNP-NNP,NN,1,1
10047,41339.0,63,asked,7,19,14,-5,18,48,-12,7,Jackson Hewitt Tax Service,Merry Brodie,ORGANIZATION-ORGANIZATION-ORGANIZATION-ORGANIZATION,PERSON-PERSON,PROPN-PROPN-PROPN-PROPN,PROPN-PROPN,compound-compound-compound-compound,compound-appos,NNP-NNP-NNP-NNP,NNP-NNP,4,1
10048,41342.0,37,'s,1,8,7,-1,7,29,-7,6,Michael Johns,crooner,PERSON-PERSON,TITLE,PROPN-PROPN,NOUN,compound-nsubj,compound,NNP-NNP,NN,1,1
10049,41368.0,38,is,2,17,5,-12,16,32,-15,3,he,Muslim,PERSON,RELIGION,PRON,PROPN,nsubj,attr,PRP,NNP,2,1
10050,66168.0,32,said,30,3,13,10,2,18,27,-17,he,Muslim,PERSON,RELIGION,PRON,PROPN,nsubjpass,attr,PRP,NNP,3,1
10051,41372.0,36,reported,2,9,1,-8,8,34,-7,-1,One Mortgage,H&R Block,ORGANIZATION-ORGANIZATION,ORGANIZATION-ORGANIZATION,PROPN-PROPN,PROPN-PROPN,compound-compound,compound-nsubj,NNP-NNP,NNP-NNP,5,1
10052,41373.0,44,was,3,11,8,-3,10,35,-8,5,Ospel,chief executive,PERSON,TITLE-TITLE,PROPN,ADJ-NOUN,appos,amod-conj,NNP,JJ-NN,3,1
10053,48679.0,45,was,3,11,8,-3,10,36,-8,5,Ospel,chief executive,PERSON,TITLE-TITLE,PROPN,ADJ-NOUN,appos,amod-conj,NNP,JJ-NN,3,1
10054,41400.0,13,did,2,1,10,9,0,2,1,8,She,Arizona State University,PERSON,ORGANIZATION-ORGANIZATION-ORGANIZATION,PRON,PROPN-PROPN-PROPN,nsubj,compound-compound-pobj,PRP,NNP-NNP-NNP,6,1
10055,41403.0,31,graduated,19,19,3,-16,18,27,0,-16,she,Allentown,PERSON,CITY,PRON,PROPN,nsubj,pobj,PRP,NNP,4,1
10056,41411.0,29,MORGANTOWN,0,11,10,-1,10,18,-11,10,Independent Steelworkers Union,"1,250-member",ORGANIZATION-ORGANIZATION-ORGANIZATION,NUMBER,PROPN-PROPN-PROPN,NUM,compound-compound-nsubj,nummod,NNP-NNPS-NNP,CD,2,1
10057,56718.0,23,said,5,3,2,-1,2,20,2,-3,Independent Steelworkers Union,"1,250-member",ORGANIZATION-ORGANIZATION-ORGANIZATION,NUMBER,PROPN-PROPN-PROPN,NUM,compound-compound-nsubj,nummod,NNP-NNPS-NNP,CD,1,1
10058,41418.0,19,move,4,4,17,13,3,1,0,13,you,New Yorker,PERSON,STATE_OR_PROVINCE-STATE_OR_PROVINCE,PRON,PROPN-PROPN,nsubj,compound-attr,PRP,NNP-NNP,2,1
10059,41419.0,22,attended,6,6,9,3,5,12,0,3,he,University of Southern California,PERSON,ORGANIZATION-ORGANIZATION-ORGANIZATION-ORGANIZATION,PRON,PROPN-ADP-PROPN-PROPN,nsubj,dobj-prep-compound-pobj,PRP,NNP-IN-NNP-NNP,2,1
10060,49876.0,25,attended,9,9,12,3,8,12,0,3,he,University of Southern California,PERSON,ORGANIZATION-ORGANIZATION-ORGANIZATION-ORGANIZATION,PRON,PROPN-ADP-PROPN-PROPN,nsubj,dobj-prep-compound-pobj,PRP,NNP-IN-NNP-NNP,2,1
10061,41424.0,36,said,17,5,2,-3,4,33,12,-15,Northwood University,Jeff Bennett,ORGANIZATION-ORGANIZATION,PERSON-PERSON,PROPN-PROPN,PROPN-PROPN,compound-pobj,compound-nsubj,NNP-NNP,NNP-NNP,2,1
10062,41434.0,14,upgraded,4,3,8,5,2,5,1,4,DirecTv,Tivo,ORGANIZATION,ORGANIZATION,PROPN,PROPN,nsubj,compound,NNP,NNP,3,1
10063,41436.0,37,succeeds,16,18,13,-5,17,23,-2,-3,Pascal Yoadimnadji,RNDP,PERSON-PERSON,ORGANIZATION,PROPN-PROPN,PROPN,compound-dobj,compound,NNP-NNPS,NNP,4,1
10064,41440.0,47,PILOTS,0,36,38,2,35,8,-36,38,FAA,Robert A. Sturgell,ORGANIZATION,PERSON-PERSON-PERSON,PROPN,PROPN-NOUN-PROPN,compound,compound-compound-dobj,NNP,NNP-NN-NNP,2,1
10065,41447.0,30,signed,7,26,18,-8,25,11,-19,11,ADB,C Lawrence Greenwood,ORGANIZATION,PERSON-PERSON-PERSON,PROPN,PROPN-PROPN-PROPN,pobj,compound-compound-conj,NNP,NNP-NNP-NNP,5,1
10066,41458.0,31,met,2,27,25,-2,26,5,-25,23,M. Enkhbold,Prime Minister,PERSON-PERSON,TITLE-TITLE,PROPN-PROPN,PROPN-PROPN,compound-conj,compound-compound,NNP-NNP,NNP-NNP,1,1
10067,52558.0,26,decided,4,3,1,-2,2,24,1,-3,M. Enkhbold,Prime Minister,PERSON-PERSON,TITLE-TITLE,PROPN-PROPN,PROPN-PROPN,compound-nsubj,compound-compound,NNP-NNP,NNP-NNP,1,1
10068,59205.0,29,said,5,4,2,-2,3,26,1,-3,M. Enkhbold,Prime Minister,PERSON-PERSON,TITLE-TITLE,PROPN-PROPN,PROPN-PROPN,compound-nsubj,compound-compound,NNP-NNP,NNP-NNP,1,1
10069,59742.0,20,met,2,9,7,-2,8,12,-7,5,M. Enkhbold,Prime Minister,PERSON-PERSON,TITLE-TITLE,PROPN-PROPN,PROPN-PROPN,compound-pobj,compound-compound,NNP-NNP,NNP-NNP,1,1
10070,60924.0,27,met,5,4,2,-2,3,24,1,-3,M. Enkhbold,Prime Minister,PERSON-PERSON,TITLE-TITLE,PROPN-PROPN,PROPN-PROPN,compound-nsubj,compound-compound,NNP-NNP,NNP-NNP,1,1
10071,63702.0,20,accepted,9,16,14,-2,15,5,-7,5,M. Enkhbold,Prime Minister,PERSON-PERSON,TITLE-TITLE,PROPN-PROPN,PROPN-PROPN,compound-pobj,compound-compound,NNP-NNP,NNP-NNP,1,1
10072,41459.0,57,Buse,1,1,27,26,0,29,0,26,Mark Buse,Goldman Sachs,PERSON-PERSON,ORGANIZATION-ORGANIZATION,PROPN-PROPN,PROPN-PROPN,compound-ROOT,compound-conj,NNP-NNP,NNP-NNP,3,1
10073,41472.0,38,remain,23,9,17,8,8,20,14,-6,New South Wales Waratahs,Ewan McKenzie,ORGANIZATION-ORGANIZATION-ORGANIZATION-ORGANIZATION,PERSON-PERSON,PROPN-PROPN-PROPN-PROPN,PROPN-PROPN,compound-compound-compound-compound,compound-appos,NNP-NNP-NNP-NNP,NNP-NNP,4,1
10074,41483.0,41,broken,11,19,33,14,18,7,-8,22,Hussein Kamel,1996,PERSON-PERSON,DATE,PROPN-PROPN,NUM,compound-compound,pobj,NNP-NNP,CD,3,1
10075,41489.0,18,noted,3,9,5,-4,8,12,-6,2,KGB,Putin,ORGANIZATION,PERSON,PROPN,PROPN,compound,nsubjpass,NNP,NNP,2,1
10076,41492.0,19,said,4,1,6,5,0,12,3,2,UNC,his,ORGANIZATION,PERSON,PROPN,DET,compound,poss,NNP,PRP$,4,1
10077,41508.0,7,Bentley,1,1,7,6,0,-1,0,6,Christopher Bentley,US,PERSON-PERSON,ORGANIZATION,PROPN-PROPN,PROPN,compound-ROOT,pobj,NNP-NNP,NNP,-1,1
10078,41529.0,37,believe,5,18,8,-10,17,28,-13,3,his,71-year-old,PERSON,DURATION,DET,PROPN,poss,amod,PRP$,NNP,7,1
10079,41534.0,38,Dec,2,10,34,24,9,3,-8,32,China National Aviation Corporation,"January 1 , 2003",ORGANIZATION-ORGANIZATION-ORGANIZATION-ORGANIZATION,DATE-DATE-DATE-DATE,PROPN-PROPN-PROPN-PROPN,PROPN-NUM-PUNCT-NUM,compound-compound-compound-conj,pobj-nummod-punct-nummod,NNP-NNP-NNP-NNP,"NNP-CD-,-CD",-1,1
10080,41552.0,29,met,5,24,17,-7,23,11,-19,12,Arsenal,Red and White Holdings,ORGANIZATION,PERSON-PERSON-PERSON-PERSON,ADJ,PROPN-CCONJ-PROPN-PROPN,compound,nmod-cc-conj-pobj,JJ,NNP-CC-NNP-NNPS,4,1
10081,41557.0,27,came,3,6,8,2,5,18,-3,5,Arsenal,Peter Hill-Wood,ORGANIZATION,PERSON-PERSON,PROPN,PROPN-PROPN,compound,compound-nsubj,NNP,NNP-NNP,2,1
10082,48028.0,21,told,7,4,6,2,3,14,3,-1,Arsenal,Peter Hill-Wood,ORGANIZATION,PERSON-PERSON,PROPN,PROPN-PROPN,compound,compound-nsubj,NNP,NNP-NNP,2,1
10083,41580.0,29,survived,2,1,7,6,0,21,1,5,She,David,PERSON,PERSON,PRON,PROPN,nsubjpass,appos,PRP,NNP,4,1
10084,41582.0,30,published,1,16,19,3,15,10,-15,18,he,director,PERSON,TITLE,PRON,NOUN,nsubjpass,oprd,PRP,NN,3,1
10085,41595.0,31,is,10,1,6,5,0,24,9,-4,Zubaydah,Zain al-Abidin Muhahhad Hussain,PERSON,PERSON-PERSON-PERSON-PERSON,PROPN,PROPN-ADP-PROPN-PROPN,nsubj,compound-compound-compound-pobj,NNP,NNP-IN-NNP-NNP,5,1
10086,41605.0,32,building,10,7,1,-6,6,30,3,-9,Carnival Corp.,Cunard Line,ORGANIZATION-ORGANIZATION,ORGANIZATION-ORGANIZATION,PROPN-PROPN,PROPN-PROPN,compound-pobj,compound-nsubj,NNP-NNP,NNP-NNP,3,1
10087,44201.0,42,said,36,12,8,-4,11,33,24,-28,Carnival Corp.,Cunard Line,ORGANIZATION-ORGANIZATION,ORGANIZATION-ORGANIZATION,PROPN-PROPN,PROPN-PROPN,compound-pobj,compound-compound,NNP-NNP,NNP-NNP,3,1
10088,41611.0,29,said,17,6,13,7,5,15,11,-4,Professional Rodeo Cowboys Association,Colorado,ORGANIZATION-ORGANIZATION-ORGANIZATION-ORGANIZATION,STATE_OR_PROVINCE,PROPN-PROPN-PROPN-PROPN,PROPN,compound-compound-compound-pobj,appos,NNP-NNP-NNPS-NNP,NNP,6,1
10089,41614.0,25,released,3,2,20,18,1,4,1,17,Erika Rose,Infinity Le Monde Recorded Music,PERSON-PERSON,ORGANIZATION-ORGANIZATION-ORGANIZATION-ORGANIZATION-ORGANIZATION,PROPN-PROPN,PROPN-PROPN-PROPN-PROPN-PROPN,compound-nsubj,compound-compound-compound-compound-pobj,NNP-NNP,NNP-NNP-NNP-NNP-NNP,6,1
10090,41620.0,31,said,19,21,27,6,20,3,-2,8,Dillinger,Pinellas,PERSON,LOCATION,PROPN,PROPN,nsubj,nmod,NNP,NNP,3,1
10091,41626.0,32,dismissed,2,22,30,8,21,1,-20,28,Ali-Akbar Salehi,vice president,PERSON-PERSON,TITLE-TITLE,PROPN-PROPN,NOUN-NOUN,compound-pobj,compound-attr,NNP-NNP,NN-NN,8,1
10092,41634.0,44,said,17,7,1,-6,6,42,10,-16,International Monetary Fund,Mohsin Khan,ORGANIZATION-ORGANIZATION-ORGANIZATION,PERSON-PERSON,PROPN-PROPN-PROPN,PROPN-PROPN,compound-compound-poss,compound-nsubj,NNP-NNP-NNP,NNP-NNP,5,1
10093,41635.0,19,married,5,8,18,10,7,0,-3,13,Forsberg,Stockholm,PERSON,STATE_OR_PROVINCE,PROPN,PROPN,dobj,pobj,NNP,NNP,3,1
10094,41637.0,18,made,4,1,3,2,0,14,3,-1,Chavez,51,PERSON,NUMBER,PROPN,NUM,nsubj,appos,NNP,CD,3,1
10095,41650.0,21,said,4,1,3,2,0,17,3,-1,Carnival,Joyce Oliva,ORGANIZATION,PERSON-PERSON,NOUN,PROPN-PROPN,compound,compound-nsubj,NN,NNP-NNP,1,1
10096,41657.0,52,said,2,4,2,-2,3,49,-2,0,Remy Ma,prosecutor,PERSON-PERSON,TITLE,PROPN-PROPN,NOUN,compound-nsubj,nsubj,NNP-NNP,NN,2,1
10097,41668.0,8,is,1,1,5,4,0,2,0,4,She,actress,PERSON,TITLE,PRON,NOUN,nsubj,attr,PRP,NN,2,1
10098,41680.0,43,said,12,1,26,25,0,16,11,14,Paul Watson,Wilfred Grenfell,PERSON-PERSON,PERSON-PERSON,PROPN-PROPN,PROPN-PROPN,compound-nsubj,compound-conj,NNP-NNP,NNP-NNP,7,1
10099,41682.0,34,said,9,18,27,9,17,6,-9,18,National Center for Disaster Preparedness,Columbia 's Mailman School of Public Health,ORGANIZATION-ORGANIZATION-ORGANIZATION-ORGANIZATION-ORGANIZATION,ORGANIZATION-ORGANIZATION-ORGANIZATION-ORGANIZATION-ORGANIZATION-ORGANIZATION-ORGANIZATION,PROPN-PROPN-ADP-PROPN-PROPN,PROPN-PART-PROPN-PROPN-ADP-PROPN-PROPN,compound-pobj-prep-compound-pobj,poss-case-compound-pobj-prep-compound-pobj,NNP-NNP-IN-NNP-NNP,NNP-POS-NNP-NNP-IN-NNP-NNP,8,1
10100,52849.0,34,said,9,18,27,9,17,6,-9,18,National Center for Disaster Preparedness,Columbia 's Mailman School of Public Health,ORGANIZATION-ORGANIZATION-ORGANIZATION-ORGANIZATION-ORGANIZATION,ORGANIZATION-ORGANIZATION-ORGANIZATION-ORGANIZATION-ORGANIZATION-ORGANIZATION-ORGANIZATION,PROPN-PROPN-ADP-PROPN-PROPN,PROPN-PART-PROPN-PROPN-ADP-PROPN-PROPN,compound-pobj-prep-compound-pobj,poss-case-compound-pobj-prep-compound-pobj,NNP-NNP-IN-NNP-NNP,NNP-POS-NNP-NNP-IN-NNP-NNP,8,1
10101,41701.0,25,Birthday,1,13,10,-3,12,14,-12,9,Johnny Knoxville,26,PERSON-PERSON,NUMBER,PROPN-PROPN,NUM,compound-appos,dobj,NNP-NNP,CD,3,1
10102,41707.0,42,deliberated,1,13,24,11,12,17,-12,23,Michael Sandy,chased into the path of a moving car,PERSON-PERSON,CAUSE_OF_DEATH-CAUSE_OF_DEATH-CAUSE_OF_DEATH-CAUSE_OF_DEATH-CAUSE_OF_DEATH-CAUSE_OF_DEATH-CAUSE_OF_DEATH-CAUSE_OF_DEATH,PROPN-PROPN,VERB-ADP-DET-NOUN-ADP-DET-VERB-NOUN,compound-pobj,conj-prep-det-pobj-prep-det-amod-pobj,NNP-NNP,VBD-IN-DT-NN-IN-DT-VBG-NN,8,1
10103,41709.0,24,became,14,14,21,7,13,2,0,7,he,National Aphasia Association,PERSON,ORGANIZATION-ORGANIZATION-ORGANIZATION,PRON,PROPN-PROPN-PROPN,nsubj,compound-compound-pobj,PRP,NNP-NNP-NNP,4,1
10104,41713.0,30,FAMILY,0,8,15,7,7,14,-8,15,Larijani,Ayatollah Morteza Motahari,PERSON,PERSON-PERSON-PERSON,PROPN,PROPN-PROPN-PROPN,nsubj,compound-compound-pobj,NNP,NNP-NNP-NNP,4,1
10105,41720.0,37,began,9,26,13,-13,25,23,-17,4,he,Franklin,PERSON,ORGANIZATION,PRON,PROPN,nsubj,pobj,PRP,NNP,8,1
10106,41722.0,12,says,11,3,1,-2,2,10,8,-10,Beverly Sills,Opera star,PERSON-PERSON,TITLE-TITLE,PROPN-PROPN,NOUN-NOUN,compound-nsubj,compound-compound,NNP-NNP,NN-NN,1,1
10107,41731.0,12,announced,3,1,9,8,0,2,2,6,Her,Yorke B Mizelle,PERSON,PERSON-PERSON-PERSON,DET,PROPN-PROPN-PROPN,poss,compound-compound-appos,PRP$,NNP-NNP-NNP,5,1
10108,41740.0,58,Dec,2,9,9,0,8,48,-7,7,Myanmar Timber Enterprise,Myanmar,ORGANIZATION-ORGANIZATION-ORGANIZATION,COUNTRY,PROPN-PROPN-PROPN,PROPN,compound-compound-pobj,nsubj,NNP-NNP-NNP,NNP,0,1
10109,41742.0,32,told,3,21,7,-14,20,24,-18,4,North Phoenix Baptist Church,South Carolina,ORGANIZATION-ORGANIZATION-ORGANIZATION-ORGANIZATION,STATE_OR_PROVINCE-STATE_OR_PROVINCE,PROPN-PROPN-PROPN-PROPN,PROPN-PROPN,compound-compound-compound-pobj,compound-pobj,NNP-NNP-NNP-NNP,NNP-NNP,7,1
10110,41747.0,15,said,12,10,4,-6,9,10,2,-8,Richmond Flowers Jr.,Parkinson 's disease,PERSON-PERSON-PERSON,CAUSE_OF_DEATH-CAUSE_OF_DEATH-CAUSE_OF_DEATH,PROPN-PROPN-PROPN,PROPN-PART-NOUN,compound-compound-appos,poss-case-attr,NNP-NNP-NNP,NNP-POS-NN,7,1
10111,41748.0,30,prohibits,3,2,5,3,1,24,1,2,FAA,PAL,ORGANIZATION,ORGANIZATION,PROPN,PROPN,compound,dobj,NNP,NNP,2,1
10112,41750.0,10,became,2,1,4,3,0,5,1,2,Nolte,chairman,PERSON,TITLE,PROPN,NOUN,nsubj,attr,NNP,NN,3,1
10113,41754.0,33,read,7,3,21,18,2,11,4,14,Gholam Ali Haddad-Adel,lawmaker,PERSON-PERSON-PERSON,TITLE,PROPN-PROPN-PROPN,NOUN,compound-compound-nsubj,nsubj,NNP-NNP-NNP,NN,7,1
10114,41771.0,43,accused,21,2,8,6,1,34,19,-13,CNAC,China National Aviation Holding Company,ORGANIZATION,ORGANIZATION-ORGANIZATION-ORGANIZATION-ORGANIZATION-ORGANIZATION,PROPN,PROPN-PROPN-PROPN-PROPN-PROPN,nsubj,compound-compound-compound-compound-pobj,NNP,NNP-NNP-NNP-NNP-NNP,3,1
10115,41772.0,39,said,6,15,3,-12,14,35,-9,-3,him,E.O. Green Junior High,PERSON,ORGANIZATION-ORGANIZATION-ORGANIZATION-ORGANIZATION,PRON,PROPN-PROPN-PROPN-PROPN,dobj,compound-compound-compound-pobj,PRP,NNP-NNP-NNP-NNP,7,1
10116,41807.0,49,said,13,17,2,-15,16,46,-4,-11,he,Christopher J Dodd,PERSON,PERSON-PERSON-PERSON,PRON,PROPN-PROPN-PROPN,nsubj,compound-compound-nsubj,PRP,NNP-NNP-NNP,4,1
10117,41811.0,42,said,36,13,40,27,12,1,23,4,Arsenal Football Club,Peter Hill-Wood,ORGANIZATION-ORGANIZATION-ORGANIZATION,PERSON-PERSON,PROPN-PROPN-PROPN,PROPN-PROPN,compound-compound-pobj,compound-nsubj,NNP-NNP-NNP,NNP-NNP,8,1
10118,41873.0,33,said,27,4,31,27,3,1,23,4,Arsenal Football Club,Peter Hill-Wood,ORGANIZATION-ORGANIZATION-ORGANIZATION,PERSON-PERSON,PROPN-PROPN-PROPN,PROPN-PROPN,compound-compound-pobj,compound-nsubj,NNP-NNP-NNP,NNP-NNP,7,1
10119,44676.0,37,LONDON,0,8,34,26,7,2,-8,34,Arsenal Football Club,Peter Hill-Wood,ORGANIZATION-ORGANIZATION-ORGANIZATION,PERSON-PERSON,PROPN-PROPN-PROPN,PROPN-PROPN,compound-compound-pobj,compound-nsubj,NNP-NNP-NNP,NNP-NNP,3,1
10120,41816.0,18,summoned,3,5,14,9,4,3,-2,11,Kollek,prime minister,PERSON,TITLE-TITLE,PROPN,ADJ-NOUN,dobj,amod-poss,NNP,JJ-NN,6,1
10121,41820.0,44,introduced,15,9,8,-1,8,35,6,-7,Carolyn B. Maloney,Representative,PERSON-PERSON-PERSON,TITLE,PROPN-PROPN-PROPN,PROPN,compound-compound-nsubj,compound,NNP-NNP-NNP,NNP,2,1
10122,41838.0,80,email,2,60,30,-30,59,49,-58,28,Richard Perle,Republican Party,PERSON-PERSON,ORGANIZATION-ORGANIZATION,PROPN-PROPN,PROPN-PROPN,compound-pobj,compound-nsubjpass,NNP-NNP,NNP-NNP,7,1
10123,41855.0,62,is,6,57,34,-23,56,27,-51,28,Chante Moore,NeYo,PERSON-PERSON,PERSON,PROPN-PROPN,PROPN,compound-ROOT,compound,NNP-NNP,NNP,-1,1
10124,41872.0,23,'s,1,6,13,7,5,9,-5,12,Abu Zubaydah,Saudi Arabia,PERSON-PERSON,COUNTRY-COUNTRY,PROPN-PROPN,PROPN-PROPN,compound-poss,compound-conj,NNP-NNP,NNP-NNP,4,1
10125,41900.0,35,was,11,32,9,-23,31,25,-21,-2,Samsung,Lee Byung-chul,ORGANIZATION,PERSON-PERSON,PROPN,PROPN-PROPN,poss,compound-npadvmod,NNP,NNP-NNP,5,1
10126,41905.0,47,face,4,16,43,27,15,3,-12,39,Arsenal,him,ORGANIZATION,PERSON,PROPN,PRON,amod,dobj,NNP,PRP,-1,1
10127,41909.0,27,say,25,21,4,-17,20,22,4,-21,her,Brandon,PERSON,PERSON,PRON,PROPN,poss,pobj,PRP,NNP,4,1
10128,41910.0,28,been,24,7,17,10,6,10,17,-7,Fidelity Investments,Ohio Public Employees Retirement System,ORGANIZATION-ORGANIZATION,ORGANIZATION-ORGANIZATION-ORGANIZATION-ORGANIZATION-ORGANIZATION,PROPN-PROPN,PROPN-PROPN-PROPN-PROPN-PROPN,compound-nsubj,compound-compound-compound-compound-conj,NNP-NNPS,NNP-NNP-NNPS-NNP-NNP,4,1
10129,41932.0,49,received,6,6,8,2,5,40,0,2,DeBlanc,his,PERSON,PERSON,PROPN,DET,nsubj,poss,NNP,PRP$,3,1
10130,41947.0,33,loss-making,3,1,19,18,0,13,2,16,Alcatel-Lucent,Alcatel SA,ORGANIZATION,ORGANIZATION-ORGANIZATION,ADJ,PROPN-PROPN,nsubj,compound-poss,JJ,NNP-NNP,8,1
10131,41958.0,21,was,1,1,8,7,0,12,0,7,He,International Indian Treaty Council,PERSON,ORGANIZATION-ORGANIZATION-ORGANIZATION-ORGANIZATION,PRON,PROPN-PROPN-PROPN-PROPN,nsubj,compound-compound-compound-pobj,PRP,NNP-NNP-NNP-NNP,4,1
10132,41976.0,24,2008-03-31T11,0,3,11,8,2,12,-3,11,Richard Perle,advisors,PERSON-PERSON,TITLE,PROPN-PROPN,NOUN,compound-ROOT,pobj,NNP-NNP,NNS,7,1
10133,41979.0,27,taught,8,2,24,22,1,2,6,16,his,South Central Bell,PERSON,ORGANIZATION-ORGANIZATION-ORGANIZATION,DET,PROPN-PROPN-PROPN,poss,compound-compound-pobj,PRP$,NNP-NNP-NNP,4,1
10134,41989.0,36,provide,20,18,7,-11,17,28,2,-13,Alcatel-Lucent,Alcatel Shanghai Bell,ORGANIZATION,ORGANIZATION-ORGANIZATION-ORGANIZATION,NOUN,PROPN-PROPN-PROPN,pobj,compound-compound-conj,NN,NNP-NNP-NNP,6,1
10135,41996.0,36,include,2,33,32,-1,32,3,-31,30,Donald E. Wildmon,Rev.,PERSON-PERSON-PERSON,TITLE,PROPN-PROPN-PROPN,PROPN,compound-compound-pobj,compound,NNP-NNP-NNP,NNP,2,1
10136,53140.0,28,scored,4,18,17,-1,17,10,-14,13,Donald E. Wildmon,Rev.,PERSON-PERSON-PERSON,TITLE,PROPN-PROPN-PROPN,PROPN,compound-compound-appos,compound,NNP-NNP-NNP,NNP,2,1
10137,42017.0,44,showed,16,2,1,-1,1,42,14,-15,Hong Kong Disneyland,http://wwwhongkongdisneylandcom,ORGANIZATION-ORGANIZATION-ORGANIZATION,URL,PROPN-PROPN-PROPN,X,compound-compound-poss,compound,NNP-NNP-NNP,ADD,1,1
10138,42024.0,43,Hooper,3,3,3,0,2,39,0,0,Jeremy,Jeremy Hooper,PERSON,PERSON-PERSON,PROPN,PROPN-PROPN,poss,compound-ROOT,NNP,NNP-NNP,0,1
10139,42033.0,51,seemed,12,37,10,-27,36,40,-25,-2,his,Associated Press,PERSON,ORGANIZATION-ORGANIZATION,DET,PROPN-PROPN,poss,compound-pobj,PRP$,NNP-NNP,12,1
10140,42038.0,15,was,6,6,13,7,5,1,0,7,he,United Nations,PERSON,ORGANIZATION-ORGANIZATION,PRON,PROPN-PROPN,nsubj,compound-pobj,PRP,NNP-NNP,3,1
10141,42059.0,40,hope,1,10,17,7,9,22,-9,16,Convocation of Anglicans in North America,CANA,ORGANIZATION-ORGANIZATION-ORGANIZATION-ORGANIZATION-ORGANIZATION-ORGANIZATION,ORGANIZATION,PROPN-ADP-PROPN-ADP-PROPN-PROPN,PROPN,appos-prep-pobj-prep-compound-pobj,compound,NNP-IN-NNPS-IN-NNP-NNP,NNP,3,1
10142,55117.0,21,followed,4,12,20,8,11,0,-8,16,Convocation of Anglicans in North America,CANA,ORGANIZATION-ORGANIZATION-ORGANIZATION-ORGANIZATION-ORGANIZATION-ORGANIZATION,ORGANIZATION,PROPN-ADP-PROPN-ADP-PROPN-PROPN,PROPN,dobj-prep-pobj-prep-compound-pobj,conj,NNP-IN-NNPS-IN-NNP-NNP,NNP,4,1
10143,42061.0,37,shows,1,16,24,8,15,12,-15,23,Gillmor,Virginia,PERSON,STATE_OR_PROVINCE,PROPN,PROPN,poss,pobj,NNP,NNP,5,1
10144,42066.0,31,set,4,9,28,19,8,2,-5,24,her,Infinity Le Monde,PERSON,ORGANIZATION-ORGANIZATION-ORGANIZATION,DET,PROPN-PROPN-PROPN,poss,compound-compound-pobj,PRP$,NNP-NNP-NNP,5,1
10145,42068.0,49,said,47,12,16,4,11,32,35,-31,he,assault,PERSON,CRIMINAL_CHARGE,PRON,NOUN,nsubjpass,pobj,PRP,NN,2,1
10146,42078.0,33,confirm,4,10,20,10,9,12,-6,16,her,Sills,PERSON,PERSON,DET,PROPN,poss,nsubj,PRP$,NNP,6,1
10147,42081.0,14,have,5,12,4,-8,11,9,-7,-1,Awami League,she,ORGANIZATION-ORGANIZATION,PERSON,PROPN-PROPN,PRON,compound-pobj,nsubj,NNP-NNP,PRP,5,1
10148,42092.0,38,said,23,25,33,8,24,4,-2,10,Ali Larijani,Supreme Council for National Security,PERSON-PERSON,ORGANIZATION-ORGANIZATION-ORGANIZATION-ORGANIZATION-ORGANIZATION,PROPN-PROPN,PROPN-PROPN-ADP-PROPN-PROPN,compound-nsubj,compound-pobj-prep-compound-pobj,NNP-NNP,NNP-NNP-IN-NNP-NNP,4,1
10149,42103.0,73,McNair,1,1,56,55,0,16,0,55,Robert McNair,Claudia Crawford McNair,PERSON-PERSON,PERSON-PERSON-PERSON,PROPN-PROPN,PROPN-PROPN-PROPN,compound-ROOT,compound-compound-conj,NNP-NNP,NNP-NNP-NNP,-1,1
10150,42104.0,7,graduated,2,2,5,3,1,1,0,3,Burns,Boston College,PERSON,ORGANIZATION-ORGANIZATION,PROPN,PROPN-PROPN,nsubj,compound-pobj,NNP,NNP-NNP,2,1
10151,42111.0,43,said,39,7,15,8,6,27,32,-24,MNLF,Philippine Autonomous Region of Muslim Mindanao,ORGANIZATION,ORGANIZATION-ORGANIZATION-ORGANIZATION-ORGANIZATION-ORGANIZATION-ORGANIZATION,PROPN,PROPN-PROPN-PROPN-ADP-PROPN-PROPN,compound,compound-compound-pobj-prep-compound-pobj,NNP,NNP-NNP-NNP-IN-NNP-NNP,5,1
10152,42114.0,37,said,6,1,3,2,0,33,5,-3,AL,Abul Mal Abdul Muhit,ORGANIZATION,PERSON-PERSON-PERSON-PERSON,PROPN,PROPN-PROPN-PROPN-PROPN,compound,compound-compound-compound-nsubj,NNP,NNP-NNP-NNP-NNP,1,1
10153,42116.0,43,is,16,28,2,-26,27,40,-12,-14,CNAHC,Hong,ORGANIZATION,COUNTRY,PROPN,PROPN,compound,compound,NNP,NNP,7,1
10154,42123.0,18,respond,10,3,1,-2,2,16,7,-9,his,Simcox,PERSON,PERSON,DET,PROPN,poss,nsubj,PRP$,NNP,2,1
10155,42128.0,5,SUPERBIKES,1,1,5,4,0,-1,0,4,AMA,AMERICA,ORGANIZATION,COUNTRY,PROPN,PROPN,compound,appos,NNP,NNP,-1,1
10156,42134.0,21,survived,3,18,1,-17,17,19,-15,-2,Mahdi,Bourguiba Jr.,PERSON,PERSON-PERSON,PROPN,PROPN-PROPN,conj,compound-nsubjpass,NNP,NNP-NNP,8,1
10157,42141.0,29,said,3,5,12,7,4,16,-2,9,Royal Caribbean,Miami,ORGANIZATION-ORGANIZATION,CITY,PROPN-PROPN,PROPN,compound-nsubj,pobj,NNP-NNP,NNP,2,1
10158,42144.0,29,achieved,14,9,1,-8,8,27,5,-13,Focus on the Family,Daly,ORGANIZATION-ORGANIZATION-ORGANIZATION-ORGANIZATION,PERSON,PROPN-ADP-DET-PROPN,PROPN,pobj-prep-det-pobj,nsubj,NNP-IN-DT-NNP,NNP,5,1
10159,42173.0,24,was,1,1,15,14,0,8,0,14,Farland,Center for Strategic and International Studies,PERSON,ORGANIZATION-ORGANIZATION-ORGANIZATION-ORGANIZATION-ORGANIZATION-ORGANIZATION,PROPN,PROPN-ADP-PROPN-CCONJ-PROPN-PROPN,nsubj,pobj-prep-nmod-cc-conj-pobj,NNP,NNP-IN-NNP-CC-NNP-NNPS,5,1
10160,42181.0,21,acknowledged,1,1,6,5,0,14,0,5,Waldheim,translator,PERSON,TITLE,PROPN,NOUN,nsubj,pobj,NNP,NN,4,1
10161,42197.0,26,had,16,10,21,11,9,4,6,5,his,Lurleen,ORGANIZATION,PERSON,DET,PROPN,poss,appos,PRP$,NNP,5,1
10162,42207.0,24,said,4,1,18,17,0,5,3,14,Carson,American,PERSON,NATIONALITY,PROPN,ADJ,nsubj,amod,NNP,JJ,7,1
10163,42217.0,62,about,1,60,40,-20,59,21,-59,39,Americans,Washington -LRB- Capitols -RRB-,ORGANIZATION,ORGANIZATION-ORGANIZATION-ORGANIZATION-ORGANIZATION,PROPN,PROPN-PROPN-PROPN-PROPN,compound,appos-compound-compound-ROOT,NNPS,NNP-NNP-NNP-NNP,-1,1
10164,42224.0,48,wrote,5,14,21,7,13,26,-9,16,Michael Sandy,struck by a car,PERSON-PERSON,CAUSE_OF_DEATH-CAUSE_OF_DEATH-CAUSE_OF_DEATH-CAUSE_OF_DEATH,PROPN-PROPN,VERB-ADP-DET-NOUN,compound-pobj,pcomp-agent-det-pobj,NNP-NNP,VBN-IN-DT-NN,4,1
10165,42228.0,46,Ltd.,8,6,6,0,5,39,2,-2,Royal Caribbean Cruises Ltd.,Royal Caribbean,ORGANIZATION-ORGANIZATION-ORGANIZATION-ORGANIZATION,ORGANIZATION-ORGANIZATION,ADJ-PROPN-PROPN-PROPN,PROPN-PROPN,compound-compound-compound-ROOT,compound-pobj,JJ-NNP-NNPS-NNP,NNP-NNP,0,1
10166,42243.0,45,said,32,43,40,-3,42,4,-11,8,Haifa University,Asian Studies,ORGANIZATION-ORGANIZATION,ORGANIZATION-ORGANIZATION,PROPN-PROPN,PROPN-PROPN,compound-pobj,compound-pobj,NNP-NNP,NNP-NNPS,6,1
10167,42259.0,39,says,4,7,13,6,6,25,-3,9,Lashkar-e-Taiba,Markaz ud-Daoua Wal-Irshad,ORGANIZATION,ORGANIZATION-ORGANIZATION-ORGANIZATION,PROPN,PROPN-PROPN-PROPN,nsubj,compound-compound-compound,NNP,NNP-NNP-NNP,3,1
10168,42264.0,12,ended,8,1,6,5,0,5,7,-2,His,Yvonne Etzel,PERSON,PERSON-PERSON,DET,PROPN-PROPN,poss,compound-pobj,PRP$,NNP-NNP,3,1
10169,42266.0,47,'s,2,44,38,-6,43,8,-42,36,American Psychiatric Association,Nada Stotland,ORGANIZATION-ORGANIZATION-ORGANIZATION,PERSON-PERSON,PROPN-PROPN-PROPN,PROPN-PROPN,compound-compound-pobj,compound-nsubj,NNP-NNP-NNP,NNP-NNP,5,1
10170,61728.0,38,said,24,35,27,-8,34,10,-11,3,American Psychiatric Association,Nada Stotland,ORGANIZATION-ORGANIZATION-ORGANIZATION,PERSON-PERSON,PROPN-PROPN-PROPN,PROPN-PROPN,compound-compound-pobj,compound-nsubj,NNP-NNP-NNP,NNP-NNP,5,1
10171,42274.0,31,is,7,16,24,8,15,6,-9,17,Haifa University,Research Institute for Peace,ORGANIZATION-ORGANIZATION,ORGANIZATION-ORGANIZATION-ORGANIZATION-ORGANIZATION,PROPN-PROPN,PROPN-PROPN-ADP-PROPN,compound-pobj,compound-pobj-prep-pobj,NNP-NNP,NNP-NNP-IN-NNP,3,1
10172,42297.0,41,said,22,3,8,5,2,32,19,-14,Mainland Affairs Council,Kao Chang,ORGANIZATION-ORGANIZATION-ORGANIZATION,PERSON-PERSON,PROPN-PROPN-PROPN,PROPN-PROPN,compound-compound-compound,compound-nsubj,NNP-NNPS-NNP,NNP-NNP,3,1
10173,42308.0,30,married,2,1,23,22,0,6,1,21,She,maid,PERSON,TITLE,PRON,ADJ,nsubj,compound,PRP,JJ,6,1
10174,42315.0,25,born,4,22,1,-21,21,23,-18,-3,Mildred Miller Nolte,Richard Henry Nolte,PERSON-PERSON-PERSON,PERSON-PERSON-PERSON,PROPN-PROPN-PROPN,PROPN-PROPN-PROPN,compound-compound-conj,compound-compound-nsubjpass,NNP-NNP-NNP,NNP-NNP-NNP,6,1
10175,42321.0,27,announced,10,9,7,-2,8,19,1,-3,Art Buchwald,newspaper columnist,PERSON-PERSON,TITLE-TITLE,PROPN-PROPN,NOUN-NOUN,compound-nsubj,compound-compound,NNP-NNP,NN-NN,1,1
10176,62542.0,27,said,24,2,9,7,1,17,22,-15,Art Buchwald,newspaper columnist,PERSON-PERSON,TITLE-TITLE,NOUN-PROPN,NOUN-NOUN,compound-nsubj,compound-pobj,NN-NNP,NN-NN,3,1
10177,42325.0,31,told,28,2,27,25,1,3,26,-1,IMF,Bill Murray,ORGANIZATION,PERSON-PERSON,PROPN,PROPN-PROPN,compound,compound-nsubj,NNP,NNP-NNP,4,1
10178,42354.0,34,Lines,2,1,1,0,0,32,1,-1,Carnival Corporation,Carnival Cruise Lines,ORGANIZATION-ORGANIZATION,ORGANIZATION-ORGANIZATION-ORGANIZATION,PROPN-PROPN,PROPN-PROPN-PROPN,compound-pobj,compound-compound-ROOT,NNP-NNP,NNP-NNP-NNPS,0,1
10179,42376.0,20,said,14,2,5,3,1,14,12,-9,He,East Mediterranean,PERSON,LOCATION-LOCATION,PRON,PROPN-PROPN,nsubj,compound-attr,PRP,NNP-NNP,3,1
10180,42404.0,54,said,38,40,3,-37,39,50,-2,-35,he,Englishman,PERSON,NATIONALITY,PRON,PROPN,nsubj,nsubjpass,PRP,NNP,8,1
10181,42407.0,26,said,6,1,11,10,0,14,5,5,Czech National Bank,central bank,ORGANIZATION-ORGANIZATION-ORGANIZATION,ORGANIZATION-ORGANIZATION,PROPN-PROPN-PROPN,ADJ-NOUN,compound-compound-compound,amod-nsubj,NNP-NNP-NNP,JJ-NN,6,1
10182,42411.0,49,voted,29,27,19,-8,26,29,2,-10,American Psychological Association,U.S.,ORGANIZATION-ORGANIZATION-ORGANIZATION,COUNTRY,PROPN-PROPN-PROPN,PROPN,compound-compound-nsubj,compound,NNP-NNP-NNP,NNP,9,1
10183,42413.0,26,is,1,16,11,-5,15,14,-15,10,MNLF,Misuari,ORGANIZATION,PERSON,PROPN,PROPN,pobj,dobj,NNP,NNP,2,1
10184,64692.0,37,was,1,11,1,-10,10,35,-10,0,MNLF,Misuari,ORGANIZATION,PERSON,PROPN,PROPN,compound,nsubj,NNP,NNP,1,1
10185,42422.0,51,made,8,16,45,29,15,5,-8,37,Kinmen Kaoliang Liquor Inc.,KKL,ORGANIZATION-ORGANIZATION-ORGANIZATION-ORGANIZATION,ORGANIZATION,PROPN-PROPN-PROPN-PROPN,PROPN,compound-compound-compound-subtok,compound,NNP-NNP-NNP-NNP,NNP,9,1
10186,42429.0,26,advanced,1,18,10,-8,17,15,-17,9,Jackson Hewitt Tax Services Inc.,his,ORGANIZATION-ORGANIZATION-ORGANIZATION-ORGANIZATION-ORGANIZATION,PERSON,PROPN-PROPN-PROPN-PROPN-PROPN,DET,compound-compound-compound-compound-appos,poss,NNP-NNP-NNP-NNPS-NNP,PRP$,7,1
10187,42432.0,33,created,18,18,21,3,17,11,0,3,he,Tampa Bay area,PERSON,LOCATION-LOCATION-LOCATION,PRON,PROPN-PROPN-NOUN,nsubj,compound-compound-poss,PRP,NNP-NNP-NN,3,1
10188,42434.0,34,was,1,16,17,1,15,16,-15,16,him,ambassador,PERSON,TITLE,PRON,NOUN,dobj,oprd,PRP,NN,2,1
10189,42435.0,48,died,37,1,5,4,0,42,36,-32,Lorraine Rothman,leader,PERSON-PERSON,TITLE,PROPN-PROPN,NOUN,compound-nsubj,appos,NNP-NNP,NN,2,1
10190,42440.0,40,endured,1,1,8,7,0,31,0,7,Hamilton,British,PERSON,NATIONALITY,PROPN,ADJ,nsubj,amod,NNP,JJ,2,1
10191,42443.0,35,survived,2,27,1,-26,26,33,-25,-1,Eleanor Derounian,Derounian,PERSON-PERSON,PERSON,PROPN-PROPN,PROPN,compound-conj,nsubjpass,NNP-NNP,NNP,5,1
10192,42451.0,32,lie,2,17,13,-4,16,18,-15,11,he,Vilma Espin,PERSON,PERSON-PERSON,PRON,PROPN-PROPN,nsubj,compound-appos,PRP,NNP-NNP,6,1
10193,42452.0,30,gained,1,1,24,23,0,5,0,23,He,Clarence Mitchell III,PERSON,PERSON-PERSON-PERSON,PRON,PROPN-PROPN-PROPN,nsubj,compound-compound-dobj,PRP,NNP-NNP-NNP,3,1
10194,42458.0,39,said,37,18,26,8,17,12,19,-11,Hussein Kamel,industry minister,PERSON-PERSON,TITLE-TITLE,PROPN-PROPN,NOUN-NOUN,compound-compound,compound-attr,NNP-NNP,NN-NN,7,1
10195,42495.0,27,said,17,2,22,20,1,4,15,5,She,Frederick `` Rick '' Ahearn,PERSON,PERSON-PERSON-PERSON-PERSON-PERSON,PRON,PROPN-PUNCT-PROPN-PUNCT-PROPN,nsubj,nmod-punct-nmod-punct-appos,PRP,NNP-``-NNP-''-NNP,5,1
10196,42500.0,15,born,5,1,14,13,0,0,4,9,Henry Bradford Washburn Jr.,Cambridge,PERSON-PERSON-PERSON-PERSON,CITY,PROPN-PROPN-PROPN-PROPN,PROPN,compound-compound-compound-nsubjpass,pobj,NNP-NNP-NNP-NNP,NNP,3,1
10197,42502.0,48,advancing,23,19,13,-6,18,34,4,-10,his,36th Infantry Division,PERSON,ORGANIZATION-ORGANIZATION-ORGANIZATION,DET,PROPN-PROPN-PROPN,poss,compound-compound-pobj,PRP$,NNP-NNP-NNP,4,1
10198,42525.0,38,said,36,2,29,27,1,8,34,-7,Paul Gillmor,Va.,PERSON-PERSON,STATE_OR_PROVINCE,PROPN-PROPN,PROPN,compound-nsubjpass,appos,NNP-NNP,NNP,4,1
10199,42529.0,43,was,7,23,31,8,22,11,-16,24,Boxer,Senate,PERSON,ORGANIZATION,PROPN,PROPN,pobj,poss,NNP,NNP,8,1
10200,58079.0,39,has,24,18,33,15,17,5,6,9,Boxer,Senate,PERSON,ORGANIZATION,PROPN,PROPN,nsubj,compound,NNP,NNP,12,1
10201,42530.0,18,joined,5,3,13,10,2,4,2,8,his,Washington Redskins,PERSON,ORGANIZATION-ORGANIZATION,DET,PROPN-PROPN,poss,compound-poss,PRP$,NNP-NNPS,7,1
10202,42532.0,16,received,4,4,14,10,3,1,0,10,she,Chapman University,PERSON,ORGANIZATION-ORGANIZATION,PRON,PROPN-PROPN,nsubj,compound-pobj,PRP,NNP-NNP,2,1
10203,42546.0,29,touched,7,19,6,-13,18,22,-12,-1,Kennedy Space Center,seven,ORGANIZATION-ORGANIZATION-ORGANIZATION,NUMBER,PROPN-PROPN-PROPN,NUM,compound-compound-pobj,nummod,NNP-NNP-NNP,CD,7,1
10204,42563.0,27,represented,4,4,12,8,3,14,0,8,Roraback,Canaan,PERSON,LOCATION,PROPN,PROPN,nsubj,pobj,NNP,NNP,4,1
10205,42564.0,42,vote,34,8,1,-7,7,40,26,-33,Metro Atlanta Chamber of Commerce,Republican,ORGANIZATION-ORGANIZATION-ORGANIZATION-ORGANIZATION-ORGANIZATION,IDEOLOGY,PROPN-PROPN-PROPN-ADP-PROPN,ADJ,compound-compound-pobj-prep-pobj,amod,NNP-NNP-NNP-IN-NNP,JJ,3,1
10206,42570.0,37,began,9,26,36,10,25,0,-17,27,he,actor,PERSON,TITLE,PRON,NOUN,nsubj,attr,PRP,NN,4,1
10207,42573.0,24,told,17,2,10,8,1,13,15,-7,David,reporter,PERSON,TITLE,PROPN,NOUN,nsubj,pobj,NNP,NN,4,1
10208,42577.0,24,recalled,6,1,5,4,0,18,5,-1,Peterson,Celine,PERSON,PERSON,PROPN,PROPN,poss,appos,NNP,NNP,4,1
10209,42582.0,23,Library,4,3,3,0,2,19,1,-1,Chelsea District Library,Chelsea,ORGANIZATION-ORGANIZATION-ORGANIZATION,CITY,PROPN-PROPN-PROPN,PROPN,compound-nmod-ROOT,appos,NNP-NNP-NNP,NNP,0,1
10210,42585.0,35,follows,3,15,7,-8,14,27,-12,4,Haifa University,Abraham Haim,ORGANIZATION-ORGANIZATION,PERSON-PERSON,PROPN-PROPN,PROPN-PROPN,compound-pobj,compound-pobj,NNP-NNP,NNP-NNP,3,1
10211,42588.0,33,says,10,9,1,-8,8,31,1,-9,ResCap,Tom Marano,ORGANIZATION,PERSON-PERSON,PROPN,PROPN-PROPN,pobj,compound-nsubj,NNP,NNP-NNP,2,1
10212,42592.0,38,said,13,8,11,3,7,26,5,-2,Supreme Court,Disciplinary Counsel,ORGANIZATION-ORGANIZATION,ORGANIZATION-ORGANIZATION,PROPN-PROPN,PROPN-PROPN,compound-poss,compound-pobj,NNP-NNP,NNP-NNP,1,1
10213,42603.0,20,said,18,1,7,6,0,12,17,-11,Bond,University of Virginia,PERSON,ORGANIZATION-ORGANIZATION-ORGANIZATION,NOUN,PROPN-ADP-PROPN,nsubj,pobj-prep-pobj,NN,NNP-IN-NNP,4,1
10214,42613.0,68,-LRB-,2,62,14,-48,61,53,-60,12,Carolyn B. Maloney,House of Representatives,PERSON-PERSON-PERSON,ORGANIZATION-ORGANIZATION-ORGANIZATION,PROPN-PROPN-PROPN,PROPN-ADP-PROPN,compound-compound-conj,pobj-prep-pobj,NNP-NNP-NNP,NNP-IN-NNPS,21,1
10215,42620.0,21,died,17,1,18,17,0,2,16,1,LORRAINE ROTHMAN,died,PERSON-PERSON,STATE_OR_PROVINCE,PROPN-PROPN,VERB,compound-nsubj,ROOT,NNP-NNP,VBD,2,1
10216,42628.0,40,seen,30,32,35,3,31,4,-2,5,Yolanda King,actress,PERSON-PERSON,TITLE,PROPN-PROPN,NOUN,compound-dobj,appos,NNP-NNP,NN,2,1
10217,56821.0,19,dies,15,1,4,3,0,14,14,-11,Yolanda King,actress,PERSON-PERSON,TITLE,PROPN-PROPN,NOUN,compound-nsubj,conj,NNP-NNP,NN,2,1
10218,42647.0,63,said,6,2,40,38,1,22,4,34,New South Wales Rugby Union,last 10 days,ORGANIZATION-ORGANIZATION-ORGANIZATION-ORGANIZATION-ORGANIZATION,DATE-DATE-DATE,PROPN-PROPN-PROPN-PROPN-PROPN,ADJ-NUM-NOUN,compound-compound-compound-compound-nsubj,amod-nummod-dobj,NNP-NNP-NNP-NNP-NNP,JJ-CD-NNS,-1,1
10219,42667.0,17,...,0,2,16,14,1,0,-2,16,Frankie Delgado,producer,PERSON-PERSON,TITLE,PROPN-PROPN,NOUN,compound-nsubj,attr,NNP-NNP,NN,2,1
10220,53746.0,16,is,12,1,15,14,0,0,11,3,Frankie Delgado,producer,PERSON-PERSON,TITLE,PROPN-PROPN,NOUN,compound-nsubj,attr,NNP-NNP,NN,2,1
10221,42668.0,52,thanked,11,1,10,9,0,41,10,-1,Haddad Adel,Iran,PERSON-PERSON,COUNTRY,PROPN-PROPN,PROPN,compound-nsubj,pobj,NNP-NNP,NNP,2,1
10222,42675.0,27,said,23,15,22,7,14,4,8,-1,IMF,Mohsen Khan,ORGANIZATION,PERSON-PERSON,PROPN,PROPN-PROPN,compound,compound-conj,NNP,NNP-NNP,3,1
10223,42687.0,43,expected,5,14,24,10,13,18,-9,19,John D. Negroponte,deputy,PERSON-PERSON-PERSON,TITLE,PROPN-PROPN-PROPN,NOUN,compound-compound-pobj,pobj,NNP-NNP-NNP,NN,4,1
10224,42696.0,53,went,23,8,51,43,7,1,15,28,his,Department I-C,PERSON,ORGANIZATION-ORGANIZATION,DET,PROPN-PROPN,poss,compound-appos,PRP$,NNP-NNP,10,1
10225,42708.0,33,died,29,7,14,7,6,18,22,-15,William Robert Anderson,congressman,PERSON-PERSON-PERSON,TITLE,PROPN-PROPN-PROPN,NOUN,compound-compound-appos,appos,NNP-NNP-NNP,NN,5,1
10226,42711.0,22,is,3,10,8,-2,9,13,-7,5,her,star,PERSON,TITLE,DET,NOUN,poss,pobj,PRP$,NN,1,1
10227,50290.0,34,is,4,28,23,-5,27,10,-24,19,her,star,PERSON,TITLE,DET,NOUN,poss,nsubj,PRP$,NN,3,1
10228,65205.0,17,left,13,15,4,-11,14,12,-2,-9,her,star,PERSON,TITLE,PRON,NOUN,dobj,nsubj,PRP,NN,3,1
10229,42715.0,29,died,16,2,20,18,1,8,14,4,Juanita Millender-McDonald,April 22,PERSON-PERSON,DATE-DATE,PROPN-PROPN,PROPN-NUM,compound-nsubj,npadvmod-nummod,NNP-NNP,NNP-CD,2,1
10230,42728.0,31,said,5,5,19,14,4,11,0,14,CNAC,Shanghai,ORGANIZATION,CITY,PROPN,PROPN,nsubj,appos,NNP,NNP,3,1
10231,42729.0,30,buried,19,1,5,4,0,24,18,-14,McNair,"Dec. 14 , 1923",PERSON,DATE-DATE-DATE-DATE,PROPN,PROPN-NUM-PUNCT-NUM,nsubjpass,pobj-nummod-punct-nummod,NNP,"NNP-CD-,-CD",5,1
10232,42732.0,54,mandates,1,33,1,-32,32,52,-32,0,Federal Executive Council,FEC,ORGANIZATION-ORGANIZATION-ORGANIZATION,ORGANIZATION,PROPN-PROPN-PROPN,PROPN,compound-compound-appos,compound,NNP-NNP-NNP,NNP,-1,1
10233,42737.0,25,founded,13,13,9,-4,12,15,0,-4,firm,Greenwich,ORGANIZATION,CITY,NOUN,PROPN,nsubj,pobj,NN,NNP,5,1
10234,42743.0,37,is,8,7,5,-2,6,31,1,-3,Jackson Hewitt,NJ,ORGANIZATION-ORGANIZATION,STATE_OR_PROVINCE,PROPN-PROPN,PROPN,compound-nsubj,conj,NNP-NNP,NNP,2,1
10235,47806.0,25,is,9,1,8,7,0,16,8,-1,Jackson Hewitt,NJ,ORGANIZATION-ORGANIZATION,STATE_OR_PROVINCE,PROPN-PROPN,PROPN,compound-nsubj,appos,NNP-NNP,NNP,2,1
10236,42745.0,18,appointed,2,4,10,6,3,7,-2,8,him,President 's Task Force on Private Sector Initiatives,PERSON,ORGANIZATION-ORGANIZATION-ORGANIZATION-ORGANIZATION-ORGANIZATION-ORGANIZATION-ORGANIZATION-ORGANIZATION,PRON,PROPN-PART-PROPN-PROPN-ADP-PROPN-PROPN-PROPN,dobj,poss-case-compound-pobj-prep-compound-compound-pobj,PRP,NNP-POS-NNP-NNP-IN-NNP-NNP-NNP,5,1
10237,42754.0,36,reveals,1,31,35,4,30,0,-30,34,his,LA.,PERSON,CITY,DET,NOUN,poss,pobj,PRP$,NN,1,1
10238,42758.0,49,concerns,2,7,34,27,6,14,-5,32,Michael Sandy,Plumb Beach,PERSON-PERSON,LOCATION-LOCATION,PROPN-PROPN,PROPN-PROPN,compound-pobj,compound-pobj,NNP-NNP,NNP-NNP,6,1
10239,42772.0,20,founded,5,1,7,6,0,12,4,2,Hanley Denning,Safe Passage,ORGANIZATION-ORGANIZATION,PERSON-PERSON,PROPN-PROPN,PROPN-PROPN,compound-nsubj,compound-dobj,NNP-NNP,NNP-NNP,2,1
10240,42788.0,38,died,33,1,9,8,0,28,32,-24,Philip M. Kaiser,Austria,PERSON-PERSON-PERSON,COUNTRY,PROPN-PROPN-PROPN,PROPN,compound-compound-nsubj,pobj,NNP-NNP-NNP,NNP,5,1
10241,42797.0,24,said,11,23,13,-10,22,10,-12,2,Bernama,Azman Ujang,ORGANIZATION,PERSON-PERSON,PROPN,PROPN-PROPN,appos,compound-nsubj,NNP,NNP-NNP,2,1
10242,50892.0,21,agency,3,5,8,3,4,12,-2,5,Bernama,Azman Ujang,ORGANIZATION,PERSON-PERSON,PROPN,PROPN-PROPN,poss,compound-nsubjpass,NNP,NNP-NNP,3,1
10243,42806.0,41,declined,3,14,20,6,13,20,-11,17,MBIA,Charles E. Chaplin,ORGANIZATION,PERSON-PERSON-PERSON,PROPN,PROPN-PROPN-PROPN,poss,compound-compound-appos,NNP,NNP-NNP-NNP,4,1
10244,42819.0,29,premieres,1,19,16,-3,18,12,-18,15,Kelly Cutrone,public relations guru,PERSON-PERSON,TITLE-TITLE-TITLE,PROPN-PROPN,ADJ-NOUN-NOUN,compound-appos,amod-compound-dobj,NNP-NNP,JJ-NNS-NN,4,1
10245,42833.0,33,said,13,11,11,0,10,21,2,-2,Vietnam Economic and Cultural Office,Vietnam,ORGANIZATION-ORGANIZATION-ORGANIZATION-ORGANIZATION-ORGANIZATION,COUNTRY,PROPN-PROPN-CCONJ-PROPN-PROPN,PROPN,nmod-nmod-cc-conj-pobj,pobj,NNP-NNP-CC-NNP-NNP,NNP,0,1
10246,42837.0,17,evolved,11,10,4,-6,9,12,1,-7,Jaguars,America,ORGANIZATION,COUNTRY,PROPN,PROPN,nsubj,pobj,NNPS,NNP,3,1
10247,42844.0,47,insisted,32,29,27,-2,28,19,3,-5,Gholam Ali Haddad Adel,ex-parliament,PERSON-PERSON-PERSON-PERSON,TITLE,PROPN-PROPN-PROPN-PROPN,NOUN,compound-compound-compound-nsubj,compound,NNP-NNP-NNP-NNP,NN,1,1
10248,42851.0,61,said,26,1,4,3,0,56,25,-22,Phil Chen,23,PERSON-PERSON,NUMBER,PROPN-PROPN,NUM,compound-nsubj,appos,NNP-NNP,CD,1,1
10249,42861.0,25,Ali,4,4,20,16,3,4,0,16,Gholam Ali Hadad-Adel,Iran,PERSON-PERSON-PERSON,COUNTRY,PROPN-PROPN-PROPN,PROPN,compound-ROOT-nsubj,poss,NNP-NNP-NNP,NNP,7,1
10250,42873.0,56,demoted,28,18,2,-16,17,53,10,-26,Inquirer,Philadelphia Media Network,ORGANIZATION,ORGANIZATION-ORGANIZATION-ORGANIZATION,PROPN,PROPN-PROPN-PROPN,dobj,compound-compound-nsubj,NNP,NNP-NNP-NNP,7,1
10251,42891.0,15,met,1,3,9,6,2,5,-2,8,George Roy Hill,actors,PERSON-PERSON-PERSON,TITLE,PROPN-PROPN-PROPN,NOUN,compound-compound-dobj,attr,NNP-NNP-NNP,NNS,5,1
10252,42900.0,32,scheduled,2,24,28,4,23,3,-22,26,Kennedy Space Center,KSC,ORGANIZATION-ORGANIZATION-ORGANIZATION,ORGANIZATION,PROPN-PROPN-PROPN,PROPN,compound-compound-compound,compound,NNP-NNP-NNP,NNP,6,1
10253,66306.0,37,announced,17,29,33,4,28,3,-12,16,Kennedy Space Center,KSC,ORGANIZATION-ORGANIZATION-ORGANIZATION,ORGANIZATION,PROPN-PROPN-PROPN,PROPN,compound-compound-pobj,compound,NNP-NNP-NNP,NNP,4,1
10254,42907.0,39,announced,6,6,25,19,5,13,0,19,Dodd,Senate Foreign Relations Committee,PERSON,ORGANIZATION-ORGANIZATION-ORGANIZATION-ORGANIZATION,PROPN,PROPN-PROPN-PROPN-PROPN,nsubj,compound-compound-compound-compound,NNP,NNP-NNP-NNPS-NNP,4,1
10255,42917.0,27,ventured,2,1,20,19,0,6,1,18,DeGeneres,Clint Eastwood,PERSON,PERSON-PERSON,PROPN,PROPN-PROPN,nsubj,compound-pobj,NNP,NNP-NNP,5,1
10256,42925.0,21,said,1,3,7,4,2,13,-2,6,Cowell,Sony BMG,PERSON,ORGANIZATION-ORGANIZATION,PROPN,PROPN-PROPN,poss,compound-pobj,NNP,NNP-NNP,4,1
10257,42930.0,31,chairs,1,1,4,3,0,26,0,3,Boxer,US Senate Committee on Environment and Public Works,PERSON,ORGANIZATION-ORGANIZATION-ORGANIZATION-ORGANIZATION-ORGANIZATION-ORGANIZATION-ORGANIZATION-ORGANIZATION,PROPN,PROPN-PROPN-PROPN-ADP-PROPN-CCONJ-PROPN-PROPN,amod,compound-compound-dobj-prep-pobj-cc-compound-conj,NNP,NNP-NNP-NNP-IN-NNP-CC-NNP-NNP,2,1
10258,42933.0,18,import,7,12,17,5,11,0,-5,10,NSG,U.S.,ORGANIZATION,COUNTRY,PROPN,PROPN,compound,pobj,NNP,NNP,3,1
10259,42935.0,52,said,45,2,7,5,1,44,43,-38,She,Guild,PERSON,ORGANIZATION,PRON,ADJ,nsubj,amod,PRP,JJ,4,1
10260,42945.0,35,proposed,13,1,18,17,0,16,12,5,China National Aviation Corp,2.985 billion,ORGANIZATION-ORGANIZATION-ORGANIZATION-ORGANIZATION,NUMBER-NUMBER,PROPN-PROPN-PROPN-PROPN,NUM-NUM,compound-compound-compound-nsubj,compound-nummod,NNP-NNP-NNP-NNP,CD-CD,5,1
10261,42961.0,43,showed,6,37,36,-1,36,6,-31,30,International Crisis Group,Belgium-based,ORGANIZATION-ORGANIZATION-ORGANIZATION,COUNTRY,PROPN-PROPN-PROPN,PROPN,compound-compound-pobj,amod,NNP-NNP-NNP,NNP,1,1
10262,42963.0,41,helicopter,4,23,25,2,22,15,-19,21,KGB,Felix Dzerzhinsky,ORGANIZATION,PERSON-PERSON,PROPN,PROPN-PROPN,compound,compound-pobj,NNP,NNP-NNP,1,1
10263,42967.0,40,talked,19,2,8,6,1,31,17,-11,Joel I Klein,chancellor,PERSON-PERSON-PERSON,TITLE,PROPN-PRON-PROPN,NOUN,nmod-compound-nsubj,appos,NNP-PRP-NNP,NN,4,1
10264,42970.0,74,is,17,4,22,18,3,51,13,5,Alice,London,PERSON,CITY,PROPN,PROPN,nsubj,poss,NNP,NNP,8,1
10265,42979.0,35,abounded,28,21,2,-19,20,32,7,-26,club,Red and White Holdings Limited,ORGANIZATION,PERSON-PERSON-PERSON-PERSON-PERSON,NOUN,PROPN-CCONJ-PROPN-PROPN-PROPN,pobj,nmod-cc-conj-compound-pobj,NN,NNP-CC-NNP-NNPS-NNP,4,1
10266,42982.0,29,charged,7,2,10,8,1,18,5,3,her,misdemeanor,PERSON,CRIMINAL_CHARGE,DET,NOUN,poss,compound,PRP$,NN,5,1
10267,42987.0,30,was,1,6,26,20,5,3,-5,25,Andrew Goodman,Miss.,PERSON-PERSON,STATE_OR_PROVINCE,PROPN-PROPN,PROPN,compound-pobj,appos,NNP-NNP,NNP,4,1
10268,42988.0,30,sent,16,1,4,3,0,25,15,-12,Raul Castro,second secretary,PERSON-PERSON,TITLE-TITLE,PROPN-PROPN,ADJ-NOUN,compound-nsubj,amod-appos,NNP-NNP,JJ-NN,1,1
10269,42994.0,38,include,1,9,12,3,8,25,-8,11,Carolyn Deaver,Bethesda,PERSON-PERSON,CITY,PROPN-PROPN,PROPN,compound-appos,pobj,NNP-NNP,NNP,1,1
10270,42996.0,30,said,7,1,3,2,0,26,6,-4,His,chairman,PERSON,TITLE,DET,NOUN,poss,nsubj,PRP$,NN,2,1
10271,42997.0,30,died,22,3,21,18,2,8,19,-1,Steven B. Derounian,judge,PERSON-PERSON-PERSON,TITLE,PROPN-PROPN-PROPN,NOUN,compound-compound-nsubj,attr,NNP-NNP-NNP,NN,3,1
10272,43016.0,26,retained,2,17,9,-8,16,16,-15,7,Barbara Boxer,West Virginia,PERSON-PERSON,STATE_OR_PROVINCE-STATE_OR_PROVINCE,PROPN-PROPN,PROPN-PROPN,compound-nsubj,compound-pobj,NNP-NNP,NNP-NNP,4,1
10273,43019.0,49,plans,9,43,6,-37,42,42,-34,-3,Convocation of Anglicans in North America,Anglican,ORGANIZATION-ORGANIZATION-ORGANIZATION-ORGANIZATION-ORGANIZATION-ORGANIZATION,RELIGION,PROPN-ADP-PROPN-ADP-PROPN-PROPN,PROPN,pobj-prep-pobj-prep-compound-pobj,compound,NNP-IN-NNPS-IN-NNP-NNP,NNP,17,1
10274,43022.0,24,grew,1,7,20,13,6,3,-6,19,Kerry,Skull and Bones Society,PERSON,ORGANIZATION-ORGANIZATION-ORGANIZATION-ORGANIZATION,PROPN,PROPN-CCONJ-PROPN-PROPN,dative,pobj-cc-compound-conj,NNP,NNP-CC-NNP-NNP,7,1
10275,43027.0,51,Kaohsiung,0,35,38,3,34,12,-35,38,Chunghwa Telecom,Tan Ho Chen,ORGANIZATION-ORGANIZATION,PERSON-PERSON-PERSON,PROPN-PROPN,PROPN-PROPN-PROPN,compound-compound,compound-compound-pobj,NNP-NNP,NNP-NNP-NNP,4,1
10276,43036.0,25,said,16,18,23,5,17,1,-2,7,International Monetary Fund,Stephen Schwartz,ORGANIZATION-ORGANIZATION-ORGANIZATION,PERSON-PERSON,PROPN-PROPN-PROPN,PROPN-PROPN,compound-compound-compound,compound-nsubj,NNP-NNP-NNP,NNP-NNP,4,1
10277,43042.0,39,invited,3,31,18,-13,30,20,-28,15,Organization of the Islamic Conference,Amr Moussa,ORGANIZATION-ORGANIZATION-ORGANIZATION-ORGANIZATION-ORGANIZATION,PERSON-PERSON,PROPN-ADP-DET-PROPN-PROPN,PROPN-PROPN,pobj-prep-det-compound-pobj,compound-pobj,NNP-IN-DT-NNP-NNP,NNP-NNP,12,1
10278,43060.0,36,putting,5,2,33,31,1,2,3,28,Erika Rose,Infiniti Le Mode,PERSON-PERSON,ORGANIZATION-ORGANIZATION-ORGANIZATION,PROPN-PROPN,PROPN-PROPN-PROPN,compound-nsubj,compound-compound-appos,NNP-NNP,NNP-NNP-NNP,7,1
10279,60389.0,38,mokhal,1,4,35,31,3,2,-3,34,Erika Rose,Infiniti Le Mode,PERSON-PERSON,ORGANIZATION-ORGANIZATION-ORGANIZATION,PROPN-PROPN,PROPN-PROPN-PROPN,compound-nsubj,compound-compound-appos,NNP-NNP,NNP-NNP-NNP,8,1
10280,43078.0,39,called,12,24,5,-19,23,33,-12,-7,she,executive producer,PERSON,TITLE-TITLE,PRON,ADJ-NOUN,nsubj,amod-appos,PRP,JJ-NN,3,1
10281,43080.0,28,scored,4,18,12,-6,17,15,-14,8,Donald E. Wildmon,Christian,PERSON-PERSON-PERSON,RELIGION,PROPN-PROPN-PROPN,ADJ,compound-compound-appos,amod,NNP-NNP-NNP,JJ,3,1
10282,43082.0,21,2009-10-07T09,0,4,9,5,3,11,-4,9,Frankie Delgado,musician,PERSON-PERSON,TITLE,PROPN-PROPN,NOUN,compound-nsubj,amod,NNP-NNP,NN,3,1
10283,51512.0,18,is,2,1,6,5,0,11,1,4,Frankie Delgado,musician,PERSON-PERSON,TITLE,PROPN-PROPN,NOUN,compound-nsubj,amod,NNP-NNP,NN,4,1
10284,43091.0,43,sent,7,6,10,4,5,32,1,3,Kollek,New York,PERSON,STATE_OR_PROVINCE-STATE_OR_PROVINCE,PROPN,PROPN-PROPN,nsubjpass,compound-pobj,NNP,NNP-NNP,3,1
10285,43096.0,48,MCNAIR,1,1,4,3,0,43,0,3,ROBERT MCNAIR,83,PERSON-PERSON,NUMBER,PROPN-PROPN,NUM,compound-ROOT,appos,NNP-NNP,CD,1,1
10286,43099.0,31,said,4,14,13,-1,13,17,-10,9,National Beef,Mo-based,ORGANIZATION-ORGANIZATION,STATE_OR_PROVINCE,PROPN-PROPN,PROPN,compound-appos,compound,NNP-NNP,NNP,1,1
10287,43111.0,15,practiced,4,4,14,10,3,0,0,10,she,Poughkeepsie,PERSON,CITY,PRON,PROPN,nsubj,pobj,PRP,NNP,1,1
10288,43121.0,12,died,8,5,11,6,4,0,3,3,Alvin H. Rothman,1995,PERSON-PERSON-PERSON,DATE,PROPN-PROPN-PROPN,NUM,compound-compound-appos,pobj,NNP-NNP-NNP,CD,4,1
10289,43134.0,26,said,20,24,22,-2,23,3,-4,2,Chris Bentley,INS,PERSON-PERSON,ORGANIZATION,PROPN-PROPN,PROPN,compound-nsubj,compound,NNP-NNP,NNP,3,1
10290,43142.0,31,made,4,1,3,2,0,27,3,-1,CTC,Hochen Tan,ORGANIZATION,PERSON-PERSON,PROPN,PROPN-PROPN,compound,compound-nsubj,NNP,NNP-NNP,2,1
10291,43149.0,36,issued,2,19,28,9,18,7,-17,26,Badr Organization,Iraq,ORGANIZATION-ORGANIZATION,COUNTRY,PROPN-PROPN,PROPN,compound-conj,pobj,NNP-NNP,NNP,8,1
10292,57035.0,30,led,1,9,23,14,8,6,-8,22,Badr Organization,Iraq,ORGANIZATION-ORGANIZATION,COUNTRY,PROPN-PROPN,PROPN,compound-appos,poss,NNP-NNP,NNP,8,1
10293,43152.0,58,pointed,31,27,19,-8,26,38,4,-12,Communist Party of China,Party School of the Central Committee,ORGANIZATION-ORGANIZATION-ORGANIZATION-ORGANIZATION,ORGANIZATION-ORGANIZATION-ORGANIZATION-ORGANIZATION-ORGANIZATION-ORGANIZATION,PROPN-PROPN-ADP-PROPN,PROPN-PROPN-ADP-DET-PROPN-PROPN,compound-pobj-prep-pobj,compound-pobj-prep-det-compound-pobj,NNP-NNP-IN-NNP,NNP-NNP-IN-DT-NNP-NNP,4,1
10294,43155.0,11,Blake,1,8,1,-7,7,9,-7,0,Paralyzed Veterans of America,Carl Blake,ORGANIZATION-ORGANIZATION-ORGANIZATION-ORGANIZATION,PERSON-PERSON,PROPN-PROPN-ADP-PROPN,PROPN-PROPN,compound-conj-prep-pobj,compound-ROOT,NNP-NNPS-IN-NNP,NNP-NNP,1,1
10295,52272.0,71,Department,1,19,12,-7,18,58,-18,11,Paralyzed Veterans of America,Carl Blake,ORGANIZATION-ORGANIZATION-ORGANIZATION-ORGANIZATION,PERSON-PERSON,PROPN-PROPN-ADP-PROPN,PROPN-PROPN,compound-conj-prep-pobj,compound-ROOT,NNP-NNPS-IN-NNP,NNP-NNP,-1,1
10296,63150.0,52,composed,4,15,20,5,14,31,-11,16,Paralyzed Veterans of America,Carl Blake,ORGANIZATION-ORGANIZATION-ORGANIZATION-ORGANIZATION,PERSON-PERSON,PROPN-PROPN-ADP-PROPN,PROPN-PROPN,compound-appos-prep-poss,compound-pobj,NNP-NNPS-IN-NNP,NNP-NNP,2,1
10297,43180.0,31,is,1,6,15,9,5,15,-5,14,the Legislature 's Joint Committee on the Judiciary,House Rules Committee,ORGANIZATION-ORGANIZATION-ORGANIZATION-ORGANIZATION-ORGANIZATION-ORGANIZATION-ORGANIZATION-ORGANIZATION,ORGANIZATION-ORGANIZATION-ORGANIZATION,DET-PROPN-PART-PROPN-PROPN-ADP-DET-PROPN,PROPN-PROPN-PROPN,det-poss-case-compound-pobj-prep-det-pobj,compound-compound-pobj,DT-NNP-POS-NNP-NNP-IN-DT-NNP,NNP-NNPS-NNP,8,1
10298,43197.0,20,helped,2,18,6,-12,17,13,-16,4,he,Congressional Black Caucus,PERSON,ORGANIZATION-ORGANIZATION-ORGANIZATION,PRON,PROPN-PROPN-PROPN,nsubj,compound-compound-dobj,PRP,NNP-NNP-NNP,4,1
10299,43200.0,18,is,2,14,2,-12,13,15,-12,0,Federal Election Commission,Smith,ORGANIZATION-ORGANIZATION-ORGANIZATION,PERSON,PROPN-PROPN-PROPN,PROPN,compound-compound-compound,nsubj,NNP-NNP-NNP,NNP,4,1
10300,43210.0,13,born,8,5,11,6,4,1,3,3,Sean Preston,September 2005,PERSON-PERSON,DATE-DATE,PROPN-PROPN,PROPN-NUM,compound-appos,pobj-nummod,NNP-NNP,NNP-CD,5,1
10301,43212.0,31,seeks,3,2,16,14,1,14,1,13,John Kerry,American,PERSON-PERSON,NATIONALITY,PROPN-PROPN,ADJ,compound-nsubj,amod,NNP-NNP,JJ,5,1
10302,43214.0,46,launched,14,7,1,-6,6,44,7,-13,MNLF,Haber Malik,ORGANIZATION,PERSON-PERSON,PROPN,PROPN-PROPN,compound,compound-nsubj,NNP,NNP-NNP,3,1
10303,43218.0,34,handed,14,7,11,4,6,22,7,-3,International Monetary Fund,Ousmane Dore,ORGANIZATION-ORGANIZATION-ORGANIZATION,PERSON-PERSON,PROPN-PROPN-PROPN,PROPN-PROPN,compound-compound-pobj,compound-appos,NNP-NNP-NNP,NNP-NNP,2,1
10304,43241.0,54,survived,2,29,16,-13,28,37,-27,14,David Kaiser,Robert G. Kaiser,PERSON-PERSON,PERSON-PERSON-PERSON,PROPN-PROPN,PROPN-PROPN-PROPN,compound-appos,compound-compound-ROOT,NNP-NNP,NNP-NNP-NNP,2,1
10305,43261.0,34,studied,4,18,2,-16,17,31,-14,-2,his,Oxford,PERSON,CITY,DET,PROPN,poss,pobj,PRP$,NNP,8,1
10306,43266.0,23,'s,1,6,11,5,5,11,-5,10,Abu Zubaydah,Riyadh,PERSON-PERSON,CITY,PROPN-PROPN,PROPN,compound-poss,pobj,NNP-NNP,NNP,4,1
10307,43268.0,42,worked,1,20,3,-17,19,38,-19,2,Carnival Corp.,his,ORGANIZATION-ORGANIZATION,PERSON,PROPN-PROPN,DET,compound-dobj,poss,NNP-NNP,PRP$,8,1
10308,43273.0,34,has,2,1,1,0,0,32,1,-1,Remy,Remy Ma,PERSON,PERSON-PERSON,PROPN,PROPN-PROPN,nsubj,compound-nsubj,NNP,NNP-NNP,0,1
10309,43275.0,18,said,7,5,4,-1,4,13,2,-3,R Nicholas Burns,State,PERSON-PERSON-PERSON,ORGANIZATION,PROPN-PROPN-PROPN,PROPN,compound-compound-nsubj,pobj,NNP-NNP-NNP,NNP,2,1
10310,43278.0,30,said,28,17,25,8,16,4,11,-3,Pamela Martin and Associates,August 2006,ORGANIZATION-ORGANIZATION-ORGANIZATION-ORGANIZATION,DATE-DATE,PROPN-PROPN-CCONJ-PROPN,PROPN-NUM,compound-conj-cc-conj,pobj-nummod,NNP-NNP-CC-NNPS,NNP-CD,5,1
10311,43299.0,46,appear,6,6,23,17,5,22,0,17,Rovers,Anuradha Desai,ORGANIZATION,PERSON-PERSON,NOUN,PROPN-PROPN,pobj,compound-nsubj,NNS,NNP-NNP,4,1
10312,43323.0,23,overcame,14,14,3,-11,13,19,0,-11,Chavez,paratrooper colonel,PERSON,TITLE-TITLE,PROPN,NOUN-NOUN,nsubj,compound-nsubj,NNP,NN-NN,1,1
10313,43325.0,22,said,14,8,3,-5,7,18,6,-11,his,Monday,PERSON,DATE,DET,PROPN,poss,npadvmod,PRP$,NNP,3,1
10314,60494.0,22,said,14,8,3,-5,7,18,6,-11,his,Monday,PERSON,DATE,DET,PROPN,poss,npadvmod,PRP$,NNP,3,1
10315,63129.0,27,died,6,16,8,-8,15,18,-10,2,his,Monday,PERSON,DATE,DET,PROPN,poss,npadvmod,PRP$,NNP,4,1
10316,43340.0,32,recalled,1,19,13,-6,18,18,-18,12,he,Vienna,PERSON,CITY,PRON,PROPN,nsubj,pobj,PRP,NNP,2,1
10317,43344.0,30,proposed,7,6,5,-1,5,24,1,-2,Richard Lindzen,climatologist,PERSON-PERSON,TITLE,PROPN-PROPN,NOUN,compound-nsubj,compound,NNP-NNP,NN,1,1
10318,43350.0,82,Woods,12,59,65,6,58,16,-47,53,Sean Preston,Britney Spears,PERSON-PERSON,PERSON-PERSON,PROPN-PROPN,PROPN-PROPN,compound-compound,compound-pobj,NNP-NNP,NNP-NNPS,4,1
10319,43366.0,16,received,1,1,11,10,0,4,0,10,He,George Washington University,PERSON,ORGANIZATION-ORGANIZATION-ORGANIZATION,PRON,PROPN-PROPN-PROPN,nsubj,compound-compound-pobj,PRP,NNP-NNP-NNP,3,1
10320,43376.0,42,suffered,4,20,15,-5,19,26,-16,11,Badr Corp,Shiite,ORGANIZATION-ORGANIZATION,RELIGION,PROPN-PROPN,ADJ,compound-appos,amod,NNP-NNP,JJ,1,1
10321,43378.0,48,looks,4,4,26,22,3,21,0,22,Perle,chairman,PERSON,TITLE,PROPN,NOUN,nsubj,attr,NNP,NN,4,1
10322,43385.0,31,thinks,10,4,1,-3,3,29,6,-9,DCR,Joseph Orfant,ORGANIZATION,PERSON-PERSON,PROPN,PROPN-PROPN,poss,compound-nsubj,NNP,NNP-NNP,3,1
10323,43398.0,12,remained,3,3,6,3,2,5,0,3,Kurnaz,Guantanamo,PERSON,COUNTRY,PROPN,PROPN,nsubj,pobj,NNP,NNP,1,1
10324,43403.0,44,held,3,2,9,7,1,34,1,6,Red Sox,American League East,ORGANIZATION-ORGANIZATION,ORGANIZATION-ORGANIZATION-ORGANIZATION,PROPN-PROPN,PROPN-PROPN-PROPN,compound-nsubj,compound-compound-dobj,NNP-NNPS,NNP-NNP-NNP,4,1
10325,43406.0,34,Jr,3,1,31,30,0,2,2,28,Harry S Dent Jr,Columbia,PERSON-PERSON-PERSON-PERSON,CITY,PROPN-PROPN-PROPN-PROPN,PROPN,compound-compound-compound-ROOT,pobj,NNP-NNP-NNP-NNP,NNP,4,1
10326,43407.0,29,met,9,21,3,-18,20,25,-12,-6,Raul Castro,Communist Party of Cuba,PERSON-PERSON,ORGANIZATION-ORGANIZATION-ORGANIZATION-ORGANIZATION,PROPN-PROPN,PROPN-PROPN-ADP-PROPN,pobj-compound,compound-pobj-prep-compound,NNP-NNP,NNP-NNP-IN-NNP,5,1
10327,43409.0,32,been,5,18,17,-1,17,14,-13,12,Ellen Degeneres,comedian,PERSON-PERSON,TITLE,PROPN-PROPN,NOUN,compound-pobj,compound,NNP-NNP,NN,1,1
10328,43426.0,38,expected,12,26,28,2,25,9,-14,16,ADB,China,ORGANIZATION,COUNTRY,PROPN,PROPN,poss,compound,NNP,NNP,2,1
10329,57634.0,16,be,2,13,15,2,12,0,-11,13,ADB,China,ORGANIZATION,COUNTRY,PROPN,PROPN,pobj,pobj,NNP,NNP,2,1
10330,43451.0,26,Service,2,24,18,-6,23,7,-22,16,Red Cross,Metropolitan Atlanta Chapter,ORGANIZATION-ORGANIZATION,ORGANIZATION-ORGANIZATION-ORGANIZATION,PROPN-PROPN,PROPN-PROPN-PROPN,compound-pobj,compound-compound-pobj,NNP-NNP,NNP-NNP-NNP,3,1
10331,43454.0,16,born,4,1,15,14,0,0,3,11,Jane Matilda Bolin,NY,PERSON-PERSON-PERSON,STATE_OR_PROVINCE,PROPN-PROPN-PROPN,PROPN,compound-compound-nsubjpass,appos,NNP-NNP-NNP,NNP,3,1
10332,43489.0,27,convicted,17,5,7,2,4,19,12,-10,her,Keith McDonald,PERSON,PERSON-PERSON,DET,PROPN-PROPN,poss,compound-appos,PRP$,NNP-NNP,1,1
10333,43493.0,55,told,11,1,4,3,0,50,10,-7,Mohamed ElBaradei,secretary-general,PERSON-PERSON,TITLE,PROPN-PROPN,NOUN,compound-nsubj,appos,NNP-NNP,NN,2,1
10334,43496.0,41,blasted,23,2,21,19,1,19,21,-2,Servicemembers Legal Defense Network,US,ORGANIZATION-ORGANIZATION-ORGANIZATION-ORGANIZATION,COUNTRY,PROPN-PROPN-PROPN-PROPN,PROPN,compound-compound-compound-nsubj,compound,NNPS-NNP-NNP-NNP,NNP,8,1
10335,43503.0,48,rose,42,6,19,13,5,28,36,-23,Roraback,Connecticut,PERSON,STATE_OR_PROVINCE,PROPN,PROPN,nsubj,pobj,NNP,NNP,2,1
10336,43517.0,32,told,28,30,28,-2,29,3,-2,0,Arsenal TV,Fabregas,ORGANIZATION-ORGANIZATION,PERSON,PROPN-PROPN,PROPN,compound-dobj,nsubj,NNP-NNP,NNP,1,1
10337,43525.0,21,was,4,9,7,-2,8,13,-5,3,John Kerry,Navy Lieutenant,PERSON-PERSON,TITLE-TITLE,PROPN-PROPN,PROPN-PROPN,compound-nsubj,compound-compound,NNP-NNP,NNP-NNP,1,1
10338,43527.0,32,has,2,7,13,6,6,18,-5,11,Samsung,Germany,ORGANIZATION,COUNTRY,PROPN,PROPN,pobj,pobj,NNP,NNP,4,1
10339,43540.0,22,took,16,2,9,7,1,12,14,-7,Chris Dodd,Foreign Relations Committee,PERSON-PERSON,ORGANIZATION-ORGANIZATION-ORGANIZATION,PROPN-PROPN,PROPN-PROPN-PROPN,compound-nsubj,compound-compound-pobj,NNP-NNP,NNP-NNPS-NNP,4,1
10340,43543.0,35,introduced,4,3,2,-1,2,32,1,-2,Carolyn Maloney,representative,PERSON-PERSON,TITLE,PROPN-PROPN,NOUN,compound-nsubj,compound,NNP-NNP,NN,1,1
10341,43545.0,36,ends,4,14,19,5,13,16,-10,15,Harry S Dent,political affairs aide,PERSON-PERSON-PERSON,TITLE-TITLE-TITLE,PROPN-PROPN-PROPN,ADJ-NOUN-NOUN,compound-compound-pobj,amod-compound-appos,NNP-NNP-NNP,JJ-NNS-NN,3,1
10342,43551.0,37,expanding,35,18,28,10,17,8,17,-7,Dan Abrams,entrepreneur,PERSON-PERSON,TITLE,PROPN-PROPN,NOUN,compound-nsubj,pobj,NNP-NNP,NN,5,1
10343,43561.0,43,said,29,38,31,-7,37,11,-9,2,ADB,Hideaki Iwasaki,ORGANIZATION,PERSON-PERSON,PROPN,PROPN-PROPN,poss,compound-nsubj,NNP,NNP-NNP,5,1
10344,43608.0,52,said,41,48,43,-5,47,8,-7,2,Servicemembers Legal Defense Network,Trevor Thomas,ORGANIZATION-ORGANIZATION-ORGANIZATION-ORGANIZATION,PERSON-PERSON,PROPN-PROPN-PROPN-PROPN,PROPN-PROPN,compound-compound-compound-pobj,compound-nsubj,NNP-NNP-NNP-NNP,NNP-NNP,4,1
10345,43609.0,50,was,7,7,19,12,6,30,0,12,Burns,NATO,PERSON,ORGANIZATION,PROPN,PROPN,nsubj,compound,NNP,NNP,1,1
10346,43618.0,51,be,8,32,30,-2,31,20,-24,22,Jennifer Dunn,House,PERSON-PERSON,ORGANIZATION,PROPN-PROPN,PROPN,compound-conj,compound,NNP-NNP,NNP,1,1
10347,48208.0,30,said,28,3,20,17,2,9,25,-8,Jennifer Dunn,House,PERSON-PERSON,ORGANIZATION,PROPN-PROPN,PROPN,compound-nsubj,nmod,NNP-NNP,NNP,6,1
10348,43625.0,56,presented,9,6,7,1,5,48,3,-2,International Crisis Group,Crisis Group,ORGANIZATION-ORGANIZATION-ORGANIZATION,ORGANIZATION-ORGANIZATION,PROPN-PROPN-PROPN,PROPN-PROPN,compound-compound-nsubj,compound-pobj,NNP-NNP-NNP,NNP-NNP,1,1
10349,43628.0,17,remain,9,8,14,6,7,2,1,5,he,chief legal analyst,PERSON,TITLE-TITLE-TITLE,PRON,ADJ-ADJ-NOUN,nsubj,amod-amod-attr,PRP,JJ-JJ-NN,3,1
10350,43641.0,32,Commenting,0,11,15,4,10,16,-11,15,SAC,Steven S. K. Chen,ORGANIZATION,PERSON-PERSON-PERSON-PERSON,PROPN,PROPN-PROPN-PROPN-PROPN,compound,compound-compound-compound-nsubj,NNP,NNP-NNP-NNP-NNP,-1,1
10351,43655.0,23,signed,2,1,11,10,0,11,1,9,Chante Moore,Peak Records,PERSON-PERSON,ORGANIZATION-ORGANIZATION,PROPN-PROPN,PROPN-PROPN,compound-nsubj,compound-appos,NNP-NNP,NNP-NNPS,3,1
10352,43661.0,17,organize,11,10,8,-2,9,8,1,-3,she,Cornell,PERSON,ORGANIZATION,PRON,PROPN,nsubj,pobj,PRP,NNP,2,1
10353,43673.0,19,happens,1,17,15,-2,16,3,-16,14,George Kennedy,President,PERSON-PERSON,TITLE,PROPN-PROPN,PROPN,compound-appos,pobj,NNP-NNP,NNP,2,1
10354,43678.0,40,conducted,3,9,18,9,8,21,-6,15,Tax Policy Center,Urban Institute,ORGANIZATION-ORGANIZATION-ORGANIZATION,ORGANIZATION-ORGANIZATION,PROPN-PROPN-PROPN,PROPN-PROPN,compound-compound-pobj,compound-pobj,NNP-NNP-NNP,NNP-NNP,4,1
10355,43696.0,43,had,3,35,25,-10,34,17,-32,22,NSG,UN,ORGANIZATION,ORGANIZATION,PROPN,PROPN,compound,nmod,NNP,NNP,3,1
10356,43707.0,21,known,3,1,9,8,0,11,2,6,She,Nickelodeon,PERSON,ORGANIZATION,PRON,PROPN,nsubjpass,compound,PRP,NNP,6,1
10357,43742.0,36,surprise,6,17,16,-1,16,19,-11,10,National Military Family Association,Virginia-based,ORGANIZATION-ORGANIZATION-ORGANIZATION-ORGANIZATION,STATE_OR_PROVINCE,PROPN-PROPN-PROPN-PROPN,PROPN,compound-compound-compound-pobj,compound,NNP-NNP-NNP-NNP,NNP,1,1
10358,43752.0,15,is,11,9,7,-2,8,7,2,-4,Bill McAllister,director,PERSON-PERSON,TITLE,PROPN-PROPN,NOUN,compound-appos,nsubj,NNP-NNP,NN,2,1
10359,55472.0,14,is,10,8,6,-2,7,7,2,-4,Bill McAllister,director,PERSON-PERSON,TITLE,PROPN-PROPN,NOUN,compound-appos,nsubj,NNP-NNP,NN,2,1
10360,43771.0,44,was,14,22,28,6,21,15,-8,14,Saint Anselm College,N.H.,ORGANIZATION-ORGANIZATION-ORGANIZATION,STATE_OR_PROVINCE,PROPN-PROPN-PROPN,PROPN,compound-compound-pobj,appos,NNP-NNP-NNP,NNP,7,1
10361,43774.0,20,dominated,3,6,18,12,5,1,-3,15,Jaguars,NFL,ORGANIZATION,ORGANIZATION,PROPN,PROPN,compound,compound,NNP,NNP,3,1
10362,43779.0,28,is,7,1,5,4,0,22,6,-2,His,Sadegh Larijani,PERSON,PERSON-PERSON,DET,PROPN-PROPN,poss,compound-appos,PRP$,NNP-NNP,2,1
10363,43790.0,52,retiring,5,1,20,19,0,31,4,15,Carnival Corp,Ted Arison,ORGANIZATION-ORGANIZATION,PERSON-PERSON,PROPN-PROPN,PROPN-PROPN,compound-dobj,compound-pobj,NNP-NNP,NNP-NNP,8,1
10364,43808.0,62,Dies,9,1,52,51,0,9,8,43,Roy Scheider,Glenn Scheider,PERSON-PERSON,PERSON-PERSON,PROPN-PROPN,PROPN-PROPN,compound-nsubj,compound-conj,NNP-NNP,NNP-NNP,7,1
10365,43813.0,28,said,12,10,1,-9,9,26,2,-11,MF Global,Nick Kalivas,ORGANIZATION-ORGANIZATION,PERSON-PERSON,PROPN-PROPN,PROPN-PROPN,compound-pobj,compound-nsubj,NNP-NNP,NNP-NNP,3,1
10366,45587.0,33,said,20,31,22,-9,30,10,-11,2,MF Global,Nick Kalivas,ORGANIZATION-ORGANIZATION,PERSON-PERSON,PROPN-PROPN,PROPN-PROPN,compound-pobj,compound-nsubj,NNP-NNP,NNP-NNP,7,1
10367,54606.0,43,said,30,41,32,-9,40,10,-11,2,MF Global,Nick Kalivas,ORGANIZATION-ORGANIZATION,PERSON-PERSON,PROPN-PROPN,PROPN-PROPN,compound-pobj,compound-nsubj,NNP-NNP,NNP-NNP,5,1
10368,56065.0,38,said,13,11,1,-10,10,36,2,-12,MF Global,Nick Kalivas,ORGANIZATION-ORGANIZATION,PERSON-PERSON,PROPN-PROPN,PROPN-PROPN,compound-pobj,compound-nsubj,NNP-NNP,NNP-NNP,3,1
10369,43816.0,56,got,36,1,29,28,0,26,35,-7,Richard H. Nolte,United Arab Republic,PERSON-PERSON-PERSON,LOCATION-LOCATION-LOCATION,PROPN-PROPN-PROPN,PROPN-PROPN-PROPN,compound-compound-nsubj,compound-compound-pobj,NNP-NNP-NNP,NNP-NNP-NNP,10,1
10370,43845.0,34,won,10,20,5,-15,19,28,-10,-5,M. Enkhbold,party,PERSON-PERSON,ORGANIZATION,PROPN-PROPN,NOUN,compound-dobj,pobj,NNP-NNP,NN,7,1
10371,43853.0,27,celebrated,12,4,2,-2,3,24,8,-10,Adam Senn,City,PERSON-PERSON,ORGANIZATION,PROPN-PROPN,PROPN,compound-nsubj,poss,NNP-NNP,NNP,2,1
10372,43857.0,30,said,28,3,11,8,2,18,25,-17,Jennifer Dunn,lawmaker,PERSON-PERSON,TITLE,PROPN-PROPN,NOUN,compound-nsubj,appos,NNP-NNP,NN,3,1
10373,43876.0,21,was,1,1,17,16,0,3,0,16,He,Garden City,PERSON,CITY-CITY,PRON,PROPN-PROPN,nsubj,compound-pobj,PRP,NNP-NNP,4,1
10374,43903.0,85,came,7,30,49,19,29,35,-23,42,John Mason,James `` Black James '' Fitch,PERSON-PERSON,PERSON-PERSON-PERSON-PERSON-PERSON-PERSON,PROPN-PROPN,PROPN-PUNCT-PROPN-PROPN-PUNCT-PROPN,compound-appos,nmod-punct-nmod-nmod-punct-pobj,NNP-NNP,NNP-``-NNP-NNP-''-NNP,-1,1
10375,43923.0,27,grew,4,1,18,17,0,8,3,14,Harry Shuler Dent,Presbyterian College,PERSON-PERSON-PERSON,ORGANIZATION-ORGANIZATION,PROPN-PROPN-PROPN,PROPN-PROPN,compound-compound-nsubj,compound-pobj,NNP-NNP-NNP,NNP-NNP,6,1
10376,43938.0,20,met,2,9,14,5,8,5,-7,12,M. Enkhbold,Parliament D. Lundeejantsan,PERSON-PERSON,ORGANIZATION-ORGANIZATION-ORGANIZATION,PROPN-PROPN,PROPN-PROPN-PROPN,compound-pobj,compound-compound-pobj,NNP-NNP,NNP-NNP-NNP,4,1
10377,43941.0,55,are,13,41,12,-29,40,42,-28,-1,Carolyn Maloney,Senate,PERSON-PERSON,ORGANIZATION,PROPN-PROPN,PROPN,compound-conj,compound,NNP-NNP,NNP,12,1
10378,43959.0,23,dies,4,2,4,2,1,18,2,0,KGB,Kryuchkov,ORGANIZATION,PERSON,PROPN,PROPN,compound,nsubj,NNP,NNP,2,1
10379,43966.0,22,increases,2,6,1,-5,5,20,-4,-1,DirecTV,Liberty Entertainment,ORGANIZATION,PERSON-PERSON,NOUN,PROPN-PROPN,pobj,compound-compound,NN,NNP-NNP,4,1
10380,43974.0,41,done,2,8,21,13,7,19,-6,19,Lindsay M. Hayes,29,PERSON-PERSON-PERSON,NUMBER,PROPN-PROPN-PROPN,NUM,compound-compound-pobj,nummod,NNP-NNP-NNP,CD,5,1
10381,43987.0,36,left,10,2,9,7,1,26,8,-1,DeBlanc,La.,PERSON,STATE_OR_PROVINCE,PROPN,PROPN,nsubj,appos,NNP,NNP,3,1
10382,43993.0,32,Last,1,14,18,4,13,13,-13,17,Jake Pavelka,that frigin idiot who picked Vienna over Tenley,PERSON-PERSON,PERSON-PERSON-PERSON-PERSON-PERSON-PERSON-PERSON-PERSON,PROPN-PROPN,DET-NOUN-NOUN-PRON-VERB-PROPN-ADP-PROPN,compound-ROOT,mark-compound-nsubj-nsubj-relcl-dobj-prep-compound,NNP-NNP,WDT-NN-NN-WP-VBD-NNP-IN-NNP,-1,1
10383,44001.0,51,died,40,1,42,41,0,8,39,2,Richard Nolte,Nov. 22,PERSON-PERSON,DATE-DATE,PROPN-PROPN,PROPN-NUM,compound-nsubj,npadvmod-nummod,NNP-NNP,NNP-CD,2,1
10384,44002.0,59,spend,35,29,2,-27,28,56,6,-33,Chris Simcox,Patriots,PERSON-PERSON,ORGANIZATION,PROPN-PROPN,PROPN,compound-pobj,poss,NNP-NNP,NNPS,14,1
10385,44004.0,55,testified,30,22,15,-7,21,39,8,-15,Michael Sandy,hate crimes,PERSON-PERSON,CRIMINAL_CHARGE-CRIMINAL_CHARGE,PROPN-PROPN,VERB-NOUN,compound-pobj,amod-compound,NNP-NNP,VB-NNS,6,1
10386,44020.0,23,was,4,1,6,5,0,16,3,2,Sills,chairwoman,PERSON,TITLE,NOUN,NOUN,nsubj,attr,NNS,NN,4,1
10387,56088.0,28,died,21,1,14,13,0,13,20,-7,Sills,chairwoman,PERSON,TITLE,NOUN,NOUN,nsubj,conj,NNS,NN,4,1
10388,44023.0,46,spent,10,33,18,-15,32,27,-23,8,her,administrator,PERSON,TITLE,PRON,NOUN,dative,pobj,PRP,NN,8,1
10389,44024.0,48,suspected,2,23,21,-2,22,26,-21,19,IRGC-QF,Corps-Quds,ORGANIZATION,ORGANIZATION,PROPN,PROPN,compound,attr,NNP,NNPS,2,1
10390,44034.0,34,is,1,10,18,8,9,15,-9,17,Inter-American Press Association,1940s,ORGANIZATION-ORGANIZATION-ORGANIZATION,DATE,ADJ-PROPN-PROPN,NOUN,amod-compound-nsubj,pobj,JJ-NNP-NNP,NNS,5,1
10391,44070.0,22,joined,6,5,10,5,4,11,1,4,Beyonce Knowles,Solange,PERSON-PERSON,PERSON,PROPN-PROPN,PROPN,compound-nsubj,appos,NNP-NNPS,NNP,4,1
10392,44098.0,34,said,9,7,1,-6,6,32,2,-8,Ali Khamenei,Iran nation,PERSON-PERSON,ORGANIZATION-ORGANIZATION,PROPN-PROPN,PROPN-NOUN,compound-appos,compound-pobj,NNP-NNP,NNP-NN,3,1
10393,44101.0,41,excels,1,15,10,-5,14,30,-14,9,NSC,National Council of Science,ORGANIZATION,ORGANIZATION-ORGANIZATION-ORGANIZATION-ORGANIZATION,PROPN,PROPN-PROPN-ADP-PROPN,compound,compound-appos-prep-pobj,NNP,NNP-NNP-IN-NNP,4,1
10394,44132.0,43,said,29,21,35,14,20,7,8,6,ANP,Afghan National Police,ORGANIZATION,ORGANIZATION-ORGANIZATION-ORGANIZATION,PROPN,PROPN-PROPN-PROPN,appos,compound-compound-conj,NNP,NNP-NNP-NNP,8,1
10395,54285.0,35,said,24,6,32,26,5,2,18,8,ANP,Afghan National Police,ORGANIZATION,ORGANIZATION-ORGANIZATION-ORGANIZATION,PROPN,PROPN-PROPN-PROPN,attr,compound-compound-pobj,NNP,NNP-NNP-NNP,8,1
10396,44158.0,63,hit,4,17,26,9,16,36,-13,22,her,US,PERSON,COUNTRY,DET,PROPN,poss,nmod,PRP$,NNP,7,1
10397,48900.0,36,said,33,19,1,-18,18,34,14,-32,her,US,PERSON,COUNTRY,DET,PROPN,poss,compound,PRP$,NNP,8,1
10398,55098.0,21,solicits,6,8,5,-3,7,15,-2,-1,her,US,PERSON,COUNTRY,DET,PROPN,poss,compound,PRP$,NNP,2,1
10399,44190.0,27,concluded,2,11,22,11,10,4,-9,20,First Group,London,ORGANIZATION-ORGANIZATION,CITY,PROPN-PROPN,PROPN,compound-nsubj,nmod,NNP-NNP,NNP,7,1
10400,44194.0,25,claims,2,2,2,0,1,22,0,0,ABA,ABA,ORGANIZATION,ORGANIZATION,PROPN,NOUN,nsubj,compound,NNP,NN,0,1
10401,44208.0,48,said,23,3,10,7,2,37,20,-13,Perle,defence policy board,PERSON,ORGANIZATION-ORGANIZATION-ORGANIZATION,PROPN,NOUN-NOUN-NOUN,nsubj,compound-compound-pobj,NNP,NN-NN-NN,5,1
10402,44212.0,19,told,2,13,1,-12,12,17,-11,-1,Konica Minolta Business Solutions,Martinelli,ORGANIZATION-ORGANIZATION-ORGANIZATION-ORGANIZATION,PERSON,PROPN-PROPN-PROPN-PROPN,PROPN,compound-compound-compound-compound,nsubjpass,NNP-NNP-NNP-NNPS,NNP,8,1
10403,44222.0,22,supplied,6,13,12,-1,12,9,-7,6,Richard Perle,secretary,PERSON-PERSON,TITLE,PROPN-PROPN,NOUN,compound-pobj,compound,NNP-NNP,NN,1,1
10404,44232.0,29,accompanied,6,10,4,-6,9,24,-4,-2,his,Barbara,PERSON,PERSON,DET,PROPN,poss,appos,PRP$,NNP,3,1
10405,44235.0,10,was,2,1,6,5,0,3,1,4,Robert McNair,South Carolina,PERSON-PERSON,STATE_OR_PROVINCE-STATE_OR_PROVINCE,PROPN-PROPN,PROPN-PROPN,compound-nsubj,compound-pobj,NNP-NNP,NNP-NNP,4,1
10406,47001.0,47,-LRB-,4,3,6,3,2,40,1,2,Robert McNair,South Carolina,PERSON-PERSON,STATE_OR_PROVINCE-STATE_OR_PROVINCE,PROPN-PROPN,PROPN-PROPN,compound-compound,compound-compound,NNP-NNP,NNP-NNP,3,1
10407,49878.0,12,McNair,1,1,6,5,0,5,0,5,Robert McNair,South Carolina,PERSON-PERSON,STATE_OR_PROVINCE-STATE_OR_PROVINCE,PROPN-PROPN,PROPN-PROPN,compound-ROOT,compound-pobj,NNP-NNP,NNP-NNP,3,1
10408,63473.0,14,Dies,11,1,6,5,0,7,10,-5,Robert McNair,South Carolina,PERSON-PERSON,STATE_OR_PROVINCE-STATE_OR_PROVINCE,PROPN-PROPN,PROPN-PROPN,compound-nsubj,compound-pobj,NNP-NNP,NNP-NNP,3,1
10409,44237.0,37,told,13,12,16,4,11,20,1,3,Paul Watson,Associated Press,PERSON-PERSON,ORGANIZATION-ORGANIZATION,PROPN-PROPN,PROPN-PROPN,compound-nsubj,compound-dobj,NNP-NNP,NNP-NNP,4,1
10410,44245.0,35,said,14,16,22,6,15,12,-2,8,Bond,the University of Virginia and American University,PERSON,ORGANIZATION-ORGANIZATION-ORGANIZATION-ORGANIZATION-ORGANIZATION-ORGANIZATION-ORGANIZATION,PROPN,DET-PROPN-ADP-PROPN-CCONJ-PROPN-PROPN,nsubj,det-pobj-prep-pobj-cc-compound-conj,NNP,DT-NNP-IN-NNP-CC-NNP-NNP,4,1
10411,44249.0,47,was,2,26,46,20,25,0,-24,44,Kurt Waldheim,Yugoslavia,PERSON-PERSON,COUNTRY,PROPN-PROPN,PROPN,compound-pobj,pobj,NNP-NNP,NNP,7,1
10412,44250.0,41,KYOTO,0,25,33,8,24,7,-25,33,Asian Development Bank,1966,ORGANIZATION-ORGANIZATION-ORGANIZATION,DATE,PROPN-PROPN-PROPN,NUM,compound-compound-pobj,pobj,NNP-NNP-NNP,CD,2,1
10413,44257.0,21,born,4,1,6,5,0,14,3,2,Augustus Freeman Hawkins,"Aug. 31 , 1907",PERSON-PERSON-PERSON,DATE-DATE-DATE-DATE,PROPN-PROPN-PROPN,PROPN-NUM-PUNCT-NUM,compound-compound-nsubjpass,npadvmod-nummod-punct-nummod,NNP-NNP-NNP,"NNP-CD-,-CD",4,1
10414,44265.0,68,In,0,25,30,5,24,37,-25,30,Juliette Binoche,puppeteer,PERSON-PERSON,TITLE,PROPN-PROPN,NOUN,compound-compound,nmod,NNP-NNP,NN,4,1
10415,44282.0,21,is,2,1,9,8,0,11,1,7,The park,Hong Kong government,ORGANIZATION-ORGANIZATION,ORGANIZATION-ORGANIZATION-ORGANIZATION,DET-NOUN,PROPN-PROPN-NOUN,det-nsubj,compound-compound-pobj,DT-NN,NNP-NNP-NN,6,1
10416,44283.0,26,Season,0,18,21,3,17,4,-18,21,her,Ryan,PERSON,PERSON,DET,PROPN,poss,appos,PRP$,NNP,4,1
10417,44285.0,34,said,1,1,10,9,0,23,0,9,Samsung,Lee Hak-Soo,ORGANIZATION,PERSON-PERSON,PROPN,PROPN-PROPN,nsubj,compound-pobj,NNP,NNP-NNP,5,1
10418,45093.0,22,chief,1,1,14,13,0,7,0,13,Samsung,Lee Hak-Soo,ORGANIZATION,PERSON-PERSON,ADJ,PROPN-PROPN,amod,compound-dobj,JJ,NNP-NNP,4,1
10419,48698.0,50,summoned,4,1,14,13,0,35,3,10,Samsung,Lee Hak-Soo,ORGANIZATION,PERSON-PERSON,PROPN,PROPN-PROPN,amod,compound-appos,NNP,NNP-NNP,5,1
10420,44286.0,34,born,4,1,9,8,0,24,3,5,Philip Mayer Kaiser,NY,PERSON-PERSON-PERSON,NATIONALITY,PROPN-PROPN-PROPN,PROPN,compound-compound-nsubjpass,appos,NNP-NNP-NNP,NNP,3,1
10421,44322.0,53,said,33,45,40,-5,44,12,-12,7,Justice and Equality Movement,Tejeddine Niem,ORGANIZATION-ORGANIZATION-ORGANIZATION-ORGANIZATION,PERSON-PERSON,PROPN-CCONJ-PROPN-PROPN,PROPN-PROPN,nmod-cc-compound-conj,compound-pobj,NNP-CC-NNP-NNP,NNP-NNP,6,1
10422,44327.0,36,said,33,5,2,-3,4,33,28,-31,ANP,National Police,ORGANIZATION,ORGANIZATION-ORGANIZATION,PROPN,PROPN-PROPN,compound,compound-compound,NNP,NNP-NNPS,2,1
10423,44349.0,51,was,5,4,8,4,3,42,1,3,Abu Zubaydah,smuggler,PERSON-PERSON,TITLE,PROPN-PROPN,NOUN,compound-nsubj,attr,NNP-NNP,NN,3,1
10424,44358.0,44,arrives,5,4,40,36,3,3,1,35,Frankie Delgado,Beverly Hills,PERSON-PERSON,CITY-CITY,PROPN-PROPN,PROPN-PROPN,compound-nsubj,compound-pobj,NNP-NNP,NNP-NNP,-1,1
10425,44359.0,33,booked,12,24,27,3,23,5,-12,15,Cathleen Black,president,PERSON-PERSON,TITLE,PROPN-PROPN,NOUN,compound-dobj,appos,NNP-NNP,NN,2,1
10426,44364.0,14,was,1,1,5,4,0,8,0,4,Watson,Greenpeace,PERSON,ORGANIZATION,PROPN,PROPN,nsubj,pobj,NNP,NNP,3,1
10427,44377.0,36,said,18,20,25,5,19,10,-2,7,Mahmood Shah,brigadier general,PERSON-PERSON,TITLE-TITLE,PROPN-PROPN,NOUN-ADJ,compound-nsubj,compound-appos,NNP-NNP,NN-JJ,1,1
10428,44383.0,41,Officials,0,8,26,18,7,14,-8,26,MAC,China,ORGANIZATION,COUNTRY,PROPN,PROPN,compound,poss,NNP,NNP,11,1
10429,44407.0,43,Committee,10,13,2,-11,12,40,-3,-8,TACC,International Atomic Energy Agency 's Technical Assistance and Cooperation Committee,ORGANIZATION,ORGANIZATION-ORGANIZATION-ORGANIZATION-ORGANIZATION-ORGANIZATION-ORGANIZATION-ORGANIZATION-ORGANIZATION-ORGANIZATION-ORGANIZATION,PROPN,PROPN-PROPN-PROPN-PROPN-PART-PROPN-PROPN-CCONJ-PROPN-PROPN,compound,compound-compound-compound-poss-case-nmod-nmod-cc-conj-ROOT,NNP,NNP-NNP-NNP-NNP-POS-NNP-NNP-CC-NNP-NNP,4,1
10430,52888.0,39,Talks,0,15,4,-11,14,34,-15,4,TACC,International Atomic Energy Agency 's Technical Assistance and Cooperation Committee,ORGANIZATION,ORGANIZATION-ORGANIZATION-ORGANIZATION-ORGANIZATION-ORGANIZATION-ORGANIZATION-ORGANIZATION-ORGANIZATION-ORGANIZATION-ORGANIZATION,PROPN,PROPN-PROPN-PROPN-PROPN-PART-PROPN-PROPN-CCONJ-PROPN-PROPN,compound,compound-compound-compound-poss-case-nmod-nmod-cc-conj-pobj,NNP,NNP-NNP-NNP-NNP-POS-NNP-NNP-CC-NNP-NNP,6,1
10431,56835.0,29,Committee,10,13,2,-11,12,26,-3,-8,TACC,International Atomic Energy Agency 's Technical Assistance and Cooperation Committee,ORGANIZATION,ORGANIZATION-ORGANIZATION-ORGANIZATION-ORGANIZATION-ORGANIZATION-ORGANIZATION-ORGANIZATION-ORGANIZATION-ORGANIZATION-ORGANIZATION,PROPN,PROPN-PROPN-PROPN-PROPN-PART-PROPN-PROPN-CCONJ-PROPN-PROPN,compound,compound-compound-compound-poss-case-nmod-nmod-cc-conj-ROOT,NNP,NNP-NNP-NNP-NNP-POS-NNP-NNP-CC-NNP-NNP,6,1
10432,58726.0,43,said,41,20,9,-11,19,33,21,-32,TACC,International Atomic Energy Agency 's Technical Assistance and Cooperation Committee,ORGANIZATION,ORGANIZATION-ORGANIZATION-ORGANIZATION-ORGANIZATION-ORGANIZATION-ORGANIZATION-ORGANIZATION-ORGANIZATION-ORGANIZATION-ORGANIZATION,PROPN,PROPN-PROPN-PROPN-PROPN-PART-PROPN-PROPN-CCONJ-PROPN-PROPN,compound,compound-compound-compound-poss-case-nmod-nmod-cc-conj-pobj,NNP,NNP-NNP-NNP-NNP-POS-NNP-NNP-CC-NNP-NNP,7,1
10433,44414.0,19,is,3,12,17,5,11,1,-9,14,Beyoncé Knowles,Tina Knowles,PERSON-PERSON,PERSON-PERSON,PROPN-PROPN,PROPN-PROPN,compound-pobj,compound-conj,NNP-NNPS,NNP-NNPS,3,1
10434,44427.0,21,run,3,1,6,5,0,14,2,3,Lashkar-e-Taiba,Qari Abdul Wahid Kashmiri,ORGANIZATION,PERSON-PERSON-PERSON-PERSON,PROPN,PROPN-PROPN-PROPN-PROPN,nsubjpass,compound-compound-compound-pobj,NNP,NNP-NNP-NNP-NNP,2,1
10435,44430.0,28,said,2,5,8,3,4,19,-3,6,Glover,advocate,PERSON,TITLE,PROPN,NOUN,nsubj,appos,NNP,NN,3,1
10436,44440.0,40,said,38,1,15,14,0,24,37,-23,Beverly Sills,American,PERSON-PERSON,NATIONALITY,PROPN-PROPN,ADJ,compound-nsubj,amod,NNP-NNP,JJ,6,1
10437,48423.0,60,says,11,3,32,29,2,27,8,21,Beverly Sills,American,PERSON-PERSON,NATIONALITY,PROPN-PROPN,ADJ,compound-nsubj,amod,NNP-NNP,JJ,8,1
10438,44469.0,30,received,24,12,10,-2,11,19,12,-14,Forsberg,5-year-old,PERSON,DURATION,PROPN,NUM,nsubj,pobj,NNP,CD,3,1
10439,44479.0,37,announced,9,24,18,-6,23,18,-15,9,Christopher J. Dodd,U.S. Senate,PERSON-PERSON-PERSON,ORGANIZATION-ORGANIZATION,PROPN-PROPN-PROPN,PROPN-PROPN,compound-compound-pobj,compound-compound,NNP-NNP-NNP,NNP-NNP,5,1
10440,49845.0,44,CT-SENATE-DODD,0,8,29,21,7,14,-8,29,Christopher J. Dodd,U.S. Senate,PERSON-PERSON-PERSON,ORGANIZATION-ORGANIZATION,PROPN-PROPN-PROPN,PROPN-PROPN,compound-compound-nsubj,compound-pobj,NNP-NNP-NNP,NNP-NNP,-1,1
10441,44484.0,86,Dead,6,5,9,4,4,76,1,3,Vernon Bellecourt,75,PERSON-PERSON,NUMBER,PROPN-PROPN,NUM,compound-compound,nummod,NNP-NNP,CD,4,1
10442,44507.0,49,died,39,1,46,45,0,2,38,7,Harry Shuler Dent,Columbia,PERSON-PERSON-PERSON,CITY,PROPN-PROPN-PROPN,PROPN,compound-compound-nsubj,pobj,NNP-NNP-NNP,NNP,3,1
10443,44514.0,49,received,6,8,13,5,7,35,-2,7,his,Louisiana State University,PERSON,ORGANIZATION-ORGANIZATION-ORGANIZATION,DET,PROPN-PROPN-PROPN,poss,compound-compound-pobj,PRP$,NNP-NNP-NNP,4,1
10444,44521.0,16,built,5,7,3,-4,6,12,-2,-2,her,44,PERSON,NUMBER,DET,NUM,poss,appos,PRP$,CD,2,1
10445,44531.0,25,entered,9,9,4,-5,8,20,0,-5,he,Notre Dame,PERSON,ORGANIZATION-ORGANIZATION,PRON,PROPN-PROPN,nsubj,compound-pobj,PRP,NNP-NNP,4,1
10446,44544.0,32,seem,18,1,1,0,0,30,17,-17,Trista Sutter,Trista Stutter,PERSON-PERSON,PERSON-PERSON,PROPN-PROPN,PROPN-PROPN,compound-compound,compound-pobj,NNP-NNP,NNP-NNP,0,1
10447,44555.0,56,said,16,8,7,-1,7,48,8,-9,Abdullahi Hassan Garweyne,Col,PERSON-PERSON-PERSON,TITLE,PROPN-PROPN-PROPN,PROPN,compound-compound-conj,compound,NNP-NNP-NNP,NNP,3,1
10448,58759.0,49,said,10,2,1,-1,1,47,8,-9,Abdullahi Hassan Garweyne,Col,PERSON-PERSON-PERSON,TITLE,PROPN-PROPN-PROPN,PROPN,compound-compound-nsubj,compound,NNP-NNP-NNP,NNP,2,1
10449,44569.0,40,meant,16,6,21,15,5,18,10,5,Obamas,Democrats,ORGANIZATION,IDEOLOGY,PROPN,PROPN,poss,poss,NNP,NNPS,11,1
10450,44593.0,38,are,8,14,10,-4,13,27,-6,2,Professional Rodeo Cowboys Association,B.J. Schumacher,ORGANIZATION-ORGANIZATION-ORGANIZATION-ORGANIZATION,PERSON-PERSON,PROPN-PROPN-PROPN-PROPN,PROPN-PROPN,compound-compound-compound-poss,compound-nsubj,NNP-NNP-NNPS-NNP,NNP-NNP,4,1
10451,44594.0,30,expect,12,19,27,8,18,2,-7,15,National Action Network,Florida,ORGANIZATION-ORGANIZATION-ORGANIZATION,STATE_OR_PROVINCE,PROPN-PROPN-PROPN,PROPN,compound-compound-compound,appos,NNP-NNP-NNP,NNP,8,1
10452,44607.0,55,said,43,19,11,-8,18,43,24,-32,Muslim bloc,57,ORGANIZATION-ORGANIZATION,NUMBER,PROPN-NOUN,NUM,compound-pobj,nummod,NNP-NN,CD,4,1
10453,44637.0,52,said,50,19,13,-6,18,38,31,-37,Central American Parliament,El Salvador,ORGANIZATION-ORGANIZATION-ORGANIZATION,ORGANIZATION-ORGANIZATION,ADJ-PROPN-PROPN,PROPN-PROPN,compound-compound-pobj,compound-poss,JJ-NNP-NNP,NNP-NNP,4,1
10454,44639.0,34,was,1,13,16,3,12,17,-12,15,Jamaat,Imam Yasin Abu Bakr,ORGANIZATION,PERSON-PERSON-PERSON-PERSON,PROPN,PROPN-PROPN-PROPN-PROPN,compound,compound-compound-compound-appos,NNP,NNP-NNP-NNP-NNP,2,1
10455,44642.0,46,have,1,9,8,-1,8,37,-8,7,Steve McPherson,exec,PERSON-PERSON,TITLE,PROPN-PROPN,NOUN,compound-dobj,compound,NNP-NNP,NN,1,1
10456,44667.0,30,has,18,1,24,23,0,5,17,6,Remy Ma,gang assault,PERSON-PERSON,CRIMINAL_CHARGE-CRIMINAL_CHARGE,PROPN-PROPN,NOUN-NOUN,compound-nsubj,compound-pobj,NNP-NNP,NN-NN,4,1
10457,44672.0,63,said,57,57,48,-9,56,14,0,-9,banks,Tajikistan,ORGANIZATION,ORGANIZATION,NOUN,PROPN,nsubj,conj,NNS,NNP,18,1
10458,44681.0,37,announced,2,31,1,-30,30,35,-29,-1,Alcatel SA,Alcatel-Lucent,ORGANIZATION-ORGANIZATION,ORGANIZATION,PROPN-PROPN,ADJ,compound-pobj,nsubj,NNP-NNP,JJ,8,1
10459,44693.0,52,took,5,41,2,-39,40,49,-36,-3,she,attorney general,PERSON,TITLE-TITLE,PRON,NOUN-NOUN,nsubj,compound-pobj,PRP,NN-NN,9,1
10460,44697.0,50,said,20,47,39,-8,46,10,-27,19,International Monetary Fund,Michel Camdessus,ORGANIZATION-ORGANIZATION-ORGANIZATION,PERSON-PERSON,PROPN-PROPN-PROPN,PROPN-PROPN,compound-compound-pobj,compound-conj,NNP-NNP-NNP,NNP-NNP,4,1
10461,44699.0,40,said,33,7,12,5,6,27,26,-21,AAA,Mosley,ORGANIZATION,PERSON,PROPN,PROPN,nsubj,pobj,NNP,NNP,3,1
10462,44730.0,39,said,5,7,2,-5,6,36,-2,-3,he,coroner,PERSON,TITLE,PRON,NOUN,nsubjpass,compound,PRP,NN,4,1
10463,44734.0,18,landed,2,11,8,-3,10,9,-9,6,he,Minn.,PERSON,STATE_OR_PROVINCE,PRON,PROPN,nsubj,appos,PRP,NNP,2,1
10464,44737.0,36,helped,15,15,6,-9,14,29,0,-9,Morgenthau,judge,PERSON,TITLE,PROPN,NOUN,nsubj,dobj,NNP,NN,5,1
10465,44757.0,32,been,3,14,6,-8,13,25,-11,3,she,fashion designer,PERSON,TITLE-TITLE,PRON,NOUN-NOUN,nsubj,compound-attr,PRP,NN-NN,3,1
10466,44762.0,43,died,10,1,9,8,0,33,9,-1,Scheider,N.Y.,PERSON,STATE_OR_PROVINCE,PROPN,PROPN,nsubj,appos,NNP,NNP,2,1
10467,48315.0,28,been,5,4,27,23,3,0,1,22,Scheider,N.Y.,PERSON,STATE_OR_PROVINCE,PROPN,PROPN,nsubj,npadvmod,NNP,NNP,2,1
10468,44764.0,63,know,22,62,52,-10,61,10,-40,30,Millender-McDonald,House,PERSON,ORGANIZATION,PROPN,PROPN,pobj,pobj,NNP,NNP,12,1
10469,44765.0,23,is,4,4,11,7,3,11,0,7,CNAC,China National Aviation Holdings Company,ORGANIZATION,ORGANIZATION-ORGANIZATION-ORGANIZATION-ORGANIZATION-ORGANIZATION,PROPN,PROPN-PROPN-PROPN-PROPN-PROPN,nsubj,compound-compound-compound-compound-appos,NNP,NNP-NNP-NNP-NNPS-NNP,3,1
10470,44769.0,34,said,18,26,32,6,25,1,-8,14,Multidisciplinary Association for Psychedelic Studies,Santa Cruz,ORGANIZATION-ORGANIZATION-ORGANIZATION-ORGANIZATION-ORGANIZATION,CITY-CITY,PROPN-PROPN-ADP-PROPN-PROPN,PROPN-PROPN,compound-pobj-prep-compound-pobj,compound-pobj,NNP-NNP-IN-NNP-NNPS,NNP-NNP,4,1
10471,44770.0,29,launched,5,1,4,3,0,24,4,-1,OIC,Hamid Algabid,ORGANIZATION,PERSON-PERSON,PROPN,PROPN-PROPN,compound,compound-nsubj,NNP,NNP-NNP,2,1
10472,44771.0,35,forced,7,20,17,-3,19,17,-13,10,Gholam Ali Hadad Adel,Iranian,PERSON-PERSON-PERSON-PERSON,NATIONALITY,PROPN-PROPN-PROPN-PROPN,ADJ,compound-compound-compound-appos,amod,NNP-NNP-NNP-NNP,JJ,5,1
10473,44779.0,18,said,1,1,17,16,0,0,0,16,Carson,Islam,PERSON,RELIGION,PROPN,PROPN,nsubj,pobj,NNP,NNP,1,1
10474,44796.0,24,-LRB-,3,1,5,4,0,18,2,2,Royal Caribbean,RCL,ORGANIZATION-ORGANIZATION,ORGANIZATION,ADJ-ADJ,PROPN,compound-compound,compound,JJ-JJ,NNP,2,1
10475,44798.0,24,said,21,18,20,2,17,3,3,-1,ABA,Karen Mathis,ORGANIZATION,PERSON-PERSON,NOUN,PROPN-PROPN,compound,compound-nsubj,NN,NNP-NNP,3,1
10476,44802.0,47,greeted,6,10,11,1,9,35,-4,5,his,Tehran,PERSON,LOCATION,DET,PROPN,poss,compound,PRP$,NNP,2,1
10477,44816.0,45,movie,2,31,29,-2,30,15,-29,27,Ellen DeGeneres,star,PERSON-PERSON,TITLE,PROPN-PROPN,NOUN,compound-ROOT,ROOT,NNP-NNP,NN,1,1
10478,67073.0,13,is,2,1,5,4,0,7,1,3,Ellen DeGeneres,star,PERSON-PERSON,TITLE,PROPN-PROPN,NOUN,compound-nsubj,attr,NNP-NNP,NN,4,1
10479,44822.0,13,died,9,2,6,4,1,6,7,-3,DeBlanc,Louise B. DeBlanc,PERSON,PERSON-PERSON-PERSON,PROPN,PROPN-PROPN-PROPN,poss,compound-compound-appos,NNP,NNP-NNP-NNP,3,1
10480,44823.0,34,received,7,20,26,6,19,7,-13,19,him,Mexican,PERSON,NATIONALITY,PRON,ADJ,pobj,amod,PRP,JJ,2,1
10481,44839.0,56,echoes,8,54,20,-34,53,35,-46,12,Johnny Knoxville,Warner,PERSON-PERSON,ORGANIZATION,PROPN-PROPN,PROPN,compound-pobj,nsubj,NNP-NNP,NNP,10,1
10482,44855.0,25,were,19,1,9,8,0,15,18,-10,Highland Capital Partners,Massachusetts,ORGANIZATION-ORGANIZATION-ORGANIZATION,STATE_OR_PROVINCE,PROPN-PROPN-PROPN,PROPN,compound-compound-nsubj,compound,NNP-NNP-NNPS,NNP,5,1
10483,44856.0,40,tried,9,8,17,9,7,22,1,8,Yolanda King,artist,PERSON-PERSON,TITLE,PROPN-PROPN,NOUN,compound-nsubj,pobj,NNP-NNP,NN,5,1
10484,44865.0,24,went,5,5,20,15,4,3,0,15,Boyle,Scotland,PERSON,COUNTRY,PROPN,PROPN,nsubj,pobj,NNP,NNP,1,1
10485,57789.0,11,born,2,1,10,9,0,0,1,8,Boyle,Scotland,PERSON,COUNTRY,PROPN,PROPN,nsubjpass,appos,NNP,NNP,2,1
10486,44869.0,32,charged,2,1,8,7,0,23,1,6,McInerney,first degree murder,PERSON,CRIMINAL_CHARGE-CRIMINAL_CHARGE-CRIMINAL_CHARGE,PROPN,ADJ-NOUN-NOUN,nsubjpass,amod-compound-pobj,NNP,JJ-NN-NN,6,1
10487,44877.0,16,Name,5,11,11,0,10,4,-6,6,Shah Mahmood,Shah Murtada,PERSON-PERSON,PERSON-PERSON,PROPN-PROPN,PROPN-PROPN,compound-pobj,compound-pobj,NNP-NNP,NNP-NNP,0,1
10488,44886.0,36,survived,12,11,30,19,10,5,1,18,Forsberg,Katarina Forsberg,PERSON,PERSON-PERSON,PROPN,PROPN-PROPN,nsubjpass,compound-appos,NNP,NNP-NNP,5,1
10489,67276.0,35,survived,12,11,30,19,10,4,1,18,Forsberg,Katarina Forsberg,PERSON,PERSON-PERSON,PROPN,PROPN-PROPN,nsubjpass,compound-appos,NNP,NNP-NNP,6,1
10490,44893.0,37,died,26,2,11,9,1,25,24,-15,Parren J Mitchell,Congress,PERSON-PERSON-PERSON,ORGANIZATION,PROPN-PROPN-PROPN,PROPN,compound-compound-nsubj,pobj,NNP-NNP-NNP,NNP,4,1
10491,44907.0,36,determined,3,17,10,-7,16,25,-14,7,Samsung,Lee Byung,ORGANIZATION,PERSON-PERSON,PROPN,PROPN-PROPN,amod,compound-compound,NNP,NNP-NNP,4,1
10492,44909.0,40,pay,16,7,38,31,6,1,9,22,Johnny Knoxville,unjust enrichment,PERSON-PERSON,CRIMINAL_CHARGE-CRIMINAL_CHARGE,PROPN-PROPN,ADJ-NOUN,compound-nsubj,amod-conj,NNP-NNP,JJ-NN,6,1
10493,44917.0,35,went,12,7,11,4,6,23,5,-1,Canadian National Railways,CN,ORGANIZATION-ORGANIZATION-ORGANIZATION,MISC,PROPN-PROPN-PROPN,PROPN,compound-compound-compound,compound,NNP-NNP-NNPS,NNP,3,1
10494,44932.0,62,said,55,19,12,-7,18,49,36,-43,IRGC-QF,Iranian Revolutionary Guard,ORGANIZATION,ORGANIZATION-ORGANIZATION-ORGANIZATION,PROPN,ADJ-PROPN-PROPN,compound,compound-compound-pobj,NNP,JJ-NNP-NNP,6,1
10495,44936.0,13,In,0,4,12,8,3,0,-4,12,Frankie Delgado,Aura,PERSON-PERSON,LOCATION,PROPN-PROPN,PROPN,compound-nsubj,pobj,NNP-NNP,NNP,2,1
10496,44979.0,40,meet,2,1,27,26,0,12,1,25,Nuclear Supplier Group,US,ORGANIZATION-ORGANIZATION-ORGANIZATION,ORGANIZATION,PROPN-PROPN-PROPN,PROPN,compound-compound-ROOT,compound,NNP-NNP-NNP,NNP,-1,1
10497,44982.0,31,is,10,1,18,17,0,12,9,8,Dodd,Democratic National Committee,PERSON,ORGANIZATION-ORGANIZATION-ORGANIZATION,ADV,PROPN-PROPN-PROPN,nsubj,compound-compound-pobj,RB,NNP-NNP-NNP,6,1
10498,45002.0,38,said,1,35,31,-4,34,6,-34,30,Bernama,national news agency,ORGANIZATION,ORGANIZATION-ORGANIZATION-ORGANIZATION,PROPN,ADJ-NOUN-NOUN,appos,amod-compound-nsubj,NNP,JJ-NN-NN,2,1
10499,45006.0,17,confirmed,3,8,2,-6,7,14,-5,-1,Spencer,NBC,PERSON,ORGANIZATION,PROPN,PROPN,conj,compound,NNP,NNP,4,1
10500,45007.0,23,gathered,1,6,13,7,5,9,-5,12,Yolanda `` Yoki '' Denise King,the Rev,PERSON-PERSON-PERSON-PERSON-PERSON-PERSON,PERSON-PERSON,PROPN-PUNCT-PROPN-PUNCT-PROPN-PROPN,DET-PROPN,nmod-punct-nmod-punct-compound-dobj,det-appos,NNP-``-NNP-''-NNP-NNP,DT-NNP,5,1
10501,45012.0,46,Party,3,11,9,-2,10,36,-8,6,Shah Mahmood Quraishi,president,PERSON-PERSON-PERSON,TITLE,PROPN-PROPN-PROPN,NOUN,compound-compound-appos,nsubjpass,NNP-NNP-NNP,NN,3,1
10502,45024.0,41,was,2,27,31,4,26,9,-25,29,her,Dennis Dunn,PERSON,PERSON-PERSON,DET,PROPN-PROPN,poss,compound-appos,PRP$,NNP-NNP,3,1
10503,45028.0,46,died,36,1,44,43,0,1,35,8,Beverly Sills,New York,PERSON-PERSON,STATE_OR_PROVINCE-STATE_OR_PROVINCE,PROPN-PROPN,PROPN-PROPN,compound-nsubj,compound-pobj,NNP-NNP,NNP-NNP,4,1
10504,45034.0,36,means,7,1,26,25,0,9,6,19,Vernon Bellecourt,spokesman,PERSON-PERSON,TITLE,PROPN-PROPN,NOUN,compound-nsubj,attr,NNP-NNP,NN,4,1
10505,45044.0,49,are,1,22,23,1,21,25,-21,22,Red Sox,Sox,ORGANIZATION-ORGANIZATION,ORGANIZATION,PROPN-PROPN,PROPN,compound-pobj,poss,NNP-NNPS,NNPS,1,1
10506,45052.0,51,said,38,46,40,-6,45,10,-8,2,Federal Motor Carrier Safety Administration,Ian Grossman,ORGANIZATION-ORGANIZATION-ORGANIZATION-ORGANIZATION-ORGANIZATION,PERSON-PERSON,PROPN-PROPN-PROPN-PROPN-PROPN,PROPN-PROPN,compound-compound-compound-compound-pobj,compound-nsubj,NNP-NNP-NNP-NNP-NNP,NNP-NNP,5,1
10507,45068.0,73,FUNDRAISING,3,24,29,5,23,43,-21,26,National Republican Campaign Committee,NRCC,ORGANIZATION-ORGANIZATION-ORGANIZATION-ORGANIZATION,ORGANIZATION,PROPN-PROPN-PROPN-PROPN,PROPN,compound-compound-compound-appos,compound,NNP-NNP-NNP-NNP,NNP,5,1
10508,45078.0,39,CITY,1,7,9,2,6,29,-6,8,FMF,Disciplinary Commission,ORGANIZATION,ORGANIZATION-ORGANIZATION,PROPN,PROPN-PROPN,poss,compound-nsubj,NNP,NNP-NNP,-1,1
10509,54364.0,34,ruled,5,2,4,2,1,29,3,-1,FMF,Disciplinary Commission,ORGANIZATION,ORGANIZATION-ORGANIZATION,PROPN,PROPN-PROPN,poss,compound-nsubj,NNP,NNP-NNP,2,1
10510,45083.0,26,watching,2,14,13,-1,13,12,-12,11,United National Congress,Indian-dominated,ORGANIZATION-ORGANIZATION-ORGANIZATION,MISC,PROPN-PROPN-PROPN,ADJ,compound-compound-pobj,amod,NNP-NNP-NNP,JJ,1,1
10511,45084.0,23,Millender-McDonald,0,1,16,15,0,6,-1,16,Millender-McDonald,congresswoman,PERSON,TITLE,PROPN,NOUN,ROOT,pobj,NNP,NN,6,1
10512,61963.0,7,congresswoman,2,4,3,-1,3,3,-2,1,Millender-McDonald,congresswoman,PERSON,TITLE,PROPN,NOUN,nsubj,ROOT,NNP,NN,2,1
10513,45109.0,25,was,5,5,7,2,4,17,0,2,Nolte,director,PERSON,TITLE,PROPN,NOUN,nsubj,attr,NNP,NN,2,1
10514,58802.0,25,said,21,15,17,2,14,7,6,-4,Nolte,director,PERSON,TITLE,PROPN,NOUN,dobj,pobj,NNP,NN,3,1
10515,45131.0,27,served,7,7,10,3,6,16,0,3,Verity,chairman,PERSON,TITLE,PROPN,NOUN,nsubj,pobj,NNP,NN,3,1
10516,45138.0,30,taken,20,12,8,-4,11,21,8,-12,Awami League,Zia,ORGANIZATION-ORGANIZATION,PERSON,PROPN-PROPN,PROPN,compound-conj,pobj,NNP-NNP,NNP,3,1
10517,45139.0,32,listed,21,6,2,-4,5,29,15,-19,Kendra Wilkinson,model,PERSON-PERSON,TITLE,PROPN-PROPN,NOUN,compound-appos,nsubjpass,NNP-NNP,NN,2,1
10518,45142.0,33,dies,11,1,5,4,0,27,10,-6,Richmond Flowers,Alabama,PERSON-PERSON,STATE_OR_PROVINCE,PROPN-PROPN,PROPN,compound-nsubj,compound,NNP-NNP,NNP,2,1
10519,52373.0,32,died,30,5,2,-3,4,29,25,-28,Richmond Flowers,Alabama,PERSON-PERSON,STATE_OR_PROVINCE,PROPN-PROPN,PROPN,compound-nsubj,compound,NNP-NNP,NNP,2,1
10520,55295.0,19,Flowers,5,5,2,-3,4,16,0,-3,Richmond Flowers,Alabama,PERSON-PERSON,ORGANIZATION,PROPN-PROPN,PROPN,compound-ROOT,compound,NNP-NNP,NNP,2,1
10521,45144.0,64,elected,2,10,63,53,9,0,-8,61,his,Woodlawn,PERSON,LOCATION,DET,PROPN,poss,pobj,PRP$,NNP,16,1
10522,45145.0,42,by,0,20,26,6,19,15,-20,26,Olivia Palermo,editor,PERSON-PERSON,TITLE,PROPN-PROPN,NOUN,compound-compound,conj,NNP-NNP,NN,4,1
10523,45156.0,29,are,15,21,10,-11,20,18,-6,-5,OIC,Albania,ORGANIZATION,COUNTRY,PROPN,PROPN,pobj,appos,NNP,NNP,7,1
10524,45157.0,31,told,7,5,3,-2,4,27,2,-4,Gary Kirchner,coroner,PERSON-PERSON,TITLE,PROPN-PROPN,NOUN,compound-appos,nsubj,NNP-NNP,NN,2,1
10525,45158.0,6,CENTER,2,1,5,4,0,0,1,3,KENNEDY SPACE CENTER,Fla,ORGANIZATION-ORGANIZATION-ORGANIZATION,STATE_OR_PROVINCE,PROPN-PROPN-PROPN,PROPN,compound-compound-ROOT,npadvmod,NNP-NNP-NNP,NNP,2,1
10526,45173.0,57,took,28,2,18,16,1,38,26,-10,he,House of Representatives,PERSON,ORGANIZATION-ORGANIZATION-ORGANIZATION,PRON,PROPN-ADP-PROPN,nsubjpass,pobj-prep-pobj,PRP,NNP-IN-NNPS,7,1
10527,45175.0,65,Participants,0,19,13,-6,18,51,-19,13,OIC,Organization of the Islamic Conference,ORGANIZATION,ORGANIZATION-ORGANIZATION-ORGANIZATION-ORGANIZATION-ORGANIZATION,PROPN,PROPN-ADP-DET-PROPN-PROPN,compound,pobj-prep-det-compound-pobj,NNP,NNP-IN-DT-NNP-NNP,7,1
10528,51297.0,45,Over,0,23,17,-6,22,27,-23,17,OIC,Organization of the Islamic Conference,ORGANIZATION,ORGANIZATION-ORGANIZATION-ORGANIZATION-ORGANIZATION-ORGANIZATION,PROPN,PROPN-ADP-DET-PROPN-PROPN,compound,pobj-prep-det-compound-pobj,NNP,NNP-IN-DT-NNP-NNP,7,1
10529,45183.0,26,reports,1,22,8,-14,21,17,-21,7,Tokyo Stock Exchange,Sanyo Electric Co.,ORGANIZATION-ORGANIZATION-ORGANIZATION,ORGANIZATION-ORGANIZATION-ORGANIZATION,PROPN-PROPN-PROPN,PROPN-PROPN-PROPN,compound-compound-pobj,compound-compound-dobj,NNP-NNP-NNP,NNP-NNP-NNP,9,1
10530,45189.0,33,plugs,1,15,15,0,14,17,-14,14,DENSO,DENSO,ORGANIZATION,ORGANIZATION,PROPN,PROPN,ROOT,compound,NNP,NNP,0,1
10531,45226.0,21,chatted,13,6,11,5,5,9,7,-2,Palermo,Johannes Huebl,PERSON,PERSON-PERSON,PROPN,PROPN-PROPN,nsubj,compound-appos,NNP,NNP-NNP,6,1
10532,45232.0,20,enable,5,17,12,-5,16,7,-12,7,Aerolineas Argentinas,Austral Lineas Aereas,ORGANIZATION-ORGANIZATION,ORGANIZATION-ORGANIZATION-ORGANIZATION,PROPN-PROPN,PROPN-PROPN-PROPN,compound-compound,compound-compound-dobj,NNP-NNP,NNP-NNP-NNP,3,1
10533,45249.0,47,said,22,33,24,-9,32,22,-11,2,Jewish National Fund,Israel Tauber,ORGANIZATION-ORGANIZATION-ORGANIZATION,PERSON-PERSON,PROPN-PROPN-PROPN,PROPN-PROPN,compound-compound-pobj,compound-nsubj,NNP-NNP-NNP,NNP-NNP,5,1
10534,45255.0,22,is,7,19,1,-18,18,20,-12,-6,Golden Baseball League,Carter,ORGANIZATION-ORGANIZATION-ORGANIZATION,PERSON,PROPN-PROPN-PROPN,PROPN,compound-compound-pobj,nsubj,NNP-NNP-NNP,NNP,8,1
10535,45264.0,25,created,5,11,1,-10,10,23,-6,-4,Badr Brigades,Iran,ORGANIZATION-ORGANIZATION,COUNTRY,PROPN-PROPN,PROPN,compound-pobj,nsubj,NNP-NNPS,NNP,5,1
10536,45275.0,30,said,28,22,27,5,21,2,6,-1,US National Security Council,Gordon Johndroe,ORGANIZATION-ORGANIZATION-ORGANIZATION-ORGANIZATION,PERSON-PERSON,PROPN-PROPN-PROPN-PROPN,PROPN-PROPN,compound-compound-compound-compound,compound-nsubj,NNP-NNP-NNP-NNP,NNP-NNP,4,1
10537,47737.0,33,told,21,15,20,5,14,12,6,-1,US National Security Council,Gordon Johndroe,ORGANIZATION-ORGANIZATION-ORGANIZATION-ORGANIZATION,PERSON-PERSON,PROPN-PROPN-PROPN-PROPN,PROPN-PROPN,compound-compound-compound-compound,compound-nsubj,NNP-NNP-NNP-NNP,NNP-NNP,4,1
10538,45279.0,42,survived,2,1,29,28,0,12,1,27,Kaiser,David Kaiser,PERSON,PERSON-PERSON,PROPN,PROPN-PROPN,nsubjpass,compound-appos,NNP,NNP-NNP,7,1
10539,45280.0,40,became,14,5,22,17,4,17,9,8,her,Bucky,PERSON,PERSON,DET,PROPN,poss,oprd,PRP$,NNP,8,1
10540,45286.0,12,was,1,1,6,5,0,5,0,5,Larijani,commander,PERSON,TITLE,PROPN,NOUN,nsubj,attr,NNP,NN,2,1
10541,45297.0,17,died,12,1,5,4,0,11,11,-7,His,Elsie,PERSON,PERSON,DET,PROPN,poss,appos,PRP$,NNP,2,1
10542,45321.0,59,was,29,17,46,29,16,12,12,17,Rovers,Premier League,ORGANIZATION,ORGANIZATION-ORGANIZATION,PROPN,PROPN-PROPN,pobj,compound-compound,NNPS,NNP-NNP,17,1
10543,45322.0,41,had,29,18,7,-11,17,33,11,-22,Remy Ma,Universal Music Group,PERSON-PERSON,ORGANIZATION-ORGANIZATION-ORGANIZATION,PROPN-PROPN,PROPN-PROPN-PROPN,compound-poss,compound-compound-pobj,NNP-NNP,NNP-NNP-NNP,6,1
10544,45324.0,37,was,12,12,2,-10,11,34,0,-10,Gregory,Los Angeles,PERSON,CITY-CITY,PROPN,PROPN-PROPN,nsubj,compound-compound,NNP,NNP-NNP,2,1
10545,45342.0,37,-LRB-,1,8,31,23,7,5,-7,30,Christopher Dodd,Senate,PERSON-PERSON,ORGANIZATION,PROPN-PROPN,PROPN,compound-nsubj,nmod,NNP-NNP,NNP,4,1
10546,45346.0,31,Director-General,1,4,10,6,3,20,-3,9,National Sports Commission,Amos Adamu,ORGANIZATION-ORGANIZATION-ORGANIZATION,PERSON-PERSON,PROPN-PROPN-PROPN,PROPN-PROPN,compound-compound-pobj,compound-nsubj,NNP-NNPS-NNP,NNP-NNP,3,1
10547,45384.0,27,say,25,8,21,13,7,5,17,-4,his,her,PERSON,PERSON,DET,PRON,poss,poss,PRP$,PRP,3,1
10548,45403.0,47,died,40,1,20,19,0,26,39,-20,Augustus F. Hawkins,House,PERSON-PERSON-PERSON,ORGANIZATION,PROPN-PROPN-PROPN,PROPN,compound-compound-nsubj,pobj,NNP-NNP-NNP,NNP,3,1
10549,45411.0,39,football,7,33,10,-23,32,28,-26,3,NFC South,NFL,ORGANIZATION-ORGANIZATION,ORGANIZATION,PROPN-PROPN,PROPN,compound-pobj,nsubj,NNP-NNP,NNP,8,1
10550,45416.0,35,sent,11,7,6,-1,6,28,4,-5,Ellen Pompeo,star,PERSON-PERSON,TITLE,PROPN-PROPN,NOUN,compound-nsubj,compound,NNP-NNP,NN,2,1
10551,45432.0,44,elevated,20,2,16,14,1,27,18,-4,Fleet Marine Forces,Navy,ORGANIZATION-ORGANIZATION-ORGANIZATION,ORGANIZATION,PROPN-PROPN-PROPN,PROPN,compound-compound-nsubjpass,compound,NNP-NNP-NNPS,NNP,5,1
10552,45442.0,22,A,1,8,12,4,7,9,-7,11,he,Peace Corps,PERSON,ORGANIZATION-ORGANIZATION,PRON,PROPN-PROPN,nsubj,compound-pobj,PRP,NNP-NNP,4,1
10553,45449.0,39,died,33,1,38,37,0,0,32,5,Jane Bolin,Queens,PERSON-PERSON,LOCATION,PROPN-PROPN,PROPN,compound-nsubj,pobj,NNP-NNP,NNP,2,1
10554,45457.0,31,seized,1,17,26,9,16,4,-16,25,Brandon McInerney,gunning down his gay classmate,PERSON-PERSON,CRIMINAL_CHARGE-CRIMINAL_CHARGE-CRIMINAL_CHARGE-CRIMINAL_CHARGE-CRIMINAL_CHARGE,PROPN-PROPN,VERB-PART-DET-NOUN-NOUN,compound-pobj,pcomp-prt-poss-amod-dobj,NNP-NNP,VBG-RP-PRP$-NN-NN,1,1
10555,45470.0,31,took,5,18,5,-13,17,25,-13,0,Paavo Nurmi,she,PERSON-PERSON,PERSON,PROPN-PROPN,PRON,compound-appos,nsubj,NNP-NNP,PRP,7,1
10556,45481.0,13,died,9,6,2,-4,5,10,3,-7,Louise B. DeBlanc,DeBlanc,PERSON-PERSON-PERSON,PERSON,PROPN-PROPN-PROPN,PROPN,compound-compound-appos,poss,NNP-NNP-NNP,NNP,3,1
10557,45488.0,44,WASHINGTON,0,28,12,-16,27,31,-28,12,International Monetary Fund,Rato,ORGANIZATION-ORGANIZATION-ORGANIZATION,PERSON,PROPN-PROPN-PROPN,PROPN,compound-compound-pobj,nsubj,NNP-NNP-NNP,NNP,9,1
10558,45491.0,42,survive,9,11,26,15,10,15,-2,17,her,Nancy Bliss,PERSON,PERSON-PERSON,PRON,PROPN-PROPN,dobj,compound-conj,PRP,NNP-NNP,2,1
10559,45501.0,45,Bank,3,2,41,39,1,3,1,38,Asian Development Bank,Haruhiko Kuroda,ORGANIZATION-ORGANIZATION-ORGANIZATION,PERSON-PERSON,PROPN-PROPN-PROPN,PROPN-PROPN,compound-compound-ROOT,compound-nsubj,NNP-NNP-NNP,NNP-NNP,13,1
10560,67936.0,31,said,28,23,27,4,22,3,5,-1,Asian Development Bank,Haruhiko Kuroda,ORGANIZATION-ORGANIZATION-ORGANIZATION,PERSON-PERSON,PROPN-PROPN-PROPN,PROPN-PROPN,compound-compound-compound,compound-nsubj,NNP-NNP-NNP,NNP-NNP,4,1
10561,45508.0,37,had,3,14,9,-5,13,27,-11,6,Alberto Gonzales,Washington,PERSON-PERSON,STATE_OR_PROVINCE,PROPN-PROPN,PROPN,compound-nsubj,pobj,NNP-NNP,NNP,3,1
10562,45512.0,42,died,32,13,1,-12,12,40,19,-31,American Psychological Association,Gardner Lindzey,ORGANIZATION-ORGANIZATION-ORGANIZATION,PERSON-PERSON,PROPN-PROPN-PROPN,PROPN-PROPN,compound-compound-pobj,compound-nsubj,NNP-NNP-NNP,NNP-NNP,7,1
10563,45514.0,38,show,14,18,10,-8,17,27,-4,-4,National Museum of Women in the Arts,Washington,ORGANIZATION-ORGANIZATION-ORGANIZATION-ORGANIZATION-ORGANIZATION-ORGANIZATION-ORGANIZATION,STATE_OR_PROVINCE,PROPN-PROPN-ADP-PROPN-ADP-DET-PROPN,PROPN,compound-nsubj-prep-pobj-prep-det-pobj,pobj,NNP-NNP-IN-NNPS-IN-DT-NNP,NNP,4,1
10564,45515.0,17,shrank,8,2,7,5,1,9,6,-1,Sox,AL East,ORGANIZATION,ORGANIZATION-ORGANIZATION,PROPN,PROPN-PROPN,poss,compound-pobj,NNPS,NNP-NNP,4,1
10565,45519.0,51,built,2,7,10,3,6,40,-5,8,Chris Simcox,founder,PERSON-PERSON,TITLE,PROPN-PROPN,NOUN,compound-dobj,appos,NNP-NNP,NN,2,1
10566,45534.0,14,spent,1,6,1,-5,5,12,-5,0,Fidelity,Reynolds,ORGANIZATION,PERSON,PROPN,PROPN,pobj,nsubj,NNP,NNP,1,1
10567,45547.0,51,died,41,1,43,42,0,7,40,2,Richmond M. Flowers,Thursday,PERSON-PERSON-PERSON,DATE,PROPN-PROPN-PROPN,PROPN,compound-compound-nsubj,npadvmod,NNP-NNP-NNP,NNP,3,1
10568,45553.0,52,paid,8,30,33,3,29,18,-22,25,Fyffes,Eagle Star Insurance,ORGANIZATION,PERSON-PERSON-PERSON,PROPN,PROPN-PROPN-PROPN,compound,compound-compound-appos,NNP,NNP-NNP-NNP,10,1
10569,45564.0,85,supervisor,67,12,55,43,11,29,55,-12,Department of Conservation and Recreation,Boston,ORGANIZATION-ORGANIZATION-ORGANIZATION-ORGANIZATION-ORGANIZATION,CITY,PROPN-ADP-PROPN-CCONJ-PROPN,PROPN,pobj-prep-pobj-cc-conj,compound,NNP-IN-NNP-CC-NNP,NNP,7,1
10570,45568.0,37,taken,2,34,31,-3,33,5,-32,29,Ali Akbar Salehi,Foreign Ministry,PERSON-PERSON-PERSON,ORGANIZATION-ORGANIZATION,PROPN-PROPN-PROPN,PROPN-PROPN,compound-compound-pobj,compound-compound,NNP-NNP-NNP,NNP-NNP,1,1
10571,45578.0,46,is,2,1,26,25,0,19,1,24,Automobile,AAA,ORGANIZATION,ORGANIZATION,NOUN,PROPN,compound,nsubj,NN,NNP,3,1
10572,45586.0,12,Millonarios,0,1,3,2,0,8,-1,3,Millonarios,Colombia,ORGANIZATION,COUNTRY,PROPN,PROPN,ROOT,appos,NNP,NNP,2,1
10573,50340.0,8,winner,2,5,7,2,4,0,-3,5,Millonarios,Colombia,ORGANIZATION,COUNTRY,PROPN,PROPN,compound,compound,NNP,NNP,2,1
10574,54167.0,26,be,3,23,25,2,22,0,-20,22,Millonarios,Colombia,ORGANIZATION,COUNTRY,PROPN,PROPN,pobj,pobj,NNP,NNP,7,1
10575,54825.0,12,will,2,9,11,2,8,0,-7,9,Millonarios,Colombia,ORGANIZATION,COUNTRY,PROPN,PROPN,conj,pobj,NNP,NNP,5,1
10576,64079.0,25,scored,2,6,8,2,5,16,-4,6,Millonarios,Colombia,ORGANIZATION,COUNTRY,PROPN,PROPN,nsubj,pobj,NNP,NNP,2,1
10577,66702.0,32,BOGOTA,0,11,3,-8,10,28,-11,3,Millonarios,Colombia,ORGANIZATION,COUNTRY,PROPN,PROPN,nsubj,npadvmod,NNP,NNP,4,1
10578,45591.0,20,said,18,4,11,7,3,8,14,-7,Jo Ann Davis,two-year,PERSON-PERSON-PERSON,DURATION,PROPN-PROPN-PROPN,ADJ,compound-compound-nsubj,amod,NNP-NNP-NNP,JJ,6,1
10579,45599.0,76,survived,25,46,31,-15,45,44,-21,6,Blair Deaver,Carolyn,PERSON-PERSON,PERSON,PROPN-PROPN,PROPN,compound-conj,appos,NNP-NNP,NNP,4,1
10580,45606.0,32,quoted,26,19,29,10,18,2,7,3,Mahmood Shah,governor,PERSON-PERSON,TITLE,PROPN-PROPN,NOUN,compound-nsubj,dobj,NNP-NNP,NN,3,1
10581,45616.0,38,considered,24,13,12,-1,12,25,11,-12,John Dewey,psychologist,PERSON-PERSON,TITLE,PROPN-PROPN,NOUN,compound-conj,compound,NNP-NNP,NN,1,1
10582,45653.0,10,'s,1,7,3,-4,6,6,-6,2,he,31,PERSON,NUMBER,PRON,NUM,nsubj,attr,PRP,CD,3,1
10583,45661.0,49,died,39,1,14,13,0,34,38,-25,Mary D Crisp,national co-chairman of the Republican Party,PERSON-PERSON-PERSON,TITLE-TITLE-TITLE-TITLE-TITLE-TITLE,PROPN-PROPN-PROPN,ADJ-NOUN-ADP-DET-PROPN-PROPN,compound-compound-nsubj,amod-pobj-prep-det-compound-pobj,NNP-NNP-NNP,JJ-NN-IN-DT-NNP-NNP,5,1
10584,45666.0,44,said,15,24,17,-7,23,26,-9,2,Highland Capital Partners,Sean Dalton,ORGANIZATION-ORGANIZATION-ORGANIZATION,PERSON-PERSON,PROPN-PROPN-PROPN,PROPN-PROPN,compound-compound-pobj,compound-nsubj,NNP-NNP-NNP,NNP-NNP,7,1
10585,45671.0,32,received,6,29,24,-5,28,7,-23,18,U.S. Surgical Corp.,Connecticut,ORGANIZATION-ORGANIZATION-ORGANIZATION,STATE_OR_PROVINCE,PROPN-PROPN-PROPN,PROPN,compound-compound-dobj,compound,NNP-NNP-NNP,NNP,3,1
10586,45699.0,25,House,8,7,1,-6,6,23,1,-7,Kentucky State House of Representatives,Carl Christopher Perkins,ORGANIZATION-ORGANIZATION-ORGANIZATION-ORGANIZATION-ORGANIZATION,PERSON-PERSON-PERSON,PROPN-PROPN-PROPN-ADP-PROPN,PROPN-PROPN-PROPN,appos-compound-ROOT-prep-pobj,compound-compound-nmod,NNP-NNP-NNP-IN-NNPS,NNP-NNP-NNP,3,1
10587,45707.0,25,was,3,21,2,-19,20,22,-18,-1,her,assistant,PERSON,TITLE,PRON,NOUN,dobj,nsubj,PRP,NN,4,1
10588,45709.0,45,plans,15,1,7,6,0,37,14,-8,Al Hubbard,President,PERSON-PERSON,TITLE,PROPN-PROPN,PROPN,compound-nsubj,compound,NNP-NNP,NNP,5,1
10589,45737.0,34,ask,21,7,17,10,6,16,14,-4,Red Sox,Oakland,ORGANIZATION-ORGANIZATION,CITY,PROPN-PROPN,PROPN,compound-attr,compound,NNP-NNPS,NNP,4,1
10590,45744.0,18,said,2,1,5,4,0,12,1,3,Alcatel-Lucent,Philippe Camus,ORGANIZATION,PERSON-PERSON,ADJ,PROPN-PROPN,nsubj,compound-nsubj,JJ,NNP-NNP,4,1
10591,45748.0,20,Gillmor,6,6,18,12,5,1,0,12,Paul Gillmor,DC,PERSON-PERSON,STATE_OR_PROVINCE,PROPN-PROPN,PROPN,compound-ROOT,compound,NNP-NNP,NNP,-1,1
10592,45751.0,33,made,18,4,9,5,3,23,14,-9,Mohamed ElBaradei,diplomat,PERSON-PERSON,TITLE,PROPN-PROPN,NOUN,compound-nsubj,appos,NNP-NNP,NN,3,1
10593,45759.0,40,died,32,3,37,34,2,2,29,5,John P Henebry,Evanston,PERSON-PERSON-PERSON,CITY,PROPN-PROPN-PROPN,PROPN,compound-compound-nsubj,pobj,NNP-NNP-NNP,NNP,3,1
10594,45769.0,26,was,7,17,9,-8,16,16,-10,2,Carnival Corp.,Micky Arison,ORGANIZATION-ORGANIZATION,PERSON-PERSON,PROPN-PROPN,PROPN-PROPN,compound-pobj,compound-nsubj,NNP-NNP,NNP-NNP,5,1
10595,45770.0,38,speed,4,3,14,11,2,23,1,10,Konica Minolta,Tokyo-based,ORGANIZATION-ORGANIZATION,CITY,PROPN-PROPN,PROPN,compound-appos,conj,NNP-NNP,NNP,7,1
10596,45775.0,52,died,37,1,43,42,0,8,36,6,Pamela Gardner Ahearn,heart attack,PERSON-PERSON-PERSON,CAUSE_OF_DEATH-CAUSE_OF_DEATH,PROPN-PROPN-PROPN,NOUN-NOUN,compound-compound-nsubj,compound-pobj,NNP-NNP-NNP,NN-NN,5,1
10597,49201.0,52,died,37,1,43,42,0,8,36,6,Pamela Gardner Ahearn,heart attack,PERSON-PERSON-PERSON,CAUSE_OF_DEATH-CAUSE_OF_DEATH,PROPN-PROPN-PROPN,NOUN-NOUN,compound-compound-nsubj,compound-pobj,NNP-NNP-NNP,NN-NN,5,1
10598,45778.0,28,recover,4,20,1,-19,19,26,-16,-3,Texas - based oil and gas drilling company,Patterson-UTI Energy Inc,ORGANIZATION-ORGANIZATION-ORGANIZATION-ORGANIZATION-ORGANIZATION-ORGANIZATION-ORGANIZATION-ORGANIZATION,ORGANIZATION-ORGANIZATION-ORGANIZATION,PROPN-PUNCT-VERB-NOUN-CCONJ-NOUN-NOUN-NOUN,PROPN-PROPN-PROPN,npadvmod-punct-amod-nmod-cc-conj-compound-pobj,compound-compound-nsubj,NNP-HYPH-VBN-NN-CC-NN-NN-NN,NNP-NNP-NNP,7,1
10599,45782.0,34,has,20,14,23,9,13,10,6,3,Denso Corp,"1,200",ORGANIZATION-ORGANIZATION,NUMBER,PROPN-PROPN,NUM,compound-nsubj,nummod,NNP-NNP,CD,2,1
10600,45783.0,37,received,12,12,13,1,11,23,0,1,he,received a doctorate in International Law at the New York University School of Law,PERSON,ORGANIZATION-ORGANIZATION-ORGANIZATION-ORGANIZATION-ORGANIZATION-ORGANIZATION-ORGANIZATION-ORGANIZATION-ORGANIZATION-ORGANIZATION-ORGANIZATION-ORGANIZATION-ORGANIZATION-ORGANIZATION,PRON,VERB-DET-NOUN-ADP-PROPN-PROPN-ADP-DET-PROPN-PROPN-PROPN-PROPN-ADP-PROPN,nsubj,ROOT-det-dobj-prep-compound-pobj-prep-det-compound-compound-compound-pobj-prep-pobj,PRP,VBD-DT-NN-IN-NNP-NNP-IN-DT-NNP-NNP-NNP-NNP-IN-NNP,2,1
10601,45791.0,28,assembled,10,9,26,17,8,1,1,16,Kerry,Senate,PERSON,ORGANIZATION,PROPN,PROPN,nsubj,compound,NNP,NNP,7,1
10602,45795.0,57,Buse,1,1,6,5,0,50,0,5,Mark Buse,Lobbyist,PERSON-PERSON,TITLE,PROPN-PROPN,PROPN,compound-ROOT,compound,NNP-NNP,NNP,1,1
10603,45799.0,37,ordered,4,3,2,-1,2,34,1,-2,Hugo Chavez,president,PERSON-PERSON,TITLE,PROPN-PROPN,NOUN,compound-nsubj,compound,NNP-NNP,NN,1,1
10604,45802.0,46,use,1,9,44,35,8,1,-8,43,John Kerry,Yale University,PERSON-PERSON,ORGANIZATION-ORGANIZATION,PROPN-PROPN,PROPN-PROPN,compound-nsubj,compound-pobj,NNP-NNP,NNP-NNP,10,1
10605,45810.0,15,served,6,14,3,-11,13,11,-8,-3,institute,Lee Teng - hui,ORGANIZATION,PERSON-PERSON-PERSON-PERSON,NOUN,PROPN-PROPN-PUNCT-PROPN,pobj,compound-compound-punct-nsubj,NN,NNP-NNP-HYPH-NNP,3,1
10606,45816.0,50,was,4,9,6,-3,8,43,-5,2,Mia Farrow,Maureen O'Sullivan,PERSON-PERSON,PERSON-PERSON,PROPN-PROPN,PROPN-PROPN,compound-poss,compound-compound,NNP-NNP,NNP-NNP,1,1
10607,45819.0,62,spending,9,26,34,8,25,27,-17,25,her,Michael Lohan,PERSON,PERSON-PERSON,DET,PROPN-PROPN,poss,compound-pobj,PRP$,NNP-NNP,9,1
10608,45833.0,50,Service,2,13,7,-6,12,42,-11,5,Federal Aviation Administration,Marion Blakey,ORGANIZATION-ORGANIZATION-ORGANIZATION,PERSON-PERSON,PROPN-PROPN-PROPN,PROPN-PROPN,compound-compound-pobj,compound-nsubj,NNP-NNP-NNP,NNP-NNP,4,1
10609,45834.0,27,claimed,8,12,15,3,11,11,-4,7,ISU,Grand Prix Final,ORGANIZATION,MISC-MISC-MISC,PROPN,PROPN-PROPN-ADJ,compound,compound-compound-amod,NNP,NNP-NNP-JJ,2,1
10610,45839.0,23,expected,6,4,3,-1,3,19,2,-3,Awami League,secular,ORGANIZATION-ORGANIZATION,RELIGION,PROPN-PROPN,ADJ,compound-nsubjpass,amod,NNP-NNP,JJ,1,1
10611,45844.0,32,said,9,18,11,-7,17,20,-9,2,MBIA,Leon J. Karvelis Jr.,ORGANIZATION,PERSON-PERSON-PERSON-PERSON,PROPN,PROPN-PROPN-PROPN-PROPN,compound,compound-compound-compound-nsubj,NNP,NNP-NNP-NNP-NNP,3,1
10612,45845.0,16,are,1,10,8,-2,9,7,-9,7,Jake Pavelka,commercial pilot,PERSON-PERSON,TITLE-TITLE,PROPN-PROPN,ADJ-NOUN,compound-appos,amod-appos,NNP-NNP,JJ-NN,1,1
10613,45848.0,40,presented,18,1,5,4,0,34,17,-13,Herrera,Arizonan,PERSON,STATE_OR_PROVINCE,NOUN,PROPN,nsubj,attr,NN,NNP,2,1
10614,45856.0,25,told,6,1,4,3,0,20,5,-2,Malia Obama,10,PERSON-PERSON,NUMBER,PROPN-PROPN,NUM,compound-nsubj,appos,NNP-NNP,CD,2,1
10615,45869.0,47,died,44,5,5,0,4,41,39,-39,Michael Deaver,Michael K Deaver,PERSON-PERSON,PERSON-PERSON-PERSON,PROPN-PROPN,PROPN-PROPN-PROPN,compound-appos,compound-compound-pobj,NNP-NNP,NNP-NNP-NNP,0,1
10616,45888.0,88,are,1,39,44,5,38,43,-38,43,Jennifer Dunn,Republican,PERSON-PERSON,ORGANIZATION,PROPN-PROPN,ADJ,compound-conj,amod,NNP-NNP,JJ,1,1
10617,45893.0,26,was,6,8,23,15,7,2,-2,17,his,Mirta Diaz Balart,PERSON,PERSON-PERSON-PERSON,DET,PROPN-PROPN-PROPN,poss,compound-compound-appos,PRP$,NNP-NNP-NNP,6,1
10618,45913.0,54,survived,2,29,22,-7,28,31,-27,20,David Kaiser,editor,PERSON-PERSON,TITLE,PROPN-PROPN,NOUN,compound-appos,appos,NNP-NNP,NN,3,1
10619,45926.0,32,were,1,30,23,-7,29,8,-29,22,NFC South,2002,ORGANIZATION-ORGANIZATION,DATE,PROPN-PROPN,NUM,compound-pobj,pobj,NNP-NNP,CD,4,1
10620,45927.0,32,avoided,16,13,9,-4,12,22,3,-7,Tyco HealthCare,Covidien,ORGANIZATION-ORGANIZATION,ORGANIZATION,PROPN-PROPN,PROPN,compound-appos,nsubj,NNP-NNP,NNP,6,1
10621,45935.0,14,died,8,2,9,7,1,4,6,1,renowned mountain photographer,died from heart failure,PERSON-PERSON-PERSON,TITLE-TITLE-TITLE-TITLE,ADJ-NOUN-NOUN,VERB-ADP-NOUN-NOUN,amod-compound-nsubj,ROOT-prep-compound-pobj,JJ-NN-NN,VBD-IN-NN-NN,3,1
10622,45966.0,23,was,4,4,8,4,3,14,0,4,Fuller,producer,PERSON,TITLE,PROPN,NOUN,nsubj,attr,NNP,NN,2,1
10623,45967.0,32,granted,12,2,9,7,1,22,10,-3,Hussein Kamel,Saddam Kamel Hassan,PERSON-PERSON,PERSON-PERSON-PERSON,PROPN-PROPN,PROPN-PROPN-PROPN,compound-compound,compound-compound-appos,NNP-NNP,NNP-NNP-NNP,4,1
10624,45980.0,28,made,1,1,16,15,0,11,0,15,FirstGroup,Ryder Public Transportation Services,ORGANIZATION,ORGANIZATION-ORGANIZATION-ORGANIZATION-ORGANIZATION,PROPN,PROPN-PROPN-PROPN-PROPN,nsubj,compound-compound-compound-pobj,NNP,NNP-NNP-NNP-NNPS,5,1
10625,45988.0,47,said,44,34,40,6,33,6,10,-4,Federal Election Commission,Donald F McGahn,ORGANIZATION-ORGANIZATION-ORGANIZATION,PERSON-PERSON-PERSON,PROPN-PROPN-PROPN,PROPN-PROPN-PROPN,compound-compound-compound,compound-compound-compound,NNP-NNP-NNP,NNP-NNP-NNP,4,1
10626,46012.0,33,quoted,16,27,26,-1,26,6,-11,10,Awami League,leftist,ORGANIZATION-ORGANIZATION,RELIGION,PROPN-PROPN,ADJ,compound-compound,amod,NNP-NNP,JJ,3,1
10627,46029.0,41,said,13,4,1,-3,3,39,9,-12,Focus on the Family,Jim Daly,ORGANIZATION-ORGANIZATION-ORGANIZATION-ORGANIZATION,PERSON-PERSON,PROPN-ADP-DET-PROPN,PROPN-PROPN,appos-prep-det-compound,compound-nsubj,NNP-IN-DT-NNP,NNP-NNP,2,1
10628,49945.0,35,said,18,27,20,-7,26,14,-9,2,Focus on the Family,Jim Daly,ORGANIZATION-ORGANIZATION-ORGANIZATION-ORGANIZATION,PERSON-PERSON,PROPN-ADP-DET-PROPN,PROPN-PROPN,pobj-prep-det-poss,compound-nsubj,NNP-IN-DT-NNP,NNP-NNP,4,1
10629,56705.0,38,FOCUS-DALY-ART,0,18,9,-9,17,28,-18,9,Focus on the Family,Jim Daly,ORGANIZATION-ORGANIZATION-ORGANIZATION-ORGANIZATION,PERSON-PERSON,PROPN-ADP-DET-PROPN,PROPN-PROPN,pobj-prep-det-pobj,compound-nsubj,NNP-IN-DT-NNP,NNP-NNP,-1,1
10630,46034.0,28,cast,18,13,12,-1,12,15,5,-6,John Kerry,Chairman,PERSON-PERSON,TITLE,PROPN-PROPN,PROPN,compound-nsubj,compound,NNP-NNP,NNP,1,1
10631,46048.0,25,VERITY-OBIT-MCC,0,22,13,-9,21,11,-22,13,William Verity,Ohio,PERSON-PERSON,STATE_OR_PROVINCE,PROPN-PROPN,PROPN,compound-compound,appos,NNP-NNP,NNP,4,1
10632,46071.0,45,is,4,16,9,-7,15,35,-12,5,CCL,Carnival Corporation,ORGANIZATION,ORGANIZATION-ORGANIZATION,PROPN,PROPN-PROPN,appos,compound-pobj,NNP,NNP-NNP,4,1
10633,46086.0,41,won,17,1,7,6,0,33,16,-10,Gillmor,judge advocate,PERSON,TITLE-TITLE,PROPN,NOUN-NOUN,nsubj,compound-pobj,NNP,NN-NN,4,1
10634,46109.0,19,is,1,1,8,7,0,10,0,7,He,Social Democrats,PERSON,ORGANIZATION-ORGANIZATION,PRON,PROPN-PROPN,nsubj,compound-pobj,PRP,NNP-NNPS,3,1
10635,46141.0,28,said,11,1,9,8,0,18,10,-2,Christopher Bentley,Immigration Services,PERSON-PERSON,ORGANIZATION-ORGANIZATION,PROPN-PROPN,PROPN-PROPN,compound-nsubj,conj-pobj,NNP-NNP,NNP-NNPS,3,1
10636,46142.0,15,said,13,8,11,3,7,3,5,-2,his,Peggy Bellecourt,PERSON,PERSON-PERSON,DET,PROPN-PROPN,poss,compound-appos,PRP$,NNP-NNP,2,1
10637,46152.0,26,was,2,2,7,5,1,18,0,5,MNLF,separatist,ORGANIZATION,IDEOLOGY,PROPN,NOUN,nsubj,compound,NNP,NN,1,1
10638,46154.0,61,hailed,22,18,1,-17,17,59,4,-21,Communist Party of China,Wang,ORGANIZATION-ORGANIZATION-ORGANIZATION-ORGANIZATION,PERSON,PROPN-PROPN-ADP-PROPN,PROPN,compound-pobj-prep-pobj,nsubj,NNP-NNP-IN-NNP,NNP,9,1
10639,46160.0,37,succeeds,16,18,6,-12,17,30,-2,-10,Pascal Yoadimnadji,National Rally for Development and Progress,PERSON-PERSON,ORGANIZATION-ORGANIZATION-ORGANIZATION-ORGANIZATION-ORGANIZATION-ORGANIZATION,PROPN-PROPN,PROPN-PROPN-ADP-PROPN-CCONJ-PROPN,compound-dobj,compound-pobj-prep-pobj-cc-conj,NNP-NNPS,NNP-NNP-IN-NNP-CC-NNP,5,1
10640,46166.0,33,dies,11,1,18,17,0,14,10,7,Richmond Flowers,Mary Russell Flowers,PERSON-PERSON,PERSON-PERSON-PERSON,PROPN-PROPN,PROPN-PROPN-PROPN,compound-nsubj,compound-compound-appos,NNP-NNP,NNP-NNP-NNP,5,1
10641,46170.0,19,chose,7,9,13,4,8,5,-2,6,Michael J. Sandy,29,PERSON-PERSON-PERSON,NUMBER,PROPN-PROPN-PROPN,NUM,compound-compound-dobj,appos,NNP-NNP-NNP,CD,2,1
10642,46175.0,37,said,35,4,7,3,3,29,31,-28,ADB,Asian Development Fund,ORGANIZATION,ORGANIZATION-ORGANIZATION-ORGANIZATION,PROPN,PROPN-PROPN-PROPN,poss,compound-compound-pobj,NNP,NNP-NNP-NNP,3,1
10643,46181.0,32,said,17,13,1,-12,12,30,4,-16,Buchwald,Ben Bradlee,PERSON,PERSON-PERSON,PROPN,PROPN-PROPN,nsubj,compound-nsubj,NNP,NNP-NNP,2,1
10644,46188.0,31,killed,5,1,15,14,0,15,4,10,Goodman,Mississippi,PERSON,STATE_OR_PROVINCE,PROPN,PROPN,poss,poss,NNP,NNP,7,1
10645,46204.0,33,grew,2,12,1,-11,11,31,-10,-1,Fraser Robinson,Michelle Obama,PERSON-PERSON,PERSON-PERSON,PROPN-PROPN,PROPN-PROPN,compound-appos,compound-nsubj,NNP-NNP,NNP-NNP,6,1
10646,46227.0,42,made,5,3,2,-1,2,39,2,-3,Alexandra Burke,vocalist,PERSON-PERSON,TITLE,PROPN-PROPN,NOUN,compound-nsubj,compound,NNP-NNP,NN,1,1
10647,54382.0,32,mokhal,0,4,3,-1,3,28,-4,3,Alexandra Burke,vocalist,PERSON-PERSON,TITLE,PROPN-PROPN,NOUN,compound-nsubj,compound,NNP-NNP,NN,1,1
10648,46241.0,26,suggested,7,6,5,-1,5,20,1,-2,Fidel Castro,81-year-old,PERSON-PERSON,DURATION,PROPN-PROPN,NUM,compound-nsubj,compound,NNP-NNP,CD,1,1
10649,46246.0,47,died,32,1,45,44,0,1,31,13,Jennifer Dunn,pulmonary embolism,PERSON-PERSON,CAUSE_OF_DEATH-CAUSE_OF_DEATH,PROPN-PROPN,ADJ-NOUN,compound-nsubj,amod-pobj,NNP-NNP,JJ-NN,-1,1
10650,46846.0,47,died,32,1,45,44,0,1,31,13,Jennifer Dunn,pulmonary embolism,PERSON-PERSON,CAUSE_OF_DEATH-CAUSE_OF_DEATH,PROPN-PROPN,ADJ-NOUN,compound-nsubj,amod-pobj,NNP-NNP,JJ-NN,-1,1
10651,46253.0,49,said,26,16,16,0,15,32,10,-10,Carnival Corp.,Carnival,ORGANIZATION-ORGANIZATION,ORGANIZATION,PROPN-PROPN,PROPN,compound-pobj,compound,NNP-NNP,NNP,0,1
10652,46254.0,24,attends,2,1,4,3,0,19,1,2,Holly Montag,Playboy,PERSON-PERSON,ORGANIZATION,PROPN-PROPN,PROPN,compound-nsubj,poss,NNP-NNP,NNP,5,1
10653,46285.0,34,Lines,2,15,1,-14,14,32,-13,-1,CCL,Carnival Cruise Lines,ORGANIZATION,ORGANIZATION-ORGANIZATION-ORGANIZATION,PROPN,PROPN-PROPN-PROPN,appos,compound-compound-ROOT,NNP,NNP-NNP-NNPS,4,1
10654,46287.0,33,killed,14,1,7,6,0,25,13,-7,Musawi,secretary-general,PERSON,TITLE,NOUN,NOUN,nsubjpass,appos,NNS,NN,3,1
10655,46294.0,18,said,5,1,3,2,0,14,4,-2,ABA,Karen J Mathis,ORGANIZATION,PERSON-PERSON-PERSON,PROPN,PROPN-PROPN-PROPN,compound,compound-compound-nsubj,NNP,NNP-NNP-NNP,2,1
10656,46300.0,32,sent,10,8,7,-1,7,24,2,-3,American Bar Association,conservative,ORGANIZATION-ORGANIZATION-ORGANIZATION,IDEOLOGY,PROPN-PROPN-PROPN,ADJ,compound-compound-nsubj,amod,NNP-NNP-NNP,JJ,2,1
10657,46301.0,38,died,33,1,13,12,0,24,32,-20,Philip M. Kaiser,Senegal,PERSON-PERSON-PERSON,COUNTRY,PROPN-PROPN-PROPN,PROPN,compound-compound-nsubj,conj,NNP-NNP-NNP,NNP,4,1
10658,46302.0,33,is,3,2,14,12,1,18,1,11,Barnes Foundation,Albert C. Barnes,ORGANIZATION-ORGANIZATION,PERSON-PERSON-PERSON,PROPN-PROPN,PROPN-PROPN-PROPN,compound-nsubj,compound-compound-pobj,NNP-NNP,NNP-NNP-NNP,6,1
10659,46303.0,39,said,28,30,34,4,29,4,-2,6,Vincenzo Ferrara,Italian,PERSON-PERSON,NATIONALITY,PROPN-PROPN,ADJ,compound-nsubj,amod,NNP-NNP,JJ,2,1
10660,46304.0,32,said,8,3,6,3,2,25,5,-2,Denso,Shen Meihua,ORGANIZATION,PERSON-PERSON,PROPN,PROPN-PROPN,compound,compound-appos,NNP,NNP-NNP,2,1
10661,46309.0,16,born,4,1,15,14,0,0,3,11,Jane Matilda Bolin,N.Y.,PERSON-PERSON-PERSON,STATE_OR_PROVINCE,PROPN-PROPN-PROPN,PROPN,compound-compound-nsubjpass,appos,NNP-NNP-NNP,NNP,3,1
10662,46331.0,43,is,1,7,31,24,6,11,-6,30,Focus on the Family,California,ORGANIZATION-ORGANIZATION-ORGANIZATION-ORGANIZATION,STATE_OR_PROVINCE,PROPN-ADP-DET-PROPN,PROPN,pobj-prep-det-compound,nmod,NNP-IN-DT-NNP,NNP,7,1
10663,46345.0,36,said,18,20,26,6,19,9,-2,8,Mahmood Shah,general,PERSON-PERSON,TITLE,PROPN-PROPN,ADJ,compound-nsubj,appos,NNP-NNP,JJ,2,1
10664,46346.0,27,got,2,2,12,10,1,14,0,10,he,Carnegie Hall,PERSON,ORGANIZATION-ORGANIZATION,PRON,PROPN-PROPN,nsubj,compound-pobj,PRP,NNP-NNP,5,1
10665,46355.0,35,recorded,1,32,34,2,31,0,-31,33,Markit,London,ORGANIZATION,CITY,PROPN,PROPN,appos,pobj,NNP,NNP,2,1
10666,51165.0,21,collect,10,1,5,4,0,15,9,-5,Markit,London,ORGANIZATION,CITY,PROPN,PROPN,compound,compound,NNP,NNP,1,1
10667,46377.0,25,says,11,20,13,-7,19,11,-9,2,New Hampshire Institute Of Politics,Jennifer Donahue,ORGANIZATION-ORGANIZATION-ORGANIZATION-ORGANIZATION-ORGANIZATION,PERSON-PERSON,PROPN-PROPN-PROPN-ADP-PROPN,PROPN-PROPN,compound-compound-pobj-prep-pobj,compound-nsubj,NNP-NNP-NNP-IN-NNP,NNP-NNP,4,1
10668,46378.0,51,died,40,1,48,47,0,2,39,8,Richard Nolte,Hanover,PERSON-PERSON,CITY,PROPN-PROPN,PROPN,compound-nsubj,pobj,NNP-NNP,NNP,5,1
10669,46379.0,54,survived,2,29,5,-24,28,48,-27,3,David Kaiser,his,PERSON-PERSON,PERSON,PROPN-PROPN,DET,compound-appos,poss,NNP-NNP,PRP$,4,1
10670,46395.0,41,walkout,1,4,4,0,3,36,-3,3,Denso,Denso Corp,ORGANIZATION,ORGANIZATION-ORGANIZATION,PROPN,PROPN-PROPN,pobj,compound-pobj,NNP,NNP-NNP,0,1
10671,46410.0,40,credited,13,19,1,-18,18,38,-6,-12,Samsung Electronics Co.,Lee,ORGANIZATION-ORGANIZATION-ORGANIZATION,PERSON,PROPN-PROPN-PROPN,PROPN,compound-compound-dobj,nsubjpass,NNP-NNPS-NNP,NNP,6,1
10672,46451.0,32,said,16,1,22,21,0,9,15,6,Negroponte,Deputy Prime Minister,PERSON,TITLE-TITLE-TITLE,PROPN,PROPN-PROPN-PROPN,poss,compound-compound-appos,NNP,NNP-NNP-NNP,7,1
10673,46463.0,19,have,1,15,11,-4,14,7,-14,10,CMA,Custom Matching Attributes,ORGANIZATION,ORGANIZATION-ORGANIZATION-ORGANIZATION,PROPN,PROPN-PROPN-PROPN,compound,compound-compound-compound,NNP,NNP-NNP-NNPS,6,1
10674,46466.0,29,investigated,5,27,18,-9,26,10,-22,13,Samsung Electronics,his,ORGANIZATION-ORGANIZATION,PERSON,PROPN-PROPN,DET,compound-pobj,poss,NNP-NNP,PRP$,4,1
10675,46475.0,55,is,12,42,28,-14,41,26,-30,16,USA Network,Universal Pictures,ORGANIZATION-ORGANIZATION,ORGANIZATION-ORGANIZATION,PROPN-PROPN,PROPN-PROPN,compound-conj,compound-compound,NNP-NNP,NNP-NNP,5,1
10676,46494.0,19,appointed,11,1,14,13,0,4,10,3,Chen,Minister of Health,PERSON,ORGANIZATION-ORGANIZATION-ORGANIZATION,PROPN,PROPN-ADP-PROPN,nsubjpass,oprd-prep-pobj,NNP,NNP-IN-NNP,4,1
10677,46503.0,43,be,39,6,31,25,5,11,33,-8,Susan Boyle,Catholic,PERSON-PERSON,RELIGION,PROPN-PROPN,PROPN,compound-poss,pobj,NNP-NNP,NNP,6,1
10678,46525.0,23,shows,1,4,3,-1,3,19,-3,2,Kurt Waldheim,Lieutenant,PERSON-PERSON,TITLE,PROPN-PROPN,PROPN,compound-dobj,compound,NNP-NNP,NNP,1,1
10679,46527.0,41,said,23,30,25,-5,29,15,-7,2,Chris Bentley,Citizenship and Immigration Services,PERSON-PERSON,ORGANIZATION-ORGANIZATION-ORGANIZATION-ORGANIZATION,PROPN-PROPN,PROPN-CCONJ-PROPN-PROPN,compound-nsubj,nmod-cc-compound-conj,NNP-NNP,NNP-CC-NNP-NNPS,3,1
10680,50867.0,22,said,11,10,5,-5,9,16,1,-6,Chris Bentley,Citizenship and Immigration Services,PERSON-PERSON,ORGANIZATION-ORGANIZATION-ORGANIZATION-ORGANIZATION,PROPN-PROPN,PROPN-CCONJ-PROPN-PROPN,compound-nsubj,nmod-cc-compound-conj,NNP-NNP,NNP-CC-NNP-NNPS,3,1
10681,52814.0,54,said,12,1,8,7,0,45,11,-4,Chris Bentley,Citizenship and Immigration Services,PERSON-PERSON,ORGANIZATION-ORGANIZATION-ORGANIZATION-ORGANIZATION,PROPN-PROPN,PROPN-CCONJ-PROPN-PROPN,compound-nsubj,nmod-cc-conj-pobj,NNP-NNP,NNP-CC-NNP-NNPS,6,1
10682,46536.0,23,says,2,1,9,8,0,13,1,7,Holly Montag,her,PERSON-PERSON,PERSON,PROPN-PROPN,DET,compound-nsubj,poss,NNP-NNP,PRP$,4,1
10683,54748.0,28,RECOVERY,3,6,14,8,5,13,-3,11,Holly Montag,her,PERSON-PERSON,PERSON,PROPN-PROPN,DET,compound-nsubj,poss,NNP-NNP,PRP$,4,1
10684,46549.0,41,said,38,9,22,13,8,18,29,-16,FMCSA,United States,ORGANIZATION,COUNTRY-COUNTRY,NOUN,PROPN-PROPN,conj,compound-pobj,NN,NNP-NNP,7,1
10685,46555.0,21,come,13,2,8,6,1,12,11,-5,the park,September 2005,ORGANIZATION-ORGANIZATION,DATE-DATE,DET-NOUN,PROPN-NUM,det-nsubj,pobj-nummod,DT-NN,NNP-CD,7,1
10686,46564.0,28,oversee,9,18,5,-13,17,22,-9,-4,FMR Co,Robert L Reynolds,ORGANIZATION-ORGANIZATION,PERSON-PERSON-PERSON,PROPN-PROPN,PROPN-PROPN-PROPN,compound-appos,compound-compound-nsubj,NNP-NNP,NNP-NNP-NNP,4,1
10687,46565.0,36,said,28,19,27,8,18,8,9,-1,Illinois Tool Works Inc.,David Speer,ORGANIZATION-ORGANIZATION-ORGANIZATION-ORGANIZATION,PERSON-PERSON,PROPN-PROPN-PROPN-PROPN,PROPN-PROPN,compound-compound-compound-pobj,compound-nsubj,NNP-NNP-NNP-NNP,NNP-NNP,3,1
10688,46583.0,19,said,10,1,9,8,0,9,9,-1,Chris Simcox,Minutemen,PERSON-PERSON,ORGANIZATION,PROPN-PROPN,PROPN,compound-nsubj,pobj,NNP-NNP,NNP,2,1
10689,46584.0,54,continued,4,17,50,33,16,3,-13,46,John Kerry,Theresa Heinz Kerry,PERSON-PERSON,PERSON-PERSON-PERSON,PROPN-PROPN,PROPN-PROPN-PROPN,compound-nsubj,compound-compound-appos,NNP-NNP,NNP-NNP-NNP,9,1
10690,46596.0,25,originated,13,1,11,10,0,13,12,-2,BNC Mortgage,last year,ORGANIZATION-ORGANIZATION,DATE-DATE,PROPN-PROPN,ADJ-NOUN,compound-nsubj,amod-npadvmod,NNP-NNP,JJ-NN,3,1
10691,46615.0,35,combined,12,12,10,-2,11,24,0,-2,Ahearn,Tennessee,PERSON,STATE_OR_PROVINCE,PROPN,PROPN,nsubj,pobj,NNP,NNP,1,1
10692,46620.0,17,was,7,5,13,8,4,3,2,6,Dennis Dunn,King County,PERSON-PERSON,LOCATION-LOCATION,PROPN-PROPN,PROPN-PROPN,compound-appos,compound-pobj,NNP-NNP,NNP-NNP,5,1
10693,46621.0,20,lives,1,14,19,5,13,0,-13,18,Jamie Lynn,Kentwood,PERSON-PERSON,CITY,PROPN-PROPN,PROPN,compound-poss,pobj,NNP-NNP,NNP,7,1
10694,46641.0,42,was,11,6,1,-5,5,40,5,-10,the Opera National de Paris,Mortier,ORGANIZATION-ORGANIZATION-ORGANIZATION-ORGANIZATION-ORGANIZATION,PERSON,DET-PROPN-PROPN-PROPN-PROPN,ADJ,det-compound-compound-compound-pobj,nsubj,DT-NNP-NNP-NNP-NNP,JJR,5,1
10695,46642.0,33,said,30,15,14,-1,14,18,15,-16,Hussein Kamel,General,PERSON-PERSON,TITLE,PROPN-PROPN,PROPN,compound-compound,compound,NNP-NNP,NNP,2,1
10696,46644.0,31,has,16,2,5,3,1,25,14,-11,CMA,"5,000 members",ORGANIZATION,NUMBER-NUMBER,PROPN,NUM-NOUN,nsubj,nummod-dobj,NNP,CD-NNS,1,1
10697,46652.0,31,was,1,9,30,21,8,0,-8,29,National Union for the Total Independence of Angola,Luanda,ORGANIZATION-ORGANIZATION-ORGANIZATION-ORGANIZATION-ORGANIZATION-ORGANIZATION-ORGANIZATION-ORGANIZATION,CITY,PROPN-PROPN-ADP-DET-PROPN-PROPN-ADP-PROPN,PROPN,compound-pobj-prep-det-compound-pobj-prep-pobj,pobj,NNP-NNP-IN-DT-NNP-NNP-IN-NNP,NNP,-1,1
10698,51050.0,31,detained,20,11,30,19,10,0,9,10,National Union for the Total Independence of Angola,Luanda,ORGANIZATION-ORGANIZATION-ORGANIZATION-ORGANIZATION-ORGANIZATION-ORGANIZATION-ORGANIZATION-ORGANIZATION,CITY,PROPN-PROPN-ADP-DET-PROPN-PROPN-ADP-PROPN,PROPN,compound-nsubjpass-prep-det-compound-pobj-prep-compound,pobj,NNP-NNP-IN-DT-NNP-NNP-IN-NNP,NNP,3,1
10699,46656.0,26,said,11,24,13,-11,23,12,-13,2,Medina hospital,Ali Mohali Mohamed,ORGANIZATION-ORGANIZATION,PERSON-PERSON-PERSON,PROPN-NOUN,PROPN-PROPN-PROPN,compound-pobj,compound-compound-nsubj,NNP-NN,NNP-NNP-NNP,5,1
10700,46659.0,23,WINCHESTER,0,7,20,13,6,2,-7,20,Farland,officer,PERSON,TITLE,PROPN,NOUN,nsubj,conj,NNP,NN,5,1
10701,46665.0,17,won,13,1,9,8,0,7,12,-4,Awami League,Khaleda,ORGANIZATION-ORGANIZATION,PERSON,PROPN-PROPN,PROPN,compound-poss,compound,NNP-NNP,NNP,4,1
10702,46666.0,8,wrote,6,5,2,-3,4,5,1,-4,CMA,Fred Goodwin,ORGANIZATION,PERSON-PERSON,PROPN,PROPN-PROPN,nsubj,compound-nmod,NNP,NNP-NNP,3,1
10703,46670.0,28,died,23,1,5,4,0,22,22,-18,Randall Forsberg,activist,PERSON-PERSON,TITLE,PROPN-PROPN,NOUN,compound-nsubj,appos,NNP-NNP,NN,3,1
10704,46695.0,25,was,20,16,1,-15,15,23,4,-19,Ali Akbar Hashemi Rafsanjani,Mohammed Hashemi,PERSON-PERSON-PERSON-PERSON,PERSON-PERSON,PROPN-PROPN-PROPN-PROPN,PROPN-PROPN,compound-compound-compound-appos,compound-nsubj,NNP-NNP-NNP-NNP,NNP-NNP,2,1
10705,46701.0,65,told,9,7,2,-5,6,62,2,-7,Nicholas Burns,Secretary for Political,PERSON-PERSON,TITLE-TITLE-TITLE,PROPN-PROPN,PROPN-ADP-PROPN,compound-pobj,nmod-prep-compound,NNP-NNP,NNP-IN-NNP,1,1
10706,46705.0,40,said,14,21,10,-11,20,29,-7,-4,Convocation of Anglicans in North America,Church of Nigeria,ORGANIZATION-ORGANIZATION-ORGANIZATION-ORGANIZATION-ORGANIZATION-ORGANIZATION,ORGANIZATION-ORGANIZATION-ORGANIZATION,PROPN-ADP-PROPN-ADP-PROPN-PROPN,PROPN-ADP-PROPN,pobj-prep-pobj-prep-compound-pobj,pobj-prep-pobj,NNP-IN-NNPS-IN-NNP-NNP,NNP-IN-NNP,10,1
10707,46721.0,50,died,35,1,48,47,0,1,34,13,Gilbert Gude,Washington DC,PERSON-PERSON,COUNTRY-COUNTRY,PROPN-PROPN,PROPN-PROPN,compound-nsubj,compound-pobj,NNP-NNP,NNP-NNP,7,1
10708,46725.0,45,serves,13,12,35,23,11,9,1,22,Chen,European Academy of Sciences,PERSON,ORGANIZATION-ORGANIZATION-ORGANIZATION-ORGANIZATION,PROPN,PROPN-PROPN-ADP-PROPN,pobj,compound-pobj-prep-pobj,NNP,NNP-NNP-IN-NNPS,7,1
10709,46726.0,42,charms,6,22,27,5,21,14,-16,21,Binoche,chef,PERSON,TITLE,PROPN,NOUN,nsubj,poss,NNP,NN,5,1
10710,46731.0,28,was,1,9,20,11,8,7,-8,19,Johnny Knoxville,MTV,PERSON-PERSON,ORGANIZATION,PROPN-PROPN,PROPN,compound-poss,pobj,NNP-NNP,NNP,5,1
10711,60416.0,24,looked,11,1,7,6,0,16,10,-4,Johnny Knoxville,MTV,PERSON-PERSON,ORGANIZATION,PROPN-PROPN,PROPN,compound-nsubj,poss,NNP-NNP,NNP,5,1
10712,46739.0,21,says,7,19,17,-2,18,3,-12,10,Oscar Peterson,pianist,PERSON-PERSON,TITLE,PROPN-PROPN,NOUN,compound-pobj,attr,NNP-NNP,NN,3,1
10713,46743.0,20,became,5,5,7,2,4,12,0,2,she,executive assistant,PERSON,TITLE-TITLE,PRON,ADJ-NOUN,nsubj,amod-attr,PRP,JJ-NN,1,1
10714,46749.0,44,quit,1,11,7,-4,10,36,-10,6,NSC,his,ORGANIZATION,PERSON,PROPN,DET,pobj,poss,NNP,PRP$,1,1
10715,46756.0,37,founded,7,1,34,33,0,2,6,27,He,Representatives,PERSON,TITLE,PRON,PROPN,nsubj,pobj,PRP,NNPS,12,1
10716,46765.0,38,join,21,2,6,4,1,31,19,-15,Andre Carson,Democratic-leaning,PERSON-PERSON,ORGANIZATION,PROPN-PROPN,VERB,compound-nsubj,amod,NNP-NNP,VBG,4,1
10717,46786.0,69,said,46,59,55,-4,58,13,-13,9,Norris Comprehensive Cancer Center,Pigmented Lesion Clinic,ORGANIZATION-ORGANIZATION-ORGANIZATION-ORGANIZATION,ORGANIZATION-ORGANIZATION-ORGANIZATION,PROPN-PROPN-PROPN-PROPN,PROPN-PROPN-PROPN,compound-compound-compound-pobj,compound-compound-pobj,NNP-NNP-NNP-NNP,NNP-NNP-NNP,4,1
10718,46797.0,71,said,38,11,68,57,10,2,27,30,CPC,socialist,ORGANIZATION,IDEOLOGY,PROPN,ADJ,compound,amod,NNP,JJ,-1,1
10719,46802.0,43,founded,7,14,5,-9,13,37,-7,-2,his,Methodist,PERSON,RELIGION,DET,ADJ,poss,compound,PRP$,JJ,5,1
10720,46806.0,36,hooked,18,24,14,-10,23,21,-6,-4,Adam Senn,23-year-old,PERSON-PERSON,DURATION,PROPN-PROPN,NUM,compound-pobj,amod,NNP-NNP,CD,4,1
10721,46808.0,61,said,26,1,8,7,0,52,25,-18,Phil Chen,singer,PERSON-PERSON,TITLE,PROPN-PROPN,NOUN,compound-nsubj,appos,NNP-NNP,NN,2,1
10722,46816.0,32,quoted,14,8,1,-7,7,30,6,-13,Philadelphia Inquirer,Brian Tierney,ORGANIZATION-ORGANIZATION,PERSON-PERSON,PROPN-PROPN,PROPN-PROPN,compound-nmod,compound-nsubjpass,NNP-NNP,NNP-NNP,4,1
10723,46820.0,48,came,20,9,4,-5,8,43,11,-16,CNR,Canadian National Railway Company,ORGANIZATION,ORGANIZATION-ORGANIZATION-ORGANIZATION-ORGANIZATION,PROPN,PROPN-PROPN-PROPN-PROPN,compound,compound-compound-compound-pobj,NNP,NNP-NNP-NNP-NNP,4,1
10724,46832.0,35,survived,2,11,27,16,10,7,-9,25,Emily Ann Kennard Derounian,Eleanor Derounian,PERSON-PERSON-PERSON-PERSON,PERSON-PERSON,PROPN-PROPN-PROPN-PROPN,PROPN-PROPN,compound-compound-compound-appos,compound-conj,NNP-NNP-NNP-NNP,NNP-NNP,5,1
10725,46833.0,40,said,23,30,25,-5,29,14,-7,2,Ghent University,Brice De Ruyver,ORGANIZATION-ORGANIZATION,PERSON-PERSON-PERSON,PROPN-PROPN,PROPN-PROPN-PROPN,compound-compound,compound-compound-nsubj,NNP-NNP,NNP-NNP-NNP,4,1
10726,46847.0,29,co-founder,1,6,5,-1,5,23,-5,4,Country Music Association,Nashville-based,ORGANIZATION-ORGANIZATION-ORGANIZATION,CITY,PROPN-PROPN-PROPN,PROPN,compound-compound-pobj,compound,NNP-NNP-NNP,NNP,3,1
10727,46848.0,39,kirstyb,1,15,31,16,14,7,-14,30,Palermo,New York,PERSON,STATE_OR_PROVINCE-STATE_OR_PROVINCE,PROPN,PROPN-PROPN,poss,compound-nmod,NNP,NNP-NNP,8,1
10728,46855.0,15,born,5,8,1,-7,7,13,-3,-4,"June 7 , 1910",Henry Bradford Washburn,PERSON-PERSON-PERSON-PERSON,DATE-DATE-DATE,PROPN-NUM-PUNCT-NUM,PROPN-PROPN-PROPN,pobj-nummod-punct-nummod,compound-compound-compound,"NNP-CD-,-CD",NNP-NNP-NNP,5,1
10729,46869.0,34,said,32,29,31,2,28,2,3,-1,FAA,Laura Brown,ORGANIZATION,PERSON-PERSON,PROPN,PROPN-PROPN,compound,compound-nsubj,NNP,NNP-NNP,3,1
10730,46871.0,8,'s,1,6,7,1,5,0,-5,6,ANP,http://americannationalparty.com/,ORGANIZATION,URL,PROPN,NOUN,compound,pobj,NNP,NN,4,1
10731,46873.0,27,said,25,4,3,-1,3,23,21,-22,Li Jie,executive,PERSON-PERSON,TITLE,PROPN-PROPN,NOUN,compound-nsubj,compound,NNP-NNP,NN,1,1
10732,46876.0,57,MAYOR,4,44,35,-9,43,21,-40,31,American Beverage,Kevin Keane,ORGANIZATION-ORGANIZATION,PERSON-PERSON,PROPN-PROPN,PROPN-PROPN,compound-compound,compound-nsubj,NNP-NNP,NNP-NNP,5,1
10733,46881.0,36,said,26,28,33,5,27,2,-2,7,Kerry,Massachusetts General Hospital,PERSON,ORGANIZATION-ORGANIZATION-ORGANIZATION,PROPN,PROPN-PROPN-PROPN,nsubj,compound-compound-pobj,NNP,NNP-NNP-NNP,4,1
10734,46891.0,25,moved,3,12,6,-6,11,18,-9,3,George,Plant City,PERSON,CITY-CITY,PROPN,PROPN-PROPN,nsubjpass,compound-pobj,NNP,NNP-NNP,2,1
10735,46893.0,32,graduated,1,28,6,-22,27,25,-27,5,he,Frederick Douglass High School,PERSON,ORGANIZATION-ORGANIZATION-ORGANIZATION-ORGANIZATION,PRON,PROPN-PROPN-PROPN-PROPN,nsubj,compound-compound-compound-pobj,PRP,NNP-NNP-NNP-NNP,8,1
10736,46898.0,36,left,10,2,7,5,1,28,8,-3,DeBlanc,Lockport,PERSON,CITY,PROPN,PROPN,nsubj,pobj,NNP,NNP,5,1
10737,46901.0,36,said,34,7,3,-4,6,32,27,-31,Carnival Corp.,he,ORGANIZATION-ORGANIZATION,PERSON,PROPN-PROPN,PRON,compound-poss,nsubj,NNP-NNP,PRP,4,1
10738,46910.0,27,returned,25,3,13,10,2,13,22,-12,Philadelphia Inquirer,Tierney,ORGANIZATION-ORGANIZATION,PERSON,PROPN-PROPN,PROPN,compound-compound,pobj,NNP-NNP,NNP,7,1
10739,46927.0,28,had,13,1,11,10,0,16,12,-2,Gaius Bolin,Williams College,PERSON-PERSON,ORGANIZATION-ORGANIZATION,PROPN-PROPN,PROPN-PROPN,compound-nsubj,compound-pobj,NNP-NNP,NNP-NNP,4,1
10740,46928.0,21,died,17,1,4,3,0,16,16,-13,LORRAINE ROTHMAN,75,PERSON-PERSON,NUMBER,PROPN-PROPN,NUM,compound-nsubj,appos,NNP-NNP,CD,1,1
10741,46929.0,27,is,1,1,24,23,0,2,0,23,Carnival,The Yachts of Seabourn,ORGANIZATION,ORGANIZATION-ORGANIZATION-ORGANIZATION-ORGANIZATION,NOUN,DET-PROPN-ADP-PROPN,nsubj,det-conj-prep-pobj,NN,DT-NNPS-IN-NNP,8,1
10742,46934.0,27,lampooned,2,15,12,-3,14,14,-13,10,Ahearn,Mass.,PERSON,STATE_OR_PROVINCE,PROPN,PROPN,poss,compound,NNP,NNP,4,1
10743,46936.0,61,saw,2,11,39,28,10,21,-9,37,Paul Sculfor,Jen,PERSON-PERSON,PERSON,PROPN-PROPN,PROPN,compound-appos,pobj,NNP-NNP,NNP,7,1
10744,46940.0,45,filed,7,16,12,-4,15,32,-9,5,House chairman of the Joint Committee on Municipalities and Regional Government,Vincent A Pedone,ORGANIZATION-ORGANIZATION-ORGANIZATION-ORGANIZATION-ORGANIZATION-ORGANIZATION-ORGANIZATION-ORGANIZATION-ORGANIZATION-ORGANIZATION-ORGANIZATION,PERSON-PERSON-PERSON,PROPN-NOUN-ADP-DET-PROPN-PROPN-ADP-PROPN-CCONJ-PROPN-PROPN,PROPN-PROPN-PROPN,compound-appos-prep-det-compound-pobj-prep-pobj-cc-compound-conj,compound-compound-nsubj,NNP-NN-IN-DT-NNP-NNP-IN-NNPS-CC-NNP-NNP,NNP-NNP-NNP,2,1
10745,46955.0,56,have,4,22,39,17,21,16,-18,35,Jaguars,Brady,ORGANIZATION,PERSON,PROPN,PROPN,nsubj,nsubj,NNPS,NNP,3,1
10746,46964.0,33,said,16,10,15,5,9,17,6,-1,Communist Party of China,CPC,ORGANIZATION-ORGANIZATION-ORGANIZATION-ORGANIZATION,ORGANIZATION,PROPN-PROPN-ADP-PROPN,PROPN,compound-pobj-prep-pobj,compound,NNP-NNP-IN-NNP,NNP,6,1
10747,49029.0,52,said,7,25,30,5,24,21,-18,23,Communist Party of China,CPC,ORGANIZATION-ORGANIZATION-ORGANIZATION-ORGANIZATION,ORGANIZATION,PROPN-PROPN-ADP-PROPN,PROPN,compound-pobj-prep-pobj,compound,NNP-NNP-IN-NNP,NNP,8,1
10748,51257.0,31,made,3,21,26,5,20,4,-18,23,Communist Party of China,CPC,ORGANIZATION-ORGANIZATION-ORGANIZATION-ORGANIZATION,ORGANIZATION,PROPN-PROPN-ADP-PROPN,PROPN,compound-appos-prep-pobj,compound,NNP-NNP-IN-NNP,NNP,2,1
10749,62594.0,50,ordered,31,22,27,5,21,22,9,-4,Communist Party of China,CPC,ORGANIZATION-ORGANIZATION-ORGANIZATION-ORGANIZATION,ORGANIZATION,PROPN-PROPN-ADP-PROPN,PROPN,compound-pobj-prep-pobj,compound,NNP-NNP-IN-NNP,NNP,6,1
10750,46966.0,36,HENEBRY,2,1,7,6,0,28,1,5,JOHN P HENEBRY,PILOT,PERSON-PERSON-PERSON,TITLE,PROPN-PROPN-PROPN,NOUN,compound-compound-ROOT,conj,NNP-NNP-NNP,NNS,3,1
10751,46979.0,43,said,11,9,2,-7,8,40,2,-9,Berthold Huber,head,PERSON-PERSON,TITLE,PROPN-PROPN,NOUN,compound-appos,nsubj,NNP-NNP,NN,2,1
10752,47006.0,25,returned,10,10,13,3,9,11,0,3,he,Yale,PERSON,ORGANIZATION,PRON,PROPN,nsubj,pobj,PRP,NNP,1,1
10753,47021.0,13,born,4,1,12,11,0,0,3,8,Parren James Mitchell,Maryland,PERSON-PERSON-PERSON,STATE_OR_PROVINCE,PROPN-PROPN-PROPN,PROPN,compound-compound-nsubjpass,pobj,NNP-NNP-NNP,NNP,3,1
10754,47022.0,21,established,6,1,11,10,0,9,5,5,"Barnes , a pharmaceutical magnate , established the foundation",1922,ORGANIZATION-ORGANIZATION-ORGANIZATION-ORGANIZATION-ORGANIZATION-ORGANIZATION-ORGANIZATION-ORGANIZATION-ORGANIZATION,DATE,NOUN-PUNCT-DET-ADJ-NOUN-PUNCT-VERB-DET-NOUN,NUM,nsubj-punct-det-amod-appos-punct-ROOT-det-dobj,pobj,"NNS-,-DT-JJ-NN-,-VBD-DT-NN",CD,4,1
10755,47046.0,16,died,12,1,5,4,0,10,11,-7,His,Pegga Adeline Smith,PERSON,PERSON-PERSON-PERSON,DET,PROPN-PROPN-PROPN,poss,compound-compound-appos,PRP$,NNP-NNP-NNP,3,1
10756,47050.0,32,paid,15,7,21,14,6,10,8,6,Oscar Peterson,musician,PERSON-PERSON,TITLE,PROPN-PROPN,NOUN,nmod-compound,compound,NNP-NNP,NN,7,1
10757,47060.0,42,died,35,1,38,37,0,3,34,3,George Roy Hill,2002,PERSON-PERSON-PERSON,DATE,PROPN-PROPN-PROPN,NUM,compound-compound-nsubj,pobj,NNP-NNP-NNP,CD,3,1
10758,47066.0,20,born,2,1,15,14,0,4,1,13,Forsberg,Long Island,PERSON,LOCATION-LOCATION,PROPN,PROPN-PROPN,nsubjpass,compound-pobj,NNP,NNP-NNP,4,1
10759,47072.0,38,died,10,32,12,-20,31,25,-22,2,him,June 14,PERSON,DATE-DATE,PRON,PROPN-NUM,dobj,npadvmod-nummod,PRP,NNP-CD,3,1
10760,47073.0,32,survived,7,16,21,5,15,10,-9,14,Silvestre,Robert,PERSON,PERSON,PROPN,PROPN,appos,conj,NNP,NNP,4,1
10761,47097.0,48,died,37,42,39,-3,41,8,-5,2,her,Sept. 25,PERSON,DATE-DATE,DET,PROPN-NUM,poss,npadvmod-nummod,PRP$,NNP-CD,4,1
10762,47104.0,46,Party,3,11,6,-5,10,39,-8,3,Shah Mahmood Quraishi,PPP,PERSON-PERSON-PERSON,ORGANIZATION,PROPN-PROPN-PROPN,PROPN,compound-compound-appos,compound,NNP-NNP-NNP,NNP,4,1
10763,47123.0,52,said,27,40,25,-15,39,26,-13,-2,Chinese Communist Party,Taiwan Work Office,ORGANIZATION-ORGANIZATION-ORGANIZATION,ORGANIZATION-ORGANIZATION-ORGANIZATION,PROPN-PROPN-PROPN,PROPN-PROPN-PROPN,compound-compound-compound,compound-compound-pobj,NNP-NNP-NNP,NNP-NNP-NNP,11,1
10764,47133.0,24,came,2,8,5,-3,7,18,-6,3,Hugo Chavez,Venezuala,PERSON-PERSON,ORGANIZATION,PROPN-PROPN,PROPN,compound-nsubj,poss,NNP-NNP,NNP,3,1
10765,47150.0,13,married,8,8,10,2,7,2,0,2,Flowers,Mary Catherine Russell,PERSON,PERSON-PERSON-PERSON,PROPN,PROPN-PROPN-PROPN,nsubj,compound-compound-dobj,NNP,NNP-NNP-NNP,2,1
10766,47159.0,26,said,14,20,25,5,19,0,-6,11,tree group,Missouri,ORGANIZATION-ORGANIZATION,STATE_OR_PROVINCE,NOUN-NOUN,PROPN,compound-pobj,pobj,NN-NN,NNP,3,1
10767,47176.0,96,04/11/07,7,58,66,8,57,29,-51,59,company,Ho Chen-tan,ORGANIZATION,PERSON-PERSON,NOUN,PROPN-INTJ,pobj,compound-appos,NN,NNP-UH,7,1
10768,47177.0,42,said,39,35,29,-6,34,12,4,-10,Carnival Corp,Cunard Line,ORGANIZATION-ORGANIZATION,ORGANIZATION-ORGANIZATION,PROPN-PROPN,PROPN-PROPN,compound-pobj,compound-pobj,NNP-NNP,NNP-NNP,3,1
10769,47186.0,24,let,7,4,10,6,3,13,3,3,Fidelity Investments,"1,300",ORGANIZATION-ORGANIZATION,NUMBER,PROPN-PROPN,NUM,compound-nsubj,nummod,NNP-NNPS,CD,2,1
10770,47197.0,29,was,1,10,23,13,9,5,-9,22,Chris Dodd,Washington,PERSON-PERSON,STATE_OR_PROVINCE,PROPN-PROPN,PROPN,compound-conj,compound,NNP-NNP,NNP,7,1
10771,47201.0,35,approved,18,9,23,14,8,11,9,5,Barry Goldwater,United States,PERSON-PERSON,COUNTRY-COUNTRY,PROPN-PROPN,PROPN-PROPN,compound-appos,compound-compound,NNP-NNP,NNP-NNP,7,1
10772,47209.0,28,said,18,20,25,5,19,2,-2,7,Chris Bentley,U.S. Immigration Service,PERSON-PERSON,ORGANIZATION-ORGANIZATION-ORGANIZATION,PROPN-PROPN,PROPN-PROPN-PROPN,compound-nsubj,compound-compound-pobj,NNP-NNP,NNP-NNP-NNP,5,1
10773,47247.0,51,joked,13,13,13,0,12,37,0,0,Spencer,Spencer,PERSON,PERSON,PROPN,PROPN,conj,nsubjpass,NNP,NNP,0,1
10774,47248.0,25,said,12,1,9,8,0,15,11,-3,Philip Chen,Cathay Pacific Airways,PERSON-PERSON,ORGANIZATION-ORGANIZATION-ORGANIZATION,PROPN-PROPN,PROPN-PROPN-PROPN,compound-nsubj,compound-compound-pobj,NNP-NNP,NNP-NNP-NNP,4,1
10775,47250.0,31,said,18,20,24,4,19,6,-2,6,Donald E. Wildmon,chairman,PERSON-PERSON-PERSON,TITLE,PROPN-PROPN-PROPN,NOUN,compound-compound-nsubj,appos,NNP-NNP-NNP,NN,2,1
10776,47253.0,28,'s,2,19,6,-13,18,21,-17,4,KGB,Primakov,ORGANIZATION,PERSON,PROPN,PROPN,pobj,attr,NNP,NNP,4,1
10777,47273.0,21,died,17,1,14,13,0,6,16,-3,LORRAINE ROTHMAN,Alvin H Rothman,PERSON-PERSON,PERSON-PERSON-PERSON,PROPN-PROPN,PROPN-PROPN-PROPN,compound-nsubj,compound-compound-appos,NNP-NNP,NNP-NNP-NNP,3,1
10778,47282.0,20,is,8,12,6,-6,11,13,-4,-2,Chad White,Million Father March,PERSON-PERSON,ORGANIZATION-ORGANIZATION-ORGANIZATION,PROPN-PROPN,PROPN-PROPN-PROPN,compound-attr,compound-compound-pobj,NNP-NNP,NNP-NNP-NNP,5,1
10779,47301.0,37,reported,26,10,16,6,9,20,16,-10,Samsung,Lee Hak-soo,ORGANIZATION,PERSON-PERSON,PROPN,PROPN-PROPN,amod,compound-pobj,NNP,NNP-NNP,3,1
10780,47308.0,48,includes,7,33,23,-10,32,24,-26,16,Beyonce,Craig David,PERSON,PERSON-PERSON,PROPN,PROPN-PROPN,conj,compound-conj,NNP,NNP-NNP,-1,1
10781,47327.0,38,parade,2,13,21,8,12,16,-11,19,Abbas Moussawi,assassinated,PERSON-PERSON,CAUSE_OF_DEATH,PROPN-PROPN,VERB,compound-conj,relcl,NNP-NNP,VBN,-1,1
10782,47350.0,4,Foundation,1,1,4,3,0,-1,0,3,Barnes Foundation,http://www.barnesfoundation.org,ORGANIZATION-ORGANIZATION,URL,PROPN-PROPN,PUNCT,compound-ROOT,appos,NNP-NNP,.,-1,1
10783,47354.0,31,slashed,8,5,1,-4,4,29,3,-7,NEC Corp,Japan,ORGANIZATION-ORGANIZATION,COUNTRY,PROPN-PROPN,PROPN,compound-nsubj,poss,NNP-NNP,NNP,2,1
10784,47356.0,37,pleaded,26,3,32,29,2,4,23,6,Brandon McInerney,Ventura County,PERSON-PERSON,LOCATION-LOCATION,PROPN-PROPN,PROPN-PROPN,compound-nsubj,compound-pobj,NNP-NNP,NNP-NNP,5,1
10785,47368.0,34,KC-BLOCK,0,10,4,-6,9,29,-10,4,Option One,Block,ORGANIZATION-ORGANIZATION,ORGANIZATION,PROPN-NUM,PROPN,dobj-nummod,nsubj,NNP-CD,NNP,4,1
10786,47383.0,61,rediscovered,18,9,16,7,8,44,9,-2,Disneyland,Hong Kong,ORGANIZATION,CITY-CITY,PROPN,PROPN-PROPN,nsubj,compound-pobj,NNP,NNP-NNP,4,1
10787,47395.0,22,got,1,1,11,10,0,10,0,10,he,Mississippi,PERSON,STATE_OR_PROVINCE,PRON,PROPN,nsubj,pobj,PRP,NNP,2,1
10788,47398.0,36,said,33,1,4,3,0,31,32,-29,Her,Edward,PERSON,PERSON,DET,PROPN,poss,appos,PRP$,NNP,2,1
10789,47399.0,47,disputed,23,15,18,3,14,28,8,-5,Yolanda King,2007,PERSON-PERSON,DATE,PROPN-PROPN,NUM,compound-pobj,pobj,NNP-NNP,CD,7,1
10790,47406.0,28,said,11,8,1,-7,7,26,3,-10,Awami National Party,Afrasiab Khattak,ORGANIZATION-ORGANIZATION-ORGANIZATION,PERSON-PERSON,PROPN-PROPN-PROPN,PROPN-PROPN,compound-compound-pobj,compound-nsubj,NNP-NNP-NNP,NNP-NNP,4,1
10791,58182.0,32,said,20,29,22,-7,28,9,-9,2,Awami National Party,Afrasiab Khattak,ORGANIZATION-ORGANIZATION-ORGANIZATION,PERSON-PERSON,PROPN-PROPN-PROPN,PROPN-PROPN,compound-compound-pobj,compound-nsubj,NNP-NNP-NNP,NNP-NNP,5,1
10792,58443.0,29,said,10,26,12,-14,25,16,-16,2,Awami National Party,Afrasiab Khattak,ORGANIZATION-ORGANIZATION-ORGANIZATION,PERSON-PERSON,PROPN-PROPN-PROPN,PROPN-PROPN,compound-compound-pobj,compound-nsubj,NNP-NNP-NNP,NNP-NNP,5,1
10793,59834.0,25,said,12,9,1,-8,8,23,3,-11,Awami National Party,Afrasiab Khattak,ORGANIZATION-ORGANIZATION-ORGANIZATION,PERSON-PERSON,PROPN-PROPN-PROPN,PROPN-PROPN,compound-compound-pobj,compound-nsubj,NNP-NNP-NNP,NNP-NNP,5,1
10794,67999.0,53,said,20,28,22,-6,27,30,-8,2,Awami National Party,Afrasiab Khattak,ORGANIZATION-ORGANIZATION-ORGANIZATION,PERSON-PERSON,PROPN-PROPN-PROPN,PROPN-PROPN,compound-compound-pobj,compound-nsubj,NNP-NNP-NNP,NNP-NNP,5,1
10795,47410.0,20,poised,5,1,13,12,0,6,4,8,Focus on the Family,Colorado,ORGANIZATION-ORGANIZATION-ORGANIZATION-ORGANIZATION,CITY,VERB-ADP-DET-PROPN,PROPN,nsubjpass-prep-det-pobj,nmod,VB-IN-DT-NNP,NNP,8,1
10796,47414.0,27,said,17,3,19,16,2,7,14,2,Citibank,Lee AhBoon,ORGANIZATION,PERSON-PERSON,PROPN,PROPN-PROPN,compound,compound-nsubj,NNP,NNP-NNP,5,1
10797,47415.0,30,elected,11,10,16,6,9,13,1,5,Gillmor,House of Representatives,PERSON,ORGANIZATION-ORGANIZATION-ORGANIZATION,PROPN,PROPN-ADP-PROPN,nsubjpass,pobj-prep-pobj,NNP,NNP-IN-NNPS,4,1
10798,47418.0,28,spent,1,1,11,10,0,16,0,10,Kurnaz,Kandahar,PERSON,LOCATION,PROPN,PROPN,nsubj,pobj,NNP,NNP,1,1
10799,47435.0,49,hopes,26,20,15,-5,19,33,6,-11,Arsenal,FA,ORGANIZATION,ORGANIZATION,PROPN,PROPN,pobj,compound,NNP,NNP,3,1
10800,47437.0,18,At,0,4,11,7,3,6,-4,11,Photographic Resource Center,832 Commonwealth Avenue,ORGANIZATION-ORGANIZATION-ORGANIZATION,LOCATION-LOCATION-LOCATION,PROPN-PROPN-PROPN,NUM-PROPN-PROPN,compound-compound-pobj,nummod-compound-appos,NNP-NNP-NNP,CD-NNP-NNP,3,1
10801,47475.0,44,has,21,1,36,35,0,7,20,15,Kendra Wilkinson,Long Beach,PERSON-PERSON,CITY-CITY,PROPN-PROPN,PROPN-PROPN,compound-nsubj,compound-pobj,NNP-NNP,NNP-NNP,8,1
10802,47478.0,19,launched,8,8,2,-6,7,16,0,-6,JEM,May 2008,ORGANIZATION,DATE-DATE,PROPN,PROPN-NUM,pobj,pobj-nummod,NNP,NNP-CD,3,1
10803,47480.0,19,imprisoned,2,1,11,10,0,7,1,9,He,money laundering,PERSON,CRIMINAL_CHARGE-CRIMINAL_CHARGE,PRON,NOUN-NOUN,nsubjpass,compound-pobj,PRP,NN-NN,5,1
10804,47481.0,35,credited,3,1,26,25,0,8,2,23,He,Guantanamo Bay,PERSON,LOCATION-LOCATION,PRON,PROPN-PROPN,nsubjpass,compound-pobj,PRP,NNP-NNP,10,1
10805,47483.0,30,manager,2,15,27,12,14,2,-13,25,RIA-Novosti,RIA,ORGANIZATION,ORGANIZATION,NOUN,PROPN,compound,compound,NN,NNP,5,1
10806,47500.0,41,is,15,1,23,22,0,17,14,8,DeGeneres,CoverGirl,PERSON,ORGANIZATION,PROPN,PROPN,nsubj,pobj,NNP,NNP,6,1
10807,47504.0,24,Shepard,1,9,1,-8,8,22,-8,0,Focus Action,Stuart Shepard,ORGANIZATION-ORGANIZATION,PERSON-PERSON,PROPN-PROPN,PROPN-PROPN,compound-compound,compound-ROOT,NNP-NNP,NNP-NNP,4,1
10808,47510.0,22,said,9,11,18,7,10,3,-2,9,Bob Dillinger,Pinellas,PERSON-PERSON,LOCATION,PROPN-PROPN,PROPN,compound-nsubj,nmod,NNP-NNP,NNP,4,1
10809,47535.0,11,died,7,1,4,3,0,6,6,-3,His,Virginia Christopher Farland,PERSON,PERSON-PERSON-PERSON,DET,PROPN-PROPN-PROPN,poss,compound-compound-appos,PRP$,NNP-NNP-NNP,2,1
10810,47547.0,39,told,1,32,37,5,31,1,-31,36,his,Iraqi,PERSON,NATIONALITY,DET,ADJ,poss,amod,PRP$,JJ,3,1
10811,47566.0,28,said,21,11,19,8,10,8,10,-2,his,Kate Gosselin,PERSON,PERSON-PERSON,DET,PROPN-PROPN,poss,compound-appos,PRP$,NNP-NNP,8,1
10812,47576.0,18,joined,5,1,13,12,0,4,4,8,He,Washington Redskins,PERSON,ORGANIZATION-ORGANIZATION,PRON,PROPN-PROPN,nsubj,compound-poss,PRP,NNP-NNPS,7,1
10813,47579.0,50,was,1,27,11,-16,26,38,-26,10,NSC,White House Principals Committee,ORGANIZATION,ORGANIZATION-ORGANIZATION-ORGANIZATION-ORGANIZATION,PROPN,PROPN-PROPN-PROPN-PROPN,compound,compound-compound-compound-pobj,NNP,NNP-NNP-NNPS-NNP,8,1
10814,47591.0,58,include,1,16,41,25,15,16,-15,40,Gilbert Gude Jr.,William Callaghan,PERSON-PERSON-PERSON,PERSON-PERSON,PROPN-PROPN-PROPN,PROPN-PROPN,compound-compound-conj,compound-appos,NNP-NNP-NNP,NNP-NNP,4,1
10815,47601.0,71,expanded,5,7,19,12,6,51,-2,14,Zagat,wwwzagatcom,ORGANIZATION,URL,PROPN,NOUN,compound,conj,NNP,NN,6,1
10816,47607.0,59,issued,13,34,34,0,33,24,-21,21,Anglican Church of Canada and La Iglesia Anglicana de Mexico,Anglican Communion,ORGANIZATION-ORGANIZATION-ORGANIZATION-ORGANIZATION-ORGANIZATION-ORGANIZATION-ORGANIZATION-ORGANIZATION-ORGANIZATION-ORGANIZATION,ORGANIZATION-ORGANIZATION,PROPN-PROPN-ADP-PROPN-CCONJ-PROPN-PROPN-PROPN-PROPN-PROPN,PROPN-PROPN,compound-appos-prep-pobj-cc-compound-compound-compound-compound-conj,compound-pobj,NNP-NNP-IN-NNP-CC-NNP-NNP-NNP-NNP-NNP,NNP-NNP,0,1
10817,47625.0,33,loss-making,3,1,24,23,0,8,2,21,Alcatel-Lucent,Lucent Technologies Inc,ORGANIZATION,ORGANIZATION-ORGANIZATION-ORGANIZATION,ADJ,PROPN-PROPN-PROPN,nsubj,compound-compound-pobj,JJ,NNP-NNP-NNP,7,1
10818,47635.0,30,established,6,4,10,6,3,19,2,4,Rothman,Feminist Women 's Health Center,PERSON,ORGANIZATION-ORGANIZATION-ORGANIZATION-ORGANIZATION-ORGANIZATION,PROPN,PROPN-PROPN-PART-PROPN-PROPN,nsubj,nmod-poss-case-compound-dobj,NNP,NNP-NNPS-POS-NNP-NNP,4,1
10819,47637.0,24,said,10,22,19,-3,21,4,-12,9,MF Global,Lind-Waldock,ORGANIZATION-ORGANIZATION,ORGANIZATION,PROPN-PROPN,ADJ,compound-pobj,amod,NNP-NNP,JJ,2,1
10820,47639.0,36,said,4,15,6,-9,14,29,-11,2,FMR Corp,Rodger A Lawson,ORGANIZATION-ORGANIZATION,PERSON-PERSON-PERSON,PROPN-PROPN,PROPN-PROPN-PROPN,compound-pobj,compound-compound-nsubj,NNP-NNP,NNP-NNP-NNP,4,1
10821,47653.0,17,achieved,8,1,7,6,0,9,7,-1,Sills,78,PERSON,NUMBER,NOUN,NUM,nsubj,pobj,NNS,CD,2,1
10822,47667.0,25,said,8,20,24,4,19,0,-12,16,University of Ghent,Belgium,ORGANIZATION-ORGANIZATION-ORGANIZATION,COUNTRY,PROPN-ADP-PROPN,PROPN,pobj-prep-pobj,pobj,NNP-IN-NNP,NNP,2,1
10823,47668.0,44,said,39,27,22,-5,26,21,12,-17,Julian Bond,National Board,PERSON-PERSON,ORGANIZATION-ORGANIZATION,PROPN-PROPN,PROPN-PROPN,compound-nsubj,compound-nmod,NNP-NNP,NNP-NNP,3,1
10824,47670.0,47,said,29,45,35,-10,44,11,-16,6,Philadelphia Inquirer,Vernon Loeb,ORGANIZATION-ORGANIZATION,PERSON-PERSON,PROPN-PROPN,PROPN-PROPN,compound-pobj,compound-nsubj,NNP-NNP,NNP-NNP,7,1
10825,47691.0,41,said,38,2,22,20,1,18,36,-16,Federal Motor Carrier Safety Administration,United States,ORGANIZATION-ORGANIZATION-ORGANIZATION-ORGANIZATION-ORGANIZATION,COUNTRY-COUNTRY,PROPN-PROPN-PROPN-PROPN-PROPN,PROPN-PROPN,compound-compound-compound-compound-nsubj,compound-pobj,NNP-NNP-NNP-NNP-NNP,NNP-NNP,10,1
10826,47694.0,8,PARIS,0,5,2,-3,4,5,-5,2,He,2007-02-23,PERSON,DATE,PRON,NUM,nsubj,nummod,PRP,CD,1,1
10827,47697.0,35,says,3,12,17,5,11,17,-9,14,Lashkar-e-Taiba,Hafiz Mohammed Saeed,ORGANIZATION,PERSON-PERSON-PERSON,PROPN,PROPN-PROPN-PROPN,poss,compound-compound-appos,NNP,NNP-NNP-NNP,3,1
10828,47698.0,45,urged,9,6,16,10,5,28,3,7,PRC,Hamas,ORGANIZATION,ORGANIZATION,PROPN,PROPN,compound,compound,NNP,NNP,-1,1
10829,47723.0,44,singing,15,2,4,2,1,39,13,-11,Chavez,54,PERSON,NUMBER,PROPN,NUM,nsubj,appos,NNP,CD,3,1
10830,47731.0,7,DSM-IV,0,5,1,-4,4,5,-5,1,American Psychiatric Association,DSM-IV,ORGANIZATION-ORGANIZATION-ORGANIZATION,ORGANIZATION,PROPN-PROPN-PROPN,ADV,compound-compound-pobj,ROOT,NNP-NNP-NNP,RB,5,1
10831,47732.0,57,said,20,28,37,9,27,19,-8,17,National Center for Disaster Preparedness,New York,ORGANIZATION-ORGANIZATION-ORGANIZATION-ORGANIZATION-ORGANIZATION,STATE_OR_PROVINCE-STATE_OR_PROVINCE,PROPN-PROPN-ADP-PROPN-PROPN,PROPN-PROPN,compound-pobj-prep-compound-pobj,compound-pobj,NNP-NNP-IN-NNP-NNP,NNP-NNP,8,1
10832,47735.0,47,said,7,11,32,21,10,14,-4,25,the club,Kroenke,ORGANIZATION-ORGANIZATION,PERSON,DET-NOUN,PROPN,det-nsubj,pobj,DT-NN,NNP,5,1
10833,47742.0,47,said,26,36,28,-8,35,18,-10,2,AAA,Betsy Sell,ORGANIZATION,PERSON-PERSON,PROPN,PROPN-PROPN,pobj,compound-nsubj,NNP,NNP-NNP,3,1
10834,47753.0,26,served,6,24,9,-15,23,16,-18,3,Carnival Corp.,Costa,ORGANIZATION-ORGANIZATION,LOCATION,PROPN-PROPN,PROPN,compound-pobj,pobj,NNP-NNP,NNP,6,1
10835,47758.0,30,died,22,3,9,6,2,20,19,-13,Steven B Derounian,Nassau County,PERSON-PERSON-PERSON,ORGANIZATION-ORGANIZATION,PROPN-PROPN-PROPN,PROPN-PROPN,compound-compound-nsubj,compound-dobj,NNP-NNP-NNP,NNP-NNP,3,1
10836,47760.0,13,died,9,2,6,4,1,6,7,-3,Rothman,Alvin H Rothman,PERSON,PERSON-PERSON-PERSON,PROPN,PROPN-PROPN-PROPN,poss,compound-compound-appos,NNP,NNP-NNP-NNP,4,1
10837,47762.0,48,joined,1,9,22,13,8,25,-8,21,Red Cross,American Red Cross of Greater New York,ORGANIZATION-ORGANIZATION,ORGANIZATION-ORGANIZATION-ORGANIZATION-ORGANIZATION-ORGANIZATION-ORGANIZATION-ORGANIZATION,PROPN-PROPN,PROPN-PROPN-PROPN-ADP-PROPN-PROPN-PROPN,compound-pobj,compound-compound-pobj-prep-compound-compound-pobj,NNP-NNP,NNP-NNP-NNP-IN-NNP-NNP-NNP,7,1
10838,47764.0,50,CHAIRMAN,3,1,34,33,0,15,2,31,SAMSUNG,Everland,ORGANIZATION,ORGANIZATION,PROPN,PROPN,poss,pobj,NNP,NNP,-1,1
10839,47780.0,43,were,2,21,23,2,20,19,-19,21,Scorpions,Rudolf Schenker,ORGANIZATION,PERSON-PERSON,PROPN,PROPN-PROPN,compound,compound-dobj,NNPS,NNP-NNP,5,1
10840,47782.0,33,owns,1,27,3,-24,26,29,-26,2,USA Network,Universal Studios,ORGANIZATION-ORGANIZATION,ORGANIZATION-ORGANIZATION,PROPN-PROPN,PROPN-PROPN,compound-pobj,compound-dobj,NNP-NNP,NNP-NNP,6,1
10841,52342.0,81,be,6,34,5,-29,33,75,-28,-1,USA Network,Universal Studios,ORGANIZATION-ORGANIZATION,ORGANIZATION-ORGANIZATION,PROPN-PROPN,PROPN-PROPN,compound-pobj,compound-compound,NNP-NNP,NNP-NNP,4,1
10842,47796.0,34,include,1,16,6,-10,15,27,-15,5,Gilbert Gude,Sharon Gude,PERSON-PERSON,PERSON-PERSON,PROPN-PROPN,PROPN-PROPN,compound-compound,compound-appos,NNP-NNP,NNP-NNP,3,1
10843,47799.0,16,sued,1,1,10,9,0,5,0,9,Mitchell,American,PERSON,NATIONALITY,PROPN,ADJ,nsubj,amod,NNP,JJ,4,1
10844,47810.0,28,is,2,26,8,-18,25,19,-24,6,Frankie Delgado,Los Angeles,PERSON-PERSON,CITY-CITY,PROPN-PROPN,PROPN-PROPN,compound-dobj,compound-compound,NNP-NNP,NNP-NNP,8,1
10845,47828.0,6,Founder,3,1,6,5,0,-1,2,3,Donald E. Wildmon Founder,Chairman,PERSON-PERSON-PERSON-PERSON,TITLE,PROPN-PROPN-PROPN-PROPN,PROPN,compound-compound-compound-ROOT,conj,NNP-NNP-NNP-NNP,NNP,-1,1
10846,47830.0,37,died,26,2,30,28,1,6,24,4,Parren J Mitchell,complications from pneumonia,PERSON-PERSON-PERSON,CAUSE_OF_DEATH-CAUSE_OF_DEATH-CAUSE_OF_DEATH,PROPN-PROPN-PROPN,NOUN-ADP-NOUN,compound-compound-nsubj,pobj-prep-pobj,NNP-NNP-NNP,NNS-IN-NN,6,1
10847,47833.0,21,coaches,4,8,16,8,7,4,-4,12,Northwood University,Nevada-Las Vegas,ORGANIZATION-ORGANIZATION,LOCATION-LOCATION,PROPN-PROPN,PROPN-PROPN,compound-pobj,compound-pobj,NNP-NNP,NNP-NNP,7,1
10848,47859.0,36,said,20,24,30,6,23,5,-4,10,John Kerry,Senate Small Business and Entrepreneurship Committee,PERSON-PERSON,ORGANIZATION-ORGANIZATION-ORGANIZATION-ORGANIZATION-ORGANIZATION-ORGANIZATION,PROPN-PROPN,PROPN-PROPN-PROPN-CCONJ-PROPN-PROPN,compound-nsubj,nmod-nmod-nmod-cc-conj-pobj,NNP-NNP,NNP-NNP-NNP-CC-NNP-NNP,4,1
10849,47862.0,33,said,7,2,6,4,1,26,5,-1,Awami League,Hossain Chowdhury,ORGANIZATION-ORGANIZATION,PERSON-PERSON,PROPN-PROPN,PROPN-PROPN,compound-compound,compound-nsubj,NNP-NNP,NNP-NNP,2,1
10850,47867.0,42,appointed,7,1,4,3,0,37,6,-3,Philip Chen,51,PERSON-PERSON,NUMBER,PROPN-PROPN,NUM,compound-nsubjpass,appos,NNP-NNP,CD,1,1
10851,49787.0,42,appointed,7,1,4,3,0,37,6,-3,Philip Chen,51,PERSON-PERSON,NUMBER,PROPN-PROPN,NUM,compound-nsubjpass,appos,NNP-NNP,CD,1,1
10852,47900.0,48,traveled,8,17,26,9,16,21,-9,18,Moro National Liberation Front,Jolo,ORGANIZATION-ORGANIZATION-ORGANIZATION-ORGANIZATION,CITY,PROPN-PROPN-PROPN-PROPN,PROPN,compound-compound-compound-pobj,pobj,NNP-NNP-NNP-NNP,NNP,5,1
10853,47904.0,39,died,10,1,20,19,0,18,9,10,Waldheim,Vienna,PERSON,CITY,PROPN,PROPN,nsubj,pobj,NNP,NNP,5,1
10854,50989.0,36,studied,18,18,16,-2,17,19,0,-2,Waldheim,Vienna,PERSON,CITY,PROPN,PROPN,nsubj,pobj,NNP,NNP,1,1
10855,47905.0,29,flew,4,24,14,-10,23,14,-20,10,Organization of the Islamic Conference,Abdullah Ahmad Badawi,ORGANIZATION-ORGANIZATION-ORGANIZATION-ORGANIZATION-ORGANIZATION,PERSON-PERSON-PERSON,PROPN-ADP-DET-PROPN-PROPN,PROPN-PROPN-PROPN,pobj-prep-det-compound-pobj,compound-compound-pobj,NNP-IN-DT-NNP-NNP,NNP-NNP-NNP,5,1
10856,56688.0,37,flew,2,20,11,-9,19,25,-18,9,Organization of the Islamic Conference,Abdullah Ahmad Badawi,ORGANIZATION-ORGANIZATION-ORGANIZATION-ORGANIZATION-ORGANIZATION,PERSON-PERSON-PERSON,PROPN-ADP-DET-PROPN-PROPN,PROPN-PROPN-PROPN,pobj-prep-det-compound-pobj,compound-compound-pobj,NNP-IN-DT-NNP-NNP,NNP-NNP-NNP,5,1
10857,63699.0,48,join,5,29,44,15,28,3,-24,39,Organization of the Islamic Conference,Abdullah Ahmad Badawi,ORGANIZATION-ORGANIZATION-ORGANIZATION-ORGANIZATION-ORGANIZATION,PERSON-PERSON-PERSON,PROPN-ADP-DET-PROPN-PROPN,PROPN-PROPN-PROPN,pobj-prep-det-compound-pobj,compound-compound-nsubj,NNP-IN-DT-NNP-NNP,NNP-NNP-NNP,10,1
10858,47914.0,44,says,3,15,43,28,14,0,-12,40,her,Blackburn,PERSON,CITY,DET,PROPN,poss,pobj,PRP$,NNP,14,1
10859,66915.0,32,hometown,1,24,4,-20,23,27,-23,3,her,Blackburn,PERSON,CITY,PRON,PROPN,pobj,pobj,PRP,NNP,5,1
10860,47922.0,45,said,4,3,2,-1,2,42,1,-2,George Sheldon,Secretary,PERSON-PERSON,TITLE,PROPN-PROPN,PROPN,compound-nsubj,compound,NNP-NNP,NNP,1,1
10861,55992.0,36,explained,11,15,14,-1,14,21,-4,3,George Sheldon,Secretary,PERSON-PERSON,TITLE,PROPN-PROPN,PROPN,compound-nsubj,compound,NNP-NNP,NNP,2,1
10862,47932.0,61,CARACAS,0,18,27,9,17,33,-18,27,Hugo Chavez,Bolivarian Republic of Venezuela,PERSON-PERSON,ORGANIZATION-ORGANIZATION-ORGANIZATION-ORGANIZATION,PROPN-PROPN,PROPN-PROPN-ADP-PROPN,compound-pobj,compound-pobj-prep-pobj,NNP-NNP,NNP-NNP-IN-NNP,11,1
10863,47958.0,22,was,9,1,6,5,0,15,8,-3,Ezra Levant,lawyer,PERSON-PERSON,TITLE,PROPN-PROPN,NOUN,compound-nsubj,appos,NNP-NNP,NN,2,1
10864,47981.0,24,worked,1,1,22,21,0,1,0,21,She,vice chairwoman,PERSON,TITLE-TITLE,PRON,NOUN-NOUN,nsubj,compound-conj,PRP,NN-NN,2,1
10865,47989.0,18,found,2,5,17,12,4,0,-3,15,Goldwater,president,PERSON,TITLE,PROPN,NOUN,nsubj,attr,NNP,NN,2,1
10866,47993.0,29,died,16,2,26,24,1,2,14,10,Juanita Millender-McDonald,Carson,PERSON-PERSON,CITY,PROPN-PROPN,PROPN,compound-nsubj,pobj,NNP-NNP,NNP,5,1
10867,50619.0,31,died,26,2,14,12,1,16,24,-12,Juanita Millender-McDonald,Carson,PERSON-PERSON,ORGANIZATION,PROPN-PROPN,PROPN,compound-nsubj,appos,NNP-NNP,NNP,5,1
10868,47994.0,25,be,2,15,14,-1,14,10,-13,12,Ownit Mortgage Solutions,Calif-based,ORGANIZATION-ORGANIZATION-ORGANIZATION,STATE_OR_PROVINCE,PROPN-PROPN-PROPN,PROPN,compound-compound-compound,compound,NNP-NNP-NNPS,NNP,1,1
10869,48001.0,36,said,34,30,33,3,29,2,4,-1,IMF,John Nelmes,ORGANIZATION,PERSON-PERSON,PROPN,PROPN-PROPN,poss,compound-appos,NNP,NNP-NNP,3,1
10870,48015.0,51,said,22,4,32,28,3,18,18,10,Mia Farrow,model,PERSON-PERSON,TITLE,PROPN-PROPN,NOUN,compound-dobj,poss,NNP-NNP,NN,5,1
10871,48036.0,33,is,11,20,32,12,19,0,-9,21,National Museum of Women in the Arts,NW,ORGANIZATION-ORGANIZATION-ORGANIZATION-ORGANIZATION-ORGANIZATION-ORGANIZATION-ORGANIZATION,URL,PROPN-PROPN-ADP-PROPN-ADP-DET-NOUN,PROPN,compound-pobj-prep-pobj-prep-det-pobj,npadvmod,NNP-NNP-IN-NNPS-IN-DT-NNS,NNP,4,1
10872,48043.0,35,survived,2,1,11,10,0,23,1,9,Derounian,Emily Ann Kennard Derounian,PERSON,PERSON-PERSON-PERSON-PERSON,PROPN,PROPN-PROPN-PROPN-PROPN,nsubjpass,compound-compound-compound-appos,NNP,NNP-NNP-NNP-NNP,4,1
10873,48050.0,36,are,6,26,3,-23,25,32,-20,-3,Noordhoff Craniofacial Foundation,NGOs,ORGANIZATION-ORGANIZATION-ORGANIZATION,ORGANIZATION,PROPN-PROPN-PROPN,PROPN,compound-compound-conj,nsubj,NNP-NNP-NNP,NNPS,8,1
10874,48053.0,36,worked,1,1,33,32,0,2,0,32,He,Urban Studies Institute,PERSON,ORGANIZATION-ORGANIZATION-ORGANIZATION,PRON,PROPN-PROPN-PROPN,nsubj,compound-compound-dobj,PRP,NNP-NNPS-NNP,8,1
10875,48074.0,35,sells,5,5,33,28,4,1,0,28,Chavez,Socialist Party,PERSON,ORGANIZATION-ORGANIZATION,PROPN,PROPN-PROPN,pobj,compound-pobj,NNP,NNP-NNP,5,1
10876,48080.0,28,see,14,6,11,5,5,16,8,-3,Barnes Foundation,Pa.,ORGANIZATION-ORGANIZATION,STATE_OR_PROVINCE,PROPN-PROPN,PROPN,compound-pobj,appos,NNP-NNP,NNP,4,1
10877,48081.0,23,elected,5,4,7,3,3,15,1,2,he,mayor,PERSON,TITLE,PRON,NOUN,nsubjpass,oprd,PRP,NN,2,1
10878,48107.0,17,comment,10,13,7,-6,12,9,-3,-3,Old Lane,Citigroup,ORGANIZATION-ORGANIZATION,ORGANIZATION,PROPN-PROPN,PROPN,compound-poss,pobj,NNP-NNP,NNP,4,1
10879,48109.0,38,arrived,19,17,13,-4,16,24,2,-6,SAC,Strategic Airlift Capability,ORGANIZATION,ORGANIZATION-ORGANIZATION-ORGANIZATION,PROPN,PROPN-PROPN-PROPN,compound,compound-compound-compound,NNP,NNP-NNP-NNP,6,1
10880,48115.0,37,said,35,10,27,17,9,9,25,-8,he,Thursday,PERSON,DATE,PRON,PROPN,nsubj,npadvmod,PRP,NNP,7,1
10881,48129.0,66,mokhal,0,5,10,5,4,55,-5,10,Chante Moore,Kenny Lattimore,PERSON-PERSON,PERSON-PERSON,PROPN-PROPN,PROPN-PROPN,compound-nsubj,compound-appos,NNP-NNP,NNP-NNP,2,1
10882,54765.0,62,scrapped,8,1,6,5,0,55,7,-2,Chante Moore,Kenny Lattimore,PERSON-PERSON,PERSON-PERSON,PROPN-PROPN,PROPN-PROPN,compound-nsubj,compound-appos,NNP-NNP,NNP-NNP,2,1
10883,48131.0,12,was,1,1,5,4,0,6,0,4,She,real estate broker,PERSON,TITLE-TITLE-TITLE,PRON,ADJ-NOUN-NOUN,nsubj,amod-compound-attr,PRP,JJ-NN-NN,2,1
10884,48134.0,15,is,1,1,6,5,0,8,0,5,He,Harvard Law School and Harvard School of Business Administration,PERSON,ORGANIZATION-ORGANIZATION-ORGANIZATION-ORGANIZATION-ORGANIZATION-ORGANIZATION-ORGANIZATION-ORGANIZATION-ORGANIZATION,PRON,PROPN-PROPN-PROPN-CCONJ-PROPN-PROPN-ADP-PROPN-PROPN,nsubj,compound-compound-pobj-cc-compound-nmod-prep-pobj-conj,PRP,NNP-NNP-NNP-CC-NNP-NNP-IN-NNP-NNP,4,1
10885,48141.0,74,tussled,8,20,23,3,19,50,-12,15,Carolyn Maloney,D-NY,PERSON-PERSON,STATE_OR_PROVINCE,PROPN-PROPN,PROPN,compound-nsubj,appos,NNP-NNP,NNP,2,1
10886,48143.0,28,was,1,14,9,-5,13,18,-13,8,Project Islamic Hope,Islam,ORGANIZATION-ORGANIZATION-ORGANIZATION,RELIGION,PROPN-PROPN-PROPN,PROPN,compound-compound-appos,pobj,NNP-NNP-NNP,NNP,5,1
10887,48149.0,47,named,2,12,14,2,11,32,-10,12,Ferrara,37,PERSON,NUMBER,PROPN,NUM,dobj,appos,NNP,CD,2,1
10888,48179.0,40,is,4,18,15,-3,17,24,-14,11,his,Texas,PERSON,STATE_OR_PROVINCE,DET,PROPN,poss,pobj,PRP$,NNP,4,1
10889,48192.0,16,Name,5,11,11,0,10,4,-6,6,Shah Murtada,Shah Mahmood,PERSON-PERSON,PERSON-PERSON,PROPN-PROPN,PROPN-PROPN,compound-pobj,compound-pobj,NNP-NNP,NNP-NNP,0,1
10890,48196.0,36,has,1,7,7,0,6,28,-6,6,China FAW Group,China,ORGANIZATION-ORGANIZATION-ORGANIZATION,COUNTRY,PROPN-PROPN-PROPN,PROPN,compound-compound-pobj,pobj,NNP-NNP-NNP,NNP,0,1
10891,48198.0,49,inaugurate,7,5,3,-2,4,45,2,-4,Trista Sutter,Ryan,PERSON-PERSON,PERSON,PROPN-PROPN,PROPN,conj-nsubj,nmod,NNP-NNP,NNP,2,1
10892,48199.0,48,advancing,23,17,8,-9,16,39,6,-15,Herrera,142nd Infantry Regiment,PERSON,ORGANIZATION-ORGANIZATION-ORGANIZATION,PROPN,PROPN-PROPN-PROPN,conj,compound-compound-pobj,NNP,NNP-NNP-NNP,5,1
10893,48216.0,11,died,6,1,8,7,0,2,5,2,His,earlier this year,PERSON,DATE-DATE-DATE,DET,ADV-DET-NOUN,poss,advmod-det-npadvmod,PRP$,RBR-DT-NN,4,1
10894,48232.0,40,is,4,18,1,-17,17,38,-14,-3,his,23-year old,PERSON,DURATION-DURATION,DET,ADJ-ADJ,poss,nummod-amod,PRP$,JJ-JJ,6,1
10895,48238.0,42,Goes,3,10,9,-1,9,32,-7,6,Jeremy Hooper,activist,PERSON-PERSON,TITLE,PROPN-PROPN,NOUN,compound-pobj,compound,NNP-NNP,NN,1,1
10896,48241.0,60,Dies,17,9,12,3,8,47,8,-5,Roy Scheider,Actor,PERSON-PERSON,TITLE,PROPN-PROPN,PROPN,compound-appos,appos,NNP-NNP,NNP,2,1
10897,48243.0,22,served,1,1,19,18,0,2,0,18,He,Iraq,PERSON,COUNTRY,PRON,PROPN,nsubj,pobj,PRP,NNP,2,1
10898,48245.0,25,offered,7,22,13,-9,21,11,-15,6,Golden Baseball League,Chico Outlaws,ORGANIZATION-ORGANIZATION-ORGANIZATION,ORGANIZATION-ORGANIZATION,PROPN-PROPN-PROPN,PROPN-PROPN,compound-compound-pobj,compound-pobj,NNP-NNP-NNP,NNP-NNPS,4,1
10899,48247.0,31,trained,5,8,1,-7,7,29,-3,-4,KGB,Litvinenko,ORGANIZATION,PERSON,PROPN,PROPN,compound,nsubjpass,NNP,NNP,4,1
10900,48255.0,49,died,39,1,18,17,0,30,38,-21,Mary D Crisp,Republican Party,PERSON-PERSON-PERSON,ORGANIZATION-ORGANIZATION,PROPN-PROPN-PROPN,PROPN-PROPN,compound-compound-nsubj,compound-pobj,NNP-NNP-NNP,NNP-NNP,8,1
10901,48261.0,34,BBA-TWINS-REDSOX,0,6,18,12,5,15,-6,18,Red Sox,AL,ORGANIZATION-ORGANIZATION,STATE_OR_PROVINCE,PROPN-PROPN,PROPN,compound-nsubj,compound,NNP-NNPS,NNP,-1,1
10902,66233.0,38,delayed,2,28,16,-12,27,21,-26,14,Red Sox,AL,ORGANIZATION-ORGANIZATION,STATE_OR_PROVINCE,PROPN-PROPN,PROPN,compound-pobj,compound,NNP-NNPS,NNP,7,1
10903,48263.0,10,am,1,6,4,-2,5,5,-5,3,she,gunner,PERSON,TITLE,PRON,NOUN,nsubj,attr,PRP,NN,2,1
10904,48273.0,36,said,4,15,2,-13,14,33,-11,-2,FMR Corp,Boston,ORGANIZATION-ORGANIZATION,CITY,PROPN-PROPN,PROPN,compound-pobj,compound,NNP-NNP,NNP,7,1
10905,48290.0,32,was,13,13,20,7,12,11,0,7,she,spokeswoman,PERSON,TITLE,PRON,NOUN,nsubj,attr,PRP,NN,3,1
10906,48298.0,18,fell,4,10,16,6,9,1,-6,12,his,New Britain,PERSON,CITY-CITY,DET,PROPN-PROPN,poss,compound-pobj,PRP$,NNP-NNP,5,1
10907,48308.0,46,As,0,8,3,-5,7,42,-8,3,SAC,Cabinet-level Sports Affairs Council,ORGANIZATION,ORGANIZATION-ORGANIZATION-ORGANIZATION-ORGANIZATION,PROPN,PROPN-PROPN-PROPN-PROPN,compound,compound-compound-compound-pobj,NNP,NNP-NNPS-NNPS-NNP,3,1
10908,48316.0,29,survived,2,1,14,13,0,14,1,12,She,N.J.,PERSON,STATE_OR_PROVINCE,PRON,PROPN,nsubjpass,appos,PRP,NNP,7,1
10909,48317.0,24,accused,3,5,7,2,4,16,-2,4,Chavez,ignoring the rebels ' crimes,PERSON,CRIMINAL_CHARGE-CRIMINAL_CHARGE-CRIMINAL_CHARGE-CRIMINAL_CHARGE-CRIMINAL_CHARGE,PROPN,VERB-DET-NOUN-PART-NOUN,dobj,pcomp-det-poss-case-dobj,NNP,VBG-DT-NNS-POS-NNS,4,1
10910,48361.0,24,praised,20,6,1,-5,5,22,14,-19,National Center for Disaster Preparedness,Stephen Morse,ORGANIZATION-ORGANIZATION-ORGANIZATION-ORGANIZATION-ORGANIZATION,PERSON-PERSON,PROPN-PROPN-ADP-PROPN-PROPN,PROPN-PROPN,compound-pobj-prep-compound-pobj,compound-nsubj,NNP-NNP-IN-NNP-NNP,NNP-NNP,2,1
10911,48384.0,28,called,16,18,22,4,17,5,-2,6,Peterson,technician,PERSON,TITLE,PROPN,NOUN,dobj,oprd,NNP,NN,3,1
10912,48407.0,22,Krakowski,1,19,1,-18,18,20,-18,0,Federal Aviation Administration,Hank Krakowski,ORGANIZATION-ORGANIZATION-ORGANIZATION,PERSON-PERSON,PROPN-PROPN-PROPN,PROPN-PROPN,compound-compound-pobj,compound-ROOT,NNP-NNP-NNP,NNP-NNP,5,1
10913,48415.0,58,include,1,11,28,17,10,29,-10,27,Adrienne Gude,Daniel Gude,PERSON-PERSON,PERSON-PERSON,PROPN-PROPN,PROPN-PROPN,compound-conj,compound-conj,NNP-NNP,NNP-NNP,4,1
10914,48418.0,29,accused,13,10,2,-8,9,26,3,-11,Remy Smith,26,PERSON-PERSON,NUMBER,PROPN-PROPN,NUM,compound-attr,nummod,NNP-NNP,CD,3,1
10915,63820.0,37,YORK,1,26,16,-10,25,20,-25,15,Remy Smith,26,PERSON-PERSON,NUMBER,PROPN-PROPN,NUM,compound-attr,nummod,NNP-NNP,CD,4,1
10916,48421.0,27,make,10,2,6,4,1,20,8,-4,Zagats,Wall Street Journal,ORGANIZATION,ORGANIZATION-ORGANIZATION-ORGANIZATION,PROPN,PROPN-PROPN-PROPN,nsubj,compound-compound-compound,NNPS,NNP-NNP-NNP,5,1
10917,48422.0,22,meet,3,5,19,14,4,2,-2,16,him,The Stamford Advocate,PERSON,ORGANIZATION-ORGANIZATION-ORGANIZATION,PRON,DET-PROPN-PROPN,dobj,det-compound-pobj,PRP,DT-NNP-NNP,6,1
10918,48425.0,38,'s,15,5,21,16,4,16,10,6,his,New York City,PERSON,CITY-CITY-CITY,DET,PROPN-PROPN-PROPN,poss,compound-compound-pobj,PRP$,NNP-NNP-NNP,7,1
10919,48468.0,41,said,39,2,1,-1,1,39,37,-38,Marcel Ospel,Ex-Chairman,PERSON-PERSON,TITLE,PROPN-PROPN,PROPN,compound-nsubj,compound,NNP-NNP,NNP,2,1
10920,48474.0,22,NASHVILLE,0,7,19,12,6,2,-7,19,Country Music Association,CMA,ORGANIZATION-ORGANIZATION-ORGANIZATION,ORGANIZATION,PROPN-PROPN-PROPN,PROPN,compound-compound-appos,compound,NNP-NNP-NNP,NNP,-1,1
10921,48487.0,19,was,4,7,6,-1,6,12,-3,2,Augustus F. Hawkins,Rep.,PERSON-PERSON-PERSON,TITLE,PROPN-PROPN-PROPN,PROPN,compound-compound-attr,compound,NNP-NNP-NNP,NNP,2,1
10922,48499.0,22,warned,7,7,10,3,6,11,0,3,IMF,Latvia,ORGANIZATION,COUNTRY,PROPN,PROPN,nsubj,poss,NNP,NNP,4,1
10923,48505.0,11,died,2,1,9,8,0,1,1,7,Yolanda King,heart attack,PERSON-PERSON,CAUSE_OF_DEATH-CAUSE_OF_DEATH,PROPN-PROPN,NOUN-NOUN,compound-nsubj,compound-pobj,NNP-NNP,NN-NN,3,1
10924,48508.0,25,moved,3,2,6,4,1,18,1,3,his,Plant City,PERSON,CITY-CITY,DET,PROPN-PROPN,poss,compound-pobj,PRP$,NNP-NNP,3,1
10925,48516.0,54,was,1,1,39,38,0,14,0,38,Nolte,Council on Foreign Relations,PERSON,ORGANIZATION-ORGANIZATION-ORGANIZATION-ORGANIZATION,PROPN,PROPN-ADP-PROPN-PROPN,nsubj,conj-prep-compound-pobj,NNP,NNP-IN-NNP-NNPS,6,1
10926,48518.0,80,said,78,2,77,75,1,2,76,-1,International Monetary Fund,Masood Ahmed,ORGANIZATION-ORGANIZATION-ORGANIZATION,PERSON-PERSON,PROPN-PROPN-PROPN,PROPN-PROPN,compound-compound-nsubj,compound-nsubj,NNP-NNP-NNP,NNP-NNP,5,1
10927,48526.0,40,are,6,31,6,-25,30,33,-25,0,Carolina Cougars,playoffs,ORGANIZATION-ORGANIZATION,ORGANIZATION,PROPN-PROPN,NOUN,compound-compound,pobj,NNP-NNPS,NNS,2,1
10928,48534.0,51,contributed,10,9,29,20,8,21,1,19,Steve McPherson,pilot,PERSON-PERSON,TITLE,PROPN-PROPN,NOUN,compound-nsubj,compound,NNP-NNP,NN,10,1
10929,48555.0,32,told,21,18,12,-6,17,19,3,-9,Gholam Ali Hadad-Adel,president,PERSON-PERSON-PERSON,TITLE,PROPN-PROPN-PROPN,NOUN,compound-compound-appos,nsubj,NNP-NNP-NNP,NN,3,1
10930,48559.0,46,is,11,13,4,-9,12,41,-2,-7,Hamilton,driver,PERSON,TITLE,PROPN,NOUN,poss,nsubj,NNP,NN,3,1
10931,56227.0,16,knows,11,1,5,4,0,10,10,-6,Hamilton,driver,PERSON,TITLE,PROPN,NOUN,nsubj,appos,NNP,NN,3,1
10932,62776.0,39,URGENT,0,8,13,5,7,25,-8,13,Hamilton,driver,PERSON,TITLE,PROPN,NOUN,nsubj,compound,NNP,NN,2,1
10933,48563.0,41,popped,26,17,7,-10,16,33,9,-19,Molly Malaney,his,PERSON-PERSON,PERSON,PROPN-PROPN,DET,compound-dobj,poss,NNP-NNP,PRP$,3,1
10934,48571.0,29,reported,8,14,16,2,13,12,-6,8,DirecTV,Neal Tiles,ORGANIZATION,PERSON-PERSON,NOUN,PROPN-PROPN,compound,compound-nsubj,NN,NNP-NNP,1,1
10935,48576.0,19,remains,11,8,4,-4,7,14,3,-7,AQR Capital Management,quantitative hedge fund,ORGANIZATION-ORGANIZATION-ORGANIZATION,ORGANIZATION-ORGANIZATION-ORGANIZATION,PROPN-PROPN-PROPN,ADJ-NOUN-NOUN,compound-compound-nsubj,amod-compound-compound,NNP-NNP-NNP,JJ-NN-NN,4,1
10936,48577.0,16,said,13,5,11,6,4,4,8,-2,his,Barbara Washburn,PERSON,PERSON-PERSON,DET,PROPN-PROPN,poss,compound-appos,PRP$,NNP-NNP,2,1
10937,48591.0,20,rose,2,18,5,-13,17,14,-16,3,his,lieutenant colonel,PERSON,TITLE-TITLE,DET,NOUN-NOUN,poss,compound-pobj,PRP$,NN-NN,5,1
10938,48594.0,35,moved,24,24,12,-12,23,22,0,-12,he,Phoenix,PERSON,CITY,PRON,PROPN,nsubj,pobj,PRP,NNP,6,1
10939,48597.0,28,was,2,1,12,11,0,15,1,10,Michael Sandy,Ikea,PERSON-PERSON,ORGANIZATION,PROPN-PROPN,PROPN,compound-nsubj,pobj,NNP-NNP,NNP,2,1
10940,48599.0,38,finished,26,1,9,8,0,28,25,-17,The 22-year-old Briton,Afro-Caribbean,PERSON-PERSON-PERSON,NATIONALITY,DET-NUM-PROPN,ADJ,det-compound-nsubj,amod,DT-CD-NNP,JJ,5,1
10941,48606.0,29,gained,16,6,1,-5,5,27,10,-15,Hindalco,Tata Power,ORGANIZATION,ORGANIZATION-ORGANIZATION,PROPN,PROPN-PROPN,appos,compound-nsubj,NNP,NNP-NNP,3,1
10942,48607.0,57,made,31,21,18,-3,20,38,10,-13,Dee Dee Myers,Lindy Boggs,PERSON-PERSON-PERSON,PERSON-PERSON,PROPN-PROPN-PROPN,PROPN-PROPN,compound-compound-conj,compound-conj,NNP-NNP-NNP,NNP-NNP,2,1
10943,48608.0,24,be,20,15,17,2,14,6,5,-3,Wilkinson,23,PERSON,NUMBER,PROPN,NUM,conj,appos,NNP,CD,6,1
10944,48615.0,21,told,14,8,12,4,7,8,6,-2,Tokyo Stock Exchange,Atsushi Saito,ORGANIZATION-ORGANIZATION-ORGANIZATION,PERSON-PERSON,PROPN-PROPN-PROPN,PROPN-PROPN,compound-compound-pobj,compound-appos,NNP-NNP-NNP,NNP-NNP,4,1
10945,48626.0,37,emphasized,2,18,21,3,17,15,-16,19,Barbara Boxer,Calif.,PERSON-PERSON,STATE_OR_PROVINCE,PROPN-PROPN,PROPN,compound-compound,subtok,NNP-NNP,NNP,-1,1
10946,48632.0,42,is,15,9,6,-3,8,35,6,-9,Juliette Binoche,Parisian,PERSON-PERSON,MISC,PROPN-PROPN,ADJ,compound-compound,amod,NNP-NNP,JJ,3,1
10947,48635.0,44,said,35,37,42,5,36,1,-2,7,MBIA,Charles Chaplin,ORGANIZATION,PERSON-PERSON,PROPN,PROPN-PROPN,poss,compound-appos,NNP,NNP-NNP,3,1
10948,65124.0,59,said,42,36,41,5,35,17,6,-1,MBIA,Charles Chaplin,ORGANIZATION,PERSON-PERSON,PROPN,PROPN-PROPN,poss,compound-appos,NNP,NNP-NNP,3,1
10949,48654.0,33,suffer,2,15,28,13,14,4,-13,26,American Psychiatric Association,United States,ORGANIZATION-ORGANIZATION-ORGANIZATION,COUNTRY-COUNTRY,PROPN-PROPN-PROPN,PROPN-PROPN,compound-compound-nsubj,compound-pobj,NNP-NNP-NNP,NNP-NNP,8,1
10950,48655.0,38,PHILADELPHIA,0,25,8,-17,24,29,-25,8,The Inquirer,Philadelphia Media Holdings,ORGANIZATION-ORGANIZATION,ORGANIZATION-ORGANIZATION-ORGANIZATION,DET-PROPN,PROPN-PROPN-PROPN,det-nmod,compound-compound-compound,DT-NNP,NNP-NNP-NNPS,7,1
10951,48660.0,45,is,1,37,40,3,36,4,-36,39,Philadelphia Inquirer,Manuel,ORGANIZATION-ORGANIZATION,PERSON,PROPN-PROPN,PROPN,compound-pobj,nsubj,NNP-NNP,NNP,5,1
10952,48661.0,44,spoke,10,9,27,18,8,16,1,17,Theroux,Tom Cruise,PERSON,PERSON-PERSON,PROPN,PROPN-PROPN,conj,compound-dobj,NNP,NNP-NNP,4,1
10953,48675.0,21,refused,2,2,11,9,1,9,0,9,she,violating a Virginia law requiring segregated seating in public transportation,PERSON,CRIMINAL_CHARGE-CRIMINAL_CHARGE-CRIMINAL_CHARGE-CRIMINAL_CHARGE-CRIMINAL_CHARGE-CRIMINAL_CHARGE-CRIMINAL_CHARGE-CRIMINAL_CHARGE-CRIMINAL_CHARGE-CRIMINAL_CHARGE,PRON,VERB-DET-PROPN-NOUN-VERB-ADJ-NOUN-ADP-ADJ-NOUN,nsubj,pcomp-det-compound-dobj-acl-amod-dobj-prep-amod-pobj,PRP,VBG-DT-NNP-NN-VBG-JJ-NN-IN-JJ-NN,5,1
10954,48686.0,36,hinted,2,13,17,4,12,18,-11,15,International Monetary Fund,Washington,ORGANIZATION-ORGANIZATION-ORGANIZATION,STATE_OR_PROVINCE,PROPN-PROPN-PROPN,PROPN,compound-compound-pobj,pobj,NNP-NNP-NNP,NNP,2,1
10955,48687.0,35,survived,2,27,5,-22,26,29,-25,3,Eleanor Derounian,his,PERSON-PERSON,PERSON,PROPN-PROPN,DET,compound-conj,poss,NNP-NNP,PRP$,6,1
10956,48696.0,39,is,24,9,37,28,8,1,15,13,American Bar Association,United States,ORGANIZATION-ORGANIZATION-ORGANIZATION,COUNTRY-COUNTRY,PROPN-PROPN-PROPN,PROPN-PROPN,compound-compound-pobj,compound-pobj,NNP-NNP-NNP,NNP-NNP,10,1
10957,51803.0,38,is,23,9,36,27,8,1,14,13,American Bar Association,United States,ORGANIZATION-ORGANIZATION-ORGANIZATION,COUNTRY-COUNTRY,PROPN-PROPN-PROPN,PROPN-PROPN,compound-compound-pobj,compound-pobj,NNP-NNP-NNP,NNP-NNP,10,1
10958,48702.0,39,run,4,18,30,12,17,8,-14,26,Barry Goldwater,1909,PERSON-PERSON,DATE,PROPN-PROPN,NUM,compound-pobj,pobj,NNP-NNP,CD,1,1
10959,48707.0,52,live,5,24,8,-16,23,43,-19,3,her,Colorado,PERSON,STATE_OR_PROVINCE,DET,PROPN,poss,pobj,PRP$,NNP,3,1
10960,48723.0,27,afford,2,24,23,-1,23,3,-22,21,NEC,2008,ORGANIZATION,DATE,PROPN,NUM,compound,nummod,NNP,CD,1,1
10961,48728.0,23,filed,8,1,5,4,0,17,7,-3,Beyonce,Tina Knowles,PERSON,PERSON-PERSON,PROPN,PROPN-PROPN,poss,compound-appos,NNP,NNP-NNP,3,1
10962,48740.0,22,accused,2,1,10,9,0,11,1,8,All,Muslim,ORGANIZATION,RELIGION,DET,ADJ,nsubjpass,amod,DT,JJ,7,1
10963,48741.0,41,accused,2,20,24,4,19,16,-18,22,he,Afghanistan,PERSON,COUNTRY,PRON,PROPN,nsubjpass,pobj,PRP,NNP,5,1
10964,55828.0,25,said,2,20,24,4,19,0,-18,22,he,Afghanistan,PERSON,COUNTRY,PRON,PROPN,nsubjpass,pobj,PRP,NNP,4,1
10965,48748.0,30,urged,6,1,8,7,0,21,5,2,"Al-Tai 's son , Ahmad",Iraqi,PERSON-PERSON-PERSON-PERSON-PERSON,NATIONALITY,PROPN-PART-NOUN-PUNCT-PROPN,ADJ,poss-case-nsubj-punct-appos,amod,"NNP-POS-NN-,-NNP",JJ,3,1
10966,48757.0,46,defeated,33,15,13,-2,14,32,18,-20,Richard Lindzen,MIT scientist,PERSON-PERSON,TITLE-TITLE,PROPN-PROPN,PROPN-NOUN,compound-pobj,compound-compound,NNP-NNP,NNP-NN,1,1
10967,48758.0,42,said,13,12,11,-1,11,30,1,-2,Bryan Fuller,producer,PERSON-PERSON,TITLE,PROPN-PROPN,NOUN,compound-nsubj,compound,NNP-NNP,NN,2,1
10968,63188.0,34,Instead,0,8,7,-1,7,26,-8,7,Bryan Fuller,producer,PERSON-PERSON,TITLE,PROPN-PROPN,NOUN,compound-appos,conj,NNP-NNP,NN,1,1
10969,48767.0,35,said,30,7,10,3,6,24,23,-20,Itochu,Toshihito Tamba,ORGANIZATION,PERSON-PERSON,PROPN,PROPN-PROPN,compound,compound-appos,NNP,NNP-NNP,2,1
10970,48771.0,58,splitting,15,2,12,10,1,45,13,-3,Tyco Healthcare,New Jersey,ORGANIZATION-ORGANIZATION,STATE_OR_PROVINCE-STATE_OR_PROVINCE,PROPN-PROPN,PROPN-PROPN,compound-appos,compound-appos,NNP-NNP,NNP-NNP,6,1
10971,48775.0,35,survived,2,11,1,-10,10,33,-9,-1,Emily Ann Kennard Derounian,Derounian,PERSON-PERSON-PERSON-PERSON,PERSON,PROPN-PROPN-PROPN-PROPN,PROPN,compound-compound-compound-appos,nsubjpass,NNP-NNP-NNP-NNP,NNP,4,1
10972,48778.0,40,said,3,22,12,-10,21,27,-19,9,NSG,India,ORGANIZATION,COUNTRY,PROPN,PROPN,compound,nsubj,NNP,NNP,3,1
10973,48782.0,30,Administration,2,1,5,4,0,24,1,3,Federal Aviation Administration,http://wwwfaagov,ORGANIZATION-ORGANIZATION-ORGANIZATION,URL,PROPN-PROPN-PROPN,PUNCT,compound-compound-ROOT,compound,NNP-NNP-NNP,:,3,1
10974,65804.0,25,------,0,2,6,4,1,18,-2,6,Federal Aviation Administration,http://wwwfaagov,ORGANIZATION-ORGANIZATION-ORGANIZATION,URL,PROPN-PROPN-PROPN,PUNCT,compound-compound-ROOT,ROOT,NNP-NNP-NNP,:,2,1
10975,48793.0,24,grew,13,13,17,4,12,6,0,4,Negroponte,Britain,PERSON,COUNTRY,PROPN,PROPN,nsubj,pobj,NNP,NNP,3,1
10976,48794.0,34,doing,8,30,27,-3,29,6,-22,19,Barbara Boxer,chairman,PERSON-PERSON,TITLE,PROPN-PROPN,NOUN,compound-appos,conj,NNP-NNP,NN,2,1
10977,48802.0,26,served,1,21,7,-14,20,18,-20,6,a Republican and a liberal,US,PERSON-PERSON-PERSON-PERSON-PERSON,ORGANIZATION,DET-PROPN-CCONJ-DET-NOUN,PROPN,det-attr-cc-det-conj,compound,DT-NNP-CC-DT-NN,NNP,7,1
10978,48833.0,25,was,1,1,5,4,0,19,0,4,He,aviator,PERSON,TITLE,PRON,NOUN,nsubj,attr,PRP,NN,1,1
10979,48855.0,37,said,9,3,13,10,2,23,6,4,U.S. National Security Council,United States,ORGANIZATION-ORGANIZATION-ORGANIZATION-ORGANIZATION,COUNTRY-COUNTRY,PROPN-PROPN-PROPN-PROPN,PROPN-PROPN,compound-compound-compound-compound,compound-nsubj,NNP-NNP-NNP-NNP,NNP-NNP,6,1
10980,48861.0,25,called,16,9,13,4,8,11,7,-3,American Red Cross,Mary S Elcano,ORGANIZATION-ORGANIZATION-ORGANIZATION,PERSON-PERSON-PERSON,PROPN-PROPN-PROPN,PROPN-PROPN-PROPN,compound-compound-pobj,compound-compound-appos,NNP-NNP-NNP,NNP-NNP-NNP,6,1
10981,48864.0,21,Chew,1,10,1,-9,9,19,-9,0,Federal Aviation Administration,Russell Chew,ORGANIZATION-ORGANIZATION-ORGANIZATION,PERSON-PERSON,PROPN-PROPN-PROPN,PROPN-PROPN,compound-compound-pobj,compound-ROOT,NNP-NNP-NNP,NNP-NNP,4,1
10982,48867.0,19,is,11,17,4,-13,16,14,-6,-7,Paavo Nurmi,Olympic heroes,PERSON-PERSON,TITLE-TITLE,PROPN-PROPN,ADJ-NOUN,compound-dobj,amod-pobj,NNP-NNP,JJ-NNS,5,1
10983,48869.0,18,died,14,14,4,-10,13,13,0,-10,he,she,PERSON,PERSON,PRON,PRON,nsubj,nsubj,PRP,PRP,1,1
10984,48870.0,27,elected,5,4,9,5,3,17,1,4,he,Georgia House of Representatives,PERSON,ORGANIZATION-ORGANIZATION-ORGANIZATION-ORGANIZATION,PRON,PROPN-PROPN-ADP-PROPN,nsubjpass,compound-pobj-prep-pobj,PRP,NNP-NNP-IN-NNPS,3,1
10985,48874.0,37,reports,3,14,10,-4,13,26,-11,7,Kurnaz,German,PERSON,NATIONALITY,PROPN,ADJ,dobj,amod,NNP,JJ,3,1
10986,48875.0,29,told,26,17,21,4,16,7,9,-5,Philip Chen,airline,PERSON-PERSON,ORGANIZATION,PROPN-PROPN,NOUN,compound-nsubj,poss,NNP-NNP,NN,3,1
10987,48885.0,26,Labels,0,13,11,-2,12,14,-13,11,Ivery,38-year,PERSON,NUMBER,PROPN,ADJ,nsubj,punct,NNP,JJ,2,1
10988,48886.0,41,served,2,1,8,7,0,32,1,6,Hubbard,representative,PERSON,TITLE,PROPN,NOUN,nsubj,pobj,NNP,NN,4,1
10989,53503.0,41,served,2,1,8,7,0,32,1,6,Hubbard,representative,PERSON,TITLE,PROPN,NOUN,nsubj,pobj,NNP,NN,4,1
10990,48889.0,31,drawn,9,6,6,0,5,24,3,-3,Jewish,Jewish National Fund,ORGANIZATION,RELIGION-RELIGION-RELIGION,ADJ,ADJ-PROPN-PROPN,amod,compound-compound-dobj,JJ,JJ-NNP-NNP,0,1
10991,48893.0,50,find,14,5,10,5,4,39,9,-4,Beverly Sills,Monday,PERSON-PERSON,DATE,PROPN-PROPN,PROPN,compound-pobj,npadvmod,NNP-NNP,NNP,2,1
10992,48902.0,45,said,28,41,35,-6,40,9,-13,7,National Republican Campaign Committee,Tom Reynolds,ORGANIZATION-ORGANIZATION-ORGANIZATION-ORGANIZATION,PERSON-PERSON,PROPN-PROPN-PROPN-PROPN,PROPN-PROPN,compound-compound-compound-pobj,compound-nsubj,NNP-NNP-NNP-NNP,NNP-NNP,4,1
10993,48904.0,22,visit,17,1,7,6,0,14,16,-10,Dodd,Peace Corps,PERSON,ORGANIZATION-ORGANIZATION,ADV,PROPN-PROPN,nsubj,compound-pobj,RB,NNP-NNP,4,1
10994,48905.0,28,commissioned,8,20,5,-15,19,22,-12,-3,Charles Wuorinen,City Opera,PERSON-PERSON,ORGANIZATION-ORGANIZATION,PROPN-PROPN,PROPN-PROPN,compound-conj,compound-pobj,NNP-NNP,NNP-NNP,6,1
10995,48910.0,41,said,21,23,39,16,22,1,-2,18,Jerry Robbins,Philadelphia,PERSON-PERSON,CITY,PROPN-PROPN,PROPN,compound-nsubj,compound,NNP-NNP,NNP,9,1
10996,48926.0,42,dropped,16,1,15,14,0,26,15,-1,Maloney,Queens,PERSON,LOCATION,PROPN,PROPN,nsubj,pobj,NNP,NNP,3,1
10997,48927.0,44,arrives,5,4,2,-2,3,41,1,-3,Frankie Delgado,Hills,PERSON-PERSON,ORGANIZATION,PROPN-PROPN,PROPN,compound-nsubj,compound,NNP-NNP,NNP,1,1
10998,54700.0,24,stars,2,7,2,-5,6,21,-5,0,Frankie Delgado,Hills,PERSON-PERSON,ORGANIZATION,PROPN-PROPN,PROPN,compound-conj,nsubj,NNP-NNP,NNP,2,1
10999,48935.0,13,was,1,1,8,7,0,4,0,7,Verity,Navy,PERSON,ORGANIZATION,PROPN,PROPN,nsubj,pobj,NNP,NNP,1,1
11000,48944.0,41,SEOUL,0,12,16,4,11,24,-12,16,Chinese Communist Party,Wang Jiarui,ORGANIZATION-ORGANIZATION-ORGANIZATION,PERSON-PERSON,PROPN-PROPN-PROPN,PROPN-PROPN,compound-compound-compound,compound-nsubj,NNP-NNP-NNP,NNP-NNP,3,1
11001,48951.0,62,cochaired,2,35,31,-4,34,30,-33,29,Fidelity,Ronald P. O'Hanley,ORGANIZATION,PERSON-PERSON-PERSON,PROPN,PROPN-PROPN-PROPN,poss,compound-compound-conj,NNP,NNP-NNP-NNP,4,1
11002,48962.0,47,died,40,1,42,41,0,4,39,2,Catherine Roraback,Wednesday,PERSON-PERSON,DATE,PROPN-PROPN,PROPN,compound-nsubj,npadvmod,NNP-NNP,NNP,2,1
11003,56453.0,47,died,40,1,42,41,0,4,39,2,Catherine Roraback,Wednesday,PERSON-PERSON,DATE,PROPN-PROPN,PROPN,compound-nsubj,npadvmod,NNP-NNP,NNP,2,1
11004,48969.0,36,said,25,30,27,-3,29,8,-5,2,ANP,Afrasiab Khattak,ORGANIZATION,PERSON-PERSON,PROPN,PROPN-PROPN,poss,compound-nsubj,NNP,NNP-NNP,4,1
11005,48986.0,39,grown,18,11,15,4,10,23,7,-3,First Auto Works,Shanghai Automotive,ORGANIZATION-ORGANIZATION-ORGANIZATION,ORGANIZATION-ORGANIZATION,PROPN-PROPN-PROPN,PROPN-PROPN,compound-compound-pobj,compound-conj,NNP-NNP-NNP,NNP-NNP,2,1
11006,48998.0,26,reported,23,1,12,11,0,13,22,-11,Chen Zhu,two-day,PERSON-PERSON,DURATION,PROPN-PROPN,NOUN,compound-nsubj,npadvmod,NNP-NNP,NN,5,1
11007,49007.0,14,was,1,8,13,5,7,0,-7,12,Marywood University,Pennsylvania,ORGANIZATION-ORGANIZATION,STATE_OR_PROVINCE,PROPN-PROPN,PROPN,compound-pobj,appos,NNP-NNP,NNP,4,1
11008,50043.0,33,notes,12,29,32,3,28,0,-17,20,Marywood University,Pennsylvania,ORGANIZATION-ORGANIZATION,STATE_OR_PROVINCE,PROPN-PROPN,PROPN,compound-pobj,appos,NNP-NNP,NNP,2,1
11009,49023.0,41,left,7,30,40,10,29,0,-23,33,Option One Mortgage,Irvine,ORGANIZATION-ORGANIZATION-ORGANIZATION,CITY,PROPN-PROPN-PROPN,PROPN,compound-nummod-compound,pobj,NNP-NNP-NNP,NNP,3,1
11010,55707.0,19,Irvine,0,4,1,-3,3,17,-4,1,Option One Mortgage,Irvine,ORGANIZATION-ORGANIZATION-ORGANIZATION,CITY,PROPN-PROPN-PROPN,PROPN,conj-nummod-nsubj,ROOT,NNP-NNP-NNP,NNP,4,1
11011,49026.0,43,said,21,1,9,8,0,33,20,-12,Sean Parker,Project Agape,PERSON-PERSON,ORGANIZATION-ORGANIZATION,PROPN-PROPN,PROPN-PROPN,compound-nsubj,compound-pobj,NNP-NNP,NNP-NNP,3,1
11012,49027.0,58,DENVER,0,34,38,4,33,19,-34,38,Carolyn Maloney,60-year-old,PERSON-PERSON,NUMBER,PROPN-PROPN,NUM,compound-pobj,amod,NNP-NNP,CD,4,1
11013,49028.0,34,was,1,16,11,-5,15,22,-15,10,him,President,PERSON,TITLE,PRON,PROPN,dobj,compound,PRP,NNP,3,1
11014,49035.0,24,told,20,17,19,2,16,4,3,-1,MECO,Taj Hargey,ORGANIZATION,PERSON-PERSON,NOUN,PROPN-PROPN,amod,compound-nsubj,NN,NNP-NNP,3,1
11015,49041.0,35,-RRB-,0,3,24,21,2,10,-3,24,The Starr Foundation,Maurice Greenberg,ORGANIZATION-ORGANIZATION-ORGANIZATION,PERSON-PERSON,DET-PROPN-PROPN,PROPN-PROPN,det-compound-nsubjpass,compound-attr,DT-NNP-NNP,NNP-NNP,4,1
11016,49069.0,26,is,1,14,18,4,13,7,-13,17,his,Julia Carson,PERSON,PERSON-PERSON,DET,PROPN-PROPN,poss,compound-appos,PRP$,NNP-NNP,5,1
11017,49075.0,44,said,2,2,18,16,1,25,0,16,IMF,World Bank,ORGANIZATION,ORGANIZATION-ORGANIZATION,PROPN,PROPN-PROPN,nsubj,compound-conj,NNP,NNP-NNP,10,1
11018,49090.0,61,found,34,31,22,-9,30,38,3,-12,National Soft Drink Association,American Beverage Association,ORGANIZATION-ORGANIZATION-ORGANIZATION-ORGANIZATION,ORGANIZATION-ORGANIZATION-ORGANIZATION,PROPN-PROPN-PROPN-PROPN,PROPN-PROPN-PROPN,compound-compound-compound-pobj,compound-compound-pobj,NNP-NNP-NNP-NNP,NNP-NNP-NNP,8,1
11019,49091.0,32,said,17,16,16,0,15,15,1,-1,Philadelphia Inquirer,Philadelphia,ORGANIZATION-ORGANIZATION,CITY,PROPN-PROPN,PROPN,compound-pobj,pobj,NNP-NNP,NNP,0,1
11020,62496.0,14,laid,6,1,1,0,0,12,5,-5,Philadelphia Inquirer,Philadelphia,ORGANIZATION-ORGANIZATION,CITY,PROPN-PROPN,PROPN,compound-pobj,nmod,NNP-NNP,NNP,0,1
11021,49092.0,43,said,5,4,41,37,3,1,1,36,MF Global,US,ORGANIZATION-ORGANIZATION,COUNTRY,PROPN-PROPN,PROPN,compound-pobj,compound,NNP-NNP,NNP,7,1
11022,51719.0,46,said,39,41,22,-19,40,23,-2,-17,MF Global,US,ORGANIZATION-ORGANIZATION,COUNTRY,PROPN-PROPN,PROPN,compound-compound,pobj,NNP-NNP,NNP,9,1
11023,63894.0,28,said,22,20,25,5,19,2,2,3,MF Global,US,ORGANIZATION-ORGANIZATION,COUNTRY,PROPN-PROPN,PROPN,compound-pobj,compound,NNP-NNP,NNP,8,1
11024,49107.0,38,decided,24,12,23,11,11,14,12,-1,SAC,Robert McNamara,ORGANIZATION,PERSON-PERSON,PROPN,PROPN-PROPN,compound,compound-nsubj,NNP,NNP-NNP,4,1
11025,49111.0,20,Federation,3,6,2,-4,5,17,-3,-1,FMF,Mexican Soccer Federation,ORGANIZATION,ORGANIZATION-ORGANIZATION-ORGANIZATION,PROPN,PROPN-PROPN-PROPN,compound,compound-compound-ROOT,NNP,NNP-NNP-NNP,3,1
11026,49112.0,42,Ospel,1,2,4,2,1,37,-1,3,Ospel,Swiss,PERSON,NATIONALITY,PROPN,ADJ,ROOT,amod,NNP,JJ,3,1
11027,49115.0,43,told,21,30,42,12,29,0,-9,21,Mohamed El Baradei,Malaysia,PERSON-PERSON-PERSON,COUNTRY,PROPN-PROPN-PROPN,PROPN,compound-compound-dobj,pobj,NNP-NNP-NNP,NNP,5,1
11028,49125.0,41,declined,3,14,20,6,13,20,-11,17,MBIA,Charles E Chaplin,ORGANIZATION,PERSON-PERSON-PERSON,PROPN,PROPN-PROPN-PROPN,poss,compound-compound-appos,NNP,NNP-NNP-NNP,4,1
11029,49129.0,33,headquartered,23,12,18,6,11,14,11,-5,military wing,Markaz Dawa-wal Irshad,ORGANIZATION-ORGANIZATION,ORGANIZATION-ORGANIZATION-ORGANIZATION,ADJ-NOUN,PROPN-PROPN-PROPN,amod-pobj,compound-compound-appos,JJ-NN,NNP-NNP-NNP,2,1
11030,49137.0,15,served,2,6,1,-5,5,13,-4,-1,Massachusetts House of Representatives,Jacinto Dinis,ORGANIZATION-ORGANIZATION-ORGANIZATION-ORGANIZATION,PERSON-PERSON,PROPN-PROPN-ADP-PROPN,PROPN-PROPN,compound-pobj-prep-pobj,compound-nsubj,NNP-NNP-IN-NNPS,NNP-NNP,3,1
11031,49172.0,33,Bond,1,1,21,20,0,11,0,20,Julian Bond,SNCC,PERSON-PERSON,ORGANIZATION,PROPN-PROPN,PROPN,compound-ROOT,compound,NNP-NNP,NNP,1,1
11032,49175.0,38,said,10,9,12,3,8,25,1,2,DirecTV,he,ORGANIZATION,PERSON,PROPN,PRON,pobj,nsubj,NNP,PRP,3,1
11033,49180.0,24,said,15,17,23,6,16,0,-2,8,Sharon Dewey,consultant,PERSON-PERSON,TITLE,PROPN-PROPN,NOUN,compound-nsubj,appos,NNP-NNP,NN,2,1
11034,49225.0,16,said,14,11,13,2,10,2,3,-1,Waratahs,Rocky Elsom,ORGANIZATION,PERSON-PERSON,PROPN,PROPN-PROPN,compound,compound-nsubj,NNP,NNP-NNP,3,1
11035,49237.0,29,closed,7,14,2,-12,13,26,-7,-5,Tokyo Stock Exchange,Nikkei Stock Average,ORGANIZATION-ORGANIZATION-ORGANIZATION,ORGANIZATION-ORGANIZATION-ORGANIZATION,PROPN-PROPN-PROPN,PROPN-PROPN-PROPN,compound-compound-pobj,compound-compound-nsubj,NNP-NNP-NNP,NNP-NNP-NNP,5,1
11036,65469.0,29,closed,7,14,2,-12,13,26,-7,-5,Tokyo Stock Exchange,Nikkei Stock Average,ORGANIZATION-ORGANIZATION-ORGANIZATION,ORGANIZATION-ORGANIZATION-ORGANIZATION,PROPN-PROPN-PROPN,PROPN-PROPN-PROPN,compound-compound-pobj,compound-compound-nsubj,NNP-NNP-NNP,NNP-NNP-NNP,7,1
11037,49242.0,46,left,11,11,9,-2,10,36,0,-2,Ospel,Basel,PERSON,CITY,PROPN,PROPN,nsubj,pobj,NNP,NNP,1,1
11038,49247.0,59,said,26,28,40,12,27,18,-2,14,Bryan Fuller,Showtime,PERSON-PERSON,ORGANIZATION,PROPN-PROPN,PROPN,compound-nsubj,compound,NNP-NNP,NNP,3,1
11039,49249.0,20,said,10,5,1,-4,4,18,5,-9,network,Charlie King,ORGANIZATION,PERSON-PERSON,NOUN,PROPN-PROPN,poss,compound-nsubj,NN,NNP-NNP,3,1
11040,49257.0,35,brought,4,23,31,8,22,3,-19,27,Focus on the Family,Democratic,ORGANIZATION-ORGANIZATION-ORGANIZATION-ORGANIZATION,IDEOLOGY,PROPN-ADP-DET-PROPN,ADJ,dobj-prep-det-pobj,amod,NNP-IN-DT-NNP,JJ,3,1
11041,49258.0,36,require,19,6,9,3,5,26,13,-10,Barbara Boxer,chairwoman,PERSON-PERSON,TITLE,PROPN-PROPN,NOUN,compound-pobj,appos,NNP-NNP,NN,4,1
11042,49263.0,13,Ø,0,7,3,-4,6,9,-7,3,JNF,Jewish National Fund,ORGANIZATION,ORGANIZATION-ORGANIZATION-ORGANIZATION,PROPN,ADJ-PROPN-PROPN,compound,amod-compound-ROOT,NNP,JJ-NNP-NNP,4,1
11043,49283.0,58,were,53,12,23,11,11,34,41,-30,Hashim Ahmad al-Tai,Iraqi,PERSON-PERSON-PERSON,NATIONALITY,PROPN-PROPN-PROPN,ADJ,compound-nsubj-punct,amod,NNP-NNP-NNP,JJ,5,1
11044,54059.0,53,upheld,8,35,6,-29,34,46,-27,-2,Hashim Ahmad al-Tai,Iraqi,PERSON-PERSON-PERSON,NATIONALITY,PROPN-PROPN-X,ADJ,compound-subtok-punct,amod,NNP-NNP-ADD,JJ,8,1
11045,54576.0,23,Ahmad,3,3,15,12,2,7,0,12,Hashim Ahmad al-Tai,Iraqi,PERSON-PERSON-PERSON,NATIONALITY,PROPN-PROPN-PROPN,ADJ,compound-ROOT-punct,compound,NNP-NNP-NNP,JJ,5,1
11046,49290.0,23,insists,2,15,20,5,14,2,-13,18,Barry Goldwater,president,PERSON-PERSON,TITLE,PROPN-PROPN,NOUN,compound-appos,pobj,NNP-NNP,NN,3,1
11047,49293.0,19,married,5,7,18,11,6,0,-2,13,Gunnar Forsberg,Stockholm,PERSON-PERSON,CITY,PROPN-PROPN,PROPN,compound-dobj,pobj,NNP-NNP,NNP,2,1
11048,49296.0,30,died,1,10,4,-6,9,25,-9,3,her,December,PERSON,DATE,DET,PROPN,poss,pobj,PRP$,NNP,5,1
11049,49302.0,8,died,4,3,6,3,2,1,1,2,Robert McNair,Nov. 17,PERSON-PERSON,DATE-DATE,PROPN-PROPN,PROPN-NUM,compound-nsubj,npadvmod-nummod,NNP-NNP,NNP-CD,3,1
11050,49318.0,25,is,1,1,7,6,0,17,0,6,He,Chinese Academy of Sciences,PERSON,ORGANIZATION-ORGANIZATION-ORGANIZATION-ORGANIZATION,PRON,PROPN-PROPN-ADP-PROPN,nsubj,compound-pobj-prep-pobj,PRP,NNP-NNP-IN-NNPS,3,1
11051,49326.0,52,paid,8,30,46,16,29,5,-22,38,Fyffes,Dreyfus Funds,ORGANIZATION,PERSON-PERSON,PROPN,PROPN-PROPN,compound,compound-appos,NNP,NNP-NNPS,10,1
11052,49336.0,29,lost,6,18,11,-7,17,17,-12,5,BNC Mortgage,Lehman Brothers Holdings Inc,ORGANIZATION-ORGANIZATION,ORGANIZATION-ORGANIZATION-ORGANIZATION-ORGANIZATION,PROPN-PROPN,PROPN-PROPN-PROPN-PROPN,compound-compound,compound-compound-compound-nsubj,NNP-NNP,NNP-NNPS-NNPS-NNP,4,1
11053,49340.0,57,said,52,55,54,-1,54,2,-3,2,Robert Morgenthau,prosecutor,PERSON-PERSON,TITLE,PROPN-PROPN,NOUN,compound-nsubj,compound,NNP-NNP,NN,2,1
11054,49348.0,34,intends,14,2,11,9,1,22,12,-3,USA Network,General Electric,ORGANIZATION-ORGANIZATION,ORGANIZATION-ORGANIZATION,PROPN-PROPN,PROPN-PROPN,compound-compound,compound-pobj,NNP-NNP,NNP-NNP,4,1
11055,49371.0,16,is,1,1,14,13,0,1,0,13,Alexandra,Mellisa Burke,PERSON,PERSON-PERSON,PROPN,PROPN-PROPN,nsubj,compound-appos,NNP,NNP-NNP,-1,1
11056,49372.0,41,had,3,21,28,7,20,12,-18,25,Red Sox,American League,ORGANIZATION-ORGANIZATION,ORGANIZATION-ORGANIZATION,PROPN-PROPN,PROPN-PROPN,compound-pobj,compound-compound,NNP-NNPS,NNP-NNP,3,1
11057,49380.0,31,passes,3,12,19,7,11,11,-9,16,Norwegian University of science and Technology,NTNU,ORGANIZATION-ORGANIZATION-ORGANIZATION-ORGANIZATION-ORGANIZATION-ORGANIZATION,ORGANIZATION,PROPN-PROPN-ADP-NOUN-CCONJ-PROPN,PROPN,compound-pobj-prep-pobj-cc-conj,compound,NNP-NNP-IN-NN-CC-NNP,NNP,3,1
11058,49394.0,54,include,1,17,25,8,16,28,-16,24,Richard DeBlanc,Frank DeBlanc,PERSON-PERSON,PERSON-PERSON,PROPN-PROPN,PROPN-PROPN,compound-conj,compound-appos,NNP-NNP,NNP-NNP,1,1
11059,49397.0,33,continued,1,1,17,16,0,15,0,16,Kerry,America,PERSON,COUNTRY,PROPN,PROPN,nsubj,pobj,NNP,NNP,5,1
11060,49417.0,24,lives,11,1,6,5,0,17,10,-5,Cutrone,New York,PERSON,CITY-CITY,PROPN,PROPN-PROPN,nsubj,compound-pobj,NNP,NNP-NNP,4,1
11061,49427.0,14,born,2,1,12,11,0,1,1,10,Rothman,Jewish family,PERSON,RELIGION-RELIGION,PROPN,ADJ-NOUN,nsubjpass,amod-pobj,NNP,JJ-NN,3,1
11062,49433.0,36,says,22,6,3,-3,5,32,16,-19,Simon Cowell,talent show judge,PERSON-PERSON,TITLE-TITLE-TITLE,PROPN-PROPN,NOUN-NOUN-NOUN,compound-nsubj,compound-compound-compound,NNP-NNP,NN-NN-NN,2,1
11063,49444.0,44,suffered,17,8,26,18,7,17,9,9,Derounian,Nassau County,PERSON,LOCATION-LOCATION,PROPN,PROPN-PROPN,appos,compound-dobj,NNP,NNP-NNP,6,1
11064,49452.0,15,called,5,4,3,-1,3,11,1,-2,Chris Dodd,Chairman,PERSON-PERSON,TITLE,PROPN-PROPN,PROPN,compound-nsubj,compound,NNP-NNP,NNP,1,1
11065,62020.0,35,agreed,6,5,4,-1,4,30,1,-2,Chris Dodd,Chairman,PERSON-PERSON,TITLE,PROPN-PROPN,PROPN,compound-nsubj,compound,NNP-NNP,NNP,1,1
11066,49472.0,23,LCronin09,0,17,6,-11,16,16,-17,6,Spencer Pratt,Holly,PERSON-PERSON,PERSON,PROPN-PROPN,PROPN,compound-appos,appos,NNP-NNP,NNP,6,1
11067,49476.0,56,DISCLOSURE,9,6,12,6,5,43,3,3,Red Sox,The New York Times Co,ORGANIZATION-ORGANIZATION,PERSON-PERSON-PERSON-PERSON-PERSON,PROPN-PROPN,DET-PROPN-PROPN-PROPN-PROPN,compound-pobj,det-compound-compound-compound-nsubj,NNP-NNPS,DT-NNP-NNP-NNP-NNP,6,1
11068,49481.0,49,Meanwhile,0,19,24,5,18,24,-19,24,FAPA,Kuomintang,ORGANIZATION,ORGANIZATION,PROPN,PROPN,compound,dobj,NNP,NNP,2,1
11069,49487.0,41,told,17,8,6,-2,7,34,9,-11,R. Nicholas Burns,secretary of state,PERSON-PERSON-PERSON,TITLE-TITLE-TITLE,PROPN-PROPN-PROPN,NOUN-ADP-NOUN,compound-compound-appos,appos-prep-pobj,NNP-NNP-NNP,NN-IN-NN,3,1
11070,49501.0,30,said,16,18,24,6,17,5,-2,8,David Gregory,professor,PERSON-PERSON,TITLE,PROPN-PROPN,NOUN,compound-nsubj,appos,NNP-NNP,NN,2,1
11071,49507.0,21,learned,14,7,13,6,6,7,7,-1,Marywood University,she,ORGANIZATION-ORGANIZATION,PERSON,PROPN-PROPN,PRON,compound-pobj,nsubj,NNP-NNP,PRP,4,1
11072,49511.0,40,support,5,39,7,-32,38,32,-34,2,seat,Barbara A L'Italien,ORGANIZATION,PERSON-PERSON-PERSON,NOUN,PROPN-PROPN-PROPN,pobj,compound-compound-dobj,NN,NNP-NNP-NNP,3,1
11073,49517.0,48,says,38,40,44,4,39,3,-2,6,ADB,Geert van der Linden,ORGANIZATION,PERSON-PERSON-PERSON-PERSON,PROPN,PROPN-PROPN-NOUN-PROPN,compound,compound-compound-nsubj-appos,NNP,NNP-NNP-NN-NNP,5,1
11074,49528.0,32,2010-02-02T12,0,4,26,22,3,5,-4,26,you,produced,PERSON,TITLE,PRON,VERB,nsubj,relcl,PRP,VBD,9,1
11075,49534.0,24,named,2,1,6,5,0,17,1,4,John Kerry,US Senate Foreign Relations Committee,PERSON-PERSON,ORGANIZATION-ORGANIZATION-ORGANIZATION-ORGANIZATION-ORGANIZATION,PROPN-PROPN,PROPN-PROPN-PROPN-PROPN-PROPN,compound-nsubj,compound-compound-compound-compound-pobj,NNP-NNP,NNP-NNP-NNP-NNPS-NNP,5,1
11076,49559.0,27,said,4,1,18,17,0,8,3,14,Al-Tai,Iraq,PERSON,NATIONALITY,PROPN,PROPN,poss,pobj,NNP,NNP,9,1
11077,49560.0,30,taken,20,12,17,5,11,12,8,-3,Awami League,Sheik Hasina,ORGANIZATION-ORGANIZATION,PERSON-PERSON,PROPN-PROPN,PROPN-PROPN,compound-conj,compound-pobj,NNP-NNP,NNP-NNP,4,1
11078,49571.0,53,show,8,38,23,-15,37,29,-30,15,he,37,PERSON,NUMBER,PRON,NUM,nsubj,nummod,PRP,CD,11,1
11079,49590.0,22,said,20,16,19,3,15,2,4,-1,Red Cross,Gail McGovern,ORGANIZATION-ORGANIZATION,PERSON-PERSON,PROPN-PROPN,PROPN-PROPN,compound-compound,compound-nsubj,NNP-NNP,NNP-NNP,2,1
11080,49598.0,55,quoted,46,43,35,-8,42,19,3,-11,Li Jie,chairman,PERSON-PERSON,TITLE,PROPN-PROPN,NOUN,compound-appos,appos,NNP-NNP,NN,2,1
11081,49620.0,54,include,1,17,41,24,16,12,-16,40,Richard DeBlanc,Barbara DeBlanc Romero,PERSON-PERSON,PERSON-PERSON-PERSON,PROPN-PROPN,PROPN-PROPN-PROPN,compound-conj,compound-compound-conj,NNP-NNP,NNP-NNP-NNP,5,1
11082,49638.0,62,ended,11,15,43,28,14,18,-4,32,Salehi,Iranian,PERSON,NATIONALITY,PROPN,ADJ,nsubjpass,compound,NNP,JJ,10,1
11083,49644.0,33,has,5,4,10,6,3,22,1,5,Paul Sculfor,her,PERSON-PERSON,PERSON,PROPN-PROPN,DET,compound-dobj,poss,NNP-NNP,PRP$,6,1
11084,49646.0,45,changed,23,29,5,-24,28,39,-6,-18,she,90,PERSON,NUMBER,PRON,NUM,nsubj,appos,PRP,CD,3,1
11085,49648.0,17,known,2,1,6,5,0,10,1,4,Kollek,builder,PERSON,TITLE,PROPN,NOUN,nsubjpass,pobj,NNP,NN,2,1
11086,49649.0,31,said,28,6,2,-4,5,28,22,-26,TSE,Taiwan Stock Exchange,ORGANIZATION,ORGANIZATION-ORGANIZATION-ORGANIZATION,PROPN,PROPN-PROPN-PROPN,compound,compound-compound-compound,NNP,NNP-NNP-NNP,2,1
11087,49650.0,37,sang,20,36,25,-11,35,11,-16,5,Cowell,Simon,PERSON,PERSON,PROPN,PROPN,pobj,poss,NNP,NNP,10,1
11088,49652.0,40,died,32,3,1,-2,2,38,29,-31,John P Henebry,Maj Gen,PERSON-PERSON-PERSON,TITLE-TITLE,PROPN-PROPN-PROPN,PROPN-PROPN,compound-compound-nsubj,compound-compound,NNP-NNP-NNP,NNP-NNP,2,1
11089,49659.0,41,said,23,30,25,-5,29,15,-7,2,International Monetary Fund,John G Nelmes,ORGANIZATION-ORGANIZATION-ORGANIZATION,PERSON-PERSON-PERSON,PROPN-PROPN-PROPN,PROPN-PROPN-PROPN,compound-compound-poss,compound-compound-nsubj,NNP-NNP-NNP,NNP-NNP-NNP,4,1
11090,49673.0,27,declared,6,17,10,-7,16,16,-11,4,Brandon McInerney,shooting,PERSON-PERSON,CRIMINAL_CHARGE,PROPN-PROPN,NOUN,compound-compound,pobj,NNP-NNP,NN,4,1
11091,49678.0,12,heading,6,4,10,6,3,1,2,4,Molly Malaney,New Zealand,PERSON-PERSON,COUNTRY-COUNTRY,PROPN-PROPN,PROPN-PROPN,compound-conj,compound-pobj,NNP-NNP,NNP-NNP,5,1
11092,49685.0,35,was,2,1,18,17,0,16,1,16,She,Chevy Chase Women 's Republican Club,PERSON,ORGANIZATION-ORGANIZATION-ORGANIZATION-ORGANIZATION-ORGANIZATION-ORGANIZATION,PRON,PROPN-PROPN-PROPN-PART-PROPN-PROPN,nsubj,compound-compound-poss-case-compound-conj,PRP,NNP-NNP-NNP-POS-NNP-NNP,6,1
11093,49686.0,40,announced,38,2,24,22,1,15,36,-14,Bernama,Syed Jamil Syed Jaafar,ORGANIZATION,PERSON-PERSON-PERSON-PERSON,PROPN,PROPN-PROPN-PROPN-PROPN,compound,compound-compound-compound-pobj,NNP,NNP-NNP-NNP-NNP,9,1
11094,49690.0,49,says,2,14,4,-10,13,44,-12,2,he,Abu Zubaydah,PERSON,PERSON-PERSON,PRON,PROPN-PROPN,nsubj,compound-nsubjpass,PRP,NNP-NNP,4,1
11095,49718.0,44,gained,4,4,9,5,3,34,0,5,FirstGroup,London,ORGANIZATION,CITY,PROPN,PROPN,nsubj,pobj,NNP,NNP,2,1
11096,49722.0,39,sold,23,33,16,-17,32,22,-10,-7,her,director,PERSON,TITLE,DET,NOUN,poss,conj,PRP$,NN,5,1
11097,49727.0,37,recognized,10,29,34,5,28,2,-19,24,American Psychological Association,Public Information Committee,ORGANIZATION-ORGANIZATION-ORGANIZATION,ORGANIZATION-ORGANIZATION-ORGANIZATION,PROPN-PROPN-PROPN,PROPN-PROPN-PROPN,compound-compound-poss,compound-compound-pobj,NNP-NNP-NNP,NNP-NNP-NNP,3,1
11098,49735.0,39,merges,4,1,17,16,0,21,3,13,Independent Steelworkers Union,US,ORGANIZATION-ORGANIZATION-ORGANIZATION,COUNTRY,PROPN-PROPN-PROPN,PROPN,compound-compound-nsubj,pobj,NNP-NNPS-NNP,NNP,4,1
11099,49755.0,19,motivated,5,4,1,-3,3,17,1,-4,her,The activist,PERSON,TITLE-TITLE,PRON,DET-NOUN,pobj,det-nsubj,PRP,DT-NN,2,1
11100,49763.0,42,included,1,16,3,-13,15,38,-15,2,Gholam-Ali Haddad-Adel,Chairman,PERSON-PERSON,TITLE,PROPN-PROPN,PROPN,compound-ROOT,appos,NNP-NNP,NNP,-1,1
11101,49764.0,23,survived,7,6,16,10,5,6,1,9,Rothman,Murray,PERSON,PERSON,PROPN,PROPN,nsubjpass,appos,NNP,NNP,5,1
11102,49769.0,45,presented,14,25,31,6,24,13,-11,17,American Psychological Association,San Diego,ORGANIZATION-ORGANIZATION-ORGANIZATION,CITY-CITY,PROPN-PROPN-PROPN,PROPN-PROPN,compound-compound-pobj,compound-pobj,NNP-NNP-NNP,NNP-NNP,6,1
11103,49771.0,33,told,28,18,22,4,17,10,10,-6,Li Jie,spokesman,PERSON-PERSON,TITLE,PROPN-PROPN,NOUN,compound-nsubj,appos,NNP-NNP,NN,2,1
11104,49772.0,32,sounded,12,10,1,-9,9,30,2,-11,International Crisis Group,Thomas Pickering,ORGANIZATION-ORGANIZATION-ORGANIZATION,PERSON-PERSON,PROPN-PROPN-PROPN,PROPN-PROPN,compound-compound-pobj,compound-nsubj,NNP-NNP-NNP,NNP-NNP,4,1
11105,49784.0,59,turned,12,45,48,3,44,10,-33,36,Jennifer Dunn,R-Wash,PERSON-PERSON,STATE_OR_PROVINCE,PROPN-PROPN,PROPN,compound-appos,appos,NNP-NNP,NNP,3,1
11106,49785.0,20,said,18,3,13,10,2,6,15,-5,Paul Gillmor,Wednesday,PERSON-PERSON,DATE,PROPN-PROPN,PROPN,compound-nsubjpass,npadvmod,NNP-NNP,NNP,3,1
11107,59327.0,23,AP,1,5,16,11,4,6,-4,15,Paul Gillmor,Wednesday,PERSON-PERSON,DATE,PROPN-PROPN,PROPN,compound-nsubjpass,npadvmod,NNP-NNP,NNP,3,1
11108,49788.0,44,blamed,14,3,36,33,2,7,11,22,John F Kerry,Catholic,PERSON-PERSON-PERSON,RELIGION,PROPN-PROPN-PROPN,ADJ,compound-compound-nsubjpass,amod,NNP-NNP-NNP,JJ,11,1
11109,49803.0,27,Zein,1,21,2,-19,20,24,-20,1,he,Zein al-Abedeen Mohammad Hassan,PERSON,PERSON-PERSON-PERSON-PERSON,PRON,PROPN-PROPN-PROPN-PROPN,nsubj,ROOT-prep-compound-appos,PRP,NNP-NNP-NNP-NNP,4,1
11110,49814.0,49,said,43,39,42,3,38,6,4,-1,NSC,Huang Wen-hsiung,ORGANIZATION,PERSON-PERSON,PROPN,PROPN-PROPN,compound,compound-nsubj,NNP,NNP-NNP,3,1
11111,49815.0,23,established,5,1,8,7,0,14,4,3,The American Red Cross,Clara Barton,ORGANIZATION-ORGANIZATION-ORGANIZATION-ORGANIZATION,PERSON-PERSON,DET-PROPN-PROPN-PROPN,PROPN-PROPN,det-compound-compound-nsubjpass,compound-pobj,DT-NNP-NNP-NNP,NNP-NNP,4,1
11112,49826.0,27,BAGHDAD,0,12,5,-7,11,21,-12,5,his,soldier,PERSON,TITLE,DET,NOUN,poss,nsubjpass,PRP$,NN,5,1
11113,49838.0,37,received,12,12,6,-6,11,30,0,-6,he,Egyptian Ministry of Foreign Affairs,PERSON,ORGANIZATION-ORGANIZATION-ORGANIZATION-ORGANIZATION-ORGANIZATION,PRON,PROPN-PROPN-ADP-PROPN-PROPN,nsubj,compound-pobj-prep-compound-pobj,PRP,NNP-NNP-IN-NNP-NNPS,4,1
11114,49851.0,48,recalled,1,14,12,-2,13,35,-13,11,Hussein Kamel al-Majid,Lt Gen,PERSON-PERSON-PERSON,TITLE-TITLE,PROPN-PROPN-PROPN,PROPN-PROPN,compound-compound-appos,compound-compound,NNP-NNP-NNP,NNP-NNP,5,1
11115,49854.0,29,said,25,24,21,-3,23,7,1,-4,Miyeegombo Enkhbold,Deputy Prime Minister,PERSON-PERSON,TITLE-TITLE-TITLE,PROPN-PROPN,PROPN-PROPN-PROPN,compound-nsubj,compound-compound-compound,NNP-NNP,NNP-NNP-NNP,2,1
11116,49858.0,18,competed/starred,3,11,6,-5,10,11,-8,3,Celebrity,NBC,PERSON,ORGANIZATION,PROPN,PROPN,attr,poss,NNP,NNP,2,1
11117,49871.0,54,said,41,49,51,2,48,2,-8,10,ADB,Operations Evaluation Department,ORGANIZATION,ORGANIZATION-ORGANIZATION-ORGANIZATION,PROPN,PROPN-PROPN-PROPN,poss,compound-compound-pobj,NNP,NNPS-NNP-NNP,3,1
11118,49883.0,25,asked,23,20,1,-19,19,23,3,-22,San Francisco,The Bachelor,PERSON-PERSON,CITY-CITY,PROPN-PROPN,DET-PROPN,compound-pobj,det-dep,NNP-NNP,DT-NNP,6,1
11119,49885.0,29,said,2,11,4,-7,10,24,-9,2,Carnival Corp,Gerry Cahill,ORGANIZATION-ORGANIZATION,PERSON-PERSON,PROPN-PROPN,PROPN-PROPN,compound-pobj,compound-nsubj,NNP-NNP,NNP-NNP,3,1
11120,49886.0,38,FOCUS-DALY-ART,0,18,3,-15,17,34,-18,3,Focus on the Family,COLORADO SPRINGS,ORGANIZATION-ORGANIZATION-ORGANIZATION-ORGANIZATION,CITY-CITY,PROPN-ADP-DET-PROPN,PROPN-PROPN,pobj-prep-det-pobj,compound-pobj,NNP-IN-DT-NNP,NNP-NNP,-1,1
11121,49891.0,27,found,8,1,4,3,0,22,7,-4,Russian Information Agency,Beijing,ORGANIZATION-ORGANIZATION-ORGANIZATION,CITY,ADJ-PROPN-PROPN,PROPN,amod-compound-compound,compound,JJ-NNP-NNP,NNP,2,1
11122,49901.0,86,Bryanston,2,2,2,0,1,83,0,0,CNR,CNR Bryanston,ORGANIZATION,ORGANIZATION-ORGANIZATION,PROPN,PROPN-PROPN,compound,compound-ROOT,NNP,NNP-NNP,0,1
11123,49904.0,37,praised,1,8,14,6,7,22,-7,13,National Action Network,Harlem,ORGANIZATION-ORGANIZATION-ORGANIZATION,LOCATION,PROPN-PROPN-PROPN,PROPN,compound-compound-poss,pobj,NNP-NNP-NNP,NNP,7,1
11124,59050.0,56,said,22,11,7,-4,10,48,11,-15,National Action Network,Harlem,ORGANIZATION-ORGANIZATION-ORGANIZATION,LOCATION,PROPN-PROPN-PROPN,PROPN,compound-compound-pobj,compound,NNP-NNP-NNP,NNP,3,1
11125,49907.0,25,said,22,17,21,4,16,3,5,-1,National Science Council,Chen Chien-jen,ORGANIZATION-ORGANIZATION-ORGANIZATION,PERSON-PERSON,PROPN-PROPN-PROPN,PROPN-PROPN,compound-compound-compound,npadvmod-punct,NNP-NNP-NNP,NNP-NNP,4,1
11126,49909.0,23,is,16,7,3,-4,6,19,9,-13,NSC,Nuclear Safety Commission,ORGANIZATION,ORGANIZATION-ORGANIZATION-ORGANIZATION,PROPN,PROPN-PROPN-PROPN,compound,compound-compound-nsubj,NNP,NNP-NNP-NNP,3,1
11127,49910.0,15,http://www.palmbeachdailynews.com/news/content/news/kellertrial/webke,13,4,14,10,3,0,9,1,Daily News,http://www.palmbeachdailynews.com/news/content/news/kellertrial/webke,ORGANIZATION-ORGANIZATION,URL,PROPN-PROPN,NOUN,compound-compound,ROOT,NNP-NNP,NNS,3,1
11128,49918.0,12,been,5,2,4,2,1,7,3,-1,58-year-old,banker,PERSON,TITLE,NUM,NOUN,amod,nsubj,CD,NN,3,1
11129,49919.0,21,said,5,14,17,3,13,3,-9,12,his,Scientology,PERSON,RELIGION,DET,PROPN,poss,compound,PRP$,NNP,2,1
11130,49926.0,20,closes,2,2,13,11,1,6,0,11,Morgenthau,district attorney,PERSON,TITLE-TITLE,PROPN,NOUN-NOUN,nsubj,compound-pobj,NNP,NN-NN,4,1
11131,49929.0,13,bid,2,9,6,-3,8,6,-7,4,Remy Ma,New York,PERSON-PERSON,STATE_OR_PROVINCE-STATE_OR_PROVINCE,PROPN-PROPN,PROPN-PROPN,compound-poss,compound-compound,NNP-NNP,NNP-NNP,2,1
11132,49942.0,16,is,3,1,1,0,0,14,2,-2,Carnival Cruise Lines,Carnival Corp.,ORGANIZATION-ORGANIZATION-ORGANIZATION,ORGANIZATION-ORGANIZATION,PROPN-PROPN-PROPN,PROPN-PROPN,compound-compound-nsubj,compound-pobj,NNP-NNP-NNP,NNP-NNP,0,1
11133,49952.0,39,Kong,1,10,1,-9,9,37,-9,0,Philip Chen,Hong Kong,PERSON-PERSON,STATE_OR_PROVINCE-STATE_OR_PROVINCE,PROPN-PROPN,PROPN-PROPN,compound-nsubjpass,compound-ROOT,NNP-NNP,NNP-NNP,-1,1
11134,49967.0,46,urged,13,9,36,27,8,9,4,23,Marcel Ospel,U.S.,PERSON-PERSON,COUNTRY,PROPN-PROPN,PROPN,compound-pobj,compound,NNP-NNP,NNP,14,1
11135,49968.0,34,is,1,1,6,5,0,27,0,5,Dodd,Thomas J Dodd,PERSON,PERSON-PERSON-PERSON,PROPN,PROPN-PROPN-PROPN,nsubj,compound-compound-pobj,NNP,NNP-NNP-NNP,4,1
11136,49974.0,17,is,4,1,3,2,0,13,3,-1,ISU,Ottavio Cinquanta,ORGANIZATION,PERSON-PERSON,PROPN,PROPN-PROPN,compound,compound-nsubj,NNP,NNP-NNP,1,1
11137,49977.0,60,confesses,28,12,11,-1,11,48,16,-17,Donald Wildmon,Rev.,PERSON-PERSON,TITLE,PROPN-PROPN,PROPN,compound-appos,compound,NNP-NNP,NNP,1,1
11138,53537.0,13,piled,10,3,2,-1,2,10,7,-8,Donald Wildmon,Rev.,PERSON-PERSON,TITLE,PROPN-PROPN,PROPN,compound-nsubj,compound,NNP-NNP,NNP,1,1
11139,49981.0,31,reported,28,27,24,-3,26,6,1,-4,official media,communist,ORGANIZATION-ORGANIZATION,RELIGION,ADJ-NOUN,ADJ,amod-nsubj,amod,JJ-NNS,JJ,1,1
11140,49983.0,20,trying,5,4,15,11,3,4,1,10,Hamilton,Monaco,PERSON,COUNTRY,PROPN,PROPN,nsubj,pobj,NNP,NNP,3,1
11141,49989.0,57,said,20,38,22,-16,37,34,-18,2,Citibank,Brian Ruder,ORGANIZATION,PERSON-PERSON,PROPN,PROPN-PROPN,pobj,compound-nsubj,NNP,NNP-NNP,6,1
11142,50000.0,45,said,33,41,35,-6,40,9,-8,2,China FAW Group Corporation,Xu Jianyi,ORGANIZATION-ORGANIZATION-ORGANIZATION-ORGANIZATION,PERSON-PERSON,PROPN-PROPN-PROPN-PROPN,PROPN-PROPN,compound-compound-compound-pobj,compound-nsubj,NNP-NNP-NNP-NNP,NNP-NNP,5,1
11143,50009.0,27,TV-IDOL-JOHNS,0,21,3,-18,20,23,-21,3,his,ATLANTA,PERSON,CITY,DET,NOUN,poss,ROOT,PRP$,NN,-1,1
11144,50017.0,37,married,12,12,16,4,11,20,0,4,she,social worker,PERSON,TITLE-TITLE,PRON,ADJ-NOUN,nsubj,amod-dobj,PRP,JJ-NN,1,1
11145,50031.0,37,bought,20,13,22,9,12,14,7,2,Old Lane Partners,last April,ORGANIZATION-ORGANIZATION-ORGANIZATION,DATE-DATE,PROPN-PROPN-PROPN,ADJ-PROPN,compound-compound-pobj,amod-npadvmod,NNP-NNP-NNPS,JJ-NNP,9,1
11146,50038.0,24,retired,17,17,21,4,16,2,0,4,DeBlanc,Marine Corps Reserve,PERSON,ORGANIZATION-ORGANIZATION-ORGANIZATION,PROPN,PROPN-PROPN-PROPN,nsubj,compound-compound-pobj,NNP,NNP-NNP-NNP,3,1
11147,50039.0,37,earn,23,29,1,-28,28,35,-6,-22,CHN,China Team,ORGANIZATION,ORGANIZATION-ORGANIZATION,PROPN,PROPN-PROPN,nmod,compound-poss,NNP,NNP-NNP,5,1
11148,50053.0,46,announced,41,10,14,4,9,31,31,-27,Pascal Yoadimnadji,cerebral hemorrhage,PERSON-PERSON,CAUSE_OF_DEATH-CAUSE_OF_DEATH,PROPN-PROPN,ADJ-NOUN,compound-nsubj,amod-pobj,NNP-NNP,JJ-NN,3,1
11149,55226.0,30,said,27,12,18,6,11,11,15,-9,Pascal Yoadimnadji,cerebral hemorrhage,PERSON-PERSON,CAUSE_OF_DEATH-CAUSE_OF_DEATH,PROPN-PROPN,ADJ-NOUN,compound-pobj,amod-pobj,NNP-NNPS,JJ-NN,5,1
11150,50058.0,20,feeling,3,6,18,12,5,1,-3,15,she,Martin King,PERSON,PERSON-PERSON,PRON,PROPN-PROPN,nsubj,compound-conj,PRP,NNP-NNP,6,1
11151,50072.0,36,deblanc,10,9,21,12,8,14,1,11,Jefferson J. deblanc Sr.,pilot,PERSON-PERSON-PERSON-PERSON,TITLE,PROPN-PROPN-NOUN-PROPN,NOUN,compound-nsubj-ROOT-dobj,appos,NNP-NNP-NN-NNP,NN,4,1
11152,50077.0,40,Credit,0,20,39,19,19,0,-20,39,Olivia Palermo,Wilhelmina,PERSON-PERSON,ORGANIZATION,PROPN-PROPN,PROPN,compound-pobj,pobj,NNP-NNP,NNP,8,1
11153,50089.0,19,raised,9,1,6,5,0,12,8,-3,Its,Richard Meelia,ORGANIZATION,PERSON-PERSON,DET,PROPN-PROPN,poss,compound-appos,PRP$,NNP-NNP,2,1
11154,50093.0,40,kidnapped,21,9,13,4,8,26,12,-8,CNR,Goma,ORGANIZATION,CITY,PROPN,PROPN,compound,pobj,NNP,NNP,4,1
11155,50096.0,38,are,9,5,32,27,4,5,4,23,club,Richard Carr,ORGANIZATION,PERSON-PERSON,NOUN,PROPN-PROPN,poss,compound-compound,NN,NNP-NNP,-1,1
11156,50160.0,20,lauded,3,7,15,8,6,4,-4,12,American Psychiatric Association,"36,000",ORGANIZATION-ORGANIZATION-ORGANIZATION,NUMBER,PROPN-PROPN-PROPN,NUM,compound-compound-pobj,nummod,NNP-NNP-NNP,CD,3,1
11157,50163.0,28,is,2,2,25,23,1,2,0,23,DeGeneres,American Express,PERSON,ORGANIZATION-ORGANIZATION,PROPN,PROPN-PROPN,nsubj,compound-compound,NNP,NNP-NNP,8,1
11158,50177.0,50,said,48,45,47,2,44,2,3,-1,FAA,Jim Peters,ORGANIZATION,PERSON-PERSON,PROPN,PROPN-PROPN,compound,compound-nsubj,NNP,NNP-NNP,1,1
11159,50178.0,27,was,3,2,1,-1,1,25,1,-2,Lewis Hamilton,Englishman,PERSON-PERSON,NATIONALITY,PROPN-PROPN,PROPN,compound-nsubj,compound,NNP-NNP,NNP,1,1
11160,66061.0,27,Auto,1,10,9,-1,9,17,-9,8,Lewis Hamilton,Englishman,PERSON-PERSON,NATIONALITY,PROPN-PROPN,PROPN,compound-nsubj,compound,NNP-NNP,NNP,1,1
11161,50180.0,33,said,24,31,2,-29,30,30,-7,-22,Paul Watson,Japanese,PERSON-PERSON,NATIONALITY,PROPN-PROPN,ADJ,compound-appos,amod,NNP-NNP,JJ,5,1
11162,50183.0,25,born,4,1,9,8,0,15,3,5,Steven Boghos Derounian,Bulgaria,PERSON-PERSON-PERSON,COUNTRY,PROPN-PROPN-PROPN,PROPN,compound-compound-nsubjpass,appos,NNP-NNP-NNP,NNP,3,1
11163,50189.0,9,contributed,4,3,2,-1,2,6,1,-2,Li Jie,researcher,PERSON-PERSON,TITLE,PROPN-PROPN,NOUN,compound-nsubj,compound,NNP-NNP,NN,1,1
11164,50193.0,39,craft,8,30,36,6,29,2,-22,28,Mainland Affairs Council,official,ORGANIZATION-ORGANIZATION-ORGANIZATION,PERSON,PROPN-PROPN-PROPN,NOUN,compound-compound-appos,nsubj,NNP-NNPS-NNP,NN,3,1
11165,50197.0,22,said,16,18,20,2,17,1,-2,4,association,Bruce Spitzer,ORGANIZATION,PERSON-PERSON,NOUN,PROPN-PROPN,compound,compound-nsubj,NN,NNP-NNP,3,1
11166,50204.0,48,shows,3,15,6,-9,14,41,-12,3,Kurt Waldheim,Wiesenthal,PERSON-PERSON,PERSON,PROPN-PROPN,PROPN,compound-pobj,nsubj,NNP-NNP,NNP,4,1
11167,50210.0,52,given,10,27,27,0,26,24,-17,17,U.S. Army Medical Command,U.S.,ORGANIZATION-ORGANIZATION-ORGANIZATION-ORGANIZATION,COUNTRY,PROPN-PROPN-PROPN-PROPN,PROPN,compound-compound-compound-pobj,pobj,NNP-NNP-NNP-NNP,NNP,0,1
11168,50215.0,26,said,24,22,19,-3,21,6,2,-5,her,natural causes,PERSON,CAUSE_OF_DEATH-CAUSE_OF_DEATH,DET,ADJ-NOUN,poss,amod-pobj,PRP$,JJ-NNS,4,1
11169,50218.0,15,makes,9,1,7,6,0,7,8,-2,Denso,"1,100",ORGANIZATION,NUMBER,PROPN,NUM,poss,nummod,NNP,CD,4,1
11170,50230.0,33,spanned,2,25,32,7,24,0,-23,30,National Christmas Tree Association,Missouri,ORGANIZATION-ORGANIZATION-ORGANIZATION-ORGANIZATION,STATE_OR_PROVINCE,PROPN-PROPN-PROPN-PROPN,PROPN,compound-compound-compound-pobj,pobj,NNP-NNP-NNP-NNP,NNP,6,1
11171,54321.0,47,expected,16,39,46,7,38,0,-23,30,National Christmas Tree Association,Missouri,ORGANIZATION-ORGANIZATION-ORGANIZATION-ORGANIZATION,STATE_OR_PROVINCE,PROPN-PROPN-PROPN-PROPN,PROPN,compound-compound-compound-pobj,appos,NNP-NNP-NNP-NNP,NNP,6,1
11172,60060.0,47,expected,16,39,46,7,38,0,-23,30,National Christmas Tree Association,Missouri,ORGANIZATION-ORGANIZATION-ORGANIZATION-ORGANIZATION,STATE_OR_PROVINCE,PROPN-PROPN-PROPN-PROPN,PROPN,compound-compound-compound-pobj,appos,NNP-NNP-NNP-NNP,NNP,6,1
11173,50236.0,10,09.16.08,0,5,10,5,4,-1,-5,10,CMT,http://www.cmt.com/shows/dyn/greatest_series/131767/episode.jhtml,ORGANIZATION,URL,PROPN,PROPN,appos,conj,NNP,NNP,-1,1
11174,50242.0,35,LLC,2,1,5,4,0,29,1,3,Residential Capital LLC,https://wwwrescapholdingscom/,ORGANIZATION-ORGANIZATION-ORGANIZATION,URL,PROPN-PROPN-PROPN,X,compound-compound-ROOT,ROOT,NNP-NNP-NNP,ADD,4,1
11175,50244.0,29,said,12,7,1,-6,6,27,5,-11,Chunghwa Telecom,Hu Hueuh-hai,ORGANIZATION-ORGANIZATION,PERSON-PERSON,PROPN-PROPN,PROPN-PROPN,compound-poss,nsubj-nummod,NNP-NNP,NNP-NNP,3,1
11176,50250.0,53,include,1,11,37,26,10,15,-10,36,Nolte,Roger Nolte,PERSON,PERSON-PERSON,PROPN,PROPN-PROPN,conj,compound-conj,NNP,NNP-NNP,9,1
11177,50255.0,30,is,9,7,12,5,6,17,2,3,John Kerry,Catholic,PERSON-PERSON,RELIGION,PROPN-PROPN,PROPN,compound-appos,attr,NNP-NNP,NNP,3,1
11178,50259.0,33,headquartered,23,22,5,-17,21,27,1,-18,it,Hafiz Mohammad Saeed,ORGANIZATION,PERSON-PERSON-PERSON,PRON,PROPN-PROPN-PROPN,nsubjpass,compound-compound-pobj,PRP,NNP-NNP-NNP,5,1
11179,50266.0,6,is,3,2,5,3,1,0,1,2,Remy Ma,28,PERSON-PERSON,NUMBER,PROPN-PROPN,NUM,compound-nsubj,attr,NNP-NNP,CD,2,1
11180,50267.0,38,died,33,1,11,10,0,26,32,-22,Philip M. Kaiser,Hungary,PERSON-PERSON-PERSON,COUNTRY,PROPN-PROPN-PROPN,PROPN,compound-compound-nsubj,conj,NNP-NNP-NNP,NNP,6,1
11181,50272.0,36,means,7,1,19,18,0,16,6,12,Vernon Bellecourt,White Earth,PERSON-PERSON,ORGANIZATION-ORGANIZATION,PROPN-PROPN,PROPN-PROPN,compound-nsubj,compound-compound,NNP-NNP,NNP-NNP,6,1
11182,50291.0,20,replace,2,4,10,6,3,9,-2,8,Dan Abrams,Hannity & Colmes,PERSON-PERSON,ORGANIZATION-ORGANIZATION-ORGANIZATION,PROPN-PROPN,PROPN-CCONJ-PROPN,compound-dobj,pobj-cc-conj,NNP-NNP,NNP-CC-NNP,6,1
11183,50318.0,35,said,15,1,7,6,0,27,14,-8,M. Enkhbold,Mongolian People 's Revolutionary Party,PERSON-PERSON,ORGANIZATION-ORGANIZATION-ORGANIZATION-ORGANIZATION-ORGANIZATION,PROPN-PROPN,PROPN-PROPN-PART-PROPN-PROPN,compound-nsubj,compound-poss-case-compound-pobj,NNP-NNP,NNP-NNPS-POS-NNP-NNP,4,1
11184,50327.0,54,survived,2,5,16,11,4,37,-3,14,his,Robert G. Kaiser,PERSON,PERSON-PERSON-PERSON,DET,PROPN-PROPN-PROPN,poss,compound-compound-ROOT,PRP$,NNP-NNP-NNP,4,1
11185,50330.0,49,received,6,8,44,36,7,4,-2,38,his,McNeese State University,PERSON,ORGANIZATION-ORGANIZATION-ORGANIZATION,DET,PROPN-PROPN-PROPN,poss,compound-compound-pobj,PRP$,NNP-NNP-NNP,8,1
11186,50332.0,56,relationship,4,48,43,-5,47,12,-44,39,Alcatel-Lucent,Vincenzo Nesci,ORGANIZATION,PERSON-PERSON,PROPN,PROPN-PROPN,poss,compound-nsubj,NNP,NNP-NNP,3,1
11187,50345.0,19,Sills,2,2,16,14,1,2,0,14,Beverly Sills,New York City,PERSON-PERSON,CITY-CITY-CITY,PROPN-PROPN,PROPN-PROPN-PROPN,compound-ROOT,compound-compound-pobj,NNP-NNP,NNP-NNP-NNP,6,1
11188,50351.0,27,lambasted,16,14,3,-11,13,23,2,-13,Ali Larijani,representative,PERSON-PERSON,TITLE,PROPN-PROPN,NOUN,compound-pobj,nsubj,NNP-NNP,NN,3,1
11189,50353.0,24,came,2,7,9,2,6,14,-5,7,President Hugo,Chavez announced in April that he would nationalise the entire cement industry in the country,PERSON-PERSON,ORGANIZATION-ORGANIZATION-ORGANIZATION-ORGANIZATION-ORGANIZATION-ORGANIZATION-ORGANIZATION-ORGANIZATION-ORGANIZATION-ORGANIZATION-ORGANIZATION-ORGANIZATION-ORGANIZATION-ORGANIZATION-ORGANIZATION,PROPN-PROPN,PROPN-VERB-ADP-PROPN-ADP-PRON-VERB-VERB-DET-ADJ-NOUN-NOUN-ADP-DET-NOUN,compound-compound,nsubj-advcl-prep-pobj-mark-nsubj-aux-ccomp-det-amod-compound-dobj-prep-det-pobj,NNP-NNP,NNP-VBD-IN-NNP-IN-PRP-MD-VB-DT-JJ-NN-NN-IN-DT-NN,2,1
11190,50357.0,34,drew,4,3,1,-2,2,32,1,-3,Carolyn Maloney,Democratic,PERSON-PERSON,ORGANIZATION,PROPN-PROPN,ADJ,compound-nsubj,amod,NNP-NNP,JJ,2,1
11191,50374.0,50,swooped,12,19,24,5,18,25,-7,12,Madoff Investment Securities,Shana Madoff,ORGANIZATION-ORGANIZATION-ORGANIZATION,PERSON-PERSON,PROPN-PROPN-PROPN,PROPN-PROPN,compound-compound-pobj,compound-nsubj,NNP-NNP-NNPS,NNP-NNP,3,1
11192,50379.0,45,shot,2,1,1,0,0,43,1,-1,NEC Corp,NEC Electronics,ORGANIZATION-ORGANIZATION,ORGANIZATION-ORGANIZATION,PROPN-PROPN,PROPN-PROPN,compound-nsubj,compound-nsubj,NNP-NNP,NNP-NNP,0,1
11193,50380.0,30,shared,5,20,17,-3,19,12,-15,12,Jerome Robbins,Robert Wise,PERSON-PERSON,PERSON-PERSON,PROPN-PROPN,PROPN-PROPN,compound-conj,compound-nsubj,NNP-NNP,NNP-NNP,1,1
11194,50384.0,29,born,4,1,9,8,0,19,3,5,Philip Mayer Kaiser,New York,PERSON-PERSON-PERSON,STATE_OR_PROVINCE-STATE_OR_PROVINCE,PROPN-PROPN-PROPN,PROPN-PROPN,compound-compound-nsubjpass,compound-appos,NNP-NNP-NNP,NNP-NNP,5,1
11195,50387.0,31,went,8,6,2,-4,5,28,2,-6,Canadian National Railways,"1,700",ORGANIZATION-ORGANIZATION-ORGANIZATION,NUMBER,PROPN-PROPN-PROPN,NUM,compound-compound-pobj,nummod,NNP-NNP-NNPS,CD,4,1
11196,50388.0,32,said,27,14,1,-13,13,30,13,-26,GMAC,Richfield,ORGANIZATION,CITY,PROPN,PROPN,compound,nsubj,NNP,NNP,7,1
11197,50394.0,43,quoted,28,8,25,17,7,17,20,-3,Lashkar-e-Tayyeba,spokesman,PERSON,TITLE,PROPN,NOUN,pobj,compound,NNP,NN,5,1
11198,50404.0,37,said,5,1,3,2,0,33,4,-2,AL,Mahmudur Rahman Manna,ORGANIZATION,PERSON-PERSON-PERSON,PROPN,PROPN-PROPN-PROPN,compound,compound-compound-nsubj,NNP,NNP-NNP-NNP,1,1
11199,50422.0,30,Come,0,25,29,4,24,0,-25,29,FMF,Marines,ORGANIZATION,ORGANIZATION,PROPN,PROPN,compound,pobj,NNP,NNPS,4,1
11200,50429.0,49,said,34,19,4,-15,18,44,15,-30,Simon Cowell,Paula Goodspeed,PERSON-PERSON,PERSON-PERSON,PROPN-PROPN,PROPN-PROPN,compound-pobj,compound-nsubj,NNP-NNP,NNP-NNP,4,1
11201,50435.0,32,confirmed,29,4,2,-2,3,29,25,-27,Parren J Mitchell,US,PERSON-PERSON-PERSON,COUNTRY,PROPN-PROPN-PROPN,PROPN,compound-compound-nsubj,compound,NNP-NNP-NNP,NNP,2,1
11202,50450.0,35,stormed,2,33,32,-1,32,2,-31,30,Mamoor Khan,commander,PERSON-PERSON,TITLE,PROPN-PROPN,NOUN,compound-nsubj,compound,NNP-NNP,NN,1,1
11203,66347.0,38,stormed,2,36,35,-1,35,2,-34,33,Mamoor Khan,commander,PERSON-PERSON,TITLE,PROPN-PROPN,NOUN,compound-nsubj,compound,NNP-NNP,NN,1,1
11204,50474.0,16,had,11,13,7,-6,12,8,-2,-4,his,Metro,PERSON,CITY,DET,PROPN,poss,pobj,PRP$,NNP,3,1
11205,50475.0,54,include,1,8,17,9,7,36,-7,16,Jefferson DeBlanc Jr.,Richard DeBlanc,PERSON-PERSON-PERSON,PERSON-PERSON,PROPN-PROPN-PROPN,PROPN-PROPN,compound-compound-appos,compound-conj,NNP-NNP-NNP,NNP-NNP,2,1
11206,50481.0,37,be,4,23,19,-4,22,17,-19,15,Farrow,war crimes,PERSON,CRIMINAL_CHARGE-CRIMINAL_CHARGE,NOUN,NOUN-NOUN,nsubjpass,compound-compound,NN,NN-NNS,7,1
11207,50485.0,37,YORK,1,26,32,6,25,4,-25,31,Remy Smith,weapon possession,PERSON-PERSON,CRIMINAL_CHARGE-CRIMINAL_CHARGE,PROPN-PROPN,NOUN-NOUN,compound-attr,compound-conj,NNP-NNP,NN-NN,2,1
11208,50517.0,30,is,1,13,1,-12,12,28,-12,0,Hector Elizondo,Alex,PERSON-PERSON,PERSON,PROPN-PROPN,PROPN,compound-compound,nsubj,NNP-NNP,NNP,5,1
11209,50520.0,21,included,4,14,2,-12,13,18,-10,-2,Konica Minolta Holdings Inc,Tokyo,ORGANIZATION-ORGANIZATION-ORGANIZATION-ORGANIZATION,CITY,PROPN-PROPN-PROPN-PROPN,PROPN,compound-compound-compound-nsubj,pobj,NNP-NNP-NNP-NNP,NNP,5,1
11210,50535.0,35,hailed,8,5,1,-4,4,33,3,-7,Blackburn Rovers,Mark Hughes,ORGANIZATION-ORGANIZATION,PERSON-PERSON,PROPN-PROPN,PROPN-PROPN,compound-compound,compound-nsubj,NNP-NNPS,NNP-NNP,2,1
11211,50537.0,46,called,13,15,43,28,14,2,-2,30,Cathleen P Black,manager,PERSON-PERSON-PERSON,TITLE,PROPN-PROPN-PROPN,NOUN,compound-compound-oprd,nsubjpass,NNP-NNP-NNP,NN,7,1
11212,50542.0,20,told,14,13,10,-3,12,9,1,-4,Haifa University,Yossi Ben-Artzi,ORGANIZATION-ORGANIZATION,PERSON-PERSON,PROPN-PROPN,PROPN-PROPN,compound-pobj,compound-nsubj,NNP-NNP,NNP-NNP,1,1
11213,50543.0,35,proclaims,9,25,16,-9,24,18,-16,7,CCP,Chinese Communist Party,ORGANIZATION,ORGANIZATION-ORGANIZATION-ORGANIZATION,PROPN,PROPN-PROPN-PROPN,pobj,compound-compound-pobj,NNP,NNP-NNP-NNP,6,1
11214,50544.0,28,said,6,23,8,-15,22,19,-17,2,Metro Atlanta Chamber of Commerce,Kessel Stelling Jr.,ORGANIZATION-ORGANIZATION-ORGANIZATION-ORGANIZATION-ORGANIZATION,PERSON-PERSON-PERSON,PROPN-PROPN-PROPN-ADP-PROPN,PROPN-PROPN-PROPN,compound-compound-pobj-prep-pobj,compound-compound-nsubj,NNP-NNP-NNP-IN-NNP,NNP-NNP-NNP,8,1
11215,50549.0,29,said,16,28,19,-9,27,9,-12,3,APA,Carolyn Robinowitz,ORGANIZATION,PERSON-PERSON,PROPN,PROPN-PROPN,pobj,compound-nsubj,NNP,NNP-NNP,5,1
11216,50551.0,57,said,43,52,45,-7,51,11,-9,2,MF Global,Edward Meir,ORGANIZATION-ORGANIZATION,PERSON-PERSON,PROPN-PROPN,PROPN-PROPN,compound-pobj,compound-nsubj,NNP-NNP,NNP-NNP,5,1
11217,57909.0,38,says,24,33,26,-7,32,11,-9,2,MF Global,Edward Meir,ORGANIZATION-ORGANIZATION,PERSON-PERSON,PROPN-PROPN,PROPN-PROPN,compound-pobj,compound-nsubj,NNP-NNP,NNP-NNP,5,1
11218,63120.0,46,said,39,41,44,3,40,1,-2,5,MF Global,Edward Meir,ORGANIZATION-ORGANIZATION,PERSON-PERSON,PROPN-PROPN,PROPN-PROPN,compound-compound,compound-nsubj,NNP-NNP,NNP-NNP,2,1
11219,50552.0,47,reported,12,1,9,8,0,37,11,-3,GMAC 's Residential Capital LLC,ResCap,ORGANIZATION-ORGANIZATION-ORGANIZATION-ORGANIZATION-ORGANIZATION,ORGANIZATION,PROPN-PART-PROPN-PROPN-PROPN,PROPN,poss-case-compound-compound-nsubj,pobj,NNP-POS-NNP-NNP-NNP,NNP,4,1
11220,50569.0,51,LONDON,0,35,7,-28,34,43,-35,7,Illinois Tool Works Inc.,Enodis,ORGANIZATION-ORGANIZATION-ORGANIZATION-ORGANIZATION,ORGANIZATION,PROPN-PROPN-PROPN-PROPN,PROPN,compound-compound-compound-pobj,dobj,NNP-NNP-NNP-NNP,NNP,6,1
11221,50598.0,24,said,14,11,2,-9,10,21,3,-12,American Psychiatric Association,Steven S. Sharfstein,ORGANIZATION-ORGANIZATION-ORGANIZATION,PERSON-PERSON-PERSON,PROPN-PROPN-PROPN,PROPN-PROPN-PROPN,compound-compound-pobj,compound-compound-nsubj,NNP-NNP-NNP,NNP-NNP-NNP,6,1
11222,50603.0,9,Dead,6,5,9,4,4,-1,1,3,Vernon Bellecourt Dead,75,PERSON-PERSON-PERSON,NUMBER,PROPN-PROPN-PROPN,NUM,compound-compound-ROOT,pobj,NNP-NNP-NNP,CD,-1,1
11223,50614.0,20,was,7,4,18,14,3,1,3,11,Gaius C. Bolin,African-American,PERSON-PERSON-PERSON,NATIONALITY,PROPN-PROPN-PROPN,ADJ,compound-compound-appos,amod,NNP-NNP-NNP,JJ,9,1
11224,50635.0,25,became,18,2,18,16,1,6,16,0,she,Jon,PERSON,PERSON,PRON,PROPN,nsubjpass,appos,PRP,NNP,9,1
11225,50646.0,25,removed,14,16,1,-15,15,23,-2,-13,him,"Five days later , the day",PERSON,DATE-DATE-DATE-DATE-DATE-DATE,PRON,NUM-NOUN-ADV-PUNCT-DET-NOUN,nsubj,nummod-npadvmod-advmod-punct-det-npadvmod,PRP,"CD-NNS-RBR-,-DT-NN",3,1
11226,50679.0,10,was,1,1,5,4,0,4,0,4,She,Bethesda,PERSON,CITY,PRON,PROPN,nsubj,nmod,PRP,NNP,4,1
11227,50688.0,45,said,28,30,35,5,29,9,-2,7,Al Hubbard,chief economic adviser,PERSON-PERSON,TITLE-TITLE-TITLE,PROPN-PROPN,ADJ-ADJ-NOUN,compound-nsubj,amod-amod-appos,NNP-NNP,JJ-JJ-NN,3,1
11228,50694.0,9,Aviation,2,1,6,5,0,2,1,4,China National Aviation,CNAC,ORGANIZATION-ORGANIZATION-ORGANIZATION,ORGANIZATION,PROPN-PROPN-PROPN,PROPN,compound-compound-ROOT,compound,NNP-NNP-NNP,NNP,3,1
11229,50699.0,24,worked,1,1,9,8,0,14,0,8,He,Tribune,PERSON,ORGANIZATION,PRON,PROPN,nsubj,pobj,PRP,NNP,5,1
11230,50739.0,29,SANTIAGO,0,9,13,4,8,15,-9,13,son,Fidel Castro,PERSON,PERSON-PERSON,NOUN,PROPN-PROPN,nsubj,compound-pobj,NN,NNP-NNP,2,1
11231,50747.0,9,PLANS,1,1,9,8,0,-1,0,8,COVIDIEN,BERMUDA,ORGANIZATION,LOCATION,ADJ,PROPN,amod,appos,JJ,NNP,-1,1
11232,50751.0,29,born,4,27,7,-20,26,21,-23,3,Tema Kaiser,Brooklyn,PERSON-PERSON,CITY,PROPN-PROPN,PROPN,compound-conj,pobj,NNP-NNP,NNP,9,1
11233,50758.0,16,Spoilers,3,6,13,7,5,2,-3,10,Jake Pavelka,Ali Becomes New Bachelorette,PERSON-PERSON,PERSON-PERSON-PERSON-PERSON,PROPN-PROPN,PROPN-VERB-PROPN-PROPN,compound-nsubj,nsubj-ROOT-compound-dobj,NNP-NNP,NNP-VBZ-NNP-NNP,3,1
11234,50762.0,18,said,11,13,16,3,12,1,-2,5,Bentley,USCIS,PERSON,ORGANIZATION,PROPN,PROPN,nsubj,compound,NNP,NNP,2,1
11235,50764.0,47,Jr,2,1,18,17,0,28,1,16,Jefferson DeBlanc,Frank DeBlanc,PERSON-PERSON,PERSON-PERSON,PROPN-PROPN,PROPN-PROPN,compound-compound,compound-appos,NNP-NNP,NNP-NNP,3,1
11236,50777.0,33,trained,15,8,2,-6,7,30,7,-13,his,chairman,PERSON,TITLE,DET,NOUN,poss,compound,PRP$,NN,3,1
11237,50819.0,39,is,7,37,32,-5,36,6,-30,25,KGB,Romano Prodi,ORGANIZATION,PERSON-PERSON,PROPN,PROPN-PROPN,compound,compound-appos,NNP,NNP-NNP,3,1
11238,50824.0,27,served,7,7,22,15,6,4,0,15,Verity,US-Soviet Trade and Economic Council,PERSON,ORGANIZATION-ORGANIZATION-ORGANIZATION-ORGANIZATION-ORGANIZATION,PROPN,PROPN-PROPN-CCONJ-PROPN-PROPN,nsubj,nmod-nmod-cc-compound-pobj,NNP,NNP-NNP-CC-NNP-NNP,8,1
11239,50827.0,47,look,2,22,7,-15,21,39,-20,5,Jennifer Dunn,Congress,PERSON-PERSON,ORGANIZATION,PROPN-PROPN,PROPN,compound-nsubj,pobj,NNP-NNP,NNP,4,1
11240,50829.0,23,said,5,1,4,3,0,18,4,-1,NSWRU,Fraser Neill,ORGANIZATION,PERSON-PERSON,PROPN,PROPN-PROPN,compound,compound-nsubj,NNP,NNP-NNP,4,1
11241,50837.0,25,declined,1,19,11,-8,18,13,-18,10,Zagats,Zagat,ORGANIZATION,ORGANIZATION,PROPN,PROPN,nsubj,compound,NNPS,NNP,4,1
11242,60129.0,31,bought,5,30,13,-17,29,17,-25,8,Zagats,Zagat,ORGANIZATION,ORGANIZATION,PROPN,PROPN,pobj,pobj,NNPS,NNP,5,1
11243,50838.0,34,Year,0,20,29,9,19,4,-20,29,Department of Conservation and Recreation,Hull,ORGANIZATION-ORGANIZATION-ORGANIZATION-ORGANIZATION-ORGANIZATION,PERSON,PROPN-ADP-PROPN-CCONJ-PROPN,PROPN,pobj-prep-pobj-cc-conj,pobj,NNP-IN-NNP-CC-NNP,NNP,8,1
11244,50855.0,34,mountaineer,2,13,5,-8,12,28,-11,3,Washburn,photographer,PERSON,TITLE,PROPN,NOUN,nsubj,appos,NNP,NN,3,1
11245,50858.0,26,Season,0,4,25,21,3,0,-4,25,Trista,him,PERSON,PERSON,PROPN,PRON,dobj,dobj,NNP,PRP,2,1
11246,50861.0,34,shot,2,13,20,7,12,13,-11,18,Remy Ma,artist,PERSON-PERSON,TITLE,PROPN-PROPN,NOUN,compound-pobj,appos,NNP-NNP,NN,8,1
11247,50862.0,37,made,5,7,1,-6,6,35,-2,-4,his,Superior Court,PERSON,ORGANIZATION-ORGANIZATION,DET,PROPN-PROPN,poss,compound-compound,PRP$,NNP-NNP,4,1
11248,50866.0,34,received,7,6,26,20,5,7,1,19,Herrera,Mexican,PERSON,NATIONALITY,PROPN,ADJ,nsubj,amod,NNP,JJ,7,1
11249,50882.0,37,said,35,35,2,-33,34,34,0,-33,KCNA,Democratic People 's Republic of Korea,ORGANIZATION,COUNTRY-COUNTRY-COUNTRY-COUNTRY-COUNTRY-COUNTRY,PROPN,PROPN-PROPN-PART-PROPN-ADP-PROPN,nsubj,amod-poss-case-nsubj-prep-pobj,NNP,NNP-NNPS-POS-NNP-IN-NNP,3,1
11250,50897.0,63,voted,2,16,11,-5,15,51,-14,9,China National Aviation Corp.,CNAHC,ORGANIZATION-ORGANIZATION-ORGANIZATION-ORGANIZATION,ORGANIZATION,PROPN-PROPN-PROPN-PROPN,PROPN,compound-compound-compound-subtok,poss,NNP-NNP-NNP-NNP,NNP,3,1
11251,50899.0,28,said,12,1,24,23,0,3,11,12,Denso,Aichi,ORGANIZATION,LOCATION,PROPN,PROPN,amod,pobj,NNP,NNP,7,1
11252,50904.0,39,checked,1,13,4,-9,12,34,-12,3,Julian Bond,Board of Directors of American Rights,PERSON-PERSON,ORGANIZATION-ORGANIZATION-ORGANIZATION-ORGANIZATION-ORGANIZATION-ORGANIZATION,PROPN-PROPN,PROPN-ADP-PROPN-ADP-PROPN-PROPN,compound-appos,dobj-prep-pobj-prep-compound-pobj,NNP-NNP,NNP-IN-NNPS-IN-NNP-NNPS,-1,1
11253,50907.0,32,was,5,5,18,13,4,13,0,13,she,her district,PERSON,ORGANIZATION-ORGANIZATION,PRON,DET-NOUN,nsubj,poss-pobj,PRP,PRP$-NN,5,1
11254,50916.0,32,were,10,26,25,-1,25,6,-16,15,Alberto Gonzales,Attorney,PERSON-PERSON,TITLE,PROPN-PROPN,PROPN,compound-conj,compound,NNP-NNP,NNP,1,1
11255,50924.0,34,was,21,1,15,14,0,18,20,-6,Her,Connecticut Women 's Hall of Fame,PERSON,ORGANIZATION-ORGANIZATION-ORGANIZATION-ORGANIZATION-ORGANIZATION-ORGANIZATION,DET,PROPN-PROPN-PART-PROPN-ADP-PROPN,poss,compound-poss-case-pobj-prep-pobj,PRP$,NNP-NNPS-POS-NNP-IN-NNP,8,1
11256,50941.0,47,returning,22,1,28,27,0,18,21,6,Morgan,Baltimore,PERSON,CITY,PROPN,PROPN,nsubj,pobj,NNP,NNP,3,1
11257,54837.0,48,returning,23,2,29,27,1,18,21,6,Morgan,Baltimore,PERSON,CITY,PROPN,PROPN,nsubj,pobj,NNP,NNP,3,1
11258,50952.0,79,survived,8,7,38,31,6,40,1,30,Meskill,Peter,PERSON,PERSON,PROPN,PROPN,nsubjpass,conj,NNP,NNP,10,1
11259,50957.0,48,declined,2,33,25,-8,32,22,-31,23,Mainland Affairs Council,TSU,ORGANIZATION-ORGANIZATION-ORGANIZATION,ORGANIZATION,PROPN-PROPN-PROPN,PROPN,compound-compound-pobj,compound,NNP-NNPS-NNP,NNP,13,1
11260,50960.0,39,was,18,1,5,4,0,33,17,-13,Julia Carson,Democrat,PERSON-PERSON,TITLE,PROPN-PROPN,PROPN,compound-nsubj,appos,NNP-NNP,NNP,3,1
11261,50962.0,28,appear,16,26,6,-20,25,21,-10,-10,NFC South,Carolina Panthers,ORGANIZATION-ORGANIZATION,ORGANIZATION-ORGANIZATION,PROPN-PROPN,PROPN-PROPN,compound-pobj,compound-dobj,NNP-NNP,NNP-NNPS,6,1
11262,50983.0,41,valued,5,4,28,24,3,12,1,23,Zagat,General Atlantic Partners,ORGANIZATION,PERSON-PERSON-PERSON,PROPN,PROPN-PROPN-PROPN,nsubjpass,compound-compound-pobj,NNP,NNP-NNP-NNPS,8,1
11263,50996.0,45,include,1,28,37,9,27,7,-27,36,Gilbert Gude,Daniel Gude,PERSON-PERSON,PERSON-PERSON,PROPN-PROPN,PROPN-PROPN,compound-compound,compound-conj,NNP-NNP,NNP-NNP,5,1
11264,50999.0,43,said,28,30,36,6,29,6,-2,8,Christopher Bentley,U.S. Bureau of Citizenship and Immigration Services,PERSON-PERSON,ORGANIZATION-ORGANIZATION-ORGANIZATION-ORGANIZATION-ORGANIZATION-ORGANIZATION-ORGANIZATION,PROPN-PROPN,PROPN-PROPN-ADP-PROPN-CCONJ-PROPN-PROPN,compound-nsubj,compound-pobj-prep-nmod-cc-conj-pobj,NNP-NNP,NNP-NNP-IN-NNP-CC-NNP-NNPS,3,1
11265,51004.0,17,is,4,1,15,14,0,1,3,11,Servicemembers Legal Defense Network,http://www.sldn.org/binary-data/SLDN_SECTIONS/pdf_file/19.pdf,ORGANIZATION-ORGANIZATION-ORGANIZATION-ORGANIZATION,URL,PROPN-PROPN-PROPN-PROPN,PROPN,compound-compound-compound-nsubj,amod,NNP-NNP-NNP-NNP,NNP,4,1
11266,51014.0,26,appointed,2,1,10,9,0,15,1,8,Larijani,Supreme National Security,PERSON,ORGANIZATION-ORGANIZATION-ORGANIZATION,PROPN,PROPN-PROPN-PROPN,nsubjpass,compound-compound-compound,NNP,NNP-NNP-NNP,6,1
11267,51047.0,23,broke,1,16,21,5,15,1,-15,20,he,hit-and-run,PERSON,CAUSE_OF_DEATH,PRON,PROPN,nsubjpass,compound,PRP,NNP,5,1
11268,51051.0,34,worked,9,20,8,-12,19,25,-11,-1,Beyonce,Knowles,PERSON,PERSON,PROPN,PROPN,appos,nsubj,NNP,NNP,8,1
11269,51072.0,56,reached,27,23,26,3,22,29,4,-1,his,Robyn,PERSON,PERSON,DET,PROPN,poss,appos,PRP$,NNP,1,1
11270,51087.0,14,is,1,6,12,6,5,1,-5,11,Hussein Kamel,Saddam Hussein,PERSON-PERSON,PERSON-PERSON,PROPN-PROPN,PROPN-PROPN,compound-pobj,compound-pobj,NNP-NNP,NNP-NNP,3,1
11271,65860.0,36,gave,6,6,5,-1,5,30,0,-1,Hussein Kamel,Saddam Hussein,PERSON-PERSON,PERSON-PERSON,PROPN-PROPN,PROPN-PROPN,compound-conj,compound-nsubj,NNP-NNP,NNP-NNP,1,1
11272,51095.0,20,said,3,2,5,3,1,14,1,2,Carolyn Maloney,Americans,PERSON-PERSON,NATIONALITY,PROPN-PROPN,PROPN,compound-nsubj,nsubjpass,NNP-NNP,NNPS,3,1
11273,51106.0,56,died,36,2,38,36,1,17,34,2,Jefferson J. DeBlanc Sr.,November 22,PERSON-PERSON-PERSON-PERSON,DATE-DATE,PROPN-PROPN-PROPN-PROPN,PROPN-NUM,compound-compound-compound-nsubj,npadvmod-nummod,NNP-NNP-NNP-NNP,NNP-CD,2,1
11274,51116.0,23,is,2,9,16,7,8,6,-7,14,Poul Thomsen,IMF,ORGANIZATION-ORGANIZATION,PERSON,PROPN-PROPN,PROPN,compound-nsubj,compound,NNP-NNP,NNP,5,1
11275,51121.0,43,is,1,7,7,0,6,35,-6,6,"Focus on the Family Action , Inc.",Focus on the Family,ORGANIZATION-ORGANIZATION-ORGANIZATION-ORGANIZATION-ORGANIZATION-ORGANIZATION-ORGANIZATION,ORGANIZATION-ORGANIZATION-ORGANIZATION-ORGANIZATION,PROPN-ADP-DET-PROPN-PROPN-PUNCT-PROPN,PROPN-ADP-DET-PROPN,pobj-prep-pobj-compound-pobj-punct-subtok,pobj-prep-det-pobj,"NNP-IN-DT-NNP-NNP-,-NNP",NNP-IN-DT-NNP,0,1
11276,51149.0,30,said,23,1,28,27,0,1,22,5,Forsberg,Celia Seupel,PERSON,PERSON-PERSON,PROPN,PROPN-PROPN,nsubj,compound-appos,NNP,NNP-NNP,5,1
11277,53662.0,30,said,23,1,28,27,0,1,22,5,Forsberg,Celia Seupel,PERSON,PERSON-PERSON,PROPN,PROPN-PROPN,nsubj,compound-appos,NNP,NNP-NNP,5,1
11278,51161.0,32,played,18,29,24,-5,28,7,-11,6,American Basketball Association,Beijing Aoshen Olympians,ORGANIZATION-ORGANIZATION-ORGANIZATION,ORGANIZATION-ORGANIZATION-ORGANIZATION,PROPN-PROPN-PROPN,PROPN-PROPN-PROPN,compound-compound-pobj,compound-compound-pobj,NNP-NNP-NNP,NNP-NNP-NNPS,4,1
11279,51168.0,56,raised,12,3,51,48,2,4,9,39,national science/technology,President Ma Ying-jeou,ORGANIZATION-ORGANIZATION,PERSON-PERSON-PERSON,ADJ-NOUN,PROPN-PROPN-PROPN,amod-nmod,compound-compound-poss,JJ-NN,NNP-NNP-NNP,7,1
11280,51171.0,54,survived,2,47,5,-42,46,48,-45,3,Charles Kaiser,his,PERSON-PERSON,PERSON,PROPN-PROPN,DET,compound-conj,poss,NNP-NNP,PRP$,5,1
11281,51172.0,32,Federation,3,6,20,14,5,11,-3,17,FMF,his,ORGANIZATION,PERSON,PROPN,DET,compound,poss,NNP,PRP$,4,1
11282,51188.0,46,cost,13,6,8,2,5,37,7,-5,Scorpions,Bulelani Ngcuka,ORGANIZATION,PERSON-PERSON,PROPN,PROPN-PROPN,compound,compound-poss,NNPS,NNP-NNP,1,1
11283,51197.0,32,said,29,19,14,-5,18,17,10,-15,NSC,Cabinet-level National Science Council,ORGANIZATION,ORGANIZATION-ORGANIZATION-ORGANIZATION-ORGANIZATION,PROPN,PROPN-PROPN-PROPN-PROPN,compound,compound-compound-compound-pobj,NNP,NNP-NNP-NNP-NNP,3,1
11284,51206.0,40,said,1,32,1,-31,31,38,-31,0,Mainland Affairs Council,Chang,ORGANIZATION-ORGANIZATION-ORGANIZATION,PERSON,PROPN-PROPN-PROPN,PROPN,compound-compound-pobj,nsubj,NNP-NNPS-NNP,NNP,7,1
11285,51214.0,89,Forum,1,42,13,-29,41,75,-41,12,Supreme Court of Pennsylvania,Philadelphia,ORGANIZATION-ORGANIZATION-ORGANIZATION-ORGANIZATION,CITY,PROPN-PROPN-ADP-PROPN,PROPN,compound-pobj-prep-pobj,pobj,NNP-NNP-IN-NNP,NNP,6,1
11286,51215.0,25,asked,23,2,13,11,1,11,21,-10,Bachelor,Williamstown,PERSON,CITY,PROPN,PROPN,dep,pobj,NNP,NNP,3,1
11287,51224.0,54,is,32,10,31,21,9,22,22,-1,Barry Goldwater,Victor Gold,PERSON-PERSON,PERSON-PERSON,PROPN-PROPN,PROPN-PROPN,compound-pobj,compound-nsubj,NNP-NNP,NNP-NNP,6,1
11288,51232.0,80,recognizes,3,18,42,24,17,37,-15,39,Chelsea Library,America,ORGANIZATION-ORGANIZATION,COUNTRY,PROPN-PROPN,PROPN,compound-pobj,pobj,NNP-NNP,NNP,-1,1
11289,51234.0,39,tied,13,20,1,-19,19,37,-7,-12,Chris Ivery,Pompeo,PERSON-PERSON,PERSON,PROPN-PROPN,PROPN,compound-pobj,nsubj,NNP-NNP,NNP,4,1
11290,51265.0,34,said,20,21,27,6,20,6,-1,7,said Khamenei,chief commander,PERSON-PERSON,TITLE-TITLE,VERB-PROPN,ADJ-NOUN,ROOT-nsubj,amod-attr,VBD-NNP,JJ-NN,2,1
11291,51272.0,44,Venezuela,0,4,39,35,3,4,-4,39,Chavez,ordering soldiers to shoot protesters,PERSON,CRIMINAL_CHARGE-CRIMINAL_CHARGE-CRIMINAL_CHARGE-CRIMINAL_CHARGE-CRIMINAL_CHARGE,PROPN,VERB-NOUN-PART-VERB-NOUN,nsubj,pcomp-dobj-aux-xcomp-dobj,NNP,VBG-NNS-TO-VB-NNS,10,1
11292,51280.0,37,said,15,2,8,6,1,28,13,-7,Covidien PLC,US,ORGANIZATION-ORGANIZATION,COUNTRY,PROPN-PROPN,PROPN,compound-pobj,compound,NNP-NNP,NNP,2,1
11293,51290.0,36,says,6,2,1,-1,1,34,4,-5,Sean Ross,Analyst,PERSON-PERSON,TITLE,PROPN-PROPN,PROPN,compound-nsubj,compound,NNP-NNP,NNP,1,1
11294,51292.0,66,survived,12,11,21,10,10,44,1,9,Kaiser,Hannah Greeley Kaiser,PERSON,PERSON-PERSON-PERSON,PROPN,PROPN-PROPN-PROPN,nsubjpass,compound-compound-appos,NNP,NNP-NNP-NNP,3,1
11295,51299.0,56,include,1,10,20,10,9,35,-9,19,Verity,Jonathan George Verity,PERSON,PERSON-PERSON-PERSON,PROPN,PROPN-PROPN-PROPN,compound,compound-compound-conj,NNP,NNP-NNP-NNP,5,1
11296,51313.0,47,died,40,1,5,4,0,41,39,-35,Catherine Roraback,lawyer,PERSON-PERSON,TITLE,PROPN-PROPN,NOUN,compound-nsubj,appos,NNP-NNP,NN,3,1
11297,55212.0,47,died,40,1,5,4,0,41,39,-35,Catherine Roraback,lawyer,PERSON-PERSON,TITLE,PROPN-PROPN,NOUN,compound-nsubj,appos,NNP-NNP,NN,3,1
11298,51328.0,41,run,24,3,15,12,2,25,21,-9,Fidelity,Pyramis Global Advisors,ORGANIZATION,ORGANIZATION-ORGANIZATION-ORGANIZATION,PROPN,PROPN-PROPN-PROPN,poss,compound-compound-conj,NNP,NNP-NNP-NNPS,6,1
11299,51335.0,24,said,5,20,22,2,19,1,-15,17,his,Asian,PERSON,NATIONALITY,DET,ADJ,poss,amod,PRP$,JJ,2,1
11300,51374.0,32,ended,2,13,17,4,12,14,-11,15,girl,MTV,PERSON,ORGANIZATION,NOUN,PROPN,poss,conj,NN,NNP,3,1
11301,51382.0,27,spoke,19,13,2,-11,12,24,6,-17,Barnes Foundation,Philadelphia Museum of Art,ORGANIZATION-ORGANIZATION,LOCATION-LOCATION-LOCATION-LOCATION,PROPN-PROPN,PROPN-PROPN-ADP-PROPN,compound-pobj,compound-nsubj-prep-pobj,NNP-NNP,NNP-NNP-IN-NNP,4,1
11302,51386.0,40,TEHRAN,0,36,1,-35,35,38,-36,1,Ali Akbar Salehi,TEHRAN,PERSON-PERSON-PERSON,LOCATION,PROPN-PROPN-PROPN,PROPN,compound-compound-nsubj,ROOT,NNP-NNP-NNP,NNP,6,1
11303,51397.0,39,said,37,8,12,4,7,26,29,-25,Popular Resistance Committees,Raad Abu el-Foul,ORGANIZATION-ORGANIZATION-ORGANIZATION,PERSON-PERSON-PERSON,PROPN-PROPN-PROPN,PROPN-PROPN-PROPN,compound-compound-pobj,compound-compound-appos,NNP-NNP-NNPS,NNP-NNP-NNP,2,1
11304,51398.0,38,fought,24,16,21,5,15,16,8,-3,her,secretary,PERSON,TITLE,DET,NOUN,poss,pobj,PRP$,NN,4,1
11305,60458.0,31,called,1,24,14,-10,23,16,-23,13,her,secretary,PERSON,TITLE,DET,NOUN,poss,appos,PRP$,NN,10,1
11306,51409.0,17,arrived,2,14,16,2,13,0,-12,14,Hawkins,11,PERSON,NUMBER,PROPN,NUM,nsubj,attr,NNP,CD,4,1
11307,51416.0,29,said,8,16,10,-6,15,18,-8,2,Tax Policy Center,Len Burman,ORGANIZATION-ORGANIZATION-ORGANIZATION,PERSON-PERSON,PROPN-PROPN-PROPN,PROPN-PROPN,compound-compound-pobj,compound-nsubj,NNP-NNP-NNP,NNP-NNP,6,1
11308,51427.0,36,accused,20,9,16,7,8,19,11,-4,Convocation of Anglicans in North America,2005,ORGANIZATION-ORGANIZATION-ORGANIZATION-ORGANIZATION-ORGANIZATION-ORGANIZATION,DATE,PROPN-ADP-PROPN-ADP-PROPN-PROPN,NUM,dobj-prep-pobj-prep-compound-pobj,pobj,NNP-IN-NNPS-IN-NNP-NNP,CD,4,1
11309,51436.0,26,went,1,17,24,7,16,1,-16,23,Alberto R. Gonzales,attorney general,PERSON-PERSON-PERSON,TITLE-TITLE,PROPN-PROPN-PROPN,NOUN-NOUN,compound-compound-pobj,compound-npadvmod,NNP-NNP-NNP,NN-NN,6,1
11310,51452.0,15,born,5,1,8,7,0,6,4,3,Henry Bradford Washburn Jr.,"June 7 , 1910",PERSON-PERSON-PERSON-PERSON,DATE-DATE-DATE-DATE,PROPN-PROPN-PROPN-PROPN,PROPN-NUM-PUNCT-NUM,compound-compound-compound-nsubjpass,pobj-nummod-punct-nummod,NNP-NNP-NNP-NNP,"NNP-CD-,-CD",5,1
11311,51455.0,38,1988,0,3,10,7,2,27,-3,10,Kurt Waldheim,director-general,PERSON-PERSON,TITLE,PROPN-PROPN,NOUN,compound-nsubj,conj,NNP-NNP,NN,3,1
11312,51459.0,67,BAGHDAD,0,26,19,-7,25,47,-26,19,IRGC-QF,Iranian Revolutionary Guard - Qods Force,ORGANIZATION,ORGANIZATION-ORGANIZATION-ORGANIZATION-ORGANIZATION-ORGANIZATION-ORGANIZATION,PROPN,ADJ-PROPN-PROPN-PUNCT-PROPN-PROPN,compound,compound-compound-compound-punct-compound-pobj,NNP,JJ-NNP-NNP-HYPH-NNP-NNP,5,1
11313,51472.0,21,representative,1,17,2,-15,16,18,-16,1,her,representative,PERSON,TITLE,PRON,NOUN,dative,ROOT,PRP,NN,-1,1
11314,51492.0,23,was,1,5,1,-4,4,21,-4,0,Nitschmann Middle School,Acerra,ORGANIZATION-ORGANIZATION-ORGANIZATION,PERSON,PROPN-PROPN-PROPN,PROPN,compound-compound-pobj,nsubj,NNP-NNP-NNP,NNP,4,1
11315,68077.0,23,was,1,5,1,-4,4,21,-4,0,Nitschmann Middle School,Acerra,ORGANIZATION-ORGANIZATION-ORGANIZATION,PERSON,PROPN-PROPN-PROPN,PROPN,compound-compound-pobj,nsubj,NNP-NNP-NNP,NNP,4,1
11316,51496.0,58,are,8,19,2,-17,18,55,-11,-6,Melanie Fiona,musicians,PERSON-PERSON,TITLE,PROPN-PROPN,NOUN,compound-conj,nsubj,NNP-NNP,NNS,4,1
11317,51500.0,55,agreed,12,28,45,17,27,9,-16,33,JNF UK,her,ORGANIZATION-ORGANIZATION,PERSON,PROPN-PROPN,DET,compound-compound,poss,NNP-NNP,PRP$,14,1
11318,51501.0,25,said,7,6,1,-5,5,23,1,-6,Mohamed ElBaradei,International Atomic Energy Association,PERSON-PERSON,ORGANIZATION-ORGANIZATION-ORGANIZATION-ORGANIZATION,PROPN-PROPN,PROPN-PROPN-PROPN-PROPN,compound-nsubj,compound-compound-compound-compound,NNP-NNP,NNP-NNP-NNP-NNP,4,1
11319,51504.0,32,moved,1,1,23,22,0,8,0,22,He,Catalonia,PERSON,LOCATION,PRON,PROPN,nsubj,pobj,PRP,NNP,2,1
11320,51517.0,37,reported,11,5,17,12,4,19,6,6,Federal Election Commission,March,ORGANIZATION-ORGANIZATION-ORGANIZATION,DATE,PROPN-PROPN-PROPN,PROPN,compound-compound-pobj,dobj,NNP-NNP-NNP,NNP,7,1
11321,51523.0,21,shocked,7,16,19,3,15,1,-9,12,he,Vienna Girardi,PERSON,PERSON-PERSON,PRON,PROPN-PROPN,nsubj,compound-pobj,PRP,NNP-NNP,4,1
11322,51553.0,44,vote,7,32,17,-15,31,26,-25,10,Weirton,Independent Steelworkers Union,ORGANIZATION,CITY-CITY-CITY,PROPN,PROPN-PROPN-PROPN,pobj,compound-compound-pobj,NNP,NNP-NNPS-NNP,8,1
11323,51578.0,25,said,10,17,18,1,16,6,-7,8,Representatives,Alice K Wolf,ORGANIZATION,PERSON-PERSON-PERSON,PROPN,PROPN-PROPN-PROPN,nmod,compound-compound-dobj,NNPS,NNP-NNP-NNP,1,1
11324,51584.0,34,said,14,7,3,-4,6,30,7,-11,Donald Wildmon,leader,PERSON-PERSON,TITLE,PROPN-PROPN,NOUN,compound-appos,nsubj,NNP-NNP,NN,2,1
11325,51593.0,46,killed,8,32,1,-31,31,44,-24,-7,KGB,RUSSIA-BLOOMBERG,ORGANIZATION,MISC,PROPN,PROPN,pobj,compound,NNP,NNP,-1,1
11326,51626.0,57,said,42,34,41,7,33,15,8,-1,New South Wales Rugby Union,Fraser Neill,ORGANIZATION-ORGANIZATION-ORGANIZATION-ORGANIZATION-ORGANIZATION,PERSON-PERSON,PROPN-PROPN-PROPN-PROPN-PROPN,PROPN-PROPN,compound-compound-nmod-nmod-nmod,compound-nsubj,NNP-NNP-NNP-NNP-NNP,NNP-NNP,5,1
11327,51631.0,17,been,2,15,1,-14,14,15,-13,-1,FMF,Nooij,ORGANIZATION,PERSON,PROPN,PROPN,pobj,nsubj,NNP,NNP,4,1
11328,51633.0,22,accessed,13,6,21,15,5,0,7,8,Ontario Human Rights Commission,http://www.ohrc.on.ca/en/resources/news/en/resources/news/statement,ORGANIZATION-ORGANIZATION-ORGANIZATION-ORGANIZATION,URL,PROPN-PROPN-PROPN-PROPN,NOUN,compound-compound-compound-poss,appos,NNP-NNP-NNPS-NNP,NN,7,1
11329,51655.0,14,been,3,9,13,4,8,0,-6,10,Disney,Shanghai,ORGANIZATION,CITY,PROPN,PROPN,compound,pobj,NNP,NNP,5,1
11330,51656.0,44,include,3,37,41,4,36,2,-34,38,John Kerry,Teresa Heinz Kerry,PERSON-PERSON,PERSON-PERSON-PERSON,PROPN-PROPN,PROPN-PROPN-PROPN,compound-pobj,compound-compound-conj,NNP-NNP,NNP-NNP-NNP,3,1
11331,51680.0,39,said,25,27,31,4,26,7,-2,6,Paul Kim,manager,PERSON-PERSON,TITLE,PROPN-PROPN,NOUN,compound-nsubj,appos,NNP-NNP,NN,2,1
11332,51716.0,13,approve,7,6,1,-5,5,11,1,-6,Jim Pavelka,Sallie Pavelka,PERSON-PERSON,PERSON-PERSON,PROPN-PROPN,PROPN-PROPN,compound-conj,compound-nsubj,NNP-NNP,NNP-NNP,3,1
11333,51730.0,55,are,14,14,9,-5,13,45,0,-5,DMC,Harper Professional Building,ORGANIZATION,ORGANIZATION-ORGANIZATION-ORGANIZATION,PROPN,PROPN-PROPN-PROPN,pobj,compound-compound-dobj,NNP,NNP-NNP-NNP,4,1
11334,51742.0,32,said,18,2,25,23,1,6,16,7,Chavez,Massachusetts,PERSON,STATE_OR_PROVINCE,PROPN,PROPN,nsubj,compound,NNP,NNP,5,1
11335,51756.0,14,after,2,9,11,2,8,2,-7,9,he,Officer Candidate School,PERSON,ORGANIZATION-ORGANIZATION-ORGANIZATION,PRON,PROPN-PROPN-PROPN,nsubj,compound-compound-dobj,PRP,NNP-NNP-NNP,2,1
11336,51757.0,11,News,1,1,7,6,0,3,0,6,Daily News,N.Y.,ORGANIZATION-ORGANIZATION,STATE_OR_PROVINCE,PROPN-PROPN,PROPN,compound-ROOT,subtok,NNP-NNP,NNP,-1,1
11337,51760.0,18,landed,2,1,5,4,0,12,1,3,He,St Paul,PERSON,CITY-CITY,PRON,PROPN-PROPN,nsubj,compound-pobj,PRP,NNP-NNP,3,1
11338,51761.0,21,turn,6,5,16,11,4,4,1,10,Mahdi,Shiites,PERSON,MISC,PROPN,PROPN,pobj,nsubj,NNP,NNPS,3,1
11339,51762.0,35,appealed,12,2,20,18,1,14,10,8,Manila Economic and Cultural Office,a Philippine woman,ORGANIZATION-ORGANIZATION-ORGANIZATION-ORGANIZATION-ORGANIZATION,PERSON-PERSON-PERSON,PROPN-PROPN-CCONJ-PROPN-PROPN,DET-ADJ-NOUN,nmod-nmod-cc-conj-compound,det-amod-pobj,NNP-NNP-CC-NNP-NNP,DT-JJ-NN,-1,1
11340,51815.0,25,urged,13,7,3,-4,6,21,6,-10,Gholam-Ali Haddad-Adel,Iran,PERSON-PERSON,COUNTRY,PROPN-PROPN,PROPN,compound-pobj,poss,NNP-NNP,NNP,3,1
11341,52059.0,14,continues,7,6,2,-4,5,11,1,-5,Gholam-Ali Haddad-Adel,Iran,PERSON-PERSON,COUNTRY,PROPN-PROPN,PROPN,compound-nsubj,poss,NNP-NNP,NNP,4,1
11342,51827.0,23,BEACH,2,19,1,-18,18,21,-17,-1,Northwood University,WEST PALM BEACH,ORGANIZATION-ORGANIZATION,CITY-CITY-CITY,PROPN-PROPN,PROPN-PROPN-PROPN,compound-compound,compound-compound-ROOT,NNP-NNP,NNP-NNP-NNP,7,1
11343,51835.0,36,responded,3,21,15,-6,20,20,-18,12,Jewish National Fund,Himanuta,ORGANIZATION-ORGANIZATION-ORGANIZATION,LOCATION,ADJ-PROPN-PROPN,PROPN,amod-compound-compound,compound,JJ-NNP-NNP,NNP,6,1
11344,51836.0,21,remains,7,7,16,9,6,4,0,9,Castro,Cuba,PERSON,COUNTRY,PROPN,PROPN,nsubj,poss,NNP,NNP,4,1
11345,51837.0,24,is,10,3,1,-2,2,22,7,-9,AAA,CAA,ORGANIZATION,ORGANIZATION,PROPN,PROPN,compound,compound,NNP,NNP,3,1
11346,51841.0,32,said,20,31,22,-9,30,9,-11,2,Citibank,Tom Lahiff,ORGANIZATION,PERSON-PERSON,PROPN,PROPN-PROPN,pobj,compound-nsubj,NNP,NNP-NNP,4,1
11347,51872.0,24,is,4,4,16,12,3,7,0,12,CNAC,CNAHC,ORGANIZATION,ORGANIZATION,PROPN,PROPN,nsubj,compound,NNP,NNP,6,1
11348,51878.0,21,wrote,17,17,10,-7,16,10,0,-7,Buchwald,Man Who Would n't Die,PERSON,MISC-MISC-MISC-MISC-MISC,PROPN,NOUN-PRON-VERB-ADV-VERB,nsubj,pobj-nsubj-aux-neg-relcl,NNP,NN-WP-MD-RB-VB,4,1
11349,51879.0,32,said,13,15,19,4,14,12,-2,6,Al Hubbard,Bush,PERSON-PERSON,PERSON,PROPN-PROPN,PROPN,compound-nsubj,poss,NNP-NNP,NNP,3,1
11350,51884.0,34,claims,2,4,4,0,3,29,-2,2,Samsung,Samsung,ORGANIZATION,ORGANIZATION,PROPN,PROPN,nsubj,pobj,NNP,NNP,0,1
11351,51885.0,25,said,23,4,14,10,3,10,19,-9,Pascal Yoadimnadji,brain hemorrhage,PERSON-PERSON,CAUSE_OF_DEATH-CAUSE_OF_DEATH,PROPN-PROPN,NOUN-NOUN,compound-nsubj,compound-pobj,NNP-NNP,NN-NN,3,1
11352,51888.0,27,approved,8,25,23,-2,24,3,-17,15,Richard Perle,director,PERSON-PERSON,TITLE,PROPN-PROPN,NOUN,compound-appos,conj,NNP-NNP,NN,2,1
11353,51892.0,23,differentiates,8,3,2,-1,2,20,5,-6,Justin Theroux,director,PERSON-PERSON,TITLE,PROPN-PROPN,VERB,compound-poss,advcl,NNP-NNP,VB,1,1
11354,51938.0,37,YORK,1,26,35,9,25,1,-25,34,Remy Smith,attempted coercion,PERSON-PERSON,CRIMINAL_CHARGE-CRIMINAL_CHARGE,PROPN-PROPN,VERB-NOUN,compound-attr,amod-conj,NNP-NNP,VBN-NN,4,1
11355,51949.0,19,voted,15,11,2,-9,10,16,4,-13,bank,United States,ORGANIZATION,ORGANIZATION-ORGANIZATION,NOUN,PROPN-PROPN,poss,compound-nsubj,NN,NNP-NNP,4,1
11356,51953.0,27,said,19,21,25,4,20,1,-2,6,Samsung,Shung-Hyun Cho,ORGANIZATION,PERSON-PERSON,PROPN,PROPN-PROPN,amod,compound-nsubj,NNP,NNP-NNP,3,1
11357,51957.0,34,told,32,26,3,-23,25,30,6,-29,him,MSNBC,PERSON,ORGANIZATION,PRON,PROPN,dobj,nsubj,PRP,NNP,4,1
11358,51961.0,24,says,11,19,13,-6,18,10,-8,2,DMC,Steve D'Arcy,ORGANIZATION,PERSON-PERSON,PROPN,PROPN-PROPN,poss,compound-nsubj,NNP,NNP-NNP,5,1
11359,51963.0,45,warned,18,8,11,3,7,33,10,-7,MNLF,Moro Islamic Liberation Front,ORGANIZATION,ORGANIZATION-ORGANIZATION-ORGANIZATION-ORGANIZATION,PROPN,PROPN-PROPN-PROPN-PROPN,pobj,compound-compound-compound-appos,NNP,NNP-NNP-NNP-NNP,3,1
11360,51975.0,24,worked,1,1,5,4,0,18,0,4,Buchwald,syndicated columnist,PERSON,TITLE-TITLE,PROPN,VERB-NOUN,nsubj,amod-pobj,NNP,VBN-NN,2,1
11361,51976.0,43,said,15,17,24,7,16,18,-2,9,Mahmood Shah,tailor,PERSON-PERSON,TITLE,PROPN-PROPN,NOUN,compound-nsubj,appos,NNP-NNP,NN,4,1
11362,51979.0,25,said,11,20,24,4,19,0,-9,13,American Bankers Association,Washington,ORGANIZATION-ORGANIZATION-ORGANIZATION,STATE_OR_PROVINCE,PROPN-PROPN-PROPN,PROPN,compound-compound-pobj,pobj,NNP-NNPS-NNP,NNP,3,1
11363,51987.0,27,is,4,15,4,-11,14,22,-11,0,IMF,Strauss-Kahn,ORGANIZATION,PERSON,PROPN,PROPN,pobj,punct,NNP,NNP,7,1
11364,51994.0,42,expelled,9,8,4,-4,7,37,1,-5,Perle,"Israeli government agent ,",PERSON,TITLE-TITLE-TITLE-TITLE,PROPN,ADJ-NOUN-NOUN-PUNCT,nsubjpass,amod-compound-nsubjpass-punct,NNP,"JJ-NN-NN-,",3,1
11365,52007.0,14,Form,1,1,14,13,0,-1,0,13,FAA,http://www.faa.gov/avr/afs/Waiver.htm,ORGANIZATION,URL,PROPN,NOUN,compound,ROOT,NNP,NN,3,1
11366,52022.0,27,responded,20,20,18,-2,19,8,0,-2,Ali,Facebook,PERSON,ORGANIZATION,PROPN,PROPN,nsubj,pobj,NNP,NNP,1,1
11367,52028.0,48,Chien,1,11,1,-10,10,46,-10,0,NSC,Tai Chien,ORGANIZATION,PERSON-PERSON,PROPN,PROPN-PROPN,compound,compound-ROOT,NNP,NNP-NNP,1,1
11368,52032.0,32,requires,3,22,22,0,21,9,-19,19,Samsung,Samsung Electronics Co,ORGANIZATION,ORGANIZATION-ORGANIZATION-ORGANIZATION,PROPN,PROPN-PROPN-PROPN,pobj,compound-compound-dobj,NNP,NNP-NNPS-NNP,0,1
11369,52047.0,39,said,37,1,28,27,0,10,36,-9,Kurt Waldheim,heart attack,PERSON-PERSON,CAUSE_OF_DEATH-CAUSE_OF_DEATH,PROPN-PROPN,NOUN-NOUN,compound-nsubj,compound-pobj,NNP-NNP,NN-NN,3,1
11370,52050.0,25,made,8,16,5,-11,15,19,-8,-3,he,Minister,PERSON,TITLE,PRON,PROPN,nsubj,nsubj,PRP,NNP,3,1
11371,52051.0,48,revealed,13,42,35,-7,41,12,-29,22,KGB,SVR,ORGANIZATION,ORGANIZATION,PROPN,PROPN,pobj,pobj,NNP,NNP,3,1
11372,52075.0,31,Looks,0,9,20,11,8,10,-9,20,NFC South,Saints & Falcons,ORGANIZATION-ORGANIZATION,ORGANIZATION-ORGANIZATION-ORGANIZATION,PROPN-PROPN,PROPN-CCONJ-PROPN,compound-pobj,pobj-cc-conj,NNP-NNP,NNPS-CC-NNPS,8,1
11373,52089.0,25,said,2,15,6,-9,14,18,-13,4,board,Fumio Urano,ORGANIZATION,PERSON-PERSON,NOUN,PROPN-PROPN,compound,compound-appos,NN,NNP-NNP,4,1
11374,52129.0,54,include,1,8,7,-1,7,46,-7,6,Jefferson DeBlanc Jr.,Rev.,PERSON-PERSON-PERSON,TITLE,PROPN-PROPN-PROPN,PROPN,compound-compound-appos,compound,NNP-NNP-NNP,NNP,2,1
11375,52134.0,48,wrote,39,34,28,-6,33,19,5,-11,PVA,Homer S Townsend Jr,ORGANIZATION,PERSON-PERSON-PERSON-PERSON,PROPN,PROPN-PROPN-PROPN-PROPN,poss,compound-compound-compound-nsubj,NNP,NNP-NNP-NNP-NNP,4,1
11376,52141.0,42,returned,18,9,29,20,8,12,9,11,Trista Sutter,bachelorette,PERSON-PERSON,TITLE,PROPN-PROPN,NOUN,compound-poss,compound,NNP-NNP,NN,9,1
11377,52143.0,50,killed,6,32,36,4,31,13,-26,30,ANP,Pakistan,ORGANIZATION,COUNTRY,PROPN,PROPN,compound,poss,NNP,NNP,8,1
11378,52183.0,32,told,24,24,5,-19,23,26,0,-19,she,MIT,PERSON,ORGANIZATION,PRON,PROPN,nsubj,pobj,PRP,NNP,4,1
11379,52185.0,40,scheduled,7,20,3,-17,19,36,-13,-4,John Kerry,Senate,PERSON-PERSON,ORGANIZATION,PROPN-PROPN,PROPN,compound-pobj,compound,NNP-NNP,NNP,6,1
11380,60341.0,21,are,1,8,5,-3,7,15,-7,4,John Kerry,Senate,PERSON-PERSON,ORGANIZATION,PROPN-PROPN,PROPN,compound-nsubj,pobj,NNP-NNP,NNP,3,1
11381,52212.0,30,tripled,13,10,21,11,9,8,3,8,Canadian National,Standard & Poor,ORGANIZATION-ORGANIZATION,ORGANIZATION-ORGANIZATION-ORGANIZATION,PROPN-PROPN,PROPN-CCONJ-PROPN,compound-conj,poss-cc-conj,NNP-NNP,NNP-CC-NNP,9,1
11382,52238.0,33,grew,2,12,19,7,11,13,-10,17,Fraser Robinson,captain,PERSON-PERSON,TITLE,PROPN-PROPN,NOUN,compound-appos,attr,NNP-NNP,NN,5,1
11383,52256.0,10,mixed,2,5,1,-4,4,8,-3,-1,FirstGroup,US,ORGANIZATION,COUNTRY,PROPN,PROPN,nsubj,compound,NNP,NNP,2,1
11384,52258.0,36,is,5,4,1,-3,3,34,1,-4,Carnival Cruises,Mickey Arison,ORGANIZATION-ORGANIZATION,PERSON-PERSON,PROPN-PROPN,PROPN-PROPN,compound-pobj,compound-nsubj,NNP-NNPS,NNP-NNP,2,1
11385,52260.0,43,helped,20,1,17,16,0,25,19,-3,Crisp,Arizona,PERSON,STATE_OR_PROVINCE,PROPN,PROPN,nsubj,pobj,NNP,NNP,5,1
11386,52268.0,48,died,37,42,5,-37,41,42,-5,-32,her,leader,PERSON,TITLE,DET,NOUN,poss,appos,PRP$,NN,5,1
11387,52269.0,32,appeared,21,15,6,-9,14,25,6,-15,MBIA,Standard & Poor 's,ORGANIZATION,ORGANIZATION-ORGANIZATION-ORGANIZATION-ORGANIZATION,PROPN,PROPN-CCONJ-PROPN-PART,poss,pobj-cc-conj-case,NNP,NNP-CC-NNP-POS,8,1
11388,52274.0,50,decommissioning,17,16,8,-8,15,41,1,-9,EnergySolutions,Chicago,ORGANIZATION,CITY,PROPN,PROPN,oprd,pobj,NNP,NNP,2,1
11389,52284.0,32,meeting,16,1,6,5,0,25,15,-10,YOLANDA KING,ACTOR,PERSON-PERSON,TITLE,PROPN-PROPN,PROPN,compound-nsubj,nmod,NNP-NNP,NNP,2,1
11390,52299.0,74,said,2,52,40,-12,51,33,-50,38,he,European,PERSON,NATIONALITY,PRON,PROPN,nsubj,compound,PRP,NNP,3,1
11391,52302.0,49,were,4,28,32,4,27,16,-24,28,Federal Aviation Administration,FAA,ORGANIZATION-ORGANIZATION-ORGANIZATION,ORGANIZATION,PROPN-PROPN-PROPN,PROPN,compound-compound-pobj,compound,NNP-NNP-NNP,NNP,4,1
11392,59030.0,34,WASHINGTON,0,28,32,4,27,1,-28,32,Federal Aviation Administration,FAA,ORGANIZATION-ORGANIZATION-ORGANIZATION,ORGANIZATION,PROPN-PROPN-PROPN,PROPN,compound-compound-nsubj,compound,NNP-NNP-NNP,NNP,2,1
11393,64774.0,49,said,47,6,10,4,5,38,41,-37,Federal Aviation Administration,FAA,ORGANIZATION-ORGANIZATION-ORGANIZATION,ORGANIZATION,PROPN-PROPN-PROPN,PROPN,compound-compound-pobj,compound,NNP-NNP-NNP,NNP,2,1
11394,52317.0,49,said,37,7,39,32,6,9,30,2,FirstGroup,Kevin Benson,ORGANIZATION,PERSON-PERSON,PROPN,PROPN-PROPN,conj,compound-nsubj,NNP,NNP-NNP,6,1
11395,52340.0,42,traveled,6,13,17,4,12,24,-7,11,my,Texas,PERSON,STATE_OR_PROVINCE,DET,PROPN,poss,pobj,PRP$,NNP,3,1
11396,52341.0,44,includes,10,6,12,6,5,31,4,2,Highland Capital 's,Lululemon Athletica,ORGANIZATION-ORGANIZATION-ORGANIZATION,ORGANIZATION-ORGANIZATION,PROPN-PROPN-PART,PROPN-PROPN,compound-poss-case,compound-dobj,NNP-NNP-POS,NNP-NNP,3,1
11397,52346.0,48,said,37,39,45,6,38,2,-2,8,R Nicholas Burns,State Department official,PERSON-PERSON-PERSON,TITLE-TITLE-TITLE,NOUN-PROPN-PROPN,PROPN-PROPN-NOUN,compound-compound-nsubj,compound-compound-appos,NN-NNP-NNP,NNP-NNP-NN,4,1
11398,52349.0,79,Minister,0,6,1,-5,5,77,-6,1,Lee Jye,Minister of National Defense,PERSON-PERSON,TITLE-TITLE-TITLE-TITLE,PROPN-PROPN,PROPN-ADP-PROPN-PROPN,compound-compound,ROOT-prep-compound-pobj,NNP-NNP,NNP-IN-NNP-NNP,4,1
11399,52362.0,36,HENEBRY,2,1,11,10,0,24,1,9,JOHN P HENEBRY,89,PERSON-PERSON-PERSON,NUMBER,PROPN-PROPN-PROPN,NUM,compound-compound-ROOT,nummod,NNP-NNP-NNP,CD,-1,1
11400,52368.0,44,gave,3,16,36,20,15,7,-13,33,North Phoenix Baptist Church,Meghan,ORGANIZATION-ORGANIZATION-ORGANIZATION-ORGANIZATION,PERSON,PROPN-PROPN-PROPN-PROPN,PROPN,compound-compound-compound-appos,appos,NNP-NNP-NNP-NNP,NNP,5,1
11401,52370.0,45,aims,3,7,18,11,6,26,-4,15,her,Rikers Island,PERSON,LOCATION-LOCATION,DET,PROPN-PROPN,poss,compound-compound,PRP$,NNPS-NNP,4,1
11402,52378.0,24,wasting,13,11,9,-2,10,14,2,-4,Kelly Cutrone,reality star,PERSON-PERSON,TITLE-TITLE,PROPN-PROPN,NOUN-NOUN,compound-nsubj,compound-compound,NNP-NNP,NN-NN,1,1
11403,52387.0,38,Taipei,0,15,18,3,14,19,-15,18,Hu,economist-turned-technocrat,PERSON,TITLE,PROPN,NOUN,pobj,appos,NNP,NN,3,1
11404,52389.0,21,returns,12,4,3,-1,3,17,8,-9,Hussein Kamel,Gen.,PERSON-PERSON,TITLE,PROPN-PROPN,PROPN,compound-nsubj,compound,NNP-NNP,NNP,1,1
11405,52396.0,25,Gude,2,22,21,-1,21,3,-20,19,Gilbert Gude,Rep,PERSON-PERSON,TITLE,PROPN-PROPN,PROPN,compound-appos,compound,NNP-NNP,NNP,1,1
11406,52403.0,35,said,15,1,10,9,0,24,14,-5,R. Nicholas Burns,Iran,PERSON-PERSON-PERSON,COUNTRY,PROPN-PROPN-PROPN,PROPN,compound-compound-nsubj,compound,NNP-NNP-NNP,NNP,2,1
11407,52413.0,33,said,7,1,10,9,0,22,6,3,McAllister,Rutherford,PERSON,PERSON,PROPN,PROPN,nsubj,nsubj,NNP,NNP,3,1
11408,52446.0,42,introduced,20,9,1,-8,8,40,11,-19,Christopher Dodd,US,PERSON-PERSON,ORGANIZATION,PROPN-PROPN,PROPN,compound-conj,nmod,NNP-NNP,NNP,3,1
11409,52447.0,44,investigating,4,8,17,9,7,26,-4,13,Murnat Kurnaz,German,PERSON-PERSON,NATIONALITY,PROPN-PROPN,ADJ,compound-pobj,amod,NNP-NNP,JJ,6,1
11410,52448.0,38,MIAMI,0,37,26,-11,36,11,-37,26,Houston,Beyonce,PERSON,CITY,PROPN,PROPN,pobj,nsubj,NNP,NNP,-1,1
11411,52451.0,50,Clashes,0,13,23,10,12,26,-13,23,Badr Organisation,SIIC,ORGANIZATION-ORGANIZATION,ORGANIZATION,PROPN-PROPN,PROPN,compound-compound,compound,NNP-NNP,NNP,4,1
11412,52452.0,53,Frame,0,5,9,4,4,43,-5,9,American Bar Association,ABA Journal,ORGANIZATION-ORGANIZATION-ORGANIZATION,ORGANIZATION-ORGANIZATION,PROPN-PROPN-PROPN,PROPN-PROPN,compound-compound-poss,compound-nsubj,NNP-NNP-NNP,NNP-NNP,2,1
11413,52462.0,29,MINNEAPOLIS,0,10,20,10,9,8,-10,20,GMAC,Bruce Paradis,ORGANIZATION,PERSON-PERSON,PROPN,PROPN-PROPN,compound,compound-nsubj,NNP,NNP-NNP,6,1
11414,52474.0,49,died,39,1,7,6,0,41,38,-32,Harry Shuler Dent,political operative,PERSON-PERSON-PERSON,TITLE-TITLE,PROPN-PROPN-PROPN,ADJ-NOUN,compound-compound-nsubj,amod-appos,NNP-NNP-NNP,JJ-NN,2,1
11415,52480.0,39,said,34,2,9,7,1,29,32,-25,She,producer,PERSON,TITLE,PRON,NOUN,nsubj,conj,PRP,NN,4,1
11416,52494.0,47,Football,4,10,32,22,9,14,-6,28,Blackburn Rovers,English,ORGANIZATION-ORGANIZATION,COUNTRY,PROPN-PROPN,PROPN,compound-pobj,compound,NNP-NNPS,NNP,6,1
11417,52498.0,52,said,11,8,1,-7,7,50,3,-10,Oxford University Press,Evan Schnittman,ORGANIZATION-ORGANIZATION-ORGANIZATION,PERSON-PERSON,PROPN-PROPN-PROPN,PROPN-PROPN,compound-compound-pobj,compound-nsubj,NNP-NNP-NNP,NNP-NNP,4,1
11418,52509.0,20,located,8,1,11,10,0,8,7,3,Denso Corp.,Nansha District of Guangzhou,ORGANIZATION-ORGANIZATION,LOCATION-LOCATION-LOCATION-LOCATION,PROPN-PROPN,PROPN-PROPN-ADP-PROPN,compound-nsubjpass,compound-pobj-prep-pobj,NNP-NNP,NNP-NNP-IN-NNP,3,1
11419,52515.0,12,trained,5,2,10,8,1,1,3,5,Badr Corps,Revolutionary Guards,ORGANIZATION-ORGANIZATION,ORGANIZATION-ORGANIZATION,PROPN-PROPN,PROPN-PROPN,compound-compound,compound-pobj,NNP-NNP,NNP-NNPS,4,1
11420,52519.0,36,means,7,1,29,28,0,6,6,22,Vernon Bellecourt,AIM Grand Governing Council,PERSON-PERSON,ORGANIZATION-ORGANIZATION-ORGANIZATION-ORGANIZATION,PROPN-PROPN,PROPN-PROPN-PROPN-PROPN,compound-nsubj,compound-compound-compound-pobj,NNP-NNP,NNP-NNP-NNP-NNP,6,1
11421,52525.0,34,appeared,8,26,4,-22,25,29,-18,-4,Kendra Baskett,Playboy Playmate,PERSON-PERSON,ORGANIZATION-ORGANIZATION,PROPN-PROPN,PROPN-PROPN,compound-conj,compound-advcl,NNP-NNP,NNP-NNP,4,1
11422,52530.0,50,damaged,2,46,23,-23,45,26,-44,21,Korean Central News Agency,DPRK,ORGANIZATION-ORGANIZATION-ORGANIZATION-ORGANIZATION,ORGANIZATION,PROPN-PROPN-PROPN-PROPN,PROPN,compound-compound-compound-pobj,poss,NNP-NNP-NNP-NNP,NNP,7,1
11423,52536.0,52,died,37,1,15,14,0,36,36,-22,Pamela Gardner Ahearn,US House of Representatives,PERSON-PERSON-PERSON,ORGANIZATION-ORGANIZATION-ORGANIZATION-ORGANIZATION,PROPN-PROPN-PROPN,PROPN-PROPN-ADP-PROPN,compound-compound-nsubj,compound-pobj-prep-pobj,NNP-NNP-NNP,NNP-NNP-IN-NNPS,7,1
11424,52543.0,24,born,5,1,22,21,0,1,4,17,Jefferson Joseph DeBlanc Sr.,St. Martinville,PERSON-PERSON-PERSON-PERSON,LOCATION-LOCATION,PROPN-PROPN-PROPN-PROPN,PROPN-PROPN,compound-compound-compound-nsubjpass,compound-pobj,NNP-NNP-NNP-NNP,NNP-NNP,6,1
11425,52549.0,33,approved,6,2,17,15,1,15,4,11,House of Representatives,Massachusetts,ORGANIZATION-ORGANIZATION-ORGANIZATION,STATE_OR_PROVINCE,PROPN-ADP-PROPN,PROPN,nsubj-prep-pobj,nsubj,NNP-IN-NNPS,NNP,6,1
11426,52554.0,37,said,21,32,23,-9,31,13,-11,2,Metro Atlanta Chamber of Commerce,Hans Gant,ORGANIZATION-ORGANIZATION-ORGANIZATION-ORGANIZATION-ORGANIZATION,PERSON-PERSON,PROPN-PROPN-PROPN-ADP-PROPN,PROPN-PROPN,compound-compound-pobj-prep-pobj,compound-nsubj,NNP-NNP-NNP-IN-NNP,NNP-NNP,5,1
11427,52568.0,15,says,3,3,2,-1,2,12,0,-1,Carson,33-year-old,PERSON,DURATION,PROPN,NUM,nsubj,amod,NNP,CD,1,1
11428,52590.0,55,said,30,37,46,9,36,8,-7,16,AQR Capital,Conn.,ORGANIZATION-ORGANIZATION,STATE_OR_PROVINCE,PROPN-PROPN,PROPN,compound-pobj,appos,NNP-NNP,NNP,5,1
11429,52593.0,59,changed,8,2,37,35,1,21,6,29,she,Major,PERSON,TITLE,PRON,PROPN,nsubj,compound,PRP,NNP,5,1
11430,52604.0,42,reported,40,8,8,0,7,33,32,-32,Austria Press Agency,Austria,ORGANIZATION-ORGANIZATION-ORGANIZATION,COUNTRY,PROPN-PROPN-PROPN,PROPN,compound-compound-nsubj,nsubj,NNP-NNP-NNP,NNP,0,1
11431,52608.0,40,said,38,13,20,7,12,19,25,-18,Kenney Space Center,Florida,ORGANIZATION-ORGANIZATION-ORGANIZATION,STATE_OR_PROVINCE,PROPN-PROPN-PROPN,PROPN,compound-compound-pobj,appos,NNP-NNP-NNP,NNP,4,1
11432,52631.0,39,said,17,3,37,34,2,1,14,20,Ayatollah Ali Khamenei,United States,PERSON-PERSON-PERSON,COUNTRY-COUNTRY,PROPN-PROPN-PROPN,PROPN-PROPN,compound-compound-poss,compound-conj,NNP-NNP-NNP,NNP-NNP,9,1
11433,52636.0,36,announced,32,8,10,2,7,25,24,-22,AFP,Arsenal,ORGANIZATION,ORGANIZATION,PROPN,PROPN,compound,nsubj,NNP,NNP,-1,1
11434,52656.0,26,said,15,24,17,-7,23,8,-9,2,Citibank,Anand Selva,ORGANIZATION,PERSON-PERSON,PROPN,PROPN-PROPN,compound,compound-nsubj,NNP,NNP-NNP,3,1
11435,52661.0,11,does,6,5,8,3,4,2,1,2,Chad White,Dolce & Gabbana,PERSON-PERSON,ORGANIZATION-ORGANIZATION-ORGANIZATION,PROPN-PROPN,PROPN-CCONJ-PROPN,compound-nsubj,dobj-cc-conj,NNP-NNP,NNP-CC-NNP,3,1
11436,52671.0,30,form,11,9,17,8,8,12,2,6,Robbins,New York City Ballet,ORGANIZATION,LOCATION-LOCATION-LOCATION-LOCATION,PROPN,PROPN-PROPN-PROPN-PROPN,compound,compound-compound-compound-poss,NNP,NNP-NNP-NNP-NNP,7,1
11437,52673.0,55,Directed,0,8,3,-5,7,51,-8,3,Justin Theroux,Jon Favreau,PERSON-PERSON,PERSON-PERSON,PROPN-PROPN,PROPN-PROPN,compound-pobj,compound-pobj,NNP-NNP,NNP-NNP,6,1
11438,52675.0,66,lifted,3,37,40,3,36,25,-34,37,Hussein Kamel,director,PERSON-PERSON,TITLE,PROPN-PROPN,NOUN,compound-nsubj,appos,NNP-NNP,NN,2,1
11439,52692.0,27,told,5,4,1,-3,3,25,1,-4,Chris Simcox,As Minuteman,PERSON-PERSON,ORGANIZATION-ORGANIZATION,PROPN-PROPN,ADP-PROPN,compound-nsubj,mark-compound,NNP-NNP,IN-NNP,2,1
11440,52694.0,29,slashed,7,1,6,5,0,22,6,-1,The Czech National Bank,CNB,ORGANIZATION-ORGANIZATION-ORGANIZATION-ORGANIZATION,ORGANIZATION,DET-PROPN-PROPN-PROPN,PROPN,det-compound-compound-compound,compound,DT-NNP-NNP-NNP,NNP,4,1
11441,52696.0,29,boasts,25,18,24,6,17,4,7,-1,Cowell-produced,London,PERSON,CITY,ADJ,PROPN,amod,compound,JJ,NNP,8,1
11442,52728.0,55,are,3,42,47,5,41,7,-39,44,Paul Kim,deputy,PERSON-PERSON,TITLE,PROPN-PROPN,ADJ,compound-conj,compound,NNP-NNP,JJ,2,1
11443,52749.0,19,gained,10,9,1,-8,8,17,1,-9,Denso,Toyota Motor,ORGANIZATION,PERSON-PERSON,PROPN,PROPN-PROPN,pobj,compound-nsubj,NNP,NNP-NNP,2,1
11444,52757.0,12,PLC,6,6,9,3,5,2,0,3,Fyffes PLC,Dole Food Co.,ORGANIZATION-ORGANIZATION,ORGANIZATION-ORGANIZATION-ORGANIZATION,PROPN-PROPN,PROPN-PROPN-PROPN,compound-ROOT,compound-compound-appos,NNP-NNP,NNP-NNP-NNP,2,1
11445,52761.0,45,said,20,26,7,-19,25,37,-6,-13,his,Jerusalem,PERSON,CITY,DET,PROPN,poss,nsubj,PRP$,NNP,7,1
11446,52764.0,29,led,23,11,1,-10,10,27,12,-22,Scorpions,Nel,ORGANIZATION,PERSON,PROPN,PROPN,oprd,nsubj,NNPS,NNP,4,1
11447,54184.0,33,alleged,18,7,1,-6,6,31,11,-17,Scorpions,Nel,ORGANIZATION,PERSON,PROPN,PROPN,pobj,npadvmod,NNPS,NNP,5,1
11448,52772.0,47,died,36,1,34,33,0,12,35,-2,Vernon Bellecourt,AIM,PERSON-PERSON,ORGANIZATION,PROPN-PROPN,PROPN,compound-nsubj,compound,NNP-NNP,NNP,1,1
11449,52792.0,24,UTC,2,4,12,8,3,11,-2,10,He,secretary of state,PERSON,TITLE-TITLE-TITLE,PRON,NOUN-ADP-NOUN,nsubj,attr-prep-pobj,PRP,NN-IN-NN,8,1
11450,52800.0,44,took,15,13,1,-12,12,42,2,-14,CNR,Bintsamou,ORGANIZATION,PERSON,PROPN,PROPN,compound,nsubj,NNP,NNP,2,1
11451,52813.0,49,joined,42,26,30,4,25,18,16,-12,Kendra Wilkinson,his,PERSON-PERSON,PERSON,PROPN-PROPN,DET,compound-appos,poss,NNP-NNP,PRP$,7,1
11452,52828.0,31,teamed,1,4,13,9,3,17,-3,12,Chris Simcox,Ariz.,PERSON-PERSON,STATE_OR_PROVINCE,PROPN-PROPN,PROPN,compound-pobj,appos,NNP-NNP,NNP,3,1
11453,52832.0,35,said,17,3,1,-2,2,33,14,-16,Danny Glover,US,PERSON-PERSON,COUNTRY,PROPN-PROPN,PROPN,compound-nsubj,compound,NNP-NNP,NNP,1,1
11454,52838.0,27,met,5,4,1,-3,3,25,1,-4,M Enkhbold,Mongolian,PERSON-PERSON,ORGANIZATION,PROPN-PROPN,ADJ,compound-nsubj,amod,NNP-NNP,JJ,2,1
11455,52841.0,28,told,7,1,18,17,0,9,6,11,Bryan Baldwin,47-year-old,PERSON-PERSON,DURATION,PROPN-PROPN,NUM,compound-nsubj,dobj,NNP-NNP,CD,6,1
11456,52851.0,54,ruled,11,36,42,6,35,11,-25,31,Multidisciplinary Association for Psychedelic Studies,MAPS,ORGANIZATION-ORGANIZATION-ORGANIZATION-ORGANIZATION-ORGANIZATION,ORGANIZATION,PROPN-PROPN-ADP-PROPN-PROPN,PROPN,compound-pobj-prep-compound-compound,compound,NNP-NNP-IN-NNP-NNPS,NNP,3,1
11457,52853.0,30,is,1,13,20,7,12,9,-12,19,Hector Elizondo,Amalia,PERSON-PERSON,PERSON,PROPN-PROPN,PROPN,compound-compound,compound,NNP-NNP,NNP,4,1
11458,52855.0,32,beats,1,27,25,-2,26,6,-26,24,Li Jie,Chinese skipper,PERSON-PERSON,TITLE-TITLE,PROPN-PROPN,ADJ-NOUN,compound-nsubj,amod-compound,NNP-NNP,JJ-NN,1,1
11459,52869.0,36,dies,12,4,21,17,3,14,8,9,attorney general,Mary Russell Flowers,PERSON-PERSON,PERSON-PERSON-PERSON,NOUN-NOUN,PROPN-PROPN-PROPN,compound-dobj,compound-compound-appos,NN-NN,NNP-NNP-NNP,5,1
11460,52871.0,58,met,28,43,37,-6,42,20,-15,9,Al Hubbard,White House National Economic Council,PERSON-PERSON,ORGANIZATION-ORGANIZATION-ORGANIZATION-ORGANIZATION-ORGANIZATION,PROPN-PROPN,PROPN-PROPN-PROPN-PROPN-PROPN,compound-conj,compound-compound-compound-compound-compound,NNP-NNP,NNP-NNP-NNP-NNP-NNP,5,1
11461,59977.0,50,discussed,30,20,14,-6,19,35,10,-16,Al Hubbard,White House National Economic Council,PERSON-PERSON,ORGANIZATION-ORGANIZATION-ORGANIZATION-ORGANIZATION-ORGANIZATION,PROPN-PROPN,PROPN-PROPN-PROPN-PROPN-PROPN,compound-conj,compound-compound-compound-compound-compound,NNP-NNP,NNP-NNP-NNP-NNP-NNP,2,1
11462,52880.0,8,died,1,1,5,4,0,2,0,4,Gillmor,fall,PERSON,CAUSE_OF_DEATH,PROPN,NOUN,nsubj,pobj,NNP,NN,1,1
11463,52882.0,43,dedroidify,0,16,26,10,15,16,-16,26,Brian McFadden,Lilly Sue,PERSON-PERSON,PERSON-PERSON,PROPN-PROPN,PROPN-PROPN,compound-appos,compound-compound,NNP-NNP,NNP-NNP,5,1
11464,56628.0,41,had,1,14,24,10,13,16,-13,23,Brian McFadden,Lilly Sue,PERSON-PERSON,PERSON-PERSON,PROPN-PROPN,PROPN-PROPN,compound-appos,compound-compound,NNP-NNP,NNP-NNP,5,1
11465,52889.0,29,been,2,16,1,-15,15,27,-14,-1,USA Network,Barkann,ORGANIZATION-ORGANIZATION,PERSON,PROPN-PROPN,PROPN,compound-nsubj,nsubj,NNP-NNP,NNP,5,1
11466,52903.0,65,was,10,53,41,-12,52,23,-43,31,Juliette Binoche,his,PERSON-PERSON,PERSON,PROPN-PROPN,DET,compound-appos,poss,NNP-NNP,PRP$,13,1
11467,52911.0,32,Labels,0,20,19,-1,19,12,-20,19,It,SLDN,ORGANIZATION,ORGANIZATION,PRON,PROPN,nsubjpass,ROOT,PRP,NNP,4,1
11468,52929.0,26,slammed,4,3,2,-1,2,23,1,-2,Berthold Huber,chief,PERSON-PERSON,TITLE,PROPN-PROPN,NOUN,compound-nsubj,compound,NNP-NNP,NN,1,1
11469,52938.0,29,drawn,2,1,23,22,0,5,1,21,Degeneres,WGA,PERSON,ORGANIZATION,NOUN,PROPN,nsubj,pobj,NNS,NNP,4,1
11470,52948.0,50,According,0,39,42,3,38,7,-39,42,Bankers Association,NBA,ORGANIZATION-ORGANIZATION,ORGANIZATION,PROPN-PROPN,PROPN,compound-conj,compound,NNPS-NNP,NNP,7,1
11471,52959.0,32,is,14,25,19,-6,24,12,-11,5,Haifa University,Government and Political Theory Department,ORGANIZATION-ORGANIZATION,ORGANIZATION-ORGANIZATION-ORGANIZATION-ORGANIZATION-ORGANIZATION,PROPN-PROPN,PROPN-CCONJ-PROPN-PROPN-PROPN,compound-poss,nmod-cc-compound-compound-pobj,NNP-NNP,NNP-CC-NNP-NNP-NNP,6,1
11472,52972.0,31,adopted,5,14,1,-13,13,29,-9,-4,Mohamed ElBaradei,The International Atomic Energy Agency,PERSON-PERSON,ORGANIZATION-ORGANIZATION-ORGANIZATION-ORGANIZATION-ORGANIZATION,PROPN-PROPN,DET-PROPN-PROPN-PROPN-PROPN,compound-nsubj,det-compound-compound-compound-nsubj,NNP-NNP,DT-NNP-NNP-NNP-NNP,5,1
11473,52976.0,49,wrote,7,10,4,-6,9,44,-3,-3,her,Judge,PERSON,TITLE,DET,PROPN,poss,compound,PRP$,NNP,4,1
11474,52984.0,28,persuaded,12,9,21,12,8,6,3,9,Art Buchwald,Ann,PERSON-PERSON,PERSON,PROPN-PROPN,PROPN,compound-appos,appos,NNP-NNP,NNP,4,1
11475,52996.0,7,2007-01-14T18,0,3,4,1,2,2,-3,4,From,http://wwwbernamacom/bernama/v3/news_litephp?id=182421,ORGANIZATION,URL,ADP,NUM,ROOT,nmod,IN,CD,2,1
11476,52998.0,29,served,5,3,2,-1,2,26,2,-3,lawyer and Democrat,61-year-old,PERSON-PERSON-PERSON,NUMBER,NOUN-CCONJ-PROPN,NUM,nsubj-cc-conj,amod,NN-CC-NNP,CD,1,1
11477,53002.0,56,said,17,36,19,-17,35,36,-19,2,MBIA Inc.,Eric Dinallo,ORGANIZATION-ORGANIZATION,PERSON-PERSON,PROPN-PROPN,PROPN-PROPN,compound-subtok,compound-nsubj,NNP-NNP,NNP-NNP,4,1
11478,53007.0,71,is,52,50,3,-47,49,67,2,-49,John Negroponte,US State Department,PERSON-PERSON,ORGANIZATION-ORGANIZATION-ORGANIZATION,PROPN-PROPN,PROPN-PROPN-PROPN,compound-pobj,compound-compound-compound,NNP-NNP,NNP-NNP-NNP,14,1
11479,53016.0,43,said,30,33,40,7,32,2,-3,10,Dan Abrams,chief executive officer,PERSON-PERSON,TITLE-TITLE-TITLE,PROPN-PROPN,ADJ-ADJ-NOUN,compound-nsubj,amod-amod-conj,NNP-NNP,JJ-JJ-NN,4,1
11480,53028.0,32,get,13,10,30,20,9,1,3,17,Myers,White House,PERSON,ORGANIZATION-ORGANIZATION,PROPN,PROPN-PROPN,nsubj,compound-pobj,NNP,NNP-NNP,5,1
11481,53029.0,86,YORK,1,17,20,3,16,65,-16,19,Zagat,General Atlantic LLC,ORGANIZATION,PERSON-PERSON-PERSON,PROPN,PROPN-PROPN-PROPN,pobj,compound-compound-pobj,NNP,NNP-NNP-NNP,6,1
11482,53041.0,32,said,4,1,6,5,0,25,3,2,SLDN,his,ORGANIZATION,PERSON,PROPN,DET,compound,poss,NNP,PRP$,4,1
11483,53046.0,42,provided,2,41,39,-2,40,2,-39,37,KGB,Soviet-era,ORGANIZATION,MISC,PROPN,PROPN,pobj,nummod,NNP,NNP,3,1
11484,53050.0,24,appointed,7,4,16,12,3,7,3,9,Cathleen P. Black,U.S.,PERSON-PERSON-PERSON,COUNTRY,PROPN-PROPN-PROPN,PROPN,compound-compound-nsubj,compound,NNP-NNP-NNP,NNP,6,1
11485,53051.0,21,housed,7,1,6,5,0,14,6,-1,The American Red Cross,Greater Indianapolis,ORGANIZATION-ORGANIZATION-ORGANIZATION-ORGANIZATION,CITY-CITY,DET-PROPN-PROPN-PROPN,PROPN-PROPN,det-compound-compound-nsubj,compound-pobj,DT-NNP-NNP-NNP,NNP-NNP,3,1
11486,53053.0,29,served,14,11,23,12,10,5,3,9,Abu Zubaydah,director,PERSON-PERSON,TITLE,PROPN-PROPN,NOUN,compound-nsubj,conj,NNP-NNP,NN,4,1
11487,53054.0,27,survived,2,5,11,6,4,15,-3,9,his,Brenda King,PERSON,PERSON-PERSON,DET,PROPN-PROPN,poss,compound-appos,PRP$,NNP-NNP,3,1
11488,53070.0,6,Association,3,1,6,5,0,-1,2,3,National Military Family Association,http://www.nmfa.org/,ORGANIZATION-ORGANIZATION-ORGANIZATION-ORGANIZATION,URL,PROPN-PROPN-PROPN-PROPN,X,compound-compound-compound-ROOT,ROOT,NNP-NNP-NNP-NNP,ADD,-1,1
11489,53071.0,55,promoted,3,30,29,-1,29,25,-27,26,Bryan McFadden,singer,PERSON-PERSON,TITLE,PROPN-PROPN,NOUN,compound-poss,pobj,NNP-NNP,NN,1,1
11490,53076.0,22,welcomed,6,21,20,-1,20,1,-15,14,Capitalia,Rome-based,ORGANIZATION,CITY,PROPN,PROPN,dobj,compound,NNP,NNP,4,1
11491,53077.0,34,said,27,29,31,2,28,2,-2,4,ABA,William H Neukom,ORGANIZATION,PERSON-PERSON-PERSON,PROPN,PROPN-PROPN-PROPN,compound,compound-compound-nsubj,NNP,NNP-NNP-NNP,3,1
11492,53079.0,21,are,3,15,18,3,14,2,-12,15,Awami League,Sheikh Hasina Wajed,ORGANIZATION-ORGANIZATION,PERSON-PERSON-PERSON,PROPN-PROPN,PROPN-PROPN-PROPN,compound-compound,compound-compound-conj,NNP-NNP,NNP-NNP-NNP,5,1
11493,55387.0,27,met,3,13,6,-7,12,20,-10,3,Awami League,Sheikh Hasina Wajed,ORGANIZATION-ORGANIZATION,PERSON-PERSON-PERSON,PROPN-PROPN,PROPN-PROPN-PROPN,compound-compound,compound-compound-pobj,NNP-NNP,NNP-NNP-NNP,5,1
11494,53083.0,34,was,21,1,15,14,0,18,20,-6,Her,Connecticut,PERSON,STATE_OR_PROVINCE,DET,PROPN,poss,compound,PRP$,NNP,8,1
11495,53088.0,21,required,4,8,18,10,7,2,-4,14,Al,Graham,PERSON,PERSON,PROPN,PROPN,pobj,conj,NNP,NNP,6,1
11496,53105.0,35,moved,24,5,9,4,4,25,19,-15,Herrera,leather artisan,PERSON,TITLE-TITLE,PROPN,NOUN-NOUN,nsubj,compound-pobj,NNP,NN-NN,2,1
11497,53110.0,37,involved,4,20,2,-18,19,34,-16,-2,Metro Atlanta Chamber of Commerce,Chapman,ORGANIZATION-ORGANIZATION-ORGANIZATION-ORGANIZATION-ORGANIZATION,PERSON,PROPN-PROPN-PROPN-ADP-PROPN,PROPN,compound-compound-pobj-prep-pobj,nsubjpass,NNP-NNP-NNP-IN-NNP,NNP,7,1
11498,53120.0,27,paid,7,16,3,-13,15,23,-9,-4,Kurt Waldheim,UN General Assembly,PERSON-PERSON,ORGANIZATION-ORGANIZATION-ORGANIZATION,PROPN-PROPN,PROPN-PROPN-PROPN,compound-pobj,compound-compound-nsubj,NNP-NNP,NNP-NNP-NNP,4,1
11499,53133.0,28,raised,3,1,16,15,0,11,2,13,Carson,Catholic,PERSON,RELIGION,PROPN,ADJ,poss,amod,NNP,JJ,7,1
11500,53144.0,23,gifted,2,1,21,20,0,1,1,19,Haddad-Adel,Ain-al-Shams University,PERSON,ORGANIZATION-ORGANIZATION,PROPN,PROPN-PROPN,nsubj,pobj-pobj,NNP,NNP-NNP,9,1
11501,53154.0,29,was,13,19,9,-10,18,19,-6,-4,her,Montgomery,PERSON,CITY,DET,PROPN,poss,pobj,PRP$,NNP,5,1
11502,53167.0,73,McNair,1,1,47,46,0,25,0,46,Robert McNair,Corinne Godshall,PERSON-PERSON,PERSON-PERSON,PROPN-PROPN,PROPN-PROPN,compound-ROOT,compound-conj,NNP-NNP,NNP-NNP,-1,1
11503,53169.0,21,reserve,7,14,16,2,13,4,-7,9,Yolanda,his,PERSON,PERSON,PROPN,DET,nsubj,poss,NNP,PRP$,2,1
11504,53196.0,49,be,20,6,29,23,5,19,14,9,American Bar Association,Sonia Sotomayor,ORGANIZATION-ORGANIZATION-ORGANIZATION,PERSON-PERSON,PROPN-PROPN-PROPN,PROPN-PROPN,compound-compound-poss,compound-pobj,NNP-NNP-NNP,NNP-NNP,9,1
11505,53208.0,28,was,17,10,27,17,9,0,7,10,she,publicist,PERSON,TITLE,PRON,NOUN,nsubj,attr,PRP,NN,7,1
11506,53210.0,36,said,10,5,1,-4,4,34,5,-9,PVA,John Ring,ORGANIZATION,PERSON-PERSON,PROPN,PROPN-PROPN,poss,compound-nsubj,NNP,NNP-NNP,3,1
11507,53212.0,53,------------------------------,0,7,24,17,6,28,-7,24,Asian Development Bank,http://www.adb.org/Documents/Speeches/2007/ms2007070.asp,ORGANIZATION-ORGANIZATION-ORGANIZATION,URL,PROPN-PROPN-PROPN,PROPN,compound-compound-ROOT,ROOT,NNP-NNP-NNP,NNP,-1,1
11508,53213.0,40,said,13,22,38,16,21,1,-9,25,Focus On the Family,United States,ORGANIZATION-ORGANIZATION-ORGANIZATION-ORGANIZATION,COUNTRY-COUNTRY,PROPN-ADP-DET-PROPN,PROPN-PROPN,pobj-prep-det-nmod,compound-pobj,NNP-IN-DT-NNP,NNP-NNP,6,1
11509,53218.0,21,confirmed,3,19,13,-6,18,7,-16,10,Peterson,Ontario,PERSON,STATE_OR_PROVINCE,PROPN,PROPN,nsubj,conj,NNP,NNP,7,1
11510,53221.0,41,organize,4,6,2,-4,5,38,-2,-2,Lashkar-e-Taiba,Pakistani,ORGANIZATION,COUNTRY,PROPN,ADJ,dobj,compound,NNP,JJ,4,1
11511,53242.0,43,alleged,16,6,16,10,5,26,10,0,Federal Election Commission,Washington,ORGANIZATION-ORGANIZATION-ORGANIZATION,STATE_OR_PROVINCE,PROPN-PROPN-PROPN,PROPN,compound-compound-pobj,pobj,NNP-NNP-NNP,NNP,5,1
11512,53250.0,36,declined,10,3,6,3,2,29,7,-4,Manuel Barcena,Zamboanga City,PERSON-PERSON,LOCATION-LOCATION,PROPN-PROPN,PROPN-PROPN,compound-nsubj,compound-compound,NNP-NNP,NNP-NNP,2,1
11513,53252.0,44,chose,22,18,22,4,17,21,4,0,pilot,Texas,PERSON,STATE_OR_PROVINCE,NOUN,PROPN,nsubj,nsubj,NN,NNP,3,1
11514,53255.0,31,became,10,3,10,7,2,20,7,0,Czech National Bank,he,ORGANIZATION-ORGANIZATION-ORGANIZATION,PERSON,PROPN-PROPN-PROPN,PRON,compound-compound-pobj,nsubj,NNP-NNP-NNP,PRP,2,1
11515,53264.0,17,agreed,2,8,15,7,7,1,-6,13,his,Sheepshead Bay,PERSON,LOCATION-LOCATION,DET,PROPN-PROPN,poss,compound-pobj,PRP$,NNP-NNP,7,1
11516,53272.0,47,starred,2,36,1,-35,35,45,-34,-1,his,Gosselin,PERSON,PERSON,DET,PROPN,poss,pobj,PRP$,NNP,12,1
11517,53284.0,30,be,9,27,6,-21,26,23,-18,-3,her,Coretta Scott King,PERSON,PERSON-PERSON-PERSON,DET,PROPN-PROPN-PROPN,poss,conj-compound-conj,PRP$,NNP-NNP-NNP,8,1
11518,53290.0,26,said,24,14,13,-1,13,12,10,-11,Hugo Chavez,commander,PERSON-PERSON,TITLE,PROPN-PROPN,NOUN,compound-pobj,compound,NNP-NNP,NN,2,1
11519,53298.0,20,became,10,10,12,2,9,7,0,2,Anderson,chairman,PERSON,TITLE,PROPN,NOUN,nsubj,attr,NNP,NN,2,1
11520,53300.0,36,Arsenal,0,3,9,6,2,26,-3,9,Blackburn Rovers,Mark,ORGANIZATION-ORGANIZATION,PERSON,PROPN-PROPN,PROPN,compound-conj,nsubj,NNP-NNP,NNP,2,1
11521,53313.0,44,told,36,29,24,-5,28,19,7,-12,Lewis Hamilton,Monte Carlo,PERSON-PERSON,LOCATION-LOCATION,PROPN-PROPN,PROPN-PROPN,compound-appos,compound-pobj,NNP-NNP,NNP-NNP,10,1
11522,53321.0,25,appointed,1,7,1,-6,6,23,-6,0,Raul Castro,He,PERSON-PERSON,PERSON,PROPN-PROPN,PRON,compound-appos,nsubj,NNP-NNP,PRP,1,1
11523,53341.0,56,died,36,2,1,-1,1,54,34,-35,Jefferson J. DeBlanc Sr.,Col.,PERSON-PERSON-PERSON-PERSON,TITLE,PROPN-PROPN-PROPN-PROPN,PROPN,compound-compound-compound-nsubj,compound,NNP-NNP-NNP-NNP,NNP,2,1
11524,53369.0,36,Turning,0,6,10,4,5,25,-6,10,Dee Dee Myers,Vanity Fair,PERSON-PERSON-PERSON,ORGANIZATION-ORGANIZATION,PROPN-PROPN-PROPN,PROPN-PROPN,compound-compound-npadvmod,compound-compound,NNP-NNP-NNP,NNP-NNP,3,1
11525,53370.0,29,said,5,1,4,3,0,24,4,-1,NSC,Yang Hung-duen,ORGANIZATION,PERSON-PERSON,PROPN,PROPN-PROPN,compound,compound-nsubj,NNP,NNP-NNP,3,1
11526,64950.0,41,said,5,1,4,3,0,36,4,-1,NSC,Yang Hung-duen,ORGANIZATION,PERSON-PERSON,PROPN,PROPN-PROPN,compound,compound-nsubj,NNP,NNP-NNP,3,1
11527,53391.0,31,studied,1,1,4,3,0,26,0,3,He,Rutgers,PERSON,ORGANIZATION,PRON,PROPN,nsubj,pobj,PRP,NNP,2,1
11528,53399.0,11,get,6,4,2,-2,3,8,2,-4,Kurt Waldheim,UN,PERSON-PERSON,ORGANIZATION,PROPN-PROPN,PROPN,compound-nsubj,compound,NNP-NNP,NNP,1,1
11529,53401.0,25,born,4,1,22,21,0,2,3,18,Richard Henry Nolte,Mildred Miller Nolte,PERSON-PERSON-PERSON,PERSON-PERSON-PERSON,PROPN-PROPN-PROPN,PROPN-PROPN-PROPN,compound-compound-nsubjpass,compound-compound-conj,NNP-NNP-NNP,NNP-NNP-NNP,6,1
11530,53408.0,63,said,57,57,41,-16,56,21,0,-16,banks,Kyrgyz Republic,ORGANIZATION,ORGANIZATION-ORGANIZATION,NOUN,PROPN-PROPN,nsubj,compound-conj,NNS,NNP-NNP,14,1
11531,53410.0,27,said,3,1,11,10,0,15,2,8,ConAgra Foods Inc.,Asia,ORGANIZATION-ORGANIZATION-ORGANIZATION,CITY,PROPN-PROPN-PROPN,PROPN,compound-compound-nsubj,pobj,NNP-NNP-NNP,NNP,7,1
11532,53415.0,34,coming,21,1,4,3,0,29,20,-17,Zondervan,Christian,ORGANIZATION,RELIGION,PROPN,ADJ,nsubj,amod,NNP,JJ,3,1
11533,53422.0,52,was,16,31,27,-4,30,24,-15,11,Jamaat al Muslimeen,Bakr,ORGANIZATION-ORGANIZATION-ORGANIZATION,PERSON,PROPN-PROPN-PROPN,PROPN,compound-compound-pobj,nsubjpass,NNP-NNP-NNP,NNP,5,1
11534,53427.0,25,said,10,22,12,-10,21,12,-12,2,American Bankers Association,Doug Johnson,ORGANIZATION-ORGANIZATION-ORGANIZATION,PERSON-PERSON,PROPN-PROPN-PROPN,PROPN-PROPN,compound-compound-pobj,compound-nsubj,NNP-NNPS-NNP,NNP-NNP,7,1
11535,53434.0,31,said,29,12,28,16,11,2,17,-1,her,Jonathan Goodman,PERSON,PERSON-PERSON,DET,PROPN-PROPN,poss,compound-appos,PRP$,NNP-NNP,11,1
11536,53454.0,30,said,28,18,18,0,17,11,10,-10,Hong Kong Disneyland,Hong Kong,ORGANIZATION-ORGANIZATION-ORGANIZATION,CITY-CITY,PROPN-PROPN-PROPN,PROPN-PROPN,compound-compound-compound,compound-conj,NNP-NNP-NNP,NNP-NNP,0,1
11537,53463.0,33,tried,3,7,16,9,6,16,-4,13,him,Egyptian,PERSON,NATIONALITY,PRON,ADJ,dobj,amod,PRP,JJ,7,1
11538,53483.0,21,says,6,18,19,1,17,1,-12,13,her,NBC,PERSON,ORGANIZATION,DET,PROPN,poss,compound,PRP$,NNP,2,1
11539,53485.0,32,are,1,23,21,-2,22,10,-22,20,Seyed Mohammad Khatami,guidance minister,PERSON-PERSON-PERSON,ORGANIZATION-ORGANIZATION,PROPN-PROPN-PROPN,NOUN-NOUN,compound-compound-conj,compound-compound,NNP-NNP-NNP,NN-NN,2,1
11540,53490.0,43,is,20,39,32,-7,38,10,-19,12,Barry Goldwater,Mr Conservative,PERSON-PERSON,PERSON-PERSON,PROPN-PROPN,PROPN-PROPN,compound-npadvmod,compound-pobj,NNP-NNP,NNP-NNP,9,1
11541,53501.0,14,is,4,1,3,2,0,10,3,-1,Chen,54,PERSON,NUMBER,PROPN,NUM,nsubj,appos,NNP,CD,3,1
11542,53531.0,16,is,5,13,1,-12,12,14,-8,-4,First Automobile Works,Sichuan FAW Toyota Manufacturing Co,ORGANIZATION-ORGANIZATION-ORGANIZATION,ORGANIZATION-ORGANIZATION-ORGANIZATION-ORGANIZATION-ORGANIZATION,PROPN-PROPN-PROPN,PROPN-PROPN-PROPN-PROPN-PROPN,compound-compound-conj,compound-compound-compound-compound-nsubj,NNP-NNP-NNP,NNP-NNP-NNP-NNP-NNP,7,1
11543,53551.0,40,said,19,28,34,6,27,5,-9,15,National Center for Disaster Preparedness,Columbia University Mailman School of Medicine,ORGANIZATION-ORGANIZATION-ORGANIZATION-ORGANIZATION-ORGANIZATION,ORGANIZATION-ORGANIZATION-ORGANIZATION-ORGANIZATION-ORGANIZATION-ORGANIZATION,PROPN-PROPN-ADP-PROPN-PROPN,PROPN-PROPN-PROPN-PROPN-ADP-PROPN,compound-pobj-prep-compound-pobj,compound-compound-compound-pobj-prep-pobj,NNP-NNP-IN-NNP-NNP,NNP-NNP-NNP-NNP-IN-NNP,5,1
11544,53553.0,9,finished,2,7,5,-2,6,3,-5,3,George Young,17-year-old,PERSON-PERSON,DURATION,PROPN-PROPN,NUM,compound-appos,amod,NNP-NNP,CD,3,1
11545,53555.0,32,rose,8,18,5,-13,17,26,-10,-3,Tokyo Stock Exchange,Dai-ichi Life Insurance Co.,ORGANIZATION-ORGANIZATION-ORGANIZATION,ORGANIZATION-ORGANIZATION-ORGANIZATION-ORGANIZATION,PROPN-PROPN-PROPN,PROPN-PROPN-PROPN-PROPN,compound-compound-pobj,compound-compound-compound-pobj,NNP-NNP-NNP,NNP-NNP-NNP-NNP,9,1
11546,53562.0,6,is,3,2,5,3,1,0,1,2,Hector Elizondo,73,PERSON-PERSON,NUMBER,PROPN-PROPN,NUM,compound-nsubj,attr,NNP-NNP,CD,2,1
11547,53566.0,44,told,20,2,1,-1,1,42,18,-19,John Kerry,Sen,PERSON-PERSON,ORGANIZATION,PROPN-PROPN,PROPN,compound-nsubj,compound,NNP-NNP,NNP,1,1
11548,53583.0,34,defends,24,23,20,-3,22,13,1,-4,Richard Perle,Assistant Defense Secretary,PERSON-PERSON,TITLE-TITLE-TITLE,PROPN-PROPN,PROPN-PROPN-PROPN,compound-nsubj,compound-compound-compound,NNP-NNP,NNP-NNP-NNP,4,1
11549,53586.0,66,plans,16,2,8,6,1,57,14,-8,Carolyn Maloney,House Subcommittee on Financial Institutions and Consumer Credit,PERSON-PERSON,ORGANIZATION-ORGANIZATION-ORGANIZATION-ORGANIZATION-ORGANIZATION-ORGANIZATION-ORGANIZATION-ORGANIZATION,PROPN-PROPN,PROPN-PROPN-ADP-PROPN-PROPN-CCONJ-PROPN-PROPN,compound-nsubj,compound-dobj-prep-compound-pobj-cc-compound-conj,NNP-NNP,NNP-NNP-IN-NNP-NNPS-CC-NNP-NNP,2,1
11550,53590.0,15,said,1,3,1,-2,2,13,-2,0,DeGeneres,Fink,PERSON,PERSON,PROPN,PROPN,poss,nsubj,NNP,NNP,3,1
11551,53592.0,69,said,34,47,36,-11,46,32,-13,2,University of Haifa,Dan Peled,ORGANIZATION-ORGANIZATION-ORGANIZATION,PERSON-PERSON,PROPN-ADP-PROPN,PROPN-PROPN,pobj-prep-pobj,compound-nsubj,NNP-IN-NNP,NNP-NNP,6,1
11552,53593.0,40,said,16,1,8,7,0,31,15,-8,Mahdi,leader,PERSON,TITLE,PROPN,NOUN,nsubj,attr,NNP,NN,4,1
11553,53598.0,35,stands,1,25,22,-3,24,12,-24,21,Elizondo,Pancho Duque,PERSON,PERSON-PERSON,PROPN,PROPN-PROPN,compound,compound-pobj,NNP,NNP-NNP,1,1
11554,53599.0,23,urged,2,2,21,19,1,1,0,19,OIC,Azerbaijan,ORGANIZATION,COUNTRY,PROPN,PROPN,nsubj,pobj,NNP,NNP,5,1
11555,53620.0,22,said,11,19,13,-6,18,8,-8,2,Awami League,Nuh Ul Alam,ORGANIZATION-ORGANIZATION,PERSON-PERSON-PERSON,PROPN-PROPN,PROPN-PROPN-PROPN,compound-compound,compound-compound-nsubj,NNP-NNP,NNP-NNP-NNP,4,1
11556,53624.0,34,says,2,4,7,3,3,26,-2,5,Zubaydah,director,PERSON,TITLE,PROPN,NOUN,nsubj,attr,NNP,NN,2,1
11557,53631.0,19,is,11,17,14,-3,16,4,-6,3,Paavo Nurmi,Flying Finn,PERSON-PERSON,PERSON-PERSON,PROPN-PROPN,VERB-PROPN,compound-dobj,xcomp-dobj,NNP-NNP,VBG-NNP,3,1
11558,57580.0,31,took,5,18,28,10,17,2,-13,23,Paavo Nurmi,Flying Finn,PERSON-PERSON,PERSON-PERSON,PROPN-PROPN,PROPN-PROPN,compound-appos,compound-pobj,NNP-NNP,NNP-NNP,5,1
11559,53645.0,28,see,14,6,11,5,5,16,8,-3,Barnes Foundation,Pa,ORGANIZATION-ORGANIZATION,STATE_OR_PROVINCE,PROPN-PROPN,PROPN,compound-pobj,npadvmod,NNP-NNP,NNP,4,1
11560,53691.0,45,met,2,40,43,3,39,1,-38,41,ADB,Liqun Jin,ORGANIZATION,PERSON-PERSON,PROPN,PROPN-PROPN,compound,compound-pobj,NNP,NNP-NNP,2,1
11561,53695.0,38,said,35,1,8,7,0,29,34,-27,Carnival Cruise Lines,Robert Dickinson,ORGANIZATION-ORGANIZATION-ORGANIZATION,PERSON-PERSON,PROPN-PROPN-VERB,PROPN-PROPN,compound-compound-compound,compound-appos,NNP-NNP-VBZ,NNP-NNP,3,1
11562,53700.0,48,widened,8,46,36,-10,45,11,-38,28,CMA,Ireland,ORGANIZATION,COUNTRY,PROPN,PROPN,compound,nsubj,NNP,NNP,4,1
11563,53722.0,11,Kelli,1,5,9,4,4,1,-4,8,She,Italian,PERSON,NATIONALITY,PRON,ADJ,nsubj,amod,PRP,JJ,3,1
11564,53725.0,46,is,7,2,26,24,1,19,5,19,Buse,Director,PERSON,TITLE,PROPN,PROPN,nsubj,pobj,NNP,NNP,6,1
11565,53734.0,36,gave,6,6,26,20,5,9,0,20,Hussein Kamel,arms chief,PERSON-PERSON,TITLE-TITLE,PROPN-PROPN,NOUN-NOUN,compound-conj,compound-compound,NNP-NNP,NNS-NN,5,1
11566,53749.0,60,survived,2,13,31,18,12,28,-11,29,McNair,Robin Lee Howell,PERSON,PERSON-PERSON-PERSON,PROPN,PROPN-PROPN-PROPN,appos,compound-compound-conj,NNP,NNP-NNP-NNP,5,1
11567,53759.0,42,criticizes,2,8,23,15,7,18,-6,21,Alberto Gonzales,deputy,PERSON-PERSON,TITLE,PROPN-PROPN,NOUN,compound-appos,conj,NNP-NNP,NN,6,1
11568,53769.0,60,survived,2,11,5,-6,10,54,-9,3,Josephine Robinson McNair,his,PERSON-PERSON-PERSON,PERSON,PROPN-PROPN-PROPN,DET,compound-compound-appos,poss,NNP-NNP-NNP,PRP$,5,1
11569,53772.0,46,had,2,2,21,19,1,24,0,19,Sills,Peter Jr.,PERSON,PERSON-PERSON,PROPN,PROPN-PROPN,nsubj,compound-appos,NNP,NNP-NNP,4,1
11570,53780.0,39,centers,2,32,24,-8,31,14,-30,22,Abu Zubaydah,Zayn al-Abidin Muhammed Hussein,PERSON-PERSON,PERSON-PERSON-PERSON-PERSON,PROPN-PROPN,PROPN-PROPN-PROPN-PROPN,compound-pobj,compound-ROOT-compound-ROOT,NNP-NNP,NNP-NNP-NNP-NNP,-1,1
11571,53793.0,28,was,5,4,1,-3,3,26,1,-4,Susan Boyle,British,PERSON-PERSON,NATIONALITY,PROPN-PROPN,ADJ,compound-nsubj,amod,NNP-NNP,JJ,2,1
11572,61160.0,75,This,0,27,66,39,26,8,-27,66,Susan Boyle,British,PERSON-PERSON,NATIONALITY,PROPN-PROPN,ADJ,compound-poss,amod,NNP-NNP,JJ,11,1
11573,53808.0,25,named,8,2,12,10,1,12,6,4,her,Scholar,PERSON,TITLE,DET,PROPN,poss,oprd,PRP$,NNP,4,1
11574,53814.0,63,said,57,57,53,-4,56,9,0,-4,banks,Uzbekistan,ORGANIZATION,ORGANIZATION,NOUN,PROPN,nsubj,conj,NNS,NNP,1,1
11575,53829.0,34,said,12,7,8,1,6,25,5,-4,Metro Atlanta Chamber of Commerce,Atlanta,ORGANIZATION-ORGANIZATION-ORGANIZATION-ORGANIZATION-ORGANIZATION,CITY,PROPN-PROPN-PROPN-ADP-PROPN,PROPN,compound-compound-pobj-prep-pobj,pobj,NNP-NNP-NNP-IN-NNP,NNP,1,1
11576,65257.0,25,said,12,20,5,-15,19,19,-8,-7,Metro Atlanta Chamber of Commerce,Atlanta,ORGANIZATION-ORGANIZATION-ORGANIZATION-ORGANIZATION-ORGANIZATION,CITY,PROPN-PROPN-PROPN-ADP-PROPN,PROPN,compound-compound-pobj-prep-pobj,pobj,NNP-NNP-NNP-IN-NNP,NNP,8,1
11577,53842.0,54,said,12,1,23,22,0,30,11,11,Chris Bentley,American,PERSON-PERSON,NATIONALITY,PROPN-PROPN,ADJ,compound-nsubj,amod,NNP-NNP,JJ,5,1
11578,53849.0,38,cracked,1,22,26,4,21,11,-21,25,USA Network,Nashville Star,ORGANIZATION-ORGANIZATION,ORGANIZATION-ORGANIZATION,PROPN-PROPN,PROPN-PROPN,compound-poss,nmod-nmod,NNP-NNP,NNP-NNP,3,1
11579,53850.0,27,DIES,4,8,21,13,7,5,-4,17,He,CEO,PERSON,TITLE,PRON,NOUN,nsubj,pobj,PRP,NN,5,1
11580,53855.0,25,born,4,22,9,-13,21,15,-18,5,Mildred Miller Nolte,Minn.,PERSON-PERSON-PERSON,STATE_OR_PROVINCE,PROPN-PROPN-PROPN,PROPN,compound-compound-conj,appos,NNP-NNP-NNP,NNP,7,1
11581,53863.0,35,said,1,12,24,12,11,10,-11,23,Justice and Equality Movement,West Darfur,ORGANIZATION-ORGANIZATION-ORGANIZATION-ORGANIZATION,LOCATION-LOCATION,PROPN-CCONJ-PROPN-PROPN,PROPN-PROPN,nmod-cc-conj-conj,compound-pobj,NNP-CC-NNP-NNP,NNP-NNP,10,1
11582,53866.0,34,said,27,10,32,22,9,1,17,5,IMF,Simon Denham,ORGANIZATION,PERSON-PERSON,PROPN,PROPN-PROPN,conj,compound-nsubj,NNP,NNP-NNP,7,1
11583,53889.0,78,Comments,2,1,37,36,0,40,1,35,Barbara Boxer,US Senate Committee on Environment and Public Works,PERSON-PERSON,ORGANIZATION-ORGANIZATION-ORGANIZATION-ORGANIZATION-ORGANIZATION-ORGANIZATION-ORGANIZATION-ORGANIZATION,PROPN-PROPN,PROPN-PROPN-PROPN-ADP-PROPN-CCONJ-PROPN-PROPN,compound-compound,compound-compound-pobj-prep-pobj-cc-compound-conj,NNP-NNP,NNP-NNP-NNP-IN-NNP-CC-NNP-NNP,-1,1
11584,53926.0,30,AL-TAI,3,2,6,4,1,23,1,3,HASHIM AHMAD AL-TAI,Defense minister,PERSON-PERSON-PERSON,TITLE-TITLE,NOUN-PROPN-PROPN,NOUN-NOUN,compound-compound-ROOT,compound-nsubj,NN-NNP-NNP,NN-NN,2,1
11585,53927.0,46,was,1,1,44,43,0,1,0,43,Bolin,legal department,PERSON,ORGANIZATION-ORGANIZATION,PROPN,ADJ-NOUN,nsubj,amod-appos,NNP,JJ-NN,7,1
11586,53937.0,17,was,7,5,9,4,4,7,2,2,Dennis Dunn,Republican Party,PERSON-PERSON,ORGANIZATION-ORGANIZATION,PROPN-PROPN,PROPN-PROPN,compound-appos,compound-compound,NNP-NNP,NNP-NNP,4,1
11587,53943.0,25,born,3,1,13,12,0,11,2,10,Raul Castro,Oriente Province,PERSON-PERSON,STATE_OR_PROVINCE-STATE_OR_PROVINCE,PROPN-PROPN,PROPN-PROPN,compound-nsubjpass,compound-pobj,NNP-NNP,NNP-NNP,3,1
11588,53945.0,33,died,12,10,1,-9,9,31,2,-11,Robert McNair,Josephine Robinson McNair,PERSON-PERSON,PERSON-PERSON-PERSON,PROPN-PROPN,PROPN-PROPN-PROPN,compound-pobj,compound-compound-nsubj,NNP-NNP,NNP-NNP-NNP,4,1
11589,53959.0,35,made,5,1,4,3,0,30,4,-1,ADB,Lawrence Greenwood,ORGANIZATION,PERSON-PERSON,PROPN,PROPN-PROPN,compound,compound-nsubj,NNP,NNP-NNP,2,1
11590,53979.0,43,ISLAMABAD,0,20,22,2,19,20,-20,22,Lashkar-e-Taiba,LET,ORGANIZATION,ORGANIZATION,PROPN,PROPN,pobj,compound,NNP,NNP,3,1
11591,63537.0,37,linked,11,1,4,3,0,32,10,-7,Lashkar-e-Taiba,LET,ORGANIZATION,ORGANIZATION,ADV,PROPN,nsubjpass,conj,RB,NNP,2,1
11592,53981.0,47,said,41,1,7,6,0,39,40,-34,Hawkins,South Los Angeles,PERSON,LOCATION-LOCATION-LOCATION,PROPN,PROPN-PROPN-PROPN,nsubj,compound-compound-dobj,NNP,NNP-NNP-NNP,5,1
11593,53994.0,35,moved,24,21,12,-9,20,22,3,-12,his,Phoenix,PERSON,CITY,DET,PROPN,poss,pobj,PRP$,NNP,4,1
11594,54021.0,15,pleaded,4,4,14,10,3,0,0,10,he,driver,PERSON,TITLE,PRON,NOUN,nsubj,attr,PRP,NN,1,1
11595,54025.0,22,honored,4,10,1,-9,9,20,-6,-3,Grady High School,Yolanda King,PERSON-PERSON-PERSON,ORGANIZATION-ORGANIZATION,PROPN-PROPN-PROPN,PROPN-PROPN,compound-compound-pobj,compound-nsubjpass,NNP-NNP-NNP,NNP-NNP,6,1
11596,54033.0,41,said,35,33,27,-6,32,13,2,-8,MAC,Liu,ORGANIZATION,PERSON,PROPN,PROPN,compound,appos,NNP,NNP,4,1
11597,54034.0,36,caught,1,30,6,-24,29,29,-29,5,her,singer/songwriter,PERSON,TITLE,DET,NOUN,poss,pobj,PRP$,NN,6,1
11598,54035.0,46,said,1,18,23,5,17,22,-17,22,JEM,Suleiman Sandal,ORGANIZATION,PERSON-PERSON,PROPN,PROPN-PROPN,compound,compound-appos,NNP,NNP-NNP,3,1
11599,54038.0,57,said,40,54,42,-12,53,14,-14,2,American Bar Association,H Thomas Wells,ORGANIZATION-ORGANIZATION-ORGANIZATION,PERSON-PERSON-PERSON,PROPN-PROPN-PROPN,PROPN-PROPN-PROPN,compound-compound-pobj,compound-compound-nsubj,NNP-NNP-NNP,NNP-NNP-NNP,7,1
11600,54055.0,38,ran,1,20,8,-12,19,29,-19,7,her,governor,PERSON,TITLE,DET,NOUN,poss,pobj,PRP$,NN,4,1
11601,54057.0,9,action,3,1,9,8,0,-1,2,6,``,Capt,PERSON,TITLE,PUNCT,PROPN,punct,pobj,``,NNP,5,1
11602,54058.0,18,is,7,1,6,5,0,11,6,-1,Gonzales,aide,PERSON,TITLE,PROPN,NOUN,nsubj,appos,NNP,NN,3,1
11603,54063.0,49,seen,3,2,12,10,1,36,1,9,she,Mississippi,PERSON,STATE_OR_PROVINCE,PRON,PROPN,nsubjpass,nsubj,PRP,NNP,2,1
11604,54104.0,43,said,26,35,37,2,34,5,-9,11,ADB,"Energy , Transport and Water Division",ORGANIZATION,ORGANIZATION-ORGANIZATION-ORGANIZATION-ORGANIZATION-ORGANIZATION-ORGANIZATION,PROPN,PROPN-PUNCT-PROPN-CCONJ-PROPN-PROPN,poss,pobj-punct-conj-cc-compound-conj,NNP,"NNP-,-NNP-CC-NNP-NNP",2,1
11605,54110.0,24,hands,2,17,1,-16,16,22,-15,-1,Crown Prosecution Service,British,ORGANIZATION-ORGANIZATION-ORGANIZATION,COUNTRY,PROPN-PROPN-PROPN,ADJ,compound-compound-pobj,amod,NNP-NNP-NNP,JJ,8,1
11606,54116.0,32,took,6,12,5,-7,11,26,-6,-1,Kennedy Space Center,Stephen Hawking,ORGANIZATION-ORGANIZATION-ORGANIZATION,PERSON-PERSON,PROPN-PROPN-PROPN,PROPN-PROPN,compound-compound-pobj,compound-dobj,NNP-NNP-NNP,NNP-NNP,4,1
11607,54122.0,9,Feb.,0,5,4,-1,4,4,-5,4,George Kennedy,Actor,PERSON-PERSON,TITLE,PROPN-PROPN,PROPN,compound-nsubj,compound,NNP-NNP,NNP,1,1
11608,54134.0,41,said,39,21,33,12,20,7,18,-6,OIC,Middle East,ORGANIZATION,LOCATION-LOCATION,PROPN,PROPN-PROPN,compound,compound-compound,NNP,NNP-NNP,5,1
11609,54135.0,20,projecting,12,2,10,8,1,9,10,-2,National Christmas Tree Association,New England,ORGANIZATION-ORGANIZATION-ORGANIZATION-ORGANIZATION,LOCATION-LOCATION,PROPN-PROPN-PROPN-PROPN,PROPN-PROPN,compound-compound-compound-nsubj,compound-pobj,NNP-NNP-NNP-NNP,NNP-NNP,5,1
11610,54143.0,28,said,3,23,1,-22,22,26,-20,-2,Residential Capital LLC,GMAC Financial Services,ORGANIZATION-ORGANIZATION-ORGANIZATION,ORGANIZATION-ORGANIZATION-ORGANIZATION,PROPN-PROPN-PROPN,PROPN-PROPN-PROPN,compound-compound-compound,compound-compound-nsubj,NNP-NNP-NNP,NNP-NNP-NNPS,9,1
11611,54151.0,36,co-authored,26,17,20,3,16,15,9,-6,Richard Perle,author,PERSON-PERSON,TITLE,PROPN-PROPN,NOUN,compound-pobj,appos,NNP-NNP,NN,2,1
11612,54175.0,19,was,10,4,1,-3,3,17,6,-9,Citibank,Anton Gunawan,ORGANIZATION,PERSON-PERSON,PROPN,PROPN-PROPN,poss,compound-nsubj,NNP,NNP-NNP,3,1
11613,54179.0,60,says,31,17,4,-13,16,55,14,-27,his,commercial flight instructor,PERSON,TITLE-TITLE-TITLE,DET,ADJ-NOUN-NOUN,poss,amod-compound-nsubj,PRP$,JJ-NN-NN,5,1
11614,54191.0,36,had,26,6,24,18,5,11,20,-2,Cathleen P Black,chancellor,PERSON-PERSON-PERSON,TITLE,PROPN-PROPN-PROPN,NOUN,compound-compound-nsubj,attr,NNP-NNP-NNP,NN,4,1
11615,54212.0,34,said,22,24,32,8,23,1,-2,10,Chris Bentley,Immigration Services,PERSON-PERSON,ORGANIZATION-ORGANIZATION,PROPN-PROPN,PROPN-PROPN,compound-nsubj,conj-pobj,NNP-NNP,NNP-NNPS,6,1
11616,54229.0,38,soldiers,2,26,31,5,25,6,-24,29,Moro National Liberation Front,MILF,ORGANIZATION-ORGANIZATION-ORGANIZATION-ORGANIZATION,ORGANIZATION,PROPN-PROPN-PROPN-PROPN,PROPN,compound-compound-compound-conj,compound,NNP-NNP-NNP-NNP,NNP,6,1
11617,54232.0,41,travels,7,7,26,19,6,14,0,19,he,Hollywood High,PERSON,ORGANIZATION-ORGANIZATION,PRON,PROPN-PROPN,nsubj,compound-appos,PRP,NNP-NNP,5,1
11618,54240.0,25,said,8,17,10,-7,16,14,-9,2,National Center for Disaster Preparedness,Dr Irwin Redlener,ORGANIZATION-ORGANIZATION-ORGANIZATION-ORGANIZATION-ORGANIZATION,PERSON-PERSON-PERSON,PROPN-PROPN-ADP-PROPN-PROPN,PROPN-PROPN-PROPN,compound-pobj-prep-compound-pobj,compound-compound-nsubj,NNP-NNP-IN-NNP-NNP,NNP-NNP-NNP,5,1
11619,59331.0,53,said,23,34,25,-9,33,27,-11,2,National Center for Disaster Preparedness,Dr Irwin Redlener,ORGANIZATION-ORGANIZATION-ORGANIZATION-ORGANIZATION-ORGANIZATION,PERSON-PERSON-PERSON,PROPN-PROPN-ADP-PROPN-PROPN,PROPN-PROPN-PROPN,compound-pobj-prep-compound-pobj,compound-compound-nsubj,NNP-NNP-IN-NNP-NNP,NNP-NNP-NNP,4,1
11620,54241.0,38,stormed,2,36,32,-4,35,5,-34,30,Mamoor Khan,local paramilitary forces commander,PERSON-PERSON,TITLE-TITLE-TITLE-TITLE,PROPN-PROPN,ADJ-ADJ-NOUN-NOUN,compound-nsubj,amod-amod-nsubj-compound,NNP-NNP,JJ-JJ-NNS-NN,3,1
11621,54243.0,17,Association,2,1,5,4,0,11,1,3,American Psychiatric Association,http://wwwpsychorg/,ORGANIZATION-ORGANIZATION-ORGANIZATION,URL,PROPN-PROPN-PROPN,PROPN,compound-compound-ROOT,appos,NNP-NNP-NNP,NNP,3,1
11622,54251.0,27,was,12,12,26,14,11,0,0,14,she,activist,PERSON,TITLE,PRON,NOUN,nsubj,pobj,PRP,NN,1,1
11623,54262.0,29,told,26,25,23,-2,24,5,1,-3,Camalata Numa,UNITA,ORGANIZATION-ORGANIZATION,PERSON,PROPN-PROPN,PROPN,compound-nsubj,nmod,NNP-NNP,NNP,3,1
11624,54297.0,40,said,29,20,11,-9,19,28,9,-18,Anwar,allegations,PERSON,CRIMINAL_CHARGE,PROPN,NOUN,dobj,dobj,NNP,NNS,3,1
11625,54311.0,42,was,1,1,32,31,0,9,0,31,Verity,Chairman,PERSON,TITLE,PROPN,PROPN,nsubj,conj,NNP,NNP,13,1
11626,54317.0,47,said,45,43,35,-8,42,11,2,-10,Dee Dee Myers,North Korea,PERSON-PERSON-PERSON,COUNTRY-COUNTRY,PROPN-PROPN-PROPN,PROPN-PROPN,compound-compound-appos,compound-pobj,NNP-NNP-NNP,NNP-NNP,13,1
11627,54322.0,22,insisted,4,3,1,-2,2,20,1,-3,Ciro Ferrara,Juventus,PERSON-PERSON,ORGANIZATION,PROPN-PROPN,PROPN,compound-nsubj,compound,NNP-NNP,NNP,1,1
11628,54518.0,15,hired,3,7,12,5,6,2,-4,9,Ciro Ferrara,Juventus,PERSON-PERSON,ORGANIZATION,PROPN-PROPN,PROPN,compound-dobj,pobj,NNP-NNP,NNP,2,1
11629,64932.0,24,vowed,5,3,1,-2,2,22,2,-4,Ciro Ferrara,Juventus,PERSON-PERSON,ORGANIZATION,PROPN-PROPN,PROPN,compound-nsubj,compound,NNP-NNP,NNP,1,1
11630,54325.0,36,said,22,29,20,-9,28,15,-7,-2,Philadelphia Inquirer,Ohio,ORGANIZATION-ORGANIZATION,STATE_OR_PROVINCE,PROPN-PROPN,PROPN,compound-poss,compound,NNP-NNP,NNP,9,1
11631,54341.0,83,included,7,58,5,-53,57,77,-51,-2,Philadelphia Inquirer,NLGJA,ORGANIZATION-ORGANIZATION,ORGANIZATION,PROPN-PROPN,PROPN,compound-conj,compound,NNP-NNP,NNP,6,1
11632,54353.0,24,shares,3,16,20,4,15,3,-13,17,Badr Organization,Fadhila,ORGANIZATION-ORGANIZATION,MISC,PROPN-PROPN,PROPN,compound-oprd,compound,NNP-NNP,NNP,1,1
11633,54393.0,29,said,27,9,27,18,8,1,18,0,Tokyo Stock Exchange,he,ORGANIZATION-ORGANIZATION-ORGANIZATION,PERSON,PROPN-PROPN-PROPN,PRON,compound-compound-nsubj,nsubj,NNP-NNP-NNP,PRP,4,1
11634,54395.0,24,returning,9,12,5,-7,11,18,-3,-4,his,creator,PERSON,TITLE,DET,NOUN,poss,compound,PRP$,NN,5,1
11635,54397.0,34,was,10,4,10,6,3,23,6,0,he,Herrera,PERSON,PERSON,PRON,PROPN,nsubj,nsubj,PRP,NNP,1,1
11636,54413.0,25,met,3,1,15,14,0,9,2,12,Arsenal,Alisher Usmanov,ORGANIZATION,PERSON-PERSON,PROPN,PROPN-PROPN,poss,compound-nsubj,NNP,NNP-NNP,7,1
11637,54451.0,28,said,4,3,1,-2,2,26,1,-3,Paul Gillmor,Republican Representative,PERSON-PERSON,TITLE-TITLE,PROPN-PROPN,ADJ-NOUN,compound-nsubj,compound-compound,NNP-NNP,JJ-NN,1,1
11638,54461.0,30,Share,0,11,17,6,10,12,-11,17,Ellen Degeneres,Portia de Rossi,PERSON-PERSON,PERSON-PERSON-PERSON,PROPN-PROPN,PROPN-PROPN-PROPN,compound-conj,compound-nmod-conj,NNP-NNP,NNP-NNP-NNP,4,1
11639,54467.0,26,signs,1,4,4,0,3,21,-3,3,Red Sox,Red Sox,ORGANIZATION-ORGANIZATION,ORGANIZATION-ORGANIZATION,PROPN-PROPN,PROPN-PROPN,compound-pobj,compound-nsubj,NNP-NNPS,NNP-NNPS,0,1
11640,54477.0,28,-RSB-,2,5,8,3,4,19,-3,6,Susan Snyder,Staff Writer,ORGANIZATION-ORGANIZATION,ORGANIZATION-ORGANIZATION,PROPN-PROPN,PROPN-PROPN,compound-compound,compound-nsubj,NNP-NNP,NNP-NNP,1,1
11641,54478.0,34,said,2,11,7,-4,10,26,-9,5,NEC,National Executive Council,ORGANIZATION,ORGANIZATION-ORGANIZATION-ORGANIZATION,PROPN,PROPN-PROPN-PROPN,compound,compound-compound-pobj,NNP,NNP-NNP-NNP,2,1
11642,54479.0,32,taped,21,1,5,4,0,26,20,-16,Ellen DeGeneres,New Orleans,PERSON-PERSON,CITY-CITY,PROPN-PROPN,PROPN-PROPN,compound-nsubj,compound-compound,NNP-NNP,NNP-NNP,2,1
11643,54490.0,39,said,17,26,24,-2,25,14,-9,7,Mohammed ElBaradei,IAEA,PERSON-PERSON,ORGANIZATION,PROPN-PROPN,PROPN,compound-pobj,compound,NNP-NNP,NNP,3,1
11644,54494.0,51,BATOR,1,19,27,8,18,23,-18,26,M Enkhbold,prime minister,PERSON-PERSON,TITLE-TITLE,PROPN-PROPN,ADJ-NOUN,compound-nsubj,amod-conj,NNP-NNP,JJ-NN,3,1
11645,54511.0,50,locked,12,29,32,3,28,17,-17,20,Lewis Hamilton,22,PERSON-PERSON,NUMBER,PROPN-PROPN,NUM,compound-appos,appos,NNP-NNP,CD,3,1
11646,54521.0,37,announced,3,29,22,-7,28,14,-26,19,Carnival,Cunard Line,ORGANIZATION,ORGANIZATION-ORGANIZATION,PROPN,PROPN-PROPN,pobj,compound-pobj,NNP,NNP-NNP,4,1
11647,54523.0,20,remembered,2,1,5,4,0,14,1,3,Beverly Sills,Lincoln Center,PERSON-PERSON,ORGANIZATION-ORGANIZATION,PROPN-PROPN,PROPN-PROPN,compound-nsubj,compound-compound,NNP-NNP,NNP-NNP,4,1
11648,62764.0,42,went,1,19,25,6,18,16,-18,24,Beverly Sills,Lincoln Center,PERSON-PERSON,ORGANIZATION-ORGANIZATION,PROPN-PROPN,PROPN-PROPN,compound-appos,compound-pobj,NNP-NNP,NNP-NNP,3,1
11649,54524.0,25,born,4,1,7,6,0,17,3,3,Richard Henry Nolte,Duluth,PERSON-PERSON-PERSON,CITY,PROPN-PROPN-PROPN,PROPN,compound-compound-nsubjpass,pobj,NNP-NNP-NNP,NNP,5,1
11650,54534.0,38,is,3,24,20,-4,23,17,-21,17,she,student,PERSON,TITLE,PRON,NOUN,nsubj,pobj,PRP,NN,2,1
11651,54535.0,47,said,45,8,1,-7,7,45,37,-44,Bernard L Madoff Investment Securities LLC,Madoff,ORGANIZATION-ORGANIZATION-ORGANIZATION-ORGANIZATION-ORGANIZATION-ORGANIZATION,PERSON,PROPN-PROPN-PROPN-PROPN-PROPN-PROPN,PROPN,compound-compound-compound-compound-compound-pobj,nsubj,NNP-NNP-NNP-NNP-NNPS-NNP,NNP,5,1
11652,54536.0,9,Dec.,0,5,8,3,4,0,-5,8,Hector Elizondo,71,PERSON-PERSON,NUMBER,PROPN-PROPN,NUM,compound-nsubj,attr,NNP-NNP,CD,2,1
11653,54545.0,21,confirmed,3,1,9,8,0,11,2,6,His,mayor,PERSON,TITLE,DET,NOUN,poss,appos,PRP$,NN,5,1
11654,54546.0,18,managed,5,13,3,-10,12,14,-8,-2,Golden Baseball League,Japan Samurai Bears,ORGANIZATION-ORGANIZATION-ORGANIZATION,ORGANIZATION-ORGANIZATION-ORGANIZATION,PROPN-PROPN-PROPN,PROPN-PROPN-PROPN,compound-compound-pobj,compound-compound-dobj,NNP-NNP-NNP,NNP-NNP-NNP,5,1
11655,54551.0,51,teamed,4,7,12,5,6,38,-3,8,Olivia Palermo,star,PERSON-PERSON,TITLE,PROPN-PROPN,NOUN,compound-pobj,appos,NNP-NNP,NN,2,1
11656,54553.0,8,columnists,2,1,4,3,0,3,1,2,Daily News,Rush & Molloy,ORGANIZATION-ORGANIZATION,ORGANIZATION-ORGANIZATION-ORGANIZATION,PROPN-PROPN,PROPN-CCONJ-PROPN,compound-nsubj,nsubj-cc-conj,NNP-NNP,NNP-CC-NNP,4,1
11657,54578.0,23,said,12,20,15,-5,19,7,-8,3,AMA,Nancy H. Nielsen,ORGANIZATION,PERSON-PERSON-PERSON,PROPN,PROPN-PROPN-PROPN,poss,compound-compound-nsubj,NNP,NNP-NNP-NNP,3,1
11658,54588.0,36,said,20,34,22,-12,33,13,-14,2,SLDN,Aubrey Sarvis,ORGANIZATION,PERSON-PERSON,PROPN,PROPN-PROPN,compound,compound-nsubj,NNP,NNP-NNP,-1,1
11659,54603.0,60,survived,2,21,5,-16,20,54,-19,3,Robert E. Jr.,his,PERSON-PERSON-PERSON,PERSON,PROPN-PROPN-PROPN,DET,compound-compound-appos,poss,NNP-NNP-NNP,PRP$,7,1
11660,54604.0,54,cooperate,4,12,49,37,11,4,-8,45,Chunghwa Telecom,Leng Tai-fen,ORGANIZATION-ORGANIZATION,PERSON-PERSON,PROPN-PROPN,PROPN-PROPN,compound-appos,compound-nsubj,NNP-NNP,NNP-NNP,-1,1
11661,54610.0,19,made,3,8,18,10,7,0,-5,15,he,messenger,PERSON,TITLE,PRON,NOUN,nsubj,attr,PRP,NN,5,1
11662,54619.0,40,are,1,16,13,-3,15,26,-15,12,Chris Simcox,host,PERSON-PERSON,TITLE,PROPN-PROPN,NOUN,compound-conj,appos,NNP-NNP,NN,2,1
11663,54622.0,31,means,9,1,18,17,0,12,8,9,Vernon Bellecourt,Daybreak,PERSON-PERSON,PERSON,PROPN-PROPN,PROPN,compound-nsubj,conj,NNP-NNP,NNP,3,1
11664,54624.0,33,seethed,12,20,18,-2,19,14,-8,6,Jennifer Dunn,GOP,PERSON-PERSON,ORGANIZATION,PROPN-PROPN,PROPN,compound-nsubj,compound,NNP-NNP,NNP,1,1
11665,54629.0,14,joins,9,8,12,4,7,1,1,3,Danny Glover,ABC,PERSON-PERSON,ORGANIZATION,PROPN-PROPN,PROPN,compound-nsubj,compound,NNP-NNP,NNP,4,1
11666,54639.0,30,Upskirt,2,1,22,21,0,7,1,20,Britney Spears,Kevin Federline,PERSON-PERSON,PERSON-PERSON,PROPN-PROPN,PROPN-PROPN,compound-dobj,compound-pobj,NNP-NNPS,NNP-NNP,-1,1
11667,54662.0,25,said,8,17,10,-7,16,14,-9,2,National Center for Disaster Preparedness,"Dr Irwin Redlener ,",ORGANIZATION-ORGANIZATION-ORGANIZATION-ORGANIZATION-ORGANIZATION,PERSON-PERSON-PERSON-PERSON,PROPN-PROPN-ADP-PROPN-PROPN,PROPN-PROPN-PROPN-PUNCT,compound-pobj-prep-compound-pobj,compound-compound-nsubj-punct,NNP-NNP-IN-NNP-NNP,"NNP-NNP-NNP-,",5,1
11668,54663.0,9,ConAgra,0,1,4,3,0,4,-1,4,ConAgra,U.S.,ORGANIZATION,COUNTRY,PROPN,PROPN,ROOT,compound,NNP,NNP,2,1
11669,54665.0,29,promotes,7,26,6,-20,25,22,-19,-1,CCP,Jiang Zemin,ORGANIZATION,PERSON-PERSON,PROPN,PROPN-PROPN,poss,compound-nsubj,NNP,NNP-NNP,6,1
11670,54691.0,22,had,4,14,2,-12,13,19,-10,-2,Negroponte,State Department,PERSON,ORGANIZATION-ORGANIZATION,PROPN,PROPN-PROPN,nsubj,compound-nsubj,NNP,NNP-NNP,3,1
11671,54714.0,44,said,11,8,1,-7,7,42,3,-10,National Science Council,Tai Chien,ORGANIZATION-ORGANIZATION-ORGANIZATION,PERSON-PERSON,PROPN-PROPN-PROPN,PROPN-PROPN,compound-compound-pobj,compound-nsubj,NNP-NNP-NNP,NNP-NNP,4,1
11672,54715.0,46,spent,10,33,8,-25,32,37,-23,-2,her,50,PERSON,NUMBER,DET,NUM,poss,pobj,PRP$,CD,6,1
11673,54722.0,35,said,5,20,31,11,19,3,-15,26,FAA,United States,ORGANIZATION,COUNTRY-COUNTRY,PROPN,PROPN-PROPN,compound,compound-pobj,NNP,NNP-NNP,8,1
11674,54730.0,48,said,35,37,43,6,36,4,-2,8,Lou Ferrara,deputy managing editor,PERSON-PERSON,TITLE-TITLE-TITLE,PROPN-PROPN,NOUN-VERB-NOUN,compound-nsubj,nmod-compound-appos,NNP-NNP,NN-VBG-NN,7,1
11675,54747.0,63,ANKARA,0,8,10,2,7,52,-8,10,Larijani,Secretary,PERSON,TITLE,PROPN,PROPN,nsubjpass,appos,NNP,NNP,4,1
11676,54771.0,34,paid,24,17,20,3,16,13,7,-4,Red Cross,Marsha J Evans,ORGANIZATION-ORGANIZATION,PERSON-PERSON-PERSON,PROPN-PROPN,PROPN-PROPN-PROPN,compound-pobj,compound-compound-appos,NNP-NNP,NNP-NNP-NNP,4,1
11677,54778.0,24,will,2,4,8,4,3,15,-2,6,Jake,Sallie,PERSON,PERSON,PROPN,PROPN,poss,conj,NNP,NNP,4,1
11678,54783.0,12,was,1,1,7,6,0,4,0,6,She,Long Island City,PERSON,LOCATION-LOCATION-LOCATION,PRON,PROPN-PROPN-PROPN,nsubj,compound-compound-pobj,PRP,NNP-NNP-NNP,4,1
11679,54794.0,29,says,11,15,13,-2,14,15,-4,2,Ferrara,ProVise,PERSON,ORGANIZATION,PROPN,PROPN,nsubj,poss,NNP,NNP,1,1
11680,54803.0,19,took,6,1,18,17,0,0,5,12,Irene Morgan,America,PERSON-PERSON,COUNTRY,PROPN-PROPN,PROPN,compound-poss,dobj,NNP-NNP,NNP,3,1
11681,54807.0,31,came,10,8,8,0,7,22,2,-2,Fidelity,Fidelity Brokerage,ORGANIZATION,ORGANIZATION-ORGANIZATION,PROPN,PROPN-PROPN,compound,compound-pobj,NNP,NNP-NNP,0,1
11682,54818.0,25,spent,5,9,12,3,8,12,-4,7,his,Shanghai,PERSON,CITY,DET,PROPN,poss,pobj,PRP$,NNP,4,1
11683,54822.0,45,changed,2,22,11,-11,21,33,-20,9,his,lawyer,PERSON,TITLE,DET,NOUN,poss,nsubj,PRP$,NN,5,1
11684,54823.0,39,said,23,37,32,-5,36,6,-14,9,Carnival Corp.,Holland America,ORGANIZATION-ORGANIZATION,LOCATION-LOCATION,PROPN-PROPN,PROPN-PROPN,compound-pobj,compound-appos,NNP-NNP,NNP-NNP,2,1
11685,54828.0,37,acknowledged,17,5,12,7,4,24,12,-5,R. Nicholas Burns,negotiator,PERSON-PERSON-PERSON,TITLE,PROPN-PROPN-PROPN,NOUN,compound-compound-appos,appos,NNP-NNP-NNP,NN,3,1
11686,54829.0,24,seems,2,6,22,16,5,1,-4,20,Fuller,Los Angeles,PERSON,CITY-CITY,PROPN,PROPN-PROPN,nsubj,compound-pobj,NNP,NNP-NNP,4,1
11687,54852.0,20,be,7,6,13,7,5,6,1,6,Chen,Swire,PERSON,ORGANIZATION,PROPN,PROPN,nsubj,poss,NNP,NNP,8,1
11688,54853.0,32,campaign,2,18,13,-5,17,18,-16,11,he,Columbia International University,PERSON,ORGANIZATION-ORGANIZATION-ORGANIZATION,PRON,PROPN-PROPN-PROPN,nsubj,compound-compound-pobj,PRP,NNP-NNP-NNP,3,1
11689,54865.0,51,made,10,8,7,-1,7,43,2,-3,Kelly Cutrone,boss,PERSON-PERSON,TITLE,PROPN-PROPN,NOUN,compound-appos,nsubj,NNP-NNP,NN,1,1
11690,54866.0,59,promoted,29,8,39,31,7,19,21,10,George Roy Hill,Restores Virginity,PERSON-PERSON-PERSON,ORGANIZATION-ORGANIZATION,PROPN-PROPN-PROPN,PROPN-PROPN,compound-compound-pobj,compound-dobj,NNP-NNP-NNP,NNPS-NNP,8,1
11691,54873.0,18,given,3,1,10,9,0,7,2,7,Trista Sutter,Maxwell Alston Sutter,PERSON-PERSON,PERSON-PERSON-PERSON,PROPN-PROPN,PROPN-PROPN-PROPN,compound-nsubj,compound-compound-appos,NNP-NNP,NNP-NNP-NNP,5,1
11692,54877.0,48,brought,3,23,27,4,22,20,-20,24,ABA,Flint Tropics,ORGANIZATION,ORGANIZATION-ORGANIZATION,PROPN,PROPN-PROPN,compound,compound-appos,NNP,NNP-NNPS,4,1
11693,54886.0,36,unimpressed,9,7,3,-4,6,32,2,-6,Marco Contiero,EU,PERSON-PERSON,ORGANIZATION,PROPN-PROPN,PROPN,compound-nsubjpass,compound,NNP-NNP,NNP,3,1
11694,54892.0,25,merged,6,4,4,0,3,20,2,-2,Konica,Konica Minolta Holdings Inc.,ORGANIZATION,ORGANIZATION-ORGANIZATION-ORGANIZATION-ORGANIZATION,PROPN,PROPN-PROPN-PROPN-PROPN,nsubj,compound-compound-compound-dobj,NNP,NNP-NNP-NNP-NNP,0,1
11695,54898.0,11,is,1,5,10,5,4,0,-4,9,Focus on the Family,wwwpluggedinonlinecom,ORGANIZATION-ORGANIZATION-ORGANIZATION-ORGANIZATION,URL,PROPN-ADP-DET-PROPN,NOUN,pobj-prep-det-poss,pobj,NNP-IN-DT-NNP,NN,5,1
11696,54920.0,40,said,13,1,7,6,0,32,12,-6,Barbara Boxer,Senate Environment and Public Works committee,PERSON-PERSON,ORGANIZATION-ORGANIZATION-ORGANIZATION-ORGANIZATION-ORGANIZATION-ORGANIZATION,PROPN-PROPN,PROPN-PROPN-CCONJ-PROPN-PROPN-NOUN,compound-nsubj,compound-pobj-cc-compound-compound-conj,NNP-NNP,NNP-NNP-CC-NNP-NNP-NN,3,1
11697,54922.0,38,approve,5,5,24,19,4,13,0,19,Capitalia,Paolo Savona,ORGANIZATION,PERSON-PERSON,PROPN,PROPN-PROPN,compound,compound-appos,NNP,NNP-NNP,3,1
11698,54936.0,27,includes,4,1,1,0,0,25,3,-3,Carnival Corp.,Carnival Cruise Lines,ORGANIZATION-ORGANIZATION,ORGANIZATION-ORGANIZATION-ORGANIZATION,PROPN-PROPN,PROPN-PROPN-PROPN,compound-poss,compound-compound-pobj,NNP-NNP,NNP-NNP-NNPS,0,1
11699,54951.0,40,support,5,11,22,11,10,17,-6,17,Democrat of Wayland,Thomas P Conroy,ORGANIZATION-ORGANIZATION-ORGANIZATION,PERSON-PERSON-PERSON,PROPN-ADP-PROPN,PROPN-PROPN-PROPN,appos-prep-pobj,compound-compound-conj,NNP-IN-NNP,NNP-NNP-NNP,5,1
11700,54953.0,47,departed,10,18,42,24,17,4,-8,32,Cathleen P Black,New York City schools chancellor,PERSON-PERSON-PERSON,TITLE-TITLE-TITLE-TITLE-TITLE,PROPN-PROPN-PROPN,PROPN-PROPN-PROPN-NOUN-NOUN,compound-compound-dobj,compound-compound-compound-compound-attr,NNP-NNP-NNP,NNP-NNP-NNP-NNS-NN,6,1
11701,54965.0,37,KONG,1,19,9,-10,18,27,-18,8,Hong Kong Disneyland,HK Disneyland,ORGANIZATION-ORGANIZATION-ORGANIZATION,ORGANIZATION-ORGANIZATION,PROPN-PROPN-PROPN,PROPN-PROPN,compound-compound-pobj,compound-poss,NNP-NNP-NNP,NNP-NNP,6,1
11702,54969.0,43,is,1,7,1,-6,6,41,-6,0,"Focus on the Family Action , Inc.",CitizenLink,ORGANIZATION-ORGANIZATION-ORGANIZATION-ORGANIZATION-ORGANIZATION-ORGANIZATION-ORGANIZATION,ORGANIZATION,PROPN-ADP-DET-PROPN-PROPN-PUNCT-PROPN,PROPN,pobj-prep-pobj-compound-pobj-punct-subtok,nsubj,"NNP-IN-DT-NNP-NNP-,-NNP",NNP,2,1
11703,54972.0,27,died,6,12,8,-4,11,18,-6,2,he,Monday,PERSON,DATE,PRON,PROPN,nsubj,npadvmod,PRP,NNP,3,1
11704,54974.0,32,said,7,1,6,5,0,25,6,-1,Babyshambles,Andy Boyd,ORGANIZATION,PERSON-PERSON,NOUN,PROPN-PROPN,compound,compound-conj,NNS,NNP-NNP,4,1
11705,54977.0,26,quoted,4,3,23,20,2,2,1,19,RIA-Novosti,Mideast,ORGANIZATION,LOCATION,PROPN,PROPN,aux,compound,NNP,NNP,6,1
11706,54982.0,59,agreed,6,17,4,-13,16,54,-11,-2,Jewish National Fund,Gordon Brown,ORGANIZATION-ORGANIZATION-ORGANIZATION,PERSON-PERSON,ADJ-PROPN-PROPN,PROPN-PROPN,compound-compound-pobj,compound-nsubj,JJ-NNP-NNP,NNP-NNP,8,1
11707,54996.0,56,remembered,2,51,24,-27,50,31,-49,22,his,"Feb. 8 , 1968",PERSON,DATE-DATE-DATE-DATE,DET,PROPN-NUM-PUNCT-NUM,poss,pobj-nummod-punct-nummod,PRP$,"NNP-CD-,-CD",6,1
11708,54997.0,30,was,2,1,9,8,0,20,1,7,Abu Zubaydah,Zein al-Abideen Muhammad Hassan,PERSON-PERSON,PERSON-PERSON-PERSON-PERSON,PROPN-PROPN,PROPN-PROPN-PROPN-PROPN,compound-nsubj,pobj-ROOT-compound-ROOT,NNP-NNP,NNP-NNP-NNP-NNP,5,1
11709,55013.0,60,grabbed,49,48,7,-41,47,52,1,-42,Dent,2007,PERSON,DATE,PROPN,NUM,nsubj,nummod,NNP,CD,3,1
11710,55030.0,20,replaced,6,9,18,9,8,1,-3,12,company-backed,Richard Breeden,ORGANIZATION,PERSON-PERSON,ADJ,PROPN-PROPN,amod,compound-pobj,JJ,NNP-NNP,8,1
11711,55043.0,44,lured,8,7,2,-5,6,41,1,-6,Sandy,"Oct. 8 , 2006",PERSON,DATE-DATE-DATE-DATE,PROPN,PROPN-NUM-PUNCT-NUM,nsubjpass,pobj-nummod-punct-nummod,NNP,"NNP-CD-,-CD",4,1
11712,55045.0,45,said,27,29,35,6,28,9,-2,8,Gholam-Ali Hadad Adel,parliament,PERSON-PERSON-PERSON,ORGANIZATION,PROPN-PROPN-PROPN,NOUN,compound-compound-nsubj,dobj,NNP-NNP-NNP,NN,4,1
11713,55046.0,22,said,11,19,13,-6,18,8,-8,2,American Beverage Association,Preston Read,ORGANIZATION-ORGANIZATION-ORGANIZATION,PERSON-PERSON,PROPN-PROPN-PROPN,PROPN-PROPN,compound-compound-pobj,compound-nsubj,NNP-NNP-NNP,NNP-NNP,5,1
11714,55061.0,32,done,3,9,17,8,8,14,-6,14,Li Jie,Beijing Lunar Village Aeronautics Science and Technology Co. Ltd.,PERSON-PERSON,ORGANIZATION-ORGANIZATION-ORGANIZATION-ORGANIZATION-ORGANIZATION-ORGANIZATION-ORGANIZATION-ORGANIZATION-ORGANIZATION,PROPN-PROPN,PROPN-PROPN-PROPN-PROPN-PROPN-CCONJ-PROPN-PROPN-PROPN,compound-pobj,compound-compound-compound-compound-pobj-cc-subtok-subtok-conj,NNP-NNP,NNP-NNP-NNP-NNP-NNP-CC-NNP-NNP-NNP,5,1
11715,55080.0,45,eliminated,23,5,23,18,4,21,18,0,Jewish National Fund,Lauder,ORGANIZATION-ORGANIZATION-ORGANIZATION,PERSON,ADJ-PROPN-PROPN,PROPN,compound-compound-pobj,nsubj,JJ-NNP-NNP,NNP,5,1
11716,55085.0,30,died,22,3,27,24,2,2,19,5,Steven B. Derounian,Austin,PERSON-PERSON-PERSON,CITY,PROPN-PROPN-PROPN,PROPN,compound-compound-nsubj,pobj,NNP-NNP-NNP,NNP,5,1
11717,55095.0,47,Tipped,1,38,13,-25,37,33,-37,12,Bernard L Madoff Investment Securities LLC,New York,ORGANIZATION-ORGANIZATION-ORGANIZATION-ORGANIZATION-ORGANIZATION-ORGANIZATION,STATE_OR_PROVINCE-STATE_OR_PROVINCE,PROPN-PROPN-PROPN-PROPN-PROPN-PROPN,PROPN-PROPN,compound-compound-compound-compound-compound-dobj,compound-compound,NNP-NNP-NNP-NNP-NNPS-NNP,NNP-NNP,9,1
11718,55110.0,39,said,9,24,20,-4,23,18,-15,11,Abu Zubaydah,terrorism,PERSON-PERSON,CRIMINAL_CHARGE,PROPN-PROPN,NOUN,compound-pobj,compound,NNP-NNP,NN,4,1
11719,55114.0,36,said,10,5,9,4,4,26,5,-1,RIA Novosti,Andrey Ilyashenko,ORGANIZATION-ORGANIZATION,PERSON-PERSON,PROPN-PROPN,PROPN-PROPN,compound-compound,compound-appos,NNP-NNP,NNP-NNP,4,1
11720,55125.0,57,Exposed,2,19,39,20,18,17,-17,37,Adam Senn,Dolce Gabbana,PERSON-PERSON,ORGANIZATION-ORGANIZATION,PROPN-PROPN,PROPN-PROPN,compound-compound,compound-pobj,NNP-NNP,NNP-NNP,8,1
11721,55136.0,56,include,1,24,42,18,23,13,-23,41,William Wymond Verity,Jean Verity Woodhull,PERSON-PERSON-PERSON,PERSON-PERSON-PERSON,PROPN-PROPN-PROPN,PROPN-PROPN-PROPN,compound-compound-conj,compound-compound-conj,NNP-NNP-NNP,NNP-NNP-NNP,12,1
11722,55139.0,30,return,22,6,5,-1,5,24,16,-17,Red Sox,Boston Red Sox,ORGANIZATION-ORGANIZATION,ORGANIZATION-ORGANIZATION-ORGANIZATION,PROPN-PROPN,PROPN-PROPN-PROPN,compound-pobj,compound-compound-compound,NNP-NNPS,NNP-NNP-NNPS,1,1
11723,55141.0,28,took,5,15,1,-14,14,26,-10,-4,ISU,Pekka Koskela,ORGANIZATION,PERSON-PERSON,PROPN,PROPN-PROPN,compound,compound-nsubj,NNP,NNP-NNP,5,1
11724,55149.0,50,said,6,5,3,-2,4,46,1,-3,Ahmad Qattan,scholar,PERSON-PERSON,TITLE,PROPN-PROPN,NOUN,compound-nsubj,nsubj,NNP-NNP,NN,3,1
11725,55160.0,36,Foreman,3,25,21,-4,24,14,-22,18,Barbara Boxer,Senate Ethics Committee,PERSON-PERSON,ORGANIZATION-ORGANIZATION-ORGANIZATION,PROPN-PROPN,PROPN-PROPN-PROPN,compound-compound,compound-compound-compound,NNP-NNP,NNP-NNP-NNP,7,1
11726,55161.0,25,spent,3,7,11,4,6,13,-4,8,his,minister,PERSON,TITLE,DET,NOUN,poss,pobj,PRP$,NN,4,1
11727,55173.0,33,said,5,1,4,3,0,28,4,-1,CMA,Thami Vilakazi,ORGANIZATION,PERSON-PERSON,PROPN,PROPN-PROPN,compound,compound-appos,NNP,NNP-NNP,3,1
11728,55175.0,23,born,2,1,12,11,0,10,1,10,Ahearn,Tenn,PERSON,STATE_OR_PROVINCE,PROPN,PROPN,nsubjpass,appos,NNP,NNP,3,1
11729,55178.0,43,helped,20,1,24,23,0,18,19,4,Crisp,National Republican Coalition for Choice,PERSON,ORGANIZATION-ORGANIZATION-ORGANIZATION-ORGANIZATION-ORGANIZATION,PROPN,PROPN-PROPN-PROPN-ADP-PROPN,nsubj,compound-compound-dobj-prep-pobj,NNP,NNP-NNP-NNP-IN-NNP,4,1
11730,55181.0,19,NOLTE,1,1,4,3,0,14,0,3,RICHARD NOLTE,86,PERSON-PERSON,NUMBER,PROPN-PROPN,NUM,compound-ROOT,appos,NNP-NNP,CD,1,1
11731,55185.0,19,disagreed,17,14,3,-11,13,15,3,-14,American Bankers Association,Floyd Stoner,ORGANIZATION-ORGANIZATION-ORGANIZATION,PERSON-PERSON,PROPN-PROPN-PROPN,PROPN-PROPN,compound-compound-pobj,compound-nsubj,NNP-NNPS-NNP,NNP-NNP,6,1
11732,55198.0,42,ANGELES,1,12,15,3,11,26,-11,14,Lou Ferrara,managing editor,PERSON-PERSON,TITLE-TITLE,PROPN-PROPN,VERB-NOUN,compound-pobj,compound-appos,NNP-NNP,VBG-NN,3,1
11733,60393.0,35,said,21,23,27,4,22,7,-2,6,Lou Ferrara,managing editor,PERSON-PERSON,TITLE-TITLE,PROPN-PROPN,VERB-NOUN,compound-nsubj,acl-dobj,NNP-NNP,VBG-NN,3,1
11734,55204.0,25,telling,10,3,2,-1,2,22,7,-8,Carolyn Maloney,congresswoman,PERSON-PERSON,TITLE,PROPN-PROPN,NOUN,compound-appos,nsubj,NNP-NNP,NN,1,1
11735,55206.0,35,said,6,8,27,19,7,7,-2,21,Remy Smith,United States,PERSON-PERSON,COUNTRY-COUNTRY,PROPN-PROPN,PROPN-PROPN,compound-attr,compound-dobj,NNP-NNP,NNP-NNP,4,1
11736,55213.0,61,BOLIN,1,1,4,3,0,56,0,3,JANE BOLIN,98,PERSON-PERSON,NUMBER,PROPN-PROPN,NUM,compound-ROOT,appos,NNP-NNP,CD,1,1
11737,55219.0,42,forming,20,1,4,3,0,37,19,-16,Dan Abrams,the chief legal correspondent,PERSON-PERSON,TITLE-TITLE-TITLE-TITLE,PROPN-PROPN,DET-ADJ-ADJ-NOUN,compound-nsubj,det-amod-amod-appos,NNP-NNP,DT-JJ-JJ-NN,2,1
11738,55225.0,51,said,13,30,30,0,29,20,-17,17,he,he,PERSON,PERSON,PRON,PRON,nsubj,nsubj,PRP,PRP,0,1
11739,55277.0,37,pronounced,18,17,13,-4,16,23,1,-5,Ahearn,US Information Agency,PERSON,ORGANIZATION-ORGANIZATION-ORGANIZATION,PROPN,PROPN-PROPN-PROPN,compound,compound-compound-pobj,NNP,NNP-NNP-NNP,8,1
11740,55279.0,25,House,8,7,17,10,6,7,1,9,Kentucky State House of Representatives,U.S.,ORGANIZATION-ORGANIZATION-ORGANIZATION-ORGANIZATION-ORGANIZATION,COUNTRY,PROPN-PROPN-PROPN-ADP-PROPN,PROPN,appos-compound-ROOT-prep-pobj,compound,NNP-NNP-NNP-IN-NNPS,NNP,6,1
11741,55285.0,13,using,6,2,1,-1,1,11,4,-5,Hugo Ch!vez,President,PERSON-PERSON,TITLE,PROPN-NOUN,PROPN,nsubj-nsubj,compound,NNP-NN,NNP,1,1
11742,55289.0,39,said,12,10,9,-1,9,29,2,-3,Ali Akber Salehi,IAEA,PERSON-PERSON-PERSON,ORGANIZATION,PROPN-PROPN-PROPN,PROPN,compound-compound-pobj,compound,NNP-NNP-NNP,NNP,2,1
11743,55296.0,51,said,26,47,41,-6,46,9,-21,15,KGB,NKVD,ORGANIZATION,ORGANIZATION,PROPN,NOUN,pobj,pobj,NNP,NN,3,1
11744,55298.0,17,Butterflies,0,6,9,3,5,7,-6,9,Daily News,Galveston County,ORGANIZATION-ORGANIZATION,LOCATION-LOCATION,PROPN-PROPN,PROPN-PROPN,compound-compound,compound-dobj,NNP-NNP,NNP-NNP,2,1
11745,55306.0,32,survived,7,12,18,6,11,13,-5,11,his,Elva Corrales,PERSON,PERSON-PERSON,DET,PROPN-PROPN,poss,compound-conj,PRP$,NNP-NNP,3,1
11746,55311.0,88,say,24,84,80,-4,83,7,-60,56,Brian McFadden,Kerry Katona,PERSON-PERSON,PERSON-PERSON,PROPN-PROPN,PROPN-PROPN,compound-nsubj,compound-poss,NNP-NNP,NNP-NNP,4,1
11747,55313.0,40,served,19,7,5,-2,6,34,12,-14,William Robert Anderson,Tennessee,PERSON-PERSON-PERSON,STATE_OR_PROVINCE,PROPN-PROPN-PROPN,PROPN,compound-compound-appos,compound,NNP-NNP-NNP,NNP,2,1
11748,55324.0,29,signed,3,9,15,6,8,13,-6,12,Chen Zhu,General,PERSON-PERSON,TITLE,PROPN-PROPN,PROPN,compound-pobj,conj,NNP-NNP,NNP,2,1
11749,55359.0,27,said,8,7,1,-6,6,25,1,-7,FirstGroup,Jennifer Robinson,ORGANIZATION,PERSON-PERSON,PROPN,PROPN-PROPN,poss,compound-nsubj,NNP,NNP-NNP,2,1
11750,55367.0,38,said,33,30,32,2,29,5,3,-1,PRC,Abu Mujahid,ORGANIZATION,PERSON-PERSON,PROPN,PROPN-PROPN,compound,compound-nsubj,NNP,NNP-NNP,3,1
11751,55374.0,31,revived,19,13,12,-1,12,18,6,-7,Juanita Millender-McDonald,Chairwoman,PERSON-PERSON,TITLE,PROPN-PROPN,PROPN,compound-pobj,compound,NNP-NNP,NNP,2,1
11752,55397.0,30,included,9,16,11,-5,15,18,-7,2,her,movie star,PERSON,TITLE-TITLE,DET,NOUN-NOUN,poss,compound-compound,PRP$,NN-NN,2,1
11753,55407.0,25,killed,21,7,10,3,6,14,14,-11,Mia Farrow,Patrick Farrow,PERSON-PERSON,PERSON-PERSON,PROPN-PROPN,PROPN-PROPN,compound-pobj,compound-conj,NNP-NNP,NNP-NNP,1,1
11754,55408.0,36,said,4,15,31,16,14,4,-11,27,FMR Corp,Robert L Reynolds,ORGANIZATION-ORGANIZATION,PERSON-PERSON-PERSON,PROPN-PROPN,PROPN-PROPN-PROPN,compound-pobj,compound-compound-appos,NNP-NNP,NNP-NNP-NNP,7,1
11755,55412.0,43,died,38,1,8,7,0,34,37,-30,Teddy Kollek,Jerusalem,PERSON-PERSON,CITY,PROPN-PROPN,PROPN,compound-nsubj,pobj,NNP-NNP,NNP,2,1
11756,57751.0,44,JERUSALEM,0,3,8,5,2,35,-3,8,Teddy Kollek,Jerusalem,PERSON-PERSON,CITY,PROPN-PROPN,PROPN,compound-nsubj,compound,NNP-NNP,NNP,1,1
11757,55441.0,61,FINDING,0,12,12,0,11,48,-12,12,AAA,AAA Auto Club South,ORGANIZATION,ORGANIZATION-ORGANIZATION-ORGANIZATION-ORGANIZATION,PROPN,PROPN-PROPN-PROPN-PROPN,poss,compound-compound-compound-poss,NNP,NNP-NNP-NNP-NNP,0,1
11758,55454.0,29,born,4,27,24,-3,26,4,-23,20,Tema Kaiser,Moishe Bear,PERSON-PERSON,PERSON-PERSON,PROPN-PROPN,PROPN-PROPN,compound-conj,compound-pobj,NNP-NNP,NNP-NNP,1,1
11759,55467.0,47,died,40,1,11,10,0,35,39,-29,Augustus F. Hawkins,representative,PERSON-PERSON-PERSON,TITLE,PROPN-PROPN-PROPN,NOUN,compound-compound-nsubj,attr,NNP-NNP-NNP,NN,4,1
11760,55478.0,38,was,6,13,5,-8,12,32,-7,-1,Moro National Liberation Front,Akbar,ORGANIZATION-ORGANIZATION-ORGANIZATION-ORGANIZATION,PERSON,PROPN-PROPN-PROPN-PROPN,PROPN,compound-compound-compound-pobj,appos,NNP-NNP-NNP-NNP,NNP,5,1
11761,55508.0,36,died,33,4,24,20,3,11,29,-9,Kurt Waldheim,German,PERSON-PERSON,NATIONALITY,PROPN-PROPN,ADJ,compound-nsubj,amod,NNP-NNP,JJ,6,1
11762,55519.0,22,said,14,1,5,4,0,16,13,-9,Herrera,age-related causes,PERSON,CAUSE_OF_DEATH-CAUSE_OF_DEATH,NOUN,ADJ-NOUN,nsubj,amod-pobj,NN,JJ-NNS,5,1
11763,55524.0,39,said,23,37,32,-5,36,6,-14,9,Carnival Corp,Holland America,ORGANIZATION-ORGANIZATION,ORGANIZATION-ORGANIZATION,PROPN-PROPN,PROPN-PROPN,compound-pobj,compound-appos,NNP-NNP,NNP-NNP,2,1
11764,55536.0,55,Mercado,5,40,52,12,39,2,-35,47,Michael Johns,US,PERSON-PERSON,COUNTRY,PROPN-PROPN,PROPN,compound-conj,pobj,NNP-NNP,NNP,7,1
11765,55537.0,33,denied,6,1,16,15,0,16,5,10,Mainland Affairs Council,she,ORGANIZATION-ORGANIZATION-ORGANIZATION,PERSON,PROPN-PROPN-PROPN,PRON,compound-compound-compound,nsubjpass,NNP-NNPS-NNP,PRP,7,1
11766,55550.0,29,said,9,21,16,-5,20,12,-12,7,American Psychological Association,1992,ORGANIZATION-ORGANIZATION-ORGANIZATION,DATE,PROPN-PROPN-PROPN,NUM,compound-compound-poss,pobj,NNP-NNP-NNP,CD,7,1
11767,55554.0,12,was,10,10,3,-7,9,8,0,-7,she,RUssian,PERSON,NATIONALITY,PRON,ADJ,nsubj,amod,PRP,JJ,3,1
11768,55559.0,32,dumped,1,18,11,-7,17,20,-17,10,Sadia,Sao Paulo,ORGANIZATION,CITY-CITY,PROPN,PROPN-PROPN,compound,compound-poss,NNP,NNP-NNP,5,1
11769,55560.0,17,was,11,1,14,13,0,2,10,3,Ms King,actor,PERSON-PERSON,TITLE,PROPN-PROPN,NOUN,compound-nsubj,attr,NNP-NNP,NN,3,1
11770,55581.0,36,said,4,2,16,14,1,19,2,12,American Automobile Association,United States,ORGANIZATION-ORGANIZATION-ORGANIZATION,COUNTRY-COUNTRY,PROPN-PROPN-PROPN,PROPN-PROPN,compound-compound-nsubj,compound-pobj,NNP-NNP-NNP,NNP-NNP,8,1
11771,67687.0,46,said,18,26,44,18,25,1,-8,26,American Automobile Association,United States,ORGANIZATION-ORGANIZATION-ORGANIZATION,COUNTRY-COUNTRY,PROPN-PROPN-PROPN,PROPN-PROPN,compound-compound-pobj,compound-pobj,NNP-NNP-NNP,NNP-NNP,10,1
11772,55584.0,23,said,15,2,12,10,1,10,13,-3,She,Republican party,PERSON,ORGANIZATION-ORGANIZATION,PRON,ADJ-NOUN,nsubj,amod-conj,PRP,JJ-NN,6,1
11773,55590.0,45,said,41,37,40,3,36,4,4,-1,SAC,Huang Xiangpin,ORGANIZATION,PERSON-PERSON,PROPN,PROPN-PROPN,compound,compound-nsubj,NNP,NNP-NNP,2,1
11774,55591.0,37,said,3,1,23,22,0,13,2,20,DirecTV,him,ORGANIZATION,PERSON,VERB,PRON,nsubj,nsubj,VB,PRP,6,1
11775,55602.0,86,Bryanston,2,2,25,23,1,60,0,23,CNR Rivonia,Cnr,ORGANIZATION-ORGANIZATION,ORGANIZATION,PROPN-PROPN,PROPN,compound-conj,compound,NNP-NNP,NNP,-1,1
11776,55607.0,44,said,33,40,35,-5,39,8,-7,2,Alcatel-Lucent,Philippe Dumont,ORGANIZATION,PERSON-PERSON,ADJ,PROPN-PROPN,amod,compound-nsubj,JJ,NNP-NNP,7,1
11777,55608.0,14,was,1,1,10,9,0,3,0,9,He,East Berlin,PERSON,CITY-CITY,PRON,PROPN-PROPN,nsubj,compound-pobj,PRP,NNP-NNP,4,1
11778,61246.0,14,was,1,1,10,9,0,3,0,9,He,East Berlin,PERSON,LOCATION-LOCATION,PRON,PROPN-PROPN,nsubj,compound-pobj,PRP,NNP-NNP,4,1
11779,55656.0,9,Submariner,0,4,1,-3,3,7,-4,1,William Anderson,Submariner,PERSON-PERSON,TITLE,PROPN-PROPN,PROPN,compound-conj,ROOT,NNP-NNP,NNP,2,1
11780,55667.0,61,Brandon,0,1,32,31,0,28,-1,32,Brandon McInerney,15,PERSON-PERSON,NUMBER,PROPN-PROPN,NUM,ROOT-compound,appos,NNP-NNP,CD,5,1
11781,55671.0,32,veered,5,17,25,8,16,6,-12,20,Barry Goldwater,Republican Party,PERSON-PERSON,ORGANIZATION-ORGANIZATION,PROPN-PROPN,PROPN-PROPN,compound-pobj,compound-compound,NNP-NNP,NNP-NNP,3,1
11782,55700.0,43,said,8,17,10,-7,16,32,-9,2,Kennedy Space Center,Allard Beutel,ORGANIZATION-ORGANIZATION-ORGANIZATION,PERSON-PERSON,PROPN-PROPN-PROPN,PROPN-PROPN,compound-compound-pobj,compound-nsubj,NNP-NNP-NNP,NNP-NNP,5,1
11783,55704.0,47,-LRB-,4,45,29,-16,44,17,-41,25,Philip Kaiser,America,PERSON-PERSON,COUNTRY,PROPN-PROPN,PROPN,compound-conj,poss,NNP-NNP,NNP,4,1
11784,55717.0,27,linked,10,7,16,9,6,10,3,6,Beyonce Knowles,Jay-Z,PERSON-PERSON,PERSON,PROPN-PROPN,NOUN,compound-nsubjpass,pobj,NNP-NNP,NNS,5,1
11785,55718.0,26,reported,2,1,6,5,0,19,1,4,ElBaradei,inspectors,PERSON,TITLE,PROPN,NOUN,nsubj,nsubj,NNP,NNS,2,1
11786,55732.0,40,died,33,1,9,8,0,30,32,-24,Jefferson J DeBlanc,fighter pilot,PERSON-PERSON-PERSON,TITLE-TITLE,PROPN-PROPN-PROPN,NOUN-NOUN,compound-compound-nsubj,compound-appos,NNP-NNP-NNP,NN-NN,2,1
11787,55734.0,23,came,12,21,20,-1,20,2,-9,8,Abbas Musawi,leader,PERSON-PERSON,ORGANIZATION,PROPN-PROPN,NOUN,compound-dobj,compound,NNP-NNP,NN,1,1
11788,55742.0,41,said,9,5,8,3,4,32,4,-1,MAC,Fu Don-cheng,ORGANIZATION,PERSON-PERSON,PROPN,PROPN-PROPN,compound,compound-nsubj,NNP,NNP-NNP,4,1
11789,55772.0,36,said,13,26,23,-3,25,12,-13,10,International Crisis Group,Nigeria,ORGANIZATION-ORGANIZATION-ORGANIZATION,COUNTRY,PROPN-PROPN-PROPN,PROPN,compound-compound-pobj,pobj,NNP-NNP-NNP,NNP,5,1
11790,55789.0,16,was,2,5,6,1,4,9,-3,4,Andrew Goodman,Goodman,PERSON-PERSON,PERSON,PROPN-PROPN,PROPN,compound-poss,nsubj,NNP-NNP,NNP,1,1
11791,55791.0,37,help,1,27,31,4,26,5,-26,30,American Bar Association,H Thomas Wells Jr,ORGANIZATION-ORGANIZATION-ORGANIZATION,PERSON-PERSON-PERSON-PERSON,PROPN-PROPN-PROPN,PROPN-PROPN-PROPN-PROPN,compound-compound-compound,compound-compound-compound-nsubj,NNP-NNP-NNP,NNP-NNP-NNP-NNP,4,1
11792,59467.0,29,said,16,26,18,-8,25,10,-10,2,American Bar Association,H Thomas Wells Jr,ORGANIZATION-ORGANIZATION-ORGANIZATION,PERSON-PERSON-PERSON-PERSON,PROPN-PROPN-PROPN,PROPN-PROPN-PROPN-PROPN,compound-compound-pobj,compound-compound-compound-nsubj,NNP-NNP-NNP,NNP-NNP-NNP-NNP,5,1
11793,55792.0,33,read,7,3,1,-2,2,31,4,-6,Gholam Ali Haddad-Adel,Parliament Speaker,PERSON-PERSON-PERSON,TITLE-TITLE,PROPN-PROPN-PROPN,PROPN-PROPN,compound-compound-nsubj,compound-compound,NNP-NNP-NNP,NNP-NNP,2,1
11794,55796.0,26,CRISP,2,1,5,4,0,20,1,3,MARY D CRISP,83,PERSON-PERSON-PERSON,NUMBER,PROPN-PROPN-PROPN,NUM,compound-compound-ROOT,appos,NNP-NNP-NNP,CD,2,1
11795,55811.0,50,verbatim,2,36,6,-30,35,43,-34,4,D.C.R.,Boston Bike Association,ORGANIZATION,ORGANIZATION-ORGANIZATION-ORGANIZATION,PROPN,PROPN-PROPN-PROPN,pobj,compound-compound-nsubj,NNP,NNP-NNP-NNP,4,1
11796,55824.0,47,said,32,34,46,12,33,0,-2,14,Marco Contiero,Brussels,PERSON-PERSON,CITY,PROPN-PROPN,PROPN,compound-nsubj,pobj,NNP-NNP,NNP,6,1
11797,55859.0,25,said,19,21,23,2,20,1,-2,4,DCR,Rick Sullivan,ORGANIZATION,PERSON-PERSON,PROPN,PROPN-PROPN,compound,compound-nsubj,NNP,NNP-NNP,3,1
11798,55862.0,35,quoted,17,19,22,3,18,12,-2,5,Li Jie,deputy director,PERSON-PERSON,TITLE-TITLE,PROPN-PROPN,NOUN-NOUN,compound-dobj,compound-appos,NNP-NNP,NN-NN,3,1
11799,55885.0,57,are,21,2,55,53,1,1,19,34,Obamas,United States,ORGANIZATION,COUNTRY-COUNTRY,PROPN,PROPN-PROPN,poss,compound-pobj,NNP,NNP-NNP,12,1
11800,57287.0,40,are,8,2,38,36,1,1,6,30,Obamas,United States,ORGANIZATION,COUNTRY-COUNTRY,PROPN,PROPN-PROPN,poss,compound-pobj,NNP,NNP-NNP,7,1
11801,55929.0,40,Roll,2,1,11,10,0,28,1,9,Massachusetts,Salvatore F DiMasi,ORGANIZATION,PERSON-PERSON-PERSON,PROPN,PROPN-PROPN-PROPN,nsubj,compound-compound-nmod,NNP,NNP-NNP-NNP,6,1
11802,55930.0,46,said,11,1,18,17,0,27,10,7,Chunghwa Telecom Co.,the end of this year,ORGANIZATION-ORGANIZATION-ORGANIZATION,DATE-DATE-DATE-DATE-DATE,PROPN-PROPN-PROPN,DET-NOUN-ADP-DET-NOUN,compound-compound-nsubj,det-pobj-prep-det-pobj,NNP-NNP-NNP,DT-NN-IN-DT-NN,5,1
11803,55932.0,41,seen,3,16,36,20,15,4,-13,33,Badr Organisation,Shiite,ORGANIZATION-ORGANIZATION,RELIGION,PROPN-PROPN,ADJ,compound-conj,amod,NNP-NNP,JJ,15,1
11804,55935.0,44,survived,12,11,18,7,10,25,1,6,Farland,Christopher,PERSON,PERSON,PROPN,PROPN,nsubjpass,appos,NNP,NNP,5,1
11805,55943.0,39,winding,8,28,3,-25,27,35,-20,-5,Jerome Robbins,New York,PERSON-PERSON,STATE_OR_PROVINCE-STATE_OR_PROVINCE,PROPN-PROPN,PROPN-PROPN,compound-appos,compound-compound,NNP-NNP,NNP-NNP,9,1
11806,55952.0,13,is,2,4,2,-2,3,10,-2,0,her,Goldwater,PERSON,PERSON,DET,PROPN,poss,nsubj,PRP$,NNP,2,1
11807,55955.0,53,went,23,14,19,5,13,33,9,-4,he,Balkans,PERSON,LOCATION,PRON,PROPN,nsubjpass,pobj,PRP,NNPS,2,1
11808,55965.0,37,said,29,35,31,-4,34,5,-6,2,UNITA,Abilio Kamalata Numa,ORGANIZATION,PERSON-PERSON-PERSON,PROPN,PROPN-PROPN-PROPN,compound,compound-compound-nsubj,NNP,NNP-NNP-NNP,3,1
11809,55966.0,22,declared,6,1,5,4,0,16,5,-1,Pennsylvania Supreme Court,Max Baer,ORGANIZATION-ORGANIZATION-ORGANIZATION,PERSON-PERSON,PROPN-PROPN-PROPN,PROPN-PROPN,compound-compound-compound,compound-nsubj,NNP-NNP-NNP,NNP-NNP,3,1
11810,55969.0,28,was,13,5,1,-4,4,26,8,-12,International Monetary Fund,Olaf Unteroberdoerster,ORGANIZATION-ORGANIZATION-ORGANIZATION,PERSON-PERSON,PROPN-PROPN-PROPN,PROPN-PROPN,compound-compound-poss,compound-nsubj,NNP-NNP-NNP,NNP-NNP,3,1
11811,55972.0,36,say,5,2,33,31,1,2,3,28,Castro,Alejandro,PERSON,PERSON,PROPN,PROPN,compound,conj,NNP,NNP,8,1
11812,55985.0,40,joined,6,33,32,-1,32,7,-27,26,Pascal Yoadimnadji,minister,PERSON-PERSON,TITLE,PROPN-PROPN,NOUN,compound-pobj,compound,NNP-NNPS,NN,1,1
11813,55990.0,17,co-managed,8,5,11,6,4,5,3,3,she,Ramones,PERSON,ORGANIZATION,PRON,PROPN,nsubj,dobj,PRP,NNPS,6,1
11814,56012.0,40,are,4,3,15,12,2,24,1,11,OIC,Sudan,ORGANIZATION,COUNTRY,PROPN,PROPN,compound,conj,NNP,NNP,8,1
11815,56020.0,25,know,5,7,13,6,6,11,-2,8,she,Yale Law School,PERSON,ORGANIZATION-ORGANIZATION-ORGANIZATION,PRON,PROPN-PROPN-PROPN,nsubjpass,compound-compound-pobj,PRP,NNP-NNP-NNP,4,1
11816,56031.0,17,Dawkins,2,9,6,-3,8,10,-7,4,Oxford University Press,Selfish Gene,ORGANIZATION-ORGANIZATION-ORGANIZATION,ORGANIZATION-ORGANIZATION,PROPN-PROPN-PROPN,PROPN-PROPN,compound-compound-compound,compound-appos,NNP-NNP-NNP,NNP-NNP,2,1
11817,56055.0,25,said,11,20,13,-7,19,11,-9,2,MF Global,Jim O'Sullivan,ORGANIZATION-ORGANIZATION,PERSON-PERSON,PROPN-PROPN,PROPN-PROPN,compound-pobj,compound-nsubj,NNP-NNP,NNP-NNP,5,1
11818,56056.0,17,was,11,1,10,9,0,6,10,-1,Ms King,Yoki,PERSON-PERSON,PERSON,PROPN-PROPN,PROPN,compound-nsubj,pobj,NNP-NNP,NNP,2,1
11819,56058.0,47,Keqiang,4,19,15,-4,18,31,-15,11,Communist Party of China,Political Bureau,ORGANIZATION-ORGANIZATION-ORGANIZATION-ORGANIZATION,ORGANIZATION-ORGANIZATION,PROPN-PROPN-ADP-PROPN,PROPN-PROPN,compound-pobj-prep-pobj,compound-pobj,NNP-NNP-IN-NNP,NNP-NNP,2,1
11820,56059.0,24,mokhal,0,4,2,-2,3,21,-4,2,Beyonce Knowles,R&B superstar,PERSON-PERSON,TITLE-TITLE,PROPN-PROPN,NOUN-NOUN,compound-nsubj,compound-compound,NNP-NNP,NN-NN,1,1
11821,56090.0,34,created,7,6,3,-3,5,30,1,-4,Spencer Pratt,The Hills,PERSON-PERSON,ORGANIZATION-ORGANIZATION,PROPN-PROPN,DET-PROPN,compound-conj,det-compound,NNP-NNP,DT-NNP,2,1
11822,56099.0,27,destroyed,6,14,23,9,13,3,-8,17,Abbas Musawi,Muslim,PERSON-PERSON,RELIGION,PROPN-PROPN,PROPN,compound-dobj,amod,NNP-NNP,NNP,4,1
11823,56102.0,17,described,8,7,10,3,6,6,1,2,John Dewey,Humanism,PERSON-PERSON,RELIGION,PROPN-PROPN,PROPN,compound-nsubj,dobj,NNP-NNP,NNP,2,1
11824,56111.0,27,said,12,22,14,-8,21,12,-10,2,Highland Capital Partners,Paul A Maeder,ORGANIZATION-ORGANIZATION-ORGANIZATION,PERSON-PERSON-PERSON,PROPN-PROPN-PROPN,PROPN-PROPN-PROPN,compound-compound-pobj,compound-compound-nsubj,NNP-NNP-NNP,NNP-NNP-NNP,3,1
11825,56112.0,41,said,39,3,25,22,2,15,36,-14,Lorraine Rothman,years,PERSON-PERSON,DATE,PROPN-PROPN,NOUN,compound-nsubj,pobj,NNP-NNP,NNS,5,1
11826,56125.0,35,meant,25,20,34,14,19,0,5,9,New Jerusalem Foundation,Israel,ORGANIZATION-ORGANIZATION-ORGANIZATION,COUNTRY,PROPN-PROPN-PROPN,PROPN,compound-compound-dobj,pobj,NNP-NNP-NNP,NNP,7,1
11827,56148.0,29,accompanied,6,1,14,13,0,14,5,8,His,she,PERSON,PERSON,DET,PRON,poss,nsubj,PRP$,PRP,2,1
11828,56150.0,74,grade,3,47,46,-1,46,27,-44,43,Trista Sutter,Bachelorette,PERSON-PERSON,TITLE,PROPN-PROPN,PROPN,compound-nsubj,compound,NNP-NNP,NNP,1,1
11829,56151.0,45,MORGANTOWN,0,10,28,18,9,16,-10,28,ISU,Mark Glyptis,ORGANIZATION,PERSON-PERSON,PROPN,PROPN-PROPN,nsubjpass,compound-nsubj,NNP,NNP-NNP,4,1
11830,65186.0,22,said,16,18,20,2,17,1,-2,4,ISU,Mark Glyptis,ORGANIZATION,PERSON-PERSON,PROPN,PROPN-PROPN,compound,compound-nsubj,NNP,NNP-NNP,3,1
11831,56159.0,9,been,5,1,3,2,0,5,4,-2,Fuller,37,PERSON,NUMBER,ADV,NUM,nsubj,appos,RB,CD,3,1
11832,56160.0,36,served,10,32,10,-22,31,25,-22,0,Professional Rodeo Cowboys Association,Steve,ORGANIZATION-ORGANIZATION-ORGANIZATION-ORGANIZATION,PERSON,PROPN-PROPN-PROPN-PROPN,PROPN,compound-compound-compound-pobj,nsubj,NNP-NNP-NNPS-NNP,NNP,7,1
11833,56164.0,18,born,5,1,11,10,0,6,4,6,Thomas Joseph Meskill Jr.,Conn.,PERSON-PERSON-PERSON-PERSON,STATE_OR_PROVINCE,PROPN-PROPN-PROPN-PROPN,PROPN,compound-compound-compound-nsubjpass,appos,NNP-NNP-NNP-NNP,NNP,3,1
11834,56172.0,22,enrolled,2,1,14,13,0,7,1,12,He,Army 's Junior Reserve Officers ' Training Corps,PERSON,ORGANIZATION-ORGANIZATION-ORGANIZATION-ORGANIZATION-ORGANIZATION-ORGANIZATION-ORGANIZATION-ORGANIZATION,PRON,PROPN-PART-PROPN-PROPN-PROPN-PART-PROPN-PROPN,nsubj,poss-case-compound-compound-poss-case-compound-pobj,PRP,NNP-POS-NNP-NNP-NNPS-POS-NNP-NNP,10,1
11835,56177.0,38,come,6,4,10,6,3,27,2,4,FMF,Foreign Military Construction Sales and Military Assistance Facts,ORGANIZATION,ORGANIZATION-ORGANIZATION-ORGANIZATION-ORGANIZATION-ORGANIZATION-ORGANIZATION-ORGANIZATION-ORGANIZATION,PROPN,PROPN-PROPN-PROPN-PROPN-CCONJ-PROPN-PROPN-PROPN,pobj,compound-compound-compound-conj-cc-compound-compound-conj,NNP,NNP-NNP-NNP-NNPS-CC-NNP-NNP-NNPS,7,1
11836,56179.0,33,said,15,30,17,-13,29,15,-15,2,St. Anselm College,Paul Christopher Manuel,ORGANIZATION-ORGANIZATION-ORGANIZATION,PERSON-PERSON-PERSON,PROPN-PROPN-PROPN,PROPN-PROPN-PROPN,compound-compound-pobj,compound-compound-nsubj,NNP-NNP-NNP,NNP-NNP-NNP,7,1
11837,56185.0,35,has,2,8,19,11,7,15,-6,17,China FAW Group,FAW-Volkswagen Automobile Co.,ORGANIZATION-ORGANIZATION-ORGANIZATION,ORGANIZATION-ORGANIZATION-ORGANIZATION,PROPN-PROPN-PROPN,PROPN-PROPN-PROPN,compound-compound-pobj,compound-compound-conj,NNP-NNP-NNP,NNP-NNP-NNP,5,1
11838,56192.0,16,served,3,1,12,11,0,3,2,9,Yoadimnadji,Independent National Electoral Commission,PERSON,ORGANIZATION-ORGANIZATION-ORGANIZATION-ORGANIZATION,NOUN,PROPN-PROPN-PROPN-PROPN,nsubj,compound-compound-compound-pobj,NNS,NNP-NNP-NNP-NNP,7,1
11839,56211.0,60,confesses,28,12,15,3,11,44,16,-13,Donald Wildmon,executive director,PERSON-PERSON,TITLE-TITLE,PROPN-PROPN,ADJ-NOUN,compound-appos,amod-appos,NNP-NNP,JJ-NN,1,1
11840,56215.0,24,sued,16,21,18,-3,20,5,-5,2,Samsung,South Korea,ORGANIZATION,COUNTRY-COUNTRY,PROPN,PROPN-PROPN,dobj,compound-poss,NNP,NNP-NNP,3,1
11841,56481.0,32,is,18,11,13,2,10,18,7,-5,Samsung,South Korea,ORGANIZATION,COUNTRY-COUNTRY,PROPN,PROPN-PROPN,conj,compound-pobj,NNP,NNP-NNP,1,1
11842,63536.0,35,making,18,1,15,14,0,19,17,-3,Samsung,South Korea,ORGANIZATION,COUNTRY-COUNTRY,PROPN,PROPN-PROPN,nsubj,compound-pobj,NNP,NNP-NNP,7,1
11843,56216.0,42,said,23,32,25,-7,31,16,-9,2,Professional Rodeo Cowboys Association,Karl Stressman,ORGANIZATION-ORGANIZATION-ORGANIZATION-ORGANIZATION,PERSON-PERSON,PROPN-PROPN-PROPN-PROPN,PROPN-PROPN,compound-compound-compound-pobj,compound-nsubj,NNP-NNP-NNPS-NNP,NNP-NNP,4,1
11844,56218.0,42,reported,40,14,33,19,13,8,26,-7,DeGeneres,Beverly Hills,PERSON,CITY-CITY,PROPN,PROPN-PROPN,appos,compound-compound,NNP,NNP-NNP,9,1
11845,56226.0,13,APA,1,2,5,3,1,7,-1,4,APA,American Paedophile Association,ORGANIZATION,ORGANIZATION-ORGANIZATION-ORGANIZATION,PROPN,PROPN-PROPN-PROPN,ROOT,compound-compound-appos,NNP,NNP-NNP-NNP,3,1
11846,56241.0,15,fits,11,2,6,4,1,8,9,-5,Kate Gosselin,America,PERSON-PERSON,COUNTRY,PROPN-PROPN,PROPN,compound-nsubj,poss,NNP-NNP,NNP,3,1
11847,56263.0,44,banned,9,1,4,3,0,39,8,-5,Lashkar-e-Taiba,Army of the Pious,ORGANIZATION,ORGANIZATION-ORGANIZATION-ORGANIZATION-ORGANIZATION,ADV,PROPN-ADP-DET-PROPN,nsubjpass,conj-prep-det-pobj,RB,NNP-IN-DT-NNP,2,1
11848,66947.0,42,fought,4,31,38,7,30,3,-27,34,Lashkar-e-Taiba,Army of the Pious,ORGANIZATION,ORGANIZATION-ORGANIZATION-ORGANIZATION-ORGANIZATION,PROPN,PROPN-ADP-DET-PROPN,compound,dobj-prep-det-pobj,NNP,NNP-IN-DT-NNP,-1,1
11849,56279.0,52,said,8,33,24,-9,32,27,-25,16,International Monetary Fund,Afghanistan,ORGANIZATION-ORGANIZATION-ORGANIZATION,COUNTRY,PROPN-PROPN-PROPN,PROPN,compound-compound-compound,nsubj,NNP-NNP-NNP,NNP,5,1
11850,56297.0,42,is,4,19,30,11,18,11,-15,26,ITOCHU Corp,BSP,ORGANIZATION-ORGANIZATION,ORGANIZATION,PROPN-PROPN,PROPN,compound-conj,nsubj,NNP-NNP,NNP,5,1
11851,56305.0,75,survived,26,2,21,19,1,53,24,-5,Deaver,San Jose State College,PERSON,ORGANIZATION-ORGANIZATION-ORGANIZATION-ORGANIZATION,PROPN,PROPN-PROPN-PROPN-PROPN,nsubjpass,compound-compound-compound-pobj,NNP,NNP-NNP-NNP-NNP,6,1
11852,56324.0,24,Posted,0,8,13,5,7,10,-8,13,National Christmas Tree Association,www.christmastree.org,ORGANIZATION-ORGANIZATION-ORGANIZATION-ORGANIZATION,URL,PROPN-PROPN-PROPN-PROPN,PROPN,compound-compound-compound-pobj,compound,NNP-NNP-NNP-NNP,NNP,-1,1
11853,56329.0,45,born,4,2,13,11,1,31,2,9,Emmanuel Peterson,Montreal,PERSON-PERSON,CITY,PROPN-PROPN,PROPN,compound-nsubjpass,pobj,NNP-NNP,NNP,2,1
11854,56334.0,31,came,2,7,5,-2,6,25,-5,3,Crown Prosecution Service,England,ORGANIZATION-ORGANIZATION-ORGANIZATION,COUNTRY,PROPN-PROPN-PROPN,PROPN,compound-compound-compound,poss,NNP-NNP-NNP,NNP,3,1
11855,56339.0,62,provided,2,1,6,5,0,55,1,4,George Boyd,Peterborough,PERSON-PERSON,CITY,PROPN-PROPN,PROPN,compound-nsubj,compound,NNP-NNP,NNP,2,1
11856,56343.0,79,survived,8,7,20,13,6,58,1,12,Meskill,Maureen Heneghan,PERSON,PERSON-PERSON,PROPN,PROPN-PROPN,nsubjpass,compound-conj,NNP,NNP-NNP,5,1
11857,56344.0,23,make,11,1,16,15,0,6,10,5,ITW,FNI Ltd,ORGANIZATION,ORGANIZATION-ORGANIZATION,PROPN,PROPN-PROPN,nsubj,compound-pobj,NNP,NNP-NNP,4,1
11858,56360.0,27,registered,14,7,10,3,6,16,7,-4,Chunghwa Telecom,Investment Department,ORGANIZATION-ORGANIZATION,ORGANIZATION-ORGANIZATION,PROPN-PROPN,PROPN-PROPN,compound-poss,compound-pobj,NNP-NNP,NNP-NNP,3,1
11859,56368.0,21,operates,12,7,20,13,6,0,5,8,Jackson Hewitt,Atlanta,ORGANIZATION-ORGANIZATION,CITY,PROPN-PROPN,PROPN,compound-compound,pobj,NNP-NNP,NNP,5,1
11860,56392.0,16,is,5,14,1,-13,13,14,-9,-4,CNAC,Dragonair,ORGANIZATION,ORGANIZATION,PROPN,PROPN,compound,poss,NNP,NNP,5,1
11861,56397.0,27,had,5,24,5,-19,23,21,-19,0,Joel Buchwald,he,PERSON-PERSON,PERSON,PROPN-PROPN,PRON,compound-nsubj,nsubj,NNP-NNP,PRP,-1,1
11862,56410.0,45,agreed,14,18,21,3,17,23,-4,7,Black,media executive,PERSON,TITLE-TITLE,PROPN,NOUN-NOUN,dobj,compound-appos,NNP,NN-NN,2,1
11863,56411.0,24,dropped,15,3,3,0,2,20,12,-12,NFC South,NFC,ORGANIZATION-ORGANIZATION,ORGANIZATION,PROPN-PROPN,PROPN,compound-compound,compound,NNP-NNP,NNP,0,1
11864,56441.0,24,born,5,1,10,9,0,13,4,5,Jefferson Joseph DeBlanc Sr.,La.,PERSON-PERSON-PERSON-PERSON,STATE_OR_PROVINCE,PROPN-PROPN-PROPN-PROPN,PROPN,compound-compound-compound-nsubjpass,appos,NNP-NNP-NNP-NNP,NNP,5,1
11865,56455.0,22,told,1,18,13,-5,17,8,-17,12,he,her,PERSON,PERSON,PRON,PRON,nsubj,dobj,PRP,PRP,7,1
11866,65779.0,11,thinks,2,4,9,5,3,1,-2,7,he,her,PERSON,PERSON,PRON,PRON,nsubj,pobj,PRP,PRP,4,1
11867,56460.0,49,helped,27,1,7,6,0,41,26,-20,Randall Forsberg,typist,PERSON-PERSON,TITLE,PROPN-PROPN,NOUN,compound-nsubj,pobj,NNP-NNP,NN,4,1
11868,56461.0,34,turned,6,9,31,22,8,2,-3,25,him,Sandy,PERSON,PERSON,PRON,PROPN,pobj,appos,PRP,NNP,7,1
11869,56463.0,47,spent,7,35,42,7,34,4,-28,35,Kerry,commander,PERSON,TITLE,PROPN,NOUN,poss,pobj,NNP,NN,6,1
11870,56484.0,41,was,2,31,35,4,30,5,-29,33,Dennis Dunn,chairman,PERSON-PERSON,TITLE,PROPN-PROPN,NOUN,compound-appos,attr,NNP-NNP,NN,2,1
11871,56490.0,51,be,8,32,15,-17,31,35,-24,7,Jennifer Dunn,director,PERSON-PERSON,TITLE,PROPN-PROPN,NOUN,compound-conj,appos,NNP-NNP,NN,4,1
11872,56492.0,19,went,1,1,10,9,0,8,0,9,Hawkins,University of California,PERSON,ORGANIZATION-ORGANIZATION-ORGANIZATION,PROPN,PROPN-ADP-PROPN,nsubj,pobj-prep-pobj,NNP,NNP-IN-NNP,5,1
11873,56507.0,24,say,8,10,13,3,9,10,-2,5,his,Freddie Mac,PERSON,ORGANIZATION-ORGANIZATION,DET,PROPN-PROPN,poss,compound-pobj,PRP$,NNP-NNP,2,1
11874,56516.0,6,disbanded,2,1,5,4,0,0,1,3,It,2003,ORGANIZATION,DATE,PRON,NUM,nsubjpass,pobj,PRP,CD,2,1
11875,56534.0,42,died,34,1,36,35,0,5,33,2,Teddy Kollek,Tuesday,PERSON-PERSON,DATE,PROPN-PROPN,PROPN,compound-nsubj,npadvmod,NNP-NNP,NNP,2,1
11876,56551.0,21,convicted,3,1,6,5,0,14,2,3,Abdul Rahim,assault,PERSON-PERSON,CRIMINAL_CHARGE,PROPN-PROPN,NOUN,compound-nsubjpass,pobj,NNP-NNP,NN,2,1
11877,56574.0,24,born,4,1,7,6,0,16,3,3,Catherine Gertrude Roraback,Brooklyn,PERSON-PERSON-PERSON,CITY,PROPN-PROPN-PROPN,PROPN,compound-compound-nsubjpass,pobj,NNP-NNP-NNP,NNP,3,1
11878,56590.0,34,died,28,1,5,4,0,28,27,-23,Vernon Bellecourt,Ojibwa,PERSON-PERSON,NATIONALITY,PROPN-PROPN,PROPN,compound-nsubj,compound,NNP-NNP,NNP,1,1
11879,56596.0,19,married,5,7,6,-1,6,12,-2,1,Gunnar Forsberg,married,PERSON-PERSON,PERSON,PROPN-PROPN,VERB,compound-dobj,ROOT,NNP-NNP,VBD,1,1
11880,56615.0,48,takes,2,2,13,11,1,34,0,11,Perle,Los Angeles,PERSON,CITY-CITY,PROPN,PROPN-PROPN,nsubj,compound-pobj,NNP,NNP-NNP,3,1
11881,56629.0,33,show,11,8,1,-7,7,31,3,-10,NSG,Japan,ORGANIZATION,ORGANIZATION,PROPN,PROPN,pobj,nsubj,NNP,NNP,3,1
11882,56636.0,20,was,3,12,15,3,11,4,-9,12,him,Santa Clara County Republican Party,PERSON,ORGANIZATION-ORGANIZATION-ORGANIZATION-ORGANIZATION-ORGANIZATION,PRON,PROPN-PROPN-PROPN-PROPN-PROPN,dobj,compound-compound-compound-compound-pobj,PRP,NNP-NNP-NNP-NNP-NNP,3,1
11883,56639.0,5,Kerry,0,1,3,2,0,1,-1,3,Kerry,Iraq,PERSON,COUNTRY,PROPN,PROPN,ROOT,pobj,NNP,NNP,3,1
11884,56647.0,46,Labels,0,37,44,7,36,1,-37,44,Focus On The Family,Alexey Ledyaev,ORGANIZATION-ORGANIZATION-ORGANIZATION-ORGANIZATION,PERSON-PERSON,PROPN-ADP-DET-PROPN,PROPN-PROPN,pobj-prep-det-pobj,compound-dobj,NNP-IN-DT-NNP,NNP-NNP,4,1
11885,56669.0,38,'s,2,2,33,31,1,4,0,31,She,her,PERSON,PERSON,PRON,DET,nsubj,poss,PRP,PRP$,6,1
11886,56675.0,34,Jr,3,1,33,32,0,0,2,30,Harry S Dent,SC,PERSON-PERSON-PERSON,STATE_OR_PROVINCE,PROPN-PROPN-PROPN,PROPN,compound-compound-compound,npadvmod,NNP-NNP-NNP,NNP,3,1
11887,56695.0,21,announced,3,7,10,3,6,10,-4,7,Lou Ferrara,the AP,PERSON-PERSON,ORGANIZATION-ORGANIZATION,PROPN-PROPN,DET-PROPN,compound-pobj,det-poss,NNP-NNP,DT-NNP,2,1
11888,56720.0,36,are,2,12,15,3,11,20,-10,13,Holly,Colorado,PERSON,STATE_OR_PROVINCE,PROPN,PROPN,nsubj,pobj,NNP,NNP,3,1
11889,56724.0,25,born,3,1,22,21,0,2,2,19,Raul Castro,University of Havana,PERSON-PERSON,ORGANIZATION-ORGANIZATION-ORGANIZATION,PROPN-PROPN,PROPN-ADP-PROPN,compound-nsubjpass,conj-prep-pobj,NNP-NNP,NNP-IN-NNP,6,1
11890,56727.0,41,*,0,17,14,-3,16,26,-17,14,AMA,Monitoring Authority,ORGANIZATION,ORGANIZATION-ORGANIZATION,PROPN,PROPN-PROPN,compound,compound-conj,NNP,NNP-NNP,3,1
11891,56732.0,44,said,16,22,12,-10,21,31,-6,-4,he,Institute of Respiratory Diseases,PERSON,ORGANIZATION-ORGANIZATION-ORGANIZATION-ORGANIZATION,PRON,PROPN-ADP-PROPN-PROPN,nsubj,pobj-prep-compound-pobj,PRP,NNP-IN-NNP-NNPS,6,1
11892,56733.0,25,bail,7,21,23,2,20,1,-14,16,ABC,Cameron,ORGANIZATION,PERSON,PROPN,PROPN,poss,nsubj,NNP,NNP,1,1
11893,56739.0,39,encouraging,26,5,14,9,4,24,21,-12,Philadelphia Inquirer,Brian P Tierney,ORGANIZATION-ORGANIZATION,PERSON-PERSON-PERSON,PROPN-PROPN,PROPN-PROPN-PROPN,nmod-dobj,compound-compound-nsubj,NNP-NNP,NNP-NNP-NNP,6,1
11894,56747.0,34,born,4,26,7,-19,25,26,-22,3,Tema Sloven Kaiser,Brooklyn,PERSON-PERSON-PERSON,CITY,PROPN-PROPN-PROPN,PROPN,compound-compound-conj,pobj,NNP-NNP-NNP,NNP,10,1
11895,56761.0,26,member,5,8,1,-7,7,24,-3,-4,Pennsylvania State House of Representatives,Joseph Kolter,ORGANIZATION-ORGANIZATION-ORGANIZATION-ORGANIZATION-ORGANIZATION,PERSON-PERSON,PROPN-PROPN-PROPN-ADP-PROPN,PROPN-PROPN,compound-compound-pobj-prep-pobj,compound-compound,NNP-NNP-NNP-IN-NNPS,NNP-NNP,4,1
11896,56767.0,13,worked,1,1,4,3,0,8,0,3,Dent,Gerald Ford 's presidential campaign,PERSON,ORGANIZATION-ORGANIZATION-ORGANIZATION-ORGANIZATION-ORGANIZATION,PROPN,PROPN-PROPN-PART-ADJ-NOUN,nsubj,compound-poss-case-amod-pobj,NNP,NNP-NNP-POS-JJ-NN,3,1
11897,56768.0,28,said,11,24,13,-11,23,14,-13,2,Inter American Press Association,Gonzalo Marroquin,ORGANIZATION-ORGANIZATION-ORGANIZATION-ORGANIZATION,PERSON-PERSON,PROPN-PROPN-PROPN-PROPN,PROPN-PROPN,compound-compound-compound-pobj,compound-nsubj,NNP-NNP-NNP-NNP,NNP-NNP,7,1
11898,56784.0,25,highlighted,12,5,1,-4,4,23,7,-11,IMF,Mark Plant,ORGANIZATION,PERSON-PERSON,PROPN,PROPN-PROPN,poss,compound-nsubj,NNP,NNP-NNP,3,1
11899,56790.0,52,died,37,1,24,23,0,27,36,-13,Pamela Gardner Ahearn,State Department,PERSON-PERSON-PERSON,ORGANIZATION-ORGANIZATION,PROPN-PROPN-PROPN,PROPN-PROPN,compound-compound-nsubj,compound-poss,NNP-NNP-NNP,NNP-NNP,7,1
11900,56801.0,33,said,15,24,17,-7,23,15,-9,2,New Hampshire Institute of Politics,Paul Christopher Manuel,ORGANIZATION-ORGANIZATION-ORGANIZATION-ORGANIZATION-ORGANIZATION,PERSON-PERSON-PERSON,PROPN-PROPN-PROPN-ADP-PROPN,PROPN-PROPN-PROPN,compound-compound-pobj-prep-pobj,compound-compound-nsubj,NNP-NNP-NNP-IN-NNP,NNP-NNP-NNP,6,1
11901,56807.0,48,is,11,29,2,-27,28,45,-18,-9,Kelly Cutrone,Kell,PERSON-PERSON,PERSON,PROPN-PROPN,PROPN,compound-appos,nsubj,NNP-NNP,NNP,6,1
11902,56810.0,19,said,17,16,14,-2,15,4,1,-3,Li Jie,Chinese captain,PERSON-PERSON,TITLE-TITLE,PROPN-PROPN,ADJ-NOUN,compound-nsubj,amod-compound,NNP-NNP,JJ-NN,1,1
11903,56817.0,34,said,29,24,28,4,23,5,5,-1,Carnival,Gerry Cahill,ORGANIZATION,PERSON-PERSON,ADJ,PROPN-PROPN,compound,compound-nsubj,JJ,NNP-NNP,3,1
11904,58891.0,30,said,13,7,1,-6,6,28,6,-12,Carnival,Gerry Cahill,ORGANIZATION,PERSON-PERSON,PROPN,PROPN-PROPN,compound,compound-nsubj,NNP,NNP-NNP,4,1
11905,56839.0,39,died,29,1,36,35,0,2,28,7,Michael K. Deaver,Bethesda,PERSON-PERSON-PERSON,CITY,PROPN-PROPN-PROPN,PROPN,compound-compound-nsubj,pobj,NNP-NNP-NNP,NNP,7,1
11906,56843.0,37,head,6,4,8,4,3,28,2,2,International Monetary Fund,Dominique Strauss-Kahn,ORGANIZATION-ORGANIZATION-ORGANIZATION,PERSON-PERSON,PROPN-PROPN-PROPN,PROPN-PROPN,compound-compound-compound,nsubj-punct,NNP-NNP-NNP,NNP-NNP,5,1
11907,56859.0,30,said,25,20,14,-6,19,15,5,-11,Federal Motor Carrier Safety Administration,Anne Ferro,ORGANIZATION-ORGANIZATION-ORGANIZATION-ORGANIZATION-ORGANIZATION,PERSON-PERSON,PROPN-PROPN-PROPN-PROPN-PROPN,PROPN-PROPN,compound-compound-compound-compound-pobj,compound-nsubj,NNP-NNP-NNP-NNP-NNP,NNP-NNP,5,1
11908,56863.0,29,led,2,1,10,9,0,18,1,8,Chavez,lieutenant colonel,PERSON,TITLE-TITLE,PROPN,NOUN-NOUN,nsubj,compound-pobj,NNP,NN-NN,5,1
11909,56872.0,46,said,16,26,18,-8,25,27,-10,2,Paralyzed Veterans of America,Jim Dudley,ORGANIZATION-ORGANIZATION-ORGANIZATION-ORGANIZATION,PERSON-PERSON,PROPN-PROPN-ADP-PROPN,PROPN-PROPN,compound-pobj-prep-pobj,compound-nsubj,NNP-NNPS-IN-NNP,NNP-NNP,5,1
11910,56873.0,44,said,3,42,18,-24,41,25,-39,15,FAA,Federal Aviation Administration,ORGANIZATION,ORGANIZATION-ORGANIZATION-ORGANIZATION,PROPN,PROPN-PROPN-PROPN,compound,compound-compound-pobj,NNP,NNP-NNP-NNP,11,1
11911,56875.0,29,announced,27,18,25,7,17,3,9,-2,International Monetary Fund,Christian Muwssen,ORGANIZATION-ORGANIZATION-ORGANIZATION,PERSON-PERSON,PROPN-PROPN-PROPN,PROPN-PROPN,compound-compound-compound,compound-nsubj,NNP-NNP-NNP,NNP-NNP,4,1
11912,56883.0,28,denounces,1,7,11,4,6,16,-6,10,Federal Election Commission,http://wwwfecorg/,ORGANIZATION-ORGANIZATION-ORGANIZATION,URL,PROPN-PROPN-PROPN,PUNCT,compound-compound-advcl,ROOT,NNP-NNP-NNP,.,-1,1
11913,56891.0,52,live,5,3,8,5,2,43,2,3,she,Colorado,PERSON,STATE_OR_PROVINCE,PRON,PROPN,nsubj,pobj,PRP,NNP,3,1
11914,56906.0,46,announce,11,14,3,-11,13,42,-3,-8,he,assistant,PERSON,TITLE,PRON,NOUN,nsubj,appos,PRP,NN,5,1
11915,56940.0,25,said,11,20,13,-7,19,11,-9,2,American Bankers Association,Joseph Pigg,ORGANIZATION-ORGANIZATION-ORGANIZATION,PERSON-PERSON,PROPN-PROPN-PROPN,PROPN-PROPN,compound-compound-pobj,compound-nsubj,NNP-NNPS-NNP,NNP-NNP,5,1
11916,56943.0,24,said,22,17,19,2,16,4,5,-3,Spelman,Beverly Daniel Tatum,ORGANIZATION,PERSON-PERSON-PERSON,PROPN,PROPN-PROPN-PROPN,pobj,compound-compound-appos,NNP,NNP-NNP-NNP,4,1
11917,56946.0,47,told,11,14,34,20,13,12,-3,23,David Gregory,Congressman,PERSON-PERSON,ORGANIZATION,PROPN-PROPN,PROPN,compound-dobj,pobj,NNP-NNP,NNP,9,1
11918,56953.0,34,was,1,1,22,21,0,11,0,21,Roraback,Black Panther,PERSON,LOCATION-LOCATION,PROPN,PROPN-PROPN,nsubj,compound-compound,NNP,NNP-NNP,6,1
11919,56954.0,21,believe,2,6,8,2,5,12,-4,6,Lashkar-e-Taiba,Yusuf Muzammil,ORGANIZATION,PERSON-PERSON,PROPN,PROPN-PROPN,compound,compound-nsubj,NNP,NNP-NNP,2,1
11920,56961.0,29,served,14,11,21,10,10,7,3,7,Abu Zubaydah,forger,PERSON-PERSON,TITLE,PROPN-PROPN,NOUN,compound-nsubj,pobj,NNP-NNP,NN,4,1
11921,56969.0,48,made,11,23,26,3,22,21,-12,15,John Kerry,Vietnam Veterans Against the War,PERSON-PERSON,ORGANIZATION-ORGANIZATION-ORGANIZATION-ORGANIZATION-ORGANIZATION,PROPN-PROPN,PROPN-PROPN-ADP-DET-PROPN,compound-pobj,compound-pobj-prep-det-pobj,NNP-NNP,NNP-NNP-IN-DT-NNP,2,1
11922,56978.0,25,founded,13,13,23,10,12,1,0,10,firm,Clifford Asness,ORGANIZATION,PERSON-PERSON,NOUN,PROPN-PROPN,nsubj,compound-pobj,NN,NNP-NNP,2,1
11923,57002.0,33,sentenced,4,3,12,9,2,20,1,8,al-Khawinay,supporting the country 's minority Shiite rebels,PERSON,CRIMINAL_CHARGE-CRIMINAL_CHARGE-CRIMINAL_CHARGE-CRIMINAL_CHARGE-CRIMINAL_CHARGE-CRIMINAL_CHARGE-CRIMINAL_CHARGE,PRON,VERB-DET-NOUN-PART-NOUN-ADJ-NOUN,nsubjpass,pcomp-det-poss-case-nmod-amod-dobj,PRP,VBG-DT-NN-POS-NN-JJ-NNS,3,1
11924,57007.0,32,done,3,9,12,3,8,19,-6,9,Li Jie,chief executive officer,PERSON-PERSON,TITLE-TITLE-TITLE,PROPN-PROPN,ADJ-ADJ-NOUN,compound-pobj,amod-amod-appos,NNP-NNP,JJ-JJ-NN,2,1
11925,66352.0,31,planned,11,1,7,6,0,23,10,-4,Li Jie,chief executive officer,PERSON-PERSON,TITLE-TITLE-TITLE,PROPN-PROPN,ADJ-ADJ-NOUN,compound-nsubj,amod-amod-appos,NNP-NNP,JJ-JJ-NN,2,1
11926,57011.0,55,Washington,0,16,38,22,15,16,-16,38,Burns,State Department,PERSON,ORGANIZATION-ORGANIZATION,PROPN,PROPN-PROPN,nsubj,compound-nsubj,NNP,NNP-NNP,3,1
11927,57014.0,48,died,37,1,45,44,0,2,36,8,Carolyn Goodman,Upper West Side,PERSON-PERSON,LOCATION-LOCATION-LOCATION,PROPN-PROPN,PROPN-PROPN-PROPN,compound-nsubj,compound-compound-pobj,NNP-NNP,NNP-NNP-NNP,7,1
11928,57016.0,22,was,16,12,8,-4,11,13,4,-8,DCR,2003,ORGANIZATION,DATE,PROPN,NUM,dobj,pobj,NNP,CD,4,1
11929,57022.0,37,received,12,24,19,-5,23,17,-12,7,Simon Cowell,judges,PERSON-PERSON,TITLE,PROPN-PROPN,NOUN,compound-nsubj,pobj,NNP-NNP,NNS,3,1
11930,57091.0,40,pay,16,7,34,27,6,5,9,18,Johnny Knoxville,fraud,PERSON-PERSON,CRIMINAL_CHARGE,PROPN-PROPN,NOUN,compound-nsubj,dobj,NNP-NNP,NN,5,1
11931,57092.0,44,chose,22,17,22,5,16,21,5,0,32-year-old,Texas,PERSON,STATE_OR_PROVINCE,NUM,PROPN,nummod,nsubj,CD,NNP,4,1
11932,57101.0,47,Jr,2,1,34,33,0,12,1,32,Jefferson DeBlanc,Barbara DeBlanc Romero,PERSON-PERSON,PERSON-PERSON-PERSON,PROPN-PROPN,PROPN-PROPN-PROPN,compound-compound,compound-compound-conj,NNP-NNP,NNP-NNP-NNP,5,1
11933,57112.0,18,said,16,9,2,-7,8,15,7,-14,his,Rep.,PERSON,TITLE,DET,PROPN,poss,compound,PRP$,NNP,4,1
11934,57117.0,22,said,18,9,1,-8,8,20,9,-17,Asian Development Bank,Georgia,ORGANIZATION-ORGANIZATION-ORGANIZATION,ORGANIZATION,PROPN-PROPN-PROPN,PROPN,compound-compound-pobj,nsubj,NNP-NNP-NNP,NNP,5,1
11935,57119.0,27,went,1,1,16,15,0,10,0,15,Dent,George Washington University,PERSON,ORGANIZATION-ORGANIZATION-ORGANIZATION,PROPN,PROPN-PROPN-PROPN,nsubj,compound-compound-pobj,NNP,NNP-NNP-NNP,4,1
11936,57139.0,31,seen,2,1,12,11,0,18,1,10,She,Ronan,PERSON,PERSON,PRON,PROPN,nsubjpass,appos,PRP,NNP,7,1
11937,57160.0,40,said,6,6,3,-3,5,36,0,-3,Carson,U.S.,PERSON,COUNTRY,PROPN,PROPN,nsubj,compound,NNP,NNP,2,1
11938,57161.0,22,said,7,18,9,-9,17,12,-11,2,U.S. Army Medical Command,Cynthia Vaughn,ORGANIZATION-ORGANIZATION-ORGANIZATION-ORGANIZATION,PERSON-PERSON,PROPN-PROPN-PROPN-PROPN,PROPN-PROPN,compound-compound-compound-pobj,compound-nsubj,NNP-NNP-NNP-NNP,NNP-NNP,4,1
11939,57166.0,33,think,22,18,25,7,17,7,4,3,Ellen DeGeneres,Judge,PERSON-PERSON,TITLE,PROPN-PROPN,PROPN,compound-conj,compound,NNP-NNP,NNP,12,1
11940,57171.0,36,deblanc,10,9,18,9,8,17,1,8,Jefferson J. deblanc Sr.,Marine Corps,PERSON-PERSON-PERSON-PERSON,ORGANIZATION-ORGANIZATION,PROPN-PROPN-NOUN-PROPN,PROPN-PROPN,compound-nsubj-ROOT-dobj,compound-compound,NNP-NNP-NN-NNP,NNP-NNP,6,1
11941,57194.0,45,said,25,1,14,13,0,30,24,-11,Representative,"Joint Committee on the Environment , Natural Resources , and Agriculture",ORGANIZATION,ORGANIZATION-ORGANIZATION-ORGANIZATION-ORGANIZATION-ORGANIZATION-ORGANIZATION-ORGANIZATION-ORGANIZATION-ORGANIZATION-ORGANIZATION-ORGANIZATION,PROPN,PROPN-PROPN-ADP-DET-PROPN-PUNCT-PROPN-PROPN-PUNCT-CCONJ-PROPN,compound,compound-pobj-prep-det-pobj-punct-compound-conj-punct-cc-conj,NNP,"NNP-NNP-IN-DT-NNP-,-NNP-NNPS-,-CC-NNP",6,1
11942,57200.0,44,chose,22,16,20,4,15,23,6,-2,the 32-year-old pilot,Denton,PERSON-PERSON-PERSON,CITY,DET-NUM-NOUN,PROPN,det-nummod-nsubj,pobj,DT-CD-NN,NNP,2,1
11943,57213.0,21,required,4,8,16,8,7,4,-4,12,Al,Jared,PERSON,PERSON,PROPN,PROPN,pobj,appos,NNP,NNP,5,1
11944,57217.0,49,IN,0,36,3,-33,35,45,-36,3,him,EVERGLADES,PERSON,LOCATION,PRON,PROPN,dative,pobj,PRP,NNP,9,1
11945,57238.0,17,had,6,8,5,-3,7,11,-2,-1,his,46,PERSON,NUMBER,DET,NUM,poss,appos,PRP$,CD,3,1
11946,57245.0,31,battled,7,9,30,21,8,0,-2,23,Mahdi,Baghdad,PERSON,CITY,PROPN,PROPN,compound,pobj,NNP,NNP,4,1
11947,57259.0,33,said,13,6,12,6,5,20,7,-1,CNAC,Cathay Pacific,ORGANIZATION,ORGANIZATION-ORGANIZATION,NOUN,PROPN-PROPN,dobj,compound-nsubj,NN,NNP-NNP,8,1
11948,57298.0,20,feeling,3,1,18,17,0,1,2,15,She,Martin King,PERSON,PERSON-PERSON,PRON,PROPN-PROPN,nsubj,compound-conj,PRP,NNP-NNP,7,1
11949,57306.0,47,died,40,1,44,43,0,2,39,4,Catherine Roraback,Salisbury,PERSON-PERSON,CITY,PROPN-PROPN,PROPN,compound-nsubj,pobj,NNP-NNP,NNP,4,1
11950,64944.0,47,died,40,1,44,43,0,2,39,4,Catherine Roraback,Salisbury,PERSON-PERSON,CITY,PROPN-PROPN,PROPN,compound-nsubj,pobj,NNP-NNP,NNP,4,1
11951,57310.0,33,is,1,11,24,13,10,8,-10,23,Ali Khamenei,Supreme National Security Council,PERSON-PERSON,ORGANIZATION-ORGANIZATION-ORGANIZATION-ORGANIZATION,PROPN-PROPN,PROPN-PROPN-PROPN-PROPN,compound-pobj,compound-compound-compound-pobj,NNP-NNP,NNP-NNP-NNP-NNP,10,1
11952,57317.0,54,survived,2,47,51,4,46,2,-45,49,Charles Kaiser,author,PERSON-PERSON,TITLE,PROPN-PROPN,NOUN,compound-conj,appos,NNP-NNP,NN,2,1
11953,57319.0,13,became,9,3,3,0,2,9,6,-6,Richmond Jr.,Richmond III,PERSON-PERSON,PERSON-PERSON,PROPN-PROPN,PROPN-PROPN,compound-appos,compound-conj,NNP-NNP,NNP-NNP,0,1
11954,57337.0,50,CIR-GEEK-NOTES,0,36,49,13,35,0,-36,49,Pentax,iCall,ORGANIZATION,ORGANIZATION,PROPN,PROPN,pobj,appos,NNP,NNP,9,1
11955,57341.0,22,was,1,15,10,-5,14,11,-14,9,she,Northampton,PERSON,LOCATION,PRON,PROPN,nsubj,pobj,PRP,NNP,4,1
11956,57346.0,24,comes,7,3,7,4,2,16,4,0,Malaney,GMA,PERSON,ORGANIZATION,PROPN,PROPN,poss,pobj,NNP,NNP,4,1
11957,57366.0,34,headed,4,18,17,-1,17,16,-14,13,Central American Parliament,Guatemala-based,ORGANIZATION-ORGANIZATION-ORGANIZATION,COUNTRY,PROPN-PROPN-PROPN,ADJ,compound-compound-pobj,amod,NNP-NNP-NNP,JJ,1,1
11958,57371.0,34,urged,9,22,3,-19,21,30,-13,-6,her,Speaker,PERSON,TITLE,DET,PROPN,poss,compound,PRP$,NNP,6,1
11959,57448.0,30,said,8,7,4,-3,6,25,1,-4,Medina hospital,Mogadishu,ORGANIZATION-ORGANIZATION,CITY,PROPN-NOUN,PROPN,compound-pobj,poss,NNP-NN,NNP,2,1
11960,58014.0,45,NAIROBI,0,12,15,3,11,29,-12,15,Medina hospital,Mogadishu,ORGANIZATION-ORGANIZATION,CITY,PROPN-NOUN,PROPN,compound-pobj,pobj,NNP-NN,NNP,1,1
11961,57452.0,37,arrested,14,7,1,-6,6,35,7,-13,Scorpions,Gerrie Nel,ORGANIZATION,PERSON-PERSON,PROPN,PROPN-PROPN,pobj,compound-nsubjpass,NNPS,NNP-NNP,4,1
11962,57480.0,37,said,1,26,5,-21,25,31,-25,4,Lashkar-e-Taiba,Al-Qaeda,ORGANIZATION,LOCATION,PROPN,PROPN,appos,poss,NNP,NNP,9,1
11963,57483.0,25,left,16,4,9,5,3,15,12,-7,Dent,deacon,PERSON,TITLE,PROPN,NOUN,nsubj,appos,NNP,NN,4,1
11964,57487.0,28,told,6,22,14,-8,21,13,-16,8,Lashkar-e-Taiba,Zarar Shah,ORGANIZATION,PERSON-PERSON,PROPN,PROPN-PROPN,nmod,compound-dobj,NNP,NNP-NNP,5,1
11965,57504.0,28,employed,6,12,21,9,11,6,-6,15,her,Western College of Lothian,PERSON,ORGANIZATION-ORGANIZATION-ORGANIZATION-ORGANIZATION,DET,PROPN-PROPN-ADP-PROPN,poss,compound-pobj-prep-pobj,PRP$,NNP-NNP-IN-NNP,11,1
11966,57520.0,31,said,16,28,18,-10,27,12,-12,2,University of Haifa,Benny Pinkas,ORGANIZATION-ORGANIZATION-ORGANIZATION,PERSON-PERSON,PROPN-ADP-PROPN,PROPN-PROPN,pobj-prep-pobj,compound-nsubj,NNP-IN-NNP,NNP-NNP,3,1
11967,57522.0,45,demands,10,1,1,0,0,43,9,-9,Carnival Corp,Carnival Australia,ORGANIZATION-ORGANIZATION,ORGANIZATION-ORGANIZATION,PROPN-PROPN,PROPN-PROPN,compound-pobj,compound-nsubj,NNP-NNP,NNP-NNP,0,1
11968,57547.0,30,died,2,1,6,5,0,23,1,4,Robert Goodman,stroke,PERSON-PERSON,CAUSE_OF_DEATH,PROPN-PROPN,NOUN,compound-nsubj,pobj,NNP-NNP,NN,2,1
11969,57555.0,58,Council,2,1,8,7,0,49,1,6,Mainland Affairs Council,Chen Ming-tung,ORGANIZATION-ORGANIZATION-ORGANIZATION,PERSON-PERSON,PROPN-PROPN-PROPN,PROPN-PROPN,compound-compound-ROOT,compound-nsubj,NNP-NNPS-NNP,NNP-NNP,-1,1
11970,57562.0,31,set,4,2,28,26,1,2,2,24,Erika Rose,Infinity Le Monde,PERSON-PERSON,ORGANIZATION-ORGANIZATION-ORGANIZATION,PROPN-PROPN,PROPN-PROPN-PROPN,compound-nsubj,compound-compound-pobj,NNP-NNP,NNP-NNP-NNP,5,1
11971,57566.0,48,said,37,20,44,24,19,3,17,7,CNAC,Hong Kong,ORGANIZATION,CITY-CITY,PROPN,PROPN-PROPN,compound,compound-compound,NNP,NNP-NNP,-1,1
11972,57581.0,32,saw,6,8,22,14,7,9,-2,16,Raul Castro,Flea,PERSON-PERSON,PERSON,PROPN-PROPN,PROPN,compound-dobj,pobj,NNP-NNP,NNP,2,1
11973,57604.0,4,was,1,1,3,2,0,0,0,2,She,78,PERSON,NUMBER,PRON,NUM,nsubj,attr,PRP,CD,1,1
11974,57617.0,87,wrote,1,30,28,-2,29,58,-29,27,Bradford Washburn,photos,PERSON-PERSON,TITLE,PROPN-PROPN,NOUN,compound-pobj,pobj,NNP-NNP,NNS,2,1
11975,57624.0,12,pleaded,3,2,1,-1,1,10,1,-2,Brandon McInerney,Classmate,PERSON-PERSON,TITLE,PROPN-PROPN,PROPN,compound-nsubj,compound,NNP-NNP,NNP,1,1
11976,57651.0,24,heading,6,22,18,-4,21,5,-16,12,FAA,Federal Aviation Authority,ORGANIZATION,ORGANIZATION-ORGANIZATION-ORGANIZATION,PROPN,PROPN-PROPN-PROPN,compound,compound-compound-pobj,NNP,NNP-NNP-NNP,4,1
11977,57655.0,29,born,4,1,27,26,0,1,3,23,Philip Mayer Kaiser,Tema Kaiser,PERSON-PERSON-PERSON,PERSON-PERSON,PROPN-PROPN-PROPN,PROPN-PROPN,compound-compound-nsubjpass,compound-conj,NNP-NNP-NNP,NNP-NNP,8,1
11978,57658.0,36,highlights,1,34,20,-14,33,15,-33,19,Mia Farrow,Soon-Yi Previn,PERSON-PERSON,PERSON-PERSON,PROPN-PROPN,PROPN-PROPN,compound-appos,compound-pobj,NNP-NNP,NNP-NNP,5,1
11979,57661.0,10,ran,1,1,4,3,0,5,0,3,He,Congress,PERSON,ORGANIZATION,PRON,PROPN,nsubj,pobj,PRP,NNP,1,1
11980,57665.0,19,leave,6,12,9,-3,11,9,-6,3,Option One,Irvine,ORGANIZATION-ORGANIZATION,CITY,PROPN-NUM,PROPN,nmod-nummod,dobj,NNP-CD,NNP,3,1
11981,57693.0,35,holding,22,10,14,4,9,20,12,-8,Popular Resistance Committees,PRC,ORGANIZATION-ORGANIZATION-ORGANIZATION,ORGANIZATION,PROPN-PROPN-PROPN,PROPN,compound-compound-compound,compound,NNP-NNP-NNPS,NNP,3,1
11982,57696.0,14,Sr.,4,2,1,-1,1,12,2,-3,Jefferson J. DeBlanc,Colonel,PERSON-PERSON-PERSON,TITLE,PROPN-PROPN-PROPN,PROPN,compound-compound-compound,compound,NNP-NNP-NNP,NNP,2,1
11983,57699.0,38,Jamaat-ud-Dawa,0,9,3,-6,8,34,-9,3,Lashkar-e-Taiba,http://wwwjamatdawahorg/,ORGANIZATION,URL,PROPN,VERB,nsubj,ROOT,NNP,VB,-1,1
11984,57706.0,18,'s,11,4,9,5,3,8,7,-2,he,years,PERSON,DURATION,PRON,NOUN,nsubj,pobj,PRP,NNS,4,1
11985,57715.0,25,Duques,1,23,8,-15,22,16,-22,7,Hector Elizondo,drama,PERSON-PERSON,ORGANIZATION,PROPN-PROPN,NOUN,compound-conj,attr,NNP-NNP,NN,6,1
11986,57718.0,19,traded,2,16,1,-15,15,17,-14,-1,Golden Baseball League,He,ORGANIZATION-ORGANIZATION-ORGANIZATION,PERSON,PROPN-PROPN-PROPN,PRON,compound-compound-pobj,nsubjpass,NNP-NNP-NNP,PRP,6,1
11987,57735.0,25,appointed,2,1,16,15,0,8,1,14,DeBlanc,second lieutenant,PERSON,TITLE-TITLE,PROPN,ADJ-NOUN,nsubjpass,amod-pobj,NNP,JJ-NN,4,1
11988,57760.0,39,had,21,7,18,11,6,20,14,-3,Waldheim,ambassador,PERSON,TITLE,PROPN,NOUN,dobj,pobj,NNP,NN,7,1
11989,57761.0,30,accused,12,2,4,2,1,25,10,-8,Hussein Kamel,al - Majid,PERSON-PERSON,PERSON-PERSON-PERSON,PROPN-PROPN,PROPN-PUNCT-PROPN,compound-compound,compound-punct-poss,NNP-NNP,NNP-HYPH-NNP,2,1
11990,57770.0,41,PORT,0,18,12,-6,17,28,-18,12,United National Congress,Kamla Persad - Bissessar,ORGANIZATION-ORGANIZATION-ORGANIZATION,PERSON-PERSON-PERSON-PERSON,PROPN-PROPN-PROPN,PROPN-PROPN-PUNCT-PROPN,compound-compound-pobj,compound-compound-punct-nsubj,NNP-NNP-NNP,NNP-NNP-HYPH-NNP,4,1
11991,68081.0,32,won,12,9,3,-6,8,28,3,-9,United National Congress,Kamla Persad - Bissessar,ORGANIZATION-ORGANIZATION-ORGANIZATION,PERSON-PERSON-PERSON-PERSON,PROPN-PROPN-PROPN,PROPN-PROPN-PUNCT-PROPN,compound-compound-pobj,compound-compound-punct-nsubj,NNP-NNP-NNP,NNP-NNP-HYPH-NNP,4,1
11992,57780.0,54,was,16,1,45,44,0,8,15,29,Al-Tai,Iraqi Army 1st Corps,PERSON,ORGANIZATION-ORGANIZATION-ORGANIZATION-ORGANIZATION,PROPN,ADJ-PROPN-NOUN-PROPN,nsubj,compound-compound-compound-pobj,NNP,JJ-NNP-NN-NNP,7,1
11993,57787.0,36,TEHRAN,0,28,26,-2,27,9,-28,26,Gholam Ali Haddad Adel,Majlis Speaker,PERSON-PERSON-PERSON-PERSON,TITLE-TITLE,PROPN-PROPN-PROPN-PROPN,PROPN-PROPN,compound-compound-compound-nsubjpass,compound-compound,NNP-NNP-NNP-NNP,NNP-NNP,4,1
11994,57794.0,34,summoned,5,19,1,-18,18,32,-14,-4,Fidel Castro,Cuba,PERSON-PERSON,NATIONALITY,PROPN-PROPN,PROPN,compound-nsubj,poss,NNP-NNP,NNP,5,1
11995,57833.0,17,was,7,5,16,11,4,0,2,9,Dennis Dunn,Wash.,PERSON-PERSON,STATE_OR_PROVINCE,PROPN-PROPN,PROPN,compound-appos,appos,NNP-NNP,NNP,3,1
11996,57842.0,52,composed,4,15,36,21,14,15,-11,32,Paralyzed Veterans of America,Vietnam Veterans of America,ORGANIZATION-ORGANIZATION-ORGANIZATION-ORGANIZATION,ORGANIZATION-ORGANIZATION-ORGANIZATION-ORGANIZATION,PROPN-PROPN-ADP-PROPN,PROPN-PROPN-ADP-PROPN,compound-appos-prep-poss,compound-appos-prep-poss,NNP-NNPS-IN-NNP,NNP-NNP-IN-NNP,6,1
11997,57846.0,23,is,3,1,10,9,0,12,2,7,Hussein Kamel al-Majid,Republican Guards,PERSON-PERSON-PERSON,ORGANIZATION-ORGANIZATION,PROPN-PROPN-PROPN,PROPN-PROPN,compound-compound-nsubj,compound-pobj,NNP-NNP-NNP,NNP-NNPS,6,1
11998,57862.0,24,was,7,1,6,5,0,17,6,-1,Alice,Guy,PERSON,PERSON,PROPN,PROPN,poss,appos,NNP,NNP,4,1
11999,62574.0,38,was,21,15,20,5,14,17,6,-1,Alice,Guy,PERSON,PERSON,PROPN,PROPN,poss,appos,NNP,NNP,4,1
12000,57863.0,35,decided,9,1,7,6,0,27,8,-2,Banda,Asinati Mwale,PERSON,PERSON-PERSON,PROPN,PROPN-PROPN,nsubj,compound-appos,NNP,NNP-NNP,3,1
12001,57898.0,18,born,5,1,14,13,0,3,4,9,Thomas Joseph Meskill Jr,"Jan 30 , 1928",PERSON-PERSON-PERSON-PERSON,DATE-DATE-DATE-DATE,PROPN-PROPN-PROPN-PROPN,PROPN-NUM-PUNCT-NUM,compound-compound-compound-nsubjpass,pobj-nummod-punct-appos,NNP-NNP-NNP-NNP,"NNP-CD-,-CD",5,1
12002,57902.0,34,was,2,23,28,5,22,5,-21,26,Ray Ferrara,Pro Vise Management Group,PERSON-PERSON,ORGANIZATION-ORGANIZATION-ORGANIZATION-ORGANIZATION,PROPN-PROPN,PROPN-PROPN-PROPN-PROPN,compound-appos,compound-compound-compound-pobj,NNP-NNP,NNP-NNP-NNP-NNP,5,1
12003,57917.0,36,manage,7,6,5,-1,5,30,1,-2,Justin Theroux,screenwriter,PERSON-PERSON,TITLE,PROPN-PROPN,NOUN,compound-conj,compound,NNP-NNP,NN,1,1
12004,57924.0,30,survived,2,1,8,7,0,21,1,6,Bellecourt,Carol Ann Bellecourt,PERSON,PERSON-PERSON-PERSON,PROPN,PROPN-PROPN-PROPN,nsubjpass,compound-compound-appos,NNP,NNP-NNP-NNP,5,1
12005,57928.0,33,be,5,1,3,2,0,29,4,-2,Arsenal,Emmanuel Adebayor,ORGANIZATION,PERSON-PERSON,ADJ,PROPN-PROPN,amod,compound-nsubj,JJ,NNP-NNP,1,1
12006,57931.0,33,led,14,3,23,20,2,9,11,9,Awami National Party,Begum Nasim Wali Khan,ORGANIZATION-ORGANIZATION-ORGANIZATION,PERSON-PERSON-PERSON-PERSON,PROPN-PROPN-PROPN,PROPN-PROPN-PROPN-PROPN,compound-compound-nsubjpass,compound-compound-compound-appos,NNP-NNP-NNP,NNP-NNP-NNP-NNP,7,1
12007,57942.0,28,shut,5,2,9,7,1,18,3,4,Oxford University Press,Canadian dictionary division,ORGANIZATION-ORGANIZATION-ORGANIZATION,ORGANIZATION-ORGANIZATION-ORGANIZATION,PROPN-PROPN-PROPN,ADJ-ADJ-NOUN,compound-compound-nsubj,amod-amod-dobj,NNP-NNP-NNP,JJ-JJ-NN,4,1
12008,57962.0,50,said,29,45,36,-9,44,13,-16,7,American Bar Association,Henry F White Jr,ORGANIZATION-ORGANIZATION-ORGANIZATION,PERSON-PERSON-PERSON-PERSON,PROPN-PROPN-PROPN,PROPN-PROPN-PROPN-PROPN,compound-compound-pobj,compound-compound-compound-nsubj,NNP-NNP-NNP,NNP-NNP-NNP-NNP,5,1
12009,57966.0,28,was,1,1,21,20,0,6,0,20,Dent,chairman,PERSON,TITLE,PROPN,NOUN,nsubj,pobj,NNP,NN,4,1
12010,57970.0,68,filed,11,32,8,-24,31,59,-21,-3,his,arson,PERSON,CRIMINAL_CHARGE,DET,NOUN,poss,compound,PRP$,NN,8,1
12011,57979.0,21,said,1,20,1,-19,19,19,-19,0,her,He,PERSON,PERSON,PRON,PRON,pobj,nsubj,PRP,PRP,1,1
12012,57984.0,35,SEATTLE,0,4,1,-3,3,33,-4,1,Federal Aviation Administration,SEATTLE,ORGANIZATION-ORGANIZATION-ORGANIZATION,COUNTRY,PROPN-PROPN-PROPN,NOUN,compound-compound-nsubj,ROOT,NNP-NNP-NNP,NNS,4,1
12013,57996.0,41,served,2,1,19,18,0,21,1,17,Hubbard,Chancellor,PERSON,TITLE,PROPN,PROPN,nsubj,compound,NNP,NNP,7,1
12014,57999.0,33,convicted,5,25,30,5,24,2,-20,25,state of Israel,Jewish National Fund,ORGANIZATION-ORGANIZATION-ORGANIZATION,COUNTRY-COUNTRY-COUNTRY,NOUN-ADP-PROPN,PROPN-PROPN-PROPN,conj-prep-pobj,amod-compound-conj,NN-IN-NNP,NNP-NNP-NNP,3,1
12015,58024.0,61,cancels,2,1,15,14,0,45,1,13,Ellen DeGeneres,Writers Guild,PERSON-PERSON,ORGANIZATION-ORGANIZATION,PROPN-PROPN,PROPN-PROPN,compound-compound,nsubj-compound,NNP-NNP,NNPS-NNP,5,1
12016,58037.0,35,brought,4,23,1,-22,22,33,-19,-3,Focus on the Family,Obama,ORGANIZATION-ORGANIZATION-ORGANIZATION-ORGANIZATION,PERSON,PROPN-ADP-DET-PROPN,PROPN,dobj-prep-det-pobj,poss,NNP-IN-DT-NNP,NNP,10,1
12017,58039.0,28,decided,2,7,1,-6,6,26,-5,-1,his,Boston University,PERSON,ORGANIZATION-ORGANIZATION,DET,PROPN-PROPN,poss,compound-nsubj,PRP$,NNP-NNP,3,1
12018,58074.0,65,survived,2,18,42,24,17,22,-16,40,Sherwood Morgan Sr.,Justine Walker,PERSON-PERSON-PERSON,PERSON-PERSON,PROPN-PROPN-PROPN,PROPN-PROPN,compound-compound-pobj,compound-appos,NNP-NNP-NNP,NNP-NNP,10,1
12019,58089.0,34,said,16,10,27,17,9,6,6,11,Alcatel - Lucent,Jean-Pascal Beaufret,ORGANIZATION-ORGANIZATION-ORGANIZATION,PERSON-PERSON,PROPN-PUNCT-PROPN,PROPN-PROPN,compound-punct-poss,compound-appos,NNP-HYPH-NNP,NNP-NNP,8,1
12020,58096.0,40,research,3,1,6,5,0,33,2,3,American Beverage Association,http://wwwschoolbeveragescom,ORGANIZATION-ORGANIZATION-ORGANIZATION,URL,PROPN-PROPN-PROPN,X,compound-compound-compound,ROOT,NNP-NNP-NNP,ADD,-1,1
12021,58098.0,23,Jr,2,1,8,7,0,14,1,6,Jefferson DeBlanc,Richard DeBlanc,PERSON-PERSON,PERSON-PERSON,PROPN-PROPN,PROPN-PROPN,compound-compound,compound-conj,NNP-NNP,NNP-NNP,2,1
12022,58108.0,40,seems,1,32,37,5,31,2,-31,36,Richard Perle,assistant defense secretary,PERSON-PERSON,TITLE-TITLE-TITLE,PROPN-PROPN,ADJ-NOUN-NOUN,compound-pobj,amod-compound-appos,NNP-NNP,JJ-NN-NN,2,1
12023,58112.0,59,say,30,35,34,-1,34,24,-5,4,Farland,Ambassador,PERSON,TITLE,PROPN,PROPN,nsubj,compound,NNP,NNP,4,1
12024,58125.0,48,said,37,46,40,-6,45,7,-9,3,Medina hospital,Dahir Mohamoud Mohamed,ORGANIZATION-ORGANIZATION,PERSON-PERSON-PERSON,PROPN-NOUN,PROPN-PROPN-PROPN,compound-pobj,compound-compound-nsubj,NNP-NN,NNP-NNP-NNP,2,1
12025,58127.0,58,has,14,50,47,-3,49,10,-36,33,Hector Elizondo,Wishing Wizzle,PERSON-PERSON,PERSON-PERSON,PROPN-PROPN,PROPN-PROPN,compound-compound,compound-pobj,NNP-NNP,NNP-NNP,7,1
12026,58143.0,31,said,25,4,3,-1,3,27,21,-22,Chen Zhu,scientist,PERSON-PERSON,TITLE,PROPN-PROPN,NOUN,compound-nsubj,compound,NNP-NNP,NN,1,1
12027,58155.0,27,died,6,12,5,-7,11,21,-6,-1,he,56,PERSON,NUMBER,PRON,NUM,nsubj,attr,PRP,CD,6,1
12028,58157.0,33,is,12,1,8,7,0,24,11,-4,The group,Army of the Pious,ORGANIZATION-ORGANIZATION,ORGANIZATION-ORGANIZATION-ORGANIZATION-ORGANIZATION,DET-NOUN,PROPN-ADP-DET-PROPN,det-nsubj,dobj-prep-det-pobj,DT-NN,NNP-IN-DT-NNP,2,1
12029,58158.0,17,died,12,1,15,14,0,1,11,3,Michael Deaver,pancreatic cancer,PERSON-PERSON,CAUSE_OF_DEATH-CAUSE_OF_DEATH,PROPN-PROPN,ADJ-NOUN,compound-nsubj,amod-pobj,NNP-NNP,JJ-NN,3,1
12030,58159.0,22,won,5,13,9,-4,12,12,-8,4,American Basketball Association,Indiana Pacers,ORGANIZATION-ORGANIZATION-ORGANIZATION,ORGANIZATION-ORGANIZATION,PROPN-PROPN-PROPN,PROPN-PROPN,compound-compound-pobj,compound-pobj,NNP-NNP-NNP,NNP-NNPS,3,1
12031,58175.0,30,head,1,11,28,17,10,1,-10,27,OIC,Muslim,ORGANIZATION,RELIGION,PROPN,ADJ,compound,amod,NNP,JJ,7,1
12032,58190.0,29,said,2,11,11,0,10,17,-9,9,Carnival Corp,Carnival,ORGANIZATION-ORGANIZATION,ORGANIZATION,PROPN-PROPN,PROPN,compound-pobj,compound,NNP-NNP,NNP,0,1
12033,58216.0,38,said,24,3,2,-1,2,35,21,-22,Wildmon,Reverend,PERSON,TITLE,PROPN,VERB,nsubj,compound,NNP,VB,1,1
12034,58219.0,27,elected,8,7,13,6,6,13,1,5,Mitchell,House of Representatives,PERSON,ORGANIZATION-ORGANIZATION-ORGANIZATION,PROPN,PROPN-ADP-PROPN,nsubjpass,pobj-prep-pobj,NNP,NNP-IN-NNPS,5,1
12035,58239.0,47,-LRB-,4,13,34,21,12,12,-9,30,Thomas Meskill,judge,PERSON-PERSON,TITLE,PROPN-PROPN,NOUN,compound-conj,appos,NNP-NNP,NN,7,1
12036,58255.0,21,required,4,8,20,12,7,0,-4,16,Al,Gabriel,PERSON,PERSON,PROPN,PROPN,pobj,conj,NNP,NNP,4,1
12037,58265.0,40,claim,6,36,11,-25,35,28,-30,5,American Basketball Association,Big,ORGANIZATION-ORGANIZATION-ORGANIZATION,MISC,PROPN-PROPN-PROPN,PROPN,compound-compound-compound,compound,NNP-NNP-NNP,NNP,8,1
12038,58268.0,48,said,23,3,36,33,2,11,20,13,Arsenal,David Dein,ORGANIZATION,PERSON-PERSON,PROPN,PROPN-PROPN,poss,compound-pobj,NNP,NNP-NNP,11,1
12039,58282.0,18,hired,6,1,4,3,0,13,5,-2,Abrams,lawyer,PERSON,TITLE,PROPN,NOUN,nsubjpass,appos,NNP,NN,3,1
12040,58292.0,19,died,6,6,10,4,5,8,0,4,Verity,"Jan 3 , 2007",PERSON,DATE-DATE-DATE-DATE,PROPN,PROPN-NUM-PUNCT-NUM,nsubj,npadvmod-nummod-punct-nummod,NNP,"NNP-CD-,-CD",2,1
12041,58302.0,39,tied,13,1,6,5,0,32,12,-7,Pompeo,Meredith Grey,PERSON,PERSON-PERSON,PROPN,PROPN-PROPN,nsubj,compound-dobj,NNP,NNP-NNP,3,1
12042,58312.0,27,spent,2,15,21,6,14,5,-13,19,his,Retail Markets Group for Verizon Corp.,PERSON,ORGANIZATION-ORGANIZATION-ORGANIZATION-ORGANIZATION-ORGANIZATION-ORGANIZATION,DET,PROPN-PROPN-PROPN-ADP-PROPN-PROPN,poss,compound-compound-pobj-prep-compound-pobj,PRP$,NNP-NNPS-NNP-IN-NNP-NNP,5,1
12043,58313.0,79,survived,8,7,66,59,6,12,1,58,Meskill,Laura Marie,PERSON,PERSON-PERSON,PROPN,PROPN-PROPN,nsubjpass,compound-conj,NNP,NNP-NNP,6,1
12044,58314.0,22,said,14,1,12,11,0,9,13,-2,Bryan Baldwin,New York,PERSON-PERSON,STATE_OR_PROVINCE-STATE_OR_PROVINCE,PROPN-PROPN,PROPN-PROPN,compound-nsubj,compound-npadvmod,NNP-NNP,NNP-NNP,4,1
12045,58327.0,25,dreams,3,8,24,16,7,0,-5,21,Beyonce,American,PERSON,NATIONALITY,PROPN,ADJ,pobj,amod,NNP,JJ,6,1
12046,58337.0,28,died,21,1,20,19,0,7,20,-1,Sills,Met,PERSON,ORGANIZATION,NOUN,PROPN,nsubj,conj,NNS,NNP,3,1
12047,58355.0,40,jen,1,9,6,-3,8,33,-8,5,Ali Fedotowsky,Bachelorette,PERSON-PERSON,TITLE,PROPN-PROPN,PROPN,compound-appos,ROOT,NNP-NNP,NNP,3,1
12048,58360.0,40,says,14,1,5,4,0,34,13,-9,Watson,Sierra Club,PERSON,ORGANIZATION-ORGANIZATION,PROPN,PROPN-PROPN,nsubj,compound-compound,NNP,NNP-NNP,3,1
12049,58372.0,56,is,1,20,12,-8,19,43,-19,11,her,2003,PERSON,DATE,DET,NUM,poss,pobj,PRP$,CD,6,1
12050,58375.0,21,included,5,19,17,-2,18,3,-14,12,Juliette Binoche,France,PERSON-PERSON,COUNTRY,PROPN-PROPN,PROPN,compound-conj,poss,NNP-NNP,NNP,2,1
12051,58376.0,44,includes,10,6,20,14,5,23,4,10,Highland Capital,O Beverages,ORGANIZATION-ORGANIZATION,ORGANIZATION-ORGANIZATION,PROPN-PROPN,INTJ-PROPN,compound-poss,compound-conj,NNP-NNP,UH-NNP,5,1
12052,58378.0,25,is,8,15,13,-2,14,11,-7,5,Chad White,fashion supermodel,PERSON-PERSON,TITLE-TITLE,PROPN-PROPN,NOUN-NOUN,compound-appos,compound-attr,NNP-NNP,NN-NN,1,1
12053,58401.0,36,founded,2,21,13,-8,20,22,-19,11,Sean Parker,Stanford,PERSON-PERSON,ORGANIZATION,PROPN-PROPN,PROPN,compound-conj,compound,NNP-NNP,NNP,3,1
12054,58408.0,44,said,37,5,5,0,4,38,32,-32,Covidien Ltd.,Covidien,ORGANIZATION-ORGANIZATION,ORGANIZATION,PROPN-PROPN,PROPN,compound-nsubj,nmod,NNP-NNP,NNP,0,1
12055,58416.0,42,missed,2,13,41,28,12,0,-11,39,his,lobbyist,PERSON,TITLE,DET,NOUN,poss,pobj,PRP$,NN,8,1
12056,58424.0,35,said,22,33,24,-9,32,10,-11,2,MF Global,Michael Fitzpatrick,ORGANIZATION-ORGANIZATION,PERSON-PERSON,PROPN-PROPN,PROPN-PROPN,compound-pobj,compound-nsubj,NNP-NNP,NNP-NNP,5,1
12057,58429.0,30,said,28,3,6,3,2,23,25,-22,Jennifer Dunn,66,PERSON-PERSON,NUMBER,PROPN-PROPN,NUM,compound-nsubj,appos,NNP-NNP,CD,1,1
12058,58449.0,36,announced,4,7,34,27,6,1,-3,30,he,Sag Harbor,PERSON,LOCATION-LOCATION,PRON,PROPN-PROPN,nsubj,compound-pobj,PRP,NNP-NNP,5,1
12059,58456.0,51,joined,6,15,49,34,14,1,-9,43,New South Wales WaratahsBurke,Chris Hickey,ORGANIZATION-ORGANIZATION-ORGANIZATION-ORGANIZATION,PERSON-PERSON,PROPN-PROPN-PROPN-PROPN,PROPN-PROPN,compound-compound-compound-pobj,compound-pobj,NNP-NNP-NNP-NNP,NNP-NNP,9,1
12060,58459.0,36,highlight,9,3,1,-2,2,34,6,-8,Mia Farrow,US actress,PERSON-PERSON,TITLE-TITLE,PROPN-PROPN,PROPN-NOUN,compound-nsubj,compound-compound,NNP-NNP,NNP-NN,1,1
12061,58463.0,33,said,31,21,30,9,20,2,10,-1,John Negroponte,White House,PERSON-PERSON,ORGANIZATION-ORGANIZATION,PROPN-PROPN,PROPN-PROPN,compound-pobj,compound-nsubj,NNP-NNP,NNP-NNP,5,1
12062,58479.0,26,announced,24,1,23,22,0,2,23,-1,Blackburn Rovers,Lancashire,ORGANIZATION-ORGANIZATION,STATE_OR_PROVINCE,PROPN-PROPN,PROPN,compound-nsubj,compound,NNP-NNP,NNP,3,1
12063,58480.0,33,Brody,3,22,6,-16,21,26,-19,3,his,Roy Scheider,PERSON,PERSON-PERSON,DET,PROPN-PROPN,poss,compound-compound,PRP$,NNP-NNP,8,1
12064,58482.0,49,survived,2,1,22,21,0,26,1,20,She,Kenneth,PERSON,PERSON,PRON,PROPN,nsubjpass,appos,PRP,NNP,5,1
12065,58488.0,6,bought,1,1,3,2,0,2,0,2,Alcatel,Lucent,ORGANIZATION,ORGANIZATION,PROPN,PROPN,nsubj,dobj,NNP,NNP,2,1
12066,58496.0,39,say,37,3,28,25,2,10,34,-9,NSG,1974,ORGANIZATION,DATE,PROPN,NUM,compound,pobj,NNP,CD,6,1
12067,58501.0,35,said,21,23,3,-20,22,31,-2,-18,Lou Ferrara,AP,PERSON-PERSON,ORGANIZATION,PROPN-PROPN,PROPN,compound-nsubj,appos,NNP-NNP,NNP,4,1
12068,58517.0,27,represented,4,23,9,-14,22,17,-19,5,he,18,PERSON,NUMBER,PRON,NUM,nsubj,appos,PRP,CD,7,1
12069,58518.0,20,------,0,14,6,-8,13,13,-14,6,National Christmas Tree Contest,River Ridge,ORGANIZATION-ORGANIZATION-ORGANIZATION-ORGANIZATION,ORGANIZATION-ORGANIZATION,PROPN-PROPN-PROPN-PROPN,PROPN-PROPN,compound-compound-compound-pobj,compound-nsubjpass,NNP-NNP-NNP-NNP,NNP-NNP,5,1
12070,58526.0,36,meet,12,7,4,-3,6,31,5,-8,American Psychiatric Association,Chicago,ORGANIZATION-ORGANIZATION-ORGANIZATION,CITY,PROPN-PROPN-PROPN,PROPN,compound-compound-poss,pobj,NNP-NNP-NNP,NNP,4,1
12071,58554.0,40,said,23,17,12,-5,16,27,6,-11,IMF,Lee Chee Sung,ORGANIZATION,PERSON-PERSON-PERSON,PROPN,PROPN-PROPN-PROPN,poss,compound-compound-nsubj,NNP,NNP-NNP-NNP,4,1
12072,58612.0,38,began,7,7,3,-4,6,34,0,-4,DeGeneres,Louisiana,PERSON,STATE_OR_PROVINCE,PROPN,PROPN,nsubj,pobj,NNP,NNP,2,1
12073,58617.0,52,said,41,48,24,-24,47,27,-7,-17,Servicemembers Legal Defense Network,Susan Collins,ORGANIZATION-ORGANIZATION-ORGANIZATION-ORGANIZATION,PERSON-PERSON,PROPN-PROPN-PROPN-PROPN,PROPN-PROPN,compound-compound-compound-pobj,compound-conj,NNP-NNP-NNP-NNP,NNP-NNP,9,1
12074,58624.0,56,made,4,15,15,0,14,40,-11,11,Kelly Cutrone,Kelly,PERSON-PERSON,PERSON,PROPN-PROPN,PROPN,compound-poss,nsubj,NNP-NNP,NNP,0,1
12075,58627.0,60,said,20,13,17,4,12,42,7,-3,Bankers Association,Republic of China,ORGANIZATION-ORGANIZATION,COUNTRY-COUNTRY-COUNTRY,PROPN-PROPN,PROPN-ADP-PROPN,compound-pobj,pobj-prep-pobj,NNPS-NNP,NNP-IN-NNP,3,1
12076,58630.0,39,died,33,1,36,35,0,2,32,3,Jane Bolin,Monday,PERSON-PERSON,DATE,PROPN-PROPN,PROPN,compound-nsubj,pobj,NNP-NNP,NNP,2,1
12077,58638.0,54,survived,2,5,22,17,4,31,-3,20,his,editor,PERSON,TITLE,DET,NOUN,poss,appos,PRP$,NN,5,1
12078,58642.0,23,CARACAS,0,8,22,14,7,0,-8,22,Hugo Chavez,Sabaneta,PERSON-PERSON,CITY,PROPN-PROPN,PROPN,compound-nsubjpass,pobj,NNP-NNP,NNP,2,1
12079,58662.0,44,gathered,3,30,26,-4,29,17,-27,23,Abdel Abdul Karim al-Khawinay,Al-Shura,PERSON-PERSON-PERSON-PERSON,ORGANIZATION,PROPN-PROPN-PROPN-PROPN,PROPN,compound-compound-compound-pobj,compound,NNP-NNP-NNP-NNP,NNP,3,1
12080,58698.0,15,died,4,3,2,-1,2,12,1,-2,Michael Deaver,aide,PERSON-PERSON,TITLE,PROPN-PROPN,NOUN,compound-nsubj,compound,NNP-NNP,NN,1,1
12081,58699.0,6,employs,2,2,4,2,1,1,0,2,company,"2,900",ORGANIZATION,NUMBER,NOUN,NUM,nsubj,nummod,NN,CD,1,1
12082,58702.0,27,joined,18,15,1,-14,14,25,3,-17,American Bankers Association,Duke,ORGANIZATION-ORGANIZATION-ORGANIZATION,PERSON,PROPN-PROPN-PROPN,PROPN,compound-compound-dobj,nsubj,NNP-NNPS-NNP,NNP,6,1
12083,58713.0,28,Focus,2,18,24,6,17,3,-16,22,Chen,Chinese Academy of Sciences,PERSON,ORGANIZATION-ORGANIZATION-ORGANIZATION-ORGANIZATION,PROPN,PROPN-PROPN-ADP-PROPN,nsubj,compound-pobj-prep-pobj,NNP,NNP-NNP-IN-NNPS,2,1
12084,58735.0,40,alleges,3,6,13,7,5,26,-3,10,Palfrey,1993,ORGANIZATION,DATE,PROPN,NUM,nsubj,pobj,NNP,CD,1,1
12085,58741.0,31,met,1,8,13,5,7,17,-7,12,John Negroponte,Pakistan,PERSON-PERSON,COUNTRY,PROPN-PROPN,PROPN,compound-pobj,pobj,NNP-NNP,NNP,3,1
12086,58745.0,18,is,3,5,3,-2,4,14,-2,0,Justin Theroux,leader,PERSON-PERSON,TITLE,PROPN-PROPN,NOUN,compound-attr,nsubj,NNP-NNP,NN,1,1
12087,58757.0,37,said,21,5,18,13,4,18,16,-3,Royal Caribbean Cruises Ltd,Celebrity Cruise,ORGANIZATION-ORGANIZATION-ORGANIZATION-ORGANIZATION,ORGANIZATION-ORGANIZATION,PROPN-PROPN-PROPN-PROPN,PROPN-PROPN,compound-compound-compound-appos,compound-conj,NNP-NNP-NNPS-NNP,NNP-NNP,7,1
12088,58776.0,52,said,4,1,3,2,0,48,3,-1,CNB,Zdenek Tuma,ORGANIZATION,PERSON-PERSON,PROPN,PROPN-PROPN,compound,compound-nsubj,NNP,NNP-NNP,1,1
12089,58805.0,56,said,30,37,48,11,36,7,-7,18,Focus on the Family,"1,200",ORGANIZATION-ORGANIZATION-ORGANIZATION-ORGANIZATION,NUMBER,PROPN-ADP-DET-PROPN,NUM,pobj-prep-det-pobj,nummod,NNP-IN-DT-NNP,CD,3,1
12090,58838.0,39,had,27,27,11,-16,26,27,0,-16,she,prostitute,PERSON,TITLE,PRON,NOUN,nsubj,pobj,PRP,NN,5,1
12091,58852.0,41,rejuvenated,13,5,9,4,4,31,8,-4,Morgenthau,Josh,PERSON,PERSON,PROPN,PROPN,nsubj,appos,NNP,NNP,2,1
12092,58868.0,42,testified,7,40,33,-7,39,8,-33,26,David Gregory,Time magazine,PERSON-PERSON,ORGANIZATION-ORGANIZATION,PROPN-PROPN,PROPN-NOUN,compound-conj,compound-pobj,NNP-NNP,NNP-NN,9,1
12093,58869.0,17,was,1,12,3,-9,11,13,-11,2,his,vice president,PERSON,TITLE-TITLE,DET,NOUN-NOUN,poss,compound-attr,PRP$,NN-NN,3,1
12094,58872.0,20,recalled,1,3,8,5,2,11,-2,7,King,officer,PERSON,TITLE,PROPN,NOUN,dobj,pobj,NNP,NN,3,1
12095,58873.0,50,earned,33,1,25,24,0,24,32,-8,Mark Buse,lobbyist,PERSON-PERSON,TITLE,PROPN-PROPN,NOUN,compound-nsubj,pobj,NNP-NNP,NN,2,1
12096,58896.0,42,arrived,28,8,25,17,7,16,20,-3,John D. Negroponte,United Nations,PERSON-PERSON-PERSON,ORGANIZATION-ORGANIZATION,PROPN-PROPN-PROPN,PROPN-PROPN,compound-compound-nsubj,compound-pobj,NNP-NNP-NNP,NNP-NNP,7,1
12097,58902.0,18,married,2,1,7,6,0,10,1,5,She,Ralph E. Mizelle,PERSON,PERSON-PERSON-PERSON,PRON,PROPN-PROPN-PROPN,nsubj,compound-compound-appos,PRP,NNP-NNP-NNP,3,1
12098,58910.0,48,said,15,2,7,5,1,40,13,-8,Mahmood Shah,head of government security,PERSON-PERSON,TITLE-TITLE-TITLE-TITLE,PROPN-PROPN,NOUN-ADP-NOUN-NOUN,compound-nsubj,appos-prep-compound-pobj,NNP-NNP,NN-IN-NN-NN,2,1
12099,58919.0,34,was,1,7,1,-6,6,32,-6,0,American Psychiatric Association,He,ORGANIZATION-ORGANIZATION-ORGANIZATION,PERSON,PROPN-PROPN-PROPN,PRON,compound-compound-pobj,nsubj,NNP-NNP-NNP,PRP,4,1
12100,58921.0,23,confirmed,7,5,22,17,4,0,2,15,Samsung,Seoul,ORGANIZATION,CITY,PROPN,PROPN,compound,pobj,NNP,NNP,7,1
12101,58928.0,11,confirmed,3,1,9,8,0,1,2,6,Her,Andrew Roraback,PERSON,PERSON-PERSON,DET,PROPN-PROPN,poss,compound-appos,PRP$,NNP-NNP,4,1
12102,58949.0,35,announced,24,27,5,-22,26,29,-3,-19,he,82,PERSON,NUMBER,PRON,NUM,nsubj,attr,PRP,CD,5,1
12103,58951.0,35,compete,2,25,14,-11,24,20,-23,12,he,NBA,PERSON,ORGANIZATION,PRON,PROPN,nsubj,pobj,PRP,NNP,8,1
12104,58957.0,61,lead,1,58,5,-53,57,55,-57,4,Chante Moore,Carey,PERSON-PERSON,PERSON,PROPN-PROPN,PROPN,compound-compound,poss,NNP-NNP,NNP,-1,1
12105,58974.0,13,born,4,1,7,6,0,5,3,3,Parren James Mitchell,"April 29 , 1922",PERSON-PERSON-PERSON,NUMBER-NUMBER-NUMBER-NUMBER,PROPN-PROPN-PROPN,PROPN-NUM-PUNCT-NUM,compound-compound-nsubjpass,pobj-nummod-punct-nummod,NNP-NNP-NNP,"NNP-CD-,-CD",5,1
12106,58976.0,10,was,6,4,1,-3,3,8,2,-5,Nyanza Hawkins,His,PERSON-PERSON,PERSON,PROPN-PROPN,DET,compound-appos,poss,NNP-NNP,PRP$,1,1
12107,58979.0,20,asked,6,15,17,2,14,2,-9,11,APA,Asset Protection Associate,ORGANIZATION,ORGANIZATION-ORGANIZATION-ORGANIZATION,PROPN,PROPN-PROPN-PROPN,oprd,compound-compound-conj,NNP,NNP-NNP-NNP,3,1
12108,58983.0,53,ordered,4,17,44,27,16,8,-13,40,the president,Rosines Chavez Rodriguez,PERSON-PERSON,PERSON-PERSON-PERSON,DET-NOUN,PROPN-PROPN-PROPN,det-poss,compound-compound-pobj,DT-NN,NNP-NNP-NNP,-1,1
12109,58993.0,22,said,2,6,1,-5,5,20,-4,-1,Option One,H&R Block,ORGANIZATION-ORGANIZATION,ORGANIZATION-ORGANIZATION,PROPN-NUM,PROPN-PROPN,nsubj-nummod,compound-nsubj,NNP-CD,NNP-NNP,4,1
12110,59005.0,32,told,25,1,28,27,0,3,24,3,``,House Financial Services Committee,PERSON,ORGANIZATION-ORGANIZATION-ORGANIZATION-ORGANIZATION,PUNCT,PROPN-PROPN-PROPN-PROPN,punct,compound-compound-compound-dobj,``,NNP-NNP-NNPS-NNP,4,1
12111,59007.0,14,died,9,2,12,10,1,1,7,3,Robbins,1998,PERSON,DATE,PROPN,NUM,nsubj,pobj,NNP,CD,3,1
12112,59017.0,24,told,10,1,9,8,0,14,9,-1,Capitalia,Cesare Geronzi,ORGANIZATION,PERSON-PERSON,NOUN,PROPN-PROPN,compound,compound-pobj,NN,NNP-NNP,4,1
12113,59021.0,42,wrote,28,36,40,4,35,1,-8,12,ABA,"400,000",ORGANIZATION,NUMBER,NOUN,NUM,pobj,nummod,NN,CD,6,1
12114,59029.0,46,Party,3,11,1,-10,10,44,-8,-2,Shah Mahmood Quraishi,Pakistan People 's Party,PERSON-PERSON-PERSON,ORGANIZATION-ORGANIZATION-ORGANIZATION-ORGANIZATION,PROPN-PROPN-PROPN,PROPN-PROPN-PART-PROPN,compound-compound-appos,compound-poss-case-ROOT,NNP-NNP-NNP,NNP-NNPS-POS-NNP,7,1
12115,59056.0,21,took,1,9,16,7,8,4,-8,15,Fidel Castro,he,PERSON-PERSON,PERSON,PROPN-PROPN,PRON,compound-appos,nsubj,NNP-NNP,PRP,5,1
12116,59074.0,60,confesses,28,12,8,-4,11,51,16,-20,Donald Wildmon,Miss.,PERSON-PERSON,STATE_OR_PROVINCE,PROPN-PROPN,PROPN,compound-appos,appos,NNP-NNP,NNP,2,1
12117,59079.0,38,begin,2,23,35,12,22,2,-21,33,the Brazilian Electoral Superior Tribunal,TSE,ORGANIZATION-ORGANIZATION-ORGANIZATION-ORGANIZATION-ORGANIZATION,ORGANIZATION,DET-PROPN-PROPN-PROPN-PROPN,PROPN,det-amod-compound-compound-nsubj,compound,DT-NNP-NNP-NNP-NNP,NNP,4,1
12118,59085.0,69,reported,3,31,26,-5,30,42,-28,23,her,superstar,PERSON,TITLE,DET,NOUN,poss,nsubj,PRP$,NN,5,1
12119,59104.0,30,says,4,19,10,-9,18,19,-15,6,Justice and Equality movement,Abdel Aziz Ushar,ORGANIZATION-ORGANIZATION-ORGANIZATION-ORGANIZATION,PERSON-PERSON-PERSON,PROPN-CCONJ-PROPN-NOUN,PROPN-PROPN-PROPN,nmod-cc-conj-pobj,compound-compound-dobj,NNP-CC-NNP-NN,NNP-NNP-NNP,5,1
12120,59109.0,56,remembered,2,1,24,23,0,31,1,22,McNair,"Feb. 8 , 1968",PERSON,DATE-DATE-DATE-DATE,PROPN,PROPN-NUM-PUNCT-NUM,nsubjpass,pobj-nummod-punct-nummod,NNP,"NNP-CD-,-CD",6,1
12121,59111.0,23,runs,9,1,6,5,0,16,8,-3,Aerolineas Argentinas,Buenos Aires,ORGANIZATION-ORGANIZATION,CITY-CITY,PROPN-PROPN,PROPN-PROPN,compound-nsubj,compound-pobj,NNP-NNP,NNP-NNP,3,1
12122,59120.0,31,attended,9,4,7,3,3,23,5,-2,her,Johannes Huebl,PERSON,PERSON-PERSON,DET,PROPN-PROPN,poss,compound-appos,PRP$,NNP-NNP,2,1
12123,59125.0,29,sentenced,12,26,9,-17,25,19,-14,-3,he,extortion,PERSON,CRIMINAL_CHARGE,PRON,NOUN,nsubjpass,compound,PRP,NN,6,1
12124,59130.0,28,said,10,7,1,-6,6,26,3,-9,Highland Capital Partners,Davis,ORGANIZATION-ORGANIZATION-ORGANIZATION,PERSON,PROPN-PROPN-PROPN,PROPN,compound-compound-pobj,nsubj,NNP-NNP-NNP,NNP,5,1
12125,59141.0,12,dies,11,1,6,5,0,5,10,-5,Richmond Flowers,attorney general,PERSON-PERSON,TITLE-TITLE,PROPN-PROPN,NOUN-NOUN,compound-nsubj,compound-appos,NNP-NNP,NN-NN,1,1
12126,59145.0,30,allowed,13,12,5,-7,11,24,1,-8,he,Cuba,PERSON,COUNTRY,PRON,PROPN,nsubj,poss,PRP,NNP,7,1
12127,59147.0,33,said,13,29,11,-18,28,21,-16,-2,VECO,Vietnam Economic and Cultural Office,ORGANIZATION,ORGANIZATION-ORGANIZATION-ORGANIZATION-ORGANIZATION-ORGANIZATION,PROPN,PROPN-PROPN-CCONJ-PROPN-PROPN,compound,nmod-nmod-cc-conj-pobj,NNP,NNP-NNP-CC-NNP-NNP,-1,1
12128,59152.0,11,went,2,2,8,6,1,2,0,6,Scorpions,Alligator and Cobra,ORGANIZATION,ORGANIZATION-ORGANIZATION-ORGANIZATION,PROPN,PROPN-CCONJ-PROPN,nsubj,pobj-cc-conj,NNPS,NNP-CC-NNP,5,1
12129,59173.0,25,dropped,9,16,18,2,15,6,-7,9,Simon,London,PERSON,CITY,PROPN,PROPN,poss,compound,NNP,NNP,3,1
12130,59177.0,7,had,1,1,5,4,0,1,0,4,He,a stroke,PERSON,CAUSE_OF_DEATH-CAUSE_OF_DEATH,PRON,DET-NOUN,nsubj,det-pobj,PRP,DT-NN,3,1
12131,59183.0,44,are,1,8,12,4,7,31,-7,11,her,NYC,PERSON,LOCATION,DET,PROPN,poss,compound,PRP$,NNP,2,1
12132,59193.0,18,Copyright,0,8,14,6,7,3,-8,14,He,Sag Harbor,PERSON,CITY-CITY,PRON,PROPN-PROPN,nsubj,compound-pobj,PRP,NNP-NNP,3,1
12133,59195.0,30,called,17,3,13,10,2,16,14,-4,American Beverage Association,Dr Pepper Snapple Group,ORGANIZATION-ORGANIZATION-ORGANIZATION,ORGANIZATION-ORGANIZATION-ORGANIZATION-ORGANIZATION,PROPN-PROPN-PROPN,PROPN-PROPN-PROPN-PROPN,compound-compound-nsubj,compound-compound-compound-conj,NNP-NNP-NNP,NNP-NNP-NNP-NNP,4,1
12134,59211.0,25,disclosed,9,5,8,3,4,16,4,-1,Chunghwa Telecom,Chang Shaio-tung,ORGANIZATION-ORGANIZATION,PERSON-PERSON,PROPN-PROPN,PROPN-PROPN,compound-compound,compound-nsubj,NNP-NNP,NNP-NNP,3,1
12135,59213.0,48,appeared,11,10,8,-2,9,39,1,-3,Simon Cowell,music producer,PERSON-PERSON,TITLE-TITLE,PROPN-PROPN,NOUN-NOUN,compound-nsubj,compound-compound,NNP-NNP,NN-NN,3,1
12136,59217.0,33,was,1,18,11,-7,17,21,-17,10,Daily News,Mortimer B. Zuckerman,ORGANIZATION-ORGANIZATION,PERSON-PERSON-PERSON,PROPN-PROPN,PROPN-PROPN-PROPN,compound-pobj,compound-compound-appos,NNP-NNP,NNP-NNP-NNP,5,1
12137,59235.0,67,think,2,63,49,-14,62,17,-61,47,Professional Rodeo Cowboys Association,Keith Martin,ORGANIZATION-ORGANIZATION-ORGANIZATION-ORGANIZATION,PERSON-PERSON,PROPN-PROPN-PROPN-PROPN,PROPN-PROPN,compound-compound-compound-pobj,compound-nsubj,NNP-NNP-NNPS-NNP,NNP-NNP,6,1
12138,59240.0,31,ATLANTA,0,15,1,-14,14,29,-15,1,he,ATLANTA,PERSON,CITY,PRON,PROPN,nsubj,ROOT,PRP,NNP,3,1
12139,59258.0,19,takes,8,4,7,3,3,11,4,-1,CitizenLink,Stuart Shepard,ORGANIZATION,PERSON-PERSON,PROPN,PROPN-PROPN,compound,compound-nsubj,NNP,NNP-NNP,2,1
12140,59279.0,25,was,1,1,19,18,0,5,0,18,He,supervisor,PERSON,TITLE,PRON,NOUN,nsubj,pobj,PRP,NN,5,1
12141,59300.0,52,told,29,27,1,-26,26,50,2,-28,MAC,Lai Hsing-yuan,ORGANIZATION,PERSON-PERSON,PROPN,PROPN-PROPN,compound,compound-nsubj,NNP,NNP-NNP,3,1
12142,59302.0,19,said,5,1,4,3,0,14,4,-1,JNF,Effi Stenzler,ORGANIZATION,PERSON-PERSON,PROPN,PROPN-PROPN,compound,compound-nsubj,NNP,NNP-NNP,2,1
12143,59326.0,25,said,14,23,16,-7,22,8,-9,2,Royal Caribbean,Harri Kulovaara,ORGANIZATION-ORGANIZATION,PERSON-PERSON,PROPN-PROPN,PROPN-PROPN,compound-pobj,compound-nsubj,NNP-NNP,NNP-NNP,3,1
12144,59344.0,56,died,36,2,44,42,1,11,34,8,Jefferson J DeBlanc,complications from pneumonia,PERSON-PERSON-PERSON,CAUSE_OF_DEATH-CAUSE_OF_DEATH-CAUSE_OF_DEATH,PROPN-PROPN-PROPN,NOUN-ADP-NOUN,compound-compound-compound,pobj-prep-pobj,NNP-NNP-NNP,NNS-IN-NN,-1,1
12145,59360.0,30,said,17,27,19,-8,26,10,-10,2,Citibank,Cheng Cheng - mount,ORGANIZATION,PERSON-PERSON-PERSON-PERSON,PROPN,PROPN-PROPN-PUNCT-PROPN,pobj,compound-compound-punct-nsubj,NNP,NNP-NNP-HYPH-NNP,5,1
12146,59367.0,28,was,2,1,7,6,0,20,1,5,Michael Sandy,designer,PERSON-PERSON,TITLE,PROPN-PROPN,NOUN,compound-nsubj,attr,NNP-NNP,NN,4,1
12147,59385.0,34,born,4,26,23,-3,25,10,-22,19,Tema Sloven Kaiser,Moishe Bear,PERSON-PERSON-PERSON,PERSON-PERSON,PROPN-PROPN-PROPN,PROPN-PROPN,compound-compound-conj,compound-pobj,NNP-NNP-NNP,NNP-NNP,2,1
12148,59386.0,30,died,28,1,5,4,0,24,27,-23,Yolanda King,Rev.,PERSON-PERSON,TITLE,PROPN-PROPN,PROPN,compound-nsubj,compound,NNP-NNP,NNP,3,1
12149,59388.0,37,was,5,2,26,24,1,10,3,21,her,Regents Review Committee of the New York State Board of Regents,PERSON,ORGANIZATION-ORGANIZATION-ORGANIZATION-ORGANIZATION-ORGANIZATION-ORGANIZATION-ORGANIZATION-ORGANIZATION-ORGANIZATION-ORGANIZATION-ORGANIZATION,DET,PROPN-PROPN-PROPN-ADP-DET-PROPN-PROPN-PROPN-PROPN-ADP-PROPN,poss,compound-compound-pobj-prep-det-compound-compound-compound-pobj-prep-pobj,PRP$,NNPS-NNP-NNP-IN-DT-NNP-NNP-NNP-NNP-IN-NNPS,6,1
12150,59390.0,49,asked,8,16,27,11,15,21,-8,19,Gonzales,Justice,PERSON,ORGANIZATION,PROPN,PROPN,pobj,compound,NNP,NNP,6,1
12151,59396.0,33,died,29,7,13,6,6,19,22,-16,William Robert Anderson,US,PERSON-PERSON-PERSON,ORGANIZATION,PROPN-PROPN-PROPN,PROPN,compound-compound-appos,compound,NNP-NNP-NNP,NNP,4,1
12152,59405.0,8,'s,1,1,5,4,0,2,0,4,He,American,PERSON,NATIONALITY,PRON,ADJ,nsubj,amod,PRP,JJ,2,1
12153,59423.0,32,absorbed,2,1,12,11,0,19,1,10,She,Bea,PERSON,PERSON,PRON,PROPN,nsubjpass,compound,PRP,NNP,-1,1
12154,59425.0,60,said,46,59,33,-26,58,26,-13,-13,EnergySolutions,500,ORGANIZATION,NUMBER,PROPN,NUM,pobj,nummod,NNP,CD,14,1
12155,59445.0,31,took,15,4,13,9,3,17,11,-2,FirstGroup PLC,United Kingdom,ORGANIZATION-ORGANIZATION,COUNTRY-COUNTRY,PROPN-PROPN,PROPN-PROPN,compound-nsubj,compound-pobj,NNP-NNP,NNP-NNP,4,1
12156,59447.0,38,include,1,17,3,-14,16,34,-16,2,Amanda Deaver,his,PERSON-PERSON,PERSON,PROPN-PROPN,DET,compound-appos,poss,NNP-NNP,PRP$,3,1
12157,59461.0,12,statement,3,1,9,8,0,2,2,6,American Psychiatric Association,http://www.psych.org/edu/other--res/lib,ORGANIZATION-ORGANIZATION-ORGANIZATION,URL,PROPN-PROPN-PROPN,NOUN,compound-compound-compound,appos,NNP-NNP-NNP,NN,4,1
12158,59487.0,49,said,15,12,9,-3,11,39,3,-6,FAPA,Legislative Yuan,ORGANIZATION,ORGANIZATION-ORGANIZATION,PROPN,PROPN-PROPN,compound,compound-pobj,NNP,NNP-NNP,8,1
12159,59500.0,50,completed,2,34,38,4,33,11,-32,36,NFC South,Atlanta Falcons,ORGANIZATION-ORGANIZATION,ORGANIZATION-ORGANIZATION,PROPN-PROPN,PROPN-PROPN,compound-pobj,compound-compound,NNP-NNP,NNP-NNPS,4,1
12160,59529.0,30,published,1,16,22,6,15,7,-15,21,he,New England Museum of Natural History,PERSON,ORGANIZATION-ORGANIZATION-ORGANIZATION-ORGANIZATION-ORGANIZATION-ORGANIZATION,PRON,PROPN-PROPN-PROPN-ADP-PROPN-PROPN,nsubjpass,compound-compound-pobj-prep-compound-pobj,PRP,NNP-NNP-NNP-IN-NNP-NNP,5,1
12161,59568.0,17,said,0,2,5,3,1,11,-2,5,Farrow,UN,PERSON,ORGANIZATION,PROPN,PROPN,nsubj,compound,NNP,NNP,3,1
12162,59577.0,12,was,1,1,3,2,0,8,0,2,She,12 years old,PERSON,DURATION-DURATION-DURATION,PRON,NUM-NOUN-ADJ,nsubj,nummod-npadvmod-acomp,PRP,CD-NNS-JJ,2,1
12163,59589.0,38,said,15,23,30,7,22,7,-8,15,National Center for Disaster Preparedness,Mailman School of Public Health,ORGANIZATION-ORGANIZATION-ORGANIZATION-ORGANIZATION-ORGANIZATION,ORGANIZATION-ORGANIZATION-ORGANIZATION-ORGANIZATION-ORGANIZATION,PROPN-PROPN-ADP-PROPN-PROPN,PROPN-PROPN-ADP-PROPN-PROPN,compound-pobj-prep-compound-pobj,compound-pobj-prep-compound-pobj,NNP-NNP-IN-NNP-NNP,NNP-NNP-IN-NNP-NNP,4,1
12164,59592.0,32,broke,1,20,14,-6,19,17,-19,13,National Union for the Total Independence of Angola,Jonas Savimbi,ORGANIZATION-ORGANIZATION-ORGANIZATION-ORGANIZATION-ORGANIZATION-ORGANIZATION-ORGANIZATION-ORGANIZATION,PERSON-PERSON,PROPN-PROPN-ADP-DET-PROPN-PROPN-ADP-PROPN,PROPN-PROPN,compound-pobj-prep-det-compound-pobj-prep-pobj,compound-dobj,NNP-NNP-IN-DT-NNP-NNP-IN-NNP,NNP-NNP,3,1
12165,59629.0,41,said,24,37,26,-11,36,14,-13,2,National Military Family Association,Mary Scott,ORGANIZATION-ORGANIZATION-ORGANIZATION-ORGANIZATION,PERSON-PERSON,PROPN-PROPN-PROPN-PROPN,PROPN-PROPN,compound-compound-compound-pobj,compound-nsubj,NNP-NNP-NNP-NNP,NNP-NNP,9,1
12166,59644.0,35,lead,5,3,1,-2,2,33,2,-4,Raul Castro,Interim President,PERSON-PERSON,TITLE-TITLE,PROPN-PROPN,ADJ-PROPN,compound-nsubj,amod-compound,NNP-NNP,JJ-NNP,1,1
12167,59652.0,20,Credit,0,5,12,7,4,7,-5,12,Spencer & Heidi Now : Pratt,26,PERSON-PERSON-PERSON-PERSON-PERSON-PERSON,NUMBER,PROPN-CCONJ-PROPN-ADV-PUNCT-PROPN,NUM,appos-cc-conj-ROOT-punct-nsubj,appos,NNP-CC-NNP-RB-:-NNP,CD,4,1
12168,59654.0,39,said,25,16,34,18,15,4,9,9,Mainland Affairs Council,he,ORGANIZATION-ORGANIZATION-ORGANIZATION,PERSON,PROPN-PROPN-PROPN,PRON,compound-compound-compound,nsubj,NNP-NNPS-NNP,PRP,-1,1
12169,59658.0,25,reported,23,1,7,6,0,17,22,-16,Beverly Sills,United States,PERSON-PERSON,COUNTRY-COUNTRY,PROPN-PROPN,PROPN-PROPN,compound-nsubj,compound-poss,NNP-NNP,NNP-NNP,4,1
12170,59663.0,60,survived,2,1,21,20,0,38,1,19,He,Robert E Jr,PERSON,PERSON-PERSON-PERSON,PRON,PROPN-PROPN-PROPN,nsubjpass,compound-compound-appos,PRP,NNP-NNP-NNP,6,1
12171,59688.0,23,backed,19,2,6,4,1,16,17,-13,EnergySolutions,Envirocare of Utah,ORGANIZATION,ORGANIZATION-ORGANIZATION-ORGANIZATION,PROPN,PROPN-ADP-PROPN,nsubj,dobj-prep-pobj,NNP,NNP-IN-NNP,3,1
12172,59689.0,49,said,26,16,28,12,15,20,10,2,Carnival Corp.,Cherie Weinstein,ORGANIZATION-ORGANIZATION,PERSON-PERSON,PROPN-PROPN,PROPN-PROPN,compound-pobj,compound-nsubj,NNP-NNP,NNP-NNP,7,1
12173,59690.0,47,survived,11,2,27,25,1,19,9,16,his,Thomas,PERSON,PERSON,DET,PROPN,poss,appos,PRP$,NNP,5,1
12174,59715.0,18,allow,13,8,2,-6,7,15,5,-11,Obamas,democrats,ORGANIZATION,IDEOLOGY,PROPN,NOUN,compound,nsubj,NNP,NNS,3,1
12175,59729.0,40,said,1,25,32,7,24,7,-24,31,Hussein Kamel,Saddam Kamel al-Majid,PERSON-PERSON,PERSON-PERSON-PERSON,PROPN-PROPN,PROPN-PROPN-PROPN,compound-compound,compound-compound-appos,NNP-NNP,NNP-NNP-NNP,3,1
12176,59750.0,44,said,31,41,34,-7,40,9,-10,3,Crown Prosecution,Ken Macdonald,ORGANIZATION-ORGANIZATION,PERSON-PERSON,PROPN-PROPN,PROPN-PROPN,compound-compound,compound-nsubj,NNP-NNP,NNP-NNP,5,1
12177,59762.0,62,about,1,60,53,-7,59,8,-59,52,Americans,Oakland Oaks,ORGANIZATION,ORGANIZATION-ORGANIZATION,PROPN,PROPN-PROPN,compound,compound-compound,NNPS,NNP-NNP,-1,1
12178,59763.0,50,Probe,7,29,15,-14,28,34,-22,8,Servicemembers Legal Defense Network,Afghanistan,ORGANIZATION-ORGANIZATION-ORGANIZATION-ORGANIZATION,COUNTRY,PROPN-PROPN-PROPN-PROPN,PROPN,compound-compound-compound-appos,pobj,NNP-NNP-NNP-NNP,NNP,-1,1
12179,59808.0,46,instituted,23,1,45,44,0,0,22,22,Thomas J Meskill,Fla,PERSON-PERSON-PERSON,STATE_OR_PROVINCE,PROPN-PROPN-PROPN,PROPN,compound-compound-nsubj,appos,NNP-NNP-NNP,NNP,3,1
12180,59828.0,28,are,3,24,23,-1,23,4,-21,20,National Christmas Tree Association,Missouri-based,ORGANIZATION-ORGANIZATION-ORGANIZATION-ORGANIZATION,STATE_OR_PROVINCE,PROPN-PROPN-PROPN-PROPN,VERB,compound-compound-compound-pobj,compound,NNP-NNP-NNP-NNP,VBN,1,1
12181,59836.0,22,said,13,7,9,2,6,12,6,-4,Fedotowsky,ABC,PERSON,ORGANIZATION,PROPN,PROPN,nmod,poss,NNP,NNP,3,1
12182,59857.0,44,GAZA,0,21,25,4,20,18,-21,25,PRC,Abu Abeer,ORGANIZATION,PERSON-PERSON,PROPN,PROPN-PROPN,compound,compound-nsubj,NNP,NNP-NNP,4,1
12183,59858.0,40,announced,6,28,27,-1,27,12,-22,21,Donald Wildmon,activist,PERSON-PERSON,TITLE,PROPN-PROPN,NOUN,compound-pobj,compound,NNP-NNP,NN,1,1
12184,59863.0,39,replied,13,25,10,-15,24,28,-12,-3,she,California,PERSON,STATE_OR_PROVINCE,PRON,PROPN,nsubj,compound,PRP,NNP,4,1
12185,59872.0,18,was,4,4,10,6,3,7,0,6,she,Armed Services Committee,PERSON,ORGANIZATION-ORGANIZATION-ORGANIZATION,PRON,PROPN-PROPN-PROPN,nsubj,compound-compound-pobj,PRP,NNP-NNPS-NNP,4,1
12186,59883.0,14,got,10,9,1,-8,8,12,1,-9,Susan Boyle,Forty seven,PERSON-PERSON,NUMBER-NUMBER,PROPN-PROPN,NUM-NUM,compound-nsubj,nummod-nummod,NNP-NNP,CD-CD,5,1
12187,59891.0,18,says,7,4,1,-3,3,16,3,-6,Focus on the Family,Conservative,ORGANIZATION-ORGANIZATION-ORGANIZATION-ORGANIZATION,IDEOLOGY,PROPN-ADP-DET-PROPN,ADJ,appos-prep-det-pobj,amod,NNP-IN-DT-NNP,JJ,3,1
12188,59903.0,37,died,26,2,13,11,1,23,24,-13,Parren J Mitchell,Maryland,PERSON-PERSON-PERSON,STATE_OR_PROVINCE,PROPN-PROPN-PROPN,PROPN,compound-compound-nsubj,pobj,NNP-NNP-NNP,NNP,3,1
12189,59910.0,44,given,2,19,25,6,18,18,-17,23,Disney,Toy Story Land,ORGANIZATION,ORGANIZATION-ORGANIZATION-ORGANIZATION,PROPN,PROPN-PROPN-PROPN,compound,compound-compound-conj,NNP,NNP-NNP-NNP,3,1
12190,59925.0,83,drop,7,54,54,0,53,28,-47,47,Fidelity,Fidelity Value,ORGANIZATION,ORGANIZATION-ORGANIZATION,PROPN,PROPN-PROPN,compound,compound-compound,NNP,NNP-NNP,0,1
12191,59926.0,26,said,17,11,16,5,10,9,6,-1,her,California,PERSON,STATE_OR_PROVINCE,DET,PROPN,poss,appos,PRP$,NNP,4,1
12192,59927.0,28,had,23,7,2,-5,6,25,16,-21,Chinese Communist Party,Mao,ORGANIZATION-ORGANIZATION-ORGANIZATION,PERSON,PROPN-PROPN-PROPN,PROPN,compound-compound-dobj,nsubj,NNP-NNP-NNP,NNP,4,1
12193,59958.0,17,known,8,1,4,3,0,12,7,-4,Sills,Belle Miriam Silverman,PERSON,PERSON-PERSON-PERSON,NOUN,PROPN-PROPN-PROPN,nsubjpass,compound-compound-appos,NNS,NNP-NNP-NNP,4,1
12194,59961.0,19,'s,1,5,8,3,4,10,-4,7,Barry Goldwater,U.S.,PERSON-PERSON,COUNTRY,PROPN-PROPN,PROPN,compound-pobj,compound,NNP-NNP,NNP,1,1
12195,59991.0,35,is,14,31,33,2,30,1,-17,19,Spelman Seminary,about 1896,ORGANIZATION-ORGANIZATION,DATE-DATE,PROPN-PROPN,ADP-NUM,compound-conj,prep-pobj,NNP-NNP,IN-CD,2,1
12196,59999.0,45,dumped,1,32,30,-2,31,14,-31,29,Dan Abrams,General Manager,PERSON-PERSON,TITLE-TITLE,PROPN-PROPN,PROPN-PROPN,compound-conj,compound-compound,NNP-NNP,NNP-NNP,1,1
12197,60011.0,39,erupted,2,24,31,7,23,7,-22,29,he,SA,PERSON,ORGANIZATION,PRON,PROPN,nsubj,pobj,PRP,NNP,3,1
12198,60020.0,49,said,14,25,30,5,24,18,-11,16,Robert M. Morgenthau,90-year-old,PERSON-PERSON-PERSON,DURATION,PROPN-PROPN-PROPN,ADJ,compound-compound-pobj,compound,NNP-NNP-NNP,JJ,5,1
12199,60040.0,19,was,5,2,10,8,1,8,3,5,his,boy,PERSON,TITLE,DET,NOUN,poss,attr,PRP$,NN,4,1
12200,60059.0,67,handled,3,64,38,-26,63,28,-61,35,Chante Moore,Donell Jones,PERSON-PERSON,PERSON-PERSON,PROPN-PROPN,PROPN-PROPN,compound-compound,compound-conj,NNP-NNP,NNP-NNP,-1,1
12201,60070.0,40,SHENG-CHENG,1,1,14,13,0,25,0,13,HU SHENG-CHENG,Council for Economic Planning and Development -LRB- CEPD -RRB-,PERSON-PERSON,ORGANIZATION-ORGANIZATION-ORGANIZATION-ORGANIZATION-ORGANIZATION-ORGANIZATION-ORGANIZATION-ORGANIZATION-ORGANIZATION,PROPN-PROPN,PROPN-ADP-PROPN-PROPN-CCONJ-PROPN-PROPN-PROPN-PROPN,compound-ROOT,pobj-prep-compound-pobj-cc-conj-compound-compound-appos,NNP-NNP,NNP-IN-NNP-NNP-CC-NNP-NNP-NNP-NNP,4,1
12202,60097.0,45,advancing,31,3,2,-1,2,42,28,-29,Brandon McInerney,14-year-old,PERSON-PERSON,DURATION,PROPN-PROPN,PUNCT,compound-nsubj,pobj,NNP-NNP,LS,1,1
12203,67474.0,38,show,36,8,2,-6,7,35,28,-34,Brandon McInerney,14-year-old,PERSON-PERSON,DURATION,PROPN-PROPN,NUM,compound-appos,nsubj,NNP-NNP,CD,5,1
12204,60106.0,29,surrendered,4,1,22,21,0,6,3,18,David,2005,PERSON,DATE,PROPN,NUM,poss,pobj,NNP,CD,6,1
12205,60110.0,38,cautioned,18,3,1,-2,2,36,15,-17,Andre Carson,U.S.,PERSON-PERSON,COUNTRY,PROPN-PROPN,PROPN,compound-nsubj,compound,NNP-NNP,NNP,1,1
12206,60138.0,47,paved,1,35,34,-1,34,12,-34,33,Paavo Nurmi,Finn,PERSON-PERSON,NATIONALITY,PROPN-PROPN,PROPN,compound-pobj,compound,NNP-NNP,NNP,5,1
12207,68055.0,19,is,11,17,15,-2,16,3,-6,4,Paavo Nurmi,Finn,PERSON-PERSON,NATIONALITY,PROPN-PROPN,PROPN,compound-dobj,dobj,NNP-NNP,NNP,2,1
12208,60151.0,41,said,39,1,8,7,0,32,38,-31,China National Aviation,Air China,ORGANIZATION-ORGANIZATION-ORGANIZATION,ORGANIZATION-ORGANIZATION,PROPN-PROPN-PROPN,PROPN-PROPN,compound-compound-nsubj,compound-pobj,NNP-NNP-NNP,NNP-NNP,4,1
12209,60154.0,47,is,8,16,28,12,15,18,-8,20,he,orthodox,PERSON,RELIGION,PRON,NOUN,nsubj,advcl,PRP,NN,2,1
12210,60164.0,33,are,1,27,18,-9,26,14,-26,17,DCR,Massachusetts,ORGANIZATION,STATE_OR_PROVINCE,PROPN,PROPN,compound,nmod,NNP,NNP,10,1
12211,60165.0,19,born,2,1,5,4,0,13,1,3,Buchwald,New York,PERSON,STATE_OR_PROVINCE-STATE_OR_PROVINCE,PROPN,PROPN-PROPN,nsubjpass,compound-compound,NNP,NNP-NNP,4,1
12212,60174.0,23,YORK,1,6,13,7,5,9,-5,12,She,Lincoln Center,PERSON,ORGANIZATION-ORGANIZATION,PRON,PROPN-PROPN,nsubj,compound-pobj,PRP,NNP-NNP,-1,1
12213,60178.0,15,led,1,1,12,11,0,2,0,11,He,coach,PERSON,TITLE,PRON,NOUN,nsubj,oprd,PRP,NN,2,1
12214,60181.0,45,said,17,2,10,8,1,34,15,-7,Barbara Boxer,Senate Committee on Environment and Public Works,PERSON-PERSON,ORGANIZATION-ORGANIZATION-ORGANIZATION-ORGANIZATION-ORGANIZATION-ORGANIZATION-ORGANIZATION,PROPN-PROPN,PROPN-PROPN-ADP-PROPN-CCONJ-PROPN-PROPN,compound-nsubj,compound-pobj-prep-pobj-cc-compound-conj,NNP-NNP,NNP-NNP-IN-NNP-CC-NNP-NNP,4,1
12215,60184.0,31,start,4,25,29,4,24,1,-21,25,Latin American Parliament,Parlacen,ORGANIZATION-ORGANIZATION-ORGANIZATION,ORGANIZATION,ADJ-ADJ-PROPN,PROPN,amod-compound-pobj,compound,JJ-JJ-NNP,NNP,7,1
12216,60189.0,26,is,15,25,12,-13,24,13,-10,-3,TACC,2009,ORGANIZATION,DATE,PROPN,NUM,pobj,pobj,NNP,CD,5,1
12217,60195.0,39,questioned,6,3,1,-2,2,37,3,-5,Mia Farrow,Hollywood actress,PERSON-PERSON,TITLE-TITLE,PROPN-PROPN,PROPN-NOUN,compound-nsubjpass,compound-compound,NNP-NNP,NNP-NN,1,1
12218,60200.0,19,earned,7,17,12,-5,16,6,-10,5,his,Assembly,PERSON,ORGANIZATION,DET,PROPN,poss,pobj,PRP$,NNP,4,1
12219,60210.0,41,said,1,16,14,-2,15,26,-15,13,Kelly Cutrone,PR guru,PERSON-PERSON,TITLE-TITLE,PROPN-PROPN,NOUN-NOUN,compound-pobj,compound-compound,NNP-NNP,NN-NN,1,1
12220,60212.0,37,has,27,5,34,29,4,2,22,7,Andre Carson,congressional district seat,PERSON-PERSON,ORGANIZATION-ORGANIZATION-ORGANIZATION,PROPN-PROPN,ADJ-NOUN-NOUN,compound-nsubj,amod-compound-pobj,NNP-NNP,JJ-NN-NN,5,1
12221,60213.0,60,survived,2,11,21,10,10,38,-9,19,Josephine Robinson McNair,Robert E. Jr.,PERSON-PERSON-PERSON,PERSON-PERSON-PERSON,PROPN-PROPN-PROPN,PROPN-PROPN-PROPN,compound-compound-appos,compound-compound-appos,NNP-NNP-NNP,NNP-NNP-NNP,4,1
12222,60245.0,16,began,13,1,6,5,0,9,12,-7,Spears,misdemeanor,PERSON,CRIMINAL_CHARGE,NOUN,NOUN,poss,compound,NNS,NN,4,1
12223,60246.0,38,dies,12,3,2,-1,2,35,9,-10,Parren Mitchell,Rep,PERSON-PERSON,TITLE,PROPN-PROPN,PROPN,compound-nsubj,compound,NNP-NNP,NNP,1,1
12224,60247.0,69,admitted,4,3,1,-2,2,67,1,-3,Lee Jye,Defense Minister,PERSON-PERSON,TITLE-TITLE,PROPN-PROPN,PROPN-PROPN,compound-nsubj,compound-compound,NNP-NNP,NNP-NNP,1,1
12225,60249.0,25,show,5,24,9,-15,23,15,-19,4,Scorpions,Brian,ORGANIZATION,PERSON,PROPN,PROPN,pobj,dobj,NNPS,NNP,2,1
12226,60260.0,60,fighting,4,1,8,7,0,51,3,4,Arsenal,Premier League,ORGANIZATION,ORGANIZATION-ORGANIZATION,PROPN,PROPN-PROPN,nsubj,compound-pobj,NNP,NNP-NNP,4,1
12227,60265.0,20,targeted,2,17,11,-6,16,8,-15,9,Awami National Party,Waqar Ahmed Khan,ORGANIZATION-ORGANIZATION-ORGANIZATION,PERSON-PERSON-PERSON,PROPN-PROPN-PROPN,PROPN-PROPN-PROPN,compound-compound-pobj,compound-compound-pobj,NNP-NNP-NNP,NNP-NNP-NNP,4,1
12228,60267.0,10,visit,7,5,9,4,4,0,2,2,DCR,www.mass.gov/dcr/projects,ORGANIZATION,URL,PROPN,PROPN,compound,dobj,NNP,NNP,5,1
12229,60280.0,47,URGENT,0,43,39,-4,42,7,-43,39,Chris Dodd,Senate Banking Committee,PERSON-PERSON,ORGANIZATION-ORGANIZATION-ORGANIZATION,PROPN-PROPN,PROPN-PROPN-PROPN,compound-nsubj,compound-compound-compound,NNP-NNP,NNP-NNP-NNP,3,1
12230,60291.0,33,pleaded,5,4,2,-2,3,30,1,-3,Brandon McInerney,murder defendant,PERSON-PERSON,TITLE-TITLE,PROPN-PROPN,NOUN-NOUN,compound-nsubj,compound-compound,NNP-NNP,NN-NN,1,1
12231,60294.0,27,posts,1,25,24,-1,24,2,-24,23,Capitalia SpA,Rome-based,ORGANIZATION-ORGANIZATION,CITY,PROPN-PROPN,PROPN,compound-pobj,compound,NNP-NNP,NNP,3,1
12232,60297.0,29,urged,15,13,5,-8,12,23,2,-10,Nicholas Burns,U.S. State Department,PERSON-PERSON,ORGANIZATION-ORGANIZATION-ORGANIZATION,PROPN-PROPN,PROPN-PROPN-PROPN,compound-appos,compound-compound-poss,NNP-NNP,NNP-NNP-NNP,4,1
12233,60302.0,17,had,1,11,16,5,10,0,-10,15,Blair Deaver,Oregon,PERSON-PERSON,STATE_OR_PROVINCE,PROPN-PROPN,PROPN,compound-conj,appos,NNP-NNP,NNP,4,1
12234,60304.0,76,held,30,51,42,-9,50,33,-21,12,Dee Dee Myers,writer,PERSON-PERSON-PERSON,TITLE,PROPN-PROPN-PROPN,NOUN,compound-compound-appos,compound,NNP-NNP-NNP,NN,8,1
12235,60308.0,65,Ranke,2,42,47,5,41,17,-40,45,George Roy Hill,film director,PERSON-PERSON-PERSON,TITLE-TITLE,PROPN-PROPN-PROPN,NOUN-NOUN,compound-compound-conj,compound-appos,NNP-NNP-NNP,NN-NN,2,1
12236,60321.0,24,said,2,2,1,-1,1,22,0,-1,Millonarios,Bogota-based,ORGANIZATION,CITY,PROPN,PROPN,nsubj,amod,NNP,NNP,1,1
12237,60324.0,49,helped,27,1,10,9,0,38,26,-17,Randall Forsberg,peace institute,PERSON-PERSON,ORGANIZATION-ORGANIZATION,PROPN-PROPN,NOUN-NOUN,compound-nsubj,compound-pobj,NNP-NNP,NN-NN,5,1
12238,60332.0,40,commissioned,5,9,8,-1,8,31,-4,3,Charles Wuorinen,composer,PERSON-PERSON,TITLE,PROPN-PROPN,NOUN,compound-dobj,compound,NNP-NNP,NN,1,1
12239,60344.0,29,supposed,6,16,26,10,15,2,-10,20,Jamie Lynn,Liberty,PERSON-PERSON,CITY,PROPN-PROPN,PROPN,compound-conj,pobj,NNP-NNP,NNP,8,1
12240,60360.0,18,served,1,1,7,6,0,10,0,6,He,U.S. Air Force,PERSON,ORGANIZATION-ORGANIZATION-ORGANIZATION,PRON,PROPN-PROPN-PROPN,nsubj,compound-compound-pobj,PRP,NNP-NNP-NNP,3,1
12241,60367.0,12,died,8,5,1,-4,4,10,3,-7,Alvin H. Rothman,Rothman,PERSON-PERSON-PERSON,PERSON,PROPN-PROPN-PROPN,PROPN,compound-compound-appos,poss,NNP-NNP-NNP,NNP,4,1
12242,60374.0,40,told,6,5,6,1,4,33,1,0,John Negroponte,Negroponte,PERSON-PERSON,PERSON,PROPN-PROPN,PROPN,compound-nsubj,nsubj,NNP-NNP,NNP,1,1
12243,60387.0,37,known,8,17,23,6,16,13,-9,15,his,Congressional Black Caucus,PERSON,ORGANIZATION-ORGANIZATION-ORGANIZATION,DET,PROPN-PROPN-PROPN,poss,compound-compound-pobj,PRP$,NNP-NNP-NNP,6,1
12244,60397.0,33,sets,17,1,15,14,0,17,16,-2,Adam,Dolce Gabbana,PERSON,ORGANIZATION-ORGANIZATION,PROPN,PROPN-PROPN,nsubj,compound-pobj,NNP,NNP-NNP,7,1
12245,60402.0,43,plays,1,24,8,-16,23,34,-23,7,American Basketball Association,the 1970s,ORGANIZATION-ORGANIZATION-ORGANIZATION,DATE-DATE,PROPN-PROPN-PROPN,DET-NOUN,compound-compound-pobj,det-pobj,NNP-NNP-NNP,DT-NNS,7,1
12246,60410.0,51,died,44,3,7,4,2,43,41,-37,Robert E. McNair,South Carolina,PERSON-PERSON-PERSON,STATE_OR_PROVINCE-STATE_OR_PROVINCE,PROPN-PROPN-PROPN,PROPN-PROPN,compound-compound-nsubj,compound-pobj,NNP-NNP-NNP,NNP-NNP,3,1
12247,60424.0,42,said,17,35,40,5,34,1,-18,23,Ahearn,State Department,PERSON,ORGANIZATION-ORGANIZATION,PROPN,PROPN-PROPN,poss,compound-pobj,NNP,NNP-NNP,11,1
12248,60462.0,32,survived,7,16,6,-10,15,25,-9,-1,Silvestre,he,PERSON,PERSON,PROPN,PRON,appos,nsubjpass,NNP,PRP,7,1
12249,60472.0,43,folded,41,8,2,-6,7,40,33,-39,Sports Affairs Council,SBL,ORGANIZATION-ORGANIZATION-ORGANIZATION,ORGANIZATION,PROPN-PROPN-PROPN,PROPN,compound-compound-pobj,nsubjpass,NNPS-NNPS-NNP,NNP,5,1
12250,60479.0,44,showing,30,14,19,5,13,24,16,-11,Jamie Lynn Spears,TV actress,PERSON-PERSON-PERSON,TITLE-TITLE,PROPN-PROPN-PROPN,NOUN-NOUN,compound-compound-appos,compound-appos,NNP-NNP-NNPS,NN-NN,6,1
12251,60491.0,41,hope,1,27,39,12,26,1,-26,38,Barry Goldwater,American,PERSON-PERSON,NATIONALITY,PROPN-PROPN,ADJ,compound-pobj,amod,NNP-NNP,JJ,6,1
12252,60500.0,24,broke,1,10,10,0,9,13,-9,9,Kate Gosselin,Kate Plus,PERSON-PERSON,ORGANIZATION-ORGANIZATION,PROPN-PROPN,PROPN-CCONJ,compound-dobj,compound-appos,NNP-NNP,NNP-CC,0,1
12253,60503.0,55,said,30,37,44,7,36,10,-7,14,AQR Capital,Greenwich,ORGANIZATION-ORGANIZATION,CITY,PROPN-PROPN,PROPN,compound-pobj,pobj,NNP-NNP,NNP,4,1
12254,60515.0,15,applauded,10,7,1,-6,6,13,3,-9,American Bankers Associated,Edward Yingling,ORGANIZATION-ORGANIZATION-ORGANIZATION,PERSON-PERSON,PROPN-PROPN-PROPN,PROPN-PROPN,compound-compound-pobj,compound-nsubj,NNP-NNPS-NNP,NNP-NNP,4,1
12255,60518.0,25,married,1,1,3,2,0,21,0,2,Banda,Flora,PERSON,PERSON,PROPN,PROPN,nsubj,dobj,NNP,NNP,1,1
12256,60538.0,32,refused,5,19,18,-1,18,13,-14,13,John Sweeney,representative,PERSON-PERSON,TITLE,PROPN-PROPN,NOUN,compound-appos,pobj,NNP-NNP,NN,1,1
12257,60567.0,36,suffered,12,27,32,5,26,3,-15,20,ISU,Tokyo,ORGANIZATION,CITY,PROPN,PROPN,compound,pobj,NNP,NNP,6,1
12258,60572.0,25,Good,1,9,11,2,8,13,-8,10,his,Andrew,PERSON,PERSON,DET,PROPN,poss,appos,PRP$,NNP,2,1
12259,60587.0,27,taught,8,2,12,10,1,14,6,4,his,New Iberia,PERSON,CITY-CITY,DET,PROPN-PROPN,poss,compound-pobj,PRP$,NNP-NNP,3,1
12260,60589.0,45,makes,6,2,1,-1,1,43,4,-5,Charles Wuorinen,Composer,PERSON-PERSON,TITLE,PROPN-PROPN,PROPN,compound-poss,compound,NNP-NNP,NNP,1,1
12261,60592.0,19,let,1,14,18,4,13,0,-13,17,he,Levant,PERSON,PERSON,PRON,PROPN,nsubj,pobj,PRP,NNP,5,1
12262,60606.0,38,told,17,16,11,-5,15,26,1,-6,Carolyn Maloney,Washington,PERSON-PERSON,ORGANIZATION,PROPN-PROPN,PROPN,compound-nsubj,pobj,NNP-NNP,NNP,8,1
12263,60612.0,35,said,10,27,22,-5,26,12,-17,12,PRC,Amer Qarmout,ORGANIZATION,PERSON-PERSON,PROPN,PROPN-PROPN,compound,compound-pobj,NNP,NNP-NNP,1,1
12264,60618.0,39,tried,1,1,33,32,0,5,0,32,Derounian,Central Intelligence Agency,PERSON,ORGANIZATION-ORGANIZATION-ORGANIZATION,PROPN,PROPN-PROPN-PROPN,nsubj,compound-compound-pobj,NNP,NNP-NNP-NNP,13,1
12265,60626.0,28,said,26,2,19,17,1,8,24,-7,Scheider,infection,PERSON,CAUSE_OF_DEATH,PROPN,NOUN,nsubj,pobj,NNP,NN,3,1
12266,60628.0,25,graduated,1,1,7,6,0,17,0,6,He,Morgan State University,PERSON,ORGANIZATION-ORGANIZATION-ORGANIZATION,PRON,PROPN-PROPN-PROPN,nsubj,compound-compound-attr,PRP,NNP-NNP-NNP,4,1
12267,60634.0,30,said,5,2,4,2,1,25,3,-1,Waratahs,Chris Hickey,ORGANIZATION,PERSON-PERSON,PROPN,PROPN-PROPN,compound,compound-nsubj,NNP,NNP-NNP,1,1
12268,60636.0,56,been,14,12,44,32,11,11,2,30,ISU,USFSA,ORGANIZATION,ORGANIZATION,PROPN,PROPN,appos,compound,NNP,NNP,3,1
12269,60641.0,18,says,7,4,1,-3,3,16,3,-6,Focus on the Family,Conservative Christian,ORGANIZATION-ORGANIZATION-ORGANIZATION-ORGANIZATION,RELIGION-RELIGION,PROPN-ADP-DET-PROPN,ADJ-ADJ,appos-prep-det-pobj,amod-amod,NNP-IN-DT-NNP,JJ-JJ,3,1
12270,60649.0,32,avoided,16,9,13,4,8,18,7,-3,Covidien,Tyco International Ltd.,ORGANIZATION,ORGANIZATION-ORGANIZATION-ORGANIZATION,PROPN,PROPN-PROPN-PROPN,nsubj,compound-compound-pobj,NNP,NNP-NNP-NNP,6,1
12271,60655.0,31,was,19,10,17,7,9,13,9,-2,Robert M Morgenthau,Henry Morgenthau,PERSON-PERSON-PERSON,PERSON-PERSON,PROPN-PROPN-PROPN,PROPN-PROPN,compound-compound-appos,compound-appos,NNP-NNP-NNP,NNP-NNP,5,1
12272,60676.0,5,Judge,0,3,1,-2,2,3,-3,1,Simon Cow,Judge,PERSON-PERSON,TITLE,PROPN-PROPN,NOUN,compound-appos,ROOT,NNP-NNP,NN,2,1
12273,60694.0,28,told,1,16,8,-8,15,19,-15,7,this football club,wwwarsenalcom,ORGANIZATION-ORGANIZATION-ORGANIZATION,URL,DET-NOUN-NOUN,NOUN,det-compound-pobj,dobj,DT-NN-NN,NN,5,1
12274,60715.0,31,canceling,4,18,15,-3,17,15,-14,11,Philip Chen,deputy managing director,PERSON-PERSON,TITLE-TITLE-TITLE,PROPN-PROPN,ADJ-VERB-NOUN,compound-nsubjpass,nmod-amod-compound,NNP-NNP,JJ-VBG-NN,3,1
12275,60723.0,28,born,4,1,25,24,0,2,3,21,Augustus Freeman Hawkins,Hattie Helena Hawkins,PERSON-PERSON-PERSON,PERSON-PERSON-PERSON,PROPN-PROPN-PROPN,PROPN-PROPN-PROPN,compound-compound-nsubjpass,compound-compound-conj,NNP-NNP-NNP,NNP-NNP-NNP,11,1
12276,60725.0,41,was,4,1,3,2,0,37,3,-1,Sandy,28,PERSON,NUMBER,PROPN,NUM,nsubj,appos,NNP,CD,3,1
12277,60727.0,25,offered,7,22,20,-2,21,4,-15,13,Golden Baseball League,US,ORGANIZATION-ORGANIZATION-ORGANIZATION,COUNTRY,PROPN-PROPN-PROPN,PROPN,compound-compound-pobj,nmod,NNP-NNP-NNP,NNP,2,1
12278,60732.0,27,said,8,2,7,5,1,19,6,-1,Hong Kong Disneyland,Andrew Kam,ORGANIZATION-ORGANIZATION-ORGANIZATION,PERSON-PERSON,PROPN-PROPN-PROPN,PROPN-PROPN,compound-nmod-nmod,compound-nsubj,NNP-NNP-NNP,NNP-NNP,3,1
12279,60739.0,46,said,41,26,30,4,25,15,15,-11,Carolyn B. Maloney,D-N.Y.,PERSON-PERSON-PERSON,LOCATION,PROPN-PROPN-PROPN,PROPN,compound-compound-nsubj,conj,NNP-NNP-NNP,NNP,2,1
12280,60741.0,19,was,1,1,3,2,0,15,0,2,He,president,PERSON,TITLE,PRON,NOUN,nsubj,attr,PRP,NN,2,1
12281,60747.0,24,obituary,6,9,13,4,8,10,-3,7,Richard Nolte,diplomat,PERSON-PERSON,TITLE,PROPN-PROPN,NOUN,compound-pobj,appos,NNP-NNP,NN,2,1
12282,60762.0,35,dies,31,8,14,6,7,20,23,-17,Kurt Waldheim,Austrian,PERSON-PERSON,NATIONALITY,PROPN-PROPN,ADJ,compound-appos,amod,NNP-NNP,JJ,2,1
12283,60766.0,42,feature,20,32,2,-30,31,39,-12,-18,Babyshambles,Montreux,PERSON,CITY,PROPN,PROPN,nsubj,compound,NNPS,NNP,9,1
12284,60777.0,11,Gude,1,1,6,5,0,4,0,5,Jane Gude,Widow Active,PERSON-PERSON,ORGANIZATION-ORGANIZATION,PROPN-PROPN,PROPN-PROPN,compound-ROOT,compound-appos,NNP-NNP,NNP-NNP,1,1
12285,60782.0,14,was,6,2,10,8,1,3,4,4,Zubaydah,al-Qaida leader,PERSON,TITLE-TITLE,PROPN,CCONJ-NOUN,poss,compound-attr,NNP,CC-NN,6,1
12286,60799.0,41,said,22,24,28,4,23,12,-2,6,Richard Perle,fellow,PERSON-PERSON,TITLE,PROPN-PROPN,NOUN,compound-nsubj,appos,NNP-NNP,NN,2,1
12287,60805.0,17,said,15,12,14,2,11,2,3,-1,FMCSA,Kristin Schrader,ORGANIZATION,PERSON-PERSON,PROPN,PROPN-PROPN,compound,compound-nsubj,NNP,NNP-NNP,4,1
12288,60815.0,33,aims,16,16,8,-8,15,24,0,-8,NCF,Samuel Noordhoff,ORGANIZATION,PERSON-PERSON,PROPN,PROPN-PROPN,nsubj,compound-pobj,NNP,NNP-NNP,3,1
12289,60817.0,7,Watson,2,2,7,5,1,-1,0,5,Paul Watson,Greenpeace,PERSON-PERSON,ORGANIZATION,PROPN-PROPN,PROPN,compound-ROOT,pobj,NNP-NNP,NNP,2,1
12290,61048.0,37,expelled,14,3,12,9,2,24,11,-2,Paul Watson,Greenpeace,PERSON-PERSON,ORGANIZATION,PROPN-PROPN,PROPN,compound-nsubjpass,pobj,NNP-NNP,NNP,2,1
12291,60819.0,29,said,19,17,12,-5,16,16,2,-7,American Motorcyclist Association,U.S.,ORGANIZATION-ORGANIZATION-ORGANIZATION,COUNTRY,PROPN-PROPN-PROPN,PROPN,compound-compound-nsubj,compound,NNP-NNP-NNP,NNP,6,1
12292,60822.0,40,said,28,30,34,4,29,5,-2,6,Sean Ross,radio analyst,PERSON-PERSON,TITLE-TITLE,PROPN-PROPN,NOUN-NOUN,compound-nsubj,compound-appos,NNP-NNP,NN-NN,3,1
12293,60826.0,26,replaces,1,3,9,6,2,16,-2,8,CMA,Kay Stafford,ORGANIZATION,PERSON-PERSON,PROPN,PROPN-PROPN,poss,compound-appos,NNP,NNP-NNP,3,1
12294,60827.0,80,states,78,1,5,4,0,74,77,-73,DeBlanc,pilots,PERSON,TITLE,PROPN,NOUN,nsubj,conj,NNP,NNS,2,1
12295,60833.0,29,made,19,3,8,5,2,20,16,-11,Lindsay M Hayes,national prison specialist,PERSON-PERSON-PERSON,TITLE-TITLE-TITLE,PROPN-PROPN-PROPN,ADJ-NOUN-NOUN,compound-compound-pobj,amod-compound-appos,NNP-NNP-NNP,JJ-NN-NN,3,1
12296,60846.0,9,Adam,0,1,8,7,0,0,-1,8,Adam,Hamptons Fun,PERSON,PERSON-PERSON,PROPN,PROPN-PROPN,ROOT,compound-ROOT,NNP,NNP-NNP,2,1
12297,60878.0,15,is,1,13,11,-2,12,3,-12,10,Paul Sculfor,construction worker,PERSON-PERSON,TITLE-TITLE,PROPN-PROPN,NOUN-NOUN,compound-conj,compound-conj,NNP-NNP,NN-NN,2,1
12298,60892.0,39,said,37,1,27,26,0,11,36,-10,Kurt Waldheim,a heart attack,PERSON-PERSON,CAUSE_OF_DEATH-CAUSE_OF_DEATH-CAUSE_OF_DEATH,PROPN-PROPN,DET-NOUN-NOUN,compound-nsubj,det-compound-pobj,NNP-NNP,DT-NN-NN,4,1
12299,60901.0,33,played,5,4,4,0,3,28,1,-1,McNair,McNair,PERSON,PERSON,PROPN,PROPN,nsubj,nsubj,NNP,NNP,0,1
12300,60911.0,30,said,15,24,26,2,23,3,-9,11,ADB,Southeast Asia Regional Department,ORGANIZATION,ORGANIZATION-ORGANIZATION-ORGANIZATION-ORGANIZATION,PROPN,PROPN-PROPN-PROPN-PROPN,poss,compound-compound-compound-pobj,NNP,NNP-NNP-NNP-NNP,3,1
12301,60926.0,32,was,5,7,4,-3,6,27,-2,-1,her,City Opera,PERSON,ORGANIZATION-ORGANIZATION,DET,PROPN-PROPN,nsubj,compound-nsubj,PRP$,NNP-NNP,2,1
12302,60929.0,10,been,2,1,7,6,0,2,1,5,Beyonce,L'Oréal,PERSON,ORGANIZATION,PROPN,PROPN,nsubj,pobj,NNP,NNP,2,1
12303,60932.0,23,explored,12,2,1,-1,1,21,10,-11,Bradford Washburn,Photographer,PERSON-PERSON,TITLE,PROPN-PROPN,PROPN,compound-nsubj,compound,NNP-NNP,NNP,1,1
12304,60940.0,42,appointed,7,1,9,8,0,32,6,2,Philip Chen,chairman,PERSON-PERSON,TITLE,PROPN-PROPN,NOUN,compound-nsubjpass,oprd,NNP-NNP,NN,3,1
12305,60945.0,24,said,9,7,1,-6,6,22,2,-8,Le Point,Caroline Puel,ORGANIZATION-ORGANIZATION,PERSON-PERSON,PROPN-PROPN,PROPN-PROPN,compound-pobj,compound-nsubj,NNP-NNP,NNP-NNP,2,1
12306,60957.0,4,Association,2,1,4,3,0,-1,1,2,American Beverage Association,http://www.ameribev.org,ORGANIZATION-ORGANIZATION-ORGANIZATION,URL,PROPN-PROPN-PROPN,PUNCT,compound-compound-ROOT,punct,NNP-NNP-NNP,.,-1,1
12307,60978.0,68,said,13,7,12,5,6,55,6,-1,Mainland Affairs Council,Tung Cheng-yuan,ORGANIZATION-ORGANIZATION-ORGANIZATION,PERSON-PERSON,PROPN-PROPN-PROPN,PROPN-PROPN,compound-compound-compound,compound-nsubj,NNP-NNPS-NNP,NNP-NNP,4,1
12308,60982.0,36,Works,3,6,2,-4,5,33,-3,-1,FAW,First Automotive Works,ORGANIZATION,ORGANIZATION-ORGANIZATION-ORGANIZATION,PROPN,PROPN-PROPN-PROPN,compound,compound-compound-ROOT,NNP,NNP-NNP-NNP,3,1
12309,60983.0,38,taught,16,3,13,10,2,24,13,-3,George Young,Oklahoma City,PERSON-PERSON,CITY-CITY,PROPN-PROPN,PROPN-PROPN,compound-nsubj,compound-pobj,NNP-NNP,NNP-NNP,5,1
12310,60998.0,45,2007-09-27T09,0,5,4,-1,4,40,-5,4,Richard Lindzen,Professor of Atmospheric Sciences,PERSON-PERSON,TITLE-TITLE-TITLE-TITLE,PROPN-PROPN,PROPN-ADP-PROPN-PROPN,compound-nsubj,appos-prep-compound-pobj,NNP-NNP,NNP-IN-NNP-NNPS,3,1
12311,61004.0,57,unleashed,12,6,3,-3,5,53,6,-9,aid program,American Red Cross,ORGANIZATION-ORGANIZATION,ORGANIZATION-ORGANIZATION-ORGANIZATION,NOUN-NOUN,PROPN-PROPN-PROPN,compound-nsubj,compound-compound-compound,NN-NN,NNP-NNP-NNP,2,1
12312,61015.0,31,said,8,1,5,4,0,25,7,-3,ADB,Joseph Ernest Zveglich Jr.,ORGANIZATION,PERSON-PERSON-PERSON-PERSON,PROPN,PROPN-PROPN-PROPN-PROPN,compound,compound-compound-compound-nsubj,NNP,NNP-NNP-NNP-NNP,3,1
12313,61025.0,34,reports,2,21,18,-3,20,15,-19,16,Jake Pavelka,Jessie Pavelka,PERSON-PERSON,PERSON-PERSON,PROPN-PROPN,PROPN-PROPN,compound-conj,compound-appos,NNP-NNP,NNP-NNP,2,1
12314,61035.0,34,prepares,4,4,29,25,3,4,0,25,Simon,Cowell,PERSON,PERSON,PROPN,PROPN,nsubj,poss,NNP,NNP,-1,1
12315,61036.0,34,said,12,1,4,3,0,29,11,-8,Mohammed ElBaradei,director,PERSON-PERSON,TITLE,PROPN-PROPN,NOUN,compound-nsubj,appos,NNP-NNP,NN,2,1
12316,61055.0,45,had,3,15,43,28,14,1,-12,40,Raul Castro,brother,PERSON-PERSON,PERSON,PROPN-PROPN,NOUN,compound-nsubj,pobj,NNP-NNP,NN,10,1
12317,61056.0,16,hands,8,12,15,3,11,0,-4,7,Raul Castro,75,PERSON-PERSON,NUMBER,PROPN-PROPN,NUM,compound-pobj,appos,NNP-NNP,CD,3,1
12318,61057.0,40,reports,38,10,18,8,9,21,28,-20,Sculfor,36,PERSON,NUMBER,PROPN,NUM,dobj,appos,NNP,CD,5,1
12319,61070.0,38,came,2,22,17,-5,21,20,-20,15,Paul Kim,Korean - American,PERSON-PERSON,NATIONALITY-NATIONALITY-NATIONALITY,PROPN-PROPN,ADJ-PUNCT-ADJ,compound-appos,amod-punct-amod,NNP-NNP,JJ-HYPH-JJ,4,1
12320,61085.0,37,heckled,18,22,33,11,21,3,-4,15,Alberto Gonzales,Harvard Law School,PERSON-PERSON,ORGANIZATION-ORGANIZATION-ORGANIZATION,PROPN-PROPN,PROPN-PROPN-PROPN,compound-dobj,compound-compound-compound,NNP-NNP,NNP-NNP-NNP,5,1
12321,61106.0,16,is,1,11,6,-5,10,9,-10,5,Kerry,Senate Foreign Relations Committee,PERSON,ORGANIZATION-ORGANIZATION-ORGANIZATION-ORGANIZATION,PROPN,PROPN-PROPN-PROPN-PROPN,conj,compound-compound-compound-pobj,NNP,NNP-NNP-NNPS-NNP,4,1
12322,61108.0,25,fired,7,16,1,-15,15,23,-9,-6,his,University of Colorado,PERSON,ORGANIZATION-ORGANIZATION-ORGANIZATION,DET,PROPN-ADP-PROPN,poss,nmod-prep-pobj,PRP$,NNP-IN-NNP,9,1
12323,61117.0,54,had,23,5,1,-4,4,52,18,-22,Christopher J. Dodd,Senate,PERSON-PERSON-PERSON,ORGANIZATION,PROPN-PROPN-PROPN,PROPN,compound-compound-nsubj,compound,NNP-NNP-NNP,NNP,4,1
12324,61119.0,36,starts,1,6,4,-2,5,31,-5,3,Beyonce Knowles,executive producer,PERSON-PERSON,TITLE-TITLE,PROPN-PROPN,ADJ-NOUN,compound-pobj,amod-compound,NNP-NNP,JJ-NN,1,1
12325,61120.0,18,is,1,1,9,8,0,8,0,8,FirstGroup,U.K.,ORGANIZATION,LOCATION,PROPN,PROPN,nsubj,pobj,NNP,NNP,1,1
12326,61123.0,19,was,10,8,1,-7,7,17,2,-9,R Nicholas Burns,Under Secretary of State for Political Affairs,PERSON-PERSON-PERSON,TITLE-TITLE-TITLE-TITLE-TITLE-TITLE-TITLE,PROPN-PROPN-PROPN,ADP-PROPN-ADP-PROPN-ADP-PROPN-PROPN,compound-compound-nsubj,prep-nmod-prep-pobj-prep-compound-pobj,NNP-NNP-NNP,IN-NNP-IN-NNP-IN-NNP-NNPS,4,1
12327,61153.0,24,were,7,1,12,11,0,11,6,5,The Inquirer and the Philadelphia Daily News,Knight Ridder Inc,ORGANIZATION-ORGANIZATION-ORGANIZATION-ORGANIZATION-ORGANIZATION-ORGANIZATION-ORGANIZATION,ORGANIZATION-ORGANIZATION-ORGANIZATION,DET-PROPN-CCONJ-DET-PROPN-PROPN-PROPN,PROPN-PROPN-PROPN,det-nsubj-cc-det-compound-compound-conj,compound-compound-pobj,DT-NNP-CC-DT-NNP-NNP-NNP,NNP-NNP-NNP,5,1
12328,61174.0,26,born,2,1,14,13,0,11,1,12,Bellecourt,"Oct 17 , 1931",PERSON,DATE-DATE-DATE-DATE,PROPN,PROPN-NUM-PUNCT-NUM,nsubjpass,pobj-nummod-punct-nummod,NNP,"NNP-CD-,-CD",3,1
12329,61207.0,32,been,3,16,6,-10,15,25,-13,3,her,fashion designer,PERSON,TITLE-TITLE,DET,NOUN-NOUN,poss,compound-attr,PRP$,NN-NN,5,1
12330,61211.0,31,began,1,10,13,3,9,17,-9,12,Yolanda,Yoki,PERSON,PERSON,PROPN,PROPN,nsubj,oprd,NNP,NNP,3,1
12331,61218.0,32,sets,10,8,6,-2,7,25,2,-4,Danny Glover,Ahab,PERSON-PERSON,PERSON,PROPN-PROPN,PROPN,compound-compound,compound,NNP-NNP,NNP,2,1
12332,61219.0,26,by,3,19,11,-8,18,14,-16,8,Pamela Martin & Associates,132,ORGANIZATION-ORGANIZATION-ORGANIZATION-ORGANIZATION,NUMBER,PROPN-PROPN-CCONJ-PROPN,NUM,compound-pobj-cc-conj,nummod,NNP-NNP-CC-NNPS,CD,3,1
12333,61225.0,33,said,13,3,12,9,2,20,10,-1,Manuel Barcena,Zamboanga,PERSON-PERSON,CITY,PROPN-PROPN,PROPN,compound-nsubj,pobj,NNP-NNP,NNP,2,1
12334,61241.0,31,insisted,7,1,6,5,0,24,6,-1,Federal Motor Carrier Safety,John Hill,ORGANIZATION-ORGANIZATION-ORGANIZATION-ORGANIZATION,PERSON-PERSON,PROPN-PROPN-PROPN-PROPN,PROPN-PROPN,compound-compound-compound-compound,compound-nsubj,NNP-NNP-NNP-NNP,NNP-NNP,4,1
12335,61260.0,47,scheduled,11,7,1,-6,6,45,4,-10,Massachusetts House of Representatives,SENATE-KENNEDY-SEAT,ORGANIZATION-ORGANIZATION-ORGANIZATION-ORGANIZATION,ORGANIZATION,PROPN-PROPN-ADP-PROPN,ADJ,compound-nsubjpass-prep-pobj,compound,NNP-NNP-IN-NNPS,JJS,-1,1
12336,61265.0,30,looked,14,8,12,4,7,17,6,-2,her,former Playboy bunny,PERSON,TITLE-TITLE-TITLE,DET,ADJ-PROPN-NOUN,poss,amod-compound-nsubj,PRP$,JJ-NNP-NN,6,1
12337,61268.0,28,said,13,10,19,9,9,8,3,6,his,29-year-old,PERSON,DURATION,DET,NUM,poss,amod,PRP$,CD,10,1
12338,61277.0,37,said,6,1,5,4,0,31,5,-1,ConAgra,Andre Hawaux,ORGANIZATION,PERSON-PERSON,PROPN,PROPN-PROPN,compound,compound-nsubj,NNP,NNP-NNP,2,1
12339,61308.0,30,became,1,15,27,12,14,2,-14,26,she,Foreign Affairs Committee,PERSON,ORGANIZATION-ORGANIZATION-ORGANIZATION,PRON,PROPN-PROPN-PROPN,nsubj,compound-compound-conj,PRP,NNP-NNPS-NNP,3,1
12340,61314.0,13,became,3,3,5,2,2,7,0,2,she,general director,PERSON,TITLE-TITLE,PRON,ADJ-NOUN,nsubj,amod-attr,PRP,JJ-NN,1,1
12341,61318.0,43,founded,17,33,42,9,32,0,-16,25,John Dewey,Columbia,PERSON-PERSON,STATE_OR_PROVINCE,PROPN-PROPN,PROPN,compound-appos,pobj,NNP-NNP,NNP,5,1
12342,61321.0,56,said,21,31,23,-8,30,32,-10,2,American Bankers Association,Mark Tenhundfeld,ORGANIZATION-ORGANIZATION-ORGANIZATION,PERSON-PERSON,PROPN-PROPN-PROPN,PROPN-PROPN,compound-compound-pobj,compound-nsubj,NNP-NNPS-NNP,NNP-NNP,4,1
12343,61332.0,17,was,11,1,16,15,0,0,10,5,Ms King,producer,PERSON-PERSON,TITLE,PROPN-PROPN,NOUN,compound-nsubj,conj,NNP-NNP,NN,2,1
12344,61351.0,50,died,35,1,37,36,0,12,34,2,Gilbert Gude,June 7,PERSON-PERSON,DATE-DATE,PROPN-PROPN,PROPN-NUM,compound-nsubj,npadvmod-nummod,NNP-NNP,NNP-CD,3,1
12345,61356.0,44,said,27,41,29,-12,40,14,-14,2,International Monetary Fund,Jahangir Amuzegar,ORGANIZATION-ORGANIZATION-ORGANIZATION,PERSON-PERSON,PROPN-PROPN-PROPN,PROPN-PROPN,compound-compound-pobj,compound-nsubj,NNP-NNP-NNP,NNP-NNP,5,1
12346,61357.0,37,University,3,3,10,7,2,26,0,7,Norwegian University of Science and Technology,NTNU,ORGANIZATION-ORGANIZATION-ORGANIZATION-ORGANIZATION-ORGANIZATION-ORGANIZATION,ORGANIZATION,PROPN-PROPN-ADP-PROPN-CCONJ-PROPN,PROPN,compound-ROOT-prep-pobj-cc-conj,compound,NNP-NNP-IN-NNP-CC-NNP,NNP,1,1
12347,61370.0,30,died,2,2,8,6,1,21,0,6,Goodman,1969,PERSON,DATE,PROPN,NUM,poss,pobj,NNP,CD,1,1
12348,61412.0,49,became,20,12,31,19,11,17,8,11,his,Bureau of Indian Affairs,PERSON,ORGANIZATION-ORGANIZATION-ORGANIZATION-ORGANIZATION,DET,PROPN-ADP-PROPN-PROPN,poss,pobj-prep-compound-compound,PRP$,NNP-IN-NNP-NNPS,10,1
12349,61417.0,35,survived,2,11,12,1,10,22,-9,10,Emily Ann Kennard Derounian,Ann Banks,PERSON-PERSON-PERSON-PERSON,PERSON-PERSON,PROPN-PROPN-PROPN-PROPN,PROPN-PROPN,compound-compound-compound-appos,compound-conj,NNP-NNP-NNP-NNP,NNP-NNP,1,1
12350,61424.0,9,.,2,5,4,-1,4,4,-3,2,Gilbert Gude,Congressman,PERSON-PERSON,TITLE,PROPN-PROPN,PROPN,compound-compound,compound,NNP-NNP,NNP,1,1
12351,61427.0,21,became,1,3,1,-2,2,19,-2,0,Nitschmann,Acerra,ORGANIZATION,PERSON,PROPN,PROPN,poss,nsubj,NNP,NNP,3,1
12352,61430.0,18,has,2,1,5,4,0,12,1,3,Illinois-based IPSCO,"4,400 employees",ORGANIZATION-ORGANIZATION,NUMBER-NUMBER,VERB-PROPN,NUM-NOUN,amod-nsubj,nummod-dobj,VBN-NNP,CD-NNS,6,1
12353,61431.0,42,hearing,7,25,19,-6,24,22,-18,12,he,pianist,PERSON,TITLE,PRON,NOUN,nsubj,dobj,PRP,NN,3,1
12354,61434.0,38,said,12,21,6,-15,20,31,-9,-6,American Bar Association,the World Justice Project,ORGANIZATION-ORGANIZATION-ORGANIZATION,ORGANIZATION-ORGANIZATION-ORGANIZATION-ORGANIZATION,PROPN-PROPN-PROPN,DET-PROPN-PROPN-PROPN,compound-compound-pobj,det-compound-compound-pobj,NNP-NNP-NNP,DT-NNP-NNP-NNP,9,1
12355,61443.0,24,named,7,6,18,12,5,5,1,11,he,White House,PERSON,ORGANIZATION-ORGANIZATION,PRON,PROPN-PROPN,nsubjpass,compound-compound,PRP,NNP-NNP,4,1
12356,61444.0,19,graduated,2,1,16,15,0,2,1,14,Ms King,New York University,PERSON-PERSON,ORGANIZATION-ORGANIZATION-ORGANIZATION,NOUN-PROPN,PROPN-PROPN-PROPN,compound-nsubj,compound-compound-pobj,NNS-NNP,NNP-NNP-NNP,5,1
12357,61460.0,44,said,9,1,5,4,0,38,8,-4,George Young,leader,PERSON-PERSON,TITLE,PROPN-PROPN,NOUN,compound-nsubj,appos,NNP-NNP,NN,2,1
12358,61465.0,34,said,2,1,7,6,0,26,1,5,He,KMT,PERSON,ORGANIZATION,PRON,PROPN,nsubj,compound,PRP,NNP,4,1
12359,61507.0,31,worked,8,27,15,-12,26,15,-19,7,National Soft Drink Association,Washington,ORGANIZATION-ORGANIZATION-ORGANIZATION-ORGANIZATION,STATE_OR_PROVINCE,PROPN-PROPN-PROPN-PROPN,PROPN,compound-compound-compound-pobj,compound,NNP-NNP-NNP-NNP,NNP,11,1
12360,61523.0,18,predicted,1,12,7,-5,11,10,-11,6,Carson,African,PERSON,NATIONALITY,PROPN,PROPN,conj,compound,NNP,NNP,2,1
12361,61540.0,25,owned,3,22,6,-16,21,18,-19,3,Aerolineas Argentinas,Grupo Marsans of Spain,ORGANIZATION-ORGANIZATION,ORGANIZATION-ORGANIZATION-ORGANIZATION-ORGANIZATION,PROPN-PROPN,PROPN-PROPN-ADP-PROPN,compound-compound,compound-pobj-prep-pobj,NNP-NNP,NNP-NNPS-IN-NNP,6,1
12362,61547.0,35,chaired,3,29,32,3,28,2,-26,29,Awami League,Khaleda Khanam,ORGANIZATION-ORGANIZATION,PERSON-PERSON,PROPN-PROPN,PROPN-PROPN,compound-compound,compound-appos,NNP-NNP,NNP-NNP,2,1
12363,61556.0,22,told,17,1,17,16,0,4,16,0,Buchwald,Joel,PERSON,PERSON,PROPN,PROPN,nsubj,appos,NNP,NNP,1,1
12364,68008.0,50,survived,9,8,6,-2,7,43,1,-3,Buchwald,Joel,PERSON,PERSON,PROPN,PROPN,nsubjpass,appos,NNP,NNP,2,1
12365,61565.0,19,is,5,7,5,-2,6,13,-2,0,Hugo de los Reyes Chavez,Barinas,PERSON-PERSON-PERSON-PERSON-PERSON,STATE_OR_PROVINCE,PROPN-PROPN-PROPN-PROPN-PROPN,PROPN,compound-compound-compound-compound-attr,pobj,NNP-NNP-NNP-NNP-NNP,NNP,2,1
12366,61577.0,33,said,11,21,13,-8,20,19,-10,2,Highland Capital Partners,Daniel J. Nova,ORGANIZATION-ORGANIZATION-ORGANIZATION,PERSON-PERSON-PERSON,PROPN-PROPN-PROPN,PROPN-PROPN-PROPN,compound-compound-pobj,compound-compound-nsubj,NNP-NNP-NNP,NNP-NNP-NNP,3,1
12367,61584.0,10,survived,3,1,6,5,0,3,2,3,Yolanda King,her sister,PERSON-PERSON,PERSON-PERSON,PROPN-PROPN,DET-NOUN,compound-nsubjpass,poss-pobj,NNP-NNP,PRP$-NN,3,1
12368,61591.0,42,said,10,5,1,-4,4,40,5,-9,Christopher Dodd,Thomas Dodd Jr,PERSON-PERSON,PERSON-PERSON-PERSON,PROPN-PROPN,PROPN-PROPN-PROPN,compound-poss,compound-compound-nsubj,NNP-NNP,NNP-NNP-NNP,3,1
12369,61592.0,25,served,1,1,21,20,0,3,0,20,Gude,Cornell University,PERSON,ORGANIZATION-ORGANIZATION,PROPN,PROPN-PROPN,nsubj,compound-pobj,NNP,NNP-NNP,5,1
12370,61593.0,54,include,1,25,8,-17,24,45,-24,7,Frank DeBlanc,Jefferson DeBlanc Jr.,PERSON-PERSON,PERSON-PERSON-PERSON,PROPN-PROPN,PROPN-PROPN-PROPN,compound-appos,compound-compound-appos,NNP-NNP,NNP-NNP-NNP,3,1
12371,61603.0,39,paired,10,8,6,-2,7,32,2,-4,Brad Washburn,Museum,PERSON-PERSON,ORGANIZATION,PROPN-PROPN,PROPN,compound-pobj,compound,NNP-NNP,NNP,2,1
12372,61615.0,20,worked,6,1,4,3,0,15,5,-2,Lindsey Hord,55,PERSON-PERSON,NUMBER,PROPN-PROPN,NUM,compound-nsubj,appos,NNP-NNP,CD,2,1
12373,61616.0,3,FMCSA,0,1,3,2,0,-1,-1,3,FMCSA,http://www.fmcsa.dot.gov,ORGANIZATION,URL,PROPN,PROPN,ROOT,punct,NNP,NNP,-1,1
12374,61622.0,33,said,7,1,4,3,0,28,6,-3,McAllister,spokesman,PERSON,TITLE,PROPN,NOUN,nsubj,appos,NNP,NN,3,1
12375,61633.0,46,defeated,33,15,18,3,14,27,18,-15,Richard Lindzen,University of London,PERSON-PERSON,ORGANIZATION-ORGANIZATION-ORGANIZATION,PROPN-PROPN,PROPN-ADP-PROPN,compound-pobj,nmod-prep-pobj,NNP-NNP,NNP-IN-NNP,3,1
12376,61635.0,36,faced,13,1,9,8,0,26,12,-4,Meskill,federal appeals court,PERSON,ORGANIZATION-ORGANIZATION-ORGANIZATION,PROPN,ADJ-NOUN-NOUN,nsubj,amod-compound-compound,NNP,JJ-NNS-NN,5,1
12377,61636.0,40,said,32,32,12,-20,31,27,0,-20,FMF,they,ORGANIZATION,ORGANIZATION,PROPN,PRON,nsubj,nsubj,NNP,PRP,4,1
12378,61651.0,30,died,2,22,18,-4,21,11,-20,16,she,Joseph Eisner,PERSON,PERSON-PERSON,PRON,PROPN-PROPN,nsubj,compound-appos,PRP,NNP-NNP,1,1
12379,61652.0,31,formed,3,9,30,21,8,0,-6,27,Alcatel,NJ,ORGANIZATION,STATE_OR_PROVINCE,PROPN,PROPN,nsubj,appos,NNP,NNP,4,1
12380,61653.0,43,ANGELES,1,10,1,-9,9,41,-9,0,Yolanda King,LOS ANGELES,PERSON-PERSON,CITY-CITY,PROPN-PROPN,PROPN-PROPN,compound-nsubj,compound-ROOT,NNP-NNP,NNP-NNP,-1,1
12381,61656.0,31,credited,7,15,25,10,14,5,-8,18,Dent,political strategist,PERSON,TITLE-TITLE,PROPN,ADJ-NOUN,nsubjpass,amod-conj,NNP,JJ-NN,6,1
12382,61659.0,37,said,21,23,25,2,22,11,-2,4,ARD,Fritz,ORGANIZATION,PERSON,PROPN,PROPN,compound,compound,NNP,NNP,3,1
12383,61661.0,20,was,2,15,4,-11,14,15,-13,2,McNair,brain cancer,PERSON,CAUSE_OF_DEATH-CAUSE_OF_DEATH,PROPN,NOUN-NOUN,compound,compound-attr,NNP,NN-NN,7,1
12384,61669.0,21,named,8,12,5,-7,11,15,-4,-3,Dee Dee Myers,State Department,PERSON-PERSON-PERSON,ORGANIZATION-ORGANIZATION,PROPN-PROPN-PROPN,PROPN-PROPN,compound-compound-dobj,compound-pobj,NNP-NNP-NNP,NNP-NNP,6,1
12385,61675.0,14,agrees,12,2,5,3,1,8,10,-7,Amir Mahdi,24,PERSON-PERSON,NUMBER,PROPN-PROPN,NUM,compound-nsubj,appos,NNP-NNP,CD,2,1
12386,61685.0,69,confirming,4,40,30,-10,39,38,-36,26,Abu Zubaydah,al Qaeda,PERSON-PERSON,ORGANIZATION-ORGANIZATION,PROPN-PROPN,PROPN-PROPN,compound-conj,compound-compound,NNP-NNP,NNP-NNP,6,1
12387,61710.0,16,include,2,4,6,2,3,9,-2,4,Citibank,CitiFinancial,ORGANIZATION,ORGANIZATION,PROPN,PROPN,dobj,conj,NNP,NNP,3,1
12388,61719.0,34,had,2,32,13,-19,31,20,-30,11,Britney Spears,Jayden James,PERSON-PERSON,PERSON-PERSON,PROPN-PROPN,PROPN-PROPN,compound-appos,compound-conj,NNP-NNPS,NNP-NNP,7,1
12389,61721.0,18,died,14,5,6,1,4,11,9,-8,married,Walter P Offutt,PERSON,PERSON-PERSON-PERSON,VERB,PROPN-PROPN-PROPN,ccomp,compound-compound-compound,VBD,NNP-NNP-NNP,1,1
12390,61722.0,35,came,3,28,33,5,27,1,-25,30,Nuclear Supplier 's Group,NSG,ORGANIZATION-ORGANIZATION-ORGANIZATION-ORGANIZATION,ORGANIZATION,PROPN-PROPN-PART-PROPN,PROPN,compound-poss-case-compound,compound,NNP-NNP-POS-NNP,NNP,10,1
12391,61725.0,27,said,18,23,20,-3,22,6,-5,2,UNITA,Alda Sachiambo,ORGANIZATION,PERSON-PERSON,PROPN,PROPN-PROPN,poss,compound-nsubj,NNP,NNP-NNP,3,1
12392,61740.0,26,faces,17,15,2,-13,14,23,2,-15,Richmond Flowers,Tarwater,PERSON-PERSON,PERSON,PROPN-PROPN,PROPN,compound-pobj,nsubj,NNP-NNP,NNP,3,1
12393,61741.0,13,died,9,6,12,6,5,0,3,3,Louise B. DeBlanc,2005,PERSON-PERSON-PERSON,DATE,PROPN-PROPN-PROPN,NUM,compound-compound-appos,pobj,NNP-NNP-NNP,CD,5,1
12394,61749.0,72,Duque,1,4,35,31,3,36,-3,34,Elizondo,Cuban,PERSON,NATIONALITY,PROPN,ADJ,compound,amod,NNP,JJ,4,1
12395,61752.0,23,2,0,5,21,16,4,1,-5,21,He,first lieutenant,PERSON,TITLE-TITLE,PRON,ADJ-NOUN,nsubj,amod-pobj,PRP,JJ-NN,5,1
12396,61760.0,32,ISLAMABAD,0,11,15,4,10,16,-11,15,group,1989,ORGANIZATION,DATE,NOUN,NUM,nsubjpass,pobj,NN,CD,3,1
12397,61781.0,31,was,1,1,17,16,0,13,0,16,He,correspondent,PERSON,TITLE,PRON,NOUN,nsubj,attr,PRP,NN,3,1
12398,61797.0,74,start,45,7,13,6,6,60,38,-32,Bob Dillinger,Department of Children and Families,PERSON-PERSON,ORGANIZATION-ORGANIZATION-ORGANIZATION-ORGANIZATION-ORGANIZATION,PROPN-PROPN,PROPN-ADP-PROPN-CCONJ-PROPN,compound-conj,pobj-prep-pobj-cc-conj,NNP-NNP,NNP-IN-NNP-CC-NNPS,4,1
12399,61798.0,46,turned,7,44,4,-40,43,41,-37,-3,Kelly Cutrone,New York City,PERSON-PERSON,CITY-CITY-CITY,PROPN-PROPN,PROPN-PROPN-PROPN,compound-conj,compound-compound-pobj,NNP-NNP,NNP-NNP-NNP,13,1
12400,61799.0,31,However,0,6,30,24,5,0,-6,30,Austrian Press Agency,Austria,ORGANIZATION-ORGANIZATION-ORGANIZATION,COUNTRY,PROPN-PROPN-PROPN,PROPN,compound-compound-pobj,pobj,NNP-NNP-NNP,NNP,6,1
12401,61803.0,25,is,8,15,14,-1,14,10,-7,6,Chad White,supermodel,PERSON-PERSON,TITLE,PROPN-PROPN,NOUN,compound-appos,attr,NNP-NNP,NN,1,1
12402,65282.0,11,does,6,5,4,-1,4,6,1,-2,Chad White,supermodel,PERSON-PERSON,TITLE,PROPN-PROPN,NOUN,compound-nsubj,nsubj,NNP-NNP,NN,1,1
12403,61825.0,59,joined,12,1,6,5,0,52,11,-6,Beyonce Knowles,singer,PERSON-PERSON,TITLE,PROPN-PROPN,NOUN,compound-nsubj,appos,NNP-NNP,NN,2,1
12404,61834.0,30,released,16,2,21,19,1,8,14,5,Zagat Survey,his,ORGANIZATION-ORGANIZATION,PERSON,PROPN-PROPN,DET,compound-pobj,poss,NNP-NNP,PRP$,6,1
12405,61844.0,27,pronounced,3,20,15,-5,19,11,-17,12,she,Rockville,PERSON,CITY,PRON,PROPN,nsubj,pobj,PRP,NNP,3,1
12406,61879.0,36,is,6,2,34,32,1,1,4,28,Obamas,Expressionist,ORGANIZATION,MISC,PROPN,PROPN,poss,compound,NNP,NNP,20,1
12407,61883.0,50,-LRB-,0,14,21,7,13,28,-14,21,Carnival Corporation,CCL,ORGANIZATION-ORGANIZATION,ORGANIZATION,PROPN-PROPN,PROPN,compound-pobj,appos,NNP-NNP,NNP,5,1
12408,61887.0,21,said,11,6,8,2,5,12,5,-3,Raul,Ramon,PERSON,PERSON,PROPN,PROPN,nsubj,conj,NNP,NNP,3,1
12409,61888.0,87,Recalls,2,1,69,68,0,17,1,67,ConAgra Foods,Hill Country Fare,ORGANIZATION-ORGANIZATION,ORGANIZATION-ORGANIZATION-ORGANIZATION,PROPN-PROPN,PROPN-PROPN-PROPN,compound-nsubj,compound-compound-conj,NNP-NNP,NNP-NNP-NNP,-1,1
12410,61893.0,22,declared,6,1,16,15,0,5,5,10,Pennsylvania Supreme Court,pro-choice,ORGANIZATION-ORGANIZATION-ORGANIZATION,IDEOLOGY,PROPN-PROPN-PROPN,ADJ,compound-compound-compound,acomp,NNP-NNP-NNP,JJ,6,1
12411,61909.0,46,------,0,16,20,4,15,25,-16,20,Illinois Tool Works,Glenville,ORGANIZATION-ORGANIZATION-ORGANIZATION,CITY,PROPN-PROPN-PROPN,PROPN,compound-compound-pobj,pobj,NNP-NNP-NNP,NNP,3,1
12412,61917.0,30,is,2,1,1,0,0,28,1,-1,FAW,FAW Car,ORGANIZATION,ORGANIZATION-ORGANIZATION,PROPN,PROPN-PROPN,compound,compound-nsubj,NNP,NNP-NNP,0,1
12413,61946.0,61,announces,16,10,26,16,9,34,6,10,Dee Dee Myers,United States,PERSON-PERSON-PERSON,COUNTRY-COUNTRY,PROPN-PROPN-PROPN,PROPN-PROPN,compound-compound-pobj,compound-pobj,NNP-NNP-NNP,NNP-NNP,12,1
12414,61952.0,29,had,9,2,5,3,1,23,7,-4,NSC,US National Security Council,ORGANIZATION,ORGANIZATION-ORGANIZATION-ORGANIZATION-ORGANIZATION,PROPN,PROPN-PROPN-PROPN-PROPN,compound,compound-compound-compound-compound,NNP,NNP-NNP-NNP-NNP,3,1
12415,61957.0,27,made,13,10,6,-4,9,20,3,-7,Denise Sandy,Sandy,PERSON-PERSON,PERSON,PROPN-PROPN,PROPN,compound-appos,poss,NNP-NNP,NNP,3,1
12416,61967.0,41,fell,7,13,23,10,12,17,-6,16,Simon Cowell,Britain,PERSON-PERSON,COUNTRY,PROPN-PROPN,PROPN,compound-pobj,poss,NNP-NNP,NNP,7,1
12417,61980.0,35,ZUCKERMAN,1,6,10,4,5,24,-5,9,NY Daily News,US,ORGANIZATION-ORGANIZATION-ORGANIZATION,COUNTRY,PROPN-PROPN-PROPN,PROPN,compound-compound-pobj,compound,NNP-NNP-NNP,NNP,4,1
12418,62005.0,23,challenged,8,6,10,4,5,12,2,2,she,House,PERSON,ORGANIZATION,PRON,PROPN,nsubj,compound,PRP,NNP,4,1
12419,62013.0,54,was,1,1,11,10,0,42,0,10,Nolte,Near East Foundation,PERSON,ORGANIZATION-ORGANIZATION-ORGANIZATION,PROPN,PROPN-PROPN-PROPN,nsubj,compound-compound-pobj,NNP,NNP-NNP-NNP,4,1
12420,62016.0,5,Association,2,1,5,4,0,-1,1,3,American Psychiatric Association,http://www.psych.org/,ORGANIZATION-ORGANIZATION-ORGANIZATION,URL,PROPN-PROPN-PROPN,X,compound-compound-ROOT,ROOT,NNP-NNP-NNP,ADD,-1,1
12421,62045.0,48,died,37,42,8,-34,41,39,-5,-29,her,feminist health movement,PERSON,ORGANIZATION-ORGANIZATION-ORGANIZATION,DET,ADJ-NOUN-NOUN,poss,amod-compound-pobj,PRP$,JJ-NN-NN,7,1
12422,62047.0,27,won,1,1,22,21,0,4,0,21,He,North Shore of Long Island,PERSON,LOCATION-LOCATION-LOCATION-LOCATION-LOCATION,PRON,PROPN-PROPN-ADP-PROPN-PROPN,nsubj,compound-pobj-prep-compound-pobj,PRP,NNP-NNP-IN-NNP-NNP,5,1
12423,62048.0,6,is,3,2,1,-1,1,4,1,-2,Johnny Knoxville,Actor,PERSON-PERSON,TITLE,PROPN-PROPN,PROPN,compound-nsubj,compound,NNP-NNP,NNP,1,1
12424,64353.0,6,is,3,2,1,-1,1,4,1,-2,Johnny Knoxville,Actor,PERSON-PERSON,TITLE,PROPN-PROPN,PROPN,compound-nsubj,compound,NNP-NNP,NNP,1,1
12425,62057.0,40,said,1,5,26,21,4,13,-4,25,Larijani,Iran,PERSON,COUNTRY,PROPN,PROPN,nsubj,dobj,NNP,NNP,6,1
12426,62070.0,26,are,4,12,8,-4,11,17,-8,4,Abdul Rahim Noor,Malaysia,PERSON-PERSON-PERSON,COUNTRY,PROPN-PROPN-PROPN,PROPN,compound-compound-conj,poss,NNP-NNP-NNP,NNP,4,1
12427,62088.0,23,have,17,6,4,-2,5,18,11,-13,George Young,Bill,PERSON-PERSON,PERSON,PROPN-PROPN,PROPN,compound-conj,nsubjpass,NNP-NNP,NNP,2,1
12428,62117.0,30,died,22,3,12,9,2,17,19,-10,Steven B. Derounian,Congress,PERSON-PERSON-PERSON,ORGANIZATION,PROPN-PROPN-PROPN,PROPN,compound-compound-nsubj,pobj,NNP-NNP-NNP,NNP,3,1
12429,62119.0,20,born,2,1,9,8,0,10,1,7,Forsberg,Ala,PERSON,STATE_OR_PROVINCE,PROPN,PROPN,nsubjpass,conj,NNP,NNP,2,1
12430,62129.0,43,characterized,23,3,21,18,2,21,20,-2,Simcox,Minuteman Project,PERSON,ORGANIZATION-ORGANIZATION,PROPN,PROPN-PROPN,nsubj,compound-pobj,NNP,NNP-NNP,10,1
12431,62149.0,31,grown,5,18,8,-10,17,22,-13,3,Mia Farrow,Dream for Darfur,PERSON-PERSON,ORGANIZATION-ORGANIZATION-ORGANIZATION,PROPN-PROPN,PROPN-ADP-PROPN,compound-pobj,pobj-prep-pobj,NNP-NNP,NNP-IN-NNP,7,1
12432,62197.0,28,holds,8,20,4,-16,19,23,-12,-4,United National Congress,People 's National Movement,ORGANIZATION-ORGANIZATION-ORGANIZATION,ORGANIZATION-ORGANIZATION-ORGANIZATION-ORGANIZATION,PROPN-PROPN-PROPN,PROPN-PART-PROPN-PROPN,compound-compound-nsubj,poss-case-compound-nsubj,NNP-NNP-NNP,NNPS-POS-NNP-NNP,6,1
12433,62217.0,15,is,6,13,9,-4,12,5,-7,3,John Negroponte,UN,PERSON-PERSON,ORGANIZATION,PROPN-PROPN,PROPN,compound-attr,compound,NNP-NNP,NNP,1,1
12434,62229.0,7,had,1,1,3,2,0,3,0,2,He,complications of a stroke,PERSON,CAUSE_OF_DEATH-CAUSE_OF_DEATH-CAUSE_OF_DEATH-CAUSE_OF_DEATH,PRON,NOUN-ADP-DET-NOUN,nsubj,dobj-prep-det-pobj,PRP,NNS-IN-DT-NN,2,1
12435,62256.0,37,said,31,16,29,13,15,7,15,-2,Alcatel-Lucent,Hubert de Pesquidoux,ORGANIZATION,PERSON-PERSON-PERSON,ADJ,PROPN-PROPN-PROPN,nsubj,compound-compound-nsubj,JJ,NNP-NNP-NNP,5,1
12436,62258.0,20,LCronin09,0,12,15,3,11,4,-12,15,Spencer,Stephanie,PERSON,PERSON,PROPN,PROPN,poss,appos,NNP,NNP,6,1
12437,62262.0,39,'m,29,10,10,0,9,28,19,-19,Frankie,Frankie Delgado,PERSON,PERSON-PERSON,PROPN,PROPN-PROPN,appos,compound-appos,NNP,NNP-NNP,0,1
12438,62305.0,26,member,5,8,23,15,7,2,-3,18,Pennsylvania State House of Representatives,1983,ORGANIZATION-ORGANIZATION-ORGANIZATION-ORGANIZATION-ORGANIZATION,DATE,PROPN-PROPN-PROPN-ADP-PROPN,NUM,compound-compound-pobj-prep-pobj,pobj,NNP-NNP-NNP-IN-NNPS,CD,7,1
12439,62306.0,23,gone,5,8,8,0,7,14,-3,3,Carnival Pride and Carnival Glory,Carnival,ORGANIZATION-ORGANIZATION-ORGANIZATION-ORGANIZATION-ORGANIZATION,ORGANIZATION,PROPN-PROPN-CCONJ-PROPN-PROPN,PROPN,compound-pobj-cc-compound-conj,compound,NNP-NNP-CC-NNP-NNP,NNP,0,1
12440,62321.0,31,said,18,26,2,-24,25,28,-8,-16,Metro Atlanta Chamber of Commerce,He,ORGANIZATION-ORGANIZATION-ORGANIZATION-ORGANIZATION-ORGANIZATION,PERSON,PROPN-PROPN-PROPN-ADP-PROPN,PRON,compound-compound-pobj-prep-pobj,nsubj,NNP-NNP-NNP-IN-NNP,PRP,7,1
12441,62323.0,22,told,1,1,21,20,0,0,0,20,Davis,1986,PERSON,DATE,PROPN,NUM,nsubj,pobj,NNP,CD,4,1
12442,62331.0,39,said,16,13,21,8,12,17,3,5,Oxford University Press,he,ORGANIZATION-ORGANIZATION-ORGANIZATION,PERSON,PROPN-PROPN-PROPN,PRON,compound-compound-pobj,nsubj,NNP-NNP-NNP,PRP,10,1
12443,62333.0,45,changed,23,1,13,12,0,31,22,-10,Irene Morgan Kirkaldy,Aug. 10,PERSON-PERSON-PERSON,DATE-DATE,PROPN-PROPN-PROPN,PROPN-NUM,compound-compound-nsubj,npadvmod-nummod,NNP-NNP-NNP,NNP-CD,4,1
12444,62339.0,8,is,4,2,6,4,1,1,2,2,Czech National Day,28 October,ORGANIZATION-ORGANIZATION-ORGANIZATION,DATE-DATE,PROPN-PROPN-PROPN,NUM-PROPN,compound-compound-nsubj,nummod-attr,NNP-NNP-NNP,CD-NNP,3,1
12445,62362.0,44,is,11,17,13,-4,16,30,-6,2,Multidisciplinary Association,Rick Doblin,ORGANIZATION-ORGANIZATION,PERSON-PERSON,PROPN-PROPN,PROPN-PROPN,compound-pobj,compound-nsubj,NNP-NNP,NNP-NNP,2,1
12446,62379.0,43,suggests,20,17,8,-9,16,34,3,-12,International Monetary Fund,Raghuram Rajan,ORGANIZATION-ORGANIZATION-ORGANIZATION,PERSON-PERSON,PROPN-PROPN-PROPN,PROPN-PROPN,compound-compound-pobj,compound-npadvmod,NNP-NNP-NNP,NNP-NNP,4,1
12447,62395.0,23,said,10,1,8,7,0,14,9,-2,Firstgroup,Greyhound,ORGANIZATION,ORGANIZATION,PROPN,PROPN,nsubj,compound,NNP,NNP,4,1
12448,62401.0,27,grew,4,1,8,7,0,18,3,4,Harry Shuler Dent,St Matthews,PERSON-PERSON-PERSON,CITY-CITY,PROPN-PROPN-PROPN,PROPN-PROPN,compound-compound-nsubj,compound-pobj,NNP-NNP-NNP,NNP-NNP,4,1
12449,62413.0,23,accosted,14,18,16,-2,17,6,-4,2,his,King,PERSON,TITLE,DET,PROPN,poss,dobj,PRP$,NNP,1,1
12450,62417.0,22,called,6,19,16,-3,18,5,-13,10,she,him,PERSON,PERSON,PRON,PRON,nsubj,dobj,PRP,PRP,-1,1
12451,62424.0,29,nominated,5,21,1,-20,20,27,-16,-4,Al Hubbard,U.S.,PERSON-PERSON,COUNTRY,PROPN-PROPN,PROPN,compound-appos,compound,NNP-NNP,NNP,7,1
12452,62451.0,24,makes,1,16,1,-15,15,22,-15,0,Danny Glover,Glover,PERSON-PERSON,PERSON,PROPN-PROPN,PROPN,compound-nsubj,nsubj,NNP-NNP,NNP,2,1
12453,62455.0,48,said,30,40,32,-8,39,15,-10,2,Country Music,Tammy Genovese,ORGANIZATION-ORGANIZATION,PERSON-PERSON,PROPN-PROPN,PROPN-PROPN,compound-compound,compound-nsubj,NNP-NNP,NNP-NNP,5,1
12454,62478.0,19,2006-11-13T15,0,3,11,8,2,7,-3,11,Ivery,postal theft,PERSON,CRIMINAL_CHARGE-CRIMINAL_CHARGE,NOUN,ADJ-NOUN,nsubj,amod-pobj,NN,JJ-NN,3,1
12455,62482.0,54,reported,52,7,17,10,6,36,45,-35,R. Nicholas Burns,Russia,PERSON-PERSON-PERSON,COUNTRY,PROPN-PROPN-PROPN,PROPN,compound-compound-nsubj,appos,NNP-NNP-NNP,NNP,3,1
12456,62483.0,40,commissioned,5,9,1,-8,8,38,-4,-4,Charles Wuorinen,New York City Opera,PERSON-PERSON,ORGANIZATION-ORGANIZATION-ORGANIZATION-ORGANIZATION,PROPN-PROPN,PROPN-PROPN-PROPN-PROPN,compound-dobj,compound-compound-compound-nsubj,NNP-NNP,NNP-NNP-NNP-NNP,3,1
12457,62486.0,42,said,40,1,7,6,0,34,39,-33,Kennedy Space Center,http://wwwkennedyspacecentercom,ORGANIZATION-ORGANIZATION-ORGANIZATION,URL,PROPN-PROPN-PROPN,X,compound-compound-compound,appos,NNP-NNP-NNP,ADD,-1,1
12458,62487.0,38,Bank-led,2,8,2,-6,7,35,-6,0,APA,Macquarie Bank-led Airline Partners Australia,ORGANIZATION,ORGANIZATION-ORGANIZATION-ORGANIZATION-ORGANIZATION-ORGANIZATION,PROPN,PROPN-VERB-PROPN-PROPN-PROPN,compound,nsubj-ROOT-compound-dobj-npadvmod,NNP,NNP-VBD-NNP-NNPS-NNP,3,1
12459,62493.0,42,sworn,9,1,7,6,0,34,8,-2,Bolin,Queens,PERSON,LOCATION,PROPN,PROPN,nsubjpass,pobj,NNP,NNP,3,1
12460,62498.0,60,transferred,6,5,13,8,4,46,1,7,Konica Minolta,Sony,ORGANIZATION-ORGANIZATION,ORGANIZATION,PROPN-PROPN,PROPN,compound-nsubj,poss,NNP-NNP,NNP,2,1
12461,62504.0,4,was,1,1,3,2,0,0,0,2,He,88,PERSON,NUMBER,PRON,NUM,nsubj,attr,PRP,CD,1,1
12462,62508.0,35,said,30,25,29,4,24,5,5,-1,IMF,Juan Fernandez-Ansola,ORGANIZATION,PERSON-PERSON,PROPN,PROPN-PROPN,poss,compound-nsubj,NNP,NNP-NNP,4,1
12463,62522.0,76,survived,25,1,12,11,0,63,24,-13,Deaver,"April 11 , 1938",PERSON,DATE-DATE-DATE-DATE,PROPN,PROPN-NUM-PUNCT-NUM,nsubjpass,pobj-nummod-punct-nummod,NNP,"NNP-CD-,-CD",5,1
12464,62538.0,48,advancing,23,17,13,-4,16,34,6,-10,Herrera,36th Infantry Division,PERSON,ORGANIZATION-ORGANIZATION-ORGANIZATION,PROPN,PROPN-PROPN-PROPN,conj,compound-compound-pobj,NNP,NNP-NNP-NNP,3,1
12465,62544.0,27,is,2,2,26,24,1,0,0,24,company,"46,500",ORGANIZATION,NUMBER,NOUN,NUM,nsubj,pobj,NN,CD,1,1
12466,62559.0,37,was,12,12,16,4,11,20,0,4,Gregory,chief anchor,PERSON,TITLE-TITLE,PROPN,ADJ-NOUN,nsubj,amod-attr,NNP,JJ-NN,1,1
12467,62576.0,50,continued,1,39,34,-5,38,15,-38,33,Spelman College,Jane Goodall,ORGANIZATION-ORGANIZATION,PERSON-PERSON,PROPN-PROPN,PROPN-PROPN,compound-pobj,compound-conj,NNP-NNP,NNP-NNP,7,1
12468,62579.0,38,said,13,11,4,-7,10,33,2,-9,American Bankers Association,Independent Community Bankers of America,ORGANIZATION-ORGANIZATION-ORGANIZATION,ORGANIZATION-ORGANIZATION-ORGANIZATION-ORGANIZATION-ORGANIZATION,PROPN-PROPN-PROPN,PROPN-PROPN-PROPN-ADP-PROPN,compound-compound-conj,compound-compound-pobj-prep-pobj,NNP-NNPS-NNP,NNP-NNP-NNPS-IN-NNP,3,1
12469,62580.0,28,said,15,10,1,-9,9,26,5,-14,Department of Conservation and Recreation,Richard K. Sullivan Jr.,ORGANIZATION-ORGANIZATION-ORGANIZATION-ORGANIZATION-ORGANIZATION,PERSON-PERSON-PERSON-PERSON,PROPN-ADP-PROPN-CCONJ-PROPN,PROPN-PROPN-PROPN-PROPN,pobj-prep-pobj-cc-conj,compound-compound-compound-nsubj,NNP-IN-NNP-CC-NNP,NNP-NNP-NNP-NNP,5,1
12470,62586.0,40,comments,3,6,39,33,5,0,-3,36,Mohamed ElBaradei,Iran,PERSON-PERSON,COUNTRY,PROPN-PROPN,PROPN,compound-pobj,pobj,NNP-NNP,NNP,4,1
12471,62611.0,44,------,0,2,6,4,1,37,-2,6,Servicemembers Legal Defense Network,http://wwwsldnorg,ORGANIZATION-ORGANIZATION-ORGANIZATION-ORGANIZATION,URL,PROPN-PROPN-PROPN-PROPN,PUNCT,compound-compound-compound-ROOT,ROOT,NNP-NNP-NNP-NNP,.,3,1
12472,62620.0,25,replaced,8,14,21,7,13,3,-6,13,Ali Larijani,Consultative Assembly,PERSON-PERSON,ORGANIZATION-ORGANIZATION,PROPN-PROPN,PROPN-PROPN,compound-dobj,compound-pobj,NNP-NNP,NNP-NNP,3,1
12473,62629.0,42,accepted,1,11,7,-4,10,34,-10,6,ABA,Asian Basketball Association,ORGANIZATION,ORGANIZATION-ORGANIZATION-ORGANIZATION,PROPN,PROPN-PROPN-PROPN,compound,compound-compound-pobj,NNP,NNP-NNP-NNP,6,1
12474,62632.0,12,lost,8,1,5,4,0,6,7,-3,Kerry,lawyer,PERSON,TITLE,PROPN,NOUN,nsubj,attr,NNP,NN,3,1
12475,62635.0,49,Resigns,4,3,3,0,2,45,1,-1,Donald Wildmon,Donald Wildmon,PERSON-PERSON,PERSON-PERSON,PROPN-PROPN,PROPN-PROPN,compound-compound,compound-nsubj,NNP-NNP,NNP-NNP,0,1
12476,62639.0,58,Shops,3,1,32,31,0,25,2,29,Jamie Lynn Spears,Bryan,PERSON-PERSON-PERSON,PERSON,PROPN-PROPN-PROPN,PROPN,compound-compound-compound,conj,NNP-NNP-NNPS,NNP,-1,1
12477,62662.0,26,believed,1,1,19,18,0,6,0,18,He,his,PERSON,PERSON,PRON,DET,nsubj,poss,PRP,PRP$,4,1
12478,62676.0,31,was,1,1,17,16,0,13,0,16,Sheldon,associate dean,PERSON,TITLE-TITLE,PROPN,ADJ-NOUN,nsubj,amod-conj,NNP,JJ-NN,1,1
12479,62680.0,42,PARIS,0,8,31,23,7,10,-8,31,Alcatel-Lucent,New Jersey,ORGANIZATION,STATE_OR_PROVINCE-STATE_OR_PROVINCE,NOUN,PROPN-PROPN,nsubjpass,compound-appos,NN,NNP-NNP,9,1
12480,62686.0,11,YORK,1,6,8,2,5,2,-5,7,It,"14,000",ORGANIZATION,NUMBER,PRON,NUM,nsubj,nummod,PRP,CD,3,1
12481,62711.0,46,said,15,36,33,-3,35,12,-21,18,she,Ritchie,PERSON,PERSON,PRON,PROPN,nsubj,nsubj,PRP,NNP,2,1
12482,62725.0,32,signed,10,5,9,4,4,22,5,-1,RIA Novosti,Stanislav Krans,ORGANIZATION-ORGANIZATION,PERSON-PERSON,PROPN-PROPN,PROPN-PROPN,compound-compound,compound-appos,NNP-NNP,NNP-NNPS,2,1
12483,62745.0,30,said,15,24,26,2,23,3,-9,11,ADB,Office of Cofinancing Operations,ORGANIZATION,ORGANIZATION-ORGANIZATION-ORGANIZATION-ORGANIZATION,PROPN,PROPN-ADP-PROPN-PROPN,poss,pobj-prep-compound-pobj,NNP,NNP-IN-NNP-NNPS,1,1
12484,62753.0,53,includes,3,12,37,25,11,15,-9,34,Hector Elizondo,Italian,PERSON-PERSON,NATIONALITY,PROPN-PROPN,ADJ,compound-conj,amod,NNP-NNP,JJ,7,1
12485,62756.0,40,hit,4,9,13,4,8,26,-5,9,Awami National Party,Bashir Ahmed Bilour,ORGANIZATION-ORGANIZATION-ORGANIZATION,PERSON-PERSON-PERSON,PROPN-PROPN-PROPN,PROPN-PROPN-PROPN,compound-compound-compound,compound-compound-pobj,NNP-NNP-NNP,NNP-NNP-NNP,4,1
12486,62768.0,12,was,9,1,8,7,0,3,8,-1,Henebry,Ill,PERSON,STATE_OR_PROVINCE,PROPN,PROPN,nsubj,appos,NNP,NNP,3,1
12487,62808.0,8,Sheldon,0,1,4,3,0,3,-1,4,Sheldon,Florida,PERSON,STATE_OR_PROVINCE,PROPN,PROPN,ROOT,poss,NNP,NNP,4,1
12488,62810.0,56,died,36,2,31,29,1,24,34,-5,Jefferson J. DeBlanc Sr.,II,PERSON-PERSON-PERSON-PERSON,MISC,PROPN-PROPN-PROPN-PROPN,PROPN,compound-compound-compound-nsubj,compound,NNP-NNP-NNP-NNP,NNP,11,1
12489,62824.0,40,is,12,2,21,19,1,18,10,9,heiress,Jack Dellal,PERSON,PERSON-PERSON,NOUN,PROPN-PROPN,nsubj,compound-pobj,NN,NNP-NNP,5,1
12490,62849.0,57,been,7,30,33,3,29,23,-23,26,MAC,Liu Te-shun,ORGANIZATION,PERSON-PERSON,PROPN,PROPN-PROPN,compound,compound-nsubj,NNP,NNP-NNP,3,1
12491,62854.0,5,died,1,1,4,3,0,0,0,3,He,1943,PERSON,DATE,PRON,NUM,nsubj,pobj,PRP,CD,1,1
12492,62855.0,54,include,1,25,28,3,24,25,-24,27,Frank DeBlanc,St. Martinville,PERSON-PERSON,LOCATION-LOCATION,PROPN-PROPN,PROPN-PROPN,compound-appos,compound-pobj,NNP-NNP,NNP-NNP,2,1
12493,62857.0,21,has,5,2,15,13,1,5,3,10,Detroit Medical Center,Huron Valley-Sinai Hospital,ORGANIZATION-ORGANIZATION-ORGANIZATION,LOCATION-LOCATION-LOCATION,PROPN-PROPN-PROPN,PROPN-PROPN-PROPN,compound-compound-nsubj,conj-compound-pobj,NNP-NNP-NNP,NNP-NNP-NNP,7,1
12494,62861.0,47,LONDON,0,6,1,-5,5,45,-6,1,Alcatel-Lucent SA,LONDON,ORGANIZATION-ORGANIZATION,CITY,ADJ-PROPN,PROPN,amod-nsubj,ROOT,JJ-NNP,NNP,-1,1
12495,62901.0,30,died,22,3,25,22,2,4,19,3,Steven B. Derounian,Tuesday,PERSON-PERSON-PERSON,DATE,PROPN-PROPN-PROPN,PROPN,compound-compound-nsubj,pobj,NNP-NNP-NNP,NNP,3,1
12496,62922.0,7,Young,1,1,4,3,0,2,0,3,George Young,Sparrowhawk,PERSON-PERSON,ORGANIZATION,PROPN-PROPN,PROPN,compound-ROOT,compound,NNP-NNP,NNP,2,1
12497,62923.0,34,Description,0,32,24,-8,31,9,-32,24,Tyco Healthcare,Pharmaceuticals Division of Mallinckrodt,ORGANIZATION-ORGANIZATION,ORGANIZATION-ORGANIZATION-ORGANIZATION-ORGANIZATION,PROPN-PROPN,PROPN-PROPN-ADP-PROPN,compound-pobj,compound-pobj-prep-pobj,NNP-NNP,NNPS-NNP-IN-NNP,3,1
12498,62928.0,31,Council,2,5,9,4,4,21,-3,7,NSC,Jeevan Ram Shrestha,ORGANIZATION,PERSON-PERSON-PERSON,PROPN,PROPN-PROPN-PROPN,compound,compound-compound-nsubj,NNP,NNP-NNP-NNP,4,1
12499,62932.0,60,Dies,17,9,52,43,8,7,8,35,Roy Scheider,Universal,PERSON-PERSON,ORGANIZATION,PROPN-PROPN,PROPN,compound-appos,pobj,NNP-NNP,NNP,-1,1
12500,62933.0,52,said,24,30,26,-4,29,25,-6,2,M. Enkhbold,State Emergency Commission,PERSON-PERSON,ORGANIZATION-ORGANIZATION-ORGANIZATION,PROPN-PROPN,PROPN-PROPN-PROPN,compound-nsubj,compound-compound-compound,NNP-NNP,NNP-NNP-NNP,3,1
12501,62947.0,17,agreed,15,7,12,5,6,4,8,-3,Haifa University,environmental studies department,ORGANIZATION-ORGANIZATION,ORGANIZATION-ORGANIZATION-ORGANIZATION,PROPN-PROPN,ADJ-NOUN-NOUN,compound-poss,conj-conj-pobj,NNP-NNP,JJ-NNS-NN,2,1
12502,62951.0,19,living,2,1,8,7,0,10,1,6,Kate,Pennsylvania,PERSON,STATE_OR_PROVINCE,PROPN,PROPN,nsubj,pobj,NNP,NNP,2,1
12503,62956.0,63,ranked,5,1,5,4,0,57,4,0,Financial Research Corp,Boston,ORGANIZATION-ORGANIZATION-ORGANIZATION,CITY,PROPN-PROPN-PROPN,PROPN,compound-compound-nsubj,pobj,NNP-NNP-NNP,NNP,2,1
12504,62976.0,26,born,4,1,13,12,0,12,3,9,Joseph Simpson Farland,"Clarksburg , WVa",PERSON-PERSON-PERSON,NATIONALITY-NATIONALITY-NATIONALITY,PROPN-PROPN-PROPN,PROPN-PUNCT-NOUN,compound-compound-nsubjpass,pobj-punct-npadvmod,NNP-NNP-NNP,"NNP-,-NNS",4,1
12505,62997.0,26,found,19,16,13,-3,15,12,3,-6,Li Jie,Inner Mongolia,PERSON-PERSON,STATE_OR_PROVINCE-STATE_OR_PROVINCE,PROPN-PROPN,PROPN-PROPN,compound-appos,compound-pobj,NNP-NNP,NNP-NNP,1,1
12506,65056.0,48,JINAN,0,29,33,4,28,14,-29,33,Li Jie,Inner Mongolia,PERSON-PERSON,STATE_OR_PROVINCE-STATE_OR_PROVINCE,PROPN-PROPN,PROPN-PROPN,compound-nsubjpass,compound-pobj,NNP-NNP,NNP-NNP,2,1
12507,63003.0,58,is,16,47,40,-7,46,17,-31,24,Nicole Boxer,Tony Rodham,PERSON-PERSON,PERSON-PERSON,PROPN-PROPN,PROPN-PROPN,compound-compound,compound-appos,NNP-NNP,NNP-NNP,4,1
12508,63016.0,22,accused,2,13,10,-3,12,11,-11,8,Lashkar-e-Taiba,Muslim,ORGANIZATION,RELIGION,PROPN,PROPN,appos,amod,NNP,NNP,2,1
12509,63035.0,16,conference,5,12,11,-1,11,4,-7,6,Gholam Ali Haddad Adel,speaker,PERSON-PERSON-PERSON-PERSON,TITLE,PROPN-PROPN-PROPN-PROPN,NOUN,compound-compound-compound-dobj,compound,NNP-NNP-NNP-NNP,NN,2,1
12510,63051.0,24,was,4,9,4,-5,8,19,-5,0,the company,Krawcheck,ORGANIZATION-ORGANIZATION,PERSON,DET-NOUN,PROPN,det-poss,nsubj,DT-NN,NNP,5,1
12511,63054.0,23,born,2,1,12,11,0,10,1,10,Ahearn,Tenn.,PERSON,STATE_OR_PROVINCE,PROPN,PROPN,nsubjpass,appos,NNP,NNP,2,1
12512,63097.0,36,pulled,24,19,35,16,18,0,5,11,her,Hollywood,PERSON,CITY,DET,PROPN,poss,pobj,PRP$,NNP,13,1
12513,63110.0,20,says,3,12,1,-11,11,18,-9,-2,Aerolineas Argentinas,The Argentine,ORGANIZATION-ORGANIZATION,COUNTRY-COUNTRY,PROPN-PROPN,DET-ADJ,compound-nsubj,det-amod,NNP-NNP,DT-JJ,5,1
12514,63121.0,14,elected,11,10,13,3,9,0,1,2,Meskill,governor,PERSON,TITLE,PROPN,NOUN,nsubjpass,oprd,NNP,NN,2,1
12515,63125.0,64,said,23,33,3,-30,32,60,-10,-20,Project Islamic HOPE,Los Angeles-based,ORGANIZATION-ORGANIZATION-ORGANIZATION,CITY-CITY,PROPN-PROPN-VERB,PROPN-VERB,appos-compound-appos,nsubj-amod,NNP-NNP-VBD,NNP-VBD,7,1
12516,63135.0,37,told,8,7,7,0,6,29,1,-1,Chunghwa,Chunghwa Telecom,ORGANIZATION,ORGANIZATION-ORGANIZATION,PROPN,PROPN-PROPN,nsubj,compound-pobj,NNP,NNP-NNP,0,1
12517,63157.0,27,1927,0,24,1,-23,23,25,-24,1,Chinese Communist Party,1927,ORGANIZATION-ORGANIZATION-ORGANIZATION,DATE,PROPN-PROPN-PROPN,NUM,compound-compound-pobj,ROOT,NNP-NNP-NNP,CD,7,1
12518,63159.0,38,said,27,29,33,4,28,4,-2,6,Chris Bentley,U.S. Citizenship and Immigration Service,PERSON-PERSON,ORGANIZATION-ORGANIZATION-ORGANIZATION-ORGANIZATION-ORGANIZATION,PROPN-PROPN,PROPN-PROPN-CCONJ-PROPN-PROPN,compound-nsubj,nmod-nmod-cc-conj-pobj,NNP-NNP,NNP-NNP-CC-NNP-NNP,3,1
12519,63160.0,24,worked,1,1,7,6,0,16,0,6,She,deputy registrar,PERSON,TITLE-TITLE,PRON,NOUN-NOUN,nsubj,compound-attr,PRP,NN-NN,2,1
12520,63164.0,36,said,11,28,23,-5,27,12,-17,12,Ali Larijani,Javad Vaidi,PERSON-PERSON,PERSON-PERSON,PROPN-PROPN,PROPN-PROPN,compound-pobj,compound-pobj,NNP-NNP,NNP-NNP,5,1
12521,63168.0,18,graduated,1,1,4,3,0,13,0,3,Watson,Barnard,PERSON,ORGANIZATION,PROPN,PROPN,nsubj,pobj,NNP,NNP,1,1
12522,63170.0,47,FLOWERS,1,1,33,32,0,13,0,32,RICHMOND FLOWERS,University of Alabama,PERSON-PERSON,ORGANIZATION-ORGANIZATION-ORGANIZATION,PROPN-PROPN,PROPN-ADP-PROPN,compound-ROOT,pobj-prep-pobj,NNP-NNP,NNP-IN-NNP,-1,1
12523,63171.0,46,rolled,6,37,41,4,36,4,-31,35,First Automobile Works,China,ORGANIZATION-ORGANIZATION-ORGANIZATION,COUNTRY,PROPN-PROPN-PROPN,PROPN,compound-compound-pobj,poss,NNP-NNP-NNP,NNP,4,1
12524,63180.0,44,urged,24,24,15,-9,23,28,0,-9,Kerry,"Senate Committee on Commerce , Science and Transportation",PERSON,ORGANIZATION-ORGANIZATION-ORGANIZATION-ORGANIZATION-ORGANIZATION-ORGANIZATION-ORGANIZATION-ORGANIZATION,PROPN,PROPN-PROPN-ADP-PROPN-PUNCT-PROPN-CCONJ-PROPN,nsubj,compound-pobj-prep-pobj-punct-conj-cc-conj,NNP,"NNP-NNP-IN-NNP-,-NNP-CC-NNP",5,1
12525,63185.0,26,born,2,1,25,24,0,0,1,23,Bellecourt,Minnesota,PERSON,STATE_OR_PROVINCE,PROPN,PROPN,nsubjpass,pobj,NNP,NNP,5,1
12526,63189.0,31,said,24,6,27,21,5,3,18,3,Yolanda King,spokeswoman,PERSON-PERSON,TITLE,PROPN-PROPN,NOUN,compound-pobj,nsubj,NNP-NNP,NN,6,1
12527,63220.0,40,died,32,3,34,31,2,5,29,2,John P Henebry,Sept 30,PERSON-PERSON-PERSON,DATE-DATE,PROPN-PROPN-PROPN,PROPN-NUM,compound-compound-nsubj,dobj-nummod,NNP-NNP-NNP,NNP-CD,2,1
12528,63241.0,34,claims,1,1,22,21,0,11,0,21,Davis,previously,PERSON,DATE,PROPN,ADV,nsubj,advmod,NNP,RB,3,1
12529,63248.0,52,EMERGES,3,6,19,13,5,32,-3,16,MADOFF,Shana Madoff,ORGANIZATION,PERSON-PERSON,PROPN,PROPN-PROPN,pobj,compound-pobj,NNP,NNP-NNP,-1,1
12530,63262.0,45,was,2,9,12,3,8,32,-7,10,ANP,Zahid Khan,ORGANIZATION,PERSON-PERSON,PROPN,PROPN-PROPN,compound,compound-nsubj,NNP,NNP-NNP,3,1
12531,63264.0,54,said,23,37,30,-7,36,23,-14,7,Federal Aviation Administration,J. Randolph Babbitt,ORGANIZATION-ORGANIZATION-ORGANIZATION,PERSON-PERSON-PERSON,PROPN-PROPN-PROPN,PROPN-PROPN-PROPN,compound-compound-pobj,compound-compound-pobj,NNP-NNP-NNP,NNP-NNP-NNP,9,1
12532,63274.0,65,seemed,10,20,20,0,19,44,-10,10,Molly Malaney,Molly,PERSON-PERSON,PERSON,PROPN-PROPN,PROPN,compound-pobj,pobj,NNP-NNP,NNP,0,1
12533,63285.0,38,said,22,24,26,2,23,11,-2,4,Denso,Goro Kanematsu,ORGANIZATION,PERSON-PERSON,PROPN,PROPN-PROPN,compound,compound-nsubj,NNP,NNP-NNP,3,1
12534,63288.0,31,denounced,18,7,2,-5,6,28,11,-16,IAPA,Inter American Press Association,ORGANIZATION,ORGANIZATION-ORGANIZATION-ORGANIZATION-ORGANIZATION,PROPN,PROPN-PROPN-PROPN-PROPN,compound,compound-compound-compound-nsubj,NNP,NNP-NNP-NNP-NNP,2,1
12535,63311.0,35,Movement,4,16,20,4,15,14,-12,16,National Elections Commission,NEC,ORGANIZATION-ORGANIZATION-ORGANIZATION,ORGANIZATION,PROPN-PROPN-PROPN,PROPN,compound-compound-pobj,compound,NNP-NNPS-NNP,NNP,5,1
12536,63313.0,29,said,1,3,3,0,2,25,-2,2,she,she,PERSON,PERSON,PRON,PRON,nsubj,nsubj,PRP,PRP,0,1
12537,63314.0,14,balked,5,4,2,-2,3,11,1,-3,Paul Watson,Shepherd,PERSON-PERSON,TITLE,PROPN-PROPN,ADJ,compound-nsubj,compound,NNP-NNP,JJ,1,1
12538,63316.0,37,was,5,5,26,21,4,10,0,21,she,Regents Review Committee,PERSON,ORGANIZATION-ORGANIZATION-ORGANIZATION,PRON,PROPN-PROPN-PROPN,nsubj,compound-compound-pobj,PRP,NNPS-NNP-NNP,4,1
12539,63321.0,28,survived,2,1,8,7,0,19,1,6,He,Barbara A. Hammond,PERSON,PERSON-PERSON-PERSON,PRON,PROPN-PROPN-PROPN,nsubjpass,compound-compound-appos,PRP,NNP-NNP-NNP,4,1
12540,63326.0,10,Attention,3,6,9,3,5,0,-3,6,CMA,http://www.cmt.com/news/country-music/1588936/jessica-simpson-grabs-a,ORGANIZATION,URL,PROPN,NOUN,compound,punct,NNP,NNS,5,1
12541,63328.0,37,died,3,8,25,17,7,11,-5,22,Yolanda King,siblings,PERSON-PERSON,PERSON,PROPN-PROPN,NOUN,compound-conj,dobj,NNP-NNP,NNS,3,1
12542,63330.0,59,said,22,40,42,2,39,16,-18,20,Citibank,New York,ORGANIZATION,STATE_OR_PROVINCE-STATE_OR_PROVINCE,PROPN,PROPN-PROPN,pobj,compound-pobj,NNP,NNP-NNP,2,1
12543,63336.0,16,is,4,1,3,2,0,12,3,-1,Larijani,48,PERSON,NUMBER,PROPN,NUM,nsubj,appos,NNP,CD,3,1
12544,63337.0,13,says,12,3,9,6,2,3,9,-3,Gillmor,Wednesday,PERSON,DATE,PROPN,PROPN,nsubj,npadvmod,NNP,NNP,2,1
12545,63339.0,66,survived,12,11,4,-7,10,61,1,-8,Kaiser,Charles,PERSON,PERSON,PROPN,PROPN,nsubjpass,appos,NNP,NNP,4,1
12546,63349.0,33,decided,25,20,24,4,19,8,5,-1,Jamie Lynn,Lynne Spears,PERSON-PERSON,PERSON-PERSON,PROPN-PROPN,PROPN-PROPN,compound-npadvmod,compound-conj,NNP-NNP,NNP-NNP,1,1
12547,63359.0,39,brought,5,36,28,-8,35,10,-31,23,Kennedy Space Center,Suzanne Kosmas,ORGANIZATION-ORGANIZATION-ORGANIZATION,PERSON-PERSON,PROPN-PROPN-PROPN,PROPN-PROPN,compound-compound-dobj,compound-conj,NNP-NNP-NNP,NNP-NNP,5,1
12548,63361.0,33,said,16,29,25,-4,28,7,-13,9,Center for Regulatory Compliance,American Bankers Association,ORGANIZATION-ORGANIZATION-ORGANIZATION-ORGANIZATION,ORGANIZATION-ORGANIZATION-ORGANIZATION,PROPN-ADP-PROPN-PROPN,PROPN-PROPN-PROPN,pobj-prep-compound-pobj,compound-compound-poss,NNP-IN-NNP-NNP,NNP-NNPS-NNP,2,1
12549,63387.0,40,says,16,18,22,4,17,17,-2,6,George Kennedy,Aikido Center,PERSON-PERSON,ORGANIZATION-ORGANIZATION,PROPN-PROPN,PROPN-PROPN,compound-nsubj,compound-pobj,NNP-NNP,NNP-NNP,4,1
12550,63392.0,16,Development,2,5,8,3,4,7,-3,6,Spelman College,Ga.,ORGANIZATION-ORGANIZATION,STATE_OR_PROVINCE,PROPN-PROPN,PROPN,compound-npadvmod,appos,NNP-NNP,NNP,2,1
12551,63411.0,27,include,2,7,6,-1,6,20,-5,4,Julian Bond,leader,PERSON-PERSON,TITLE,PROPN-PROPN,NOUN,compound-dobj,compound,NNP-NNP,NN,1,1
12552,63426.0,30,upgraded,3,18,24,6,17,5,-15,21,Michael Sandy,Friday,PERSON-PERSON,DATE,PROPN-PROPN,PROPN,compound-pobj,pobj,NNP-NNP,NNP,5,1
12553,63438.0,17,organize,11,1,8,7,0,8,10,-3,Her,Cornell,PERSON,ORGANIZATION,DET,PROPN,poss,pobj,PRP$,NNP,4,1
12554,63447.0,20,are,1,17,9,-8,16,10,-16,8,University of Haifa,Shlomo Tzadok,ORGANIZATION-ORGANIZATION-ORGANIZATION,PERSON-PERSON,PROPN-ADP-PROPN,PROPN-PROPN,pobj-prep-pobj,compound-pobj,NNP-IN-NNP,NNP-NNP,4,1
12555,63450.0,31,signed,24,15,18,3,14,12,9,-6,George Boyd,Craig Mackail-Smith,PERSON-PERSON,PERSON-PERSON,PROPN-PROPN,PROPN-PROPN,compound-nsubjpass,compound-conj,NNP-NNP,NNP-NNP,2,1
12556,63474.0,26,said,24,3,6,3,2,19,21,-18,Matthew Ferrara,24,PERSON-PERSON,NUMBER,PROPN-PROPN,NUM,compound-npadvmod,nsubj,NNP-NNP,CD,3,1
12557,63490.0,22,includes,4,1,1,0,0,20,3,-3,Royal Caribbean International,Royal Caribbean,ORGANIZATION-ORGANIZATION-ORGANIZATION,ORGANIZATION-ORGANIZATION,PROPN-PROPN-PROPN,PROPN-PROPN,compound-compound-nmod,compound-poss,NNP-NNP-NNP,NNP-NNP,0,1
12558,63513.0,18,landed,2,1,14,13,0,3,1,12,He,cosmetologist,PERSON,TITLE,PRON,NOUN,nsubj,nmod,PRP,NN,7,1
12559,63515.0,20,CORRECTIONS-NYT,0,10,14,4,9,5,-10,14,Yolanda King,actor,PERSON-PERSON,TITLE,PROPN-PROPN,NOUN,compound-pobj,appos,NNP-NNP,NN,3,1
12560,63516.0,31,discovered,10,9,8,-1,8,22,1,-2,Augustus Hawkins,Rep,PERSON-PERSON,TITLE,PROPN-PROPN,PROPN,compound-conj,compound,NNP-NNP,NNP,1,1
12561,63540.0,53,ANAHEIM,0,11,15,4,10,37,-11,15,Red Sox,Phil Morse,ORGANIZATION-ORGANIZATION,PERSON-PERSON,PROPN-PROPN,PROPN-PROPN,compound-compound,compound-nsubj,NNP-NNPS,NNP-NNP,2,1
12562,63559.0,25,VERITY-OBIT-MCC,0,2,11,9,1,13,-2,11,Verity,Middletown,PERSON,CITY,PROPN,PROPN,nsubjpass,pobj,NNP,NNP,5,1
12563,63562.0,20,Thank,0,14,5,-9,13,14,-14,5,Citizen Silhouette Eco-Drive Womens Watch EG2052-56D,www.wholesale-watches.org,ORGANIZATION-ORGANIZATION-ORGANIZATION-ORGANIZATION-ORGANIZATION-ORGANIZATION,URL,PROPN-PROPN-PROPN-PROPN-VERB-NOUN,PROPN,compound-compound-compound-compound-compound-pobj,dobj,NNP-NNP-NNP-NNP-VB-NN,NNP,7,1
12564,63563.0,34,confirmed,32,2,20,18,1,13,30,-12,National Republican Campaign Committee,Tom Feeney,ORGANIZATION-ORGANIZATION-ORGANIZATION-ORGANIZATION,PERSON-PERSON,PROPN-PROPN-PROPN-PROPN,PROPN-PROPN,compound-compound-compound-nsubj,compound-conj,NNP-NNP-NNP-NNP,NNP-NNP,-1,1
12565,63568.0,16,is,2,1,4,3,0,11,1,2,Johnny Knoxville,35,PERSON-PERSON,NUMBER,PROPN-PROPN,NUM,compound-nsubj,attr,NNP-NNP,CD,3,1
12566,63579.0,34,announced,2,4,26,22,3,7,-2,24,he,US,PERSON,COUNTRY,PRON,PROPN,nsubj,compound,PRP,NNP,9,1
12567,63596.0,31,said,2,1,14,13,0,16,1,12,He,China,PERSON,COUNTRY,PRON,PROPN,nsubjpass,poss,PRP,NNP,9,1
12568,63622.0,27,completed,8,1,22,21,0,4,7,14,IPSCO,NS Group Inc.,ORGANIZATION,ORGANIZATION-ORGANIZATION-ORGANIZATION,PROPN,PROPN-PROPN-PROPN,nsubj,compound-compound-conj,NNP,NNP-NNP-NNP,6,1
12569,63623.0,54,said,38,52,40,-12,51,13,-14,2,Barnes Foundation,Robert Zaller,ORGANIZATION-ORGANIZATION,PERSON-PERSON,PROPN-PROPN,PROPN-PROPN,compound-pobj,compound-nsubj,NNP-NNP,NNP-NNP,8,1
12570,63635.0,23,found,6,14,4,-10,13,18,-8,-2,his,45,PERSON,NUMBER,DET,NUM,poss,appos,PRP$,CD,4,1
12571,63637.0,86,'s,1,1,6,5,0,79,0,5,She,artist,PERSON,TITLE,PRON,NOUN,nsubj,attr,PRP,NN,1,1
12572,63646.0,25,remain,4,4,1,-3,3,23,0,-3,Malaney,He,PERSON,PERSON,PROPN,PRON,conj,nsubj,NNP,PRP,2,1
12573,63651.0,53,PAZ,1,9,16,7,8,36,-8,15,Dodd,US-Latin,PERSON,ORGANIZATION,PROPN,ADJ,nsubj,amod,NNP,JJ,-1,1
12574,63666.0,62,about,1,33,21,-12,32,40,-32,20,NBA,Utah -LRB- Stars,ORGANIZATION,ORGANIZATION-ORGANIZATION-ORGANIZATION,PROPN,PROPN-PROPN-PROPN,compound,compound-appos-compound,NNP,NNP-NNP-NNP,3,1
12575,63671.0,92,Weitz,1,11,1,-10,10,90,-10,0,JNF,Yossef Weitz,ORGANIZATION,PERSON-PERSON,PROPN,PROPN-PROPN,compound,compound-ROOT,NNP,NNP-NNP,2,1
12576,63681.0,26,faces,17,15,9,-6,14,16,2,-8,Richmond Flowers,Giants,PERSON-PERSON,ORGANIZATION,PROPN-PROPN,PROPN,compound-pobj,compound,NNP-NNP,NNP,4,1
12577,63682.0,4,was,1,1,3,2,0,0,0,2,She,75,PERSON,NUMBER,PRON,NUM,nsubj,attr,PRP,CD,1,1
12578,63692.0,26,think,4,6,22,16,5,3,-2,18,he,filmmaker,PERSON,TITLE,PRON,NOUN,nsubj,appos,PRP,NN,5,1
12579,63693.0,13,died,9,2,6,4,1,6,7,-3,DeBlanc,Louise B DeBlanc,PERSON,PERSON-PERSON-PERSON,PROPN,PROPN-PROPN-PROPN,poss,compound-compound-appos,NNP,NNP-NNP-NNP,4,1
12580,63725.0,31,worked,1,28,1,-27,27,29,-27,0,Old Lane Partners,He,ORGANIZATION-ORGANIZATION-ORGANIZATION,PERSON,PROPN-PROPN-PROPN,PRON,compound-compound-dobj,nsubj,NNP-NNP-NNPS,PRP,5,1
12581,63727.0,44,was,18,25,37,12,24,6,-7,19,Lewis Hamilton,Vodafone McLaren,PERSON-PERSON,ORGANIZATION-ORGANIZATION,PROPN-PROPN,PROPN-PROPN,compound-dative,compound-compound,NNP-NNP,NNP-NNP,7,1
12582,63730.0,28,named,3,25,15,-10,24,12,-22,12,Old Lane,Guru Ramakrishnan,ORGANIZATION-ORGANIZATION,PERSON-PERSON,PROPN-PROPN,PROPN-PROPN,compound-compound,compound-nsubj,NNP-NNP,NNP-NNP,5,1
12583,63763.0,44,said,9,1,29,28,0,14,8,20,Chunghwa Telecom,South Korea,ORGANIZATION-ORGANIZATION,COUNTRY-COUNTRY,PROPN-PROPN,PROPN-PROPN,compound-nsubj,compound-pobj,NNP-NNP,NNP-NNP,6,1
12584,63791.0,39,said,18,29,20,-9,28,18,-11,2,American Bankers Association,Michael Gullette,ORGANIZATION-ORGANIZATION-ORGANIZATION,PERSON-PERSON,PROPN-PROPN-PROPN,PROPN-PROPN,compound-compound-pobj,compound-nsubj,NNP-NNPS-NNP,NNP-NNP,6,1
12585,63793.0,44,died,26,22,20,-2,21,23,4,-6,Gilbert Gude,U.S.,PERSON-PERSON,COUNTRY,PROPN-PROPN,PROPN,compound-appos,compound,NNP-NNP,NNP,1,1
12586,63803.0,22,visit,14,5,19,14,4,2,9,5,DCR,http://www.mass.gov/dcr,ORGANIZATION,NUMBER,PROPN,PRON,pobj,ROOT,NNP,PRP,7,1
12587,63812.0,56,attended,14,49,28,-21,48,27,-35,14,Organization of Islamic Conference,Turkey,ORGANIZATION-ORGANIZATION-ORGANIZATION-ORGANIZATION,COUNTRY,PROPN-ADP-PROPN-PROPN,PROPN,conj-prep-compound-pobj,conj,NNP-IN-NNP-NNP,NNP,9,1
12588,63826.0,39,host,25,1,15,14,0,23,24,-10,Olivia Palermo,ELLE,PERSON-PERSON,ORGANIZATION,PROPN-PROPN,PROPN,compound-nsubj,pobj,NNP-NNP,NNP,3,1
12589,63827.0,31,graduated,19,16,13,-3,15,17,3,-6,Harry Dent,Elizabeth Patch,PERSON-PERSON,PERSON-PERSON,PROPN-PROPN,PROPN-PROPN,compound-conj,compound-pobj,NNP-NNP,NNP-NNP,1,1
12590,63828.0,57,are,17,1,5,4,0,51,16,-12,Donald E. Wildmon,Founder and Chairman American Family Association Donate,PERSON-PERSON-PERSON,ORGANIZATION-ORGANIZATION-ORGANIZATION-ORGANIZATION-ORGANIZATION-ORGANIZATION-ORGANIZATION,PROPN-PROPN-PROPN,PROPN-CCONJ-PROPN-PROPN-PROPN-PROPN-PROPN,compound-compound-nsubj,conj-cc-compound-compound-compound-compound-conj,NNP-NNP-NNP,NNP-CC-NNP-NNP-NNP-NNP-NNP,3,1
12591,63839.0,38,misspelled,22,9,14,5,8,23,13,-8,Cathleen P. Black,mayor,PERSON-PERSON-PERSON,TITLE,PROPN-PROPN-PROPN,NOUN,compound-compound-pobj,poss,NNP-NNP-NNP,NN,4,1
12592,63861.0,45,struggling,32,41,13,-28,40,31,-9,-19,DMC,Detroit Medical Center,ORGANIZATION,ORGANIZATION-ORGANIZATION-ORGANIZATION,PROPN,PROPN-PROPN-PROPN,poss,compound-compound-pobj,NNP,NNP-NNP-NNP,13,1
12593,63869.0,28,said,11,1,4,3,0,23,10,-7,Bryan Fuller,creator/executive producer,PERSON-PERSON,TITLE-TITLE,PROPN-PROPN,ADJ-NOUN,compound-nsubj,det-appos,NNP-NNP,JJ-NN,3,1
12594,63882.0,24,declined,16,8,1,-7,7,22,8,-15,FAW,Dong Chunbo,ORGANIZATION,PERSON-PERSON,PROPN,PROPN-PROPN,compound,compound-nsubj,NNP,NNP-NNP,3,1
12595,63889.0,12,responds,10,10,4,-6,9,7,0,-6,Pratt,Heidi,PERSON,PERSON,PROPN,PROPN,nsubj,poss,NNP,NNP,3,1
12596,63925.0,15,seeking,5,1,14,13,0,0,4,9,Knoxville,Madison,PERSON,PERSON,PROPN,PROPN,nsubj,appos,NNP,NNP,6,1
12597,63928.0,35,Enter,0,4,3,-1,3,31,-4,3,Maloney,Carolyn Maloney,PERSON,PERSON-PERSON,PROPN,PROPN-PROPN,nsubj,compound-nsubj,NNP,NNP-NNP,1,1
12598,63929.0,29,said,27,23,26,3,22,2,4,-1,Arsenal,Keith Edelman,ORGANIZATION,PERSON-PERSON,ADJ,PROPN-PROPN,amod,compound-nsubj,JJ,NNP-NNP,3,1
12599,63933.0,33,are,4,16,9,-7,15,23,-12,5,Chen Zhu,Minister of Science and Technology,PERSON-PERSON,ORGANIZATION-ORGANIZATION-ORGANIZATION-ORGANIZATION-ORGANIZATION,PROPN-PROPN,PROPN-ADP-PROPN-CCONJ-PROPN,compound-conj,appos-prep-pobj-cc-conj,NNP-NNP,NNP-IN-NNP-CC-NNP,3,1
12600,63949.0,17,said,15,15,6,-9,14,10,0,-9,Abrams,Court TV,PERSON,ORGANIZATION-ORGANIZATION,PROPN,PROPN-PROPN,nsubj,compound-pobj,NNP,NNP-NNP,5,1
12601,63954.0,33,said,24,23,8,-15,22,24,1,-16,Nicholas Burns,US State Department,PERSON-PERSON,ORGANIZATION-ORGANIZATION-ORGANIZATION,PROPN-PROPN,PROPN-PROPN-PROPN,compound-nsubj,compound-compound-compound,NNP-NNP,NNP-NNP-NNP,7,1
12602,65233.0,44,told,38,26,35,9,25,8,12,-3,Nicholas Burns,US State Department,PERSON-PERSON,ORGANIZATION-ORGANIZATION-ORGANIZATION,PROPN-PROPN,PROPN-PROPN-PROPN,compound-nsubj,compound-compound-pobj,NNP-NNP,NNP-NNP-NNP,5,1
12603,63955.0,86,YORK,1,17,33,16,16,52,-16,32,Zagat,Kleiner Perkins Caufield & Byers,ORGANIZATION,PERSON-PERSON-PERSON-PERSON-PERSON,PROPN,PROPN-PROPN-PROPN-CCONJ-PROPN,pobj,compound-compound-appos-cc-conj,NNP,NNP-NNP-NNP-CC-NNPS,6,1
12604,63958.0,17,convicted,2,1,9,8,0,7,1,7,He,St. Paul,PERSON,LOCATION-LOCATION,PRON,PROPN-PROPN,nsubjpass,compound-pobj,PRP,NNP-NNP,6,1
12605,63963.0,33,said,13,10,1,-9,9,31,3,-12,American Bankers Association,Robert C. Seiwert,ORGANIZATION-ORGANIZATION-ORGANIZATION,PERSON-PERSON-PERSON,PROPN-PROPN-PROPN,PROPN-PROPN-PROPN,compound-compound-pobj,compound-compound-nsubj,NNP-NNPS-NNP,NNP-NNP-NNP,5,1
12606,63965.0,19,was,1,1,3,2,0,15,0,2,He,85,PERSON,NUMBER,PRON,NUM,nsubj,attr,PRP,CD,1,1
12607,63974.0,42,presented,1,40,33,-7,39,8,-39,32,Philip Chen,Cathay Pacific Airline,PERSON-PERSON,ORGANIZATION-ORGANIZATION-ORGANIZATION,PROPN-PROPN,PROPN-PROPN-PROPN,compound-conj,compound-compound-poss,NNP-NNP,NNP-NNP-NNP,2,1
12608,63975.0,38,got,4,35,14,-21,34,23,-31,10,his,Warner Bros.,PERSON,ORGANIZATION-ORGANIZATION,DET,PROPN-PROPN,poss,compound-nsubj,PRP$,NNP-NNPS,6,1
12609,63987.0,21,Union,2,5,8,3,4,12,-3,6,ISU,Devra Pitt Getaz,ORGANIZATION,PERSON-PERSON-PERSON,PROPN,PROPN-PROPN-PROPN,compound,compound-compound-nsubj,NNP,NNP-NNP-NNP,3,1
12610,63988.0,46,become,22,4,3,-1,3,42,18,-19,Susan Boyle,singer,PERSON-PERSON,TITLE,PROPN-PROPN,NOUN,compound-appos,nsubj,NNP-NNP,NN,1,1
12611,63994.0,35,found,33,31,4,-27,30,30,2,-29,American Bankers Association,US,ORGANIZATION-ORGANIZATION-ORGANIZATION,COUNTRY,PROPN-PROPN-PROPN,PROPN,compound-compound-pobj,compound,NNP-NNPS-NNP,NNP,8,1
12612,64010.0,23,said,10,12,19,7,11,3,-2,9,Hewitt,Virginia Beach,PERSON,CITY-CITY,PROPN,PROPN-PROPN,nsubj,compound-pobj,NNP,NNP-NNP,4,1
12613,64017.0,25,said,12,11,1,-10,10,23,1,-11,EnergySolutions,Jill Sigal,ORGANIZATION,PERSON-PERSON,PROPN,PROPN-PROPN,pobj,compound-nsubj,NNP,NNP-NNP,2,1
12614,64019.0,10,judge,3,1,9,8,0,0,2,6,Trista,bachelorette,PERSON,TITLE,PROPN,NOUN,nsubj,attr,NNP,NN,3,1
12615,64027.0,29,bagged,7,7,5,-2,6,23,0,-2,Ferrera,actress,PERSON,TITLE,PROPN,NOUN,nsubj,compound,NNP,NN,1,1
12616,64029.0,32,includes,4,8,28,20,7,3,-4,24,Julian Bond,Loyola University Law School,PERSON-PERSON,ORGANIZATION-ORGANIZATION-ORGANIZATION-ORGANIZATION,PROPN-PROPN,PROPN-PROPN-PROPN-PROPN,compound-dobj,compound-compound-compound-conj,NNP-NNP,NNP-NNP-NNP-NNP,5,1
12617,64030.0,38,join,21,2,28,26,1,9,19,7,Andre Carson,Minnesota Democrat,PERSON-PERSON,COUNTRY-COUNTRY,PROPN-PROPN,PROPN-PROPN,compound-nsubj,compound-appos,NNP-NNP,NNP-NNP,5,1
12618,64039.0,19,said,7,13,9,-4,12,9,-6,2,International Monetary Fund,Alvin Hilaire,ORGANIZATION-ORGANIZATION-ORGANIZATION,PERSON-PERSON,PROPN-PROPN-PROPN,PROPN-PROPN,compound-compound-compound,compound-nsubj,NNP-NNP-NNP,NNP-NNP,4,1
12619,64049.0,24,earned,4,4,18,14,3,5,0,14,she,California State University,PERSON,ORGANIZATION-ORGANIZATION-ORGANIZATION,PRON,PROPN-PROPN-PROPN,nsubj,compound-compound-attr,PRP,NNP-NNP-NNP,4,1
12620,64053.0,33,told,30,7,12,5,6,20,23,-18,Awami National Party,Fazalur Rehman Atakhel,ORGANIZATION-ORGANIZATION-ORGANIZATION,PERSON-PERSON-PERSON,PROPN-PROPN-PROPN,PROPN-PROPN-PROPN,compound-compound-compound,compound-compound-pobj,NNP-NNP-NNP,NNP-NNP-NNP,4,1
12621,64062.0,29,said,7,6,6,0,5,22,1,-1,National Beef,National Beef/JBS-Swift,ORGANIZATION-ORGANIZATION,ORGANIZATION-ORGANIZATION,PROPN-PROPN,PROPN-PROPN,compound-nsubj,nmod-compound,NNP-NNP,NNP-NNP,0,1
12622,64064.0,31,said,19,28,21,-7,27,9,-9,2,American Bankers Association,John Hall,ORGANIZATION-ORGANIZATION-ORGANIZATION,PERSON-PERSON,PROPN-PROPN-PROPN,PROPN-PROPN,compound-compound-pobj,compound-nsubj,NNP-NNPS-NNP,NNP-NNP,5,1
12623,64082.0,16,died,2,1,5,4,0,10,1,3,Yolanda King,last week,PERSON-PERSON,DATE-DATE,PROPN-PROPN,ADJ-NOUN,compound-nsubj,amod-npadvmod,NNP-NNP,JJ-NN,2,1
12624,64084.0,35,told,9,6,1,-5,5,33,3,-8,Citibank,Maura Markus,ORGANIZATION,PERSON-PERSON,PROPN,PROPN-PROPN,compound,compound-nsubj,NNP,NNP-NNP,4,1
12625,64093.0,45,says,15,5,32,27,4,12,10,17,"aunt , it did take a little getting used to , says Spears , who was a little `` shocked '' while visiting her 17-year-old sister",actress Jamie Lynn,PERSON-PERSON-PERSON-PERSON-PERSON-PERSON-PERSON-PERSON-PERSON-PERSON-PERSON-PERSON-PERSON-PERSON-PERSON-PERSON-PERSON-PERSON-PERSON-PERSON-PERSON-PERSON-PERSON-PERSON-PERSON-PERSON,PERSON-PERSON-PERSON,NOUN-PUNCT-PRON-VERB-VERB-DET-ADJ-VERB-VERB-ADP-PUNCT-VERB-PROPN-PUNCT-PRON-VERB-DET-ADJ-PUNCT-ADJ-PUNCT-ADP-VERB-DET-NUM-NOUN,NOUN-PROPN-PROPN,attr-punct-nsubj-aux-ccomp-det-amod-auxpass-xcomp-prep-punct-ROOT-nsubj-punct-nsubj-relcl-det-amod-punct-attr-punct-mark-advcl-poss-amod-dobj,conj-compound-appos,"NN-,-PRP-VBD-VB-DT-JJ-VBG-VBN-IN-,-VBZ-NNP-,-WP-VBD-DT-JJ-``-JJ-''-IN-VBG-PRP$-CD-NN",NN-NNP-NNP,8,1
12626,64096.0,40,died,18,3,21,18,2,18,15,3,Paul Gillmor,blunt head and neck trauma,PERSON-PERSON,CAUSE_OF_DEATH-CAUSE_OF_DEATH-CAUSE_OF_DEATH-CAUSE_OF_DEATH-CAUSE_OF_DEATH,PROPN-PROPN,ADJ-NOUN-CCONJ-NOUN-NOUN,compound-nsubj,amod-pobj-cc-compound-conj,NNP-NNP,JJ-NN-CC-NN-NN,3,1
12627,64097.0,52,said,36,38,42,4,37,9,-2,6,IMF,Takatoshi Kato,ORGANIZATION,PERSON-PERSON,PROPN,PROPN-PROPN,compound,compound-nsubj,NNP,NNP-NNP,3,1
12628,64099.0,52,said,24,9,1,-8,8,50,15,-23,National Christmas Tree Association,Rick Dungey,ORGANIZATION-ORGANIZATION-ORGANIZATION-ORGANIZATION,PERSON-PERSON,PROPN-PROPN-PROPN-PROPN,PROPN-PROPN,compound-compound-compound-pobj,compound-nsubj,NNP-NNP-NNP-NNP,NNP-NNP,5,1
12629,64100.0,21,said,14,19,16,-3,18,4,-5,2,Andrea Rothman,her,PERSON-PERSON,PERSON,PROPN-PROPN,DET,compound-appos,poss,NNP-NNP,PRP$,3,1
12630,64101.0,39,said,32,34,37,3,33,1,-2,5,FMF,Leon Louw,ORGANIZATION,PERSON-PERSON,PROPN,PROPN-PROPN,compound,compound-nsubj,NNP,NNP-NNP,3,1
12631,64103.0,16,took,10,8,1,-7,7,14,2,-9,Aerolineas Argentinas,Julio Alak,ORGANIZATION-ORGANIZATION,PERSON-PERSON,PROPN-PROPN,PROPN-PROPN,compound-pobj,compound-nsubj,NNP-NNP,NNP-NNP,3,1
12632,64115.0,50,opened,2,25,32,7,24,17,-23,30,Illinois Tool Works Inc,Glenview,ORGANIZATION-ORGANIZATION-ORGANIZATION-ORGANIZATION,CITY,PROPN-PROPN-PROPN-PROPN,PROPN,compound-compound-compound-nsubj,pobj,NNP-NNP-NNP-NNP,NNP,5,1
12633,64117.0,48,expected,4,14,36,22,13,11,-10,32,IMF,Shogo Ishii,ORGANIZATION,PERSON-PERSON,PROPN,PROPN-PROPN,pobj,compound-compound,NNP,NNP-NNP,4,1
12634,64118.0,48,joined,5,5,20,15,4,27,0,15,Nolte,President,PERSON,TITLE,PROPN,PROPN,nsubj,compound,NNP,NNP,6,1
12635,64134.0,43,bought,11,5,33,28,4,9,6,22,CCP,China Petrochemical Development Corp,ORGANIZATION,ORGANIZATION-ORGANIZATION-ORGANIZATION-ORGANIZATION,PROPN,PROPN-PROPN-PROPN-PROPN,compound,compound-compound-compound-appos,NNP,NNP-NNP-NNP-NNP,5,1
12636,64141.0,23,Millender-McDonald,0,1,21,20,0,1,-1,21,Millender-McDonald,Southern California,PERSON,LOCATION-LOCATION,PROPN,PROPN-PROPN,ROOT,compound-dobj,NNP,NNP-NNP,8,1
12637,64146.0,19,happens,1,17,14,-3,16,4,-16,13,George Kennedy,US,PERSON-PERSON,COUNTRY,PROPN-PROPN,PROPN,compound-appos,compound,NNP-NNP,NNP,1,1
12638,64160.0,17,Courtney,2,1,11,10,0,5,1,9,Richard S. Courtney,consultant,PERSON-PERSON-PERSON,TITLE,PROPN-PROPN-PROPN,NOUN,compound-compound-ROOT,conj,NNP-NNP-NNP,NN,5,1
12639,64167.0,50,said,45,16,20,4,15,29,29,-25,MNLF,Panamao,ORGANIZATION,LOCATION,PROPN,PROPN,compound,compound,NNP,NNP,3,1
12640,64184.0,61,General,3,7,1,-6,6,59,-4,-2,National Security Council,Taiwan,ORGANIZATION-ORGANIZATION-ORGANIZATION,COUNTRY,PROPN-PROPN-PROPN,PROPN,compound-compound-pobj,poss,NNP-NNP-NNP,NNP,5,1
12641,64194.0,74,MEET,11,40,47,7,39,26,-29,36,David Gregory,anchor,PERSON-PERSON,TITLE,PROPN-PROPN,NOUN,compound-dobj,appos,NNP-NNP,NN,2,1
12642,64207.0,24,born,4,2,7,5,1,16,2,3,Gertrude Dittmars Roraback,Brooklyn,PERSON-PERSON-PERSON,CITY,PROPN-PROPN-PROPN,PROPN,conj-compound-appos,pobj,NNP-NNP-NNP,NNP,2,1
12643,64209.0,50,include,1,37,18,-19,36,31,-36,17,Daniel Gude,Sharon Gude,PERSON-PERSON,PERSON-PERSON,PROPN-PROPN,PROPN-PROPN,compound-conj,compound-appos,NNP-NNP,NNP-NNP,6,1
12644,64217.0,29,has,2,1,8,7,0,20,1,6,National Beef,Kansas City,ORGANIZATION-ORGANIZATION,CITY-CITY,PROPN-PROPN,PROPN-PROPN,compound-nsubj,compound-conj,NNP-NNP,NNP-NNP,5,1
12645,67769.0,31,said,4,14,10,-4,13,20,-10,6,National Beef,Kansas City,ORGANIZATION-ORGANIZATION,CITY-CITY,PROPN-PROPN,PROPN-PROPN,compound-appos,compound-dobj,NNP-NNP,NNP-NNP,1,1
12646,64219.0,54,include,1,17,8,-9,16,45,-16,7,Richard DeBlanc,Jefferson DeBlanc Jr.,PERSON-PERSON,PERSON-PERSON-PERSON,PROPN-PROPN,PROPN-PROPN-PROPN,compound-conj,compound-compound-appos,NNP-NNP,NNP-NNP-NNP,2,1
12647,64224.0,28,named,5,25,9,-16,24,18,-20,4,Britney,his,PERSON,PERSON,PROPN,DET,poss,poss,NNP,PRP$,8,1
12648,64248.0,26,served,1,1,4,3,0,21,0,3,Sills,general director,PERSON,TITLE-TITLE,NOUN,ADJ-NOUN,nsubj,amod-pobj,NNS,JJ-NN,2,1
12649,64274.0,15,moved,1,1,4,3,0,10,0,3,She,Long Island,PERSON,LOCATION-LOCATION,PRON,PROPN-PROPN,nsubj,compound-pobj,PRP,NNP-NNP,2,1
12650,64279.0,32,lined,4,21,16,-5,20,15,-17,12,Spelman College,Beverly Tatum,ORGANIZATION-ORGANIZATION,PERSON-PERSON,PROPN-PROPN,PROPN-PROPN,compound-pobj,compound-conj,NNP-NNP,NNP-NNP,3,1
12651,64280.0,12,was,9,1,6,5,0,5,8,-3,Henebry,Winnetka,PERSON,CITY,PROPN,PROPN,nsubj,pobj,NNP,NNP,5,1
12652,64292.0,16,served,3,1,6,5,0,9,2,3,Yoadimnadji,agricultural minister,PERSON,TITLE-TITLE,NOUN,ADJ-NOUN,nsubj,amod-pobj,NNS,JJ-NN,3,1
12653,64295.0,39,is,3,3,27,24,2,11,0,24,she,American,PERSON,NATIONALITY,PRON,ADJ,nsubj,amod,PRP,JJ,5,1
12654,64304.0,13,died,4,1,10,9,0,2,3,6,Davis,Gloucester,PERSON,CITY,PROPN,PROPN,nsubj,pobj,NNP,NNP,7,1
12655,64333.0,59,CITY,2,10,1,-9,9,57,-8,-1,EnergySolutions,SALT LAKE CITY,ORGANIZATION,CITY-CITY-CITY,PROPN,PROPN-PROPN-PROPN,poss,compound-compound-ROOT,NNP,NNP-NNP-NNP,3,1
12656,64360.0,32,",",0,3,17,14,2,14,-3,17,her,Justine Walker,PERSON,PERSON-PERSON,DET,PROPN-PROPN,poss,compound-appos,PRP$,NNP-NNP,3,1
12657,64364.0,15,asked,1,13,12,-1,12,2,-12,11,Vladimir Putin,President,PERSON-PERSON,TITLE,PROPN-PROPN,PROPN,compound-pobj,compound,NNP-NNP,NNP,1,1
12658,64365.0,38,come,14,27,8,-19,26,29,-13,-6,Kurnaz,Schroeder,PERSON,PERSON,PROPN,PROPN,dobj,poss,NNP,NNP,8,1
12659,64372.0,49,survived,2,1,38,37,0,10,1,36,She,Sally Bloom,PERSON,PERSON-PERSON,PRON,PROPN-PROPN,nsubjpass,compound-conj,PRP,NNP-NNP,6,1
12660,64387.0,42,ANGELES,1,37,34,-3,36,7,-36,33,DirecTV,News Corp 's,ORGANIZATION,ORGANIZATION-ORGANIZATION-ORGANIZATION,PROPN,PROPN-PROPN-PART,compound,compound-poss-case,NNP,NNP-NNP-POS,8,1
12661,64396.0,21,said,6,1,20,19,0,0,5,14,Marco Contiero,EFSA,PERSON-PERSON,ORGANIZATION,PROPN-PROPN,PROPN,compound-nsubj,pobj,NNP-NNP,NNP,5,1
12662,64398.0,28,begins,2,1,16,15,0,11,1,14,Philadelphia Inquirer,Knight Ridder,ORGANIZATION-ORGANIZATION,ORGANIZATION-ORGANIZATION,PROPN-PROPN,PROPN-PROPN,compound-nsubj,compound-compound,NNP-NNP,NNP-NNP,6,1
12663,64409.0,39,said,5,3,2,-1,2,36,2,-3,G Gary Kirchner,coroner,PERSON-PERSON-PERSON,TITLE,PROPN-PROPN-PROPN,NOUN,compound-compound-nsubj,compound,NNP-NNP-NNP,NN,2,1
12664,64413.0,22,says,11,13,9,-4,12,12,-2,-2,he,analyst,PERSON,TITLE,PRON,NOUN,nsubj,compound,PRP,NN,4,1
12665,65388.0,46,started,1,11,7,-4,10,38,-10,6,he,analyst,PERSON,TITLE,PRON,NOUN,nsubj,pobj,PRP,NN,5,1
12666,64430.0,42,told,22,21,16,-5,20,25,1,-6,Ali Larijani,Supreme National Security Council,PERSON-PERSON,ORGANIZATION-ORGANIZATION-ORGANIZATION-ORGANIZATION,PROPN-PROPN,PROPN-PROPN-PROPN-PROPN,compound-nsubj,compound-compound-compound-compound,NNP-NNP,NNP-NNP-NNP-NNP,4,1
12667,64432.0,38,represented,11,1,17,16,0,20,10,6,His,Labor party,PERSON,ORGANIZATION-ORGANIZATION,DET,PROPN-NOUN,poss,compound-poss,PRP$,NNP-NN,5,1
12668,64469.0,35,prevented,4,23,22,-1,22,12,-19,18,Mia Farrow,actor,PERSON-PERSON,TITLE,PROPN-PROPN,NOUN,compound-poss,compound,NNP-NNP,NN,1,1
12669,64470.0,21,2009-10-07T09,0,4,11,7,3,9,-4,11,Frankie Delgado,television personality,PERSON-PERSON,TITLE-TITLE,PROPN-PROPN,NOUN-NOUN,compound-nsubj,conj-attr,NNP-NNP,NN-NN,6,1
12670,64473.0,57,Buse,1,1,25,24,0,31,0,24,Mark Buse,ExxonMobil,PERSON-PERSON,ORGANIZATION,PROPN-PROPN,PROPN,compound-ROOT,conj,NNP-NNP,NNP,3,1
12671,64490.0,29,wants,2,1,16,15,0,12,1,14,EnergySolutions Inc.,Italy,ORGANIZATION-ORGANIZATION,COUNTRY,PROPN-PROPN,PROPN,compound-nsubj,pobj,NNP-NNP,NNP,6,1
12672,64492.0,29,miss,7,1,5,4,0,23,6,-2,Boston Red Sox,Terry Francona,ORGANIZATION-ORGANIZATION-ORGANIZATION,PERSON-PERSON,PROPN-PROPN-PROPN,PROPN-PROPN,compound-compound-compound,compound-nsubj,NNP-NNP-NNP,NNP-NNP,3,1
12673,64493.0,49,made,22,14,18,4,13,30,8,-4,George Kennedy,Cool Hand Luke,PERSON-PERSON,ORGANIZATION-ORGANIZATION-ORGANIZATION,PROPN-PROPN,PROPN-PROPN-PROPN,compound-pobj,compound-compound-pobj,NNP-NNP,NNP-NNP-NNP,6,1
12674,64504.0,22,began,8,8,4,-4,7,17,0,-4,Sheldon,NJ,PERSON,STATE_OR_PROVINCE,PROPN,PROPN,nsubj,pobj,NNP,NNP,4,1
12675,64514.0,22,born,2,1,12,11,0,9,1,10,Deaver,California,PERSON,STATE_OR_PROVINCE,PROPN,PROPN,nsubjpass,appos,NNP,NNP,5,1
12676,64515.0,19,said,17,17,7,-10,16,11,0,-10,Baldwin,New York,PERSON,STATE_OR_PROVINCE-STATE_OR_PROVINCE,PROPN,PROPN-PROPN,nsubj,compound-pobj,NNP,NNP-NNP,6,1
12677,64516.0,43,mollified,5,3,20,17,2,22,2,15,MBIA,he,ORGANIZATION,PERSON,PROPN,PRON,nsubj,nsubj,NNP,PRP,3,1
12678,65544.0,26,said,2,9,2,-7,8,23,-7,0,MBIA,he,ORGANIZATION,PERSON,PROPN,PRON,poss,nsubj,NNP,PRP,7,1
12679,64524.0,62,gave,26,49,16,-33,48,45,-23,-10,Spelman College,South Carolina,ORGANIZATION-ORGANIZATION,STATE_OR_PROVINCE-STATE_OR_PROVINCE,PROPN-PROPN,PROPN-PROPN,compound-pobj,compound-compound,NNP-NNP,NNP-NNP,-1,1
12680,64529.0,20,received,8,8,6,-2,7,13,0,-2,she,73,PERSON,NUMBER,PRON,NUM,nsubj,nummod,PRP,CD,1,1
12681,64541.0,24,stood,2,19,14,-5,18,9,-17,12,Carolyn Goodman,New York,PERSON-PERSON,STATE_OR_PROVINCE-STATE_OR_PROVINCE,PROPN-PROPN,PROPN-PROPN,compound-dative,compound-compound,NNP-NNP,NNP-NNP,3,1
12682,64548.0,29,accompanied,6,8,4,-4,7,24,-2,-2,him,Barbara,PERSON,PERSON,PRON,PROPN,dobj,appos,PRP,NNP,2,1
12683,64549.0,40,detained,5,3,2,-1,2,37,2,-3,Babyshambles,28-year-old,PERSON,DURATION,PROPN,NUM,compound,amod,NNP,CD,1,1
12684,64569.0,36,said,22,33,24,-9,32,11,-11,2,national auto club,Robert L Darbelnet,ORGANIZATION-ORGANIZATION-ORGANIZATION,PERSON-PERSON-PERSON,ADJ-NOUN-NOUN,PROPN-PROPN-PROPN,amod-compound-pobj,compound-compound-nsubj,JJ-NN-NN,NNP-NNP-NNP,5,1
12685,64572.0,28,reiterated,3,3,2,-1,2,25,0,-1,mom,TLC-approved,PERSON,ORGANIZATION,NOUN,ADJ,nsubj,amod,NN,JJ,1,1
12686,64577.0,51,singles,16,9,12,3,8,38,7,-4,Bernama,Malaysian government,ORGANIZATION,ORGANIZATION-ORGANIZATION,PROPN,ADJ-NOUN,pobj,amod-compound,NNP,JJ-NN,3,1
12687,64618.0,14,led,6,5,4,-1,4,9,1,-2,Beyonce Knowles,star,PERSON-PERSON,TITLE,PROPN-PROPN,NOUN,compound-nsubj,compound,NNP-NNP,NN,2,1
12688,64621.0,73,survived,9,8,20,12,7,52,1,11,Nolte,Jeanne McQuarrie,PERSON,PERSON-PERSON,PROPN,PROPN-PROPN,nsubjpass,compound-appos,NNP,NNP-NNP,3,1
12689,64629.0,46,COLUMBUS,0,7,20,13,6,25,-7,20,Paul Gillmor,earlier this week,PERSON-PERSON,DATE-DATE-DATE,PROPN-PROPN,ADV-DET-NOUN,compound-nsubj,advmod-det-npadvmod,NNP-NNP,RBR-DT-NN,5,1
12690,64632.0,19,leave,6,12,11,-1,11,7,-6,5,Option One subsidiary,California-based,ORGANIZATION-ORGANIZATION-ORGANIZATION,STATE_OR_PROVINCE,PROPN-NUM-NOUN,PROPN,nmod-nummod-dobj,amod,NNP-CD-NN,NNP,1,1
12691,64654.0,30,became,1,1,27,26,0,2,0,26,Davis,Foreign Affairs Committee,PERSON,ORGANIZATION-ORGANIZATION-ORGANIZATION,PROPN,PROPN-PROPN-PROPN,nsubj,compound-compound-conj,NNP,NNP-NNPS-NNP,4,1
12692,64660.0,15,survived,2,1,8,7,0,6,1,6,She,Martin III,PERSON,PERSON-PERSON,PRON,PROPN-PROPN,nsubjpass,compound-appos,PRP,NNP-NNP,2,1
12693,64672.0,29,became,2,1,11,10,0,17,1,9,He,black representatives,PERSON,TITLE-TITLE,PRON,ADJ-NOUN,nsubj,amod-pobj,PRP,JJ-NNS,6,1
12694,64685.0,48,suggested,1,7,19,12,6,28,-6,18,Mainland Affairs Council,Chung Hwa Travel Service,ORGANIZATION-ORGANIZATION-ORGANIZATION,ORGANIZATION-ORGANIZATION-ORGANIZATION-ORGANIZATION,PROPN-PROPN-PROPN,PROPN-PROPN-PROPN-PROPN,compound-compound-poss,compound-compound-compound-pobj,NNP-NNPS-NNP,NNP-NNP-NNP-NNP,7,1
12695,64695.0,27,survived,2,8,14,6,7,12,-6,12,Brenda Morgan Bacquie,Sherwood Morgan Jr.,PERSON-PERSON-PERSON,PERSON-PERSON-PERSON,PROPN-PROPN-PROPN,PROPN-PROPN-PROPN,compound-compound-appos,compound-compound-appos,NNP-NNP-NNP,NNP-NNP-NNP,4,1
12696,64700.0,40,includes,1,12,5,-7,11,34,-11,4,Northland,Dr Joel C Hunter,ORGANIZATION,PERSON-PERSON-PERSON-PERSON,PROPN,PROPN-PROPN-PROPN-PROPN,pobj,compound-compound-compound-pobj,NNP,NNP-NNP-NNP-NNP,5,1
12697,64707.0,47,ii,0,16,16,0,15,30,-16,16,Oxford University Press,Oxford Dictionary of National Biography,ORGANIZATION-ORGANIZATION-ORGANIZATION,ORGANIZATION-ORGANIZATION-ORGANIZATION-ORGANIZATION-ORGANIZATION,PROPN-PROPN-PROPN,PROPN-PROPN-ADP-PROPN-PROPN,compound-compound-nsubj,compound-pobj-prep-compound-pobj,NNP-NNP-NNP,NNP-NNP-IN-NNP-NNP,0,1
12698,64720.0,27,DIES,4,8,11,3,7,15,-4,7,He,Armco Steel,PERSON,ORGANIZATION-ORGANIZATION,PRON,PROPN-PROPN,nsubj,compound-pobj,PRP,NNP-NNP,2,1
12699,64726.0,23,noted,14,22,16,-6,21,6,-8,2,Denso,Sadahiro Usui,ORGANIZATION,PERSON-PERSON,PROPN,PROPN-PROPN,pobj,compound-nsubj,NNP,NNP-NNP,2,1
12700,64727.0,30,is,2,11,28,17,10,1,-9,26,American Bankers Association,Republican,ORGANIZATION-ORGANIZATION-ORGANIZATION,RELIGION,PROPN-PROPN-PROPN,ADJ,compound-compound-appos,amod,NNP-NNPS-NNP,JJ,10,1
12701,64743.0,28,won,1,12,5,-7,11,22,-11,4,Goldwater,icon,PERSON,ORGANIZATION,PROPN,NOUN,dobj,poss,NNP,NN,4,1
12702,64778.0,56,include,1,24,33,9,23,22,-23,32,William Wymond Verity,Betsy Verity Blakey,PERSON-PERSON-PERSON,PERSON-PERSON-PERSON,PROPN-PROPN-PROPN,PROPN-PROPN-PROPN,compound-compound-conj,compound-compound-conj,NNP-NNP-NNP,NNP-NNP-NNP,7,1
12703,64784.0,42,gave,17,14,10,-4,13,31,3,-7,Ghent University,Center for Vaccinology,ORGANIZATION-ORGANIZATION,ORGANIZATION-ORGANIZATION-ORGANIZATION,PROPN-PROPN,PROPN-ADP-PROPN,compound-pobj,pobj-prep-pobj,NNP-NNP,NNP-IN-NNP,2,1
12704,64797.0,32,KONG,1,6,30,24,5,1,-5,29,The theme park,September 2005,ORGANIZATION-ORGANIZATION-ORGANIZATION,DATE-DATE,DET-NOUN-NOUN,PROPN-NUM,det-compound-nsubjpass,pobj-nummod,DT-NN-NN,NNP-CD,-1,1
12705,64804.0,54,According,0,39,52,13,38,1,-39,52,Ayatollah Ali Khamenei,Myanmar,PERSON-PERSON-PERSON,NATIONALITY,PROPN-PROPN-PROPN,PROPN,compound-compound-conj,compound,NNP-NNP-NNP,NNP,4,1
12706,64810.0,25,survived,2,1,18,17,0,6,1,16,She,Sherwood Morgan Jr,PERSON,PERSON-PERSON-PERSON,PRON,PROPN-PROPN-PROPN,nsubjpass,compound-compound-appos,PRP,NNP-NNP-NNP,7,1
12707,64812.0,28,reached,2,19,1,-18,18,26,-17,-1,Holly Montag,Stephani Pratt,PERSON-PERSON,PERSON-PERSON,PROPN-PROPN,PROPN-PROPN,compound-poss,compound-nsubj,NNP-NNP,NNP-NNP,9,1
12708,64823.0,43,joined,2,2,25,23,1,17,0,23,AAA,he,ORGANIZATION,PERSON,PROPN,PRON,nsubj,nsubj,NNP,PRP,10,1
12709,64833.0,32,says,11,3,2,-1,2,29,8,-9,Beverly Sills,star,PERSON-PERSON,TITLE,PROPN-PROPN,NOUN,compound-nsubj,compound,NNP-NNP,NN,1,1
12710,64834.0,73,McNair,1,1,1,0,0,71,0,0,Robert McNair,Robert E Jr,PERSON-PERSON,PERSON-PERSON-PERSON,PROPN-PROPN,PROPN-PROPN-PROPN,compound-ROOT,compound-compound-appos,NNP-NNP,NNP-NNP-NNP,0,1
12711,64842.0,49,said,34,30,36,6,29,12,4,2,Taiwan Research Institute,Xu Bodong,ORGANIZATION-ORGANIZATION-ORGANIZATION,PERSON-PERSON,PROPN-PROPN-PROPN,PROPN-PROPN,compound-compound-pobj,compound-nsubj,NNP-NNP-NNP,NNP-NNP,6,1
12712,64849.0,34,became,26,1,31,30,0,2,25,5,He,anchor,PERSON,TITLE,PRON,NOUN,nsubj,attr,PRP,NN,3,1
12713,64850.0,14,was,1,1,13,12,0,0,0,12,He,Conn.,PERSON,STATE_OR_PROVINCE,PRON,PROPN,nsubj,appos,PRP,NNP,1,1
12714,64858.0,26,lists,7,5,9,4,4,16,2,2,American Bankers Association,Bank Sepah,ORGANIZATION-ORGANIZATION-ORGANIZATION,ORGANIZATION-ORGANIZATION,PROPN-PROPN-PROPN,PROPN-PROPN,compound-compound-pobj,compound-dobj,NNP-NNPS-NNP,NNP-NNP,5,1
12715,64864.0,48,said,35,2,37,35,1,10,33,2,USA Network,Jeff Wachtel,ORGANIZATION-ORGANIZATION,PERSON-PERSON,PROPN-PROPN,PROPN-PROPN,compound-nsubj,compound-nsubj,NNP-NNP,NNP-NNP,4,1
12716,64868.0,17,took,1,4,16,12,3,0,-3,15,Carnival,Mexico,ORGANIZATION,COUNTRY,PROPN,PROPN,compound,pobj,NNP,NNP,2,1
12717,64904.0,26,founded,3,1,10,9,0,15,2,7,He co,the 1980s,ORGANIZATION-ORGANIZATION,DATE-DATE,PRON-VERB,DET-NOUN,nsubj-subtok,det-pobj,PRP-VBD,DT-NNS,2,1
12718,64905.0,34,honored,8,2,5,3,1,28,6,-3,Red Sox,John Harrington,ORGANIZATION-ORGANIZATION,PERSON-PERSON,PROPN-PROPN,PROPN-PROPN,compound-compound,compound-nsubjpass,NNP-NNPS,NNP-NNP,2,1
12719,64907.0,32,said,19,29,21,-8,28,10,-10,2,International Monetary Fund,Claudio Loser,ORGANIZATION-ORGANIZATION-ORGANIZATION,PERSON-PERSON,PROPN-PROPN-PROPN,PROPN-PROPN,compound-compound-pobj,compound-nsubj,NNP-NNP-NNP,NNP-NNP,4,1
12720,64924.0,47,told,16,24,18,-6,23,28,-8,2,his,Iranian,PERSON,NATIONALITY,DET,ADJ,poss,amod,PRP$,JJ,5,1
12721,64930.0,33,managed,4,20,25,5,19,7,-16,21,Golden Baseball League,independent,ORGANIZATION-ORGANIZATION-ORGANIZATION,RELIGION,PROPN-PROPN-PROPN,ADJ,compound-compound-pobj,amod,NNP-NNP-NNP,JJ,8,1
12722,64936.0,42,goes,32,1,6,5,0,35,31,-26,Hamilton,McLaren Mercedes-Benz,PERSON,ORGANIZATION-ORGANIZATION,PROPN,PROPN-PROPN,nsubj,compound-nmod,NNP,NNP-NNP,5,1
12723,64943.0,16,says,3,15,10,-5,14,5,-12,7,LET,Lashkar-e-Tayyiba,ORGANIZATION,ORGANIZATION,PROPN,PROPN,pobj,pobj,NNP,NNP,7,1
12724,64947.0,69,'s,10,61,65,4,60,3,-51,55,Michael Sandy,29-year-old,PERSON-PERSON,DURATION,PROPN-PROPN,NUM,compound-pobj,amod,NNP-NNP,CD,4,1
12725,64951.0,33,showed,30,6,4,-2,5,28,24,-26,Ellen DeGeneres,US,PERSON-PERSON,COUNTRY,PROPN-PROPN,PROPN,compound-nsubj,compound,NNP-NNP,NNP,1,1
12726,64956.0,55,survived,15,14,28,14,13,26,1,13,she,Anne Crisp,PERSON,PERSON-PERSON,PRON,PROPN-PROPN,nsubjpass,compound-conj,PRP,NNP-NNP,5,1
12727,64960.0,28,said,2,16,22,6,15,5,-14,20,Remy Ma,witness tampering,PERSON-PERSON,CRIMINAL_CHARGE-CRIMINAL_CHARGE,PROPN-PROPN,NOUN-NOUN,compound-poss,compound-pobj,NNP-NNP,NN-NN,4,1
12728,64961.0,14,Get,1,10,13,3,9,0,-9,12,bus company,wwwfmcsadotgov,ORGANIZATION-ORGANIZATION,URL,NOUN-NOUN,NOUN,compound-pobj,pobj,NN-NN,NN,6,1
12729,64967.0,21,noted,4,8,9,1,7,11,-4,5,24-year-old,shipbuilder,PERSON,TITLE,NUM,NOUN,amod,nsubjpass,CD,NN,1,1
12730,64972.0,25,elected,19,1,22,21,0,2,18,3,Gillmor,Congress,PERSON,ORGANIZATION,PROPN,PROPN,nsubjpass,pobj,NNP,NNP,3,1
12731,64978.0,79,survived,8,7,14,7,6,64,1,6,Meskill,Eileen Gallup,PERSON,PERSON-PERSON,PROPN,PROPN-PROPN,nsubjpass,compound-appos,NNP,NNP-NNP,4,1
12732,65008.0,53,encouraged,13,8,33,25,7,19,5,20,Oxford University Press,Southern California,ORGANIZATION-ORGANIZATION-ORGANIZATION,LOCATION-LOCATION,PROPN-PROPN-PROPN,PROPN-PROPN,compound-compound-pobj,compound-pobj,NNP-NNP-NNP,NNP-NNP,9,1
12733,65009.0,42,appointed,7,1,11,10,0,30,6,4,Philip Chen,John Swire & Sons -LRB- China -RRB- Ltd.,PERSON-PERSON,ORGANIZATION-ORGANIZATION-ORGANIZATION-ORGANIZATION-ORGANIZATION-ORGANIZATION-ORGANIZATION-ORGANIZATION,PROPN-PROPN,PROPN-PROPN-CCONJ-PROPN-PROPN-PROPN-PROPN-PROPN,compound-nsubjpass,compound-pobj-cc-conj-compound-compound-compound-ccomp,NNP-NNP,NNP-NNP-CC-NNPS-NNP-NNP-NNP-NNP,4,1
12734,65012.0,47,died,36,1,40,39,0,6,35,4,Vernon Bellecourt,complications,PERSON-PERSON,CAUSE_OF_DEATH,PROPN-PROPN,NOUN,compound-nsubj,pobj,NNP-NNP,NNS,5,1
12735,65026.0,16,said,4,3,1,-2,2,14,1,-3,George Kennedy,Kent,PERSON-PERSON,ORGANIZATION,PROPN-PROPN,NOUN,compound-nsubj,compound,NNP-NNP,NN,1,1
12736,65027.0,31,working,14,2,8,6,1,22,12,-6,International Monetary Fund,Organization for Economic Cooperation and Development,ORGANIZATION-ORGANIZATION-ORGANIZATION,ORGANIZATION-ORGANIZATION-ORGANIZATION-ORGANIZATION-ORGANIZATION-ORGANIZATION,PROPN-PROPN-PROPN,PROPN-ADP-PROPN-PROPN-CCONJ-PROPN,compound-compound-nsubj,conj-prep-compound-pobj-cc-conj,NNP-NNP-NNP,NNP-IN-NNP-NNP-CC-NNP,3,1
12737,65036.0,55,Dozens,0,6,10,4,5,44,-6,10,Chunghwa Telecom Co.,CHT,ORGANIZATION-ORGANIZATION-ORGANIZATION,ORGANIZATION,PROPN-PROPN-PROPN,PROPN,compound-subtok-subtok,nmod,NNP-NNP-NNP,NNP,-1,1
12738,65039.0,31,was,5,2,1,-1,1,29,3,-4,Michael Johns,Australian,PERSON-PERSON,NATIONALITY,PROPN-PROPN,PROPN,compound-poss,compound,NNP-NNP,NNP,1,1
12739,65048.0,25,said,2,14,24,10,13,0,-12,22,his,Afghanistan,PERSON,COUNTRY,DET,PROPN,poss,pobj,PRP$,NNP,3,1
12740,65060.0,17,nursed,4,1,3,2,0,13,3,-1,Maloney,59,PERSON,NUMBER,PROPN,NUM,nsubj,appos,NNP,CD,3,1
12741,65068.0,48,said,37,2,44,42,1,3,35,7,China National Aviation Corp,Hong Kong,ORGANIZATION-ORGANIZATION-ORGANIZATION-ORGANIZATION,CITY-CITY,PROPN-PROPN-PROPN-PROPN,PROPN-PROPN,compound-compound-compound-compound,compound-compound,NNP-NNP-NNP-NNP,NNP-NNP,-1,1
12742,65069.0,42,accepted,1,7,11,4,6,30,-6,10,Asian Basketball Association,ABA,ORGANIZATION-ORGANIZATION-ORGANIZATION,ORGANIZATION,PROPN-PROPN-PROPN,PROPN,compound-compound-pobj,compound,NNP-NNP-NNP,NNP,6,1
12743,65072.0,34,promoted,3,26,21,-5,25,12,-23,18,Lou Ferrara,news executives,PERSON-PERSON,TITLE-TITLE,PROPN-PROPN,NOUN-NOUN,compound-conj,compound-dobj,NNP-NNP,NN-NNS,2,1
12744,65107.0,24,said,21,1,4,3,0,19,20,-17,Flowers,Parkinson 's disease,PERSON,CAUSE_OF_DEATH-CAUSE_OF_DEATH-CAUSE_OF_DEATH,NOUN,PROPN-PART-NOUN,nsubj,poss-case-pobj,NNS,NNP-POS-NN,4,1
12745,65125.0,24,stands,2,1,14,13,0,9,1,12,Fidelity Investments,Johnson,ORGANIZATION-ORGANIZATION,PERSON,PROPN-PROPN,PROPN,compound-nsubj,compound,NNP-NNP,NNP,4,1
12746,65153.0,10,been,2,1,5,4,0,4,1,3,Beyonce,spokeswoman,PERSON,TITLE,PROPN,NOUN,nsubj,attr,NNP,NN,3,1
12747,65159.0,41,released,22,5,4,-1,4,36,17,-18,Barbara Boxer,Chairman,PERSON-PERSON,TITLE,PROPN-PROPN,PROPN,compound-nsubj,compound,NNP-NNP,NNP,1,1
12748,65172.0,94,redemption,1,8,15,7,7,78,-7,14,Paul Kim,Asian,PERSON-PERSON,NATIONALITY,PROPN-PROPN,ADJ,compound-nsubj,amod,NNP-NNP,JJ,4,1
12749,65178.0,28,said,1,22,12,-10,21,15,-21,11,Alberto Gonzales,Senate Judiciary committee,PERSON-PERSON,ORGANIZATION-ORGANIZATION-ORGANIZATION,PROPN-PROPN,PROPN-PROPN-NOUN,compound-nsubjpass,compound-compound-compound,NNP-NNP,NNP-NNP-NN,4,1
12750,65187.0,34,agreed,1,16,7,-9,15,26,-15,6,CNAC,China National Aviation Corp. -LRB- Group -RRB- Ltd.,ORGANIZATION,ORGANIZATION-ORGANIZATION-ORGANIZATION-ORGANIZATION-ORGANIZATION-ORGANIZATION-ORGANIZATION-ORGANIZATION,PROPN,PROPN-PROPN-PROPN-PROPN-PROPN-PROPN-PROPN-PROPN,compound,compound-compound-subtok-subtok-subtok-subtok-subtok-subtok,NNP,NNP-NNP-NNP-NNP-NNP-NNP-NNP-NNP,-1,1
12751,65195.0,35,said,33,1,33,32,0,1,32,0,Carolyn Goodman,Jonathan,PERSON-PERSON,PERSON,PROPN-PROPN,PROPN,compound-nsubj,appos,NNP-NNP,NNP,4,1
12752,65213.0,32,said,18,29,27,-2,28,4,-11,9,Private Sector Department,ADB,ORGANIZATION-ORGANIZATION-ORGANIZATION,ORGANIZATION,PROPN-PROPN-PROPN,PROPN,compound-compound-pobj,poss,NNP-NNP-NNP,NNP,3,1
12753,65226.0,32,appointed,13,6,10,4,5,21,7,-3,Asian Development Bank,Khempheng Pholsena,ORGANIZATION-ORGANIZATION-ORGANIZATION,PERSON-PERSON,PROPN-PROPN-PROPN,PROPN-PROPN,compound-compound-pobj,compound-appos,NNP-NNP-NNP,NNP-NNP,2,1
12754,65266.0,18,-LRB-,0,9,13,4,8,4,-9,13,Oxford University Press,1978,ORGANIZATION-ORGANIZATION-ORGANIZATION,DATE,PROPN-PROPN-PROPN,NUM,compound-compound-appos,appos,NNP-NNP-NNP,CD,2,1
12755,65270.0,60,survived,2,21,1,-20,20,58,-19,-1,Robert E. Jr.,He,PERSON-PERSON-PERSON,PERSON,PROPN-PROPN-PROPN,PRON,compound-compound-appos,nsubjpass,NNP-NNP-NNP,PRP,6,1
12756,65274.0,47,died,32,1,40,39,0,6,31,8,Jennifer Dunn,Va.,PERSON-PERSON,STATE_OR_PROVINCE,PROPN-PROPN,PROPN,compound-nsubj,subtok,NNP-NNP,NNP,-1,1
12757,65280.0,9,died,5,1,4,3,0,4,4,-1,His,Mary,PERSON,PERSON,DET,PROPN,poss,appos,PRP$,NNP,2,1
12758,65287.0,30,has,18,1,28,27,0,1,17,10,Remy Ma,intimidation,PERSON-PERSON,CRIMINAL_CHARGE,PROPN-PROPN,NOUN,compound-nsubj,compound,NNP-NNP,NN,7,1
12759,65290.0,30,said,14,27,16,-11,26,13,-13,2,American Beverage Association,Judith Thorman,ORGANIZATION-ORGANIZATION-ORGANIZATION,PERSON-PERSON,PROPN-PROPN-PROPN,PROPN-PROPN,compound-compound-pobj,compound-nsubj,NNP-NNP-NNP,NNP-NNP,7,1
12760,65299.0,25,said,20,2,7,5,1,17,18,-13,Her,disease,PERSON,CAUSE_OF_DEATH,DET,NOUN,poss,dobj,PRP$,NN,3,1
12761,65301.0,33,is,23,21,17,-4,20,15,2,-6,FAW,First Automobile Work,ORGANIZATION,ORGANIZATION-ORGANIZATION-ORGANIZATION,PROPN,PROPN-PROPN-PROPN,compound,compound-compound-pobj,NNP,NNP-NNP-NNP,7,1
12762,65304.0,27,said,2,17,26,9,16,0,-15,24,he,Dragonair,PERSON,ORGANIZATION,PRON,PROPN,nsubj,pobj,PRP,NNP,7,1
12763,65308.0,32,detained,7,1,4,3,0,27,6,-3,Kurnaz,German-born,PERSON,NATIONALITY,PROPN,PROPN,nsubjpass,compound,NNP,NNP,4,1
12764,65332.0,48,told,42,44,29,-15,43,18,-2,-13,The Jakarta Globe,Jakarta,ORGANIZATION-ORGANIZATION-ORGANIZATION,CITY,DET-PROPN-PROPN,PROPN,det-compound-compound,pobj,DT-NNP-NNP,NNP,8,1
12765,65347.0,15,House,7,6,1,-5,5,13,1,-6,Massachusetts State House of Representatives,George Rogers,ORGANIZATION-ORGANIZATION-ORGANIZATION-ORGANIZATION-ORGANIZATION,PERSON-PERSON,PROPN-PROPN-PROPN-ADP-PROPN,PROPN-PROPN,compound-compound-ROOT-prep-pobj,compound-compound,NNP-NNP-NNP-IN-NNPS,NNP-NNP,3,1
12766,65395.0,37,said,30,1,35,34,0,1,29,5,Konica Minolta,Yoshiaki Ando,ORGANIZATION-ORGANIZATION,PERSON-PERSON,PROPN-PROPN,PROPN-PROPN,compound-nsubj,compound-nsubj,NNP-NNP,NNP-NNP,4,1
12767,65396.0,26,born,4,1,15,14,0,10,3,11,Joseph Simpson Farland,WVa,PERSON-PERSON-PERSON,STATE_OR_PROVINCE,PROPN-PROPN-PROPN,NOUN,compound-compound-nsubjpass,npadvmod,NNP-NNP-NNP,NNS,4,1
12768,65397.0,32,received,6,29,5,-24,28,26,-23,-1,U.S. Surgical Corp.,Jarvik,ORGANIZATION-ORGANIZATION-ORGANIZATION,PERSON,PROPN-PROPN-PROPN,PROPN,compound-compound-dobj,nsubj,NNP-NNP-NNP,NNP,7,1
12769,65405.0,14,suppose,1,4,9,5,3,4,-3,8,Abrams,American-News-Guy-Who-I-Don,PERSON,NATIONALITY,PROPN,NOUN,nsubj,attr,NNP,NN,5,1
12770,65412.0,19,set,6,2,11,9,1,7,4,5,Inter American Press Association,1940s,ORGANIZATION-ORGANIZATION-ORGANIZATION-ORGANIZATION,DATE,PROPN-PROPN-PROPN-PROPN,NOUN,compound-compound-compound-nsubjpass,pobj,NNP-NNP-NNP-NNP,NNS,4,1
12771,65415.0,31,was,1,1,4,3,0,26,0,3,Sheldon,deputy state attorney general,PERSON,TITLE-TITLE-TITLE-TITLE,PROPN,NOUN-NOUN-NOUN-NOUN,nsubj,compound-compound-compound-attr,NNP,NN-NN-NN-NN,2,1
12772,65477.0,39,provided,6,30,19,-11,29,19,-24,13,FMF,Foreign Military Financing,ORGANIZATION,ORGANIZATION-ORGANIZATION-ORGANIZATION,PROPN,PROPN-PROPN-PROPN,compound,compound-compound-appos,NNP,NNP-NNP-NNP,6,1
12773,65486.0,46,*,0,41,38,-3,40,7,-41,38,Oxford University Press,Bertram Wyatt-Brown,ORGANIZATION-ORGANIZATION-ORGANIZATION,PERSON-PERSON,PROPN-PROPN-PROPN,PROPN-PROPN,compound-compound-conj,compound-pobj,NNP-NNP-NNP,NNP-NNP,2,1
12774,65489.0,28,BAGHDAD,0,13,7,-6,12,20,-13,7,Hussein Kamel,Izzeddine Hassan al-Majid,PERSON-PERSON,PERSON-PERSON-PERSON,PROPN-PROPN,PROPN-PROPN-NOUN,compound-compound,compound-compound-nsubj,NNP-NNP,NNP-NNP-NN,3,1
12775,65500.0,17,asked,0,3,11,8,2,5,-3,11,Carolyn Maloney,House,PERSON-PERSON,ORGANIZATION,PROPN-PROPN,PROPN,compound-nsubj,compound,NNP-NNP,NNP,3,1
12776,65516.0,34,be,5,1,10,9,0,23,4,5,His,54,PERSON,NUMBER,DET,NUM,poss,appos,PRP$,CD,5,1
12777,65529.0,39,spent,21,4,8,4,3,30,17,-13,Federal Election Commission,Bradley Smith,ORGANIZATION-ORGANIZATION-ORGANIZATION,PERSON-PERSON,PROPN-PROPN-PROPN,PROPN-PROPN,compound-compound-compound,compound-nsubj,NNP-NNP-NNP,NNP-NNP,3,1
12778,65533.0,64,said,23,33,25,-8,32,38,-10,2,Project Islamic HOPE,TuesdayNajee Ali,ORGANIZATION-ORGANIZATION-ORGANIZATION,PERSON-PERSON,PROPN-PROPN-VERB,PROPN-PROPN,appos-compound-appos,compound-nsubj,NNP-NNP-VBD,NNP-NNP,3,1
12779,65552.0,14,lasts,10,1,8,7,0,5,9,-2,His,Council of State,PERSON,ORGANIZATION-ORGANIZATION-ORGANIZATION,DET,PROPN-ADP-PROPN,poss,pobj-prep-pobj,PRP$,NNP-IN-NNP,6,1
12780,65553.0,33,are,26,2,6,4,1,26,24,-20,Julian Bond,Georgia,PERSON-PERSON,STATE_OR_PROVINCE,PROPN-PROPN,PROPN,compound-nsubj,compound,NNP-NNP,NNP,1,1
12781,65568.0,24,Coroner,2,5,4,-1,4,19,-3,2,G Gary Kirchner,Dr,PERSON-PERSON-PERSON,TITLE,PROPN-PROPN-PROPN,PROPN,compound-compound-nsubj,compound,NNP-NNP-NNP,NNP,2,1
12782,65590.0,22,asks,11,8,1,-7,7,20,3,-10,American Psychological Association,Dr Martin Seligman,ORGANIZATION-ORGANIZATION-ORGANIZATION,PERSON-PERSON-PERSON,PROPN-PROPN-PROPN,PROPN-PROPN-PROPN,compound-compound-pobj,compound-compound-nsubj,NNP-NNP-NNP,NNP-NNP-NNP,5,1
12783,65596.0,61,take,7,15,40,25,14,20,-8,33,Dodd,Grace,PERSON,PERSON,PROPN,PROPN,nsubj,appos,NNP,NNP,11,1
12784,65599.0,43,arrested,23,16,10,-6,15,32,7,-13,Scorpions,Gerry Nel,ORGANIZATION,PERSON-PERSON,PROPN,PROPN-PROPN,pobj,compound-dobj,NNPS,NNP-NNP,4,1
12785,65607.0,51,ranked,26,8,17,9,7,33,18,-9,American Bankers Association,ABA Banking Journal,ORGANIZATION-ORGANIZATION-ORGANIZATION,ORGANIZATION-ORGANIZATION-ORGANIZATION,PROPN-PROPN-PROPN,PROPN-PROPN-PROPN,compound-compound-poss,compound-compound-conj,NNP-NNPS-NNP,NNP-NNP-NNP,4,1
12786,65638.0,37,be,4,13,10,-3,12,26,-9,6,Army Medical Command,Americans,ORGANIZATION-ORGANIZATION-ORGANIZATION,MISC,PROPN-PROPN-PROPN,PROPN,compound-compound-pobj,pobj,NNP-NNP-NNP,NNPS,3,1
12787,65644.0,37,said,14,4,1,-3,3,35,10,-13,IMF,David Cowen,ORGANIZATION,PERSON-PERSON,PROPN,PROPN-PROPN,poss,compound-nsubj,NNP,NNP-NNP,3,1
12788,65645.0,43,were,6,10,16,6,9,26,-4,10,Levant,Western Standard,PERSON,ORGANIZATION-ORGANIZATION,PROPN,PROPN-PROPN,poss,compound-appos,NNP,NNP-NNP,4,1
12789,65664.0,8,died,1,1,4,3,0,3,0,3,Davis,breast cancer,PERSON,CAUSE_OF_DEATH-CAUSE_OF_DEATH,PROPN,NOUN-NOUN,nsubj,compound-pobj,NNP,NN-NN,2,1
12790,65665.0,35,approached,14,1,5,4,0,29,13,-9,Cutrone,44,PERSON,NUMBER,PROPN,NUM,nsubjpass,nummod,NNP,CD,4,1
12791,65675.0,33,told,7,1,3,2,0,29,6,-4,JEM,Abu Zumam,ORGANIZATION,PERSON-PERSON,PROPN,PROPN-PROPN,compound,compound-nsubj,NNP,NNP-NNP,1,1
12792,65683.0,48,is,12,8,9,1,7,38,4,-3,Raul Castro,Castro,PERSON-PERSON,PERSON,PROPN-PROPN,PROPN,compound-pobj,pobj,NNP-NNP,NNP,3,1
12793,65688.0,41,was,2,31,38,7,30,2,-29,36,Dennis Dunn,King County GOP,PERSON-PERSON,ORGANIZATION-ORGANIZATION-ORGANIZATION,PROPN-PROPN,PROPN-PROPN-PROPN,compound-appos,compound-compound-pobj,NNP-NNP,NNP-NNP-NNP,6,1
12794,65695.0,29,elected,9,6,5,-1,5,23,3,-4,Seyed Ali Khamenei,Ayatollah,PERSON-PERSON-PERSON,TITLE,PROPN-PROPN-PROPN,PROPN,compound-compound-nsubjpass,compound,NNP-NNP-NNP,NNP,2,1
12795,65701.0,24,Department,1,2,20,18,1,3,-1,19,Department of Conservation and Recreation,MA,ORGANIZATION-ORGANIZATION-ORGANIZATION-ORGANIZATION-ORGANIZATION,STATE_OR_PROVINCE,PROPN-ADP-PROPN-CCONJ-PROPN,PROPN,ROOT-prep-pobj-cc-conj,npadvmod,NNP-IN-NNP-CC-NNP,NNP,-1,1
12796,65715.0,23,said,4,3,1,-2,2,21,1,-3,Chris Bentley,CIS,PERSON-PERSON,ORGANIZATION,PROPN-PROPN,PROPN,compound-nsubj,compound,NNP-NNP,NNP,1,1
12797,65723.0,26,said,14,25,16,-9,24,9,-11,2,FAW,Li Jun,ORGANIZATION,PERSON-PERSON,PROPN,PROPN-PROPN,pobj,compound-nsubj,NNP,NNP-NNP,2,1
12798,65724.0,29,investigating,8,13,7,-6,12,21,-5,-1,Lewis Hamilton,FIA,PERSON-PERSON,ORGANIZATION,PROPN-PROPN,PROPN,compound-dobj,nsubj,NNP-NNP,NNP,8,1
12799,65726.0,29,has,6,21,2,-19,20,26,-15,-4,Kennedy Space Center,National Aeronautics and Space Administration,ORGANIZATION-ORGANIZATION-ORGANIZATION,ORGANIZATION-ORGANIZATION-ORGANIZATION-ORGANIZATION-ORGANIZATION,PROPN-PROPN-PROPN,PROPN-PROPN-CCONJ-PROPN-PROPN,compound-compound-pobj,nmod-nmod-cc-conj-nsubj,NNP-NNP-NNP,NNP-NNP-CC-NNP-NNP,8,1
12800,65731.0,35,received,1,18,11,-7,17,23,-17,10,Chelsea Library,McKune Memorial Library,ORGANIZATION-ORGANIZATION,ORGANIZATION-ORGANIZATION-ORGANIZATION,PROPN-PROPN,PROPN-PROPN-PROPN,compound-attr,compound-compound-pobj,NNP-NNP,NNP-NNP-NNP,-1,1
12801,65746.0,43,1-5,2,15,23,8,14,19,-13,21,Scorpions,National Directorate of Public Prosecutions,ORGANIZATION,ORGANIZATION-ORGANIZATION-ORGANIZATION-ORGANIZATION-ORGANIZATION,PROPN,PROPN-PROPN-ADP-PROPN-PROPN,poss,compound-pobj-prep-compound-pobj,NNPS,NNP-NNP-IN-NNP-NNPS,7,1
12802,65747.0,21,Clinton,5,17,8,-9,16,12,-12,3,John Kerry,Vice President,PERSON-PERSON,TITLE-TITLE,PROPN-PROPN,PROPN-PROPN,compound-conj,compound-compound,NNP-NNP,NNP-NNP,2,1
12803,65755.0,20,included,3,14,3,-11,13,16,-11,0,Itochu,Tokyo,ORGANIZATION,CITY,PROPN,PROPN,compound,pobj,NNP,NNP,2,1
12804,65768.0,49,said,33,44,46,2,43,2,-11,13,ADB,East Asia Department,ORGANIZATION,ORGANIZATION-ORGANIZATION-ORGANIZATION,PROPN,PROPN-PROPN-PROPN,poss,compound-compound-pobj,NNP,NNP-NNP-NNP,2,1
12805,65775.0,45,has,37,7,2,-5,6,42,30,-35,David Gregory,Huffington Post,PERSON-PERSON,ORGANIZATION-ORGANIZATION,PROPN-PROPN,PROPN-PROPN,compound-nsubj,compound-compound,NNP-NNP,NNP-NNP,4,1
12806,65776.0,20,died,10,2,18,16,1,1,8,8,David,September 2005,PERSON,DATE-DATE,PROPN,PROPN-NUM,poss,pobj-nummod,NNP,NNP-CD,8,1
12807,65783.0,28,declined,15,5,12,7,4,15,10,-3,Ipsco,David S Sutherland,ORGANIZATION,PERSON-PERSON-PERSON,PROPN,PROPN-PROPN-PROPN,poss,compound-compound-appos,NNP,NNP-NNP-NNP,4,1
12808,65818.0,40,served,11,2,17,15,1,22,9,6,his,Baltimore,PERSON,CITY,DET,PROPN,poss,compound,PRP$,NNP,7,1
12809,67820.0,64,elected,2,10,23,13,9,40,-8,21,his,Baltimore,PERSON,CITY,DET,PROPN,poss,nmod,PRP$,NNP,10,1
12810,65819.0,29,says,9,23,15,-8,22,13,-14,6,Justice and Equality Movement rebel group,Abdelaziz Ushar,ORGANIZATION-ORGANIZATION-ORGANIZATION-ORGANIZATION-ORGANIZATION-ORGANIZATION,PERSON-PERSON,PROPN-CCONJ-PROPN-PROPN-NOUN-NOUN,PROPN-PROPN,nmod-cc-conj-compound-compound-pobj,compound-dobj,NNP-CC-NNP-NNP-NN-NN,NNP-NNP,6,1
12811,65850.0,31,gave,5,14,25,11,13,5,-9,20,he,drugs,PERSON,CRIMINAL_CHARGE,PRON,NOUN,nsubj,pobj,PRP,NNS,4,1
12812,65862.0,37,told,31,33,7,-26,32,29,-2,-24,Australian Broadcasting Corp.,one,ORGANIZATION-ORGANIZATION-ORGANIZATION,NUMBER,PROPN-PROPN-PROPN,PRON,compound-compound-compound,nsubj,NNP-NNP-NNP,PRP,8,1
12813,65871.0,60,said,52,58,54,-4,57,5,-6,2,Bankers Association,Beth Mills,ORGANIZATION-ORGANIZATION,PERSON-PERSON,PROPN-PROPN,PROPN-PROPN,compound-pobj,compound-nsubj,NNPS-NNP,NNP-NNP,4,1
12814,65876.0,44,said,42,6,6,0,5,37,36,-36,Korean Central News Agency,Korean Peninsula,ORGANIZATION-ORGANIZATION-ORGANIZATION-ORGANIZATION,LOCATION-LOCATION,PROPN-PROPN-PROPN-PROPN,PROPN-PROPN,compound-compound-compound-nsubj,compound-pobj,NNP-NNP-NNP-NNP,NNP-NNP,0,1
12815,65877.0,30,looked,14,8,19,11,7,10,6,5,her,Hank Baskett,PERSON,PERSON-PERSON,DET,PROPN-PROPN,poss,compound-pobj,PRP$,NNP-NNP,6,1
12816,65887.0,28,intensify,13,10,17,7,9,10,3,4,Detroit Medical Center,Metro Detroit,ORGANIZATION-ORGANIZATION-ORGANIZATION,LOCATION-LOCATION,PROPN-PROPN-PROPN,PROPN-PROPN,compound-compound-pobj,compound-compound,NNP-NNP-NNP,NNP-NNP,8,1
12817,65906.0,35,appointed,26,33,1,-32,32,33,-7,-25,FAW,Xu Jianyi,ORGANIZATION,PERSON-PERSON,PROPN,PROPN-PROPN,compound,compound-nsubjpass,NNP,NNP-NNP,4,1
12818,65917.0,47,said,28,37,30,-7,36,16,-9,2,Gibson Guitar,Henry Juskiewicz,ORGANIZATION-ORGANIZATION,PERSON-PERSON,PROPN-PROPN,PROPN-PROPN,compound-pobj,compound-nsubj,NNP-NNP,NNP-NNP,5,1
12819,65919.0,31,said,12,28,9,-19,27,21,-16,-3,Asian Development Bank,financial institutions,ORGANIZATION-ORGANIZATION-ORGANIZATION,ORGANIZATION-ORGANIZATION,PROPN-PROPN-PROPN,ADJ-NOUN,compound-compound-pobj,amod-pobj,NNP-NNP-NNP,JJ-NNS,13,1
12820,65939.0,69,said,46,59,49,-10,58,19,-13,3,Norris Comprehensive Cancer Center,David Peng,ORGANIZATION-ORGANIZATION-ORGANIZATION-ORGANIZATION,PERSON-PERSON,PROPN-PROPN-PROPN-PROPN,PROPN-PROPN,compound-compound-compound-pobj,compound-nsubj,NNP-NNP-NNP-NNP,NNP-NNP,6,1
12821,65942.0,33,sung,6,9,13,4,8,19,-3,7,Brian McFadden,Irish,PERSON-PERSON,NATIONALITY,PROPN-PROPN,ADJ,compound-pobj,amod,NNP-NNP,JJ,3,1
12822,65947.0,22,declined,12,10,1,-9,9,20,2,-11,Konica Minolta,Donald Warwick,ORGANIZATION-ORGANIZATION,PERSON-PERSON,PROPN-PROPN,PROPN-PROPN,compound-pobj,compound-nsubj,NNP-NNP,NNP-NNP,3,1
12823,65967.0,5,shouted,3,2,1,-1,1,3,1,-2,Ellen DeGeneres,presenter,PERSON-PERSON,TITLE,PROPN-PROPN,NOUN,compound-nsubj,compound,NNP-NNP,NN,1,1
12824,65968.0,31,is,17,7,10,3,6,20,10,-7,his,pilot,PERSON,TITLE,DET,NOUN,poss,dobj,PRP$,NN,3,1
12825,65974.0,29,included,4,8,6,-2,7,22,-4,2,Dan Ferrara,Tampa,PERSON-PERSON,CITY,PROPN-PROPN,PROPN,compound-dobj,poss,NNP-NNP,NNP,2,1
12826,65976.0,26,RELEASE,1,5,21,16,4,4,-4,20,Chelsea District Library,Friends of the Library Group,ORGANIZATION-ORGANIZATION-ORGANIZATION,ORGANIZATION-ORGANIZATION-ORGANIZATION-ORGANIZATION-ORGANIZATION,PROPN-PROPN-PROPN,PROPN-ADP-DET-PROPN-PROPN,compound-compound-nsubj,dobj-prep-det-compound-pobj,NNP-NNP-NNP,NNPS-IN-DT-NNP-NNP,5,1
12827,66020.0,27,finishing,7,1,6,5,0,20,6,-1,Chelsea Library,Elmouchi,ORGANIZATION-ORGANIZATION,PERSON,PROPN-PROPN,PROPN,compound-compound,nsubj,NNP-NNP,NNP,3,1
12828,66028.0,49,concerns,2,7,25,18,6,23,-5,23,Michael Sandy,last October,PERSON-PERSON,DATE-DATE,PROPN-PROPN,ADJ-PROPN,compound-pobj,amod-npadvmod,NNP-NNP,JJ-NNP,5,1
12829,66029.0,13,founded,8,10,12,2,9,0,-2,4,it,1981,ORGANIZATION,DATE,PRON,NUM,dobj,pobj,PRP,CD,2,1
12830,66045.0,8,settled,2,1,5,4,0,2,1,3,His,Mineola,PERSON,CITY,DET,PROPN,poss,pobj,PRP$,NNP,4,1
12831,67200.0,8,settled,2,1,5,4,0,2,1,3,His,Mineola,PERSON,CITY,DET,PROPN,poss,pobj,PRP$,NNP,4,1
12832,66052.0,52,obtained,16,23,29,6,22,22,-7,13,his,porter,PERSON,TITLE,DET,NOUN,poss,appos,PRP$,NN,2,1
12833,66054.0,31,swapping,2,17,8,-9,16,22,-15,6,DirecTV Group Inc.,News Corp.,ORGANIZATION-ORGANIZATION-ORGANIZATION,ORGANIZATION-ORGANIZATION,PROPN-PROPN-PROPN,PROPN-PROPN,compound-compound-pobj,compound-pobj,NNP-NNP-NNP,NNP-NNP,9,1
12834,66057.0,55,wrote,12,45,10,-35,44,44,-33,-2,Convocation of Anglicans in North America,Episcopal Church,ORGANIZATION-ORGANIZATION-ORGANIZATION-ORGANIZATION-ORGANIZATION-ORGANIZATION,RELIGION-RELIGION,PROPN-ADP-PROPN-ADP-PROPN-PROPN,PROPN-PROPN,pobj-prep-pobj-prep-compound-pobj,compound-pobj,NNP-IN-NNPS-IN-NNP-NNP,NNP-NNP,12,1
12835,66059.0,47,Jr,2,1,24,23,0,22,1,22,Jefferson DeBlanc,Michael DeBlanc,PERSON-PERSON,PERSON-PERSON,PROPN-PROPN,PROPN-PROPN,compound-compound,compound-conj,NNP-NNP,NNP-NNP,4,1
12836,66086.0,24,Seligman,0,8,1,-7,7,22,-8,1,American Psychological Association,Seligman,ORGANIZATION-ORGANIZATION-ORGANIZATION,PERSON,PROPN-PROPN-PROPN,PROPN,compound-compound-pobj,ROOT,NNP-NNP-NNP,NNP,5,1
12837,66089.0,30,died,22,3,9,6,2,20,19,-13,Steven B. Derounian,Nassau County,PERSON-PERSON-PERSON,LOCATION-LOCATION,PROPN-PROPN-PROPN,PROPN-PROPN,compound-compound-nsubj,compound-dobj,NNP-NNP-NNP,NNP-NNP,3,1
12838,66098.0,12,ordered,1,8,1,-7,7,10,-7,0,him,He,PERSON,PERSON,PRON,PRON,pobj,nsubj,PRP,PRP,2,1
12839,66100.0,52,said,12,1,5,4,0,46,11,-7,Mahmood Shah,security chief,PERSON-PERSON,TITLE-TITLE,PROPN-PROPN,NOUN-NOUN,compound-nsubj,compound-appos,NNP-NNP,NN-NN,1,1
12840,66111.0,32,features,10,26,10,-16,25,21,-16,0,USA Network,Hulu,ORGANIZATION-ORGANIZATION,LOCATION,PROPN-PROPN,PROPN,compound-conj,nsubj,NNP-NNP,NNP,6,1
12841,66119.0,27,said,12,7,1,-6,6,25,5,-11,Kennedy Space Center,George Diller,ORGANIZATION-ORGANIZATION-ORGANIZATION,PERSON-PERSON,PROPN-PROPN-PROPN,PROPN-PROPN,compound-compound-pobj,compound-nsubj,NNP-NNP-NNP,NNP-NNP,4,1
12842,66130.0,37,dropped,5,34,4,-30,33,32,-29,-1,Option One Mortgage,H&R Block,ORGANIZATION-ORGANIZATION-ORGANIZATION,ORGANIZATION-ORGANIZATION,PROPN-NUM-NOUN,PROPN-PROPN,compound-nummod-appos,compound-nsubj,NNP-CD-NN,NNP-NNP,6,1
12843,66131.0,29,supposed,6,16,28,12,15,0,-10,22,Jamie Lynn,Missouri,PERSON-PERSON,STATE_OR_PROVINCE,PROPN-PROPN,PROPN,compound-conj,appos,NNP-NNP,NNP,4,1
12844,66172.0,47,died,40,1,46,45,0,0,39,6,Catherine Roraback,Conn,PERSON-PERSON,STATE_OR_PROVINCE,PROPN-PROPN,PROPN,compound-nsubj,appos,NNP-NNP,NNP,2,1
12845,66173.0,46,is,7,10,26,16,9,19,-3,19,he,Director,PERSON,TITLE,PRON,PROPN,nsubj,pobj,PRP,NNP,4,1
12846,66179.0,27,received,9,9,26,17,8,0,0,17,she,Washington,PERSON,STATE_OR_PROVINCE,PRON,PROPN,nsubj,pobj,PRP,NNP,1,1
12847,66181.0,25,years,3,19,10,-9,18,14,-16,7,Blackburn,Rovers,ORGANIZATION,ORGANIZATION,PROPN,PROPN,dobj,compound,NNP,NNPS,4,1
12848,66197.0,40,is,4,3,31,28,2,8,1,27,Adam Senn,star,PERSON-PERSON,TITLE,PROPN-PROPN,NOUN,compound-nsubj,attr,NNP-NNP,NN,7,1
12849,66214.0,26,excited,15,6,6,0,5,19,9,-9,Arsenal Football Club,Arsenal,ORGANIZATION-ORGANIZATION-ORGANIZATION,ORGANIZATION,PROPN-PROPN-PROPN,PROPN,compound-compound-pobj,compound,NNP-NNP-NNP,NNP,0,1
12850,66230.0,25,born,4,1,20,19,0,4,3,16,Richard Henry Nolte,Julius,PERSON-PERSON-PERSON,PERSON,PROPN-PROPN-PROPN,PROPN,compound-compound-nsubjpass,pobj,NNP-NNP-NNP,NNP,5,1
12851,66238.0,30,died,22,3,21,18,2,8,19,-1,Steven B Derounian,judge,PERSON-PERSON-PERSON,TITLE,PROPN-PROPN-PROPN,NOUN,compound-compound-nsubj,attr,NNP-NNP-NNP,NN,3,1
12852,66241.0,8,is,2,1,4,3,0,3,1,2,Susan Boyle,48,PERSON-PERSON,NUMBER,PROPN-PROPN,NUM,compound-nsubj,nummod,NNP-NNP,CD,3,1
12853,66259.0,24,forced,4,12,22,10,11,1,-8,18,Aerolineas,"9,000",ORGANIZATION,NUMBER,PROPN,NUM,pobj,nummod,NNP,CD,5,1
12854,66266.0,25,owned,3,22,24,2,21,0,-19,21,Aerolineas Argentinas,SA,ORGANIZATION-ORGANIZATION,ORGANIZATION,PROPN-PROPN,PROPN,compound-compound,pobj,NNP-NNP,NNP,9,1
12855,66293.0,42,announced,5,5,23,18,4,18,0,18,IMF,Liberia,ORGANIZATION,COUNTRY,PROPN,PROPN,nsubj,dobj,NNP,NNP,2,1
12856,66294.0,53,said,39,2,49,47,1,3,37,10,Red Cross,ARC,ORGANIZATION-ORGANIZATION,ORGANIZATION,PROPN-PROPN,PROPN,compound-nsubj,poss,NNP-NNP,NNP,5,1
12857,66300.0,40,died,33,1,40,39,0,-1,32,7,Jefferson J DeBlanc,La,PERSON-PERSON-PERSON,STATE_OR_PROVINCE,PROPN-PROPN-PROPN,PROPN,compound-compound-nsubj,npadvmod,NNP-NNP-NNP,NNP,-1,1
12858,66314.0,33,won,9,2,32,30,1,0,7,23,grandson,Congress,PERSON,ORGANIZATION,NOUN,PROPN,nsubj,pobj,NN,NNP,3,1
12859,66317.0,43,reported,41,8,19,11,7,23,33,-22,Theodor ` Teddy ' Kollek,Israeli,PERSON-PERSON-PERSON-PERSON-PERSON,COUNTRY,NOUN-PUNCT-PROPN-PART-PROPN,PROPN,nmod-punct-poss-case-nsubj,amod,NN-''-NNP-POS-NNP,NNP,5,1
12860,66326.0,43,mollified,5,3,3,0,2,39,2,-2,MBIA,MBIA Inc.,ORGANIZATION,ORGANIZATION-ORGANIZATION,PROPN,PROPN-PROPN,nsubj,compound-nsubj,NNP,NNP-NNP,0,1
12861,66350.0,58,bade,7,27,26,-1,26,31,-20,19,Randall Forsberg,leader,PERSON-PERSON,TITLE,PROPN-PROPN,NOUN,compound-conj,compound,NNP-NNP,NN,1,1
12862,66356.0,41,was,2,20,31,11,19,9,-18,29,she,Dennis Dunn,PERSON,PERSON-PERSON,PRON,PROPN-PROPN,nsubj,compound-appos,PRP,NNP-NNP,4,1
12863,66365.0,36,conceded,7,11,35,24,10,0,-4,28,his,accident,PERSON,CAUSE_OF_DEATH,DET,NOUN,poss,attr,PRP$,NN,4,1
12864,66376.0,34,is,2,4,10,6,3,23,-2,8,Covidien Ltd.,Tyco,ORGANIZATION-ORGANIZATION,ORGANIZATION,PROPN-PROPN,PROPN,compound-attr,compound,NNP-NNP,NNP,2,1
12865,66393.0,23,is,3,1,7,6,0,15,2,4,Hussein Kamel al-Majid,commander,PERSON-PERSON-PERSON,TITLE,PROPN-PROPN-PROPN,NOUN,compound-compound-nsubj,attr,NNP-NNP-NNP,NN,4,1
12866,66396.0,30,survived,2,5,1,-4,4,28,-3,-1,his,Bellecourt,PERSON,PERSON,DET,PROPN,poss,nsubjpass,PRP$,NNP,3,1
12867,66405.0,18,Association,3,2,6,4,1,11,1,3,American Bankers Association,http://wwwabacom,ORGANIZATION-ORGANIZATION-ORGANIZATION,URL,PROPN-PROPN-PROPN,X,compound-compound-ROOT,compound,NNP-NNPS-NNP,ADD,3,1
12868,66414.0,39,urged,6,8,37,29,7,1,-2,31,Gonzales,US,PERSON,COUNTRY,PROPN,PROPN,dobj,compound,NNP,NNP,8,1
12869,66438.0,41,said,6,17,16,-1,16,24,-11,10,Raul Castro,leader,PERSON-PERSON,TITLE,PROPN-PROPN,NOUN,compound-pobj,compound,NNP-NNP,NN,1,1
12870,66445.0,25,left,1,1,16,15,0,8,0,15,He,Pakistan,PERSON,COUNTRY,PRON,PROPN,nsubj,pobj,PRP,NNP,3,1
12871,66450.0,39,remembered,3,1,26,25,0,12,2,23,Beverly Sills,administrator,PERSON-PERSON,TITLE,PROPN-PROPN,NOUN,compound-nsubjpass,pobj,NNP-NNP,NN,6,1
12872,66454.0,36,is,15,1,9,8,0,26,14,-6,Fyffes,London,ORGANIZATION,CITY,ADV,PROPN,nsubj,compound,RB,NNP,5,1
12873,66472.0,28,said,16,1,11,10,0,16,15,-5,Jackson Hewitt Tax Services Inc.,Smart Tax of Georgia Inc.,ORGANIZATION-ORGANIZATION-ORGANIZATION-ORGANIZATION-ORGANIZATION,ORGANIZATION-ORGANIZATION-ORGANIZATION-ORGANIZATION-ORGANIZATION,PROPN-PROPN-PROPN-PROPN-PROPN,PROPN-PROPN-ADP-PROPN-PROPN,compound-compound-compound-compound-nsubj,compound-dobj-prep-compound-pobj,NNP-NNP-NNP-NNPS-NNP,NNP-NNP-IN-NNP-NNP,3,1
12874,66493.0,42,left,6,17,8,-9,16,33,-11,2,Mahdi,Karbala,PERSON,LOCATION,PROPN,PROPN,pobj,dobj,NNP,NNP,7,1
12875,66497.0,42,said,35,29,32,3,28,9,6,-3,Obamas,White House,ORGANIZATION,LOCATION-LOCATION,PROPN,PROPN-PROPN,dobj,compound-pobj,NNP,NNP-NNP,4,1
12876,66505.0,11,Patterson-UTI,0,1,3,2,0,7,-1,3,Patterson-UTI,http://wwwpatenergycom,ORGANIZATION,URL,NOUN,X,ROOT,ROOT,NN,ADD,2,1
12877,66512.0,57,said,25,1,6,5,0,50,24,-19,Marcel Ospel,chairman of the board,PERSON-PERSON,TITLE-TITLE-TITLE-TITLE,PROPN-PROPN,NOUN-ADP-DET-NOUN,compound-nsubj,appos-prep-det-pobj,NNP-NNP,NN-IN-DT-NN,2,1
12878,66517.0,86,Bryanston,2,2,2,0,1,83,0,0,CNR Bryanston,CNR,ORGANIZATION-ORGANIZATION,ORGANIZATION,PROPN-PROPN,PROPN,compound-ROOT,compound,NNP-NNP,NNP,0,1
12879,66529.0,40,said,1,25,37,12,24,2,-24,36,Hussein Kamel,Baghdad,PERSON-PERSON,CITY,PROPN-PROPN,PROPN,compound-compound,pobj,NNP-NNP,NNP,3,1
12880,66556.0,47,take,20,30,17,-13,29,29,-10,-3,he,Poland,PERSON,COUNTRY,PRON,PROPN,nsubj,pobj,PRP,NNP,6,1
12881,66560.0,47,reviving,7,44,31,-13,43,15,-37,24,American Red Cross,Clara Barton,ORGANIZATION-ORGANIZATION-ORGANIZATION,PERSON-PERSON,PROPN-PROPN-PROPN,PROPN-PROPN,compound-compound-dobj,compound-pobj,NNP-NNP-NNP,NNP-NNP,10,1
12882,66611.0,24,said,19,19,9,-10,18,14,0,-10,Alcatel-Lucent,Camus,ORGANIZATION,PERSON,PROPN,PROPN,advmod,nsubj,NNP,NNP,5,1
12883,66642.0,19,became,1,1,6,5,0,12,0,5,Dent,South Carolina Republican Party,PERSON,ORGANIZATION-ORGANIZATION-ORGANIZATION-ORGANIZATION,PROPN,PROPN-PROPN-PROPN-PROPN,nsubj,compound-compound-compound-pobj,NNP,NNP-NNP-NNP-NNP,4,1
12884,66662.0,32,appointed,2,2,18,16,1,13,0,16,FMF,April 16,ORGANIZATION,DATE-DATE,PROPN,PROPN-NUM,nsubj,pobj-nummod,NNP,NNP-CD,4,1
12885,66674.0,30,gained,1,28,24,-4,27,5,-27,23,Michael Mitchell,Clarence Mitchell III,PERSON-PERSON,PERSON-PERSON-PERSON,PROPN-PROPN,PROPN-PROPN-PROPN,compound-conj,compound-compound-dobj,NNP-NNP,NNP-NNP-NNP,3,1
12886,66705.0,19,said,4,1,3,2,0,15,3,-1,FAA,Kathleen Bergen,ORGANIZATION,PERSON-PERSON,PROPN,PROPN-PROPN,compound,compound-nsubj,NNP,NNP-NNP,1,1
12887,66713.0,60,UPDATE,0,3,13,10,2,46,-3,13,Focus On The Family,Colorado Springs,ORGANIZATION-ORGANIZATION-ORGANIZATION-ORGANIZATION,CITY-CITY,PROPN-ADP-DET-PROPN,PROPN-PROPN,ROOT-prep-det-poss,compound-pobj,NNP-IN-DT-NNP,NNP-NNP,4,1
12888,66718.0,32,sack,1,5,10,5,4,21,-4,9,Jacksonville,American Conference,ORGANIZATION,ORGANIZATION-ORGANIZATION,PROPN,PROPN-PROPN,nsubj,compound-pobj,NNP,NNP-NNP,2,1
12889,66724.0,48,gives,12,4,1,-3,3,46,8,-11,Haifa University,Roni Reich,ORGANIZATION-ORGANIZATION,PERSON-PERSON,PROPN-PROPN,PROPN-PROPN,compound-pobj,compound-nsubj,NNP-NNP,NNP-NNP,2,1
12890,66727.0,52,said,50,19,42,23,18,9,31,-8,Central American Parliament,Panama,ORGANIZATION-ORGANIZATION-ORGANIZATION,ORGANIZATION,ADJ-PROPN-PROPN,PROPN,compound-compound-pobj,conj,JJ-NNP-NNP,NNP,22,1
12891,66733.0,28,died,21,1,26,25,0,1,20,5,Sills,July 2,PERSON,DATE-DATE,NOUN,PROPN-NUM,nsubj,npadvmod-nummod,NNS,NNP-CD,4,1
12892,66735.0,86,YORK,1,17,41,24,16,44,-16,40,Zagat,Allen & Co,ORGANIZATION,PERSON-PERSON-PERSON,PROPN,PROPN-CCONJ-PROPN,pobj,appos-cc-conj,NNP,NNP-CC-NNP,5,1
12893,66737.0,27,is,1,1,21,20,0,5,0,20,Carnival,Princess Cruises,ORGANIZATION,ORGANIZATION-ORGANIZATION,NOUN,PROPN-PROPN,nsubj,compound-conj,NN,NNP-NNPS,7,1
12894,66747.0,35,Washburn,2,2,29,27,1,5,0,27,Bradford Washburn,heart failure,PERSON-PERSON,CAUSE_OF_DEATH-CAUSE_OF_DEATH,PROPN-PROPN,NOUN-NOUN,compound-ROOT,compound-pobj,NNP-NNP,NN-NN,7,1
12895,66777.0,10,founded,1,1,7,6,0,2,0,6,She,Higher Ground Productions,PERSON,ORGANIZATION-ORGANIZATION-ORGANIZATION,PRON,PROPN-PROPN-PROPN,nsubj,compound-compound-oprd,PRP,NNP-NNP-NNPS,4,1
12896,66802.0,27,told,24,22,14,-8,21,12,2,-10,International Crisis Group,Issandr El Amrani,ORGANIZATION-ORGANIZATION-ORGANIZATION,PERSON-PERSON-PERSON,PROPN-PROPN-PROPN,PROPN-PROPN-PROPN,compound-compound-pobj,compound-compound-nsubj,NNP-NNP-NNP,NNP-NNP-NNP,7,1
12897,66806.0,35,be,12,1,32,31,0,2,11,20,Cartier Tank American Ladies Watch WB7072K2,wholesalewa,ORGANIZATION-ORGANIZATION-ORGANIZATION-ORGANIZATION-ORGANIZATION-ORGANIZATION,LOCATION,PROPN-PROPN-PROPN-PROPN-PROPN-PROPN,NOUN,compound-compound-compound-compound-compound-nsubj,pobj,NNP-NNP-NNP-NNP-NNP-NNP,NN,6,1
12898,66811.0,16,says,14,4,14,10,3,1,10,0,Project Islamic Hope,he,ORGANIZATION-ORGANIZATION-ORGANIZATION,PERSON,PROPN-PROPN-PROPN,PRON,compound-compound-appos,nsubj,NNP-NNP-NNP,PRP,4,1
12899,66825.0,54,responded,5,1,52,51,0,1,4,47,Boxer,America,PERSON,COUNTRY,PROPN,PROPN,amod,pobj,NNP,NNP,11,1
12900,66842.0,15,said,1,12,1,-11,11,13,-11,0,Khamenei,He,PERSON,PERSON,PROPN,PRON,poss,nsubj,NNP,PRP,5,1
12901,66847.0,30,said,15,10,1,-9,9,28,5,-14,Department of Conservation and Recreation,Ken Gooch,ORGANIZATION-ORGANIZATION-ORGANIZATION-ORGANIZATION-ORGANIZATION,PERSON-PERSON,PROPN-ADP-PROPN-CCONJ-PROPN,PROPN-PROPN,pobj-prep-pobj-cc-conj,compound-nsubj,NNP-IN-NNP-CC-NNP,NNP-NNP,4,1
12902,66857.0,19,said,5,8,4,-4,7,14,-3,-1,he,21,PERSON,NUMBER,PRON,NUM,nsubj,appos,PRP,CD,3,1
12903,66866.0,53,held,14,1,34,33,0,18,13,20,Murat Kurnaz,Kandahar,PERSON-PERSON,LOCATION,PROPN-PROPN,PROPN,compound-compound,pobj,NNP-NNP,NNP,8,1
12904,66888.0,45,Rebels,0,42,29,-13,41,15,-42,29,MNLF,Mampait Alam,ORGANIZATION,PERSON-PERSON,PROPN,PROPN-PROPN,poss,compound-pobj,NNP,NNP-NNP,6,1
12905,66892.0,16,said,7,9,13,4,8,2,-2,6,Dewey,Turf-rific Turf Consulting,PERSON,ORGANIZATION-ORGANIZATION-ORGANIZATION,PROPN,PROPN-PROPN-PROPN,nsubj,compound-compound-dobj,NNP,NNP-NNP-NNP,5,1
12906,66899.0,29,served,5,2,9,7,1,19,3,4,61-year-old,DCF,PERSON,ORGANIZATION,NUM,PROPN,amod,compound,CD,NNP,4,1
12907,66912.0,50,Tehran,0,7,16,9,6,33,-7,16,Asian Parliament Assembly,IRNA,ORGANIZATION-ORGANIZATION-ORGANIZATION,ORGANIZATION,ADJ-PROPN-PROPN,PROPN,compound-pobj-appos,compound,JJ-NNP-NNP,NNP,8,1
12908,66914.0,17,were,6,5,16,11,4,0,1,10,SAC,1946,ORGANIZATION,DATE,PROPN,NUM,nsubjpass,pobj,NNP,CD,2,1
12909,66930.0,47,accused,4,6,8,2,5,38,-2,4,Chavez,offering an open-ended loan of at least US$ 250 million to the Revolutionary Armed Forces of Colombia,PERSON,CRIMINAL_CHARGE-CRIMINAL_CHARGE-CRIMINAL_CHARGE-CRIMINAL_CHARGE-CRIMINAL_CHARGE-CRIMINAL_CHARGE-CRIMINAL_CHARGE-CRIMINAL_CHARGE-CRIMINAL_CHARGE-CRIMINAL_CHARGE-CRIMINAL_CHARGE-CRIMINAL_CHARGE-CRIMINAL_CHARGE-CRIMINAL_CHARGE-CRIMINAL_CHARGE-CRIMINAL_CHARGE-CRIMINAL_CHARGE,PROPN,VERB-DET-ADJ-NOUN-ADP-ADV-ADV-SYM-NUM-NUM-ADP-DET-PROPN-PROPN-PROPN-ADP-PROPN,dobj,pcomp-det-amod-dobj-prep-advmod-advmod-quantmod-compound-pobj-dative-det-compound-compound-pobj-prep-pobj,NNP,VBG-DT-JJ-NN-IN-RB-RBS-$-CD-CD-IN-DT-NNP-NNP-NNPS-IN-NNP,3,1
12910,66951.0,42,forming,20,1,5,4,0,36,19,-15,Dan Abrams,chief legal correspondent,PERSON-PERSON,TITLE-TITLE-TITLE,PROPN-PROPN,ADJ-ADJ-NOUN,compound-nsubj,amod-amod-appos,NNP-NNP,JJ-JJ-NN,2,1
12911,66981.0,23,WINCHESTER,0,7,10,3,6,12,-7,10,Farland,special agent,PERSON,TITLE-TITLE,PROPN,ADJ-NOUN,nsubj,amod-attr,NNP,JJ-NN,3,1
12912,66997.0,14,Court,1,6,1,-5,5,12,-5,0,he,Circuit Court of Appeals,PERSON,ORGANIZATION-ORGANIZATION-ORGANIZATION-ORGANIZATION,PRON,PROPN-PROPN-ADP-PROPN,nsubj,compound-ROOT-prep-pobj,PRP,NNP-NNP-IN-NNPS,1,1
12913,67009.0,38,canceled,12,8,6,-2,7,31,4,-6,Christopher Dodd,presidential candidate,PERSON-PERSON,TITLE-TITLE,PROPN-PROPN,ADJ-NOUN,compound-conj,amod-compound,NNP-NNP,JJ-NN,1,1
12914,67024.0,48,was,1,47,44,-3,46,3,-46,43,Citibank,Robert Rubin,ORGANIZATION,PERSON-PERSON,PROPN,PROPN-PROPN,conj,compound-poss,NNP,NNP-NNP,13,1
12915,67042.0,21,'m,1,7,4,-3,6,16,-6,3,Brian McFadden,Australia,PERSON-PERSON,COUNTRY,PROPN-PROPN,PROPN,compound-compound,nsubj,NNP-NNP,NNP,3,1
12916,67046.0,55,survived,15,14,38,24,13,16,1,23,she,Jesse Dent Cook,PERSON,PERSON-PERSON-PERSON,PRON,PROPN-PROPN-PROPN,nsubjpass,compound-compound-appos,PRP,NNP-NNP-NNP,6,1
12917,67054.0,8,settled,2,1,7,6,0,0,1,5,His,N.Y.,PERSON,STATE_OR_PROVINCE,DET,PROPN,poss,appos,PRP$,NNP,2,1
12918,67063.0,37,is,1,11,27,16,10,9,-10,26,Melanie Fiona,Canada,PERSON-PERSON,COUNTRY,PROPN-PROPN,PROPN,compound-poss,pobj,NNP-NNP,NNP,10,1
12919,67092.0,30,collapsed,1,1,11,10,0,18,0,10,She,Calif.,PERSON,STATE_OR_PROVINCE,PRON,PROPN,nsubj,appos,PRP,NNP,2,1
12920,67139.0,26,said,10,15,4,-11,14,21,-5,-6,Marcel Ospel,Switzerland,PERSON-PERSON,COUNTRY,PROPN-PROPN,PROPN,compound-appos,poss,NNP-NNP,NNP,6,1
12921,67195.0,40,said,37,10,4,-6,9,35,27,-33,Marcel Ospel,Switzerland,PERSON-PERSON,COUNTRY,PROPN-PROPN,PROPN,compound-appos,poss,NNP-NNP,NNP,3,1
12922,67149.0,25,Gude,2,22,20,-2,21,4,-20,18,Gilbert Gude,US,PERSON-PERSON,COUNTRY,PROPN-PROPN,PROPN,compound-appos,compound,NNP-NNP,NNP,1,1
12923,67173.0,33,provided,2,18,16,-2,17,16,-16,14,Richard Perle,Pentagon official,PERSON-PERSON,TITLE-TITLE,PROPN-PROPN,PROPN-NOUN,compound-nsubj,compound-compound,NNP-NNP,NNP-NN,1,1
12924,67175.0,23,is,14,6,10,4,5,12,8,-4,Gibson Musical Instruments,Nashville,ORGANIZATION-ORGANIZATION-ORGANIZATION,CITY,PROPN-PROPN-PROPN,PROPN,compound-compound-appos,pobj,NNP-NNP-NNPS,NNP,4,1
12925,67198.0,44,said,42,1,18,17,0,25,41,-24,Yoadimnadji,Chadian,PERSON,ORGANIZATION,NOUN,PROPN,nsubjpass,compound,NNS,NNP,5,1
12926,67201.0,20,born,3,1,11,10,0,8,2,8,Mary Dent,1923,PERSON-PERSON,DATE,PROPN-PROPN,NUM,compound-nsubjpass,pobj,NNP-NNP,CD,3,1
12927,67206.0,54,said,10,10,6,-4,9,47,0,-4,NSC,Wu Maw-kuen,ORGANIZATION,PERSON-PERSON,PROPN,PROPN-PROPN,pobj,compound-appos,NNP,NNP-NNP,4,1
12928,67218.0,40,said,1,25,38,13,24,1,-24,37,Hussein Kamel,last Friday,PERSON-PERSON,DATE-DATE,PROPN-PROPN,ADJ-PROPN,compound-compound,amod-npadvmod,NNP-NNP,JJ-NNP,4,1
12929,67224.0,41,said,39,1,7,6,0,33,38,-32,Randall Caroline Watson,"July 23 , 1943",PERSON-PERSON-PERSON,DATE-DATE-DATE-DATE,PROPN-PROPN-PROPN,PROPN-NUM-PUNCT-NUM,compound-compound-nsubjpass,pobj-nummod-punct-nummod,NNP-NNP-NNP,"NNP-CD-,-CD",5,1
12930,67239.0,58,include,1,16,49,33,15,8,-15,48,Gilbert Gude Jr.,Sarah Callaghan,PERSON-PERSON-PERSON,PERSON-PERSON,PROPN-PROPN-PROPN,PROPN-PROPN,compound-compound-conj,compound-conj,NNP-NNP-NNP,NNP-NNP,5,1
12931,67262.0,81,adopted,7,32,5,-27,31,75,-25,-2,American Bar Association,House of Delegates,ORGANIZATION-ORGANIZATION-ORGANIZATION,ORGANIZATION-ORGANIZATION-ORGANIZATION,PROPN-PROPN-PROPN,PROPN-ADP-PROPN,compound-compound-nsubj,nsubj-prep-pobj,NNP-NNP-NNP,NNP-IN-NNPS,5,1
12932,67268.0,33,supplies,15,1,7,6,0,25,14,-8,Denso,Guangdong province,ORGANIZATION,LOCATION-LOCATION,PROPN,PROPN-NOUN,nsubj,compound-pobj,NNP,NNP-NN,4,1
12933,67294.0,36,said,12,8,1,-7,7,34,4,-11,New York Immigration Coalition,Chung-Hwa Hung,ORGANIZATION-ORGANIZATION-ORGANIZATION-ORGANIZATION,PERSON-PERSON,PROPN-PROPN-PROPN-PROPN,PROPN-PROPN,compound-compound-compound-pobj,compound-nsubj,NNP-NNP-NNP-NNP,NNP-NNP,5,1
12934,67307.0,49,Delegates,0,36,30,-6,35,18,-36,30,Manila Economic and Cultural office,Tomas Alcantara,ORGANIZATION-ORGANIZATION-ORGANIZATION-ORGANIZATION-ORGANIZATION,PERSON-PERSON,PROPN-PROPN-CCONJ-ADJ-NOUN,PROPN-PROPN,nmod-amod-cc-conj-pobj,compound-dobj,NNP-NNP-CC-JJ-NN,NNP-NNP,4,1
12935,67318.0,47,outlines,22,29,18,-11,28,28,-7,-4,Raul Castro,Spanish,PERSON-PERSON,NATIONALITY,PROPN-PROPN,ADJ,compound-pobj,amod,NNP-NNP,JJ,10,1
12936,67319.0,30,was,11,10,24,14,9,5,1,13,John Negroponte,director,PERSON-PERSON,TITLE,PROPN-PROPN,NOUN,compound-nsubj,pobj,NNP-NNP,NN,8,1
12937,67320.0,52,said,50,19,40,21,18,11,31,-10,Central American Parliament,Honduras,ORGANIZATION-ORGANIZATION-ORGANIZATION,ORGANIZATION,ADJ-PROPN-PROPN,PROPN,compound-compound-pobj,conj,JJ-NNP-NNP,NNP,21,1
12938,67323.0,52,live,5,3,16,13,2,35,2,11,she,Blakesley Grace,PERSON,PERSON-PERSON,PRON,PROPN-PROPN,nsubj,compound-conj,PRP,NNP-NNP,6,1
12939,67327.0,68,been,20,56,50,-6,55,17,-36,30,Awami League,Sheik Hasina Wajed,ORGANIZATION-ORGANIZATION,PERSON-PERSON-PERSON,PROPN-PROPN,PROPN-PROPN-PROPN,compound-pobj,compound-compound-appos,NNP-NNP,NNP-NNP-NNP,4,1
12940,67345.0,62,organizations,2,15,11,-4,14,50,-13,9,Focus on the Family,Catholic,ORGANIZATION-ORGANIZATION-ORGANIZATION-ORGANIZATION,RELIGION,PROPN-ADP-DET-PROPN,ADJ,appos-prep-det-pobj,amod,NNP-IN-DT-NNP,JJ,6,1
12941,67362.0,28,was,1,1,17,16,0,10,0,16,Negroponte,senior executive,PERSON,TITLE-TITLE,PROPN,ADJ-NOUN,nsubj,amod-attr,NNP,JJ-NN,4,1
12942,67375.0,32,recall,2,18,15,-3,17,16,-16,13,Albert Gonzales,US,PERSON-PERSON,COUNTRY,PROPN-PROPN,PROPN,compound-poss,compound,NNP-NNP,NNP,2,1
12943,67384.0,26,became,9,9,3,-6,8,22,0,-6,he,Naval Aviation Cadet Reserve,PERSON,ORGANIZATION-ORGANIZATION-ORGANIZATION-ORGANIZATION,PRON,PROPN-PROPN-PROPN-PROPN,nsubj,compound-compound-compound-compound,PRP,NNP-NNP-NNP-NNP,4,1
12944,67388.0,38,led,25,15,25,10,14,12,10,0,Army Medical Command,Cody,ORGANIZATION-ORGANIZATION-ORGANIZATION,PERSON,PROPN-PROPN-PROPN,PROPN,compound-compound-pobj,nsubj,NNP-NNP-NNP,NNP,7,1
12945,67392.0,24,told,21,20,10,-10,19,13,1,-11,Medina,Dr Dahir Dheere,ORGANIZATION,PERSON-PERSON-PERSON,PROPN,PROPN-PROPN-PROPN,compound,compound-compound-nsubj,NNP,NNP-NNP-NNP,4,1
12946,67402.0,43,talking,3,25,28,3,24,14,-22,25,MF Global,Dan,ORGANIZATION-ORGANIZATION,PERSON,PROPN-PROPN,PROPN,compound-dobj,nsubj,NNP-NNP,NNP,2,1
12947,67408.0,55,survived,15,14,25,11,13,29,1,10,she,Barbara Crisp,PERSON,PERSON-PERSON,PRON,PROPN-PROPN,nsubjpass,compound-conj,PRP,NNP-NNP,4,1
12948,67417.0,30,became,1,1,21,20,0,8,0,20,Davis,House Armed Services Committee,PERSON,ORGANIZATION-ORGANIZATION-ORGANIZATION-ORGANIZATION,PROPN,PROPN-PROPN-PROPN-PROPN,nsubj,compound-compound-compound-pobj,NNP,NNP-NNP-NNPS-NNP,6,1
12949,67486.0,30,announced,27,9,1,-8,8,28,18,-26,Asian Development Bank,Tadao Chino,ORGANIZATION-ORGANIZATION-ORGANIZATION,PERSON-PERSON,PROPN-PROPN-PROPN,PROPN-PROPN,compound-compound-pobj,compound-nsubj,NNP-NNP-NNP,NNP-NNP,4,1
12950,67489.0,22,says,5,14,7,-7,13,14,-9,2,DirecTV,Eddy Hartenstein,ORGANIZATION,PERSON-PERSON,NOUN,PROPN-PROPN,pobj,compound-nsubj,NN,NNP-NNP,1,1
12951,67495.0,18,born,5,1,14,13,0,3,4,9,Thomas Joseph Meskill Jr.,"Jan. 30 , 1928",PERSON-PERSON-PERSON-PERSON,DATE-DATE-DATE-DATE,PROPN-PROPN-PROPN-PROPN,PROPN-NUM-PUNCT-NUM,compound-compound-compound-nsubjpass,pobj-nummod-punct-nummod,NNP-NNP-NNP-NNP,"NNP-CD-,-CD",5,1
12952,67502.0,41,seems,32,13,11,-2,12,29,19,-21,Alice Dellal,model,PERSON-PERSON,TITLE,PROPN-PROPN,NOUN,compound-compound,compound,NNP-NNP,NN,1,1
12953,67503.0,33,called,25,1,15,14,0,17,24,-10,Richard Perle,Defense Policy Board Advisory Committee,PERSON-PERSON,ORGANIZATION-ORGANIZATION-ORGANIZATION-ORGANIZATION-ORGANIZATION,PROPN-PROPN,PROPN-PROPN-PROPN-PROPN-PROPN,compound-nsubjpass,compound-compound-compound-compound-pobj,NNP-NNP,NNP-NNP-NNP-NNP-NNP,8,1
12954,67505.0,37,said,17,4,8,4,3,28,13,-9,Julian Bond,professor,PERSON-PERSON,TITLE,PROPN-PROPN,NOUN,compound-nsubj,appos,NNP-NNP,NN,2,1
12955,67509.0,21,vaulted,17,7,11,4,6,9,10,-6,Barry Goldwater,U.S. Senate,PERSON-PERSON,ORGANIZATION-ORGANIZATION,PROPN-PROPN,PROPN-PROPN,compound-nsubj,compound-compound,NNP-NNP,NNP-NNP,4,1
12956,67518.0,24,born,4,2,1,-1,1,22,2,-3,Gertrude Dittmars Roraback,Catherine Gertrude Roraback,PERSON-PERSON-PERSON,PERSON-PERSON-PERSON,PROPN-PROPN-PROPN,PROPN-PROPN-PROPN,conj-compound-appos,compound-compound-nsubjpass,NNP-NNP-NNP,NNP-NNP-NNP,1,1
12957,67547.0,12,Hawkins,0,1,12,11,0,-1,-1,12,Hawkins,100,PERSON,NUMBER,PROPN,NUM,ROOT,pobj,NNP,CD,-1,1
12958,67559.0,44,vote,7,17,23,6,16,20,-10,16,Independent Steelworkers Union,"1,250",ORGANIZATION-ORGANIZATION-ORGANIZATION,NUMBER,PROPN-PROPN-PROPN,NUM,compound-compound-pobj,nummod,NNP-NNPS-NNP,CD,3,1
12959,67581.0,25,said,23,1,20,19,0,4,22,-3,He,fundraiser,PERSON,TITLE,PRON,NOUN,nsubj,conj,PRP,NN,4,1
12960,67587.0,27,http://tinyurlcom/38p5gg,1,12,15,3,11,11,-11,14,Sean Preston,2005,PERSON-PERSON,DATE,PROPN-PROPN,NUM,compound-appos,pobj,NNP-NNP,CD,4,1
12961,67590.0,24,assassinated,17,3,10,7,2,13,14,-7,Awami League,Mujibur,ORGANIZATION-ORGANIZATION,PERSON,PROPN-PROPN,PROPN,compound-nsubjpass,pobj,NNP-NNP,NNP,2,1
12962,67603.0,26,made,21,15,11,-4,14,14,6,-10,his,Englishman,PERSON,NATIONALITY,DET,PROPN,poss,poss,PRP$,NNP,3,1
12963,67630.0,15,said,4,3,1,-2,2,13,1,-3,Chris Bentley,Immigration,PERSON-PERSON,ORGANIZATION,PROPN-PROPN,NOUN,compound-nsubj,compound,NNP-NNP,NN,1,1
12964,67638.0,43,sat,12,24,9,-15,23,33,-12,-3,him,Shreveport,PERSON,CITY,PRON,PROPN,dobj,pobj,PRP,NNP,4,1
12965,67642.0,32,flyhalf,1,25,30,5,24,1,-24,29,New South Wales Waratahs,Australia,ORGANIZATION-ORGANIZATION-ORGANIZATION-ORGANIZATION,COUNTRY,PROPN-PROPN-PROPN-PROPN,PROPN,compound-compound-compound-pobj,pobj,NNP-NNP-NNP-NNP,NNP,2,1
12966,67653.0,48,put,35,1,1,0,0,46,34,-34,Zagat,Zagat Survey,ORGANIZATION,ORGANIZATION-ORGANIZATION,PROPN,PROPN-PROPN,conj,compound-nsubjpass,NNP,NNP-NNP,0,1
12967,67659.0,12,took,8,4,1,-3,3,10,4,-7,Abdul Rahim Noor,Inspector-General,PERSON-PERSON-PERSON,TITLE,PROPN-PROPN-PROPN,ADJ,compound-compound-poss,nsubj,NNP-NNP-NNP,JJ,4,1
12968,67660.0,31,revived,19,13,10,-3,12,20,6,-9,Juanita Millender-McDonald,Administration Committee,PERSON-PERSON,ORGANIZATION-ORGANIZATION,PROPN-PROPN,PROPN-PROPN,compound-pobj,compound-compound,NNP-NNP,NNP-NNP,3,1
12969,67674.0,55,reported,53,17,11,-6,16,43,36,-42,Awami National Party,Mawlana Fazal Rahman,ORGANIZATION-ORGANIZATION-ORGANIZATION,PERSON-PERSON-PERSON,PROPN-PROPN-PROPN,PROPN-PROPN-PROPN,compound-compound-compound,compound-compound-pobj,NNP-NNP-NNP,NNP-NNP-NNP,2,1
12970,67698.0,16,disclosed,14,9,10,1,8,5,5,-4,Alcatel-Lucent,Shanghai Bell,ORGANIZATION,ORGANIZATION-ORGANIZATION,ADJ,PROPN-PROPN,amod,compound-pobj,JJ,NNP-NNP,1,1
12971,67714.0,26,told,21,20,18,-2,19,7,1,-3,Chen Zhu,Health Minister,PERSON-PERSON,TITLE-TITLE,PROPN-PROPN,PROPN-PROPN,compound-nsubj,compound-compound,NNP-NNP,NNP-NNP,1,1
12972,67735.0,45,demands,10,1,1,0,0,43,9,-9,Carnival Corp.,Carnival Australia,ORGANIZATION-ORGANIZATION,ORGANIZATION-ORGANIZATION,PROPN-PROPN,PROPN-PROPN,compound-pobj,compound-nsubj,NNP-NNP,NNP-NNP,0,1
12973,67737.0,29,taken,13,19,1,-18,18,27,-6,-12,Fidelity,McColgan,ORGANIZATION,PERSON,PROPN,PROPN,nsubj,poss,NNP,NNP,4,1
12974,67761.0,16,LLC,2,1,5,4,0,10,1,3,Zagat Survey LLC,http://wwwzagatcom/,ORGANIZATION-ORGANIZATION-ORGANIZATION,URL,PROPN-PROPN-PROPN,PROPN,compound-compound-ROOT,ROOT,NNP-NNP-NNP,NNP,3,1
12975,67775.0,26,are,15,14,4,-10,13,21,1,-11,Britney Spears,CA,PERSON-PERSON,STATE_OR_PROVINCE,PROPN-PROPN,PROPN,compound-appos,appos,NNP-NNPS,NNP,6,1
12976,67778.0,46,said,37,17,22,5,16,23,20,-15,Army Medical Command,Kevin C Kiley,ORGANIZATION-ORGANIZATION-ORGANIZATION,PERSON-PERSON-PERSON,PROPN-PROPN-PROPN,PROPN-PROPN-PROPN,compound-compound-pobj,compound-compound-nsubj,NNP-NNP-NNP,NNP-NNP-NNP,9,1
12977,67791.0,42,Goes,3,10,8,-2,9,33,-7,5,Jeremy Hooper,LGBT activist,PERSON-PERSON,TITLE-TITLE,PROPN-PROPN,VERB-NOUN,compound-pobj,compound-compound,NNP-NNP,VB-NN,1,1
12978,67800.0,44,called,17,19,22,3,18,21,-2,5,him,author,PERSON,TITLE,PRON,NOUN,dobj,oprd,PRP,NN,1,1
12979,67810.0,29,BAGHDAD,0,9,19,10,8,9,-9,19,IRGC-QF,Iran,ORGANIZATION,COUNTRY,PROPN,PROPN,nsubj,poss,NNP,NNP,4,1
12980,67833.0,55,said,46,51,48,-3,50,6,-5,2,ICG,Mark Schneider,ORGANIZATION,PERSON-PERSON,PROPN,PROPN-PROPN,poss,compound-nsubj,NNP,NNP-NNP,2,1
12981,67837.0,22,renewed,4,1,21,20,0,0,3,17,Her,70,PERSON,NUMBER,DET,NUM,poss,pobj,PRP$,CD,6,1
12982,67838.0,48,VIENNA,0,21,41,20,20,6,-21,41,nuclear trade,Austria,ORGANIZATION-ORGANIZATION,ORGANIZATION,ADJ-NOUN,PROPN,amod-compound,conj,JJ-NN,NNP,6,1
12983,67841.0,10,been,2,9,1,-8,8,8,-7,-1,Frankie,Brody,PERSON,PERSON,PROPN,PROPN,appos,nsubj,NNP,NNP,2,1
12984,67855.0,5,Association,2,1,5,4,0,-1,1,3,American Bar Association,http://www.abanet.org,ORGANIZATION-ORGANIZATION-ORGANIZATION,URL,PROPN-PROPN-PROPN,PUNCT,compound-compound-ROOT,appos,NNP-NNP-NNP,.,-1,1
12985,67863.0,52,drawn,4,13,19,6,12,32,-9,15,American Bar Association,Sandy '' D'Alemberte,ORGANIZATION-ORGANIZATION-ORGANIZATION,PERSON-PERSON-PERSON,PROPN-PROPN-PROPN,PROPN-PUNCT-PROPN,compound-compound-compound,nmod-punct-pobj,NNP-NNP-NNP,NNP-''-NNP,5,1
12986,67875.0,53,went,23,8,26,18,7,26,15,3,his,Arsakli,PERSON,LOCATION,DET,PROPN,poss,pobj,PRP$,NNP,6,1
12987,67876.0,10,was,4,4,9,5,3,0,0,5,Goodman,Jew,PERSON,RELIGION,PROPN,PROPN,nsubj,attr,NNP,NNP,1,1
12988,67884.0,40,offers,4,10,10,0,9,29,-6,6,IPSCO,IPSCO Inc,ORGANIZATION,ORGANIZATION-ORGANIZATION,PROPN,PROPN-PROPN,compound,compound-pobj,NNP,NNP-NNP,0,1
12989,67893.0,22,serves,1,1,4,3,0,17,0,3,Black,senior vice president,PERSON,TITLE-TITLE-TITLE,PROPN,ADJ-NOUN-NOUN,nsubj,amod-compound-pobj,NNP,JJ-NN-NN,3,1
12990,67932.0,24,looking,15,3,1,-2,2,22,12,-14,Hamilton,Britain,PERSON,COUNTRY,PROPN,PROPN,nsubj,poss,NNP,NNP,3,1
12991,67944.0,24,died,21,1,23,22,0,0,20,2,Michael K. Deaver,Saturday,PERSON-PERSON-PERSON,DATE,PROPN-PROPN-PROPN,PROPN,compound-compound-nsubj,npadvmod,NNP-NNP-NNP,NNP,3,1
12992,67949.0,44,survived,12,11,28,17,10,15,1,16,Farland,Brooke Oatley,PERSON,PERSON-PERSON,PROPN,PROPN-PROPN,nsubjpass,compound-appos,NNP,NNP-NNP,5,1
12993,67975.0,39,s,3,1,1,0,0,37,2,-2,Royal Caribbean,Royal Caribbean Cruises Ltd,ORGANIZATION-ORGANIZATION,ORGANIZATION-ORGANIZATION-ORGANIZATION-ORGANIZATION,ADJ-ADJ,ADJ-PROPN-PROPN-PROPN,compound-nsubj,compound-compound-compound-pobj,JJ-JJ,JJ-NNP-NNPS-NNP,0,1
12994,67983.0,60,survived,2,5,21,16,4,38,-3,19,his,Robert E. Jr.,PERSON,PERSON-PERSON-PERSON,DET,PROPN-PROPN-PROPN,poss,compound-compound-appos,PRP$,NNP-NNP-NNP,7,1
12995,68002.0,33,said,30,4,1,-3,3,31,26,-29,Lee Jye,National Defense Minister,PERSON-PERSON,TITLE-TITLE-TITLE,PROPN-PROPN,PROPN-PROPN-PROPN,compound-nsubj,compound-compound-compound,NNP-NNP,NNP-NNP-NNP,2,1
12996,68019.0,34,has,2,1,1,0,0,32,1,-1,Remy Ma,Remy,PERSON-PERSON,PERSON,PROPN-PROPN,PROPN,compound-nsubj,nsubj,NNP-NNP,NNP,0,1
12997,68023.0,35,exploited,14,3,31,28,2,3,11,17,Hugo Chavez,South America,PERSON-PERSON,LOCATION-LOCATION,PROPN-PROPN,PROPN-PROPN,compound-nsubj,compound-dobj,NNP-NNP,NNP-NNP,4,1
12998,68025.0,48,Mahdi,1,14,25,11,13,22,-13,24,National Salvation Council,Ethiopia,ORGANIZATION-ORGANIZATION-ORGANIZATION,COUNTRY,PROPN-PROPN-PROPN,PROPN,compound-compound-pobj,pobj,NNP-NNP-NNP,NNP,11,1
12999,68039.0,30,said,27,18,14,-4,17,15,9,-13,New South Wales Waratahs,Super 14,ORGANIZATION-ORGANIZATION-ORGANIZATION-ORGANIZATION,ORGANIZATION-ORGANIZATION,PROPN-PROPN-PROPN-PROPN,PROPN-NUM,compound-compound-compound-dobj,nmod-nummod,NNP-NNP-NNP-NNP,NNP-CD,4,1
13000,68042.0,38,managed,7,14,17,3,13,20,-7,10,Lewis Hamilton,23,PERSON-PERSON,NUMBER,PROPN-PROPN,NUM,compound-dobj,appos,NNP-NNP,CD,2,1
13001,68045.0,64,says,3,60,15,-45,59,48,-57,12,Pamela Martin & Associates,Palfrey,ORGANIZATION-ORGANIZATION-ORGANIZATION-ORGANIZATION,PERSON,PROPN-PROPN-CCONJ-PROPN,PROPN,compound-appos-cc-conj,dobj,NNP-NNP-CC-NNPS,NNP,4,1
13002,68051.0,25,was,1,1,10,9,0,14,0,9,He,St. Martinville,PERSON,LOCATION-LOCATION,PRON,PROPN-PROPN,nsubj,compound-compound,PRP,NNP-NNP,4,1
13003,68057.0,22,Representing,0,7,21,14,6,0,-7,21,Nicholas Burns,ambassador,PERSON-PERSON,TITLE,PROPN-PROPN,NOUN,compound-nsubj,conj,NNP-NNP,NN,2,1
13004,68060.0,39,said,34,8,1,-7,7,37,26,-33,Itochu,Tyr Energy,ORGANIZATION,ORGANIZATION-ORGANIZATION,PROPN,PROPN-PROPN,pobj,compound-nsubj,NNP,NNP-NNP,2,1
13005,68065.0,35,said,10,2,1,-1,1,33,8,-9,Zagat Survey,Tim Zagat,ORGANIZATION-ORGANIZATION,PERSON-PERSON,PROPN-PROPN,PROPN-PROPN,compound-pobj,compound-nsubj,NNP-NNP,NNP-NNP,1,1
13006,68072.0,41,said,1,39,35,-4,38,5,-38,34,mortgage,Irvine,ORGANIZATION,CITY,NOUN,PROPN,compound,pobj,NN,NNP,3,1
13007,68083.0,29,said,5,10,26,16,9,2,-5,21,National Beef,US,ORGANIZATION-ORGANIZATION,COUNTRY,PROPN-PROPN,PROPN,compound-dobj,compound,NNP-NNP,NNP,6,1
13008,68088.0,37,-LRB-,3,5,1,-4,4,35,-2,-2,CTC,Chunghwa Telecom Co.,ORGANIZATION,ORGANIZATION-ORGANIZATION-ORGANIZATION,PROPN,PROPN-PROPN-PROPN,compound,compound-compound-subtok,NNP,NNP-NNP-NNP,-1,1
13009,68089.0,43,held,23,29,41,12,28,1,-6,18,Moro National Liberation Front,Khaid Ajibun,ORGANIZATION-ORGANIZATION-ORGANIZATION-ORGANIZATION,PERSON-PERSON,PROPN-PROPN-PROPN-PROPN,PROPN-PROPN,compound-compound-compound-pobj,compound-conj,NNP-NNP-NNP-NNP,NNP-NNP,-1,1
13010,68098.0,23,quoted,8,7,4,-3,6,18,1,-4,Ospel,Balanx,PERSON,ORGANIZATION,PROPN,PROPN,nsubjpass,compound,NNP,NNP,3,1
13011,68121.0,76,held,30,51,47,-4,50,28,-21,17,Dee Myers,White House,PERSON-PERSON,ORGANIZATION-ORGANIZATION,PROPN-PROPN,PROPN-PROPN,compound-appos,compound-compound,NNP-NNP,NNP-NNP,3,1
